ibge;anomes;cadunico_tot_fam;cadunico_tot_pes;cadunico_tot_fam_rpc_ate_meio_sm;cadunico_tot_pes_rpc_ate_meio_sm;cadunico_tot_fam_pob;cadunico_tot_pes_pob;cadunico_tot_fam_ext_pob;cadunico_tot_pes_ext_pob;cadunico_tot_fam_pob_e_ext_pob;cadunico_tot_pes_pob_e_ext_pob
110001;201801;3308;10316;2688;9237;708;2576;1156;4026;1864;6602
110002;201801;11662;32281;8660;27251;2694;9091;2700;8414;5394;17505
110003;201801;681;2062;517;1730;162;579;96;299;258;878
110004;201801;8473;25402;6465;21534;1933;6782;1309;4698;3242;11480
110005;201801;2143;5976;1471;4767;360;1231;533;1801;893;3032
110006;201801;1701;4959;1084;3665;316;1129;124;415;440;1544
110007;201801;1247;3608;1011;3196;334;1109;327;1198;661;2307
110008;201801;2396;7782;2168;7465;280;903;1657;5951;1937;6854
110009;201801;4193;12335;3057;10454;922;3281;918;3273;1840;6554
110010;201801;6138;20717;5125;18999;1521;5525;2164;9007;3685;14532
110011;201801;6498;19154;5123;16541;1714;5771;1193;3922;2907;9693
110012;201801;14154;38666;10330;32164;2747;8972;1926;6098;4673;15070
110013;201801;5373;16491;4416;14683;1750;6005;844;3051;2594;9056
110014;201801;3755;10377;2837;8794;844;2696;1140;3458;1984;6154
110015;201801;4780;13700;3127;10429;824;2914;431;1446;1255;4360
110018;201801;3499;9489;2338;7555;558;2059;658;2032;1216;4091
110020;201801;67393;174421;47381;146674;10556;34593;18224;59948;28780;94541
110025;201801;4468;11916;3214;9789;528;1703;1808;5420;2336;7123
110026;201801;522;1586;452;1468;133;478;191;609;324;1087
110028;201801;6040;17345;4287;13922;1258;4392;536;1706;1794;6098
110029;201801;1332;3411;868;2691;216;684;365;1139;581;1823
110030;201801;10617;27638;7655;23405;1600;5536;3045;9284;4645;14820
110032;201801;3236;9854;2481;8259;863;2924;588;1979;1451;4903
110033;201801;4413;14195;3687;12843;1324;4683;1030;3947;2354;8630
110034;201801;3324;8752;2517;7596;825;2638;1118;3402;1943;6040
110037;201801;1698;5566;1412;4995;348;1280;642;2253;990;3533
110040;201801;2996;9042;2331;7807;744;2665;623;2006;1367;4671
110045;201801;4703;14663;3986;13649;1293;4756;1584;5410;2877;10166
110050;201801;1623;4977;1284;4317;529;1837;314;1058;843;2895
110060;201801;800;2545;595;2114;212;789;65;257;277;1046
110070;201801;1908;6273;1575;5501;568;2077;385;1295;953;3372
110080;201801;4800;12660;3768;11383;1036;3242;1795;5652;2831;8894
110090;201801;662;1851;464;1493;126;441;182;559;308;1000
110092;201801;1169;3623;982;3335;160;596;551;1909;711;2505
110094;201801;3132;9213;2491;8169;858;2905;794;2658;1652;5563
110100;201801;1913;5952;1653;5448;358;1275;847;2773;1205;4048
110110;201801;1595;4780;1230;4206;438;1570;269;982;707;2552
110120;201801;1479;4541;1116;3785;330;1183;242;818;572;2001
110130;201801;2383;6400;1618;5104;407;1431;503;1557;910;2988
110140;201801;2197;7012;1673;5935;453;1697;404;1408;857;3105
110143;201801;1419;3997;1035;3276;353;1159;280;882;633;2041
110145;201801;1013;2847;670;2184;165;574;225;731;390;1305
110146;201801;422;1213;302;1020;56;179;146;523;202;702
110147;201801;646;1819;440;1417;110;371;156;468;266;839
110148;201801;1011;3057;612;2116;110;414;71;247;181;661
110149;201801;2978;8718;2226;7501;865;2871;639;2361;1504;5232
110150;201801;2141;6123;1688;5425;707;2525;394;1190;1101;3715
110155;201801;730;2272;596;1961;133;468;232;734;365;1202
110160;201801;1618;5157;1272;4436;460;1576;295;1087;755;2663
110170;201801;2351;6540;1636;5175;346;1143;789;2462;1135;3605
110175;201801;1484;4434;1172;3964;202;734;587;2083;789;2817
110180;201801;1153;3304;907;2871;268;820;388;1276;656;2096
120001;201801;2875;9279;2507;8728;503;1753;1460;5362;1963;7115
120005;201801;1735;6861;1568;6580;183;852;1166;5019;1349;5871
120010;201801;5169;16666;4527;15583;638;2152;3126;11094;3764;13246
120013;201801;2039;8004;1928;7849;516;2024;1087;4768;1603;6792
120017;201801;2008;7020;1826;6704;391;1480;1005;3916;1396;5396
120020;201801;14007;60516;13348;59229;1595;7540;9790;44521;11385;52061
120025;201801;2566;8201;2236;7783;468;1657;1353;4838;1821;6495
120030;201801;6413;25361;6194;25008;369;1828;5180;20988;5549;22816
120032;201801;1586;7514;1511;7338;104;639;1182;5734;1286;6373
120033;201801;3845;14867;3636;14508;169;871;3144;12502;3313;13373
120034;201801;2286;8913;2025;8449;146;848;1582;6509;1728;7357
120035;201801;3314;14325;3197;14109;290;1504;2550;11317;2840;12821
120038;201801;2602;8996;2394;8627;604;2253;1256;4641;1860;6894
120039;201801;1831;8470;1762;8335;167;1007;1340;6357;1507;7364
120040;201801;41868;143955;37764;137108;7567;29275;21142;78264;28709;107539
120042;201801;3076;12300;2869;11840;172;889;2274;9358;2446;10247
120043;201801;1171;5264;1110;5125;62;376;953;4413;1015;4789
120045;201801;5083;15687;4652;15210;207;786;4230;13807;4437;14593
120050;201801;8376;32633;7827;31676;824;3748;5813;24023;6637;27771
120060;201801;8143;34954;7781;34326;571;3072;6410;28461;6981;31533
120070;201801;2756;9723;2586;9436;350;1271;1783;6713;2133;7984
120080;201801;3864;13991;3558;13486;593;2366;2399;9253;2992;11619
130002;201801;3123;12851;2895;12528;113;624;2597;11285;2710;11909
130006;201801;2225;9005;1897;8395;150;782;1439;6360;1589;7142
130008;201801;2387;8905;2154;8515;97;514;1773;7007;1870;7521
130010;201801;3689;10919;3239;10408;88;351;2988;9608;3076;9959
130014;201801;3086;9747;2581;8898;427;1548;1652;5782;2079;7330
130020;201801;2700;10541;2518;10238;131;766;2045;8268;2176;9034
130030;201801;8947;31273;8286;30559;172;505;7793;29254;7965;29759
130040;201801;3808;11506;3258;10787;222;758;2605;8759;2827;9517
130050;201801;6955;26420;5944;25118;229;1022;5279;22698;5508;23720
130060;201801;6784;28953;6019;27867;529;3127;4664;21521;5193;24648
130063;201801;5005;19078;4501;18490;137;673;4140;17140;4277;17813
130068;201801;3282;13187;2923;12468;224;1168;2185;9340;2409;10508
130070;201801;8204;26258;7133;25058;359;1233;6213;22310;6572;23543
130080;201801;5993;24780;5438;24034;467;2628;4264;18874;4731;21502
130083;201801;2487;9074;2245;8739;216;988;1738;6736;1954;7724
130090;201801;3123;10320;2871;9985;66;289;2582;9100;2648;9389
130100;201801;6594;22290;5941;21576;91;308;5670;20832;5761;21140
130110;201801;7287;22050;6367;20954;560;1622;5337;18087;5897;19709
130115;201801;5140;17076;4688;16488;125;495;4094;14561;4219;15056
130120;201801;14852;55065;13756;53646;1371;5612;11067;43981;12438;49593
130130;201801;4729;16709;3985;15736;471;2139;2993;11750;3464;13889
130140;201801;6433;24666;6249;24455;242;1098;5772;22619;6014;23717
130150;201801;3537;13887;3369;13672;126;748;3039;12290;3165;13038
130160;201801;4615;18007;4190;17453;323;1633;3457;14579;3780;16212
130165;201801;3028;12149;2879;11896;124;697;2517;10363;2641;11060
130170;201801;10768;34316;8919;32096;728;2885;7261;26613;7989;29498
130180;201801;4095;13146;3862;12871;56;263;3669;12210;3725;12473
130185;201801;14757;40864;12184;38112;516;1187;10721;34944;11237;36131
130190;201801;17444;59380;14872;55762;1911;7219;10514;40926;12425;48145
130195;201801;2225;8666;1904;8240;94;435;1678;7353;1772;7788
130200;201801;2169;6925;1876;6525;169;578;1454;5203;1623;5781
130210;201801;1403;5355;1264;5190;112;636;992;4002;1104;4638
130220;201801;2023;7921;1852;7619;142;712;1418;5875;1560;6587
130230;201801;3989;17741;3615;17189;349;1968;2914;13996;3263;15964
130240;201801;9967;33927;8576;31949;241;1418;7527;28037;7768;29455
130250;201801;23586;74823;21051;71929;1615;5437;17422;61062;19037;66499
130255;201801;4144;14676;3761;14032;269;1206;2994;11220;3263;12426
130260;201801;241306;750589;208252;698807;62324;223511;84533;287698;146857;511209
130270;201801;7631;30535;6805;29236;818;3743;4956;21986;5774;25729
130280;201801;3451;14150;3262;13940;79;354;3062;13261;3141;13615
130290;201801;11895;41560;10859;40387;232;569;10281;39078;10513;39647
130300;201801;4618;17114;4303;16638;240;1211;3685;14208;3925;15419
130310;201801;5489;20165;4964;19440;388;1582;4069;16226;4457;17808
130320;201801;3207;11126;2818;10617;329;1197;2053;8007;2382;9204
130330;201801;4091;14041;3522;13329;155;774;3059;11568;3214;12342
130340;201801;20194;71767;18072;69260;1521;5844;15068;59317;16589;65161
130350;201801;3714;14290;3456;13941;192;1131;2959;11782;3151;12913
130353;201801;6278;18847;5355;17663;886;2788;3678;12884;4564;15672
130356;201801;4807;16848;4320;16057;516;2022;3055;11646;3571;13668
130360;201801;3309;9664;2877;9207;85;228;2685;8719;2770;8947
130370;201801;5737;22337;5138;21533;205;1207;4420;18527;4625;19734
130380;201801;7600;31756;7270;31275;515;2734;6172;26366;6687;29100
130390;201801;5362;23817;4930;23023;536;2873;3662;17126;4198;19999
130395;201801;2350;7880;2061;7366;237;884;1478;5306;1715;6190
130400;201801;2405;8289;2111;7867;117;442;1853;6985;1970;7427
130406;201801;10904;40711;9691;39074;1802;7488;6570;27115;8372;34603
130410;201801;3997;14726;3498;13854;1031;4273;1677;6862;2708;11135
130420;201801;11778;46169;10640;44692;1139;5252;8390;35742;9529;40994
130423;201801;3846;13461;3441;12957;182;935;2979;11091;3161;12026
130426;201801;2638;10606;2512;10417;87;416;2304;9652;2391;10068
130430;201801;3856;12486;3547;12060;416;1400;2756;9526;3172;10926
130440;201801;4249;14004;3816;13501;103;399;3532;12592;3635;12991
140002;201801;1860;5847;1651;5585;111;468;1299;4337;1410;4805
140005;201801;3391;9375;3216;9187;115;359;3014;8594;3129;8953
140010;201801;49826;140271;39962;125979;10028;33282;15395;51778;25423;85060
140015;201801;3324;10401;3006;10024;201;659;2566;8726;2767;9385
140017;201801;3503;11006;3122;10501;316;1007;2298;8165;2614;9172
140020;201801;4873;15394;4226;14519;384;1586;3178;10900;3562;12486
140023;201801;2210;7098;1865;6579;240;890;1291;4641;1531;5531
140028;201801;2082;5580;1815;5225;198;649;1374;3851;1572;4500
140030;201801;4019;11919;3608;11402;391;1120;2823;9192;3214;10312
140040;201801;1922;8404;1800;8233;87;505;1630;7439;1717;7944
140045;201801;2605;9671;2231;9137;416;1665;1427;6235;1843;7900
140047;201801;6061;18161;5168;16783;1080;3552;2821;9652;3901;13204
140050;201801;1425;4330;1223;4031;156;506;822;2765;978;3271
140060;201801;1440;4144;1275;3902;118;348;1023;3169;1141;3517
140070;201801;1742;9483;1686;9334;153;1060;1311;7225;1464;8285
150010;201801;40197;108115;37191;104131;1568;5110;32163;89416;33731;94526
150013;201801;1778;4978;1518;4687;140;393;1140;3658;1280;4051
150020;201801;12988;42172;12352;41315;1330;3541;10133;35272;11463;38813
150030;201801;8497;33245;7817;32394;422;1837;6813;28584;7235;30421
150034;201801;4089;11150;3553;10402;260;800;2893;8520;3153;9320
150040;201801;13305;39569;11583;37582;1075;2719;9448;32582;10523;35301
150050;201801;6369;23542;5951;22930;172;893;5372;20736;5544;21629
150060;201801;19058;56324;16461;52419;3674;11630;9112;30334;12786;41964
150070;201801;6299;24866;5643;24127;184;991;5168;22331;5352;23322
150080;201801;81238;202135;68746;185716;15895;44353;28082;83662;43977;128015
150085;201801;6100;19651;5636;19071;271;812;5082;17492;5353;18304
150090;201801;10212;38780;9630;37845;746;3190;7638;30284;8384;33474
150095;201801;5442;17228;4908;16486;301;938;4021;13877;4322;14815
150100;201801;3178;11362;2851;10783;226;893;2171;8244;2397;9137
150110;201801;3783;17384;3707;17288;223;1077;3301;15582;3524;16659
150120;201801;6993;24210;6792;23920;344;1038;5921;21475;6265;22513
150125;201801;744;2075;621;1923;114;398;375;1140;489;1538
150130;201801;22641;67315;20237;63898;2600;7491;14503;47462;17103;54953
150140;201801;189282;493403;169022;466598;25569;69320;110165;314062;135734;383382
150145;201801;4666;14159;4096;13393;640;1891;2997;10228;3637;12119
150150;201801;13183;37470;11995;35904;1231;3830;9004;27329;10235;31159
150157;201801;3189;9245;2684;8572;320;1114;1842;6020;2162;7134
150160;201801;2999;9339;2807;9032;669;2137;1555;5156;2224;7293
150170;201801;24330;81869;21398;77243;3730;13074;13205;50667;16935;63741
150172;201801;3665;11266;3046;10329;304;970;2229;7812;2533;8782
150175;201801;1767;5431;1584;5144;148;544;1195;3928;1343;4472
150178;201801;10064;29284;8461;27378;560;1862;6805;22580;7365;24442
150180;201801;20262;77348;18906;75635;1060;4509;16340;66337;17400;70846
150190;201801;6964;23851;6618;23400;234;1001;5919;20973;6153;21974
150195;201801;5519;17593;5226;17135;111;427;4785;15706;4896;16133
150200;201801;5494;16697;5048;16199;71;225;4773;15458;4844;15683
150210;201801;25242;92066;23982;90402;2052;7542;19380;75536;21432;83078
150215;201801;7428;22704;6485;21274;2084;6928;2600;9032;4684;15960
150220;201801;11072;33654;9886;31897;1896;6054;5584;18759;7480;24813
150230;201801;12442;36901;10747;34635;1604;4967;7141;24262;8745;29229
150240;201801;33565;97224;27860;87234;9325;29867;7074;23091;16399;52958
150250;201801;4211;17122;4016;16838;643;2738;2908;12518;3551;15256
150260;201801;2257;8221;2121;8006;250;943;1519;5849;1769;6792
150270;201801;8235;24038;6116;21136;1856;6598;2466;9026;4322;15624
150275;201801;6202;21338;5770;20682;433;1638;4631;16714;5064;18352
150276;201801;2255;6449;1950;6083;284;876;1426;4626;1710;5502
150277;201801;5005;14162;4212;13212;458;1349;3205;10583;3663;11932
150280;201801;6132;26674;5945;26305;561;2471;4774;21452;5335;23923
150285;201801;3151;11602;2846;11147;332;1417;1960;7830;2292;9247
150290;201801;10635;29165;9828;28291;569;1233;8626;25683;9195;26916
150293;201801;9915;25012;7155;21349;1920;5829;2899;9588;4819;15417
150295;201801;7696;21185;5996;19199;1818;5843;2749;9994;4567;15837
150300;201801;2049;6597;1875;6362;67;337;1585;5359;1652;5696
150304;201801;4127;12999;3585;12128;636;2106;2260;7961;2896;10067
150307;201801;6427;21039;6018;20442;369;1220;5065;17400;5434;18620
150309;201801;6035;19623;5161;18186;1282;4375;2493;9444;3775;13819
150310;201801;6703;27333;6347;26863;321;1622;5475;23379;5796;25001
150320;201801;9567;25427;8688;24305;550;1520;6920;19559;7470;21079
150330;201801;14303;47255;13283;45688;1788;6255;9646;34057;11434;40312
150340;201801;2714;8088;2452;7709;278;821;1785;5745;2063;6566
150345;201801;7337;22860;6684;22007;506;1773;5470;18229;5976;20002
150350;201801;8380;24133;7810;23439;858;2078;6295;19607;7153;21685
150360;201801;22684;66355;18738;61474;2481;7757;12917;44208;15398;51965
150370;201801;9608;33337;8569;31917;846;3093;6415;24802;7261;27895
150375;201801;3126;13349;2850;12923;323;1548;2229;10243;2552;11791
150380;201801;9726;27304;8274;25311;429;1337;6924;21488;7353;22825
150390;201801;7822;33164;7210;32095;1197;5091;4825;22484;6022;27575
150400;201801;6028;22938;5759;22428;362;1427;4732;18625;5094;20052
150405;201801;8531;24336;7572;23165;495;1234;6096;19397;6591;20631
150410;201801;1740;6117;1556;5787;236;896;969;3679;1205;4575
150420;201801;34922;109782;27944;99005;9513;35459;7506;30542;17019;66001
150430;201801;7748;24714;7304;24075;770;2357;5680;19298;6450;21655
150440;201801;5583;18562;5274;18127;396;1293;4335;15144;4731;16437
150442;201801;22498;61689;19442;57284;2899;8415;12048;36846;14947;45261
150445;201801;5613;18668;5093;17836;334;1175;4139;14705;4473;15880
150450;201801;4645;21246;4404;20887;379;1943;3650;17477;4029;19420
150460;201801;7984;26938;7332;26123;256;1091;6288;23196;6544;24287
150470;201801;18069;53437;17007;52180;1173;3176;14765;46132;15938;49308
150475;201801;4187;14056;3780;13449;252;935;3050;11083;3302;12018
150480;201801;14014;47498;12642;45355;1901;6749;8884;33073;10785;39822
150490;201801;7716;28153;7320;27638;220;1057;6533;24760;6753;25817
150495;201801;5017;18146;4867;17954;138;570;4496;16672;4634;17242
150497;201801;2526;8858;2199;8276;608;2366;1029;4057;1637;6423
150500;201801;3241;8697;2921;8225;335;881;2240;6360;2575;7241
150503;201801;3971;11715;3079;10441;990;3402;1262;4636;2252;8038
150506;201801;10347;34469;9228;32888;2043;6802;5712;21927;7755;28729
150510;201801;10063;37738;8888;35463;1374;5279;5731;24189;7105;29468
150520;201801;6975;27052;6858;26901;181;818;6427;25329;6608;26147
150530;201801;12536;42784;11070;40511;1389;4337;8113;31104;9502;35441
150540;201801;4717;13778;4088;12856;197;633;3441;10844;3638;11477
150543;201801;6335;18176;5342;16857;917;2937;3537;11700;4454;14637
150548;201801;9740;30753;8942;29766;316;937;8169;27482;8485;28419
150549;201801;2013;6321;1804;6082;59;236;1615;5445;1674;5681
150550;201801;19454;60511;16750;55982;4776;16155;6693;23754;11469;39909
150553;201801;22703;73915;18410;65797;6422;23983;4993;19487;11415;43470
150555;201801;1747;5035;1425;4528;84;271;1030;3276;1114;3547
150560;201801;1842;5892;1646;5511;314;988;909;3154;1223;4142
150563;201801;2488;8135;2234;7686;486;1799;1183;4083;1669;5882
150565;201801;3967;13418;3598;12824;117;565;3031;10867;3148;11432
150570;201801;5993;20987;5783;20628;392;1507;4701;16793;5093;18300
150580;201801;10120;41705;9285;40755;642;3085;7784;34869;8426;37954
150590;201801;6566;25013;6159;24472;188;952;5648;22462;5836;23414
150600;201801;8456;31053;7925;30348;232;1043;7174;27676;7406;28719
150610;201801;2491;8121;2274;7690;159;603;1783;5963;1942;6566
150611;201801;2829;9082;2621;8736;127;469;2204;7333;2331;7802
150613;201801;12552;35958;9709;31269;2250;7534;4198;13969;6448;21503
150616;201801;3078;9027;2299;7699;579;2129;671;2161;1250;4290
150618;201801;6530;20895;5589;19281;1059;3677;3192;11482;4251;15159
150619;201801;5314;17010;4637;15966;362;1412;3560;12181;3922;13593
150620;201801;6403;22092;5667;21133;783;2904;4091;15628;4874;18532
150630;201801;6225;17361;5807;16872;343;1048;5046;14768;5389;15816
150635;201801;4111;12704;3639;11861;796;2657;1807;6014;2603;8671
150640;201801;2107;6175;1951;6004;38;119;1821;5696;1859;5815
150650;201801;11413;33738;10229;31682;3055;9268;4310;14249;7365;23517
150655;201801;5515;16706;5080;16013;320;987;4198;13323;4518;14310
150658;201801;4442;12923;3747;11968;756;2611;2227;7350;2983;9961
150660;201801;5721;16937;5154;16162;638;1951;3481;11135;4119;13086
150670;201801;7686;19525;6186;17750;629;1681;4818;14324;5447;16005
150680;201801;63957;201738;50703;180904;13292;47524;21471;85962;34763;133486
150690;201801;2239;6327;1994;5979;129;379;1638;4964;1767;5343
150700;201801;6075;18873;5549;18189;588;1857;4151;14046;4739;15903
150710;201801;4200;13955;3745;13235;326;1252;2759;9867;3085;11119
150715;201801;5207;16437;4554;15427;342;1181;3604;12410;3946;13591
150720;201801;6402;24813;6043;24178;499;2181;4801;19458;5300;21639
150730;201801;10695;35002;9589;33275;1127;4048;7139;25320;8266;29368
150740;201801;3682;11155;3227;10368;494;1592;2050;6693;2544;8285
150745;201801;4844;14851;4178;13941;841;2993;2700;9076;3541;12069
150746;201801;1378;4466;1291;4311;101;318;1011;3436;1112;3754
150747;201801;5176;16433;4588;15613;852;2616;2891;10583;3743;13199
150750;201801;3545;11327;3099;10682;205;806;2439;8534;2644;9340
150760;201801;11678;35583;10715;34393;1292;3969;7950;26221;9242;30190
150770;201801;6106;22629;5855;22274;157;506;5326;21076;5483;21582
150775;201801;971;2876;804;2604;148;562;454;1436;602;1998
150780;201801;3953;12391;3736;12143;90;337;3457;11310;3547;11647
150790;201801;5196;16102;4617;15449;268;779;3790;13685;4058;14464
150795;201801;14448;46572;13053;44335;3094;10098;7324;26411;10418;36509
150796;201801;3336;9236;2918;8742;217;660;2357;7188;2574;7848
150797;201801;3890;12664;3407;11892;125;413;2849;10057;2974;10470
150800;201801;13380;42925;12293;41609;2109;6520;8621;30900;10730;37420
150803;201801;6696;23375;6243;22664;557;2131;4957;18125;5514;20256
150805;201801;2915;9874;2601;9356;303;1056;1946;7150;2249;8206
150808;201801;5800;18024;4461;15615;1651;6333;489;1874;2140;8207
150810;201801;19513;56626;15510;51641;2885;9399;9015;32337;11900;41736
150812;201801;5290;15831;4756;14892;513;1776;3475;10639;3988;12415
150815;201801;8502;27445;7464;26137;765;2659;5758;20670;6523;23329
150820;201801;11432;32552;10013;30890;958;2655;7765;24848;8723;27503
150830;201801;12168;46011;11529;45216;480;2501;9824;39333;10304;41834
150835;201801;2212;7717;2048;7418;467;1714;1057;3948;1524;5662
150840;201801;7346;21814;5870;19254;1305;4559;2605;8642;3910;13201
160005;201801;1030;3043;948;2903;26;114;867;2621;893;2735
160010;201801;1740;5259;1719;5237;13;41;1687;5147;1700;5188
160015;201801;2068;7128;1927;6936;108;363;1726;6315;1834;6678
160020;201801;1923;6862;1739;6591;245;990;1270;4845;1515;5835
160021;201801;1093;4415;1023;4311;93;516;814;3379;907;3895
160023;201801;1179;4488;1087;4344;88;315;849;3544;937;3859
160025;201801;1595;4680;1564;4646;30;80;1510;4507;1540;4587
160027;201801;8496;24014;7748;23184;763;2062;6244;19388;7007;21450
160030;201801;54798;174547;46814;163061;11289;38069;23795;90936;35084;129005
160040;201801;4989;17791;4536;17178;125;688;4184;15724;4309;16412
160050;201801;3770;12931;3216;12134;1499;5383;1024;4642;2523;10025
160053;201801;3224;11294;3052;11073;551;1889;2140;8025;2691;9914
160055;201801;587;2275;580;2266;23;112;537;2081;560;2193
160060;201801;19220;58340;17004;55826;1368;4508;13958;46457;15326;50965
160070;201801;2960;11331;2723;10929;190;862;2188;8919;2378;9781
160080;201801;2768;9872;2627;9704;83;385;2396;8881;2479;9266
170025;201801;604;1758;483;1590;134;433;213;727;347;1160
170030;201801;1149;3704;936;3284;175;658;463;1667;638;2325
170035;201801;1426;3867;1101;3339;108;355;643;1983;751;2338
170040;201801;1802;5450;1504;5061;135;513;834;2982;969;3495
170070;201801;1643;4154;1197;3576;164;515;687;2101;851;2616
170100;201801;2373;6931;1999;6340;190;607;1413;4556;1603;5163
170105;201801;730;2259;531;1824;142;482;194;679;336;1161
170110;201801;881;2854;708;2524;137;529;333;1206;470;1735
170130;201801;1338;4142;1015;3522;210;753;476;1734;686;2487
170190;201801;1481;4300;1048;3607;351;1145;232;1024;583;2169
170200;201801;1588;4206;978;3085;276;951;188;549;464;1500
170210;201801;28356;79111;21988;68837;7457;25516;3084;10560;10541;36076
170215;201801;1265;3685;1053;3381;74;290;775;2473;849;2763
170220;201801;5730;18625;5015;17269;1286;4352;2419;8816;3705;13168
170230;201801;1272;4005;1002;3458;245;860;316;1124;561;1984
170240;201801;2706;7898;2133;6970;196;791;1432;4603;1628;5394
170255;201801;3831;11648;2745;9544;692;2489;1091;3892;1783;6381
170270;201801;1042;2535;682;2041;30;88;462;1370;492;1458
170290;201801;2933;8395;2525;7932;187;431;2064;6861;2251;7292
170300;201801;1908;5565;1550;4998;194;628;977;3230;1171;3858
170305;201801;746;2188;584;1869;84;312;283;878;367;1190
170307;201801;989;3474;807;3101;163;619;397;1593;560;2212
170310;201801;1473;4069;1103;3441;227;774;524;1610;751;2384
170320;201801;1045;2911;777;2479;124;414;402;1319;526;1733
170330;201801;826;2667;745;2538;47;199;571;1911;618;2110
170360;201801;459;1372;357;1200;56;217;207;661;263;878
170370;201801;1304;3624;990;3098;158;505;487;1547;645;2052
170380;201801;1801;5607;1387;4936;157;642;791;2877;948;3519
170382;201801;580;1769;476;1588;76;262;283;942;359;1204
170384;201801;1530;5921;1316;5501;363;1602;534;2247;897;3849
170386;201801;782;2228;497;1653;87;325;102;308;189;633
170388;201801;586;1741;426;1455;68;254;192;649;260;903
170389;201801;1193;4279;1044;4020;50;213;840;3290;890;3503
170390;201801;1462;3783;1111;3340;83;270;868;2651;951;2921
170410;201801;535;1668;413;1454;28;119;264;921;292;1040
170460;201801;406;1119;310;956;42;154;176;531;218;685
170510;201801;825;2628;625;2228;83;348;314;1095;397;1443
170550;201801;6507;18047;4652;14865;1401;4912;729;2424;2130;7336
170555;201801;1331;3781;1053;3343;114;388;553;1809;667;2197
170560;201801;1127;3329;853;2955;122;475;449;1731;571;2206
170600;201801;1364;3878;1124;3534;284;816;609;2039;893;2855
170610;201801;1682;4834;1281;4149;105;412;829;2633;934;3045
170625;201801;409;1156;267;842;35;114;94;279;129;393
170650;201801;1264;3878;964;3342;218;769;372;1399;590;2168
170700;201801;3571;10835;2805;9491;598;2199;1180;4111;1778;6310
170710;201801;1643;4683;1290;4045;274;929;581;1743;855;2672
170720;201801;1857;4832;1557;4406;78;171;1328;3874;1406;4045
170730;201801;965;2869;748;2506;181;630;334;1155;515;1785
170740;201801;2073;7320;1767;6742;234;924;1128;4348;1362;5272
170755;201801;854;2559;623;2101;78;304;296;988;374;1292
170765;201801;1233;3314;863;2733;218;706;340;1156;558;1862
170770;201801;1717;5536;1502;5164;214;748;972;3381;1186;4129
170820;201801;3937;13709;3467;12841;507;1827;2038;8030;2545;9857
170825;201801;985;2399;795;2141;65;148;557;1545;622;1693
170830;201801;1380;3918;1129;3518;37;100;927;2936;964;3036
170900;201801;2468;8590;2253;8241;188;748;1807;6654;1995;7402
170930;201801;3641;10501;2985;9382;684;2328;1323;4242;2007;6570
170950;201801;12442;35266;8868;29058;2587;9559;1265;4331;3852;13890
170980;201801;489;1350;370;1163;36;141;219;649;255;790
171050;201801;1555;5075;1387;4774;76;362;1076;3652;1152;4014
171070;201801;1399;4201;1215;3930;295;854;682;2448;977;3302
171090;201801;1095;2770;896;2498;65;162;650;1811;715;1973
171110;201801;572;1661;424;1396;108;393;168;487;276;880
171150;201801;1060;2802;658;2081;74;261;405;1283;479;1544
171180;201801;720;2114;480;1621;89;320;197;690;286;1010
171190;201801;1560;5714;1387;5391;249;977;764;3116;1013;4093
171195;201801;847;2896;711;2649;130;536;413;1568;543;2104
171200;201801;581;1736;441;1483;111;400;158;518;269;918
171215;201801;440;1268;333;1066;69;241;141;437;210;678
171240;201801;734;2599;625;2368;57;282;392;1481;449;1763
171245;201801;603;1966;479;1699;90;350;218;748;308;1098
171250;201801;998;2817;762;2429;194;628;357;1161;551;1789
171270;201801;403;1559;348;1427;93;360;152;698;245;1058
171280;201801;860;2678;687;2369;157;519;298;1138;455;1657
171320;201801;3951;11435;3127;9986;669;2136;1361;4612;2030;6748
171330;201801;2730;7772;2120;6728;487;1595;1011;3296;1498;4891
171360;201801;1437;4452;1229;4165;101;386;957;3245;1058;3631
171370;201801;686;1831;541;1633;58;191;369;1125;427;1316
171380;201801;1333;4035;1076;3599;209;779;546;1833;755;2612
171395;201801;933;2736;664;2207;104;406;328;1061;432;1467
171420;201801;1798;5611;1346;4683;233;896;596;2074;829;2970
171430;201801;1044;3121;855;2781;102;362;564;1775;666;2137
171488;201801;2446;7416;1997;6697;363;1242;1092;3814;1455;5056
171500;201801;909;2508;711;2195;68;225;491;1528;559;1753
171510;201801;798;2781;713;2625;54;246;490;1821;544;2067
171515;201801;470;1318;349;1107;27;93;210;658;237;751
171525;201801;595;1879;498;1705;38;174;316;1023;354;1197
171550;201801;334;1045;240;884;45;188;114;423;159;611
171570;201801;1240;3789;1055;3450;203;642;623;2127;826;2769
171575;201801;1871;5094;1240;3935;196;661;541;1695;737;2356
171610;201801;5527;16344;4242;14123;1048;3845;1147;3985;2195;7830
171620;201801;2830;7924;2362;7285;139;488;1906;5950;2045;6438
171630;201801;936;2740;772;2501;169;589;446;1472;615;2061
171650;201801;2064;6184;1527;5156;378;1288;504;1802;882;3090
171660;201801;2334;6246;1638;5000;273;856;862;2624;1135;3480
171665;201801;1363;3922;1035;3407;199;702;481;1637;680;2339
171670;201801;1869;5101;1443;4417;253;874;748;2244;1001;3118
171700;201801;1162;3529;889;3039;143;485;468;1640;611;2125
171720;201801;778;2163;629;1906;77;255;431;1288;508;1543
171750;201801;1210;3592;874;2961;235;804;197;750;432;1554
171780;201801;1288;3369;926;2848;84;275;604;1846;688;2121
171790;201801;1445;5037;1171;4434;280;1083;514;2036;794;3119
171800;201801;704;2068;557;1839;68;251;333;1101;401;1352
171820;201801;10303;30280;8083;26496;1942;6785;2934;10075;4876;16860
171830;201801;1443;5096;1245;4692;234;920;669;2562;903;3482
171840;201801;691;1885;558;1683;33;104;415;1232;448;1336
171845;201801;637;1745;504;1543;74;276;278;862;352;1138
171850;201801;857;3049;734;2790;73;323;496;1862;569;2185
171855;201801;1099;3432;972;3212;85;291;644;2099;729;2390
171865;201801;393;1332;340;1247;65;259;165;598;230;857
171870;201801;757;2193;560;1817;89;312;274;949;363;1261
171875;201801;1211;3725;971;3328;62;268;717;2436;779;2704
171880;201801;1008;3368;917;3256;66;218;744;2737;810;2955
171884;201801;949;2534;683;2142;137;493;213;746;350;1239
171886;201801;1355;4073;994;3397;285;1038;186;672;471;1710
171888;201801;752;2198;522;1751;44;158;325;1082;369;1240
171889;201801;482;1489;414;1356;73;266;185;622;258;888
171890;201801;1154;3281;892;2872;160;518;521;1703;681;2221
171900;201801;491;1778;378;1503;96;381;136;568;232;949
172000;201801;590;1850;484;1641;74;281;251;827;325;1108
172010;201801;1061;3737;946;3500;93;439;608;2173;701;2612
172015;201801;328;1274;269;1148;52;215;126;547;178;762
172020;201801;2251;7363;2077;7089;189;750;1547;5273;1736;6023
172025;201801;740;2122;535;1786;64;261;306;1019;370;1280
172030;201801;1220;3694;1059;3432;31;128;861;2786;892;2914
172049;201801;1355;3352;888;2635;313;974;395;1178;708;2152
172065;201801;1401;3624;1122;3294;65;164;1000;2986;1065;3150
172080;201801;2381;7311;1953;6521;146;553;1333;4454;1479;5007
172085;201801;470;1334;313;1006;59;167;102;321;161;488
172090;201801;4040;10683;3204;9509;111;379;2645;7878;2756;8257
172093;201801;501;1521;378;1290;69;278;188;615;257;893
172097;201801;641;1775;471;1504;83;288;198;642;281;930
172100;201801;39795;106377;27968;86856;6776;23166;7807;25285;14583;48451
172110;201801;1572;5979;1371;5649;145;623;1023;4366;1168;4989
172120;201801;4865;15102;3877;13518;696;2471;2039;7354;2735;9825
172125;201801;280;844;212;729;29;107;112;393;141;500
172130;201801;723;2187;585;1962;26;95;426;1461;452;1556
172208;201801;2318;6245;1879;5611;271;804;1123;3403;1394;4207
172210;201801;2629;7441;2097;6693;454;1506;1138;3642;1592;5148
210005;201801;20156;61075;16535;55421;4944;17237;6394;22517;11338;39754
210010;201801;1691;5728;1549;5480;50;217;1345;4775;1395;4992
210015;201801;3301;10276;2949;9762;160;424;2485;8448;2645;8872
210020;201801;7398;17000;6644;16158;108;286;6180;14985;6288;15271
210030;201801;5009;16732;4722;16344;250;1209;4048;13868;4298;15077
210040;201801;2123;6169;1926;5943;33;66;1787;5618;1820;5684
210043;201801;6897;18487;5687;17094;751;2109;3992;12750;4743;14859
210047;201801;6469;22386;5847;21520;323;1497;4950;18163;5273;19660
210050;201801;2240;7994;1814;7184;307;1298;1063;4321;1370;5619
210055;201801;1771;5983;1620;5737;72;290;1311;4651;1383;4941
210060;201801;6802;26487;6247;25411;890;3683;4282;17877;5172;21560
210070;201801;7360;21114;6855;20512;55;155;6500;19641;6555;19796
210080;201801;3691;13021;3616;12929;17;75;3523;12641;3540;12716
210083;201801;4792;15804;4236;15201;84;425;3980;14285;4064;14710
210087;201801;2868;8346;2590;7979;185;546;2128;6706;2313;7252
210090;201801;9952;30848;9453;30058;321;1162;8516;27034;8837;28196
210095;201801;6054;20930;5675;20449;304;1254;4914;17845;5218;19099
210100;201801;6995;20969;6448;20227;230;881;5514;17287;5744;18168
210110;201801;2731;9117;2588;8926;53;224;2406;8303;2459;8527
210120;201801;25015;68332;21160;63677;2700;6990;14478;46562;17178;53552
210125;201801;3846;11526;3594;11219;610;1488;2728;9050;3338;10538
210130;201801;4284;12011;3737;11307;205;602;3097;9412;3302;10014
210135;201801;1526;4641;1354;4378;62;229;1112;3605;1174;3834
210140;201801;17055;51313;14023;47194;3053;10529;7605;26470;10658;36999
210150;201801;4625;11415;4105;10747;68;257;3707;9574;3775;9831
210160;201801;16781;51813;15447;49870;1408;4423;11741;39038;13149;43461
210170;201801;14049;47552;13451;46799;636;2306;12056;42198;12692;44504
210173;201801;2459;9379;2330;9175;49;294;2161;8519;2210;8813
210177;201801;3042;9161;2867;8953;59;143;2723;8601;2782;8744
210180;201801;1466;4215;1352;4063;35;126;1203;3592;1238;3718
210190;201801;4829;14892;4400;14107;127;633;3566;11189;3693;11822
210193;201801;1237;3881;1126;3712;49;183;922;3058;971;3241
210197;201801;2001;6671;1841;6472;217;698;1396;5102;1613;5800
210200;201801;7728;25772;7146;24928;743;2597;5626;20042;6369;22639
210203;201801;7027;21571;6515;20895;434;1314;5611;18326;6045;19640
210207;201801;3389;10350;3072;9900;176;481;2512;8339;2688;8820
210210;201801;8242;27517;7835;26961;99;514;7206;25014;7305;25528
210215;201801;1896;6591;1735;6365;65;327;1518;5560;1583;5887
210220;201801;5823;21429;5521;20907;277;1384;4698;17635;4975;19019
210230;201801;5120;16165;4718;15580;239;693;4155;13904;4394;14597
210232;201801;12505;39301;10268;36314;1520;5520;6535;25002;8055;30522
210235;201801;3636;11006;3220;10488;121;505;2821;9231;2942;9736
210237;201801;2374;8751;2236;8581;27;139;2134;8217;2161;8356
210240;201801;2787;8809;2583;8488;110;420;2213;7236;2323;7656
210250;201801;5444;17093;5016;16566;110;576;4487;14738;4597;15314
210255;201801;2671;8314;2345;7733;309;1071;1601;5262;1910;6333
210260;201801;5220;16482;4725;15731;327;1136;3863;12950;4190;14086
210270;201801;4950;14181;4478;13547;103;512;3971;11888;4074;12400
210275;201801;3585;9020;3324;8721;72;127;3146;8380;3218;8507
210280;201801;5543;16571;4635;15227;251;1186;3413;11000;3664;12186
210290;201801;6258;19088;5803;18538;151;544;5188;16643;5339;17187
210300;201801;35827;97823;29630;90079;2008;6307;22250;70552;24258;76859
210310;201801;2960;7917;2693;7563;66;139;2408;6819;2474;6958
210312;201801;2430;7080;2209;6817;50;253;1997;6124;2047;6377
210315;201801;2817;8382;2429;7909;74;211;2135;7151;2209;7362
210317;201801;4048;12846;3783;12540;140;559;3449;11445;3589;12004
210320;201801;18994;61415;17762;59820;587;2573;15913;53641;16500;56214
210325;201801;3501;10550;3120;9997;106;389;2722;8814;2828;9203
210330;201801;29779;80856;24607;74582;5812;16638;12919;44808;18731;61446
210340;201801;10822;32724;9808;31295;1038;3095;7113;23868;8151;26963
210350;201801;9585;28583;8542;27196;310;1091;7230;23209;7540;24300
210355;201801;3932;14141;3525;13509;137;731;2955;11422;3092;12153
210360;201801;15014;44483;13544;42432;712;2689;11164;34784;11876;37473
210370;201801;9954;23252;8096;21267;299;614;7176;19424;7475;20038
210375;201801;3052;8908;2438;8075;655;2183;1166;4110;1821;6293
210380;201801;5650;15255;5073;14532;309;798;4330;12629;4639;13427
210390;201801;2777;10045;2567;9693;138;656;2133;8043;2271;8699
210400;201801;4760;14873;4400;14441;113;307;4075;13537;4188;13844
210405;201801;7439;20657;6009;18595;1265;3844;3165;10380;4430;14224
210407;201801;1940;6799;1641;6225;149;654;1242;4643;1391;5297
210408;201801;2358;9215;2237;9049;157;785;1835;7517;1992;8302
210409;201801;3668;13009;3380;12604;120;674;2909;10816;3029;11490
210410;201801;3564;11260;3206;10729;254;795;2520;8667;2774;9462
210420;201801;4027;13171;3680;12557;181;624;3092;10633;3273;11257
210430;201801;2216;6584;2097;6449;128;350;1819;5662;1947;6012
210440;201801;4132;11871;3919;11608;72;215;3716;11048;3788;11263
210450;201801;2569;8114;2303;7702;123;451;1850;6161;1973;6612
210455;201801;3802;10605;3246;9935;696;2023;2119;6774;2815;8797
210460;201801;3396;10756;3082;10303;125;527;2608;8696;2733;9223
210462;201801;1419;4909;1275;4642;59;285;1019;3672;1078;3957
210465;201801;2620;8133;2347;7752;98;303;2063;6921;2161;7224
210467;201801;6047;19938;5567;19377;321;1215;4842;17043;5163;18258
210470;201801;2105;5580;1473;4660;71;193;1124;3644;1195;3837
210480;201801;15226;47262;13076;44535;1724;5609;9187;33395;10911;39004
210490;201801;3733;9890;3138;9051;82;275;2727;7867;2809;8142
210500;201801;6118;25170;5801;24567;461;2271;4595;19405;5056;21676
210510;201801;6313;21295;5861;20759;265;787;5120;18693;5385;19480
210515;201801;3616;10991;3294;10651;123;352;2991;9869;3114;10221
210520;201801;2602;7654;2317;7284;110;391;2032;6412;2142;6803
210530;201801;49293;132065;41079;119693;6952;25497;12039;42385;18991;67882
210535;201801;3188;10909;3042;10712;88;314;2720;9675;2808;9989
210540;201801;13908;43887;12120;41507;1622;5446;8348;29921;9970;35367
210542;201801;5818;15425;5041;14575;240;508;4547;13495;4787;14003
210545;201801;2308;7258;2165;7040;44;203;1928;6201;1972;6404
210547;201801;3656;13121;3336;12534;379;1363;2381;9274;2760;10637
210550;201801;5918;17844;5178;16967;328;1037;4407;14716;4735;15753
210560;201801;3758;11645;3357;10993;116;445;2875;9345;2991;9790
210565;201801;1438;5089;1229;4759;43;216;1010;4000;1053;4216
210570;201801;11399;31639;10397;30479;376;919;9431;28091;9807;29010
210580;201801;3009;8477;2678;8073;282;527;2100;6751;2382;7278
210590;201801;4027;12645;3641;12142;150;710;3192;10545;3342;11255
210592;201801;2515;7723;2371;7495;34;185;2091;6538;2125;6723
210594;201801;2719;7505;2139;6607;100;280;1573;5030;1673;5310
210596;201801;2452;9075;2292;8746;176;770;1778;6822;1954;7592
210598;201801;1812;5394;1679;5222;50;185;1540;4799;1590;4984
210600;201801;2972;8435;2547;7866;88;280;2077;6445;2165;6725
210610;201801;2471;7758;2237;7465;89;418;1982;6517;2071;6935
210620;201801;2195;6843;1946;6537;46;125;1782;6115;1828;6240
210630;201801;3147;11009;2858;10590;188;908;2295;8373;2483;9281
210632;201801;4367;14750;3966;14156;387;1554;3046;10867;3433;12421
210635;201801;1870;6558;1753;6355;141;435;1452;5440;1593;5875
210637;201801;2491;8554;2270;8224;144;644;1774;6462;1918;7106
210640;201801;4843;18920;4762;18835;34;137;4667;18531;4701;18668
210650;201801;7072;20758;6739;20323;82;266;6448;19452;6530;19718
210660;201801;8545;24963;7692;23714;312;1144;6636;20281;6948;21425
210663;201801;2642;8098;2506;7936;116;366;2157;7012;2273;7378
210667;201801;1892;6290;1766;6091;69;284;1567;5452;1636;5736
210670;201801;4478;15910;4219;15496;183;852;3656;13411;3839;14263
210675;201801;5082;14022;4549;13325;330;806;3779;11436;4109;12242
210680;201801;4060;10634;3457;9911;140;320;3030;8843;3170;9163
210690;201801;7543;24890;6986;24296;274;1042;6151;21899;6425;22941
210700;201801;2725;7684;2340;7213;186;450;1837;6181;2023;6631
210710;201801;4784;15654;4433;15141;158;736;3853;13108;4011;13844
210720;201801;2723;9332;2554;9112;63;327;2338;8285;2401;8612
210725;201801;1187;4334;1063;4114;31;122;812;3280;843;3402
210730;201801;1216;3431;1041;3194;77;237;821;2542;898;2779
210735;201801;4445;14112;3938;13342;326;1179;3217;11024;3543;12203
210740;201801;5234;14784;4737;14280;147;652;4239;12606;4386;13258
210745;201801;4404;12100;4120;11753;189;438;3670;10598;3859;11036
210750;201801;19688;52295;17186;49416;1701;4860;12898;38024;14599;42884
210760;201801;5592;16251;5162;15796;29;91;5001;15379;5030;15470
210770;201801;5859;15902;5041;14965;62;274;4633;13767;4695;14041
210780;201801;7275;24356;6626;23252;692;2289;4936;17815;5628;20104
210790;201801;4740;14850;4384;14413;168;415;3546;12427;3714;12842
210800;201801;4880;13418;4289;12679;80;298;3885;11458;3965;11756
210805;201801;3846;14958;3710;14754;137;721;3261;12977;3398;13698
210810;201801;5098;15320;4691;14798;253;513;4118;13416;4371;13929
210820;201801;7258;21019;6328;19560;758;2304;4217;13296;4975;15600
210825;201801;6181;20128;5815;19665;302;967;5049;17410;5351;18377
210830;201801;8206;23404;7709;22801;548;1269;6581;20128;7129;21397
210840;201801;3408;9233;3090;8792;94;293;2667;7541;2761;7834
210845;201801;5917;17072;5682;16824;38;79;5594;16645;5632;16724
210850;201801;5858;20414;5247;19444;435;1931;3966;14647;4401;16578
210860;201801;17870;51340;15519;48176;960;2887;12517;39661;13477;42548
210870;201801;6113;19069;5353;18156;388;1236;4446;15401;4834;16637
210880;201801;4325;13803;4023;13442;251;971;3370;11248;3621;12219
210890;201801;4579;13777;4173;13293;281;704;3506;11693;3787;12397
210900;201801;4872;14355;3769;12419;1413;4984;764;2814;2177;7798
210905;201801;1892;5579;1636;5229;71;170;1410;4625;1481;4795
210910;201801;7648;24161;6681;22544;899;3138;4418;15005;5317;18143
210920;201801;2980;10417;2665;9983;101;539;2299;8585;2400;9124
210923;201801;1408;4670;1285;4469;99;387;943;3312;1042;3699
210927;201801;4976;15876;4521;15394;115;403;4176;14379;4291;14782
210930;201801;2480;8738;2286;8439;128;633;1840;6692;1968;7325
210940;201801;3357;11177;3183;10924;139;654;2770;9350;2909;10004
210945;201801;5853;17902;5572;17566;270;720;4955;15828;5225;16548
210950;201801;5146;15372;4105;13810;524;1599;2819;9911;3343;11510
210955;201801;1752;5565;1545;5244;145;471;1106;3875;1251;4346
210960;201801;8942;27997;8091;26794;1639;5029;4947;17624;6586;22653
210970;201801;1300;4371;1118;4053;94;427;828;2899;922;3326
210975;201801;1703;5657;1597;5461;136;498;1195;4082;1331;4580
210980;201801;10690;24014;9641;22946;235;433;9106;21932;9341;22365
210990;201801;16695;49216;13524;45001;1979;6775;8449;29087;10428;35862
211000;201801;14631;45390;12889;43419;671;2746;10740;36889;11411;39635
211003;201801;4996;17067;4428;16362;188;876;3704;13937;3892;14813
211010;201801;6417;23775;5981;23184;78;457;5531;21610;5609;22067
211020;201801;7941;25105;7505;24521;422;1594;6393;20898;6815;22492
211023;201801;2087;6967;1980;6809;112;422;1648;5644;1760;6066
211027;201801;2682;9701;2622;9598;220;878;2198;8036;2418;8914
211030;201801;3807;11125;3465;10744;292;649;2908;9406;3200;10055
211040;201801;4497;16554;4301;16265;159;858;3763;14205;3922;15063
211050;201801;9881;25177;9145;24291;216;572;8516;22628;8732;23200
211060;201801;5857;20041;5549;19565;273;1107;4897;17272;5170;18379
211065;201801;2054;6193;1799;5834;58;171;1606;5283;1664;5454
211070;201801;7799;26245;6996;24941;476;1750;5572;20134;6048;21884
211080;201801;1309;3768;1091;3436;52;272;853;2534;905;2806
211085;201801;1981;6313;1800;6044;133;433;1482;5034;1615;5467
211090;201801;3322;9382;3036;9008;66;316;2697;7896;2763;8212
211100;201801;6510;17130;6259;16811;52;172;5915;15864;5967;16036
211102;201801;2907;10817;2707;10539;163;727;2335;9134;2498;9861
211105;201801;2423;7911;2019;7210;241;883;1364;4888;1605;5771
211107;201801;4436;14121;3933;13421;203;716;3187;11223;3390;11939
211110;201801;6174;17567;4792;15530;631;1901;3279;11086;3910;12987
211120;201801;35207;98192;32185;94663;4428;12143;23630;71911;28058;84054
211125;201801;2023;6263;1748;5820;89;339;1466;4899;1555;5238
211130;201801;177394;460537;165891;446172;24184;67006;78117;234123;102301;301129
211140;201801;5024;15879;4591;15255;228;782;3877;12912;4105;13694
211150;201801;9600;27249;8497;25896;295;1093;7309;22336;7604;23429
211153;201801;2581;7979;2238;7549;433;1541;1466;5142;1899;6683
211157;201801;1084;3523;920;3264;52;282;636;2261;688;2543
211160;201801;3995;12582;3317;11457;213;1000;2384;7985;2597;8985
211163;201801;1697;5723;1610;5600;25;73;1512;5343;1537;5416
211167;201801;1514;4925;1428;4787;32;147;1340;4472;1372;4619
211170;201801;5963;15523;5690;15197;69;230;5411;14402;5480;14632
211172;201801;2437;6991;2181;6595;82;305;1821;5368;1903;5673
211174;201801;2723;8257;2519;7988;72;350;2264;7117;2336;7467
211176;201801;4099;12677;3439;11764;288;1139;2601;8907;2889;10046
211178;201801;4485;10743;4015;10225;34;125;3795;9571;3829;9696
211180;201801;4093;14030;3839;13652;272;1030;3228;11590;3500;12620
211190;201801;3024;9356;2664;8813;60;299;2298;7529;2358;7828
211195;201801;1417;4178;1192;3882;70;204;982;3302;1052;3506
211200;201801;2028;6368;1731;5969;191;687;1159;4115;1350;4802
211210;201801;6636;20339;6179;19717;311;1093;5338;17101;5649;18194
211220;201801;33951;93874;29337;88074;3894;11762;20227;62692;24121;74454
211223;201801;4901;14730;4430;14011;469;1375;3286;10638;3755;12013
211227;201801;1632;5815;1520;5644;45;233;1322;4936;1367;5169
211230;201801;7455;23609;6739;22438;600;2045;5183;17350;5783;19395
211240;201801;8061;26995;7669;26495;207;1088;6982;23820;7189;24908
211245;201801;5900;16674;5683;16456;42;85;5607;16286;5649;16371
211250;201801;13894;41148;12901;39969;649;2100;11213;34936;11862;37036
211260;201801;7935;25262;7388;24536;260;1026;6671;22231;6931;23257
211270;201801;10126;33792;8930;32270;425;2021;7287;26661;7712;28682
211280;201801;13375;38547;12057;36893;803;2008;9919;31370;10722;33378
211285;201801;1699;6115;1492;5740;266;1081;712;2843;978;3924
211290;201801;6998;22593;6604;22049;255;971;5718;19152;5973;20123
211300;201801;8179;23811;7517;22953;75;195;7098;21836;7173;22031
211400;201801;11473;35001;9675;32364;1846;6264;5523;19934;7369;26198
220005;201801;1824;5088;1634;4801;42;181;1338;3816;1380;3997
220010;201801;1457;4226;1255;3886;28;122;998;3033;1026;3155
220020;201801;3206;9957;2952;9521;396;1314;2062;6633;2458;7947
220025;201801;2266;5384;1983;4974;35;107;1634;3999;1669;4106
220027;201801;1266;3386;1102;3165;46;169;882;2503;928;2672
220030;201801;3189;8457;3040;8226;118;358;2620;6961;2738;7319
220040;201801;7131;21807;6478;20621;1216;3805;4062;13114;5278;16919
220045;201801;1387;4491;1225;4182;45;227;953;3182;998;3409
220050;201801;4461;13070;3801;12057;155;657;3194;10019;3349;10676
220060;201801;2205;5149;1866;4756;32;69;1704;4346;1736;4415
220070;201801;2448;6714;2152;6256;89;243;1740;5030;1829;5273
220080;201801;657;1974;602;1887;26;107;505;1520;531;1627
220090;201801;1745;4335;1439;3909;23;79;1260;3403;1283;3482
220095;201801;683;1799;639;1740;7;19;596;1616;603;1635
220100;201801;1335;3879;1090;3434;53;218;871;2680;924;2898
220105;201801;2100;6603;1842;6085;137;464;1348;4484;1485;4948
220110;201801;3393;9591;3173;9214;64;267;2789;7971;2853;8238
220115;201801;2611;8312;2457;8062;99;422;2167;6988;2266;7410
220117;201801;1329;3372;1039;2938;20;67;882;2468;902;2535
220120;201801;11525;33802;10614;32696;126;545;9963;30657;10089;31202
220130;201801;954;2914;832;2735;18;122;736;2369;754;2491
220140;201801;1668;4253;1428;3954;109;255;1207;3392;1316;3647
220150;201801;6696;20104;6263;19494;152;747;5439;16641;5591;17388
220155;201801;1090;3252;860;2824;26;99;597;1934;623;2033
220157;201801;1066;2694;899;2416;17;61;732;1918;749;1979
220160;201801;2611;7728;2274;7103;55;282;1855;5666;1910;5948
220170;201801;1373;3917;1164;3593;25;130;1002;3021;1027;3151
220173;201801;2013;5907;1626;5172;45;217;1308;4030;1353;4247
220177;201801;1804;5389;1756;5327;14;51;1701;5164;1715;5215
220180;201801;1161;2985;909;2520;11;43;665;1747;676;1790
220190;201801;5298;15586;4702;14795;425;1396;3588;11399;4013;12795
220191;201801;1372;4511;1279;4343;90;379;916;3030;1006;3409
220192;201801;1841;5117;1462;4444;41;163;1148;3420;1189;3583
220194;201801;1726;5089;1533;4782;74;296;1253;3822;1327;4118
220196;201801;2013;5616;1835;5317;63;254;1543;4372;1606;4626
220198;201801;1261;3650;1010;3312;8;27;957;3177;965;3204
220200;201801;4592;14577;4187;14047;294;1065;3408;11453;3702;12518
220202;201801;2156;6247;1862;5724;29;145;1583;4768;1612;4913
220205;201801;2633;7214;2321;6748;42;172;2009;5738;2051;5910
220207;201801;840;2545;712;2319;60;231;483;1552;543;1783
220208;201801;1725;5445;1416;4836;315;1200;630;2144;945;3344
220209;201801;1609;4711;1380;4315;31;136;1113;3461;1144;3597
220210;201801;1603;4280;1379;3896;33;139;1114;3039;1147;3178
220211;201801;1498;4147;1416;4031;20;86;1257;3573;1277;3659
220213;201801;1690;4690;1514;4345;31;122;1246;3489;1277;3611
220217;201801;1961;6190;1864;6070;36;144;1746;5718;1782;5862
220220;201801;10410;28018;8859;25620;557;1466;6540;19320;7097;20786
220225;201801;1150;3172;941;2890;21;80;793;2412;814;2492
220230;201801;5629;14470;4944;13558;188;524;4271;11728;4459;12252
220240;201801;2892;8732;2655;8292;95;356;2193;6823;2288;7179
220245;201801;1544;3967;1250;3589;13;48;1104;3235;1117;3283
220250;201801;2699;8168;2424;7780;53;227;2112;6780;2165;7007
220253;201801;1646;4664;1380;4192;137;402;1055;3180;1192;3582
220255;201801;1801;4676;1527;4250;26;145;1271;3375;1297;3520
220260;201801;4295;13683;3776;12763;211;776;2928;9918;3139;10694
220265;201801;1253;4253;1141;4075;70;292;858;3045;928;3337
220270;201801;6668;21312;6289;20637;391;1622;5110;16297;5501;17919
220271;201801;1514;4032;1301;3709;47;150;1097;3131;1144;3281
220272;201801;1711;5051;1525;4719;34;115;1187;3615;1221;3730
220273;201801;1193;3448;1020;3127;41;151;787;2393;828;2544
220275;201801;2150;5342;1697;4760;42;161;1460;4069;1502;4230
220277;201801;2134;5743;1840;5280;35;128;1520;4278;1555;4406
220280;201801;1523;4008;1302;3648;55;186;1064;2882;1119;3068
220285;201801;1500;3979;1276;3691;18;75;1175;3377;1193;3452
220290;201801;5775;18439;4840;17091;435;1766;3465;12221;3900;13987
220300;201801;1833;5853;1576;5473;55;319;1291;4371;1346;4690
220310;201801;2615;8028;2217;7566;55;294;1910;6439;1965;6733
220320;201801;2849;8589;2342;7636;156;602;1762;5659;1918;6261
220323;201801;1552;5138;1283;4715;92;384;1009;3690;1101;4074
220325;201801;1199;3703;1016;3354;44;188;803;2627;847;2815
220327;201801;1347;4168;1206;3927;44;220;999;3160;1043;3380
220330;201801;3758;10105;3255;9420;169;519;2648;7613;2817;8132
220335;201801;1764;5359;1567;5131;15;58;1462;4798;1477;4856
220340;201801;1821;4927;1484;4369;55;199;1077;3077;1132;3276
220342;201801;1140;3559;1040;3406;37;152;848;2781;885;2933
220345;201801;2975;7116;2435;6365;18;44;2300;6007;2318;6051
220350;201801;3517;9308;2899;8308;150;498;2182;6153;2332;6651
220360;201801;1222;3209;1003;2874;30;95;804;2257;834;2352
220370;201801;9158;25981;8260;24762;228;886;7309;21748;7537;22634
220375;201801;1411;4399;1317;4277;8;26;1283;4177;1291;4203
220380;201801;1495;3758;1217;3362;39;130;1039;2824;1078;2954
220385;201801;800;1979;633;1693;11;42;531;1379;542;1421
220390;201801;8654;25426;7398;23241;1894;5936;3030;10062;4924;15998
220400;201801;1499;3749;1162;3213;25;97;904;2408;929;2505
220410;201801;1143;3280;955;2961;60;187;762;2332;822;2519
220415;201801;817;2238;709;2062;26;86;535;1520;561;1606
220420;201801;2060;5874;1673;5127;84;272;1239;3736;1323;4008
220430;201801;2441;6681;2376;6596;93;275;2129;5866;2222;6141
220435;201801;1697;4746;1516;4456;56;186;1178;3410;1234;3596
220440;201801;2441;7865;2173;7432;143;539;1777;5973;1920;6512
220450;201801;2107;6131;1764;5650;250;912;1252;3960;1502;4872
220455;201801;1317;4157;1243;4057;34;156;1093;3540;1127;3696
220460;201801;930;2463;845;2364;42;140;728;1990;770;2130
220465;201801;2357;7572;2115;7196;163;603;1601;5456;1764;6059
220470;201801;3540;10279;3189;9705;115;392;2577;7721;2692;8113
220480;201801;2370;6632;1983;5977;135;354;1454;4340;1589;4694
220490;201801;2351;6302;2136;6037;42;162;1900;5318;1942;5480
220500;201801;2787;7564;2460;7029;60;251;1965;5443;2025;5694
220510;201801;2723;7961;2215;7068;90;288;1694;5435;1784;5723
220515;201801;1696;4145;1514;3903;50;125;1340;3442;1390;3567
220520;201801;5021;13373;4585;12785;84;258;4151;11563;4235;11821
220525;201801;1226;3387;1122;3239;23;84;970;2762;993;2846
220527;201801;1315;3864;1152;3571;39;123;944;2962;983;3085
220530;201801;1225;3421;1088;3218;33;131;985;2856;1018;2987
220535;201801;815;2341;756;2264;55;166;597;1794;652;1960
220540;201801;3373;10737;3184;10434;96;426;2767;9003;2863;9429
220545;201801;1379;4455;1287;4281;96;387;1033;3376;1129;3763
220550;201801;8944;27949;8095;26500;584;2179;6095;19619;6679;21798
220551;201801;1425;4335;1252;4050;54;228;988;3116;1042;3344
220552;201801;1521;4587;1297;4158;41;211;1044;3226;1085;3437
220553;201801;1600;4466;1360;4093;50;158;1053;3251;1103;3409
220554;201801;814;2284;660;2035;46;115;502;1557;548;1672
220555;201801;2063;6669;1911;6424;55;281;1604;5309;1659;5590
220556;201801;1288;3885;1124;3553;49;214;838;2519;887;2733
220557;201801;1545;4785;1332;4361;88;321;951;3059;1039;3380
220558;201801;1126;3331;977;3118;36;168;789;2452;825;2620
220559;201801;1614;4348;1394;3989;14;48;1167;3345;1181;3393
220560;201801;1630;3967;1322;3546;39;98;1149;3060;1188;3158
220570;201801;7189;22635;6620;21716;626;2131;4948;16377;5574;18508
220580;201801;6492;19130;6212;18679;174;579;5556;16579;5730;17158
220585;201801;1968;6487;1785;6149;75;303;1438;4910;1513;5213
220590;201801;1290;3695;1102;3412;112;357;748;2325;860;2682
220595;201801;2418;6840;2252;6628;20;110;2109;6135;2129;6245
220600;201801;1360;3166;1107;2840;81;119;910;2407;991;2526
220605;201801;1732;5084;1477;4652;37;166;1168;3583;1205;3749
220610;201801;2859;8784;2691;8543;44;204;2462;7797;2506;8001
220620;201801;7635;24596;7163;23955;213;953;6458;21422;6671;22375
220630;201801;379;1156;306;1029;44;172;176;601;220;773
220635;201801;1670;5410;1467;4981;82;327;1087;3635;1169;3962
220640;201801;2717;7539;2321;6951;85;301;1926;5707;2011;6008
220650;201801;2070;6017;1796;5527;70;237;1365;4171;1435;4408
220660;201801;2820;8322;2510;7920;90;387;2151;6646;2241;7033
220665;201801;1279;3998;1132;3756;25;136;960;3131;985;3267
220667;201801;1618;5324;1461;5044;73;282;1174;4061;1247;4343
220669;201801;1735;5530;1657;5392;91;409;1358;4340;1449;4749
220670;201801;2012;5670;1740;5335;48;144;1556;4767;1604;4911
220672;201801;2618;7218;2318;6847;112;333;2033;6050;2145;6383
220675;201801;1250;3504;1146;3318;59;156;893;2584;952;2740
220680;201801;2561;7400;2434;7231;126;370;2137;6345;2263;6715
220690;201801;1623;4442;1412;4094;128;331;1046;3091;1174;3422
220695;201801;938;2671;854;2508;31;109;693;2016;724;2125
220700;201801;8369;22757;7013;20778;371;1262;5376;15742;5747;17004
220710;201801;841;2435;659;2069;53;145;462;1441;515;1586
220720;201801;1976;4992;1809;4746;40;129;1566;4077;1606;4206
220730;201801;1339;3860;1122;3513;29;131;914;2808;943;2939
220735;201801;1002;2422;782;2059;26;63;649;1700;675;1763
220740;201801;1411;4087;1147;3744;35;123;970;3179;1005;3302
220750;201801;3736;10358;3373;9824;188;543;2862;8336;3050;8879
220755;201801;1129;3067;1000;2858;35;125;793;2204;828;2329
220760;201801;2899;8887;2584;8465;99;392;2200;7211;2299;7603
220770;201801;20658;66516;18077;61747;6427;22777;5579;19995;12006;42772
220775;201801;1123;3045;1066;2982;18;64;1036;2891;1054;2955
220777;201801;1555;4149;1238;3619;41;114;942;2735;983;2849
220779;201801;1350;3338;1217;3152;30;107;1057;2696;1087;2803
220780;201801;5402;14350;4679;13195;229;767;3785;10443;4014;11210
220785;201801;1411;3266;1294;3096;23;28;1218;2918;1241;2946
220790;201801;10162;29695;9194;28255;336;1395;7732;23384;8068;24779
220793;201801;829;2315;716;2122;33;111;580;1706;613;1817
220795;201801;1425;3859;1292;3688;33;128;1149;3265;1182;3393
220800;201801;16027;41029;13671;37578;870;2492;9635;26004;10505;28496
220810;201801;2942;8508;2572;7853;59;251;2129;6361;2188;6612
220820;201801;5266;14017;4636;13122;441;1163;3525;10032;3966;11195
220830;201801;7077;19756;6489;18879;346;1072;5308;15380;5654;16452
220840;201801;12747;39801;11003;36290;2168;6958;5896;19884;8064;26842
220850;201801;2956;9577;2708;9275;74;384;2415;8222;2489;8606
220855;201801;602;1750;515;1602;20;88;415;1264;435;1352
220860;201801;984;2529;860;2343;18;64;769;2072;787;2136
220865;201801;2567;6938;2016;5997;63;253;1580;4558;1643;4811
220870;201801;2440;7687;2079;7198;38;211;1878;6450;1916;6661
220880;201801;5003;12791;4496;12187;52;170;4209;11381;4261;11551
220885;201801;1240;4305;1077;4002;63;322;819;3035;882;3357
220887;201801;1330;3162;1187;2965;10;34;1112;2757;1122;2791
220890;201801;1575;5203;1349;4773;104;358;980;3522;1084;3880
220900;201801;1962;5079;1673;4672;39;100;1454;4042;1493;4142
220910;201801;1493;4381;1290;4074;32;110;1134;3595;1166;3705
220915;201801;963;2667;808;2368;21;87;635;1810;656;1897
220920;201801;1362;4689;1174;4415;83;392;902;3340;985;3732
220930;201801;1516;4572;1357;4335;35;156;1203;3765;1238;3921
220935;201801;1044;3051;847;2631;29;125;572;1655;601;1780
220937;201801;1381;3763;1194;3476;27;105;968;2760;995;2865
220940;201801;1375;4139;1171;3729;49;212;856;2637;905;2849
220945;201801;424;1512;379;1422;22;120;268;988;290;1108
220950;201801;1365;3258;918;2535;19;79;703;1876;722;1955
220955;201801;1539;4149;1343;3813;46;125;1119;3186;1165;3311
220960;201801;882;2251;690;1940;18;68;541;1497;559;1565
220965;201801;1707;4861;1548;4611;27;166;1328;3829;1355;3995
220970;201801;1875;4933;1448;4239;65;173;1124;3316;1189;3489
220975;201801;714;2235;638;2140;25;164;564;1795;589;1959
220980;201801;1206;3472;1078;3264;33;130;886;2642;919;2772
220985;201801;1189;3389;1088;3240;46;192;835;2373;881;2565
220987;201801;1476;4535;1289;4205;67;290;1036;3322;1103;3612
220990;201801;1728;4987;1483;4589;41;204;1169;3510;1210;3714
220995;201801;1194;3517;919;3072;66;264;648;2173;714;2437
220997;201801;2395;7016;2251;6809;55;218;2060;6173;2115;6391
221000;201801;4075;11979;3780;11519;172;726;3103;9268;3275;9994
221005;201801;1409;4096;1280;3862;106;320;975;2877;1081;3197
221010;201801;1201;3019;1006;2778;26;87;872;2363;898;2450
221020;201801;1590;4965;1471;4725;44;204;1086;3420;1130;3624
221030;201801;1523;4295;1339;4013;42;188;1104;3244;1146;3432
221035;201801;1357;3740;1251;3602;25;55;1150;3375;1175;3430
221037;201801;592;1750;512;1603;11;56;358;1066;369;1122
221038;201801;552;1546;425;1317;18;65;288;885;306;950
221039;201801;897;2435;788;2268;21;84;665;1865;686;1949
221040;201801;4320;13263;3934;12593;166;582;3115;10007;3281;10589
221050;201801;3534;10076;3233;9693;59;257;2927;8677;2986;8934
221060;201801;8285;23513;6971;21420;323;1078;5303;16561;5626;17639
221062;201801;1222;4134;1075;3848;47;252;837;2940;884;3192
221063;201801;1156;3499;1006;3262;73;261;723;2325;796;2586
221065;201801;2685;7067;2350;6508;42;146;2026;5528;2068;5674
221070;201801;3518;11163;3004;10170;189;712;2209;7442;2398;8154
221080;201801;3500;8704;2829;7704;74;279;2282;6136;2356;6415
221090;201801;1385;3734;1176;3378;19;79;1004;2821;1023;2900
221093;201801;1476;4332;1373;4122;166;517;871;2516;1037;3033
221095;201801;900;2402;770;2192;6;21;638;1772;644;1793
221097;201801;811;2191;637;1872;21;78;469;1327;490;1405
221100;201801;99543;285885;89093;267973;16452;50857;50775;151085;67227;201942
221110;201801;10250;31071;9400;30006;284;1315;8157;25699;8441;27014
221120;201801;4137;12571;3857;12109;338;1137;3059;9568;3397;10705
221130;201801;4678;12837;3634;10728;996;2890;1442;4336;2438;7226
221135;201801;1557;4429;1403;4216;40;157;1220;3621;1260;3778
221140;201801;1305;3169;1152;2955;12;41;1030;2597;1042;2638
221150;201801;1144;2877;910;2468;23;84;702;1820;725;1904
221160;201801;790;2011;719;1916;24;55;581;1542;605;1597
221170;201801;1096;3227;987;3047;23;76;804;2469;827;2545
230010;201801;3290;8837;2635;7688;185;619;1961;5620;2146;6239
230015;201801;2891;9780;2663;9336;261;1080;1792;6180;2053;7260
230020;201801;13326;42673;12832;41880;489;1997;10939;35312;11428;37309
230030;201801;12217;32852;10662;30629;265;927;9265;26495;9530;27422
230040;201801;4198;11401;3573;10344;132;504;2855;8129;2987;8633
230050;201801;2683;8736;1987;6969;444;1497;671;2390;1115;3887
230060;201801;2331;6569;1911;5765;56;227;1526;4500;1582;4727
230070;201801;4025;11460;3384;10180;194;669;2328;7092;2522;7761
230075;201801;9126;30343;8447;29118;436;2160;6751;22697;7187;24857
230080;201801;2502;5993;2008;5268;43;176;1725;4441;1768;4617
230090;201801;3993;10732;3465;9890;190;616;2614;7339;2804;7955
230100;201801;17622;48958;15787;46223;1955;6088;9921;29127;11876;35215
230110;201801;11791;36573;10559;34077;2024;6644;5616;18259;7640;24903
230120;201801;7519;20765;6536;19232;615;1686;4712;14198;5327;15884
230125;201801;2983;8305;2464;7415;102;372;1882;5625;1984;5997
230130;201801;5704;18246;4776;16245;506;1839;3059;10213;3565;12052
230140;201801;3542;10838;2973;9799;168;677;2127;6934;2295;7611
230150;201801;1632;4952;1393;4422;264;820;733;2382;997;3202
230160;201801;6348;17478;5504;16207;218;799;4478;13010;4696;13809
230170;201801;6023;18065;5232;16579;251;958;3858;11971;4109;12929
230180;201801;1672;4759;1427;4280;40;178;1086;3118;1126;3296
230185;201801;3982;12321;3487;11436;342;1247;2474;8134;2816;9381
230190;201801;12639;38710;10967;35465;1690;5674;5782;18764;7472;24438
230195;201801;5171;15528;4590;14526;339;1210;3522;10987;3861;12197
230200;201801;4889;13703;4275;12513;194;604;3328;9532;3522;10136
230205;201801;4053;12846;3637;12109;193;842;2669;8727;2862;9569
230210;201801;9513;25132;8093;23033;545;1723;5849;16551;6394;18274
230220;201801;13434;36023;11932;33585;600;1899;9558;26537;10158;28436
230230;201801;6948;21598;6284;20282;536;1767;4496;14490;5032;16257
230240;201801;13076;35324;11526;32839;521;1475;9181;26085;9702;27560
230250;201801;9215;27375;9097;27177;406;1475;7135;20806;7541;22281
230260;201801;14333;45824;12939;42985;1758;6184;7494;25078;9252;31262
230270;201801;7432;21011;6033;18405;632;2002;3897;11972;4529;13974
230280;201801;20199;57036;17201;51924;842;3343;13227;38756;14069;42099
230290;201801;4724;13776;4057;12392;466;1309;2819;8752;3285;10061
230300;201801;4331;12445;4096;12120;147;606;3514;10176;3661;10782
230310;201801;4810;13931;4106;12706;128;519;2973;9022;3101;9541
230320;201801;7510;22078;6603;20423;360;1386;5000;15205;5360;16591
230330;201801;4730;13380;3927;11846;221;690;2857;8529;3078;9219
230340;201801;3572;11456;3079;10432;278;1005;2105;7067;2383;8072
230350;201801;18571;53288;16580;49927;1130;4003;10718;32610;11848;36613
230360;201801;2986;8349;2370;7211;151;517;1627;4887;1778;5404
230365;201801;3019;7790;2575;7080;72;323;2168;5843;2240;6166
230370;201801;53402;160523;46520;149656;10503;34828;21948;73428;32451;108256
230380;201801;6449;18339;5211;15998;184;676;3733;11270;3917;11946
230390;201801;3319;10223;2910;9514;151;639;2192;7019;2343;7658
230393;201801;3029;9598;2562;8641;109;586;1907;6154;2016;6740
230395;201801;5606;15684;4948;14528;538;1547;3295;9839;3833;11386
230400;201801;5591;16208;4980;15178;189;835;3940;11689;4129;12524
230410;201801;14681;44791;12078;39603;1485;5008;7268;23979;8753;28987
230420;201801;24813;74790;21566;68564;3264;11094;11428;36088;14692;47182
230423;201801;4514;13892;3966;12785;145;621;3124;9894;3269;10515
230425;201801;5534;17821;5064;16821;567;1920;3382;11260;3949;13180
230426;201801;2552;6998;1963;5862;49;212;1479;4325;1528;4537
230427;201801;1810;5278;1290;4086;75;262;865;2629;940;2891
230428;201801;9433;26823;8458;25293;1314;4192;4744;14070;6058;18262
230430;201801;4475;13556;3882;12487;233;908;2865;8950;3098;9858
230435;201801;5432;15686;4693;14396;627;1983;2793;8608;3420;10591
230440;201801;385239;1038530;327314;946934;56754;171938;168800;489564;225554;661502
230445;201801;4443;11965;3740;10739;212;567;2657;7534;2869;8101
230450;201801;3524;10704;3086;9933;230;939;2216;6995;2446;7934
230460;201801;1962;5985;1714;5539;96;377;1341;4312;1437;4689
230465;201801;4047;11639;3353;10384;115;510;2437;7289;2552;7799
230470;201801;11166;38635;10218;36799;949;4094;7340;26029;8289;30123
230480;201801;1425;4338;1209;3909;110;434;867;2719;977;3153
230490;201801;2309;6845;2018;6304;228;731;1129;3428;1357;4159
230495;201801;5667;17669;5087;16595;451;1829;3348;10740;3799;12569
230500;201801;8492;29460;7980;28471;419;1851;6122;21796;6541;23647
230510;201801;1618;5319;1204;4332;231;884;467;1665;698;2549
230520;201801;4330;12962;3922;12185;311;1059;2748;8403;3059;9462
230523;201801;15061;46210;12673;41088;2956;9826;3209;10878;6165;20704
230526;201801;3959;11514;3380;10487;160;705;2600;7827;2760;8532
230530;201801;5222;16434;4560;15323;503;1789;3175;10772;3678;12561
230533;201801;4025;10603;3432;9528;182;505;2677;7400;2859;7905
230535;201801;5483;15626;4667;14148;327;990;3201;9881;3528;10871
230540;201801;16540;46955;14786;44301;376;1579;12561;37110;12937;38689
230550;201801;19536;55102;16588;49826;2231;7150;9421;28045;11652;35195
230560;201801;7398;19728;6144;17485;123;481;4954;13903;5077;14384
230565;201801;3340;9147;2698;7996;94;346;1992;5860;2086;6206
230570;201801;3532;9242;3066;8610;76;219;2557;7142;2633;7361
230580;201801;9793;28029;8776;26535;422;1555;7297;21842;7719;23397
230590;201801;8965;26661;7493;23895;559;2022;5186;16094;5745;18116
230600;201801;3751;10090;2841;8312;102;317;1851;5472;1953;5789
230610;201801;6324;18688;5675;17653;482;1512;4253;13257;4735;14769
230620;201801;2114;5882;1631;4880;157;495;956;2800;1113;3295
230625;201801;8069;24598;7092;22632;2091;6963;1882;6234;3973;13197
230630;201801;10540;32560;9405;30275;2502;7568;4008;13949;6510;21517
230640;201801;26854;83552;24381;79662;1830;6799;18868;61218;20698;68017
230650;201801;4806;14085;4204;12911;276;942;3146;9496;3422;10438
230655;201801;9334;33174;8896;32385;623;2646;6997;25527;7620;28173
230660;201801;6178;18604;5141;16593;196;1014;4123;12979;4319;13993
230670;201801;6032;15219;4582;12766;179;538;3548;9644;3727;10182
230680;201801;2569;7432;2209;6730;251;772;1435;4373;1686;5145
230690;201801;6352;19824;5857;18767;584;2066;3579;11254;4163;13320
230700;201801;9412;25497;8235;23293;381;1295;6150;16856;6531;18151
230710;201801;7167;22721;6221;20937;557;2008;4496;15054;5053;17062
230720;201801;1861;5753;1564;5115;148;478;1004;3254;1152;3732
230725;201801;3537;11625;3090;10525;740;2593;1065;3612;1805;6205
230730;201801;54779;158060;45662;143279;11343;38798;14870;48866;26213;87664
230740;201801;6096;17597;5415;16442;159;621;4314;12966;4473;13587
230750;201801;8218;22849;6970;20777;247;887;5397;15711;5644;16598
230760;201801;11265;31755;10136;29823;829;2830;7224;20708;8053;23538
230763;201801;4349;12784;3762;11670;214;844;2851;8519;3065;9363
230765;201801;39703;117218;34350;107681;7899;26074;12257;39057;20156;65131
230770;201801;26073;68607;22233;63273;2942;8831;13644;38924;16586;47755
230780;201801;5854;21384;5539;20720;959;3564;3172;12333;4131;15897
230790;201801;2881;8669;2656;8299;155;542;2087;6499;2242;7041
230800;201801;7761;25978;7020;24419;968;3706;3955;13596;4923;17302
230810;201801;11637;36140;10637;34495;524;2056;8234;26270;8758;28326
230820;201801;3183;10662;2748;9720;287;1178;1675;5785;1962;6963
230830;201801;7549;21936;6497;20027;235;1010;5109;15400;5344;16410
230835;201801;4004;10056;3182;8761;119;402;2554;6871;2673;7273
230837;201801;3119;10165;2694;9329;157;730;1977;6666;2134;7396
230840;201801;8861;27345;7839;25611;568;2052;5978;19563;6546;21615
230850;201801;9179;27747;8192;25916;595;2085;5805;18275;6400;20360
230860;201801;4988;13613;4267;12525;176;624;3562;10340;3738;10964
230870;201801;17328;44022;14953;40403;599;1750;11732;31527;12331;33277
230880;201801;1989;6422;1843;6160;80;406;1397;4513;1477;4919
230890;201801;4333;14683;3999;14029;376;1462;2785;9685;3161;11147
230900;201801;2965;9278;2503;8290;323;1085;1500;4911;1823;5996
230910;201801;3034;8643;2468;7663;97;459;1922;5849;2019;6308
230920;201801;4435;12696;4008;12091;148;591;3380;10097;3528;10688
230930;201801;6624;19504;5671;17654;455;1547;3760;11599;4215;13146
230940;201801;7650;21112;6781;19696;210;664;5610;16202;5820;16866
230945;201801;6436;18981;5628;17415;457;1517;3772;11767;4229;13284
230950;201801;6350;16497;5758;15763;135;329;5125;14305;5260;14634
230960;201801;13512;41132;12244;38652;1969;6433;6095;19464;8064;25897
230970;201801;13524;38879;11627;35718;2140;6949;5512;16995;7652;23944
230980;201801;2733;8240;2368;7587;539;1674;1281;4256;1820;5930
230990;201801;1768;5061;1446;4458;94;392;972;2874;1066;3266
231000;201801;2539;6846;2119;6017;97;287;1483;4135;1580;4422
231010;201801;3007;7955;2460;7038;164;540;1837;5155;2001;5695
231020;201801;8034;26234;7373;24778;1304;4191;4269;14866;5573;19057
231025;201801;7390;21939;6629;20638;1083;3447;4106;12934;5189;16381
231030;201801;6894;21731;5697;19158;1010;3430;2976;10057;3986;13487
231040;201801;3122;9355;2723;8606;103;420;2075;6443;2178;6863
231050;201801;11831;31939;9690;28193;606;1741;7192;20709;7798;22450
231060;201801;2531;7771;2299;7385;93;422;1765;5611;1858;6033
231070;201801;8175;24825;7099;22796;1147;3752;3894;12634;5041;16386
231080;201801;3966;11897;3579;11217;138;697;2766;8330;2904;9027
231085;201801;5567;15516;4935;14727;372;1088;3681;11234;4053;12322
231090;201801;4206;11433;3276;9582;125;449;2300;6541;2425;6990
231095;201801;2063;6442;1763;5776;157;575;1210;3916;1367;4491
231100;201801;2979;9105;2553;8308;206;700;1836;5958;2042;6658
231110;201801;3347;10660;3291;10556;222;868;2385;7499;2607;8367
231120;201801;1912;6165;1729;5795;157;551;1146;3831;1303;4382
231123;201801;1972;5222;1665;4668;87;269;1225;3360;1312;3629
231126;201801;5881;16647;4777;14542;213;765;3422;10190;3635;10955
231130;201801;18930;54564;16515;50998;1836;6329;10881;33788;12717;40117
231135;201801;4134;11906;3492;10727;177;665;2523;7598;2700;8263
231140;201801;17205;51356;14425;46155;947;3913;9739;30280;10686;34193
231150;201801;5277;15158;4471;13594;732;2195;2239;6964;2971;9159
231160;201801;5744;18402;5299;17523;1140;3541;2772;9566;3912;13107
231170;201801;4230;12992;3559;11590;229;848;2463;7836;2692;8684
231180;201801;14093;41107;12073;36863;2595;8019;5297;16056;7892;24075
231190;201801;4040;11628;3487;10690;187;765;2615;7742;2802;8507
231195;201801;4510;14713;3903;13426;269;1171;2781;9304;3050;10475
231200;201801;7956;25799;6890;23583;285;1412;5096;16946;5381;18358
231210;201801;4750;14713;4153;13707;197;860;3108;9994;3305;10854
231220;201801;11803;32146;9672;28096;571;1737;6995;19851;7566;21588
231230;201801;8981;29110;8096;27685;593;2330;6045;20735;6638;23065
231240;201801;11682;35406;10522;33117;1843;5910;5952;18938;7795;24848
231250;201801;1954;5324;1354;3928;117;336;745;2118;862;2454
231260;201801;3204;9563;2859;8999;339;1012;1878;6066;2217;7078
231270;201801;6772;18118;5752;16508;192;777;4379;12276;4571;13053
231280;201801;1684;5409;1571;5194;141;478;1114;3686;1255;4164
231290;201801;36094;112841;31806;104001;5672;19378;14584;47218;20256;66596
231300;201801;3996;11521;3273;10030;281;906;2114;6381;2395;7287
231310;201801;7399;20307;6009;17542;711;2076;3667;10580;4378;12656
231320;201801;7249;21081;5841;18334;152;692;4481;13844;4633;14536
231325;201801;2554;7309;2174;6692;425;1277;1144;3616;1569;4893
231330;201801;10353;32523;8804;29307;1737;5715;4434;15138;6171;20853
231335;201801;5478;14990;4657;13587;118;547;3943;11255;4061;11802
231340;201801;17705;56154;16017;53332;1262;4381;11839;39763;13101;44144
231350;201801;15049;42477;13832;40790;354;1141;12423;36697;12777;37838
231355;201801;4469;13836;4011;13031;228;876;3042;9809;3270;10685
231360;201801;7579;23518;6647;21905;616;2119;4708;15679;5324;17798
231370;201801;2352;6389;1852;5517;51;147;1384;4105;1435;4252
231375;201801;4237;13729;3899;13112;154;701;3184;10544;3338;11245
231380;201801;5631;15867;5267;15405;195;472;4510;13514;4705;13986
231390;201801;3358;10167;3024;9599;208;781;2160;6687;2368;7468
231395;201801;3913;12153;3343;11183;635;2140;1796;6093;2431;8233
231400;201801;8996;26887;8081;25150;400;1569;6175;18859;6575;20428
231410;201801;14846;47259;13279;44702;940;3418;10095;33718;11035;37136
240010;201801;2519;7092;1969;6062;199;722;1191;3564;1390;4286
240020;201801;10846;32494;9523;29981;1149;3954;5848;18319;6997;22273
240030;201801;2568;6971;2462;6825;120;388;2162;5933;2282;6321
240040;201801;860;2452;714;2164;16;82;515;1491;531;1573
240050;201801;3340;8970;2763;7949;65;216;2152;6078;2217;6294
240060;201801;1379;3854;1193;3503;42;148;941;2692;983;2840
240070;201801;2248;6782;2073;6423;238;759;1489;4555;1727;5314
240080;201801;2825;7671;2401;6993;102;370;1815;5213;1917;5583
240090;201801;2258;5848;1853;5148;34;119;1475;4022;1509;4141
240100;201801;8569;22975;7153;20306;475;1472;5239;14469;5714;15941
240110;201801;4581;13791;3989;12691;386;1388;2556;8017;2942;9405
240120;201801;2543;8727;2401;8429;266;1067;1585;5490;1851;6557
240130;201801;3006;7205;2614;6604;86;279;2274;5630;2360;5909
240140;201801;2149;6422;1815;5776;208;758;1152;3602;1360;4360
240145;201801;6070;18027;5208;16534;831;2790;3170;10203;4001;12993
240150;201801;877;2703;775;2489;55;220;586;1819;641;2039
240160;201801;1384;4298;1201;3962;82;316;837;2786;919;3102
240165;201801;857;2557;741;2318;95;278;504;1592;599;1870
240170;201801;2281;6661;1951;6059;258;905;1199;3597;1457;4502
240180;201801;2742;8445;2375;7689;430;1410;1343;4431;1773;5841
240185;201801;1285;4259;1173;4072;67;294;953;3282;1020;3576
240190;201801;961;2987;848;2793;24;115;693;2250;717;2365
240200;201801;11397;30484;9543;27472;1597;4718;4434;12944;6031;17662
240210;201801;2800;7604;2529;7152;63;258;2116;5807;2179;6065
240220;201801;7299;23653;6622;22634;602;2539;4753;16181;5355;18720
240230;201801;5783;15061;4797;13436;272;754;3759;10526;4031;11280
240240;201801;1773;5371;1074;3598;167;573;226;707;393;1280
240250;201801;2685;7671;2487;7394;180;484;1988;5958;2168;6442
240260;201801;11959;38696;11130;37276;1525;5305;7153;24401;8678;29706
240270;201801;2286;6953;2090;6649;124;372;1683;5437;1807;5809
240280;201801;1593;4273;1391;3986;45;151;1154;3252;1199;3403
240290;201801;1186;3591;1007;3215;43;207;674;1990;717;2197
240300;201801;2294;6075;1670;4852;119;385;954;2695;1073;3080
240310;201801;9267;25389;7877;23064;991;3033;4332;12669;5323;15702
240320;201801;1961;5527;1492;4589;33;156;1119;3272;1152;3428
240325;201801;29542;83561;23860;73770;6663;21660;6324;20714;12987;42374
240330;201801;1464;4321;1225;3827;57;225;832;2497;889;2722
240340;201801;1981;4888;1608;4314;86;220;1233;3247;1319;3467
240350;201801;2039;5513;1874;5318;40;147;1655;4694;1695;4841
240360;201801;6915;20864;6185;19708;1366;4278;3263;10964;4629;15242
240370;201801;2025;5531;1593;4682;133;396;1012;2941;1145;3337
240375;201801;864;2274;757;2070;37;142;569;1477;606;1619
240380;201801;2340;6783;1714;5371;158;508;960;2958;1118;3466
240390;201801;923;2459;698;1994;8;20;485;1304;493;1324
240400;201801;1310;3465;1024;2922;33;120;708;1927;741;2047
240410;201801;508;1612;451;1488;56;222;278;891;334;1113
240420;201801;4582;17180;4194;16286;655;3103;2227;8448;2882;11551
240430;201801;3272;9056;2870;8279;207;726;2123;5892;2330;6618
240440;201801;2542;6074;2164;5558;231;617;1523;3861;1754;4478
240450;201801;3934;11359;3246;10058;374;1271;1891;5714;2265;6985
240460;201801;2985;8798;2778;8501;256;882;2182;6637;2438;7519
240470;201801;3616;11125;2833;9487;365;1238;1609;5404;1974;6642
240480;201801;545;1489;399;1204;37;115;192;571;229;686
240485;201801;2114;6328;1785;5668;180;574;1172;3766;1352;4340
240490;201801;1741;4333;1427;3806;33;73;1202;3207;1235;3280
240500;201801;2231;6075;1949;5682;70;246;1622;4699;1692;4945
240510;201801;1644;4609;1512;4416;120;373;1227;3517;1347;3890
240520;201801;1282;3442;1090;3165;43;175;917;2588;960;2763
240530;201801;1896;6041;1754;5800;139;522;1326;4324;1465;4846
240540;201801;2032;5434;1828;5131;61;209;1584;4385;1645;4594
240550;201801;725;2024;627;1854;38;119;468;1371;506;1490
240560;201801;3336;9094;2905;8520;305;780;2138;6393;2443;7173
240570;201801;2943;7962;2075;6008;275;855;964;2537;1239;3392
240580;201801;7577;22835;6986;21812;542;1870;5535;17183;6077;19053
240590;201801;714;1952;626;1796;22;84;474;1331;496;1415
240600;201801;1682;4714;1257;3827;98;338;774;2275;872;2613
240610;201801;4464;12573;3807;11362;245;811;2653;7781;2898;8592
240615;201801;1036;2977;823;2532;88;319;537;1570;625;1889
240620;201801;1830;5309;1572;4858;120;358;1238;3801;1358;4159
240630;201801;2038;6049;1848;5725;152;387;1259;4015;1411;4402
240640;201801;915;2533;740;2249;56;219;509;1492;565;1711
240650;201801;3917;11222;3505;10557;176;559;2763;8276;2939;8835
240660;201801;2550;7423;2386;7190;103;364;2051;6084;2154;6448
240670;201801;2457;7230;2049;6371;184;655;1283;3850;1467;4505
240680;201801;1556;4388;1247;3841;63;229;890;2684;953;2913
240690;201801;914;2402;740;2099;23;80;589;1619;612;1699
240700;201801;2453;7197;2037;6432;68;285;1588;4895;1656;5180
240710;201801;15693;43045;13812;39696;2677;7490;7399;21791;10076;29281
240720;201801;5158;13894;4537;12890;821;2423;2615;7299;3436;9722
240725;201801;1048;3136;818;2616;42;143;523;1632;565;1775
240730;201801;2115;6143;1801;5523;118;384;1347;4080;1465;4464
240740;201801;1849;5143;1588;4657;71;299;1163;3231;1234;3530
240750;201801;2045;7433;1865;7068;355;1465;975;3722;1330;5187
240760;201801;1413;3628;1027;3025;61;158;772;2306;833;2464
240770;201801;3058;8685;2712;8200;127;490;2258;6693;2385;7183
240780;201801;5441;15023;4474;13462;556;1693;2719;8344;3275;10037
240790;201801;869;2552;721;2262;23;89;549;1723;572;1812
240800;201801;35974;98246;30557;89493;5387;16425;14108;41638;19495;58063
240810;201801;80289;225993;72363;212142;17075;49902;34362;102847;51437;152749
240820;201801;5226;16705;4674;15769;962;3318;2419;8494;3381;11812
240830;201801;8683;25876;8012;24856;343;1456;6588;20092;6931;21548
240840;201801;1132;3013;932;2660;85;251;632;1751;717;2002
240850;201801;1262;3645;933;2905;62;197;517;1592;579;1789
240860;201801;1242;3463;977;2965;31;138;735;2120;766;2258
240870;201801;1163;3022;904;2577;66;201;611;1692;677;1893
240880;201801;1241;4037;1168;3895;90;336;925;3061;1015;3397
240890;201801;4764;13244;3763;11308;664;2093;1728;5125;2392;7218
240895;201801;2612;8821;2422;8504;236;885;1827;6469;2063;7354
240910;201801;3068;8818;2659;8009;74;273;2160;6424;2234;6697
240920;201801;792;2458;680;2231;77;277;369;1198;446;1475
240930;201801;3500;8628;3010;8030;95;204;2430;6605;2525;6809
240933;201801;1705;4344;1455;3942;50;188;1189;3135;1239;3323
240940;201801;6272;15996;5017;13904;387;1123;3533;9554;3920;10677
240950;201801;946;2983;847;2785;41;178;628;2014;669;2192
240960;201801;792;2404;691;2203;46;156;496;1553;542;1709
240970;201801;1841;4998;1522;4421;58;212;1226;3437;1284;3649
240980;201801;2865;9216;2621;8765;283;1078;1863;6138;2146;7216
240990;201801;2536;7480;2340;7082;317;1023;1602;4774;1919;5797
241000;201801;960;2621;809;2345;37;126;564;1609;601;1735
241010;201801;2667;8877;2515;8587;265;1102;1800;5934;2065;7036
241020;201801;2048;5584;1543;4551;189;510;899;2644;1088;3154
241025;201801;1698;5036;1413;4495;86;295;951;3027;1037;3322
241030;201801;2412;7822;2049;7048;202;752;1354;4631;1556;5383
241040;201801;2273;7382;2035;6973;129;547;1567;5354;1696;5901
241050;201801;1271;3681;1070;3308;57;200;773;2341;830;2541
241060;201801;767;2192;679;2021;56;160;461;1367;517;1527
241070;201801;642;1837;569;1711;37;139;436;1236;473;1375
241080;201801;1136;3272;881;2765;18;84;643;1979;661;2063
241090;201801;1909;5774;1639;5298;67;302;1262;4030;1329;4332
241100;201801;1100;3239;922;2836;49;173;633;1890;682;2063
241105;201801;1104;3335;934;3032;252;810;362;1214;614;2024
241110;201801;861;2571;682;2174;35;133;441;1351;476;1484
241120;201801;7154;21313;6311;19803;1374;4082;3258;10893;4632;14975
241140;201801;3293;8709;2768;7696;174;477;2029;5505;2203;5982
241142;201801;770;2156;575;1766;44;155;337;999;381;1154
241150;201801;5522;15587;4927;14587;245;929;3812;11046;4057;11975
241160;201801;1549;4661;1359;4356;154;434;958;3152;1112;3586
241170;201801;1197;3252;1074;3042;55;176;872;2393;927;2569
241180;201801;968;2626;717;2118;70;207;392;1142;462;1349
241190;201801;1140;3066;918;2616;36;140;661;1796;697;1936
241200;201801;17947;50205;15728;46823;3508;10751;7443;22697;10951;33448
241210;201801;1442;3972;1118;3321;106;332;671;1961;777;2293
241220;201801;8106;25742;7300;24297;2181;7285;2997;10459;5178;17744
241230;201801;2983;8304;2696;7846;110;422;2236;6324;2346;6746
241240;201801;1173;3422;696;2274;48;188;345;1125;393;1313
241250;201801;5878;17619;4817;15581;206;1023;3538;10994;3744;12017
241255;201801;1856;6505;1653;6045;201;875;1033;3709;1234;4584
241260;201801;5028;13382;3965;11654;119;526;2959;8464;3078;8990
241270;201801;1805;5400;1548;4897;115;452;1114;3458;1229;3910
241280;201801;1883;5191;1691;4853;103;312;1356;3841;1459;4153
241290;201801;3163;8252;2504;7154;101;366;1937;5404;2038;5770
241300;201801;1472;4109;1230;3674;40;127;817;2394;857;2521
241310;201801;1825;5012;1633;4704;48;186;1379;3909;1427;4095
241320;201801;895;3094;804;2879;93;382;531;1877;624;2259
241330;201801;1390;4140;1288;4003;50;210;1117;3431;1167;3641
241335;201801;2898;8419;2610;7908;112;396;2163;6452;2275;6848
241340;201801;1756;5262;1421;4507;296;964;611;1907;907;2871
241350;201801;1867;5712;1686;5369;97;366;1272;3953;1369;4319
241355;201801;1347;3734;1093;3269;37;146;835;2470;872;2616
241360;201801;2086;5468;1673;4674;68;211;1225;3337;1293;3548
241370;201801;1356;3893;1071;3327;79;283;701;2076;780;2359
241380;201801;649;1805;519;1547;64;201;316;915;380;1116
241390;201801;2621;8315;2419;7986;185;687;1869;6148;2054;6835
241400;201801;3617;10253;3240;9714;237;779;2541;7585;2778;8364
241410;201801;2368;7145;2046;6575;419;1407;1089;3497;1508;4904
241415;201801;1622;4826;1388;4400;117;408;1030;3209;1147;3617
241420;201801;2090;7177;1856;6750;542;2083;605;2246;1147;4329
241430;201801;528;1520;401;1252;36;126;239;718;275;844
241440;201801;6826;22874;6177;21705;512;2121;4643;16174;5155;18295
241445;201801;954;2700;909;2646;30;65;826;2467;856;2532
241450;201801;2872;7422;2546;6949;277;719;1860;5106;2137;5825
241460;201801;3480;9849;2986;8786;206;711;2119;6043;2325;6754
241470;201801;1371;3727;1115;3362;57;209;893;2668;950;2877
241475;201801;1240;3647;991;3160;35;193;705;2128;740;2321
241480;201801;2628;8557;2344;8020;882;3020;630;2495;1512;5515
241490;201801;688;1746;560;1546;26;84;380;1004;406;1088
241500;201801;762;2342;652;2207;20;87;556;1871;576;1958
250010;201801;2724;8319;2268;7332;81;355;1664;5240;1745;5595
250020;201801;1567;4364;1165;3581;57;165;812;2446;869;2611
250030;201801;6784;19130;6153;18206;359;1186;4952;14404;5311;15590
250040;201801;3928;12805;3571;12085;323;1223;2509;8374;2832;9597
250050;201801;3320;9884;3063;9493;289;995;2305;7023;2594;8018
250053;201801;1220;3591;1112;3429;97;322;804;2483;901;2805
250057;201801;658;2504;635;2476;3;8;608;2409;611;2417
250060;201801;5166;14574;4742;13999;433;1307;3691;10970;4124;12277
250070;201801;3842;11476;3516;10878;61;309;2713;8096;2774;8405
250073;201801;772;2194;653;1997;16;61;498;1472;514;1533
250077;201801;2198;6152;1682;5265;101;331;1200;3725;1301;4056
250080;201801;4310;11834;3959;11325;127;463;3341;9398;3468;9861
250090;201801;2683;7229;2471;6898;127;317;2050;5699;2177;6016
250100;201801;3803;11988;3536;11504;179;738;2873;9096;3052;9834
250110;201801;4805;13971;4469;13480;426;1518;3479;10222;3905;11740
250115;201801;504;1530;453;1449;17;92;337;1033;354;1125
250120;201801;1687;5250;1483;4890;59;267;1174;3849;1233;4116
250130;201801;5322;15808;4660;14704;124;664;3736;11537;3860;12201
250135;201801;1075;3173;991;3037;23;93;834;2536;857;2629
250140;201801;2080;6581;2009;6467;97;437;1682;5344;1779;5781
250150;201801;4817;15902;4424;15160;190;924;3423;11457;3613;12381
250153;201801;1471;3833;1224;3486;25;102;1000;2799;1025;2901
250157;201801;1781;5576;1616;5228;190;589;1131;3690;1321;4279
250160;201801;3715;9892;3092;9031;52;174;2811;8207;2863;8381
250170;201801;1650;4599;1479;4339;64;238;1216;3528;1280;3766
250180;201801;16437;45228;14962;43163;1039;3502;11251;31711;12290;35213
250190;201801;4016;11390;3577;10682;512;1467;2323;6954;2835;8421
250200;201801;1862;5404;1569;4940;54;215;1284;4013;1338;4228
250205;201801;783;2681;738;2591;21;119;592;2049;613;2168
250210;201801;1492;4733;1379;4541;55;268;1082;3483;1137;3751
250215;201801;1384;4145;1217;3902;69;259;800;2556;869;2815
250220;201801;710;2032;572;1824;25;90;429;1359;454;1449
250230;201801;1640;3933;1248;3308;35;122;986;2515;1021;2637
250240;201801;2249;7152;2055;6807;72;281;1685;5529;1757;5810
250250;201801;4434;12899;3959;12234;125;428;3284;10114;3409;10542
250260;201801;1670;4817;1430;4404;43;153;1141;3505;1184;3658
250270;201801;1261;3817;1107;3625;79;257;827;2833;906;3090
250280;201801;3347;9781;2925;9100;155;544;2274;7028;2429;7572
250290;201801;1716;4650;1468;4303;18;47;1232;3615;1250;3662
250300;201801;5121;14832;4843;14489;269;1137;4094;11897;4363;13034
250310;201801;1092;3231;957;2992;33;134;745;2254;778;2388
250320;201801;8957;24653;8175;23635;643;2051;6501;18593;7144;20644
250330;201801;2380;7126;2027;6602;131;457;1572;5070;1703;5527
250340;201801;1089;3028;950;2816;14;53;803;2342;817;2395
250350;201801;4142;11389;3745;10869;152;395;3208;9425;3360;9820
250355;201801;1941;6053;1788;5862;28;152;1625;5300;1653;5452
250360;201801;1785;5154;1660;4950;40;132;1378;4095;1418;4227
250370;201801;11685;32620;10143;30609;507;1781;8392;25095;8899;26876
250375;201801;1046;3015;933;2857;17;64;831;2562;848;2626
250380;201801;1618;4444;1515;4309;53;200;1250;3422;1303;3622
250390;201801;1795;4777;1494;4275;185;505;999;2887;1184;3392
250400;201801;71302;183165;52990;154469;13852;42356;17873;53778;31725;96134
250403;201801;1600;4970;1452;4780;151;637;1017;3251;1168;3888
250407;201801;1215;3234;1036;2963;76;171;757;2171;833;2342
250410;201801;547;1665;482;1542;12;62;395;1218;407;1280
250415;201801;1907;5566;1695;5195;64;218;1338;4101;1402;4319
250420;201801;1212;3497;1105;3346;20;82;1006;3043;1026;3125
250430;201801;6187;16081;5470;15037;202;646;4492;12088;4694;12734
250435;201801;1368;4033;1200;3747;43;173;917;2817;960;2990
250440;201801;4440;12382;3962;11725;103;384;3382;9897;3485;10281
250450;201801;1853;5101;1581;4728;43;157;1309;3865;1352;4022
250460;201801;6478;18779;6060;18254;311;962;5260;15972;5571;16934
250470;201801;1507;3998;1247;3624;65;235;938;2640;1003;2875
250480;201801;3684;10823;3356;10397;49;217;3013;9368;3062;9585
250485;201801;693;1630;511;1371;29;81;397;1026;426;1107
250490;201801;4264;11842;3932;11423;275;914;3203;9243;3478;10157
250500;201801;1887;5435;1689;5107;94;306;1352;4077;1446;4383
250510;201801;5108;13598;4460;12724;79;254;3994;11409;4073;11663
250520;201801;1783;5112;1575;4804;178;600;1032;3088;1210;3688
250523;201801;1948;5273;1800;5088;80;345;1546;4235;1626;4580
250527;201801;1602;4402;1492;4263;36;114;1368;3891;1404;4005
250530;201801;595;1775;523;1673;18;73;464;1474;482;1547
250535;201801;1347;4098;1235;3889;41;201;970;2974;1011;3175
250540;201801;2555;6598;2214;6204;51;148;1961;5483;2012;5631
250550;201801;844;2814;765;2680;30;150;620;2117;650;2267
250560;201801;1658;4911;1535;4726;46;185;1269;3800;1315;3985
250570;201801;2516;7778;2213;7218;90;394;1758;5583;1848;5977
250580;201801;1058;2776;945;2613;49;186;780;2105;829;2291
250590;201801;811;2436;729;2306;22;108;597;1829;619;1937
250600;201801;7360;20594;6714;19618;438;1164;5504;16205;5942;17369
250610;201801;2997;8613;2758;8261;159;557;2248;6663;2407;7220
250620;201801;685;1955;601;1789;33;129;453;1315;486;1444
250625;201801;2527;7565;2346;7288;51;222;2031;6180;2082;6402
250630;201801;9497;28085;8254;25713;1277;4136;4900;14968;6177;19104
250640;201801;3395;10078;3168;9765;120;536;2655;7980;2775;8516
250650;201801;863;2244;732;2069;37;126;587;1597;624;1723
250660;201801;1681;4318;1510;4095;36;99;1362;3671;1398;3770
250670;201801;2304;7465;2157;7216;58;305;1837;5992;1895;6297
250680;201801;5061;13066;4708;12661;146;502;4267;11338;4413;11840
250690;201801;6407;15538;5862;14852;190;467;5286;13303;5476;13770
250700;201801;4348;12588;3900;11895;405;1267;2847;8618;3252;9885
250710;201801;4418;13160;3849;12393;341;1223;2753;8898;3094;10121
250720;201801;2702;7408;2474;7054;48;216;2216;6245;2264;6461
250730;201801;3764;10543;3382;10025;188;672;2783;8039;2971;8711
250740;201801;1898;5121;1594;4680;142;450;1229;3530;1371;3980
250750;201801;96172;259691;85912;244794;9235;28505;57930;162185;67165;190690
250760;201801;2318;6234;2030;5785;130;392;1587;4428;1717;4820
250770;201801;3786;12237;3489;11844;298;1193;2542;8540;2840;9733
250780;201801;1705;4845;1451;4357;126;426;1003;2941;1129;3367
250790;201801;2319;7245;2114;6919;327;1117;1312;4334;1639;5451
250800;201801;2474;6800;2149;6272;90;224;1755;5113;1845;5337
250810;201801;1244;3518;1049;3231;37;145;852;2600;889;2745
250820;201801;1789;5622;1732;5552;77;319;1545;4902;1622;5221
250830;201801;5274;16512;4769;15484;365;1427;3357;10646;3722;12073
250840;201801;863;2751;734;2483;20;91;508;1729;528;1820
250850;201801;1909;5731;1710;5407;49;267;1376;4220;1425;4487
250855;201801;1044;3058;901;2808;34;154;693;2100;727;2254
250860;201801;3175;9920;2653;8987;477;1724;1327;4556;1804;6280
250870;201801;1071;3000;919;2713;33;117;740;2163;773;2280
250880;201801;1520;4075;1246;3668;154;452;815;2449;969;2901
250890;201801;9338;26705;8737;25860;683;2588;6900;19768;7583;22356
250900;201801;2694;8275;2353;7620;100;368;1892;6018;1992;6386
250905;201801;2108;6350;2005;6213;85;327;1752;5381;1837;5708
250910;201801;5074;14027;4597;13387;143;532;3928;11384;4071;11916
250915;201801;1794;4611;1395;4194;25;52;1292;3965;1317;4017
250920;201801;3179;8802;2944;8425;334;901;2127;6052;2461;6953
250930;201801;2043;5854;1891;5632;93;355;1554;4526;1647;4881
250933;201801;1106;3520;989;3283;44;213;707;2262;751;2475
250937;201801;690;1993;577;1785;34;123;426;1296;460;1419
250939;201801;1621;4559;1431;4267;42;176;1169;3397;1211;3573
250940;201801;3723;10667;3456;10245;52;205;3096;9185;3148;9390
250950;201801;1458;4090;1224;3783;33;135;1058;3267;1091;3402
250960;201801;1050;3258;969;3126;32;135;788;2492;820;2627
250970;201801;8387;22625;7201;20724;453;1494;5357;15158;5810;16652
250980;201801;2510;7127;2289;6717;62;263;1851;5264;1913;5527
250990;201801;1917;6245;1682;5740;101;459;1232;4086;1333;4545
251000;201801;2091;5978;1743;5418;44;200;1446;4437;1490;4637
251010;201801;2620;7551;2359;7139;39;145;2110;6375;2149;6520
251020;201801;1676;4567;1543;4403;48;153;1415;4021;1463;4174
251030;201801;1004;2815;882;2571;46;154;616;1742;662;1896
251040;201801;1767;5329;1545;4943;58;283;1242;3859;1300;4142
251050;201801;1091;3063;895;2684;89;292;629;1809;718;2101
251060;201801;1022;2275;752;1922;17;78;605;1499;622;1577
251065;201801;454;1294;374;1186;17;72;257;760;274;832
251070;201801;724;2104;646;2003;16;65;550;1685;566;1750
251080;201801;19124;51043;16049;46470;2623;7937;9177;26889;11800;34826
251090;201801;2839;8436;2431;7657;82;314;1886;5852;1968;6166
251100;201801;871;2723;772;2549;36;172;542;1699;578;1871
251110;201801;1746;4938;1517;4496;59;176;1151;3368;1210;3544
251120;201801;6543;20514;5873;19535;360;1476;4476;14737;4836;16213
251130;201801;3683;9092;3340;8712;267;721;2932;7636;3199;8357
251140;201801;4307;12522;3952;12007;118;477;3258;9819;3376;10296
251150;201801;2665;8064;2438;7714;145;615;1920;5902;2065;6517
251160;201801;1936;6123;1792;5906;88;294;1554;5154;1642;5448
251170;201801;1489;4313;1378;4184;40;147;1248;3795;1288;3942
251180;201801;2495;7274;2187;6808;226;771;1436;4431;1662;5202
251190;201801;4409;11880;4166;11587;80;300;3774;10316;3854;10616
251200;201801;4011;12638;3740;12303;86;348;3351;11082;3437;11430
251203;201801;944;3137;902;3048;33;154;686;2264;719;2418
251207;201801;1022;3058;838;2716;22;122;586;1836;608;1958
251210;201801;7537;20397;6273;18782;337;1010;4979;15045;5316;16055
251220;201801;1164;2972;930;2651;45;115;732;2116;777;2231
251230;201801;4623;12889;4101;12171;169;604;3450;10032;3619;10636
251240;201801;3431;9876;2962;9200;207;683;2207;6722;2414;7405
251250;201801;10019;28347;9079;26959;849;2748;6503;18795;7352;21543
251260;201801;457;1427;411;1346;13;57;314;1011;327;1068
251270;201801;4130;13164;3727;12646;122;555;3180;10803;3302;11358
251272;201801;1287;3592;1201;3470;38;144;1066;3054;1104;3198
251274;201801;896;2645;742;2368;50;214;503;1516;553;1730
251275;201801;1236;3542;1104;3318;46;188;832;2378;878;2566
251276;201801;1159;3344;1081;3236;53;234;892;2606;945;2840
251278;201801;595;1791;523;1652;49;181;353;1105;402;1286
251280;201801;2240;6438;2048;6121;57;263;1650;4761;1707;5024
251290;201801;5521;14638;5211;14240;341;1232;4319;11411;4660;12643
251300;201801;754;2412;708;2336;14;64;592;1933;606;1997
251310;201801;2786;8195;2548;7838;96;450;2048;6119;2144;6569
251315;201801;1641;5340;1525;5142;93;332;1185;3955;1278;4287
251320;201801;1725;4641;1231;3813;54;195;865;2655;919;2850
251330;201801;1860;4710;1532;4302;41;160;1383;3852;1424;4012
251335;201801;1088;3506;992;3354;54;231;774;2549;828;2780
251340;201801;3468;9413;2916;8679;128;437;2226;6529;2354;6966
251350;201801;1105;3406;1019;3262;37;162;830;2576;867;2738
251360;201801;1774;5345;1468;4926;26;115;1268;4283;1294;4398
251365;201801;717;2101;583;1810;12;53;451;1388;463;1441
251370;201801;22663;66752;21452;65093;2097;6931;15944;47970;18041;54901
251380;201801;1283;3824;1105;3530;24;115;930;2873;954;2988
251385;201801;716;1882;565;1619;22;68;409;1116;431;1184
251390;201801;5929;18869;5196;17500;1048;3709;2671;8896;3719;12605
251392;201801;1001;2836;862;2606;41;167;639;1871;680;2038
251394;201801;629;2005;543;1855;28;127;410;1371;438;1498
251396;201801;750;2086;643;1911;39;103;439;1286;478;1389
251398;201801;917;2501;702;2126;26;108;500;1454;526;1562
251400;201801;1119;3067;929;2799;44;158;678;1973;722;2131
251410;201801;1606;3954;1318;3524;27;101;1096;2847;1123;2948
251420;201801;1874;5203;1573;4848;64;270;1225;3681;1289;3951
251430;201801;1527;4989;1379;4742;42;220;1188;4019;1230;4239
251440;201801;1129;3319;919;2910;26;99;728;2295;754;2394
251445;201801;1530;4519;1436;4394;79;313;1159;3452;1238;3765
251450;201801;4393;13539;4004;12994;89;402;3349;10767;3438;11169
251455;201801;1005;3123;894;2908;54;235;659;2095;713;2330
251460;201801;842;2522;757;2389;29;114;626;1995;655;2109
251465;201801;435;1351;365;1191;15;69;275;883;290;952
251470;201801;1132;3210;882;2681;81;255;546;1619;627;1874
251480;201801;920;2529;792;2318;27;116;590;1662;617;1778
251490;201801;1821;5152;1531;4737;119;400;1028;3135;1147;3535
251500;201801;1759;5399;1662;5224;83;334;1398;4318;1481;4652
251510;201801;2472;7962;2205;7405;216;830;1387;4558;1603;5388
251520;201801;946;2568;734;2144;84;224;459;1325;543;1549
251530;201801;12783;33282;11299;31333;189;876;9960;27110;10149;27986
251540;201801;2789;8588;2553;8146;115;444;2026;6354;2141;6798
251550;201801;3547;8934;2872;8066;76;256;2389;6677;2465;6933
251560;201801;606;1886;548;1794;93;335;327;1018;420;1353
251570;201801;938;2739;768;2397;23;94;561;1691;584;1785
251580;201801;1855;4839;1645;4547;153;419;1281;3500;1434;3919
251590;201801;1544;4260;1372;4044;56;182;1110;3233;1166;3415
251593;201801;973;2914;891;2791;112;375;544;1655;656;2030
251597;201801;1956;5824;1868;5708;30;117;1702;5155;1732;5272
251600;201801;6419;18118;5817;17199;212;706;4843;14142;5055;14848
251610;201801;3305;9578;2879;8796;321;926;1971;6085;2292;7011
251615;201801;1141;3093;920;2718;25;117;681;1929;706;2046
251620;201801;16767;41587;13949;38249;288;728;11669;33470;11957;34198
251630;201801;4592;11387;3769;10242;219;616;2853;7686;3072;8302
251640;201801;2074;6156;1894;5815;68;294;1599;4799;1667;5093
251650;201801;4039;11093;3608;10534;166;578;3063;8868;3229;9446
251660;201801;3441;10670;3060;9989;92;454;2536;8088;2628;8542
251670;201801;4342;12503;3840;11835;39;183;3533;10910;3572;11093
251675;201801;692;2090;634;2014;98;340;403;1257;501;1597
251680;201801;2665;7483;2186;6773;59;222;1766;5438;1825;5660
251690;201801;3291;9523;2883;8743;84;290;2104;6243;2188;6533
251700;201801;1874;5930;1749;5767;80;380;1460;4703;1540;5083
251710;201801;830;2199;562;1633;56;200;288;804;344;1004
251720;201801;1384;4075;1156;3645;35;151;878;2684;913;2835
251740;201801;689;1925;545;1672;40;138;369;1089;409;1227
260005;201801;26725;61075;22037;54749;2760;6844;14740;36334;17500;43178
260010;201801;9734;25981;8107;23640;591;1762;5060;15064;5651;16826
260020;201801;6556;16489;5521;14978;147;604;4595;12252;4742;12856
260030;201801;6232;17086;5386;15774;267;905;4217;12321;4484;13226
260040;201801;8350;22436;6916;20420;684;1946;4790;14434;5474;16380
260050;201801;11688;34212;10636;32957;433;1433;9139;28781;9572;30214
260060;201801;3862;10477;3341;9601;259;713;2508;7249;2767;7962
260070;201801;9836;26955;8722;25230;702;2330;6362;18079;7064;20409
260080;201801;6432;15585;5609;14382;199;600;4581;11459;4780;12059
260090;201801;5167;13549;4699;12926;581;1558;3430;9553;4011;11111
260100;201801;3224;8737;2744;8062;127;463;2236;6524;2363;6987
260105;201801;5186;14001;4664;13273;127;530;3937;10933;4064;11463
260110;201801;22233;59594;20132;56906;1032;3143;17182;48321;18214;51464
260120;201801;13528;38282;11682;35292;1851;5696;6875;21334;8726;27030
260130;201801;3080;8392;2815;7969;269;803;2068;5763;2337;6566
260140;201801;12885;30827;10983;28448;596;1688;9012;23360;9608;25048
260150;201801;3365;8556;2897;7979;163;533;2385;6485;2548;7018
260160;201801;5871;17135;5037;16027;136;617;4304;13781;4440;14398
260170;201801;17263;45947;15576;43564;1396;3778;11896;33446;13292;37224
260180;201801;3288;9505;2954;9019;156;555;2478;7482;2634;8037
260190;201801;16914;37072;14816;34586;249;743;12945;29691;13194;30434
260200;201801;11205;27663;9860;25984;376;1090;8665;22711;9041;23801
260210;201801;11929;34784;10292;32136;394;1549;8286;25785;8680;27334
260220;201801;9734;25596;9208;24932;260;895;8300;22214;8560;23109
260230;201801;9987;26752;8819;25115;370;1258;7042;19866;7412;21124
260240;201801;2838;8401;2468;7828;209;704;1860;5898;2069;6602
260250;201801;2179;5994;1897;5585;79;277;1530;4403;1609;4680
260260;201801;12285;33969;10842;31777;555;1990;8455;24441;9010;26431
260270;201801;3587;10083;3268;9622;195;830;2519;7167;2714;7997
260280;201801;12985;40493;11863;38877;556;2095;10083;32976;10639;35071
260290;201801;35306;98356;31734;92710;4453;13577;19976;57805;24429;71382
260300;201801;9064;26245;7995;24683;284;1247;6443;19803;6727;21050
260310;201801;4437;12545;3982;11894;554;1542;2730;8419;3284;9961
260320;201801;7397;22400;6654;21117;288;1025;5415;17065;5703;18090
260330;201801;2527;8016;2308;7571;95;368;1811;5808;1906;6176
260340;201801;1965;5451;1739;5132;35;139;1516;4425;1551;4564
260345;201801;23294;66607;20593;62291;4455;14514;8999;26363;13454;40877
260350;201801;4965;12860;4514;12252;141;489;3919;10516;4060;11005
260360;201801;2484;6802;2243;6369;85;369;1545;4295;1630;4664
260370;201801;5467;16374;4779;15163;259;1040;3608;11298;3867;12338
260380;201801;4859;15211;4273;14267;237;924;3141;10384;3378;11308
260390;201801;4185;13089;3625;11954;265;969;2481;8054;2746;9023
260392;201801;3443;11099;3130;10683;167;865;2578;8653;2745;9518
260400;201801;14807;38495;13238;36310;1112;3409;9812;26386;10924;29795
260410;201801;61115;164555;50310;148598;11605;36353;20722;62885;32327;99238
260415;201801;3775;11192;3281;10250;142;644;2355;7072;2497;7716
260420;201801;12611;27840;10935;25956;177;569;9932;23320;10109;23889
260430;201801;2873;9017;2484;8271;159;621;1722;5669;1881;6290
260440;201801;3455;9795;3025;9022;199;742;2276;6595;2475;7337
260450;201801;5328;14372;4927;13873;185;549;4261;12022;4446;12571
260460;201801;5363;16842;4774;15706;641;2377;2775;8903;3416;11280
260470;201801;4816;13263;4154;12506;107;278;3699;11430;3806;11708
260480;201801;4204;11358;3550;10426;366;1210;2365;7063;2731;8273
260490;201801;5076;12702;4449;11642;111;412;3831;9741;3942;10153
260500;201801;6044;16275;5124;14907;576;1619;3386;10003;3962;11622
260510;201801;9358;23385;8122;21735;238;780;7183;19029;7421;19809
260515;201801;4519;13120;3457;11041;174;628;2247;7075;2421;7703
260520;201801;17315;42254;15662;40070;1159;3042;12474;31682;13633;34724
260530;201801;9382;28184;8193;26307;249;1129;6901;21959;7150;23088
260540;201801;6224;14781;5578;14045;533;1097;4644;12009;5177;13106
260545;201801;46;140;24;94;6;22;4;17;10;39
260550;201801;2851;8676;2378;7712;212;836;1429;4555;1641;5391
260560;201801;6171;16008;5351;14855;140;587;4547;12413;4687;13000
260570;201801;7095;21192;6408;20190;596;1943;4918;15535;5514;17478
260580;201801;3956;10359;3550;9760;51;213;3182;8638;3233;8851
260590;201801;6621;16012;5765;15035;257;706;4930;12907;5187;13613
260600;201801;29605;81364;25022;74258;1442;5098;18392;53855;19834;58953
260610;201801;6487;18477;6022;17807;515;1634;4489;13180;5004;14814
260620;201801;14814;43145;13865;41635;2023;6670;8898;26181;10921;32851
260630;201801;2349;6449;1968;5868;47;212;1633;4819;1680;5031
260640;201801;18428;46609;16384;44116;1261;3775;12420;33122;13681;36897
260650;201801;5457;16133;4677;14905;200;851;3845;12150;4045;13001
260660;201801;7495;20169;6543;18961;189;789;5565;15855;5754;16644
260670;201801;2273;5945;1877;5368;101;292;1348;3835;1449;4127
260680;201801;23318;61239;20011;56133;2691;7725;11438;31896;14129;39621
260690;201801;3604;9566;3005;8625;120;386;2411;6875;2531;7261
260700;201801;5795;17254;5592;17022;23;40;5452;16774;5475;16814
260710;201801;1323;3621;1237;3506;64;208;903;2621;967;2829
260720;201801;19388;56396;17533;53498;3041;9406;10242;31264;13283;40670
260730;201801;7017;21683;6315;20676;405;1575;5096;16388;5501;17963
260740;201801;1310;3804;1156;3550;25;87;959;2950;984;3037
260750;201801;6996;19920;6003;18650;155;460;5377;16968;5532;17428
260760;201801;5255;13221;4633;12457;220;672;3776;10203;3996;10875
260765;201801;7534;24218;6797;23094;819;3356;4474;14824;5293;18180
260770;201801;3755;10025;3288;9247;108;357;2582;7204;2690;7561
260775;201801;5068;14264;4635;13631;304;1163;3451;9846;3755;11009
260780;201801;3663;11276;3324;10673;446;1594;2083;6536;2529;8130
260790;201801;112133;269116;97623;249232;17543;44915;56440;143705;73983;188620
260795;201801;3102;8641;2707;8040;159;527;2027;6050;2186;6577
260800;201801;5461;13125;4979;12465;113;389;4459;10820;4572;11209
260805;201801;3616;10770;3061;9818;224;839;2117;6720;2341;7559
260810;201801;6448;18126;5944;17180;548;1603;4385;12494;4933;14097
260820;201801;4201;10944;3710;10231;329;1146;2674;7133;3003;8279
260825;201801;2846;8887;2500;8286;132;550;1859;6090;1991;6640
260830;201801;4075;12432;3450;11242;478;1473;2260;7502;2738;8975
260840;201801;4169;11587;3671;10860;188;582;2991;8783;3179;9365
260845;201801;4041;11342;3754;10829;306;889;2763;7946;3069;8835
260850;201801;4936;14943;4300;13635;557;1865;2452;7642;3009;9507
260860;201801;3554;10370;3019;9369;122;478;2364;7187;2486;7665
260870;201801;4338;11014;3776;10301;132;485;3262;8730;3394;9215
260875;201801;6428;17443;5500;15976;772;2261;3487;10243;4259;12504
260880;201801;9857;28298;8753;26477;412;1306;7021;21347;7433;22653
260890;201801;13068;35974;11860;34186;926;3029;8556;24221;9482;27250
260900;201801;5495;16563;4722;15164;341;1341;3139;9874;3480;11215
260910;201801;3108;8966;2760;8389;126;444;2100;6336;2226;6780
260915;201801;4871;15059;4365;14438;62;336;3961;13120;4023;13456
260920;201801;3265;9438;2935;9007;124;441;2467;7660;2591;8101
260930;201801;3676;11978;3272;11274;222;866;2455;8445;2677;9311
260940;201801;14339;35956;12727;33563;1128;3233;9111;23591;10239;26824
260950;201801;6489;19128;5390;16980;744;2513;2717;8181;3461;10694
260960;201801;60666;152035;51163;138410;8176;23518;28418;75758;36594;99276
260970;201801;4988;14292;4509;13673;196;592;3546;10892;3742;11484
260980;201801;4199;12971;3849;12531;78;341;3467;11290;3545;11631
260990;201801;17355;50929;15245;48041;958;3405;11720;36856;12678;40261
261000;201801;15741;40430;13057;36592;1036;3241;8891;25078;9927;28319
261010;201801;2466;6673;2226;6365;77;186;1999;5763;2076;5949
261020;201801;6362;17951;5499;16358;426;1387;4101;11868;4527;13255
261030;201801;3997;11552;3475;10701;227;677;2700;8316;2927;8993
261040;201801;5112;15896;4285;14166;292;1111;3043;9857;3335;10968
261050;201801;7453;20945;6823;19876;682;1950;4618;13494;5300;15444
261060;201801;12771;34790;11502;32937;777;2447;8937;25330;9714;27777
261070;201801;54652;127117;46616;116121;4135;10258;33155;81979;37290;92237
261080;201801;5795;15776;5455;15293;228;643;4849;13652;5077;14295
261090;201801;16750;43676;15228;41638;558;1825;12920;35019;13478;36844
261100;201801;8006;24116;7044;22569;818;2713;4691;15279;5509;17992
261110;201801;59822;175212;51936;162588;12295;40292;23367;74719;35662;115011
261120;201801;3784;9787;3272;9162;73;230;2916;8205;2989;8435
261130;201801;7424;18165;6642;17232;163;469;5872;15159;6035;15628
261140;201801;3324;8453;2977;7955;257;740;2236;5919;2493;6659
261150;201801;5258;14582;4657;13656;162;599;3928;11421;4090;12020
261153;201801;1971;5895;1685;5429;86;348;1172;3738;1258;4086
261160;201801;202880;508013;176404;470793;44404;123261;71937;196052;116341;319313
261170;201801;5626;14763;5118;14027;282;783;4104;11174;4386;11957
261180;201801;9786;25964;8795;24626;676;2123;6229;17256;6905;19379
261190;201801;4902;14828;4476;14241;394;1543;3225;10009;3619;11552
261200;201801;3493;8329;3078;7810;253;686;2431;6098;2684;6784
261210;201801;1885;4773;1675;4474;70;214;1468;3906;1538;4120
261220;201801;13479;40127;11307;35854;1589;5436;6300;19835;7889;25271
261230;201801;4679;13757;3977;12878;95;401;3350;10963;3445;11364
261240;201801;4942;13462;4399;12605;342;953;3432;9857;3774;10810
261245;201801;3482;10396;2991;9531;127;587;2345;7222;2472;7809
261247;201801;2996;9142;2547;8319;158;609;1809;5862;1967;6471
261250;201801;19189;48097;16849;45272;2986;7736;10708;29965;13694;37701
261255;201801;4011;12202;3526;11306;189;827;2716;8443;2905;9270
261260;201801;12552;34577;10976;32610;407;1520;9245;27455;9652;28975
261270;201801;3862;10871;3470;10259;238;816;2667;7679;2905;8495
261280;201801;2562;7491;2312;7066;99;405;1847;5504;1946;5909
261290;201801;2941;8109;2570;7630;129;473;2030;6061;2159;6534
261300;201801;11204;33796;9704;31073;752;2895;6713;21019;7465;23914
261310;201801;7136;20769;6421;19684;1283;4012;3746;11463;5029;15475
261320;201801;5824;17210;5181;16081;130;526;4273;13050;4403;13576
261330;201801;5702;15240;5293;14700;198;786;4575;12430;4773;13216
261340;201801;4025;12519;3562;11834;241;1027;2614;8620;2855;9647
261350;201801;8167;25274;7592;24334;172;863;6242;19636;6414;20499
261360;201801;8263;20988;7137;19404;377;1105;5711;15218;6088;16323
261370;201801;19398;54577;17615;51883;3363;10167;9954;29512;13317;39679
261380;201801;3948;12902;3634;12264;542;2020;2249;7449;2791;9469
261390;201801;16112;47835;14183;44575;1631;5561;8755;27442;10386;33003
261400;201801;4648;15469;4098;14301;197;898;2995;10249;3192;11147
261410;201801;9175;24439;7871;22360;581;1704;6195;17542;6776;19246
261420;201801;7085;23057;6661;22499;1160;4418;4171;13986;5331;18404
261430;201801;3480;10262;2954;9445;131;443;2374;7612;2505;8055
261440;201801;1525;4689;1346;4348;47;226;957;3001;1004;3227
261450;201801;13793;38901;12908;37665;356;1334;10998;31925;11354;33259
261460;201801;6979;19999;6437;19222;268;899;5580;16582;5848;17481
261470;201801;4143;10895;3734;10352;61;288;3097;8608;3158;8896
261480;201801;4458;14521;3947;13656;225;950;3016;10204;3241;11154
261485;201801;5020;14793;4379;13744;446;1616;2934;9028;3380;10644
261500;201801;5537;15045;4872;14154;422;1186;3523;10514;3945;11700
261510;201801;1833;5747;1608;5343;91;363;1200;4005;1291;4368
261520;201801;2588;8035;2425;7728;97;377;1646;5370;1743;5747
261530;201801;10589;33440;9244;30801;1458;5489;4261;14000;5719;19489
261540;201801;7408;22521;6733;21454;1213;3912;3886;12679;5099;16591
261550;201801;3575;9711;3182;9103;246;800;2351;6620;2597;7420
261560;201801;7335;22909;6499;21736;474;1961;4861;16173;5335;18134
261570;201801;3436;9784;2904;8920;246;877;1940;5855;2186;6732
261580;201801;6508;17767;5896;16864;160;692;5224;14727;5384;15419
261590;201801;2636;7013;2167;6316;104;317;1664;4887;1768;5204
261600;201801;5178;13647;4381;12478;384;1093;3008;8708;3392;9801
261610;201801;2466;6696;2087;6127;76;279;1643;4818;1719;5097
261618;201801;2485;6587;2230;6248;95;298;1836;5071;1931;5369
261620;201801;3930;11983;3664;11547;838;2502;2144;7062;2982;9564
261630;201801;6991;20010;5930;18074;537;1980;3624;10586;4161;12566
261640;201801;34938;82758;31288;78426;1842;4152;25244;65098;27086;69250
261650;201801;4039;10942;3600;10365;151;593;2701;7817;2852;8410
270010;201801;4289;15401;3899;14654;198;1078;3076;11336;3274;12414
270020;201801;3846;10163;3433;9618;231;797;2797;7600;3028;8397
270030;201801;35126;100955;31203;94618;4992;15254;19158;58662;24150;73916
270040;201801;10823;30786;9584;29262;595;2167;7717;23517;8312;25684
270050;201801;4790;12053;4192;11377;238;653;3615;9887;3853;10540
270060;201801;1900;5277;1700;5014;194;572;1222;3685;1416;4257
270070;201801;4482;13315;3976;12587;160;738;3326;10267;3486;11005
270080;201801;1337;3971;1125;3579;95;323;811;2516;906;2839
270090;201801;1993;6195;1771;5757;80;373;1379;4320;1459;4693
270100;201801;5539;15830;4940;14933;363;1341;3825;11327;4188;12668
270110;201801;3034;7933;2526;7377;201;609;1967;5887;2168;6496
270120;201801;3016;8273;2661;7832;80;328;2363;6911;2443;7239
270130;201801;5317;14656;4647;13895;309;1017;3722;11247;4031;12264
270135;201801;1918;4888;1673;4601;78;184;1496;4153;1574;4337
270140;201801;10423;24047;8540;21568;448;1734;6907;16490;7355;18224
270150;201801;2618;8199;2527;8088;28;100;2465;7887;2493;7987
270160;201801;5169;16169;4578;15427;125;646;3992;13318;4117;13964
270170;201801;3595;11043;3176;10458;315;1334;2234;7120;2549;8454
270180;201801;2261;7174;2073;6913;68;323;1764;5773;1832;6096
270190;201801;1732;5382;1606;5211;75;281;1324;4299;1399;4580
270200;201801;2520;7935;2235;7560;158;667;1646;5422;1804;6089
270210;201801;5279;13779;4639;13007;194;647;4093;11368;4287;12015
270220;201801;1298;3906;1150;3693;219;806;659;2058;878;2864
270230;201801;9850;29752;8485;27539;898;3509;5383;16895;6281;20404
270235;201801;5986;19033;5421;18085;276;1146;4347;14341;4623;15487
270240;201801;10547;29455;8746;27189;1211;4118;5906;18319;7117;22437
270250;201801;2890;7615;2608;7250;280;736;1998;5591;2278;6327
270255;201801;4707;13835;3653;11903;204;851;2597;8231;2801;9082
270260;201801;5626;17292;5298;16780;169;793;4564;14033;4733;14826
270270;201801;1082;2985;991;2865;158;481;631;1787;789;2268
270280;201801;3776;9813;3087;8923;400;843;2159;6557;2559;7400
270290;201801;7790;25736;7183;24696;361;1674;5904;19937;6265;21611
270300;201801;4026;11361;3250;10515;264;945;2362;7686;2626;8631
270310;201801;7197;21081;6307;19700;193;999;5235;15824;5428;16823
270320;201801;5815;17458;5285;16533;687;2284;3615;11115;4302;13399
270330;201801;3880;13157;3564;12728;317;1219;2742;9857;3059;11076
270340;201801;1632;4768;1402;4463;81;320;1127;3509;1208;3829
270350;201801;1911;4831;1629;4479;166;509;1182;3268;1348;3777
270360;201801;2235;6311;2048;6090;112;325;1819;5476;1931;5801
270370;201801;1423;4600;1304;4384;60;268;1016;3387;1076;3655
270375;201801;2980;7577;2548;7032;57;190;2294;6319;2351;6509
270380;201801;5759;17120;5044;16176;437;1497;3683;11981;4120;13478
270390;201801;1247;3302;1036;3011;31;119;826;2358;857;2477
270400;201801;6216;17735;5405;16467;232;867;4116;12187;4348;13054
270410;201801;4612;14199;4145;13391;290;1098;3074;9788;3364;10886
270420;201801;5722;17537;5334;17030;219;971;4387;13725;4606;14696
270430;201801;134431;358868;111780;328047;28483;88328;42328;128293;70811;216621
270440;201801;4836;13644;4227;12883;139;575;3457;10501;3596;11076
270450;201801;6566;18863;5944;18103;344;1274;4847;14620;5191;15894
270460;201801;3416;8421;3022;7954;81;254;2704;7017;2785;7271
270470;201801;10681;32382;9544;30698;1049;3696;6555;21311;7604;25007
270480;201801;2872;8289;2470;7649;223;838;1839;5501;2062;6339
270490;201801;985;2946;879;2814;51;196;690;2193;741;2389
270500;201801;4846;15512;4457;15004;197;934;3695;12253;3892;13187
270510;201801;5849;16491;5126;15487;564;2125;3639;10508;4203;12633
270520;201801;3728;11334;3127;10272;913;3184;998;3460;1911;6644
270530;201801;1210;3697;1109;3547;72;241;831;2666;903;2907
270540;201801;2089;6491;1874;6206;85;419;1569;5051;1654;5470
270550;201801;6850;18833;5720;17577;548;1658;4295;13545;4843;15203
270560;201801;3183;8945;2834;8444;173;593;2185;6424;2358;7017
270570;201801;3801;11710;3352;10995;182;762;2679;8651;2861;9413
270580;201801;2156;6362;2031;6196;82;254;1789;5495;1871;5749
270590;201801;1484;4603;1394;4492;7;25;1360;4388;1367;4413
270600;201801;2790;8905;2500;8428;120;613;2085;6825;2205;7438
270610;201801;3503;9805;3015;9187;121;473;2594;7765;2715;8238
270620;201801;1348;4268;1239;4071;53;236;1030;3289;1083;3525
270630;201801;15018;42889;13429;40422;1320;4168;9864;29816;11184;33984
270640;201801;5645;16682;4946;15629;236;986;3964;12208;4200;13194
270642;201801;2335;7871;2160;7615;152;760;1697;5797;1849;6557
270644;201801;3066;8348;2589;7722;250;762;1900;5771;2150;6533
270650;201801;3502;10578;3183;10135;427;1752;2206;6679;2633;8431
270660;201801;2163;5434;1722;4826;80;253;1276;3545;1356;3798
270670;201801;16110;39832;13718;37046;1102;2968;10681;29140;11783;32108
270680;201801;4766;12755;4325;12261;82;177;4057;11586;4139;11763
270690;201801;9559;24271;8128;22658;1386;3582;5616;16193;7002;19775
270700;201801;558;1739;484;1603;55;230;325;1036;380;1266
270710;201801;5884;17915;5459;17375;292;1280;4543;14146;4835;15426
270720;201801;3364;10713;2996;10082;103;610;2501;8197;2604;8807
270730;201801;6904;18091;6389;17527;417;1038;5390;15379;5807;16417
270740;201801;2328;6315;2092;6017;100;366;1754;4959;1854;5325
270750;201801;5229;15128;4656;14308;349;1281;3610;11014;3959;12295
270760;201801;3516;10040;3081;9389;92;394;2596;7799;2688;8193
270770;201801;20407;51221;16395;46393;3085;8356;9252;28022;12337;36378
270780;201801;1804;5460;1698;5309;111;378;1397;4381;1508;4759
270790;201801;1520;4573;1366;4357;186;626;901;2879;1087;3505
270800;201801;10905;31252;9911;29882;483;2046;8381;24636;8864;26682
270810;201801;3139;9410;2506;8295;195;805;1703;5525;1898;6330
270820;201801;1734;5382;1484;4953;142;542;1059;3489;1201;4031
270830;201801;5655;13963;4786;12882;307;907;3834;10430;4141;11337
270840;201801;8130;24632;7347;23549;232;1255;6394;19919;6626;21174
270850;201801;8135;22260;7356;21249;555;2108;5831;16121;6386;18229
270860;201801;11004;28987;9258;26876;722;2388;7008;20018;7730;22406
270870;201801;2086;6166;1792;5604;203;690;1229;3795;1432;4485
270880;201801;8194;25048;7483;24046;337;1449;6139;19352;6476;20801
270890;201801;2475;7206;2197;6798;172;625;1589;4793;1761;5418
270895;201801;2956;9982;2772;9730;94;530;2432;8336;2526;8866
270900;201801;1808;4807;1425;4201;62;209;1123;3231;1185;3440
270910;201801;3563;11045;3161;10353;154;681;2405;7712;2559;8393
270915;201801;8997;28388;7722;26117;1011;3943;4798;15891;5809;19834
270920;201801;5918;18298;5551;17760;262;1241;4691;14527;4953;15768
270930;201801;16556;41920;13352;38163;2342;6330;8644;25606;10986;31936
270940;201801;5757;17723;5222;17051;320;1465;4010;12782;4330;14247
280010;201801;665;1835;568;1663;28;123;403;1083;431;1206
280020;201801;4781;13081;4128;12018;540;1607;2690;7797;3230;9404
280030;201801;71233;179059;58404;160807;15687;44597;21645;62415;37332;107012
280040;201801;3138;8972;2763;8396;292;941;1913;5769;2205;6710
280050;201801;3620;11043;3290;10521;616;2076;1906;6061;2522;8137
280060;201801;5039;14715;4194;13339;738;2482;2104;6853;2842;9335
280067;201801;6856;18471;5824;16840;606;1791;3880;11172;4486;12963
280070;201801;1951;6147;1867;6010;129;423;1545;4955;1674;5378
280100;201801;3701;10898;3270;10191;383;1321;2236;6960;2619;8281
280110;201801;1321;3939;1204;3742;50;203;1000;3009;1050;3212
280120;201801;7760;23463;7008;22215;880;2594;5029;16352;5909;18946
280130;201801;8256;21172;7417;19963;764;2128;5506;14878;6270;17006
280140;201801;5646;14336;5102;13577;328;883;4177;11107;4505;11990
280150;201801;3705;10131;3395;9713;190;646;2789;7864;2979;8510
280160;201801;1258;3701;1045;3327;149;504;643;2010;792;2514
280170;201801;5063;13932;4599;13284;290;812;3731;10889;4021;11701
280190;201801;1210;2912;1007;2619;59;184;796;1990;855;2174
280200;201801;1165;3356;1015;3095;102;369;733;2174;835;2543
280210;201801;14734;39998;12957;37553;2260;6771;7352;21699;9612;28470
280220;201801;1778;4868;1575;4594;52;227;1287;3748;1339;3975
280230;201801;3381;9503;3042;8995;235;795;2301;6680;2536;7475
280240;201801;3442;9414;3118;8915;88;366;2642;7407;2730;7773
280250;201801;841;2176;665;1890;82;264;367;996;449;1260
280260;201801;2064;5323;1902;5129;54;154;1759;4743;1813;4897
280270;201801;2224;6596;1997;6243;104;378;1678;5172;1782;5550
280280;201801;4139;13248;3724;12603;588;1752;2396;8592;2984;10344
280290;201801;17028;48711;15221;46077;1758;5948;9818;29786;11576;35734
280300;201801;10141;27909;8929;26543;493;1719;6875;21317;7368;23036
280310;201801;1346;3677;1140;3316;34;126;846;2384;880;2510
280320;201801;8613;25199;7675;23753;995;3313;4764;14548;5759;17861
280330;201801;4578;11980;4016;11180;275;872;3151;8536;3426;9408
280340;201801;4737;11018;4087;10280;255;606;3466;8887;3721;9493
280350;201801;22424;59307;19504;55053;2201;6442;13384;37809;15585;44251
280360;201801;5635;16770;5147;15935;874;2787;2981;9310;3855;12097
280370;201801;2004;5152;1680;4635;102;276;1286;3518;1388;3794
280380;201801;1009;2939;882;2747;99;366;602;1829;701;2195
280390;201801;3045;8583;2644;7856;148;515;1996;5855;2144;6370
280400;201801;3819;10522;3402;9911;674;1882;1923;5870;2597;7752
280410;201801;2128;6490;1771;5805;195;682;1044;3334;1239;4016
280420;201801;4230;11746;3862;11217;134;431;3392;9834;3526;10265
280430;201801;2110;5355;1867;5020;76;276;1469;3856;1545;4132
280440;201801;4722;12909;4148;12123;293;911;3252;9367;3545;10278
280445;201801;2366;6223;2121;5794;49;163;1614;4243;1663;4406
280450;201801;9928;23740;8944;22478;394;817;7770;19759;8164;20576
280460;201801;6607;16762;6025;15932;582;1541;4757;12608;5339;14149
280470;201801;1797;5221;1605;4890;75;265;1212;3678;1287;3943
280480;201801;34036;92034;30853;87556;3391;10709;21327;59488;24718;70197
280490;201801;3873;11280;3289;10296;120;519;2463;7504;2583;8023
280500;201801;923;2345;809;2186;36;113;671;1801;707;1914
280510;201801;2533;7186;2230;6741;119;477;1615;4834;1734;5311
280520;201801;1710;4488;1526;4244;101;270;1248;3470;1349;3740
280530;201801;2485;6350;2241;6052;124;356;1832;4926;1956;5282
280540;201801;9092;24825;8321;23742;206;968;7315;20322;7521;21290
280550;201801;6816;16867;5605;15038;320;859;4267;11290;4587;12149
280560;201801;7207;20847;6794;20260;216;865;5893;17254;6109;18119
280570;201801;6341;16479;5270;15065;315;1045;3807;10803;4122;11848
280580;201801;5283;15655;4584;14466;596;1840;2981;9579;3577;11419
280590;201801;2682;7065;2327;6611;163;671;1656;4516;1819;5187
280600;201801;3382;9768;3061;9313;228;793;2281;6881;2509;7674
280610;201801;2478;6407;2252;6106;167;475;1810;4848;1977;5323
280620;201801;5354;14349;4640;13268;441;1089;3304;9828;3745;10917
280630;201801;3632;11348;3301;10836;226;809;2557;8490;2783;9299
280640;201801;2323;6700;2144;6502;54;135;1998;6136;2052;6271
280650;201801;1077;3113;930;2907;93;330;673;2057;766;2387
280660;201801;2809;7281;2584;7016;148;397;2217;6027;2365;6424
280670;201801;17543;42900;15641;40431;1358;3732;11637;30052;12995;33784
280680;201801;2800;7165;2374;6481;159;396;1772;4774;1931;5170
280690;201801;962;2543;827;2359;53;160;613;1718;666;1878
280700;201801;1069;2918;942;2711;27;96;723;2049;750;2145
280710;201801;13770;32761;11983;30694;566;1010;10463;27613;11029;28623
280720;201801;2546;6031;2190;5613;148;405;1492;4084;1640;4489
280730;201801;1098;2800;991;2647;67;218;778;2037;845;2255
280740;201801;13547;35054;11586;32015;1235;3405;7624;21078;8859;24483
280750;201801;3441;10116;3122;9556;201;737;2251;6788;2452;7525
280760;201801;5819;16887;5191;15897;674;2101;3305;10411;3979;12512
290010;201801;3008;6559;2116;5180;15;56;1745;4065;1760;4121
290020;201801;4907;14361;4659;14023;258;666;4051;12326;4309;12992
290030;201801;3735;9963;3256;9393;201;565;2725;7875;2926;8440
290035;201801;5109;11754;4131;10476;258;564;3277;8580;3535;9144
290040;201801;4394;10827;3683;10008;169;509;2886;8020;3055;8529
290050;201801;2222;7229;1920;6660;141;573;1334;4583;1475;5156
290060;201801;1322;3333;1024;2878;107;380;695;1866;802;2246
290070;201801;33544;80686;28938;74780;3413;9006;18419;48532;21832;57538
290080;201801;5683;16794;4790;15529;645;2151;3106;10265;3751;12416
290090;201801;2305;4423;1737;3827;50;101;1590;3515;1640;3616
290100;201801;9143;25322;7812;23292;1049;3009;4807;14739;5856;17748
290110;201801;4961;13985;4590;13336;514;1574;3118;8967;3632;10541
290115;201801;4389;12780;3868;12082;192;669;3160;9930;3352;10599
290120;201801;6910;17195;5658;15679;164;584;4802;13099;4966;13683
290130;201801;4584;11635;3693;10532;128;542;2956;8233;3084;8775
290135;201801;4504;10803;3704;9544;250;719;2758;6903;3008;7622
290140;201801;4522;12819;3752;11828;146;536;3250;10259;3396;10795
290150;201801;2252;6511;2118;6305;196;608;1594;4641;1790;5249
290160;201801;3209;7898;2981;7618;374;780;2284;5981;2658;6761
290170;201801;2732;8152;2525;7893;83;347;2256;6989;2339;7336
290180;201801;2911;8172;2428;7403;111;401;1896;5733;2007;6134
290190;201801;3958;12267;3620;11797;193;849;2866;9178;3059;10027
290195;201801;2323;6090;1884;5414;59;269;1520;4293;1579;4562
290200;201801;3970;11621;3408;10749;217;705;2665;8398;2882;9103
290205;201801;3424;9141;3022;8552;131;513;2395;6574;2526;7087
290210;201801;13548;39092;12071;37068;1156;3208;9099;28877;10255;32085
290220;201801;2685;7088;2451;6796;170;526;1994;5448;2164;5974
290225;201801;3457;7505;2832;6839;41;94;2661;6448;2702;6542
290230;201801;2343;6977;2146;6743;93;364;1830;5739;1923;6103
290240;201801;3710;9668;3100;8890;146;504;2476;6987;2622;7491
290250;201801;3942;11857;3576;11380;108;291;3059;10174;3167;10465
290260;201801;5313;14038;4341;12593;240;840;3414;9800;3654;10640
290265;201801;3548;10528;2971;9484;137;584;2261;7124;2398;7708
290270;201801;11907;41358;11265;40296;840;3514;8731;30934;9571;34448
290280;201801;5768;17564;5181;16615;382;1320;3830;12236;4212;13556
290290;201801;9954;29999;8491;27394;848;2849;5884;18973;6732;21822
290300;201801;4524;12503;3264;10109;193;693;2246;6958;2439;7651
290310;201801;1519;4162;1274;3815;116;431;887;2584;1003;3015
290320;201801;25595;70311;21654;65048;5439;16644;10199;31932;15638;48576
290323;201801;3604;9967;3230;9470;80;273;2687;7769;2767;8042
290327;201801;4323;12586;3747;11524;325;998;2655;8171;2980;9169
290330;201801;1990;4525;1701;4211;50;101;1536;3846;1586;3947
290340;201801;5680;15654;4632;14343;781;2567;3022;9430;3803;11997
290350;201801;4670;13895;3973;12702;345;1164;2820;9112;3165;10276
290360;201801;4901;13700;4254;12847;110;391;3644;11044;3754;11435
290370;201801;5093;12940;3953;11440;219;577;3072;9048;3291;9625
290380;201801;5590;15478;4832;14401;153;529;4108;12301;4261;12830
290390;201801;14900;43400;12896;40445;1457;4698;8569;27460;10026;32158
290395;201801;2732;8496;2317;7745;83;392;1801;5972;1884;6364
290400;201801;3686;10384;3013;9324;171;611;2205;6710;2376;7321
290405;201801;4707;14133;3970;12832;288;1005;2741;8981;3029;9986
290410;201801;5658;16108;4558;14305;185;806;3447;10436;3632;11242
290420;201801;3034;8639;2539;7873;157;507;1955;6054;2112;6561
290430;201801;3169;9293;2646;8427;384;1271;1621;5215;2005;6486
290440;201801;2940;7465;2238;6452;88;295;1626;4740;1714;5035
290450;201801;3260;9111;2724;8335;136;508;2080;6228;2216;6736
290460;201801;12150;34370;10619;31535;2899;8848;4004;11776;6903;20624
290470;201801;4401;11800;3304;10156;556;1860;1627;5147;2183;7007
290475;201801;6065;18404;5271;16968;116;591;4187;13198;4303;13789
290480;201801;2023;5316;1796;4993;153;461;1177;3268;1330;3729
290485;201801;4663;14150;4039;13213;164;827;3388;10856;3552;11683
290490;201801;8720;21542;8035;20651;588;1564;6368;16449;6956;18013
290500;201801;3957;12130;3106;10378;406;1437;1631;5403;2037;6840
290510;201801;3259;8746;2809;8132;105;382;2388;6820;2493;7202
290515;201801;3735;10035;3112;9237;87;230;2705;8212;2792;8442
290520;201801;11346;34085;9085;29647;403;1700;6091;19485;6494;21185
290530;201801;5025;14593;4385;13579;209;658;3591;11133;3800;11791
290540;201801;3678;10134;3306;9645;95;302;2930;8507;3025;8809
290550;201801;4401;11457;3896;10886;49;153;3610;10161;3659;10314
290560;201801;6731;18088;5430;16181;585;1932;3705;10868;4290;12800
290570;201801;43241;112406;39320;107392;2885;8238;30434;82679;33319;90917
290580;201801;7539;23625;6828;22574;660;2152;5102;17256;5762;19408
290590;201801;7061;22172;6095;20436;176;758;4998;16752;5174;17510
290600;201801;17962;52112;16392;49791;955;3001;13042;40089;13997;43090
290610;201801;2475;8125;2008;7190;112;482;1386;4898;1498;5380
290620;201801;6259;18109;5646;17143;243;799;4753;14338;4996;15137
290630;201801;9014;22298;7298;20136;596;1667;5712;15847;6308;17514
290640;201801;2678;7377;2071;6379;92;299;1609;4890;1701;5189
290650;201801;11339;31442;10467;30330;2761;7746;5693;17425;8454;25171
290660;201801;3617;9690;3088;8903;111;283;2289;6945;2400;7228
290670;201801;6833;19843;5980;18466;514;1603;4442;13857;4956;15460
290680;201801;10325;29897;8955;27887;282;1402;7154;21658;7436;23060
290682;201801;4671;12739;4084;11893;145;437;3417;9918;3562;10355
290685;201801;3651;8359;2409;6634;220;573;1559;4436;1779;5009
290687;201801;6872;19569;5512;17312;876;2739;3127;10191;4003;12930
290689;201801;2960;8478;2471;7652;163;569;1795;5608;1958;6177
290690;201801;5585;15030;4652;13805;579;1699;3131;9326;3710;11025
290700;201801;2580;7303;2336;6970;79;295;2015;6021;2094;6316
290710;201801;8356;24323;7294;22871;288;1074;6232;19507;6520;20581
290720;201801;18743;52154;17218;50135;922;2862;14324;41854;15246;44716
290730;201801;7065;18445;6139;17315;293;817;4713;13303;5006;14120
290740;201801;1002;2837;761;2402;37;149;569;1777;606;1926
290750;201801;10585;28272;9170;25833;1132;3391;5884;16151;7016;19542
290755;201801;2244;6298;1752;5398;99;357;1221;3696;1320;4053
290760;201801;4002;11866;3174;10251;410;1203;1852;6279;2262;7482
290770;201801;2549;8604;2364;8365;76;372;1941;6904;2017;7276
290780;201801;8439;21394;7310;19799;485;1032;5661;15692;6146;16724
290790;201801;4511;12771;4045;12145;153;431;3464;10458;3617;10889
290800;201801;7291;15199;5449;13125;333;698;4222;10408;4555;11106
290810;201801;5713;15949;4568;14125;125;475;3523;10936;3648;11411
290820;201801;5145;13983;4631;13293;286;927;3498;10065;3784;10992
290830;201801;4612;11046;4128;10411;123;390;3384;8404;3507;8794
290840;201801;16917;47123;14833;43975;1798;4831;9752;30265;11550;35096
290850;201801;6262;16600;5741;16017;507;1252;4502;12947;5009;14199
290860;201801;5657;17514;4957;16695;242;893;4123;14113;4365;15006
290870;201801;4738;13392;3737;11649;155;568;2692;8337;2847;8905
290880;201801;1412;3635;1114;3195;81;203;774;2263;855;2466
290890;201801;7573;17656;6619;16582;203;579;6036;15042;6239;15621
290900;201801;2314;6362;1760;5391;118;401;1124;3400;1242;3801
290910;201801;5017;13055;4022;11549;60;265;3358;9551;3418;9816
290920;201801;5109;12916;4727;12429;89;206;4355;11455;4444;11661
290930;201801;8191;23314;6841;21053;226;1006;5458;16333;5684;17339
290940;201801;3777;11060;3241;10292;186;644;2422;7754;2608;8398
290950;201801;1530;4067;1296;3701;88;255;930;2674;1018;2929
290960;201801;5350;14902;4857;14256;164;515;4082;12001;4246;12516
290970;201801;3644;10778;3083;9861;190;594;2256;7256;2446;7850
290980;201801;10849;28814;9176;25952;1405;4259;4591;12676;5996;16935
290990;201801;8935;25506;7747;23533;411;1535;6122;18178;6533;19713
291000;201801;3338;9164;2685;8342;271;761;2066;6572;2337;7333
291005;201801;14773;36438;13107;34403;758;2066;10791;28396;11549;30462
291010;201801;3206;9674;2531;8306;167;560;1661;5413;1828;5973
291020;201801;1276;3294;1022;2833;44;148;680;1780;724;1928
291030;201801;2405;6219;1696;4871;106;320;1056;2938;1162;3258
291040;201801;5457;15700;4715;14627;223;923;3734;11455;3957;12378
291050;201801;7592;22916;6749;21598;1207;4259;4076;12826;5283;17085
291060;201801;6053;20639;5380;19664;519;2274;3714;13372;4233;15646
291070;201801;15683;44005;13595;40828;641;2379;10758;32004;11399;34383
291072;201801;23692;65558;18037;55032;3960;12790;6533;20252;10493;33042
291075;201801;4922;13626;4395;12738;221;665;3449;9873;3670;10538
291077;201801;1553;4226;1258;3715;55;145;916;2741;971;2886
291080;201801;81288;237120;69697;217908;25799;82362;10899;35788;36698;118150
291085;201801;5724;14760;4792;13459;201;615;4035;11299;4236;11914
291090;201801;1846;3844;1480;3425;135;180;1199;2898;1334;3078
291100;201801;2990;6853;2098;5800;101;359;1601;4336;1702;4695
291110;201801;5481;17789;4788;16608;535;2049;3369;11435;3904;13484
291120;201801;7655;19523;6696;18224;418;1245;5136;13934;5554;15179
291125;201801;2006;3765;1547;3260;82;163;1237;2658;1319;2821
291130;201801;2923;8833;2369;7801;93;443;1757;5587;1850;6030
291140;201801;4384;12492;3427;10636;471;1293;2170;6858;2641;8151
291150;201801;2173;5115;1883;4774;31;82;1659;4179;1690;4261
291160;201801;4843;14706;4269;13751;466;1631;2782;8861;3248;10492
291165;201801;2373;6568;1831;5577;23;101;1340;3982;1363;4083
291170;201801;20463;53319;17352;48354;1186;3576;11025;30716;12211;34292
291180;201801;6176;15496;4806;13502;413;1194;3445;9681;3858;10875
291185;201801;3364;9349;2938;8605;121;401;2373;6850;2494;7251
291190;201801;7540;19327;6364;17726;401;1208;4995;13901;5396;15109
291200;201801;2905;8398;2191;7059;117;403;1384;4414;1501;4817
291210;201801;6808;15678;5335;13918;203;678;4033;10403;4236;11081
291220;201801;4057;11925;3648;11289;329;1127;2615;7997;2944;9124
291230;201801;4349;10046;3437;9027;88;165;3149;8393;3237;8558
291240;201801;4356;11503;3779;10520;76;257;3214;8796;3290;9053
291250;201801;3379;10225;2710;8991;176;574;1831;6157;2007;6731
291260;201801;1215;3105;1058;2894;46;181;883;2357;929;2538
291270;201801;4938;14499;4075;13055;819;2759;2311;7490;3130;10249
291280;201801;2325;6350;1805;5498;216;691;1010;3017;1226;3708
291290;201801;5985;16177;4868;14512;592;1792;3127;9412;3719;11204
291300;201801;4056;11387;3095;9736;139;458;2232;6973;2371;7431
291310;201801;5266;14595;4503;13198;175;594;3594;10388;3769;10982
291320;201801;6116;18204;4804;15589;1145;3537;2187;7433;3332;10970
291330;201801;1693;4611;1443;4207;83;274;1053;2998;1136;3272
291340;201801;4041;10840;3406;9844;84;310;2720;7764;2804;8074
291345;201801;3113;9786;2881;9465;160;565;2322;7686;2482;8251
291350;201801;6455;17181;5040;15212;178;533;4133;12673;4311;13206
291360;201801;33601;85522;27509;77532;5358;15434;14337;41612;19695;57046
291370;201801;7953;22072;7309;21220;474;1565;5601;16156;6075;17721
291380;201801;3475;10178;3054;9500;125;511;2418;7412;2543;7923
291390;201801;12247;29163;9992;26560;574;1714;7880;20881;8454;22595
291400;201801;14150;37607;11980;34379;1890;4990;7332;22244;9222;27234
291410;201801;2929;7835;2260;6712;70;316;1716;4952;1786;5268
291420;201801;1954;5024;1626;4605;44;170;1378;3874;1422;4044
291430;201801;3117;8744;2730;8169;100;474;2223;6443;2323;6917
291440;201801;6451;18951;5624;17558;418;1372;4366;13762;4784;15134
291450;201801;8549;23083;7171;21374;177;427;6146;18847;6323;19274
291460;201801;13739;39393;12271;37224;1051;3449;8742;26645;9793;30094
291465;201801;8270;22201;6789;20434;326;1405;5505;16324;5831;17729
291470;201801;15666;39178;13423;36594;627;1677;10238;28649;10865;30326
291480;201801;38621;89920;29276;77487;3894;11038;15684;41739;19578;52777
291490;201801;4827;13593;4309;12930;323;1008;3509;10591;3832;11599
291500;201801;4734;12422;3919;11292;99;405;3415;9794;3514;10199
291510;201801;3837;10774;3168;9803;96;450;2563;7911;2659;8361
291520;201801;4304;10665;3398;9443;228;690;2401;6698;2629;7388
291530;201801;2194;5517;1645;4747;322;857;933;2958;1255;3815
291535;201801;3265;10051;3000;9627;218;695;2255;7335;2473;8030
291540;201801;2209;5056;1620;4411;83;258;1405;3784;1488;4042
291550;201801;5473;13358;4382;11893;583;1479;2633;7307;3216;8786
291560;201801;19528;44170;13376;36904;949;2491;9121;26515;10070;29006
291570;201801;2268;5537;1879;5069;100;216;1575;4361;1675;4577
291580;201801;5941;16651;4922;15261;401;1457;3511;10784;3912;12241
291590;201801;1735;5183;1587;4958;159;563;1214;3780;1373;4343
291600;201801;5197;13602;3921;11558;665;2056;2117;6138;2782;8194
291610;201801;4926;14716;4673;14434;85;289;4369;13561;4454;13850
291620;201801;3130;7122;2247;6154;114;360;1723;4787;1837;5147
291630;201801;3247;7612;2481;6630;148;437;1958;5170;2106;5607
291640;201801;15878;41789;12234;36335;2551;7784;4200;13351;6751;21135
291650;201801;8526;23543;7610;22416;471;1209;6421;19216;6892;20425
291660;201801;2249;5538;1649;4603;126;462;1086;2844;1212;3306
291670;201801;1994;5300;1733;4940;118;301;1353;3921;1471;4222
291680;201801;3946;10728;3345;9736;385;1186;2341;6801;2726;7987
291685;201801;4790;11682;3836;10453;345;792;2788;7889;3133;8681
291690;201801;4063;9630;2940;7995;105;293;2357;6341;2462;6634
291700;201801;8890;26522;7854;24669;584;1892;6091;19097;6675;20989
291710;201801;5241;13126;3987;11415;373;1194;2650;7441;3023;8635
291720;201801;4632;14526;3831;12892;315;1200;2581;8470;2896;9670
291730;201801;6314;17393;5484;16301;315;1064;4413;13147;4728;14211
291733;201801;2957;7815;2449;7105;104;323;1811;5436;1915;5759
291735;201801;3019;8041;2539;7337;98;304;2125;6151;2223;6455
291740;201801;3897;10282;3117;9094;146;473;2422;6978;2568;7451
291750;201801;20160;50387;16066;44222;2236;6270;9520;26696;11756;32966
291760;201801;10707;32426;8655;29023;3013;11306;1956;6649;4969;17955
291770;201801;7138;20198;5951;18046;603;1984;4079;12111;4682;14095
291780;201801;4706;13287;4252;12580;139;460;3650;10752;3789;11212
291790;201801;2664;7789;2468;7507;198;585;1919;5877;2117;6462
291800;201801;30645;79832;24494;70925;3169;9115;14532;43112;17701;52227
291810;201801;10856;27318;8952;24943;257;878;7557;20867;7814;21745
291820;201801;3811;10589;3331;9904;148;523;2558;7609;2706;8132
291830;201801;4222;10527;3671;9788;259;718;2934;7846;3193;8564
291835;201801;6290;19187;5087;16912;885;3055;2863;9754;3748;12809
291840;201801;46344;128968;40246;121236;5011;15198;27483;85000;32494;100198
291845;201801;2420;6996;2171;6669;138;406;1798;5586;1936;5992
291850;201801;4207;12151;3457;10902;318;912;2465;8029;2783;8941
291855;201801;1973;4341;1572;3849;80;249;1298;3116;1378;3365
291860;201801;2280;6063;1642;4829;33;113;1134;3217;1167;3330
291870;201801;1374;3646;928;2841;65;220;598;1784;663;2004
291875;201801;2777;8430;2462;7899;114;425;1788;5604;1902;6029
291880;201801;5115;15527;4557;14430;357;1129;3349;10594;3706;11723
291890;201801;1445;3287;993;2735;183;401;636;1828;819;2229
291900;201801;1223;3151;943;2680;30;117;730;2021;760;2138
291905;201801;2747;7099;2098;5994;82;280;1553;4326;1635;4606
291910;201801;2834;7326;2407;6822;83;278;2066;5858;2149;6136
291915;201801;6928;20649;5797;18710;290;1101;4447;14390;4737;15491
291920;201801;25335;71929;22618;68152;2903;9394;14714;44066;17617;53460
291930;201801;2474;7205;2162;6685;208;740;1485;4476;1693;5216
291940;201801;3426;9355;2382;7494;229;742;1449;4430;1678;5172
291950;201801;8795;27876;7686;25750;1017;3445;4514;15493;5531;18938
291955;201801;12431;34010;11361;32643;1824;5111;7640;22763;9464;27874
291960;201801;3107;8696;2523;7811;146;467;1915;6048;2061;6515
291970;201801;4011;11522;3542;10826;226;897;2538;7684;2764;8581
291980;201801;10608;30336;8457;27116;594;1937;5935;19253;6529;21190
291990;201801;2025;5898;1886;5726;35;123;1754;5353;1789;5476
291992;201801;4125;10285;3050;8800;341;942;2293;6714;2634;7656
291995;201801;2172;5971;1760;5371;55;241;1429;4268;1484;4509
292000;201801;2369;6277;2011;5749;168;557;1406;3996;1574;4553
292010;201801;6205;14698;5054;13108;258;740;4147;10641;4405;11381
292020;201801;4426;13493;3841;12458;327;1120;2845;9095;3172;10215
292030;201801;1747;5602;1644;5442;117;435;995;3200;1112;3635
292040;201801;4256;11316;3529;10356;248;666;2834;8551;3082;9217
292045;201801;3753;10510;2978;9363;75;191;2617;8356;2692;8547
292050;201801;6497;18932;5322;16687;424;1466;3324;10320;3748;11786
292060;201801;12475;29610;11411;28324;725;1767;9585;23509;10310;25276
292070;201801;5415;15018;4782;14254;305;948;4067;12130;4372;13078
292080;201801;3358;8575;2736;7787;147;489;2341;6639;2488;7128
292090;201801;4410;10064;3301;8777;228;657;2615;7041;2843;7698
292100;201801;10539;27332;8886;25142;1785;5089;4509;13175;6294;18264
292105;201801;3073;8790;2754;8280;78;348;2324;6907;2402;7255
292110;201801;6371;16457;4625;13564;1160;3402;2028;6076;3188;9478
292120;201801;6856;18504;5538;16135;636;1886;3653;10648;4289;12534
292130;201801;3126;8083;2635;7446;218;681;1965;5556;2183;6237
292140;201801;4986;12458;4124;11219;280;754;3235;8789;3515;9543
292145;201801;2267;6830;1943;6272;126;412;1393;4542;1519;4954
292150;201801;12930;37223;11725;35448;333;1300;9814;29431;10147;30731
292160;201801;2455;6812;2108;6365;84;248;1857;5634;1941;5882
292170;201801;8374;23361;6962;20967;666;2126;4680;14126;5346;16252
292180;201801;2968;8206;2199;6885;418;1223;1121;3581;1539;4804
292190;201801;2942;8134;2482;7451;294;925;1588;4827;1882;5752
292200;201801;7044;19413;5585;17194;1147;3642;2714;8579;3861;12221
292205;201801;3679;10697;3301;10131;90;435;2857;8598;2947;9033
292210;201801;6043;15318;5073;14019;119;477;4458;12172;4577;12649
292220;201801;1985;5082;1774;4779;150;410;1294;3440;1444;3850
292225;201801;3176;9563;2840;9058;102;430;2334;7348;2436;7778
292230;201801;7509;19258;6932;18463;176;728;5908;15372;6084;16100
292240;201801;4952;14587;4300;13320;358;1126;2905;8967;3263;10093
292250;201801;5333;15113;4887;14405;680;1982;3145;9407;3825;11389
292260;201801;3306;9146;2979;8703;190;532;2475;7343;2665;7875
292265;201801;3193;9330;2742;8577;84;391;2163;6591;2247;6982
292270;201801;4042;9904;3300;9005;246;720;2657;7271;2903;7991
292273;201801;2517;5739;2064;5182;83;155;1618;4201;1701;4356
292275;201801;1800;5052;1467;4575;83;201;1146;3737;1229;3938
292280;201801;2485;6235;2052;5730;94;220;1689;4893;1783;5113
292285;201801;2497;6415;2005;5705;92;319;1578;4480;1670;4799
292290;201801;6732;19513;5655;17941;259;975;4522;14327;4781;15302
292300;201801;9464;25807;7667;23523;1159;3709;4739;14822;5898;18531
292303;201801;2840;8335;2512;7839;69;245;2161;6726;2230;6971
292305;201801;2575;6935;2383;6650;48;218;2113;5791;2161;6009
292310;201801;6525;17742;5747;16718;247;749;4802;13937;5049;14686
292320;201801;6467;17546;5313;15486;302;968;4050;11541;4352;12509
292330;201801;2443;5944;2149;5579;123;324;1702;4471;1825;4795
292335;201801;4952;12843;4398;12069;316;800;3550;9863;3866;10663
292340;201801;6276;17115;5326;15461;272;800;3991;11516;4263;12316
292350;201801;2380;6632;1964;6070;83;307;1628;5062;1711;5369
292360;201801;4909;13191;4282;12083;348;1127;3091;8515;3439;9642
292370;201801;10107;24496;8811;22785;210;635;7889;20092;8099;20727
292380;201801;6956;20011;6311;18919;536;1574;4703;14162;5239;15736
292390;201801;4173;8695;3083;7409;147;271;2659;6464;2806;6735
292400;201801;21060;63312;18961;59770;2222;7382;12795;40324;15017;47706
292405;201801;4471;11001;3680;9929;190;448;3006;8184;3196;8632
292410;201801;2042;5250;1793;4960;74;217;1540;4293;1614;4510
292420;201801;3638;11336;3389;10958;192;829;2809;8977;3001;9806
292430;201801;5126;15004;3879;13129;331;1188;2536;8681;2867;9869
292440;201801;8283;26919;7654;26018;123;588;6993;23879;7116;24467
292450;201801;3752;11290;3102;10045;165;614;2388;7737;2553;8351
292460;201801;4766;13663;3993;12353;398;1228;2816;8715;3214;9943
292465;201801;2440;6800;2025;6177;108;311;1436;4537;1544;4848
292467;201801;1715;5244;1596;5087;204;635;1129;3699;1333;4334
292470;201801;2960;7531;2367;6591;82;226;1871;5214;1953;5440
292480;201801;6525;15918;5274;14371;108;395;4675;12527;4783;12922
292490;201801;2237;6015;1867;5460;117;352;1406;4137;1523;4489
292500;201801;6433;18279;5312;16295;597;1811;3498;10818;4095;12629
292510;201801;12788;35470;10432;31926;656;2483;7594;23133;8250;25616
292520;201801;6552;17114;5669;15806;917;2515;3655;10390;4572;12905
292525;201801;5572;13842;4587;12700;142;403;3977;11043;4119;11446
292530;201801;27092;74882;22722;68243;5822;17683;9261;29051;15083;46734
292540;201801;3454;7872;2806;7158;188;490;2366;6055;2554;6545
292550;201801;7318;21012;5875;19127;444;1613;4418;14634;4862;16247
292560;201801;4195;11166;3628;10333;127;517;2929;8248;3056;8765
292570;201801;4117;11050;3559;10273;63;228;3227;9284;3290;9512
292575;201801;6757;20691;6347;20138;273;916;5417;17232;5690;18148
292580;201801;7244;19619;6318;18280;200;736;5448;15604;5648;16340
292590;201801;7229;19888;6598;18982;258;899;5695;16037;5953;16936
292593;201801;2843;7177;2409;6475;158;406;1882;5044;2040;5450
292595;201801;5672;15166;4887;14193;217;750;4009;11561;4226;12311
292600;201801;10959;30300;9615;28399;588;1544;7407;22123;7995;23667
292610;201801;4492;11817;3732;10578;214;516;2661;7769;2875;8285
292620;201801;6358;18128;5504;17173;73;204;5226;16475;5299;16679
292630;201801;8769;22103;7228;19640;488;1356;5115;14004;5603;15360
292640;201801;7898;24254;7061;22927;247;1008;5303;17226;5550;18234
292650;201801;4462;11510;4052;10972;200;538;3560;9576;3760;10114
292660;201801;10814;31024;9609;29246;612;2016;7500;22865;8112;24881
292665;201801;2232;6850;2048;6613;50;164;1814;5929;1864;6093
292670;201801;3554;9837;2767;8407;147;536;1865;5564;2012;6100
292680;201801;3910;10843;3258;9652;235;710;2332;6765;2567;7475
292690;201801;2632;7159;1884;5921;147;456;1231;3999;1378;4455
292700;201801;9614;27008;8313;25089;917;2641;5606;17535;6523;20176
292710;201801;2268;7402;2116;7209;55;210;1914;6549;1969;6759
292720;201801;9371;22936;7934;21345;306;913;6683;18190;6989;19103
292730;201801;4065;10642;3879;10400;187;422;3333;8994;3520;9416
292740;201801;328633;847986;301758;807290;53331;147494;175461;465178;228792;612672
292750;201801;6415;17251;5488;15890;268;808;4164;12129;4432;12937
292760;201801;3861;11509;3472;10811;274;907;2518;7818;2792;8725
292770;201801;5926;16809;5029;15447;916;2950;2876;9138;3792;12088
292780;201801;1919;4127;1435;3529;55;166;1145;2729;1200;2895
292790;201801;4021;8754;3283;7951;67;221;3009;7232;3076;7453
292800;201801;10299;27290;9034;25321;418;1214;7324;20362;7742;21576
292805;201801;3371;8651;2701;7719;240;648;1962;5648;2202;6296
292810;201801;10114;28256;8028;25079;391;1466;5858;18198;6249;19664
292820;201801;7725;21130;5629;18002;426;1646;4060;12741;4486;14387
292830;201801;2665;6394;2320;5960;49;183;2112;5365;2161;5548
292840;201801;8811;23873;8029;22824;170;701;7148;19823;7318;20524
292850;201801;2825;7570;2301;6761;168;586;1523;4330;1691;4916
292860;201801;15778;38183;14165;36129;1049;2572;11084;28448;12133;31020
292870;201801;17859;47292;15595;43929;1220;3898;10073;27945;11293;31843
292880;201801;11786;32628;10366;30614;504;1970;7766;22172;8270;24142
292890;201801;5678;17590;5068;16584;370;1371;3912;12720;4282;14091
292895;201801;2983;6752;2215;5606;122;301;1651;4165;1773;4466
292900;201801;2691;7736;2504;7434;86;391;2008;5734;2094;6125
292905;201801;4330;11982;3389;10541;255;808;2314;7262;2569;8070
292910;201801;5023;14237;4525;13396;382;1240;3154;9264;3536;10504
292920;201801;9987;27867;9401;27081;351;1361;8124;22954;8475;24315
292925;201801;5179;15051;4639;14169;251;785;3584;10874;3835;11659
292930;201801;6229;19349;5626;18175;422;1802;3709;11596;4131;13398
292935;201801;2062;5864;1668;5431;41;207;1455;4828;1496;5035
292937;201801;3107;7700;2689;7194;86;255;2323;6232;2409;6487
292940;201801;3162;8414;2557;7455;180;488;1910;5698;2090;6186
292950;201801;9263;24940;8295;23467;384;1217;6345;17589;6729;18806
292960;201801;5350;13043;4555;11990;135;417;3680;9515;3815;9932
292970;201801;4061;11870;3551;11166;130;573;2933;9206;3063;9779
292975;201801;4325;9701;3856;9159;216;436;3395;8170;3611;8606
292980;201801;3192;8169;2555;7195;130;414;1947;5381;2077;5795
292990;201801;11329;31448;9668;28786;447;1514;7684;22893;8131;24407
293000;201801;2654;6622;2406;6303;29;104;1905;5199;1934;5303
293010;201801;17857;47321;14656;42157;1969;5733;8931;25794;10900;31527
293015;201801;7538;24429;6222;21894;612;2548;4161;14513;4773;17061
293020;201801;9294;29003;8566;28030;197;897;7548;24757;7745;25654
293030;201801;5555;15315;4302;13351;154;524;2887;9235;3041;9759
293040;201801;3825;11421;3511;10986;111;429;3084;9597;3195;10026
293050;201801;20968;54151;18635;50926;1887;5315;12491;34643;14378;39958
293060;201801;3562;9393;2934;8386;211;676;2136;5982;2347;6658
293070;201801;24528;62600;20234;56762;3985;11073;10644;31318;14629;42391
293075;201801;3189;10645;2938;10219;210;930;2297;7939;2507;8869
293076;201801;3550;9434;3173;8924;105;293;2634;7502;2739;7795
293077;201801;5230;15325;4437;14206;549;1820;2882;9457;3431;11277
293080;201801;4722;14365;4197;13504;161;696;3386;10694;3547;11390
293090;201801;3105;9622;2510;8627;241;930;1617;5547;1858;6477
293100;201801;5720;16093;4721;14273;354;1070;3547;10786;3901;11856
293105;201801;3766;12127;3297;11209;259;913;2312;7822;2571;8735
293110;201801;2297;5856;1931;5355;63;200;1613;4390;1676;4590
293120;201801;4090;11916;3722;11308;141;441;3117;9429;3258;9870
293130;201801;3696;10702;3330;10247;98;396;2895;8898;2993;9294
293135;201801;31067;75574;22856;64183;4483;14092;9286;26376;13769;40468
293140;201801;2151;5406;1941;5144;88;276;1608;4142;1696;4418
293150;201801;5371;16961;4517;15278;533;1821;2966;10174;3499;11995
293160;201801;3942;9722;3362;9033;294;559;2698;7645;2992;8204
293170;201801;3741;9654;3289;9043;139;470;2576;7050;2715;7520
293180;201801;4902;13489;3963;11938;129;565;3158;9262;3287;9827
293190;201801;13545;39038;12116;36908;361;1616;10293;30969;10654;32585
293200;201801;7847;20158;6564;18330;218;817;5092;14097;5310;14914
293210;201801;5095;13952;4386;12826;232;725;3426;9972;3658;10697
293220;201801;5066;14027;3951;12121;1000;3060;1487;4795;2487;7855
293230;201801;3842;10752;3037;9569;362;1247;1971;6284;2333;7531
293240;201801;4338;11881;3494;10456;105;333;2666;8078;2771;8411
293245;201801;4130;11270;3668;10634;165;555;3044;8725;3209;9280
293250;201801;5666;14334;4872;13239;347;925;3717;10096;4064;11021
293260;201801;4393;12591;3653;11445;131;454;2620;8141;2751;8595
293270;201801;6537;15745;5348;14444;437;863;4327;12275;4764;13138
293280;201801;4976;13556;4235;12545;218;642;3225;9626;3443;10268
293290;201801;12954;41792;11981;40064;2960;9987;5547;19534;8507;29521
293300;201801;6332;15138;5406;13939;346;785;4028;10590;4374;11375
293305;201801;4339;10849;3721;10008;80;260;3204;8578;3284;8838
293310;201801;2264;5860;1824;5109;139;401;1278;3534;1417;3935
293315;201801;4187;10357;3452;9225;182;440;2762;7356;2944;7796
293317;201801;2464;6436;2186;5969;114;302;1654;4498;1768;4800
293320;201801;8378;24985;7879;24403;759;2405;6388;19972;7147;22377
293325;201801;1734;4680;1393;4154;223;690;856;2537;1079;3227
293330;201801;45219;144539;40304;135648;8915;30838;18063;61807;26978;92645
293340;201801;2464;6992;1995;6186;160;545;1281;3931;1441;4476
293345;201801;3136;9104;2709;8538;280;634;1959;6659;2239;7293
293350;201801;6834;19430;6142;18651;98;264;5693;17632;5791;17896
293360;201801;14539;39665;12715;37432;564;1863;11140;32678;11704;34541
310010;201801;825;2093;625;1803;69;231;290;788;359;1019
310020;201801;2285;6833;1821;6024;462;1681;248;796;710;2477
310030;201801;2294;6776;1829;5938;277;1046;1109;3449;1386;4495
310040;201801;964;2503;782;2226;56;206;586;1602;642;1808
310050;201801;1640;5391;1495;5118;283;1077;721;2376;1004;3453
310060;201801;3325;9655;2874;9063;158;678;2345;7317;2503;7995
310070;201801;349;872;251;700;5;14;181;491;186;505
310080;201801;762;2111;550;1705;70;264;225;653;295;917
310090;201801;4597;12953;3856;11740;418;1385;2685;8132;3103;9517
310100;201801;3439;9958;2877;9046;148;604;2250;6952;2398;7556
310110;201801;4965;13483;4021;11845;734;2441;1894;5320;2628;7761
310120;201801;660;1760;447;1401;82;312;200;545;282;857
310130;201801;385;1120;324;1015;60;228;175;491;235;719
310140;201801;183;601;144;533;43;193;43;137;86;330
310150;201801;4455;13176;3609;11518;792;2715;1224;3842;2016;6557
310160;201801;6827;20026;5480;17602;1545;5460;1173;3635;2718;9095
310163;201801;1073;3270;879;2914;276;1002;240;735;516;1737
310170;201801;9001;24271;7618;22169;823;2494;5295;15424;6118;17918
310180;201801;1635;4470;1350;4034;124;471;894;2571;1018;3042
310190;201801;2970;9355;2532;8525;665;2443;306;986;971;3429
310200;201801;1746;5524;1392;4798;278;1059;502;1662;780;2721
310205;201801;1098;3133;840;2746;98;312;496;1679;594;1991
310210;201801;2708;7270;2260;6606;118;390;1693;4898;1811;5288
310220;201801;1026;2914;868;2669;107;379;593;1768;700;2147
310230;201801;2339;6837;1962;6079;252;946;1147;3344;1399;4290
310240;201801;889;3040;793;2861;87;373;524;1849;611;2222
310250;201801;908;2724;791;2512;103;406;496;1480;599;1886
310260;201801;2821;8397;1941;6715;472;1866;293;792;765;2658
310270;201801;2652;7004;2117;6265;138;529;1678;4859;1816;5388
310280;201801;2288;5688;1813;4981;221;730;1118;2942;1339;3672
310285;201801;1939;6591;1708;6202;181;731;1112;4115;1293;4846
310290;201801;1126;3202;1002;2983;227;787;529;1420;756;2207
310300;201801;1557;5005;1430;4795;275;1084;720;2261;995;3345
310310;201801;306;801;215;637;37;108;110;326;147;434
310320;201801;500;1341;324;1022;26;106;165;489;191;595
310330;201801;505;1225;315;879;39;122;129;310;168;432
310340;201801;7928;22608;6401;20024;1175;3634;3080;10008;4255;13642
310350;201801;12615;32092;8805;25939;2215;7036;2442;7044;4657;14080
310360;201801;465;1236;396;1147;15;57;306;863;321;920
310370;201801;1361;4432;1169;4056;239;883;445;1553;684;2436
310375;201801;1025;2732;689;2168;112;372;264;834;376;1206
310380;201801;366;892;200;595;39;118;71;191;110;309
310390;201801;442;1432;374;1295;102;372;81;234;183;606
310400;201801;9274;24445;6784;20445;1304;4371;2782;8100;4086;12471
310410;201801;737;2258;496;1814;129;523;111;370;240;893
310420;201801;4049;11009;2687;8262;538;1838;562;1527;1100;3365
310430;201801;1300;3927;902;3141;212;785;178;577;390;1362
310440;201801;558;1491;392;1188;44;174;204;594;248;768
310445;201801;1328;4038;1000;3407;63;239;703;2380;766;2619
310450;201801;4624;12188;3498;10438;257;824;2593;7763;2850;8587
310460;201801;1729;4824;1230;3899;271;928;330;1025;601;1953
310470;201801;3928;8684;3183;7735;282;860;2562;6073;2844;6933
310480;201801;1203;3314;873;2729;169;564;430;1295;599;1859
310490;201801;2964;8972;2419;7936;437;1695;1025;3163;1462;4858
310500;201801;1491;4444;1101;3687;224;807;456;1494;680;2301
310510;201801;1744;5169;1294;4268;339;1217;276;900;615;2117
310520;201801;1412;3550;1032;2946;87;241;655;1877;742;2118
310530;201801;880;2503;469;1526;73;256;64;170;137;426
310540;201801;3226;9742;2711;8826;718;2469;1027;3201;1745;5670
310550;201801;1201;3190;889;2680;118;457;548;1536;666;1993
310560;201801;13988;40048;11272;35350;2624;9162;3792;10976;6416;20138
310570;201801;1144;3254;947;2931;109;426;640;1903;749;2329
310590;201801;4179;11735;3485;10577;417;1423;1991;5890;2408;7313
310600;201801;1467;4529;1212;3977;197;686;548;1699;745;2385
310610;201801;509;1454;352;1178;63;257;158;479;221;736
310620;201801;152651;426673;119230;366157;27168;93449;41790;114822;68958;208271
310630;201801;4448;12743;3797;11594;307;1081;2685;8056;2992;9137
310640;201801;1017;3222;861;2916;231;865;244;778;475;1643
310650;201801;2594;7808;1969;6656;238;846;1068;3537;1306;4383
310660;201801;1278;3670;1101;3445;71;236;850;2636;921;2872
310665;201801;1290;3660;1092;3371;62;214;866;2699;928;2913
310670;201801;45485;128533;38320;115402;7212;23646;18939;54624;26151;78270
310680;201801;678;1750;574;1601;38;115;435;1189;473;1304
310690;201801;1532;4455;1184;3875;158;627;625;1933;783;2560
310700;201801;528;1216;394;1055;48;162;261;670;309;832
310710;201801;5624;17500;4210;15352;967;4106;418;1433;1385;5539
310720;201801;849;2330;714;2141;62;219;529;1554;591;1773
310730;201801;8878;26186;7748;24291;757;2719;5073;15676;5830;18395
310740;201801;5054;15043;3690;12271;749;2689;884;2811;1633;5500
310750;201801;1355;3356;964;2813;166;545;385;1039;551;1584
310760;201801;536;1544;424;1351;53;196;176;568;229;764
310770;201801;1064;3038;733;2525;109;428;344;1135;453;1563
310780;201801;3906;10255;3167;9060;211;653;2226;6274;2437;6927
310790;201801;1896;5977;1695;5632;352;1189;762;2667;1114;3856
310800;201801;2388;7489;1786;6285;504;2079;113;362;617;2441
310810;201801;1120;3006;949;2706;90;300;598;1627;688;1927
310820;201801;1177;3277;795;2554;187;654;211;658;398;1312
310825;201801;2860;9556;2325;8662;100;588;1817;6623;1917;7211
310830;201801;1424;4412;1124;3839;265;977;405;1343;670;2320
310840;201801;2098;5928;1460;4770;308;1077;351;1046;659;2123
310850;201801;1490;4251;1286;3981;80;368;983;2945;1063;3313
310855;201801;3135;8857;2525;7948;265;980;1782;5515;2047;6495
310860;201801;6967;20747;5727;18357;568;1916;3536;11386;4104;13302
310870;201801;1049;2629;794;2237;153;446;483;1351;636;1797
310880;201801;982;2996;789;2616;96;356;473;1539;569;1895
310890;201801;2380;6906;1717;5752;423;1577;274;799;697;2376
310900;201801;4527;13226;3431;11103;624;2261;1453;4355;2077;6616
310910;201801;1825;4955;1117;3586;144;526;142;365;286;891
310920;201801;1838;5151;1418;4465;243;834;745;2324;988;3158
310925;201801;962;2916;820;2676;138;503;522;1654;660;2157
310930;201801;5976;16168;4428;13729;771;2527;2305;7366;3076;9893
310940;201801;6119;16271;4946;14511;462;1509;3276;9459;3738;10968
310945;201801;1243;3405;1064;3155;79;265;707;2057;786;2322
310950;201801;1996;6056;1429;4860;298;1148;478;1498;776;2646
310960;201801;732;1865;439;1336;74;260;140;446;214;706
310970;201801;1149;3618;843;2961;204;767;209;684;413;1451
310980;201801;378;888;230;645;27;87;144;378;171;465
310990;201801;1229;3721;958;3159;210;730;348;1102;558;1832
311000;201801;4099;12114;3230;10671;908;3252;1186;3770;2094;7022
311010;201801;745;2377;643;2142;231;826;226;732;457;1558
311020;201801;969;2669;693;2158;104;367;306;889;410;1256
311030;201801;1642;4390;1101;3411;301;1063;313;863;614;1926
311040;201801;379;1232;309;1063;77;263;69;212;146;475
311050;201801;2291;6509;1889;5863;454;1560;713;2133;1167;3693
311060;201801;2647;7426;1853;5747;292;1056;664;1841;956;2897
311070;201801;1672;4901;1273;4191;209;827;559;1732;768;2559
311080;201801;861;2374;713;2113;105;376;407;1109;512;1485
311090;201801;1954;6637;1573;5931;415;1730;479;1778;894;3508
311100;201801;2028;6243;1424;5026;392;1562;180;555;572;2117
311110;201801;3224;7424;2167;5914;502;1426;917;2568;1419;3994
311115;201801;1202;3368;998;3070;75;296;752;2260;827;2556
311120;201801;6894;18871;5131;15636;981;3352;1608;4387;2589;7739
311130;201801;1934;5600;1569;5038;191;742;761;2335;952;3077
311140;201801;1236;3180;923;2745;65;218;605;1832;670;2050
311150;201801;1468;4954;1274;4587;196;753;743;2663;939;3416
311160;201801;3729;11700;2803;10018;893;3483;644;2226;1537;5709
311170;201801;828;2351;644;2036;51;182;363;1171;414;1353
311180;201801;1211;3048;825;2452;213;707;285;838;498;1545
311190;201801;1045;2968;805;2511;141;509;288;825;429;1334
311200;201801;1704;4969;1277;4098;360;1232;226;681;586;1913
311205;201801;905;2930;768;2653;80;353;426;1445;506;1798
311210;201801;990;3050;892;2925;144;441;624;2110;768;2551
311220;201801;775;2344;637;2066;125;453;271;806;396;1259
311230;201801;7971;24950;6035;20891;1254;4602;1855;6649;3109;11251
311240;201801;929;2718;742;2426;155;553;372;1192;527;1745
311250;201801;838;2517;690;2271;164;578;273;864;437;1442
311260;201801;2204;5688;1593;4691;323;1044;621;1731;944;2775
311265;201801;1217;3301;946;2872;95;329;602;1798;697;2127
311270;201801;3245;9981;2835;9380;236;1090;1981;6218;2217;7308
311280;201801;1184;3255;626;2025;105;377;128;387;233;764
311290;201801;1908;6087;1780;5803;217;698;1194;3907;1411;4605
311300;201801;4517;13643;3840;12542;225;1060;2954;9444;3179;10504
311310;201801;630;1937;536;1748;105;356;183;549;288;905
311320;201801;3244;10448;2878;9630;481;1848;1223;3775;1704;5623
311330;201801;4571;12977;3926;11905;553;1863;2122;6508;2675;8371
311340;201801;10872;33275;8974;29645;2647;9245;2161;7237;4808;16482
311350;201801;2179;5842;1657;4899;207;684;826;2255;1033;2939
311360;201801;863;2433;711;2220;334;1136;122;383;456;1519
311370;201801;4091;11189;3185;9656;304;1168;1784;5090;2088;6258
311380;201801;437;1393;345;1203;98;343;104;382;202;725
311390;201801;1720;5767;1459;5402;610;2591;368;1175;978;3766
311400;201801;1415;4200;1071;3531;175;678;430;1271;605;1949
311410;201801;1581;5168;1380;4908;301;1189;675;2386;976;3575
311420;201801;1770;5576;1205;4279;195;751;129;346;324;1097
311430;201801;3486;9898;2344;7578;386;1324;589;1886;975;3210
311440;201801;2436;7478;1764;6209;500;1979;397;1378;897;3357
311450;201801;1863;6047;1434;5193;379;1503;277;890;656;2393
311455;201801;993;2481;700;2014;189;550;227;645;416;1195
311460;201801;560;1806;404;1497;91;420;106;352;197;772
311470;201801;409;1374;322;1161;76;301;60;197;136;498
311480;201801;883;2220;739;2014;107;294;450;1181;557;1475
311490;201801;212;728;185;652;56;224;70;216;126;440
311500;201801;429;1172;322;992;45;161;165;510;210;671
311510;201801;2708;7914;1947;6497;468;1801;471;1514;939;3315
311520;201801;584;1808;541;1723;133;463;263;795;396;1258
311530;201801;9547;23569;6361;18352;1546;5026;1601;4442;3147;9468
311535;201801;746;2101;491;1624;106;423;117;367;223;790
311540;201801;563;1869;515;1784;137;474;241;853;378;1327
311545;201801;2186;6211;1860;5797;122;506;1363;4142;1485;4648
311547;201801;1502;4039;1300;3722;50;172;1007;2870;1057;3042
311550;201801;2777;8340;2228;7259;390;1499;810;2482;1200;3981
311560;201801;258;619;196;547;27;81;111;286;138;367
311570;201801;1951;4784;1453;4086;57;174;1156;3358;1213;3532
311580;201801;2336;4442;1607;3612;226;418;1018;2468;1244;2886
311590;201801;496;1461;411;1334;83;315;199;631;282;946
311600;201801;1319;3637;1092;3341;106;327;831;2550;937;2877
311610;201801;2463;8569;2155;7883;524;1869;894;3354;1418;5223
311615;201801;3005;9166;2466;8294;211;863;1775;5883;1986;6746
311620;201801;390;1144;344;1068;31;114;256;782;287;896
311630;201801;1355;3847;1110;3397;79;262;773;2303;852;2565
311640;201801;599;1901;494;1697;107;410;199;667;306;1077
311650;201801;2020;5579;1737;5138;174;630;1132;3216;1306;3846
311660;201801;2880;8665;2129;7200;421;1524;409;1219;830;2743
311670;201801;1552;4215;1235;3718;228;767;528;1617;756;2384
311680;201801;2076;6280;1655;5507;254;899;1028;3393;1282;4292
311690;201801;570;1311;453;1166;29;76;348;913;377;989
311700;201801;2243;5634;1751;4963;49;181;1410;3919;1459;4100
311710;201801;1545;4622;1080;3705;310;1151;319;1119;629;2270
311720;201801;413;1310;344;1176;45;176;172;565;217;741
311730;201801;5011;12437;2972;8837;942;3120;402;1086;1344;4206
311740;201801;759;2306;708;2241;51;147;622;2001;673;2148
311750;201801;3981;12330;3352;11306;399;1629;2069;6704;2468;8333
311760;201801;639;2036;556;1862;114;444;173;490;287;934
311770;201801;1976;6071;1564;5282;351;1277;525;1698;876;2975
311780;201801;1220;3967;948;3373;212;877;239;726;451;1603
311783;201801;2039;6257;1712;5666;64;300;1391;4525;1455;4825
311787;201801;709;2177;514;1709;86;319;182;522;268;841
311790;201801;1541;4189;1064;3374;229;819;397;1245;626;2064
311800;201801;4889;15703;4167;14047;852;3191;579;1790;1431;4981
311810;201801;983;3173;819;2847;61;248;490;1692;551;1940
311820;201801;695;1954;561;1693;93;352;327;906;420;1258
311830;201801;8226;25355;6016;20456;1583;5859;567;1866;2150;7725
311840;201801;2882;8265;2532;7737;361;1264;1667;5011;2028;6275
311850;201801;299;876;253;801;31;92;159;504;190;596
311860;201801;51877;141209;41978;124986;6849;21723;23201;67740;30050;89463
311870;201801;1957;5544;1378;4438;254;945;495;1429;749;2374
311880;201801;6400;17626;5537;16446;468;1318;4125;12480;4593;13798
311890;201801;1403;3858;1129;3411;197;640;605;1758;802;2398
311900;201801;687;1901;545;1684;63;225;356;1087;419;1312
311910;201801;4289;11598;3304;10308;691;2254;1536;4832;2227;7086
311920;201801;1961;5905;1624;5329;175;636;942;3046;1117;3682
311930;201801;3242;8617;2581;7610;1025;3222;700;1924;1725;5146
311940;201801;13361;38124;10364;32314;1765;6093;4031;11851;5796;17944
311950;201801;2211;6315;1695;5439;118;506;1166;3641;1284;4147
311960;201801;564;1433;478;1293;40;177;326;762;366;939
311970;201801;438;1458;290;1078;51;219;58;193;109;412
311980;201801;460;1304;289;965;39;141;85;274;124;415
311990;201801;522;1317;356;1086;108;378;137;396;245;774
311995;201801;991;2905;563;1889;35;133;52;115;87;248
312000;201801;564;1615;491;1505;35;111;352;1096;387;1207
312010;201801;884;2754;704;2381;80;291;367;1218;447;1509
312015;201801;1320;4072;1174;3811;95;399;846;2654;941;3053
312020;201801;1105;3471;962;3230;209;752;391;1289;600;2041
312030;201801;1943;5147;1714;4877;38;178;1561;4379;1599;4557
312040;201801;761;2533;607;2200;105;446;209;702;314;1148
312050;201801;1234;4129;996;3629;253;1067;236;748;489;1815
312060;201801;833;2314;626;2035;159;535;283;915;442;1450
312070;201801;898;2711;634;2155;88;336;318;1043;406;1379
312080;201801;2740;7089;2034;6015;199;700;1214;3370;1413;4070
312083;201801;951;2583;762;2288;96;313;499;1452;595;1765
312087;201801;2207;6181;1911;5766;111;352;1486;4556;1597;4908
312090;201801;9119;26234;7172;22912;1705;5770;2856;9075;4561;14845
312100;201801;1501;4652;1103;3926;139;612;514;1743;653;2355
312110;201801;1000;3325;847;2996;247;984;206;646;453;1630
312120;201801;639;1930;496;1658;116;445;178;525;294;970
312125;201801;1205;3609;1073;3409;157;483;778;2523;935;3006
312130;201801;871;2317;671;1969;77;249;271;761;348;1010
312140;201801;789;2447;659;2157;158;566;231;680;389;1246
312150;201801;478;1397;405;1229;19;79;257;724;276;803
312160;201801;7616;23644;6208;20868;1124;4290;2513;7994;3637;12284
312170;201801;843;2380;678;2083;42;145;459;1358;501;1503
312180;201801;1336;3918;1095;3450;180;634;516;1548;696;2182
312190;201801;541;1688;400;1386;110;412;70;252;180;664
312200;201801;4735;13184;3870;11672;755;2345;2095;6291;2850;8636
312210;201801;1247;3090;921;2629;103;355;597;1647;700;2002
312220;201801;2009;6449;1818;6189;129;410;1388;4827;1517;5237
312230;201801;11478;32945;8119;26678;2486;9008;1040;3116;3526;12124
312235;201801;1582;4519;1359;4210;136;486;964;2925;1100;3411
312240;201801;778;2582;607;2219;148;594;145;526;293;1120
312245;201801;2385;6565;2077;6142;81;296;1719;5063;1800;5359
312247;201801;837;2282;615;1922;157;500;272;892;429;1392
312250;201801;1058;2838;736;2241;138;448;288;842;426;1290
312260;201801;930;2725;749;2438;75;284;514;1611;589;1895
312270;201801;684;1978;536;1680;40;177;274;775;314;952
312280;201801;410;1294;339;1148;112;389;37;129;149;518
312290;201801;747;2427;666;2279;128;491;230;771;358;1262
312300;201801;922;2865;675;2280;168;622;86;223;254;845
312310;201801;782;2719;692;2538;119;484;313;1129;432;1613
312320;201801;1894;5182;1437;4349;423;1392;306;873;729;2265
312330;201801;891;2611;741;2384;85;316;532;1670;617;1986
312340;201801;283;760;213;646;29;96;110;325;139;421
312350;201801;271;640;230;598;28;80;173;440;201;520
312352;201801;1618;4872;1400;4510;171;548;910;3085;1081;3633
312360;201801;2698;8358;2121;7118;483;1770;484;1544;967;3314
312370;201801;1713;4981;1462;4542;316;1091;670;1980;986;3071
312380;201801;2122;5175;1807;4767;39;100;1596;4250;1635;4350
312385;201801;1237;3525;1026;3155;158;558;622;1811;780;2369
312390;201801;1975;6012;1523;5171;319;1180;413;1283;732;2463
312400;201801;2909;8964;2346;7882;863;3012;589;2033;1452;5045
312410;201801;11285;33860;9452;30567;1868;6401;4387;14008;6255;20409
312420;201801;3707;11066;3344;10409;608;2008;1817;5611;2425;7619
312430;201801;7926;22106;6607;19786;697;2260;4331;12898;5028;15158
312440;201801;891;2804;699;2381;307;1124;95;302;402;1426
312450;201801;1163;3701;907;3204;267;989;320;1181;587;2170
312460;201801;392;1067;287;917;53;187;158;518;211;705
312470;201801;519;1384;334;1053;60;229;110;308;170;537
312480;201801;1215;3041;842;2552;120;415;501;1461;621;1876
312490;201801;1952;4991;1508;4296;255;778;809;2221;1064;2999
312500;201801;797;2111;646;1897;73;261;397;1122;470;1383
312510;201801;3627;10218;2828;8686;432;1381;1289;3844;1721;5225
312520;201801;204;603;166;544;46;152;68;232;114;384
312530;201801;556;1567;487;1474;31;112;398;1205;429;1317
312540;201801;1411;4252;927;3181;203;749;377;1282;580;2031
312550;201801;770;2212;602;1843;58;187;334;937;392;1124
312560;201801;2001;5315;1676;4862;88;347;1341;3826;1429;4173
312570;201801;2288;6271;1797;5533;510;1642;669;2096;1179;3738
312580;201801;530;1652;423;1406;47;192;173;548;220;740
312590;201801;1668;5210;1398;4666;169;713;719;2226;888;2939
312595;201801;1741;5647;1592;5338;284;944;925;3189;1209;4133
312600;201801;907;2501;589;2009;92;375;249;833;341;1208
312610;201801;6382;17032;4343;13343;904;3025;1038;3038;1942;6063
312620;201801;2418;6389;1756;5463;73;295;1335;4261;1408;4556
312630;201801;274;884;230;802;58;232;78;272;136;504
312640;201801;630;1767;421;1396;60;202;131;439;191;641
312650;201801;2059;5651;1428;4405;126;458;903;2653;1029;3111
312660;201801;1370;3488;1066;3030;115;388;702;1928;817;2316
312670;201801;5191;14546;4310;13331;511;1965;2625;7800;3136;9765
312675;201801;1303;3795;1055;3344;88;364;794;2443;882;2807
312680;201801;1343;3956;1154;3690;99;406;844;2638;943;3044
312690;201801;2161;5458;1690;4831;177;540;1163;3251;1340;3791
312695;201801;893;2794;809;2646;90;283;588;1947;678;2230
312700;201801;1918;5462;1455;4601;158;529;818;2546;976;3075
312705;201801;1272;3499;1049;3117;44;163;782;2261;826;2424
312707;201801;1404;4385;1077;3753;90;426;620;2054;710;2480
312710;201801;6479;15322;3855;11325;1187;3831;769;2304;1956;6135
312720;201801;989;2911;746;2487;90;351;365;1166;455;1517
312730;201801;1755;4181;1271;3574;76;242;843;2356;919;2598
312733;201801;1555;4140;1196;3489;45;139;766;2176;811;2315
312735;201801;723;1979;623;1806;94;341;403;1059;497;1400
312737;201801;796;1969;565;1616;124;378;246;687;370;1065
312738;201801;514;1475;347;1147;69;269;139;425;208;694
312740;201801;335;837;190;616;56;194;39;100;95;294
312750;201801;1232;4127;1075;3833;177;731;547;1846;724;2577
312760;201801;1897;5843;1386;4808;281;1025;397;1350;678;2375
312770;201801;39921;103769;27662;82772;6611;21119;8031;23387;14642;44506
312780;201801;2558;8395;2250;7866;292;1157;1346;4670;1638;5827
312790;201801;330;821;194;622;27;108;74;208;101;316
312800;201801;4854;14940;3810;12802;928;3421;1241;4072;2169;7493
312810;201801;1895;5441;1265;4255;309;1142;319;951;628;2093
312820;201801;1905;5278;1575;4699;69;266;1081;3129;1150;3395
312825;201801;1255;3223;1106;3038;38;126;921;2528;959;2654
312830;201801;2417;7226;1658;5732;412;1567;324;1093;736;2660
312840;201801;1152;3602;907;3121;150;592;285;874;435;1466
312850;201801;791;2212;583;1853;84;320;257;770;341;1090
312860;201801;1436;3750;948;2949;239;789;248;745;487;1534
312870;201801;5643;16885;3734;12723;605;2271;946;2968;1551;5239
312880;201801;1357;3716;1124;3375;57;179;699;2192;756;2371
312890;201801;1945;5527;1279;4161;212;725;474;1563;686;2288
312900;201801;1184;3337;990;3077;88;293;630;2015;718;2308
312910;201801;1554;2984;881;2112;137;349;433;1010;570;1359
312920;201801;914;2684;690;2298;135;530;317;983;452;1513
312930;201801;2093;5750;1722;5175;401;1255;763;2262;1164;3517
312940;201801;855;2664;744;2466;165;580;314;1040;479;1620
312950;201801;2603;7177;1984;6204;643;2136;584;1829;1227;3965
312960;201801;1930;5302;1658;4911;123;351;1233;3731;1356;4082
312965;201801;1737;5325;1461;4796;103;357;941;3077;1044;3434
312970;201801;1012;3162;781;2775;192;756;260;883;452;1639
312980;201801;20696;62421;17811;57140;3578;12672;8308;25378;11886;38050
312990;201801;443;1268;295;1010;76;308;110;364;186;672
313000;201801;453;1416;364;1259;63;286;143;443;206;729
313005;201801;2584;7771;2271;7236;205;753;1603;5019;1808;5772
313010;201801;4327;12985;3557;11636;747;2727;1889;5961;2636;8688
313020;201801;925;2976;638;2280;100;403;77;218;177;621
313030;201801;1286;3267;904;2681;132;466;480;1380;612;1846
313040;201801;772;2482;650;2201;70;281;328;1045;398;1326
313050;201801;1761;5211;1260;4437;265;1104;337;1051;602;2155
313055;201801;1658;4938;1509;4721;52;182;1312;4083;1364;4265
313060;201801;930;2571;670;2111;201;693;134;384;335;1077
313065;201801;1818;5750;1557;5338;126;506;1165;3981;1291;4487
313070;201801;921;2568;737;2257;119;390;371;1113;490;1503
313080;201801;402;1145;292;931;75;280;79;194;154;474
313090;201801;4802;13498;4054;12251;1059;3431;1927;5788;2986;9219
313100;201801;1426;3818;1110;3343;67;224;848;2559;915;2783
313110;201801;1519;4221;1099;3438;133;480;520;1516;653;1996
313115;201801;2438;7703;2176;7171;364;1295;1065;3311;1429;4606
313120;201801;3615;8909;2849;7947;318;982;1860;5221;2178;6203
313130;201801;26027;74605;21451;65817;3483;11866;10161;29623;13644;41489
313140;201801;519;1284;359;1034;20;75;248;695;268;770
313150;201801;1282;3889;1029;3405;298;1033;269;877;567;1910
313160;201801;919;2559;720;2220;88;306;426;1269;514;1575
313170;201801;11103;35100;8143;28650;1622;5988;2596;8845;4218;14833
313180;201801;2286;6272;1688;5152;276;917;789;2333;1065;3250
313190;201801;4033;12549;3087;10502;606;2210;879;2810;1485;5020
313200;201801;1109;3321;955;3041;51;191;753;2345;804;2536
313210;201801;3877;11682;3167;10437;512;1837;1736;5539;2248;7376
313220;201801;1650;4617;1164;3679;212;772;408;1133;620;1905
313230;201801;2535;8031;2314;7743;95;338;1991;6689;2086;7027
313240;201801;8500;23878;5988;19340;1164;4183;2339;7109;3503;11292
313250;201801;6278;19268;5207;17312;578;2105;2713;8920;3291;11025
313260;201801;651;1819;441;1387;55;211;179;546;234;757
313270;201801;5462;15657;4359;13802;867;2861;2356;7493;3223;10354
313280;201801;388;1185;274;944;51;196;72;229;123;425
313290;201801;783;2626;626;2390;249;1037;112;395;361;1432
313300;201801;1683;5151;1327;4423;370;1340;197;574;567;1914
313310;201801;997;3244;850;2950;163;643;180;530;343;1173
313320;201801;2185;6044;1548;5036;303;1104;673;2166;976;3270
313330;201801;4026;11598;3273;10375;263;1131;2146;6543;2409;7674
313340;201801;1454;3445;1059;2864;161;447;651;1777;812;2224
313350;201801;2290;6909;1730;5747;299;1093;527;1634;826;2727
313360;201801;1287;3465;915;2827;168;648;466;1325;634;1973
313370;201801;1203;3851;1083;3611;154;566;588;1909;742;2475
313375;201801;1967;5213;1329;4158;251;920;368;1093;619;2013
313380;201801;5416;14968;4076;12531;912;3133;1554;4332;2466;7465
313390;201801;865;2881;779;2729;59;256;511;1734;570;1990
313400;201801;3528;9367;2930;8608;223;653;2347;6879;2570;7532
313410;201801;1198;3265;980;2915;113;386;723;2115;836;2501
313420;201801;16080;37579;9211;26108;1907;6040;1355;3901;3262;9941
313430;201801;903;2750;683;2309;121;501;268;793;389;1294
313440;201801;5948;13326;4014;10896;314;834;2615;7218;2929;8052
313450;201801;642;1866;475;1534;101;334;138;403;239;737
313460;201801;2109;6630;1729;6012;418;1707;724;2313;1142;4020
313470;201801;3056;7853;2514;7120;252;695;1773;5047;2025;5742
313480;201801;840;2438;567;1891;85;333;170;506;255;839
313490;201801;1536;3750;758;2580;265;1065;71;238;336;1303
313500;201801;405;1315;325;1114;44;172;126;401;170;573
313505;201801;8899;25499;8013;24416;345;1136;6971;21342;7316;22478
313507;201801;1408;3703;1204;3421;63;228;927;2619;990;2847
313510;201801;13154;37583;11218;34244;1455;4894;5841;17438;7296;22332
313520;201801;13438;40535;11128;36431;987;3701;7478;24111;8465;27812
313530;201801;491;1426;404;1285;28;97;189;568;217;665
313535;201801;2472;6984;2172;6438;177;506;1488;4383;1665;4889
313540;201801;866;2690;655;2137;160;542;210;675;370;1217
313545;201801;1178;4101;1021;3792;175;727;564;1998;739;2725
313550;201801;1758;5451;1502;4942;365;1273;724;2297;1089;3570
313560;201801;2438;5187;1826;4468;98;255;1488;3621;1586;3876
313570;201801;961;3083;785;2727;197;758;306;1014;503;1772
313580;201801;5548;15435;4349;13556;711;2341;2237;7218;2948;9559
313590;201801;910;2669;703;2354;298;1089;179;596;477;1685
313600;201801;3702;10619;3132;9696;205;781;2400;7344;2605;8125
313610;201801;990;2739;820;2427;122;368;513;1496;635;1864
313620;201801;5585;16047;4656;14383;1002;3325;2019;6123;3021;9448
313630;201801;8156;21373;5741;17790;886;2988;2836;8987;3722;11975
313640;201801;955;2388;605;1883;181;608;195;571;376;1179
313650;201801;1832;5764;1558;5322;129;529;1023;3484;1152;4013
313652;201801;817;2808;756;2687;122;492;455;1546;577;2038
313655;201801;976;2905;799;2634;67;261;536;1732;603;1993
313657;201801;1351;3766;1043;3273;71;308;742;2184;813;2492
313660;201801;854;2635;727;2372;135;548;354;1065;489;1613
313665;201801;4351;12791;3512;11225;547;1972;1872;5792;2419;7764
313670;201801;42431;116965;29793;93503;6048;20683;10235;30820;16283;51503
313680;201801;992;2846;857;2632;80;283;536;1598;616;1881
313690;201801;825;2835;686;2541;139;527;213;812;352;1339
313695;201801;1535;4588;1234;4077;101;397;866;2833;967;3230
313700;201801;3340;11045;2856;10432;306;1162;2204;8151;2510;9313
313710;201801;1395;3585;1016;3005;104;326;618;1829;722;2155
313720;201801;5481;16195;4075;13278;743;2711;1454;4357;2197;7068
313730;201801;1247;3133;942;2723;84;241;589;1674;673;1915
313740;201801;1774;6396;1482;5633;365;1520;156;546;521;2066
313750;201801;1958;5657;1528;4800;370;1294;503;1421;873;2715
313753;201801;2030;5201;1463;4296;196;650;773;2221;969;2871
313760;201801;4958;14523;3738;12114;932;3264;1264;3879;2196;7143
313770;201801;3567;10614;2942;9709;335;1171;1873;6217;2208;7388
313780;201801;3935;10821;2984;9281;432;1519;854;2692;1286;4211
313790;201801;443;1448;417;1402;68;247;238;765;306;1012
313800;201801;1265;3176;1034;2845;70;231;780;2160;850;2391
313810;201801;1581;4316;1307;3912;109;370;928;2797;1037;3167
313820;201801;12563;32148;9337;26508;1497;4836;3733;9950;5230;14786
313830;201801;336;1051;299;984;67;238;138;467;205;705
313835;201801;874;2768;758;2563;73;295;426;1383;499;1678
313840;201801;6630;18411;5030;15696;1242;4185;1105;3364;2347;7549
313850;201801;1010;2643;843;2375;121;421;461;1175;582;1596
313860;201801;2709;7782;2001;6288;405;1360;665;1963;1070;3323
313862;201801;1429;3377;842;2485;88;279;437;1284;525;1563
313865;201801;2193;6479;1961;6133;181;608;1440;4456;1621;5064
313867;201801;1097;3675;928;3322;294;1098;353;1259;647;2357
313868;201801;1686;5469;1417;4921;121;498;1035;3539;1156;4037
313870;201801;799;2269;626;1975;135;472;207;578;342;1050
313880;201801;1371;3933;1078;3463;230;812;407;1172;637;1984
313890;201801;2003;4863;1480;4183;181;559;887;2580;1068;3139
313900;201801;3651;12209;3057;10976;905;3558;726;2591;1631;6149
313910;201801;656;2089;513;1814;139;516;87;309;226;825
313920;201801;3083;10021;2566;9041;519;1857;1308;4711;1827;6568
313925;201801;1718;4610;1329;3879;246;669;751;2244;997;2913
313930;201801;6127;21115;5180;19476;488;1754;3515;13934;4003;15688
313940;201801;8527;26386;6360;22641;1470;5891;1628;6268;3098;12159
313950;201801;4312;10989;3229;9415;728;2609;1546;4198;2274;6807
313960;201801;5364;13720;3729;11071;855;2760;1146;3212;2001;5972
313970;201801;1316;3888;1166;3643;88;345;704;2219;792;2564
313980;201801;1336;3812;891;3040;141;560;312;1007;453;1567
313990;201801;1648;5841;1368;5165;414;1687;364;1259;778;2946
314000;201801;8814;25502;7639;23334;651;2448;5018;15060;5669;17508
314010;201801;1242;3217;1012;2906;51;195;768;2157;819;2352
314015;201801;2076;5951;1633;5251;223;846;882;2758;1105;3604
314020;201801;507;1474;317;1066;63;249;64;208;127;457
314030;201801;820;2569;633;2164;91;340;280;936;371;1276
314040;201801;733;2058;608;1817;119;394;258;731;377;1125
314050;201801;1556;4622;1216;3935;204;772;562;1677;766;2449
314053;201801;1662;5064;1421;4679;191;607;951;3313;1142;3920
314055;201801;2228;6336;1928;5898;48;214;1614;4920;1662;5134
314060;201801;1131;3314;887;2909;56;223;610;1970;666;2193
314070;201801;4294;12508;3370;10805;809;2691;1195;3711;2004;6402
314080;201801;1744;5222;1251;4136;216;856;346;1034;562;1890
314085;201801;2073;6558;1738;6042;411;1559;739;2549;1150;4108
314090;201801;3467;10894;3022;10128;296;1193;1921;6391;2217;7584
314100;201801;3203;7691;2652;6951;77;171;2218;5960;2295;6131
314110;201801;4061;12422;3466;11224;631;2269;1634;4926;2265;7195
314120;201801;890;2113;412;1313;100;361;60;187;160;548
314130;201801;752;2109;386;1310;59;219;111;365;170;584
314140;201801;4759;14256;3688;12086;680;2313;1522;4945;2202;7258
314150;201801;1522;4067;1192;3502;131;410;712;2034;843;2444
314160;201801;2481;6570;1830;5480;262;829;862;2661;1124;3490
314170;201801;1025;2968;835;2585;109;364;482;1413;591;1777
314180;201801;5250;15288;4403;13964;713;2444;2367;7548;3080;9992
314190;201801;730;2129;538;1817;101;364;252;875;353;1239
314200;201801;2899;8511;2444;7693;175;711;1740;5273;1915;5984
314210;201801;1991;5419;1690;4922;157;514;1028;2928;1185;3442
314220;201801;1390;4101;993;3355;284;1072;247;760;531;1832
314225;201801;1236;3545;1086;3335;69;232;806;2491;875;2723
314230;201801;716;2071;628;1947;76;288;397;1205;473;1493
314240;201801;1072;3096;851;2743;208;728;341;1126;549;1854
314250;201801;537;1555;357;1148;67;232;125;361;192;593
314260;201801;966;3188;807;2865;188;785;300;959;488;1744
314270;201801;3102;9252;2524;8253;131;533;1875;6010;2006;6543
314280;201801;3390;8336;2126;6166;379;1230;770;2090;1149;3320
314290;201801;4541;12257;3845;11102;526;1566;2435;6941;2961;8507
314300;201801;1543;4812;1199;4066;317;1136;341;1127;658;2263
314310;201801;5414;14924;4048;12515;1259;4175;967;2779;2226;6954
314315;201801;844;3144;746;2925;60;293;536;2055;596;2348
314320;201801;2823;7843;1934;6374;462;1639;717;2372;1179;4011
314330;201801;49483;143671;39602;127096;11818;39984;9514;30912;21332;70896
314340;201801;2571;6736;1394;4465;267;982;202;476;469;1458
314345;201801;1290;4122;1141;3858;149;525;726;2401;875;2926
314350;201801;1116;3093;779;2504;181;640;167;513;348;1153
314360;201801;684;2072;419;1474;73;294;90;305;163;599
314370;201801;595;1765;512;1632;47;176;368;1146;415;1322
314380;201801;1171;3441;821;2763;219;808;118;414;337;1222
314390;201801;11975;33049;8227;26083;1834;6274;1964;5602;3798;11876
314400;201801;4296;12690;3498;11411;1022;3465;1194;4037;2216;7502
314410;201801;2736;8001;1983;6540;361;1309;684;2443;1045;3752
314420;201801;740;1975;572;1729;23;124;437;1262;460;1386
314430;201801;6094;17086;4887;14971;1071;3497;1705;5214;2776;8711
314435;201801;1438;4319;1231;3995;62;285;911;2898;973;3183
314437;201801;949;2500;745;2217;28;107;482;1447;510;1554
314440;201801;534;1587;429;1406;123;454;134;387;257;841
314450;201801;1428;4075;1199;3710;181;693;664;1907;845;2600
314460;201801;3621;11694;2717;9663;646;2496;443;1537;1089;4033
314465;201801;2229;6683;1981;6199;72;304;1534;4680;1606;4984
314467;201801;951;2685;804;2448;25;74;621;1888;646;1962
314470;201801;2183;6657;1824;5919;386;1388;735;2209;1121;3597
314480;201801;5818;18219;4154;14299;765;2867;807;2503;1572;5370
314490;201801;866;2484;648;2036;95;336;369;1096;464;1432
314500;201801;1731;4718;1247;3892;244;785;400;1247;644;2032
314505;201801;1906;5092;1639;4725;134;446;1162;3309;1296;3755
314510;201801;1909;5014;1250;4088;282;999;438;1446;720;2445
314520;201801;3502;11493;2444;9062;463;1971;238;747;701;2718
314530;201801;5521;18740;5121;18002;598;2192;3425;12193;4023;14385
314535;201801;2677;7226;2219;6560;153;484;1677;4932;1830;5416
314537;201801;1085;3232;831;2788;85;330;541;1783;626;2113
314540;201801;385;1055;269;832;39;144;108;314;147;458
314545;201801;1570;4432;1395;4183;62;192;1153;3622;1215;3814
314550;201801;657;1673;471;1413;58;222;212;573;270;795
314560;201801;4054;13225;3314;11581;565;2170;1107;3669;1672;5839
314570;201801;290;840;221;705;29;107;113;357;142;464
314580;201801;484;1572;366;1313;86;335;48;169;134;504
314585;201801;757;2396;555;1960;101;432;219;713;320;1145
314587;201801;1895;5535;1507;4881;247;742;806;2677;1053;3419
314590;201801;2776;8946;2131;7507;404;1551;655;2188;1059;3739
314600;201801;1715;5166;1086;3874;256;1011;112;346;368;1357
314610;201801;7535;22685;6012;19911;1228;4657;2417;7672;3645;12329
314620;201801;1828;4860;1474;4368;84;262;1178;3464;1262;3726
314625;201801;1499;4704;1328;4445;115;569;981;3099;1096;3668
314630;201801;4848;13699;4057;12485;181;792;3206;9736;3387;10528
314640;201801;590;1563;442;1305;93;304;181;484;274;788
314650;201801;988;2606;669;2093;81;307;260;720;341;1027
314655;201801;1564;4501;1126;3653;245;765;450;1467;695;2232
314660;201801;313;794;207;590;13;29;106;287;119;316
314670;201801;1611;4108;1145;3337;96;327;702;1989;798;2316
314675;201801;1790;5069;1548;4652;130;456;1135;3350;1265;3806
314690;201801;2089;6400;1606;5559;509;1933;298;1000;807;2933
314700;201801;9333;29117;6346;22675;1540;6114;1154;4029;2694;10143
314710;201801;8089;23677;5786;18818;1138;4070;1153;3357;2291;7427
314720;201801;2224;7066;1693;5922;383;1464;413;1419;796;2883
314730;201801;2102;6124;1607;5227;416;1468;465;1392;881;2860
314740;201801;2767;8248;2263;7340;266;1033;1186;3713;1452;4746
314750;201801;336;1007;264;859;24;91;142;439;166;530
314760;201801;1797;5713;1279;4494;192;776;287;812;479;1588
314770;201801;1031;3140;552;1881;44;160;131;375;175;535
314780;201801;316;793;218;649;47;161;107;300;154;461
314790;201801;10225;30026;7678;25370;2709;9955;960;2763;3669;12718
314795;201801;1455;4137;1251;3787;65;275;962;2790;1027;3065
314800;201801;11446;31016;7061;22445;1562;5372;954;2747;2516;8119
314810;201801;9525;26763;7124;22546;2090;6995;1610;5161;3700;12156
314820;201801;891;2392;659;2002;110;396;338;966;448;1362
314830;201801;1515;4886;1305;4489;295;1106;641;2185;936;3291
314840;201801;893;2987;720;2726;85;434;461;1669;546;2103
314850;201801;1953;5205;1531;4519;98;365;1191;3444;1289;3809
314860;201801;3208;10195;2719;9217;418;1561;1564;5161;1982;6722
314870;201801;5826;16466;4703;14905;432;1468;3437;10952;3869;12420
314875;201801;1709;5376;1574;5198;103;302;1342;4479;1445;4781
314880;201801;897;2279;711;2025;40;91;501;1509;541;1600
314890;201801;470;1390;346;1120;58;214;128;370;186;584
314900;201801;656;1808;518;1572;114;366;179;547;293;913
314910;201801;1693;5239;1326;4633;322;1312;571;1887;893;3199
314915;201801;2293;7115;1967;6531;155;648;1316;4214;1471;4862
314920;201801;463;1221;341;1055;21;66;202;605;223;671
314930;201801;5359;16458;4227;14218;932;3362;1330;4290;2262;7652
314940;201801;385;1085;333;986;38;118;198;547;236;665
314950;201801;381;1066;265;885;32;116;108;349;140;465
314960;201801;711;1981;548;1660;74;270;304;846;378;1116
314970;201801;605;1938;513;1785;105;413;198;672;303;1085
314980;201801;1243;3676;992;3289;290;1078;106;331;396;1409
314990;201801;2330;7040;1639;5476;392;1482;335;971;727;2453
314995;201801;1567;4662;1324;4269;119;500;795;2429;914;2929
315000;201801;1067;2947;835;2573;83;301;517;1557;600;1858
315010;201801;414;1257;309;1038;69;281;113;337;182;618
315015;201801;2080;6195;1872;5922;218;734;1218;3972;1436;4706
315020;201801;815;2477;585;2013;92;373;274;887;366;1260
315030;201801;572;1676;428;1400;111;388;88;260;199;648
315040;201801;864;2566;787;2417;132;434;474;1437;606;1871
315050;201801;1197;3303;927;2910;101;373;481;1493;582;1866
315053;201801;1102;3169;896;2786;101;390;494;1481;595;1871
315057;201801;1612;5334;1423;4951;216;756;816;2849;1032;3605
315060;201801;618;1971;424;1560;100;387;77;286;177;673
315070;201801;660;1911;497;1601;137;472;146;442;283;914
315080;201801;2797;8767;2228;7523;508;1738;954;3235;1462;4973
315090;201801;796;2629;626;2261;127;499;169;572;296;1071
315100;201801;1160;3748;789;2827;158;660;273;888;431;1548
315110;201801;1339;3680;1062;3217;162;524;489;1491;651;2015
315120;201801;12289;29307;8743;24440;1097;3140;4465;13123;5562;16263
315130;201801;1273;3970;1085;3594;213;838;383;1181;596;2019
315140;201801;2790;8228;2217;7133;452;1663;981;2851;1433;4514
315150;201801;4204;10979;3017;8971;461;1513;1265;3691;1726;5204
315160;201801;1420;3790;989;3097;207;693;401;1215;608;1908
315170;201801;1501;4724;1105;3837;243;894;180;613;423;1507
315180;201801;16858;44998;9211;29425;1504;5447;1866;5329;3370;10776
315190;201801;1998;4904;1615;4345;327;903;1047;2785;1374;3688
315200;201801;3836;11924;2891;10105;878;3343;604;2051;1482;5394
315210;201801;7813;21919;5929;17862;841;2815;2461;6840;3302;9655
315213;201801;1125;3184;980;2978;29;87;783;2368;812;2455
315217;201801;2478;8029;1997;7145;153;728;1272;4411;1425;5139
315220;201801;8875;25100;7241;22251;2189;7031;2143;6591;4332;13622
315230;201801;2974;7650;2639;7250;83;137;2368;6809;2451;6946
315240;201801;2778;8458;2357;7771;580;2064;1151;3697;1731;5761
315250;201801;10002;29049;7642;24641;1496;5273;2910;9129;4406;14402
315260;201801;927;2820;569;1981;101;368;56;168;157;536
315270;201801;755;2330;537;1890;98;416;142;442;240;858
315280;201801;2870;7740;1693;5307;385;1287;268;813;653;2100
315290;201801;1231;3276;775;2526;239;833;188;637;427;1470
315300;201801;708;1791;475;1493;241;810;111;379;352;1189
315310;201801;1278;3823;994;3268;95;350;565;1787;660;2137
315320;201801;685;2023;508;1713;59;281;225;695;284;976
315330;201801;716;2563;408;1684;75;334;102;387;177;721
315340;201801;3227;8662;2486;7566;333;1097;1343;4019;1676;5116
315350;201801;1668;4584;1236;3876;111;381;604;1859;715;2240
315360;201801;1670;5257;1240;4298;221;830;414;1356;635;2186
315370;201801;458;1396;384;1241;69;223;176;561;245;784
315380;201801;202;650;149;528;38;149;31;99;69;248
315390;201801;1189;3686;885;3037;177;657;264;850;441;1507
315400;201801;4198;12152;3321;10511;506;1665;1657;5170;2163;6835
315410;201801;2239;5358;1743;4672;391;1127;715;1878;1106;3005
315415;201801;1162;3496;958;3178;305;1119;340;1119;645;2238
315420;201801;1196;3677;850;2992;192;695;115;363;307;1058
315430;201801;3556;9259;2595;7695;659;2253;840;2342;1499;4595
315440;201801;951;2714;798;2456;115;439;417;1160;532;1599
315445;201801;2036;5291;1539;4530;188;593;991;2889;1179;3482
315450;201801;2283;6817;1979;6333;289;908;1223;4004;1512;4912
315460;201801;30834;95361;26837;87774;8493;29648;7407;23127;15900;52775
315470;201801;467;1344;373;1188;28;104;197;603;225;707
315480;201801;1520;4446;1035;3430;227;800;239;792;466;1592
315490;201801;2944;7565;2097;6365;349;1167;703;2042;1052;3209
315500;201801;484;1383;300;964;26;98;133;376;159;474
315510;201801;1268;3606;1091;3322;52;205;895;2678;947;2883
315520;201801;1102;3182;864;2794;60;247;568;1773;628;2020
315530;201801;646;2061;507;1717;173;642;170;528;343;1170
315540;201801;1145;3303;839;2734;135;502;313;999;448;1501
315550;201801;1741;4806;1303;4128;282;1019;460;1404;742;2423
315560;201801;6049;19769;5397;18680;428;1664;3651;12667;4079;14331
315570;201801;1870;5678;1631;5223;137;526;905;2812;1042;3338
315580;201801;2272;6022;1778;5209;419;1391;556;1584;975;2975
315590;201801;902;2500;739;2238;95;329;355;1042;450;1371
315600;201801;2426;8146;1828;6963;277;1066;973;3868;1250;4934
315610;201801;948;2524;736;2128;131;481;319;765;450;1246
315620;201801;318;1052;289;1006;60;204;161;610;221;814
315630;201801;834;2500;685;2204;160;545;180;507;340;1052
315640;201801;392;1093;329;997;45;162;169;481;214;643
315645;201801;875;2370;615;1926;188;624;150;435;338;1059
315650;201801;1788;4714;1398;4155;76;301;1049;3066;1125;3367
315660;201801;2544;6397;1946;5398;133;368;1318;3575;1451;3943
315670;201801;12188;36658;10178;32987;2167;7564;4467;13980;6634;21544
315680;201801;2909;9311;2212;7935;588;2281;733;2610;1321;4891
315690;201801;2890;7852;1913;6113;461;1557;440;1520;901;3077
315700;201801;7380;21741;5864;18766;977;3326;2687;8324;3664;11650
315710;201801;1875;5013;1349;4157;87;362;839;2438;926;2800
315720;201801;4078;12310;3534;11320;216;1012;2370;7244;2586;8256
315725;201801;1653;4758;1375;4379;196;634;947;3068;1143;3702
315727;201801;592;1684;450;1417;80;286;199;583;279;869
315730;201801;695;2151;624;1995;85;321;302;907;387;1228
315733;201801;1224;3304;947;2827;211;745;341;943;552;1688
315737;201801;1181;3504;927;3028;45;186;628;2029;673;2215
315740;201801;970;2846;779;2455;131;479;374;1053;505;1532
315750;201801;1204;3401;1023;3101;65;208;731;2216;796;2424
315760;201801;1133;2862;1060;2775;26;53;971;2542;997;2595
315765;201801;1775;4973;1507;4627;34;115;1361;4215;1395;4330
315770;201801;1212;3780;1042;3521;343;1266;344;1138;687;2404
315780;201801;24565;73962;21337;67903;2866;10589;11165;33690;14031;44279
315790;201801;3590;11490;3093;10546;270;937;2032;7098;2302;8035
315800;201801;1224;4739;935;3908;199;913;190;739;389;1652
315810;201801;1290;3357;1113;3095;82;294;853;2257;935;2551
315820;201801;2356;7403;2040;6867;296;1115;1298;4296;1594;5411
315830;201801;1143;3480;854;2950;69;293;382;1258;451;1551
315840;201801;751;1944;471;1403;63;196;169;468;232;664
315850;201801;1017;3321;901;3126;201;768;446;1438;647;2206
315860;201801;521;1642;372;1345;81;350;109;352;190;702
315870;201801;455;1271;374;1150;32;117;234;677;266;794
315880;201801;1125;2985;841;2550;76;278;343;989;419;1267
315890;201801;1490;4815;1292;4459;407;1499;520;1715;927;3214
315895;201801;5735;16696;4637;14419;714;2508;2081;6004;2795;8512
315900;201801;815;2186;715;2044;63;225;562;1526;625;1751
315910;201801;482;1539;424;1440;74;266;270;885;344;1151
315920;201801;1612;4336;825;2642;175;592;187;533;362;1125
315930;201801;1046;2610;729;2092;163;475;273;766;436;1241
315935;201801;819;2664;707;2442;163;624;213;741;376;1365
315940;201801;634;1915;525;1702;76;270;260;839;336;1109
315950;201801;1199;3453;1028;3159;165;511;711;2196;876;2707
315960;201801;3487;10458;2267;8123;747;3119;93;199;840;3318
315970;201801;654;1881;510;1679;58;181;358;1212;416;1393
315980;201801;3773;8839;2209;6261;505;1554;708;1810;1213;3364
315990;201801;3712;9974;2947;8688;358;1193;1650;4775;2008;5968
316000;201801;529;1527;425;1367;84;326;169;502;253;828
316010;201801;668;2094;532;1827;51;221;284;900;335;1121
316020;201801;975;3077;841;2821;84;393;550;1721;634;2114
316030;201801;3024;8655;2217;7208;252;863;1330;4396;1582;5259
316040;201801;2964;9398;2224;7909;349;1347;556;1993;905;3340
316045;201801;1909;5673;1790;5485;142;404;1417;4439;1559;4843
316050;201801;354;1083;270;924;41;174;141;450;182;624
316060;201801;707;1977;533;1702;65;304;308;895;373;1199
316070;201801;5741;16974;4806;15131;885;3072;2136;6491;3021;9563
316080;201801;721;2432;608;2185;167;652;66;226;233;878
316090;201801;488;1497;353;1212;59;246;127;391;186;637
316095;201801;1386;4354;1189;3990;218;772;620;2055;838;2827
316100;201801;2544;8099;1872;6526;378;1452;520;1693;898;3145
316105;201801;875;2426;657;2067;115;386;357;1116;472;1502
316110;201801;11853;37880;10382;35345;1451;5128;6577;22684;8028;27812
316120;201801;1077;3372;793;2665;175;607;200;577;375;1184
316130;201801;1436;3262;858;2384;113;354;397;1072;510;1426
316140;201801;1058;2914;735;2368;148;501;335;1082;483;1583
316150;201801;1513;3873;1277;3492;191;597;661;1715;852;2312
316160;201801;1088;3159;877;2773;97;339;502;1521;599;1860
316165;201801;905;2303;717;2021;124;420;397;1084;521;1504
316170;201801;1175;3194;862;2707;113;404;447;1350;560;1754
316180;201801;1380;4202;957;3283;201;766;127;356;328;1122
316190;201801;2782;8302;1597;5393;288;968;429;1309;717;2277
316200;201801;3553;10862;2638;9094;611;2394;586;1919;1197;4313
316210;201801;4261;13062;3186;10798;1085;3931;337;1146;1422;5077
316220;201801;660;2044;451;1583;94;356;45;188;139;544
316225;201801;1267;3241;1007;2792;80;293;700;1817;780;2110
316230;201801;440;1179;347;1042;42;129;164;524;206;653
316240;201801;6192;18458;5482;17414;611;2023;3947;12523;4558;14546
316245;201801;3095;10554;2813;10107;200;1055;2146;7466;2346;8521
316250;201801;9452;25604;7100;21388;1940;6381;1577;4520;3517;10901
316255;201801;2686;7821;2330;7312;342;1181;1539;4837;1881;6018
316257;201801;1301;3313;915;2688;123;397;412;1174;535;1571
316260;201801;1883;5056;1437;4388;61;220;797;2521;858;2741
316265;201801;1265;3469;935;2886;56;179;602;1837;658;2016
316270;201801;3458;11348;3055;10419;657;2379;1273;4163;1930;6542
316280;201801;3075;9553;2741;8918;382;1398;1503;4712;1885;6110
316290;201801;3255;9716;2627;8517;446;1659;942;3023;1388;4682
316292;201801;4268;12253;3610;11172;390;1383;2532;7686;2922;9069
316294;201801;760;2320;563;1957;100;390;101;352;201;742
316295;201801;2346;6990;2027;6416;108;466;1507;4605;1615;5071
316300;201801;1001;3152;826;2830;58;225;529;1832;587;2057
316310;201801;961;2361;545;1721;98;341;216;668;314;1009
316320;201801;566;1692;450;1487;72;273;161;519;233;792
316330;201801;1053;3075;800;2539;69;260;530;1623;599;1883
316340;201801;1063;3138;793;2608;100;407;395;1213;495;1620
316350;201801;1253;3862;1100;3607;135;474;694;2269;829;2743
316360;201801;695;1838;557;1623;66;214;393;1115;459;1329
316370;201801;4515;13342;3647;11689;953;3476;890;2505;1843;5981
316380;201801;1612;4081;1233;3569;48;146;922;2657;970;2803
316390;201801;859;2374;682;2088;179;616;244;736;423;1352
316400;201801;1286;3831;907;3101;148;535;330;1082;478;1617
316410;201801;1025;3176;892;2973;84;292;707;2362;791;2654
316420;201801;1790;5487;1575;5203;112;448;1206;3921;1318;4369
316430;201801;875;2549;581;1944;125;445;140;456;265;901
316440;201801;673;2150;519;1901;147;624;80;283;227;907
316443;201801;578;1699;456;1471;107;385;133;414;240;799
316447;201801;1700;4764;1501;4471;62;216;1242;3682;1304;3898
316450;201801;2171;6922;1741;6043;196;746;1148;3950;1344;4696
316460;201801;865;2511;767;2344;241;784;353;1039;594;1823
316470;201801;6768;20282;5168;17085;1116;4173;1573;4912;2689;9085
316480;201801;192;598;162;536;34;126;62;189;96;315
316490;201801;335;961;249;777;36;117;99;281;135;398
316500;201801;1199;4053;784;2922;162;658;92;315;254;973
316510;201801;663;2438;605;2319;155;651;225;862;380;1513
316520;201801;1048;2961;833;2591;142;513;330;970;472;1483
316530;201801;928;2804;714;2387;122;522;300;884;422;1406
316540;201801;739;2291;649;2126;110;430;227;682;337;1112
316550;201801;1221;3893;1110;3686;133;504;765;2502;898;3006
316553;201801;2885;9181;2026;7110;578;2173;335;1087;913;3260
316555;201801;2753;8985;2428;8558;150;577;1883;6764;2033;7341
316556;201801;653;1602;472;1317;30;90;263;661;293;751
316557;201801;867;2988;771;2807;329;1265;227;781;556;2046
316560;201801;295;965;222;843;63;285;46;158;109;443
316570;201801;1170;3685;1008;3364;336;1143;295;1005;631;2148
316580;201801;368;939;232;679;56;182;78;207;134;389
316590;201801;1366;3695;986;3014;174;593;539;1531;713;2124
316600;201801;1005;3201;892;2987;158;599;451;1479;609;2078
316610;201801;592;2011;499;1835;71;355;303;1051;374;1406
316620;201801;2154;6212;1830;5713;127;465;1296;4043;1423;4508
316630;201801;1500;4648;1198;4049;367;1229;418;1568;785;2797
316640;201801;149;427;121;374;28;104;58;147;86;251
316650;201801;972;3294;800;3036;68;285;528;2059;596;2344
316660;201801;183;466;73;233;6;29;11;27;17;56
316670;201801;1985;5293;1521;4511;457;1447;446;1256;903;2703
316680;201801;1984;5210;1546;4520;143;459;1097;3120;1240;3579
316690;201801;1125;3617;945;3272;234;910;323;1092;557;2002
316695;201801;1018;3076;885;2838;62;251;598;1873;660;2124
316700;201801;372;1016;325;959;20;95;228;614;248;709
316710;201801;2698;9594;2174;8469;673;2699;659;2717;1332;5416
316720;201801;17917;54126;14025;46169;3081;10886;4898;15484;7979;26370
316730;201801;336;1020;284;907;73;266;110;311;183;577
316740;201801;675;2101;606;2000;67;295;421;1360;488;1655
316750;201801;406;1311;322;1131;63;258;112;379;175;637
316760;201801;3609;11577;2999;10535;1305;4859;910;3196;2215;8055
316770;201801;1457;3770;1217;3445;40;141;1029;2941;1069;3082
316780;201801;588;1865;476;1642;139;538;50;136;189;674
316790;201801;720;2026;536;1689;138;461;171;529;309;990
316800;201801;5377;16508;4507;14862;542;2065;2577;8134;3119;10199
316805;201801;900;2113;788;1985;19;29;705;1856;724;1885
316810;201801;543;1579;413;1333;100;361;170;510;270;871
316820;201801;348;866;185;583;28;104;31;102;59;206
316830;201801;631;1961;540;1795;111;427;297;950;408;1377
316840;201801;2714;7879;2315;7151;477;1648;1062;3133;1539;4781
316850;201801;2046;5674;1570;4848;222;799;786;2329;1008;3128
316860;201801;18070;52697;14516;46875;3029;11096;5866;18395;8895;29491
316870;201801;6371;19356;4969;16383;1185;4207;1396;4371;2581;8578
316880;201801;858;2418;737;2236;160;576;301;861;461;1437
316890;201801;1221;2820;807;2257;164;554;452;1135;616;1689
316900;201801;2392;6779;1866;5700;440;1478;579;1578;1019;3056
316905;201801;463;1487;381;1309;94;338;158;538;252;876
316910;201801;873;2565;597;2040;158;628;68;215;226;843
316920;201801;1653;4343;1129;3523;239;822;458;1427;697;2249
316930;201801;7843;25202;5923;21298;1191;4644;1133;3947;2324;8591
316935;201801;4027;11692;2865;9418;690;2414;773;2495;1463;4909
316940;201801;6712;20977;5213;17655;1071;3962;1441;4557;2512;8519
316950;201801;1722;4382;1362;3871;76;254;1056;2940;1132;3194
316960;201801;4752;11635;3608;10023;558;1706;2144;5885;2702;7591
316970;201801;3164;9737;2872;9191;633;2180;1139;3418;1772;5598
316980;201801;803;2428;567;1958;158;595;73;253;231;848
316990;201801;9867;29484;7547;24467;2069;7113;713;2160;2782;9273
317000;201801;2682;8560;2509;8322;202;692;1841;6478;2043;7170
317005;201801;2501;7414;2102;6731;401;1328;1066;3369;1467;4697
317010;201801;24501;59580;14693;44611;3674;12340;2927;9606;6601;21946
317020;201801;62653;161490;36841;112517;7226;24124;7884;21921;15110;46045
317030;201801;689;1964;558;1771;38;159;387;1199;425;1358
317040;201801;10143;27722;7568;23202;1874;6029;2804;8658;4678;14687
317043;201801;765;1961;623;1762;132;414;331;912;463;1326
317047;201801;1194;2988;862;2494;65;195;571;1639;636;1834
317050;201801;1322;4270;953;3420;162;614;314;1052;476;1666
317052;201801;2320;7115;1991;6551;243;871;1320;4260;1563;5131
317057;201801;1676;4340;1228;3582;69;260;817;2306;886;2566
317060;201801;411;1123;227;723;41;147;72;200;113;347
317065;201801;1251;3623;1064;3295;50;226;830;2476;880;2702
317070;201801;8372;24914;5597;18966;1254;4772;820;2616;2074;7388
317075;201801;998;2929;716;2323;151;506;115;343;266;849
317080;201801;6005;15339;4795;13340;1590;4629;1253;3264;2843;7893
317090;201801;4532;14434;4169;13865;377;1305;3060;10220;3437;11525
317100;201801;2681;6823;1877;5524;620;1933;566;1635;1186;3568
317103;201801;1838;6096;1625;5699;201;933;972;3203;1173;4136
317107;201801;1354;3918;1130;3487;78;302;712;2006;790;2308
317110;201801;652;1539;357;1102;57;230;120;378;177;608
317115;201801;1134;3376;948;2988;75;233;665;2098;740;2331
317120;201801;11963;35844;9353;31036;1614;6001;4363;13913;5977;19914
317130;201801;7888;20974;5682;17232;1256;4168;1877;5632;3133;9800
317140;201801;580;1774;502;1633;70;225;291;949;361;1174
317150;201801;1007;2603;809;2360;51;175;639;1829;690;2004
317160;201801;3599;9074;2545;7534;253;778;1596;4750;1849;5528
317170;201801;1979;5189;1409;4189;226;766;489;1271;715;2037
317180;201801;1624;5397;1285;4610;300;1146;312;1077;612;2223
317190;201801;1319;3678;1009;3197;68;234;654;2045;722;2279
317200;201801;4544;13154;3494;11133;873;3025;812;2388;1685;5413
317210;201801;961;2688;794;2438;64;271;564;1722;628;1993
317220;201801;266;889;243;842;55;208;103;348;158;556
320010;201801;4731;14417;3955;12912;525;1851;2326;7425;2851;9276
320013;201801;1825;5470;1267;4214;217;724;523;1808;740;2532
320016;201801;3061;8162;2491;7353;147;429;1967;5801;2114;6230
320020;201801;3720;11005;2950;9555;790;2675;900;3012;1690;5687
320030;201801;1464;4528;1045;3624;303;1121;278;886;581;2007
320035;201801;1707;4922;1461;4518;469;1608;602;1773;1071;3381
320040;201801;3238;10062;2667;8991;497;1797;1188;3981;1685;5778
320050;201801;1646;4193;1441;3854;324;916;728;1897;1052;2813
320060;201801;9832;29641;7267;24348;1612;5905;1927;6218;3539;12123
320070;201801;1408;4271;1085;3598;233;838;327;1046;560;1884
320080;201801;5363;14816;3967;12125;841;2684;1428;4383;2269;7067
320090;201801;7299;20630;5504;17076;1365;4422;2087;6351;3452;10773
320100;201801;2439;7461;1937;6465;548;1879;667;2203;1215;4082
320110;201801;1231;3438;1007;3050;252;792;298;905;550;1697
320115;201801;1786;6132;1577;5743;767;2879;430;1610;1197;4489
320120;201801;14430;40872;10806;34334;2434;8473;3186;9801;5620;18274
320130;201801;35153;106593;30450;98209;5334;19082;15672;49214;21006;68296
320140;201801;3131;9590;2274;7740;531;2012;573;1911;1104;3923
320150;201801;12933;35860;9488;29129;2899;9546;1123;3133;4022;12679
320160;201801;4944;14964;4000;13113;831;2954;1736;5586;2567;8540
320170;201801;1619;4948;1243;4170;287;989;496;1645;783;2634
320180;201801;699;2347;578;2099;201;749;134;509;335;1258
320190;201801;3113;10481;2424;8844;612;2332;444;1594;1056;3926
320200;201801;966;2874;743;2471;228;848;196;663;424;1511
320210;201801;4656;12451;3683;10726;620;1995;1832;5096;2452;7091
320220;201801;2661;7540;2097;6609;374;1285;1129;3558;1503;4843
320225;201801;1241;4076;910;3252;318;1184;134;483;452;1667
320230;201801;4235;12856;3367;11360;904;3300;1281;4346;2185;7646
320240;201801;12928;35882;10108;31188;2241;7432;3937;12132;6178;19564
320245;201801;2996;9688;2628;8916;1020;3597;614;2056;1634;5653
320250;201801;1869;5578;1306;4263;326;1197;252;743;578;1940
320255;201801;1637;5535;1446;5200;559;2073;563;2117;1122;4190
320260;201801;980;2941;724;2354;213;768;195;540;408;1308
320265;201801;2403;7616;2043;6929;866;3058;575;1927;1441;4985
320270;201801;2507;7211;1857;5993;357;1218;892;2933;1249;4151
320280;201801;5671;16942;4796;15311;1259;4351;1379;4253;2638;8604
320290;201801;1357;4257;941;3238;281;1072;174;542;455;1614
320300;201801;3895;12707;3275;11323;1067;3879;643;2219;1710;6098
320305;201801;4516;13788;3698;12062;911;3158;1383;4406;2294;7564
320310;201801;1864;5455;1431;4566;330;1104;554;1761;884;2865
320313;201801;2043;5598;1377;4272;326;1122;270;789;596;1911
320316;201801;1536;4514;1213;3867;307;1036;491;1547;798;2583
320320;201801;19287;54605;14166;45626;3734;12900;4686;14825;8420;27725
320330;201801;2824;8162;2286;7206;664;2074;897;3011;1561;5085
320332;201801;5305;16225;4473;14733;1073;3810;2150;6937;3223;10747
320334;201801;1951;5983;1366;4705;324;1265;309;977;633;2242
320335;201801;1975;5818;1266;4158;337;1216;215;642;552;1858
320340;201801;4936;13172;4221;12055;824;2465;2120;6199;2944;8664
320350;201801;4992;12905;3566;10338;596;1810;1607;4564;2203;6374
320360;201801;1559;4080;1139;3305;189;539;483;1366;672;1905
320370;201801;2526;8258;2017;7073;574;2065;634;2209;1208;4274
320380;201801;2134;6185;1829;5667;421;1402;895;2695;1316;4097
320390;201801;7014;20124;5415;16783;1308;4290;1881;5683;3189;9973
320400;201801;3325;10003;2835;9066;690;2344;1206;3812;1896;6156
320405;201801;4439;12359;3575;10923;571;1883;1984;5969;2555;7852
320410;201801;4976;13535;3740;11676;695;2249;1747;5644;2442;7893
320420;201801;2513;7261;1981;6339;571;1998;482;1547;1053;3545
320425;201801;1994;4975;1520;4193;135;425;948;2525;1083;2950
320430;201801;2627;7106;2131;6128;377;1143;1167;3187;1544;4330
320435;201801;2469;7919;1964;6896;754;2762;505;1851;1259;4613
320440;201801;1078;3283;876;2853;177;646;363;1137;540;1783
320450;201801;1697;5153;1367;4520;337;1215;591;1874;928;3089
320455;201801;3703;11889;2701;9549;756;2858;701;2403;1457;5261
320460;201801;2346;7354;1683;5821;405;1465;334;1082;739;2547
320465;201801;1342;3993;1012;3310;132;474;528;1741;660;2215
320470;201801;3903;11269;2734;8809;734;2533;562;1755;1296;4288
320480;201801;1666;5018;1421;4528;292;1028;665;2065;957;3093
320490;201801;15131;43849;12357;39155;2722;9473;4875;15477;7597;24950
320495;201801;1373;3911;901;2933;221;764;211;692;432;1456
320500;201801;45783;130657;38443;118088;7463;24773;19428;58085;26891;82858
320501;201801;4502;13562;3371;11629;989;3861;893;2934;1882;6795
320503;201801;1989;6502;1560;5577;521;2085;454;1459;975;3544
320506;201801;3237;9813;2252;7539;647;2324;97;269;744;2593
320510;201801;8781;25589;7331;23097;1301;4537;3804;11711;5105;16248
320515;201801;1764;5021;1406;4257;410;1303;355;1052;765;2355
320517;201801;2040;6473;1612;5581;585;2176;323;1070;908;3246
320520;201801;31559;91187;25138;80296;5479;19275;9579;30330;15058;49605
320530;201801;27214;77421;21893;68055;3230;11797;12047;35270;15277;47067
330010;201801;19598;57620;16881;52890;3531;11613;8832;27666;12363;39279
330015;201801;1412;3816;1182;3407;201;654;549;1508;750;2162
330020;201801;18601;50520;16430;47266;2643;8520;10672;29870;13315;38390
330022;201801;1867;5275;1507;4707;280;954;863;2651;1143;3605
330023;201801;3289;9412;2634;8422;665;2299;938;2894;1603;5193
330025;201801;4623;12227;3366;9980;1072;3462;1012;2958;2084;6420
330030;201801;8720;26832;7256;24139;1204;4473;3793;12045;4997;16518
330040;201801;11583;33395;10149;30854;1690;5623;5991;17559;7681;23182
330045;201801;79163;202020;67351;186070;8082;22439;47958;131382;56040;153821
330050;201801;2340;6692;1882;5919;475;1598;772;2287;1247;3885
330060;201801;5224;14615;4391;13304;1024;3419;1882;5440;2906;8859
330070;201801;19855;56626;17093;52302;3483;11323;8471;25942;11954;37265
330080;201801;8466;23009;7509;21582;749;2295;5063;14359;5812;16654
330090;201801;2552;6433;2118;5807;298;885;1239;3313;1537;4198
330093;201801;1923;5391;1541;4807;206;664;983;3154;1189;3818
330095;201801;1015;3235;854;2900;120;446;391;1250;511;1696
330100;201801;61493;177762;53092;165085;5573;20232;35026;107405;40599;127637
330110;201801;2134;6569;1885;6144;385;1335;757;2418;1142;3753
330115;201801;1767;4885;1469;4442;278;948;820;2417;1098;3365
330120;201801;2956;7342;2382;6592;261;831;1668;4527;1929;5358
330130;201801;3465;10505;2989;9760;603;2099;1582;5166;2185;7265
330140;201801;3181;9177;2735;8521;487;1735;1582;4786;2069;6521
330150;201801;1984;5725;1599;5057;365;1191;565;1785;930;2976
330160;201801;1127;3340;948;3064;229;809;455;1428;684;2237
330170;201801;90734;259793;80098;244114;14306;45591;46688;141850;60994;187441
330180;201801;2059;5701;1685;5071;88;364;1187;3463;1275;3827
330185;201801;8762;25020;7371;22597;1058;3601;4585;13641;5643;17242
330187;201801;3708;10226;3084;9250;510;1697;1873;5521;2383;7218
330190;201801;27439;72416;24403;68171;2958;8520;18042;50289;21000;58809
330200;201801;13589;39400;11493;36434;2650;8445;6176;20138;8826;28583
330205;201801;1971;5266;1661;4778;125;423;1150;3229;1275;3652
330210;201801;3098;8350;2338;6904;529;1663;819;2278;1348;3941
330220;201801;9661;27728;7843;24240;1885;6307;2153;6134;4038;12441
330225;201801;3413;10133;2885;9217;297;1193;1866;5713;2163;6906
330227;201801;16120;43935;14189;41304;1793;5555;10090;29338;11883;34893
330230;201801;1238;3463;1047;3167;106;374;686;2021;792;2395
330240;201801;17570;50487;14644;45589;3669;12371;6151;18505;9820;30876
330245;201801;1297;3674;916;2997;219;758;225;725;444;1483
330250;201801;33724;94903;29426;88267;7294;22160;13208;40620;20502;62780
330260;201801;4407;12598;3549;11180;637;2190;1708;5136;2345;7326
330270;201801;22106;47593;14244;36782;2870;8174;5594;14351;8464;22525
330280;201801;2189;6223;1778;5478;268;913;897;2628;1165;3541
330285;201801;18661;49448;15640;45162;2215;7107;9991;28147;12206;35254
330290;201801;3284;9143;2765;8306;439;1432;1501;4335;1940;5767
330300;201801;3209;9995;2785;9232;454;1677;1572;5065;2026;6742
330310;201801;2257;6152;1790;5351;165;493;1133;3381;1298;3874
330320;201801;12986;35941;11572;33958;1521;4641;8311;24456;9832;29097
330330;201801;27863;71887;23638;65668;3486;10792;15154;40828;18640;51620
330340;201801;13219;37060;10403;32188;2318;7769;4021;11933;6339;19702
330350;201801;89913;243361;77427;226391;8974;28390;54429;158067;63403;186457
330360;201801;6800;18020;5901;16962;477;1460;4682;13390;5159;14850
330370;201801;3523;12000;3086;11100;942;3502;1080;3892;2022;7394
330380;201801;4916;14989;3949;13185;950;3424;1335;4321;2285;7745
330385;201801;3825;12455;3367;11670;981;3624;1331;4673;2312;8297
330390;201801;22073;68283;18207;60692;4082;14662;7713;24980;11795;39642
330395;201801;3065;8449;2683;7910;216;747;1800;5213;2016;5960
330400;201801;2721;8011;2428;7479;220;839;1656;4776;1876;5615
330410;201801;2705;7958;2066;6787;402;1453;905;2829;1307;4282
330411;201801;2256;6663;1929;6050;200;746;1311;3939;1511;4685
330412;201801;1392;4480;1151;4009;201;762;565;1861;766;2623
330414;201801;22998;61734;19260;56585;2938;8494;12193;36035;15131;44529
330415;201801;3451;10062;2740;8823;522;1672;1236;4134;1758;5806
330420;201801;9652;25886;6433;20389;1178;3991;1907;5748;3085;9739
330430;201801;7130;19966;6251;18463;980;3279;3668;10339;4648;13618
330440;201801;1592;4997;1359;4598;368;1386;523;1659;891;3045
330450;201801;1310;4145;1104;3774;202;766;538;1798;740;2564
330452;201801;13558;37980;10773;33139;2305;7640;5125;15373;7430;23013
330455;201801;522660;1343376;406186;1164295;74831;229478;219923;619608;294754;849086
330460;201801;1190;3577;949;3185;203;732;434;1413;637;2145
330470;201801;4295;11878;3419;10480;851;2813;1412;4195;2263;7008
330475;201801;8295;23533;6834;21412;1863;6426;3006;9138;4869;15564
330480;201801;5709;15975;4948;14832;707;2337;3108;9059;3815;11396
330490;201801;111248;276433;95358;253835;10731;30874;65515;171224;76246;202098
330500;201801;4998;14559;4618;13984;611;1977;3292;9889;3903;11866
330510;201801;36472;104080;30420;95157;9092;28678;13048;41598;22140;70276
330513;201801;1194;3501;1051;3247;332;1070;408;1253;740;2323
330515;201801;2860;8344;2375;7489;782;2585;759;2350;1541;4935
330520;201801;10768;31333;9243;28725;1779;5994;4380;13185;6159;19179
330530;201801;1514;4108;1210;3599;268;860;528;1513;796;2373
330540;201801;2789;7969;2249;6993;637;2055;793;2400;1430;4455
330550;201801;7573;24031;6544;22204;2523;8932;1515;5254;4038;14186
330555;201801;10126;27844;8790;26003;1533;4769;5438;16256;6971;21025
330560;201801;4148;12079;3571;11028;488;1644;2079;6232;2567;7876
330570;201801;2967;8646;2489;7827;521;1721;1318;4107;1839;5828
330575;201801;5363;14605;4675;13406;516;1706;3302;9111;3818;10817
330580;201801;12129;36576;9873;32279;2676;9254;3777;12156;6453;21410
330590;201801;1563;4482;1382;4245;164;522;983;3034;1147;3556
330600;201801;10978;31659;8829;27798;1472;4915;4289;13478;5761;18393
330610;201801;8591;25546;7507;23822;1004;3681;4575;14098;5579;17779
330615;201801;1624;5325;1439;5063;480;1810;627;2192;1107;4002
330620;201801;3508;11495;2987;10523;1079;4043;638;2178;1717;6221
330630;201801;23253;64378;18671;56499;2319;8106;11469;33302;13788;41408
350010;201801;1871;5306;1026;3389;259;881;85;224;344;1105
350020;201801;581;1559;323;1042;37;129;148;432;185;561
350030;201801;4213;12637;3155;10528;857;3065;809;2628;1666;5693
350040;201801;542;1749;364;1321;76;307;104;341;180;648
350050;201801;868;2510;656;2098;151;544;186;496;337;1040
350055;201801;681;1906;578;1749;57;210;423;1244;480;1454
350060;201801;104;315;86;287;20;73;36;125;56;198
350070;201801;3880;10878;2430;7949;469;1588;689;2050;1158;3638
350075;201801;577;1875;448;1597;178;662;58;191;236;853
350080;201801;669;1876;414;1327;58;212;174;527;232;739
350090;201801;568;1443;339;998;77;227;101;285;178;512
350100;201801;2024;5793;1360;4546;208;829;569;1768;777;2597
350110;201801;422;1254;314;1025;26;102;188;589;214;691
350115;201801;1267;3799;1056;3335;197;674;508;1461;705;2135
350120;201801;814;2203;495;1547;71;216;254;833;325;1049
350130;201801;3082;8816;2593;7883;320;1072;1444;4147;1764;5219
350140;201801;564;1844;460;1628;37;170;260;881;297;1051
350150;201801;484;1538;418;1410;139;485;118;388;257;873
350160;201801;9690;25664;6194;19257;975;3485;3099;8945;4074;12430
350170;201801;1482;4766;1195;4111;281;1023;318;1038;599;2061
350180;201801;1104;2895;634;1950;124;421;271;802;395;1223
350190;201801;2982;8952;2260;7450;485;1797;890;2515;1375;4312
350200;201801;382;1123;329;1033;23;76;231;698;254;774
350210;201801;5246;13130;3512;10269;756;2257;1617;4680;2373;6937
350220;201801;2287;6920;1848;5983;377;1383;755;2243;1132;3626
350230;201801;833;2525;727;2342;175;585;326;1052;501;1637
350240;201801;612;1868;441;1470;72;249;170;555;242;804
350250;201801;2132;7101;1776;6445;634;2478;418;1567;1052;4045
350260;201801;830;2195;554;1673;95;291;266;796;361;1087
350270;201801;4580;13388;3764;11720;665;2274;1759;5122;2424;7396
350275;201801;2038;6183;1713;5609;400;1411;727;2281;1127;3692
350280;201801;20541;48169;12678;35294;2478;7376;3859;10415;6337;17791
350290;201801;2755;8170;2015;6687;395;1480;710;2224;1105;3704
350300;201801;613;1781;429;1375;91;292;126;366;217;658
350310;201801;828;2677;699;2369;96;374;275;872;371;1246
350315;201801;523;1542;376;1243;59;227;123;359;182;586
350320;201801;11271;32759;9257;29105;2571;8645;2026;6446;4597;15091
350330;201801;14316;37366;9793;27901;1425;4125;4990;13450;6415;17575
350335;201801;384;1123;329;1028;19;52;251;796;270;848
350340;201801;1004;2817;664;2154;140;505;212;665;352;1170
350350;201801;711;2056;581;1887;127;431;230;721;357;1152
350360;201801;898;2928;762;2614;212;711;281;965;493;1676
350370;201801;553;1572;387;1204;117;357;55;162;172;519
350380;201801;4592;12943;3158;10218;757;2588;951;2957;1708;5545
350390;201801;9339;27363;7825;24568;2185;7051;2828;8693;5013;15744
350395;201801;395;1044;192;632;20;70;57;165;77;235
350400;201801;7637;20803;5695;17405;1484;4934;1686;4888;3170;9822
350410;201801;8726;26744;6673;22746;1666;6256;1756;5530;3422;11786
350420;201801;569;1744;423;1470;85;351;64;210;149;561
350430;201801;683;2031;568;1832;74;298;338;1028;412;1326
350440;201801;1346;3994;1088;3445;243;780;486;1486;729;2266
350450;201801;6916;20834;5496;18101;1255;4397;1669;5257;2924;9654
350460;201801;1499;3907;828;2581;167;587;239;693;406;1280
350470;201801;225;582;187;513;11;41;123;316;134;357
350480;201801;787;2194;528;1681;92;321;83;227;175;548
350490;201801;1695;5019;1359;4383;311;1064;423;1261;734;2325
350500;201801;583;1693;496;1542;84;300;267;808;351;1108
350510;201801;1048;3022;780;2492;102;372;395;1203;497;1575
350520;201801;1740;6027;1359;5148;278;1164;446;1610;724;2774
350530;201801;2298;6401;1759;5315;464;1485;585;1636;1049;3121
350535;201801;1371;4063;1229;3861;140;534;853;2597;993;3131
350540;201801;1648;4496;1213;3732;259;875;505;1559;764;2434
350550;201801;9233;23438;6244;18558;889;3036;2828;7836;3717;10872
350560;201801;3443;10744;2871;9494;324;1153;1651;5349;1975;6502
350570;201801;18397;56618;15846;51656;4152;14667;6484;20162;10636;34829
350580;201801;1712;5228;1040;3564;204;735;118;328;322;1063
350590;201801;4141;12050;3107;9921;704;2596;1338;3819;2042;6415
350600;201801;39460;97129;25611;71860;3761;11653;11678;30151;15439;41804
350610;201801;6497;18775;4945;15801;1032;3481;2050;6402;3082;9883
350620;201801;379;1037;272;880;31;125;130;400;161;525
350630;201801;1509;4226;1109;3450;135;488;551;1573;686;2061
350635;201801;6709;18660;5215;16168;1086;3733;2415;7140;3501;10873
350640;201801;798;2379;484;1586;72;271;143;415;215;686
350650;201801;7479;21494;4960;15968;1061;3705;1335;3984;2396;7689
350660;201801;4718;13311;3737;11582;745;2453;1729;5335;2474;7788
350670;201801;1460;4428;1304;4155;273;881;665;2137;938;3018
350680;201801;1033;2955;718;2347;147;521;301;987;448;1508
350690;201801;1006;3057;760;2551;150;548;317;1005;467;1553
350700;201801;4088;11575;2960;9696;616;2304;1295;3949;1911;6253
350710;201801;2639;7881;2259;7165;319;1132;1286;3915;1605;5047
350715;201801;779;2318;686;2130;87;321;380;1086;467;1407
350720;201801;144;395;121;356;24;76;43;121;67;197
350730;201801;433;1429;350;1261;67;269;163;575;230;844
350740;201801;1572;4671;1068;3514;198;690;265;777;463;1467
350745;201801;573;1682;340;1118;44;161;144;419;188;580
350750;201801;8881;26029;7149;22730;1487;5326;2378;6749;3865;12075
350760;201801;12666;34935;9572;29563;2644;8809;2254;6199;4898;15008
350770;201801;668;1839;450;1397;59;198;245;744;304;942
350775;201801;574;1503;449;1298;47;155;216;620;263;775
350780;201801;1847;5302;1407;4509;354;1288;337;1150;691;2438
350790;201801;1740;5162;1206;4080;263;966;194;574;457;1540
350800;201801;3049;9738;2777;9196;499;1809;1428;4559;1927;6368
350810;201801;1979;5365;1680;4956;347;1075;904;2766;1251;3841
350820;201801;712;1805;417;1250;60;181;155;435;215;616
350830;201801;816;2446;498;1706;71;253;137;417;208;670
350840;201801;2447;7931;1894;6812;580;2249;562;1910;1142;4159
350850;201801;5761;18087;4604;15720;1378;4917;1241;4228;2619;9145
350860;201801;3105;9120;2851;8736;105;449;2219;6681;2324;7130
350870;201801;2673;8108;2085;7091;430;1643;1043;3490;1473;5133
350880;201801;1284;4066;1032;3464;226;797;291;929;517;1726
350890;201801;646;1763;404;1257;43;148;123;312;166;460
350900;201801;5648;16758;3923;13139;1251;4575;408;1285;1659;5860
350910;201801;800;2234;694;2023;140;477;405;1128;545;1605
350920;201801;11483;30774;9928;28202;684;2253;7589;20712;8273;22965
350925;201801;4505;13364;3395;11247;812;2787;1110;3288;1922;6075
350930;201801;1365;3762;958;2933;144;468;467;1361;611;1829
350940;201801;1882;5753;1592;5210;240;884;921;2908;1161;3792
350945;201801;913;2731;714;2338;122;437;316;979;438;1416
350950;201801;75549;214618;60365;183006;10224;34110;31991;91666;42215;125776
350960;201801;4728;14533;3859;12865;752;2860;1939;6125;2691;8985
350970;201801;3724;12206;2995;10527;965;3682;447;1362;1412;5044
350980;201801;577;1826;496;1647;195;674;156;515;351;1189
350990;201801;1761;5481;1360;4741;355;1387;417;1338;772;2725
350995;201801;803;2622;728;2461;72;299;441;1413;513;1712
351000;201801;2542;7217;1971;6147;387;1332;658;1923;1045;3255
351010;201801;306;832;175;558;23;76;81;252;104;328
351015;201801;668;2202;554;1991;109;434;237;816;346;1250
351020;201801;8357;24412;6839;21978;1403;4811;3846;12203;5249;17014
351030;201801;2335;7451;1937;6539;331;1298;919;2906;1250;4204
351040;201801;4166;11488;3586;10564;284;1008;2665;7561;2949;8569
351050;201801;15859;41545;10903;33406;2475;8221;3726;11305;6201;19526
351060;201801;39949;108144;31704;94226;4848;15666;18517;53496;23365;69162
351070;201801;1389;3729;836;2714;244;852;85;249;329;1101
351080;201801;2538;7155;1916;6339;443;1622;863;2674;1306;4296
351090;201801;363;1144;260;942;47;184;53;194;100;378
351100;201801;2531;7281;1659;5271;429;1441;310;1013;739;2454
351110;201801;5246;14128;3482;10883;802;2775;1113;3178;1915;5953
351120;201801;687;1919;482;1516;78;255;191;542;269;797
351130;201801;954;2605;461;1583;82;289;80;266;162;555
351140;201801;1649;5318;1286;4549;364;1396;295;908;659;2304
351150;201801;1556;4951;1009;3619;229;880;83;246;312;1126
351160;201801;1116;3799;944;3412;222;862;308;982;530;1844
351170;201801;1407;4258;1177;3766;136;483;666;2004;802;2487
351190;201801;811;2510;613;2015;97;313;194;607;291;920
351200;201801;1665;4429;1286;3817;93;319;747;2104;840;2423
351210;201801;1375;3537;857;2518;107;365;410;1080;517;1445
351220;201801;2922;9142;2594;8510;364;1311;1528;4889;1892;6200
351230;201801;1737;5137;1355;4452;294;1082;598;1806;892;2888
351240;201801;1547;4348;1063;3284;234;773;450;1283;684;2056
351250;201801;1025;2931;608;1968;87;295;207;657;294;952
351260;201801;888;2565;733;2246;255;777;167;496;422;1273
351270;201801;317;988;272;893;60;235;128;349;188;584
351280;201801;4793;13298;3623;11062;647;2201;1469;4257;2116;6458
351290;201801;928;2552;640;1999;134;440;262;783;396;1223
351300;201801;13490;40304;9796;32980;2298;8358;3100;10471;5398;18829
351310;201801;2879;8247;2262;7140;329;1225;1232;3605;1561;4830
351320;201801;890;2843;702;2372;131;469;240;760;371;1229
351330;201801;1041;4135;980;4035;63;175;828;3575;891;3750
351340;201801;5923;18616;4861;16634;1333;4733;1770;6081;3103;10814
351350;201801;9318;26211;7900;23753;1342;4221;4809;13989;6151;18210
351360;201801;3909;11484;3408;10606;860;2931;1080;3100;1940;6031
351370;201801;2207;6608;1588;5268;365;1262;569;1733;934;2995
351380;201801;38886;105363;31954;92911;6036;18550;15672;44382;21708;62932
351385;201801;266;738;172;543;31;93;52;160;83;253
351390;201801;1326;3578;910;2942;206;811;430;1242;636;2053
351400;201801;940;2865;800;2590;203;682;323;1020;526;1702
351410;201801;2330;6935;1854;6005;297;982;939;2999;1236;3981
351420;201801;278;763;180;564;43;127;54;168;97;295
351430;201801;752;2272;686;2150;79;279;496;1522;575;1801
351440;201801;3145;8969;2226;7007;415;1417;430;1163;845;2580
351450;201801;1505;4155;1123;3458;250;814;282;884;532;1698
351460;201801;679;1932;572;1735;221;655;218;670;439;1325
351470;201801;1016;2867;848;2551;91;336;486;1359;577;1695
351480;201801;2563;8081;2209;7467;313;1301;1171;3790;1484;5091
351490;201801;1803;5685;1575;5203;128;541;1062;3327;1190;3868
351492;201801;328;990;271;860;17;62;144;423;161;485
351495;201801;185;592;144;478;24;90;63;197;87;287
351500;201801;31934;84744;23740;70442;5417;17019;10528;29997;15945;47016
351510;201801;10196;28477;7822;24083;1460;4879;4102;12271;5562;17150
351512;201801;475;1339;342;1049;57;176;136;388;193;564
351515;201801;2699;7080;1740;5315;353;1254;414;1243;767;2497
351518;201801;2213;6198;1505;4904;257;981;720;2113;977;3094
351519;201801;640;1870;441;1427;89;337;81;175;170;512
351520;201801;966;2555;381;1274;54;213;124;360;178;573
351530;201801;343;1018;197;651;27;86;62;168;89;254
351535;201801;2151;5440;1647;4637;147;508;1043;2766;1190;3274
351540;201801;1791;4954;1268;3974;449;1543;206;531;655;2074
351550;201801;5331;15012;3652;11336;569;1953;1624;4663;2193;6616
351560;201801;417;1318;354;1173;83;314;79;256;162;570
351565;201801;159;542;140;495;28;103;59;197;87;300
351570;201801;15058;42736;12111;36996;1904;6363;7204;21146;9108;27509
351580;201801;279;762;163;530;30;90;50;182;80;272
351590;201801;503;1234;284;804;34;120;154;408;188;528
351600;201801;1681;4530;1292;3817;161;533;712;1964;873;2497
351610;201801;637;1657;446;1324;43;160;244;632;287;792
351620;201801;19034;56709;14511;48049;2758;10360;4982;14687;7740;25047
351630;201801;24025;69292;20517;63382;3757;12183;12148;36706;15905;48889
351640;201801;14198;40334;11519;35716;1691;5850;7066;21169;8757;27019
351650;201801;401;1170;182;623;30;108;26;83;56;191
351660;201801;763;2377;509;1724;98;365;90;273;188;638
351670;201801;4465;13266;3387;10814;641;2194;1591;4748;2232;6942
351680;201801;466;1438;288;955;58;180;62;206;120;386
351685;201801;436;1357;361;1212;87;281;129;434;216;715
351690;201801;984;2788;673;2136;120;407;238;668;358;1075
351700;201801;928;2679;789;2416;172;513;312;946;484;1459
351710;201801;595;1867;458;1585;58;247;200;635;258;882
351720;201801;1357;3876;964;3085;177;608;365;1123;542;1731
351730;201801;985;2709;747;2317;100;370;366;1055;466;1425
351740;201801;3861;10232;3018;8596;562;1703;1257;3290;1819;4993
351750;201801;1232;3756;769;2720;130;500;269;951;399;1451
351760;201801;3189;9637;2391;7898;565;2046;673;2000;1238;4046
351770;201801;1990;6159;1656;5471;487;1673;605;1932;1092;3605
351780;201801;1358;3667;727;2302;122;436;182;535;304;971
351790;201801;1180;3132;959;2805;150;407;588;1751;738;2158
351800;201801;568;1259;291;754;38;105;96;218;134;323
351810;201801;980;2756;805;2439;68;182;576;1706;644;1888
351820;201801;2409;7372;1713;5890;368;1344;261;892;629;2236
351830;201801;4294;12399;3292;10454;448;1658;1747;5287;2195;6945
351840;201801;6658;21201;5566;19080;1208;4593;2259;7279;3467;11872
351850;201801;1990;5281;1322;4099;232;847;426;1178;658;2025
351860;201801;2824;8829;2381;7908;517;1847;1138;3713;1655;5560
351870;201801;24475;68572;19678;60420;6293;20121;7041;21855;13334;41976
351880;201801;114377;333293;91067;289748;26927;91821;24449;73553;51376;165374
351885;201801;689;2247;610;2070;148;514;269;891;417;1405
351890;201801;580;1792;473;1580;99;337;78;214;177;551
351900;201801;1126;3340;899;2954;205;701;302;1002;507;1703
351905;201801;419;1229;306;987;36;129;139;411;175;540
351907;201801;20200;56288;16440;49443;983;3619;11947;34954;12930;38573
351910;201801;1142;3220;841;2579;165;556;352;972;517;1528
351920;201801;926;2475;718;2109;87;297;360;1014;447;1311
351925;201801;949;2745;759;2372;109;358;359;1040;468;1398
351930;201801;2712;8256;2581;8014;276;1147;2080;6200;2356;7347
351940;201801;1042;2883;787;2458;90;325;433;1331;523;1656
351950;201801;1501;3908;1077;3155;82;269;613;1757;695;2026
351960;201801;4749;12990;3464;10659;820;2696;1366;4079;2186;6775
351970;201801;5489;18733;4846;17495;1063;4247;2204;7512;3267;11759
351980;201801;913;2576;679;2086;107;386;323;906;430;1292
351990;201801;1370;3546;972;2891;149;536;316;845;465;1381
352000;201801;2239;7053;1985;6523;246;948;1159;3608;1405;4556
352010;201801;1853;5670;1513;4994;367;1319;221;783;588;2102
352020;201801;1537;4470;1222;3913;248;867;527;1592;775;2459
352030;201801;4985;14117;4027;12675;773;2716;2170;6719;2943;9435
352040;201801;2034;5990;1374;4628;283;1008;223;679;506;1687
352042;201801;3359;8729;1997;6077;396;1265;824;2500;1220;3765
352044;201801;1911;5557;1140;3991;202;772;240;774;442;1546
352050;201801;11515;33083;7695;24882;1817;6645;1351;3858;3168;10503
352060;201801;724;2120;549;1764;85;303;231;688;316;991
352070;201801;811;1801;581;1469;98;272;252;613;350;885
352080;201801;455;1261;274;869;44;157;82;231;126;388
352090;201801;1341;4423;1056;3727;187;735;296;926;483;1661
352100;201801;3044;9011;2460;7917;539;1874;1074;3320;1613;5194
352110;201801;543;1766;446;1557;106;388;161;526;267;914
352115;201801;497;1513;416;1365;93;315;203;673;296;988
352120;201801;817;2584;663;2258;84;339;342;1058;426;1397
352130;201801;1820;5409;1174;3767;242;823;339;1033;581;1856
352140;201801;1556;4298;948;3060;148;519;373;1125;521;1644
352150;201801;761;2147;586;1834;155;482;268;846;423;1328
352160;201801;897;2419;667;2043;128;446;265;758;393;1204
352170;201801;2701;7950;2261;6998;466;1560;1076;3079;1542;4639
352180;201801;2945;8259;2405;7218;573;1844;876;2442;1449;4286
352190;201801;1178;3348;882;2816;144;532;301;851;445;1383
352200;201801;375;1235;272;1018;41;158;81;303;122;461
352210;201801;16480;42878;13463;38431;1800;5490;9040;25716;10840;31206
352215;201801;491;1417;446;1364;57;194;296;883;353;1077
352220;201801;13832;39306;10132;32471;3044;10281;2521;7999;5565;18280
352230;201801;12069;38963;9749;34347;2736;10656;3006;9820;5742;20476
352240;201801;11608;32182;8626;26843;2100;7427;2980;8364;5080;15791
352250;201801;20151;61199;16948;55466;4639;15916;7434;23979;12073;39895
352260;201801;5498;15622;3783;12116;624;2171;1886;5843;2510;8014
352265;201801;860;2611;746;2418;66;270;506;1580;572;1850
352270;201801;1514;4960;1213;4297;282;1049;343;1181;625;2230
352280;201801;2256;6338;1806;5621;215;825;923;2696;1138;3521
352290;201801;1060;3309;893;2923;157;613;409;1199;566;1812
352300;201801;962;2747;690;2174;112;423;311;853;423;1276
352310;201801;44216;123804;33956;106225;9037;28962;14025;44094;23062;73056
352320;201801;5577;16154;4522;13989;913;3127;1914;5251;2827;8378
352330;201801;1916;5825;1583;5332;428;1593;623;1970;1051;3563
352340;201801;4730;14062;3556;11891;910;3266;1087;3393;1997;6659
352350;201801;1664;5276;1420;4729;260;992;535;1635;795;2627
352360;201801;1035;2979;906;2778;161;597;608;1767;769;2364
352370;201801;932;2991;823;2761;57;249;566;1839;623;2088
352380;201801;844;2529;674;2219;169;616;189;583;358;1199
352390;201801;17722;45088;11766;34607;1910;6242;5893;16326;7803;22568
352400;201801;3420;9692;2684;8338;657;2363;1290;3615;1947;5978
352410;201801;2811;8020;2307;7197;359;1247;1221;3656;1580;4903
352420;201801;916;2324;656;1880;103;318;246;679;349;997
352430;201801;6573;18355;5133;15945;1569;5156;1756;5447;3325;10603
352440;201801;16285;47973;12945;41389;2814;9564;5411;16764;8225;26328
352450;201801;625;1842;357;1233;71;261;94;312;165;573
352460;201801;2540;7658;1912;6443;437;1627;577;1843;1014;3470
352470;201801;3757;10039;2749;8284;322;1112;1433;4021;1755;5133
352480;201801;3744;9638;2653;7660;505;1644;1137;2997;1642;4641
352490;201801;672;2209;521;1850;96;367;180;636;276;1003
352500;201801;9012;24394;7069;21126;3533;11426;1189;2645;4722;14071
352510;201801;3090;9034;2415;7813;639;2256;776;2386;1415;4642
352520;201801;2251;7018;1837;6194;465;1668;759;2444;1224;4112
352530;201801;8470;25414;5784;19313;1367;4917;817;2152;2184;7069
352540;201801;513;1569;368;1240;73;262;89;280;162;542
352550;201801;881;2718;627;2191;125;487;153;491;278;978
352560;201801;539;1604;378;1231;68;217;90;268;158;485
352570;201801;1865;5812;1232;4451;328;1312;199;588;527;1900
352580;201801;805;2391;624;2016;107;385;216;645;323;1030
352585;201801;248;758;201;654;20;74;99;302;119;376
352590;201801;13247;37954;9809;31163;3180;10797;3525;10293;6705;21090
352600;201801;1835;5398;1424;4508;270;923;606;1805;876;2728
352610;201801;3202;9611;2515;8378;562;2088;802;2494;1364;4582
352620;201801;5182;14884;4355;13569;1175;3770;1801;5574;2976;9344
352630;201801;774;2060;599;1776;104;382;282;761;386;1143
352640;201801;2591;7190;2030;6269;169;578;1347;4110;1516;4688
352650;201801;642;1933;471;1509;82;295;142;426;224;721
352660;201801;953;3230;810;2929;169;646;311;1085;480;1731
352670;201801;9824;28152;5905;19822;1407;5163;430;1414;1837;6577
352680;201801;3012;9523;2221;7727;428;1675;881;2822;1309;4497
352690;201801;30268;80108;21926;64490;2298;7661;12708;35488;15006;43149
352700;201801;560;1518;425;1326;153;522;128;352;281;874
352710;201801;4964;13903;3633;11314;966;3307;1316;3833;2282;7140
352720;201801;7849;23751;6534;21052;2612;8617;1314;3970;3926;12587
352725;201801;411;1132;210;679;17;69;99;297;116;366
352730;201801;2444;7503;2169;6816;420;1494;1099;3102;1519;4596
352740;201801;2138;5451;1633;4662;204;644;920;2539;1124;3183
352750;201801;437;1171;228;744;45;159;47;127;92;286
352760;201801;1381;4329;1093;3654;200;744;473;1476;673;2220
352770;201801;778;2349;612;1980;129;457;199;605;328;1062
352780;201801;614;1984;476;1654;94;338;156;534;250;872
352790;201801;609;1688;425;1339;64;211;141;416;205;627
352800;201801;1150;3911;854;3136;210;812;191;644;401;1456
352810;201801;1041;2620;641;1852;112;327;261;735;373;1062
352820;201801;563;1465;379;1168;80;257;93;282;173;539
352830;201801;561;1523;272;861;41;137;44;116;85;253
352840;201801;3833;12166;3338;11212;1008;3559;1255;4033;2263;7592
352850;201801;10273;27656;7242;22753;1897;6398;2186;6726;4083;13124
352860;201801;819;2641;723;2425;161;580;282;918;443;1498
352870;201801;818;2110;538;1498;52;168;285;720;337;888
352880;201801;1948;5038;1362;3922;218;659;606;1554;824;2213
352885;201801;266;819;215;724;31;99;130;437;161;536
352890;201801;625;1585;407;1120;64;198;173;395;237;593
352900;201801;18004;50281;12872;40141;2434;8352;5163;15088;7597;23440
352910;201801;414;1155;216;704;17;65;45;118;62;183
352920;201801;2473;6889;1795;5604;253;867;914;2678;1167;3545
352930;201801;5428;16165;4230;13689;825;2845;1638;5044;2463;7889
352940;201801;21829;65941;17605;57215;5504;19695;2941;8564;8445;28259
352950;201801;435;1180;235;775;46;168;23;63;69;231
352960;201801;635;1851;364;1218;58;211;111;340;169;551
352965;201801;318;909;188;618;51;177;33;91;84;268
352970;201801;3054;7537;2424;6574;247;685;1640;4464;1887;5149
352980;201801;1259;3752;1029;3356;201;691;512;1650;713;2341
352990;201801;3980;12002;3370;10984;758;2801;1598;4907;2356;7708
353000;201801;448;1239;224;729;41;147;52;146;93;293
353010;201801;2654;7087;1836;5502;418;1367;568;1559;986;2926
353020;201801;3809;10194;2199;6730;316;1043;757;2116;1073;3159
353030;201801;3734;10378;2709;8424;694;2295;515;1571;1209;3866
353040;201801;498;1342;393;1142;88;283;139;360;227;643
353050;201801;4900;15367;3787;13069;950;3543;1422;4660;2372;8203
353060;201801;43363;120563;36599;109517;3467;12374;25632;73641;29099;86015
353070;201801;9595;28590;6888;22923;1555;5548;2037;6631;3592;12179
353080;201801;4578;13677;3210;10857;767;2825;928;2889;1695;5714
353090;201801;530;1756;465;1610;44;170;278;911;322;1081
353100;201801;279;758;108;362;11;38;21;63;32;101
353110;201801;7190;21432;6167;19792;992;3506;3831;12308;4823;15814
353120;201801;536;1520;363;1142;64;228;124;335;188;563
353130;201801;2345;6380;1681;5341;500;1721;507;1564;1007;3285
353140;201801;2182;5828;1676;4885;229;742;921;2533;1150;3275
353150;201801;1495;4212;1133;3575;298;949;353;1079;651;2028
353160;201801;634;1722;428;1346;77;252;160;458;237;710
353170;201801;492;1490;412;1380;83;351;197;601;280;952
353180;201801;9113;24159;7279;21223;1059;3376;4661;13340;5720;16716
353190;201801;3420;9869;2748;8449;366;1220;1554;4471;1920;5691
353200;201801;1088;3462;761;2594;172;643;195;616;367;1259
353205;201801;329;1097;290;998;74;295;135;445;209;740
353210;201801;967;2410;625;1794;35;127;377;1041;412;1168
353215;201801;416;1238;343;1084;54;194;131;343;185;537
353220;201801;596;1740;440;1423;111;368;91;278;202;646
353230;201801;795;2415;680;2227;165;589;248;715;413;1304
353240;201801;2096;6296;1769;5670;234;880;1061;3270;1295;4150
353250;201801;1086;2738;744;2111;124;368;326;897;450;1265
353260;201801;915;2460;568;1785;121;404;159;465;280;869
353270;201801;606;1739;504;1530;69;205;236;687;305;892
353280;201801;670;1989;481;1566;83;280;142;448;225;728
353282;201801;1789;5414;1584;5000;220;763;889;2682;1109;3445
353284;201801;400;1023;212;639;38;132;69;185;107;317
353286;201801;128;375;92;305;23;74;23;62;46;136
353290;201801;1095;3152;804;2572;93;376;439;1269;532;1645
353300;201801;1540;4491;1173;3726;199;705;471;1359;670;2064
353310;201801;290;777;209;635;35;121;99;280;134;401
353320;201801;587;1624;488;1435;34;100;340;991;374;1091
353325;201801;599;1877;423;1476;79;284;126;436;205;720
353330;201801;527;1445;351;1054;42;146;189;529;231;675
353340;201801;2922;8159;1975;6403;539;1880;602;1947;1141;3827
353350;201801;3196;9305;2224;7147;535;1835;420;1207;955;3042
353360;201801;474;1527;413;1405;60;233;232;774;292;1007
353370;201801;570;1860;492;1700;48;184;294;982;342;1166
353380;201801;285;934;234;816;39;148;85;290;124;438
353390;201801;5574;14803;4055;12078;770;2428;1578;4472;2348;6900
353400;201801;426;1286;343;1115;67;239;68;172;135;411
353410;201801;570;1618;462;1419;84;284;229;677;313;961
353420;201801;519;1427;303;930;66;199;34;87;100;286
353430;201801;2072;6491;1550;5321;413;1544;384;1244;797;2788
353440;201801;56759;168534;41927;137921;9748;33433;17171;54666;26919;88099
353450;201801;387;1062;265;811;41;149;109;309;150;458
353460;201801;3322;9327;2428;7536;265;941;1070;3323;1335;4264
353470;201801;6843;19612;4961;15946;1060;3705;1529;4601;2589;8306
353475;201801;1384;3837;1017;3042;151;492;402;1095;553;1587
353480;201801;1397;4109;1233;3800;88;284;872;2631;960;2915
353490;201801;931;2640;671;2073;134;412;265;784;399;1196
353500;201801;933;2391;755;2110;191;531;395;1123;586;1654
353510;201801;840;2635;609;2035;167;569;100;299;267;868
353520;201801;1111;3025;779;2422;91;317;371;1086;462;1403
353530;201801;2258;6358;1835;5538;248;855;981;2770;1229;3625
353540;201801;1895;5662;1602;5138;339;1147;783;2448;1122;3595
353550;201801;5706;16069;4594;14084;814;2701;2306;6721;3120;9422
353560;201801;2080;6483;1637;5704;545;2057;381;1255;926;3312
353570;201801;490;1438;358;1172;80;262;160;511;240;773
353580;201801;2176;6088;1763;5324;396;1249;866;2527;1262;3776
353590;201801;664;1929;426;1377;89;297;152;505;241;802
353600;201801;1644;4486;1391;3996;166;529;739;2010;905;2539
353610;201801;598;2003;456;1688;98;394;100;336;198;730
353620;201801;2343;7097;1804;6032;438;1564;448;1396;886;2960
353625;201801;501;1323;296;914;33;120;159;463;192;583
353630;201801;1249;4221;958;3491;200;767;187;632;387;1399
353640;201801;1346;3720;1036;3132;121;438;591;1737;712;2175
353650;201801;8752;24936;6572;20351;1044;3470;3169;9248;4213;12718
353657;201801;302;892;246;792;38;121;95;278;133;399
353660;201801;1043;2412;713;1883;130;396;366;855;496;1251
353670;201801;3349;10366;2784;9215;752;2719;1136;3532;1888;6251
353680;201801;707;2089;547;1828;132;475;227;731;359;1206
353690;201801;498;1309;219;698;25;77;30;84;55;161
353700;201801;1927;5664;1648;5119;237;800;946;2799;1183;3599
353710;201801;3470;7992;1764;5118;319;918;735;1972;1054;2890
353715;201801;535;1515;372;1191;24;96;100;283;124;379
353720;201801;1846;5434;1510;4930;278;1007;793;2481;1071;3488
353730;201801;4167;12149;3162;10007;565;1961;1292;3725;1857;5686
353740;201801;1769;5031;1270;4072;326;1146;326;974;652;2120
353750;201801;863;2809;602;2231;159;638;106;386;265;1024
353760;201801;11169;28476;8942;25378;1318;4180;5616;15612;6934;19792
353770;201801;660;2035;334;1179;70;267;35;76;105;343
353780;201801;4350;13809;3512;12109;1003;3782;851;2750;1854;6532
353790;201801;2154;7103;1695;6131;493;2058;392;1267;885;3325
353800;201801;16171;47310;12698;41144;2695;9399;5438;17389;8133;26788
353810;201801;1030;3063;724;2424;133;517;258;821;391;1338
353820;201801;1522;4733;1210;4014;224;852;504;1601;728;2453
353830;201801;597;1592;462;1358;60;181;245;682;305;863
353850;201801;1669;4922;1330;4246;366;1155;422;1381;788;2536
353860;201801;2506;7739;2012;6671;529;1823;690;2216;1219;4039
353870;201801;27303;76597;18962;59812;3187;11085;7621;21889;10808;32974
353880;201801;2772;8325;2256;7361;262;962;1242;3974;1504;4936
353890;201801;2289;5468;1630;4458;196;602;984;2539;1180;3141
353900;201801;738;2212;550;1840;117;430;189;583;306;1013
353910;201801;1959;6491;1752;6156;237;857;1202;4333;1439;5190
353920;201801;2276;6546;1546;5054;338;1234;298;840;636;2074
353930;201801;4254;12283;2948;9866;770;2828;541;1664;1311;4492
353940;201801;1096;3458;798;2772;154;562;218;720;372;1282
353950;201801;2939;8919;2431;7865;479;1727;1184;3529;1663;5256
353960;201801;591;1781;407;1374;96;305;111;370;207;675
353970;201801;585;1600;469;1395;46;141;296;858;342;999
353980;201801;13013;36489;10595;32277;1756;5667;5959;17667;7715;23334
353990;201801;708;1877;470;1423;50;164;281;811;331;975
354000;201801;2214;5875;1353;4196;264;887;218;655;482;1542
354010;201801;357;1013;268;841;36;119;165;498;201;617
354020;201801;3735;11330;3077;9896;801;2825;985;2851;1786;5676
354025;201801;771;2165;537;1726;118;393;145;478;263;871
354030;201801;481;1177;275;780;47;137;104;274;151;411
354040;201801;745;1914;480;1412;40;129;285;785;325;914
354050;201801;942;2891;685;2350;165;632;156;508;321;1140
354060;201801;4382;13162;2982;10065;797;2797;729;2281;1526;5078
354070;201801;2928;9074;2243;7622;546;2016;472;1405;1018;3421
354075;201801;2039;6785;1661;6032;287;1189;838;2970;1125;4159
354080;201801;1469;4297;968;3216;181;655;266;775;447;1430
354085;201801;396;866;329;785;4;24;235;527;239;551
354090;201801;1451;4173;1296;3867;140;483;892;2615;1032;3098
354100;201801;14806;45823;11481;39857;2808;10520;4536;15439;7344;25959
354105;201801;952;2665;817;2466;157;476;477;1453;634;1929
354110;201801;503;1376;384;1198;105;370;111;310;216;680
354120;201801;1633;4547;1132;3448;193;622;393;1082;586;1704
354130;201801;5678;15869;3932;12419;1267;4326;206;454;1473;4780
354140;201801;21723;54288;14063;40637;3001;9275;4539;12083;7540;21358
354150;201801;3443;8930;2561;7349;520;1593;1085;2987;1605;4580
354160;201801;3266;10218;2501;8512;726;2572;712;2373;1438;4945
354165;201801;526;1659;436;1478;93;374;216;684;309;1058
354170;201801;1364;4194;1105;3587;115;415;587;1786;702;2201
354180;201801;452;1372;352;1152;64;237;126;358;190;595
354190;201801;1440;4355;1125;3717;180;666;383;1244;563;1910
354200;201801;909;2511;727;2178;84;274;347;962;431;1236
354210;201801;654;1969;521;1723;60;241;294;885;354;1126
354220;201801;2977;8440;2347;7243;424;1395;1128;3362;1552;4757
354230;201801;689;1987;554;1779;74;298;294;856;368;1154
354240;201801;1311;4050;915;3177;172;648;219;665;391;1313
354250;201801;520;1400;337;1093;100;338;86;285;186;623
354260;201801;7591;21838;6029;19111;1510;5054;1953;6253;3463;11307
354270;201801;1101;3511;886;3077;170;627;324;1114;494;1741
354280;201801;709;1970;606;1808;95;358;357;969;452;1327
354290;201801;861;2964;755;2708;161;607;307;1081;468;1688
354300;201801;3667;11411;3291;10710;1040;3515;1117;3495;2157;7010
354310;201801;766;2351;616;2025;123;430;273;853;396;1283
354320;201801;837;2302;545;1737;114;417;191;556;305;973
354323;201801;497;1295;344;1002;38;108;139;378;177;486
354325;201801;1201;3818;889;3104;156;568;315;1038;471;1606
354330;201801;6429;17894;4980;15228;878;3168;2615;7306;3493;10474
354340;201801;24420;68684;17936;57480;4655;16188;6541;20169;11196;36357
354350;201801;1099;3083;918;2721;154;513;531;1441;685;1954
354360;201801;498;1474;296;1048;54;184;38;133;92;317
354370;201801;1047;3407;879;3067;126;504;470;1594;596;2098
354380;201801;779;2210;543;1778;129;493;99;270;228;763
354390;201801;13241;35548;8657;27113;1666;5586;2192;6464;3858;12050
354400;201801;1567;5292;1243;4492;229;899;399;1418;628;2317
354410;201801;5013;14872;4075;13100;978;3407;1647;5090;2625;8497
354420;201801;1377;3909;987;3077;149;496;507;1501;656;1997
354425;201801;2104;5832;1701;5076;420;1305;587;1800;1007;3105
354430;201801;1445;4305;1171;3850;204;765;560;1743;764;2508
354440;201801;535;1525;356;1147;41;141;158;474;199;615
354450;201801;373;1039;214;699;32;115;49;141;81;256
354460;201801;957;2610;669;2047;112;364;285;853;397;1217
354470;201801;536;1365;378;1046;31;103;189;465;220;568
354480;201801;878;2209;651;1853;66;206;391;1064;457;1270
354490;201801;748;2397;592;2040;109;407;238;774;347;1181
354500;201801;2027;6151;1721;5682;572;2076;409;1329;981;3405
354510;201801;809;2231;679;1965;100;288;357;961;457;1249
354515;201801;267;838;207;718;41;170;84;285;125;455
354520;201801;7016;21350;4241;14041;717;2667;1996;6108;2713;8775
354530;201801;3550;11236;2872;9820;702;2554;1101;3721;1803;6275
354540;201801;1259;3613;928;2990;233;802;269;868;502;1670
354550;201801;531;1454;399;1207;67;211;218;628;285;839
354560;201801;1821;4833;1032;3133;134;429;491;1420;625;1849
354570;201801;1106;3050;476;1497;95;338;65;185;160;523
354580;201801;10024;27447;6641;20992;1181;4055;2713;8070;3894;12125
354600;201801;1630;4901;1313;4304;225;805;672;2118;897;2923
354610;201801;363;1002;203;636;40;140;60;172;100;312
354620;201801;440;1318;302;1055;57;239;105;310;162;549
354625;201801;312;935;193;668;26;94;46;134;72;228
354630;201801;2002;6353;1674;5663;685;2466;164;523;849;2989
354640;201801;3037;9610;2249;7828;455;1741;495;1568;950;3309
354650;201801;875;2471;728;2194;93;284;453;1400;546;1684
354660;201801;2461;6517;1710;5267;118;443;1173;3569;1291;4012
354670;201801;1009;2995;721;2321;166;585;209;598;375;1183
354680;201801;4409;13203;3795;12152;989;3311;1818;5816;2807;9127
354690;201801;698;2212;470;1676;107;404;102;342;209;746
354700;201801;1001;2783;701;2143;135;461;293;783;428;1244
354710;201801;513;1501;370;1186;44;158;169;493;213;651
354720;201801;267;697;137;423;38;115;24;71;62;186
354730;201801;9300;27532;6877;22907;1177;4312;3452;10999;4629;15311
354740;201801;324;909;129;462;17;77;21;70;38;147
354750;201801;2473;6980;1691;5521;328;1219;646;1955;974;3174
354760;201801;1798;5420;1345;4495;427;1519;220;742;647;2261
354765;201801;308;845;144;475;19;69;31;95;50;164
354770;201801;2190;5847;1580;4755;408;1320;526;1535;934;2855
354780;201801;54228;145025;43246;123195;6621;21006;23269;62015;29890;83021
354790;201801;860;2644;717;2370;103;353;374;1207;477;1560
354800;201801;2469;6890;1978;6082;394;1320;938;2761;1332;4081
354805;201801;970;2778;717;2250;83;287;270;749;353;1036
354810;201801;581;1804;348;1265;62;252;82;269;144;521
354820;201801;906;2906;709;2497;137;539;165;510;302;1049
354830;201801;457;1180;315;915;105;304;108;306;213;610
354840;201801;751;2144;495;1543;77;231;225;683;302;914
354850;201801;18918;54182;13552;43760;2297;8519;6852;20556;9149;29075
354860;201801;1336;4040;1014;3430;215;806;321;974;536;1780
354870;201801;45926;124443;37285;108559;6555;20790;19352;53930;25907;74720
354880;201801;4921;12869;2455;7510;337;1179;831;2098;1168;3277
354890;201801;15061;41549;12344;36804;2160;7030;6267;18002;8427;25032
354900;201801;453;1286;289;942;35;120;82;260;117;380
354910;201801;5484;15419;3029;10406;636;2381;242;779;878;3160
354920;201801;329;933;187;623;27;116;28;72;55;188
354925;201801;263;792;135;479;27;96;25;79;52;175
354930;201801;347;886;210;644;30;101;97;281;127;382
354940;201801;1730;5861;1367;4970;484;1882;134;437;618;2319
354950;201801;1439;4239;1167;3797;105;444;717;2210;822;2654
354960;201801;777;2231;618;1981;129;470;266;810;395;1280
354970;201801;3744;11671;3114;10426;510;1900;1736;5607;2246;7507
354980;201801;26584;68623;18056;53093;2602;8917;8654;23430;11256;32347
354990;201801;56936;155380;42775;129048;5865;19391;22680;65577;28545;84968
354995;201801;2137;5754;1621;4992;332;1108;880;2617;1212;3725
355000;201801;1423;4176;1160;3722;259;951;268;735;527;1686
355010;201801;3083;9328;2195;7215;758;2654;223;740;981;3394
355020;201801;3062;9485;2291;7925;769;2956;598;1967;1367;4923
355030;201801;1219164;3131538;947521;2621092;184192;555366;433815;1123348;618007;1678714
355040;201801;2719;7802;2308;7163;393;1252;1431;4441;1824;5693
355050;201801;997;2820;756;2376;225;703;170;501;395;1204
355060;201801;4742;14276;3663;12126;710;2672;1545;4594;2255;7266
355070;201801;7297;20902;5984;18643;928;3338;3292;9564;4220;12902
355080;201801;858;2786;575;2152;107;459;46;144;153;603
355090;201801;1112;3509;891;3062;198;698;278;968;476;1666
355100;201801;18235;52749;14782;47286;3166;10902;8065;25223;11231;36125
355110;201801;1057;3179;815;2757;310;1130;149;492;459;1622
355120;201801;613;1812;457;1519;81;307;166;526;247;833
355130;201801;604;1476;270;765;33;96;99;254;132;350
355140;201801;1225;3644;1125;3480;167;594;761;2312;928;2906
355150;201801;3768;10723;3035;9424;542;1802;1437;4396;1979;6198
355160;201801;1746;5205;1349;4488;369;1384;324;1019;693;2403
355170;201801;8712;23726;6746;20582;1986;6379;2533;7765;4519;14144
355180;201801;2685;7979;2027;6761;465;1828;640;1907;1105;3735
355190;201801;1566;4621;1289;4115;363;1270;514;1716;877;2986
355200;201801;793;2643;687;2448;288;1122;158;509;446;1631
355210;201801;2919;8530;2515;7720;283;1027;1601;4656;1884;5683
355220;201801;40049;114452;32132;98989;9290;30363;10242;28844;19532;59207
355230;201801;1256;3273;715;2168;145;438;173;489;318;927
355240;201801;22820;63227;15642;48820;3162;10312;5964;18306;9126;28618
355250;201801;32384;93086;25105;79887;6733;22811;8412;26043;15145;48854
355255;201801;826;2199;449;1412;79;232;145;467;224;699
355260;201801;1189;3304;905;2827;135;524;525;1519;660;2043
355270;201801;1483;4603;1168;3873;280;990;403;1247;683;2237
355280;201801;26530;73700;20002;61092;3648;11967;8445;24525;12093;36492
355290;201801;800;2479;614;2021;150;470;180;552;330;1022
355300;201801;1288;3975;1050;3474;228;793;319;1038;547;1831
355310;201801;1009;2909;772;2503;94;338;402;1302;496;1640
355320;201801;534;1520;426;1310;87;322;165;423;252;745
355330;201801;1977;5699;1462;4734;228;810;803;2484;1031;3294
355340;201801;3041;7233;2576;6568;294;768;1777;4463;2071;5231
355350;201801;1317;4194;987;3459;219;840;291;989;510;1829
355360;201801;1203;3470;1046;3138;106;320;749;2304;855;2624
355365;201801;356;996;190;661;39;120;24;84;63;204
355370;201801;6170;15948;4808;14069;1106;3373;2127;6649;3233;10022
355380;201801;2979;8571;2274;7103;458;1527;616;1657;1074;3184
355385;201801;1160;3504;1011;3231;205;742;463;1353;668;2095
355390;201801;736;2126;565;1774;114;376;210;603;324;979
355395;201801;1915;5719;1409;4572;217;752;573;1731;790;2483
355400;201801;8766;27885;7345;24884;2228;8187;1947;6077;4175;14264
355410;201801;21010;61295;14827;49409;3822;13921;2953;9880;6775;23801
355420;201801;689;2420;601;2226;155;670;133;498;288;1168
355430;201801;3637;9648;2873;8324;677;1989;1278;3705;1955;5694
355440;201801;831;2400;574;1840;120;404;158;463;278;867
355450;201801;3626;10107;2263;7225;445;1506;715;2103;1160;3609
355460;201801;552;1449;353;1083;56;202;142;370;198;572
355465;201801;361;1095;262;865;56;203;60;177;116;380
355470;201801;1143;3101;629;2012;174;573;182;554;356;1127
355475;201801;248;665;225;622;19;63;175;472;194;535
355480;201801;3360;10525;2893;9695;527;2024;1631;5256;2158;7280
355490;201801;942;2686;538;1781;75;268;173;548;248;816
355495;201801;781;2417;616;2086;107;400;178;565;285;965
355500;201801;6622;18776;4115;13276;663;2303;965;2909;1628;5212
355510;201801;1698;4321;854;2685;124;425;245;671;369;1096
355520;201801;409;946;201;553;21;63;103;265;124;328
355530;201801;467;1057;171;490;19;68;53;118;72;186
355535;201801;567;1642;439;1415;123;457;141;399;264;856
355540;201801;8372;24336;7269;22634;1442;4821;4159;12609;5601;17430
355550;201801;681;2087;542;1803;72;239;229;764;301;1003
355560;201801;1073;3134;600;2045;117;422;31;100;148;522
355570;201801;236;701;124;423;22;80;18;63;40;143
355580;201801;1208;3185;811;2469;114;425;371;1076;485;1501
355590;201801;191;511;145;437;21;71;78;228;99;299
355600;201801;1433;3870;1006;3047;247;821;354;995;601;1816
355610;201801;1640;4434;1172;3527;180;577;539;1550;719;2127
355620;201801;4483;13198;3479;11028;496;1817;1716;4963;2212;6780
355630;201801;2246;6584;1592;5313;352;1220;565;1896;917;3116
355635;201801;918;2822;761;2551;96;339;485;1675;581;2014
355640;201801;2695;8287;1894;6672;452;1688;353;1236;805;2924
355645;201801;4008;12376;3306;11217;411;1664;2032;6762;2443;8426
355650;201801;6787;19451;5718;17467;1354;4528;3018;8593;4372;13121
355660;201801;1258;3653;933;2994;129;519;375;1167;504;1686
355670;201801;3270;9769;2252;7317;379;1409;970;2784;1349;4193
355680;201801;2622;7758;1181;4093;332;1243;92;266;424;1509
355690;201801;579;1840;391;1438;110;433;15;36;125;469
355695;201801;237;773;135;486;13;50;18;53;31;103
355700;201801;5925;18475;4992;16357;1242;4148;2024;6423;3266;10571
355710;201801;8653;21257;5298;15151;1008;3061;1695;4421;2703;7482
355715;201801;387;1153;234;778;58;215;49;152;107;367
355720;201801;1437;4552;1166;3972;243;873;460;1422;703;2295
355730;201801;836;2601;701;2312;190;619;215;667;405;1286
410010;201801;1303;3820;1016;3186;226;783;206;631;432;1414
410020;201801;1083;3493;912;3092;298;1008;277;923;575;1931
410030;201801;1272;4005;1069;3579;239;873;401;1330;640;2203
410040;201801;10329;31650;8512;28234;1865;6786;2742;8730;4607;15516
410045;201801;1010;2758;690;2163;111;398;199;568;310;966
410050;201801;2655;6901;1652;5043;394;1293;258;687;652;1980
410060;201801;2134;6400;1740;5584;417;1398;592;1871;1009;3269
410070;201801;1644;4496;1229;3686;277;909;400;1141;677;2050
410080;201801;1361;3756;1023;3138;176;581;410;1230;586;1811
410090;201801;971;2851;902;2718;129;398;473;1492;602;1890
410100;201801;2260;6889;1624;5327;250;941;263;839;513;1780
410105;201801;362;1090;222;740;46;187;42;124;88;311
410110;201801;3069;8426;2214;6681;328;1066;784;2312;1112;3378
410115;201801;515;1349;371;1085;77;252;126;337;203;589
410120;201801;2425;7941;2171;7476;844;3049;510;1722;1354;4771
410130;201801;1075;3159;975;2974;339;1157;299;781;638;1938
410140;201801;15466;39545;9814;29250;2034;6591;2036;5648;4070;12239
410150;201801;16254;40538;7962;23378;1530;4803;1295;3630;2825;8433
410160;201801;2894;8511;2472;7728;531;1845;927;2945;1458;4790
410165;201801;646;1866;535;1612;70;232;300;849;370;1081
410170;201801;2193;6105;1627;4856;454;1482;180;511;634;1993
410180;201801;12428;37293;10132;32208;1859;6351;4637;13704;6496;20055
410185;201801;510;1428;373;1166;69;223;106;306;175;529
410190;201801;1958;5464;1531;4614;338;1074;314;898;652;1972
410200;201801;3961;10343;2548;7663;534;1850;484;1422;1018;3272
410210;201801;2552;7260;1755;5518;287;1018;446;1182;733;2200
410220;201801;616;1618;417;1239;52;177;109;332;161;509
410230;201801;1428;4273;1217;3852;248;893;546;1623;794;2516
410240;201801;4189;12169;3521;10857;1051;3600;433;1308;1484;4908
410250;201801;2644;6916;1844;5423;384;1261;533;1489;917;2750
410260;201801;1651;4426;1159;3546;230;796;502;1487;732;2283
410270;201801;506;1359;390;1139;33;115;194;554;227;669
410275;201801;749;2242;489;1625;71;244;195;636;266;880
410280;201801;2085;5934;1410;4509;301;1080;409;1179;710;2259
410290;201801;3241;9600;2493;8036;574;1830;904;2935;1478;4765
410300;201801;675;1796;532;1522;90;281;228;599;318;880
410302;201801;426;1116;219;703;22;71;105;338;127;409
410304;201801;1137;3419;994;3109;202;682;483;1501;685;2183
410305;201801;1696;4440;1265;3734;318;965;551;1629;869;2594
410310;201801;2318;7064;1949;6394;422;1523;618;2020;1040;3543
410315;201801;784;2086;424;1421;103;354;100;326;203;680
410320;201801;1129;3319;738;2431;101;380;110;338;211;718
410322;201801;526;1495;284;915;29;96;89;277;118;373
410330;201801;1383;3688;1048;3032;228;723;266;752;494;1475
410335;201801;858;2462;707;2161;115;411;308;859;423;1270
410337;201801;762;1976;541;1555;65;199;220;593;285;792
410340;201801;507;1417;345;1018;47;155;135;329;182;484
410345;201801;2027;5553;1193;3756;262;850;281;831;543;1681
410347;201801;710;1834;509;1468;56;192;150;412;206;604
410350;201801;1197;3428;892;2815;133;467;274;784;407;1251
410360;201801;3972;10211;3080;8675;285;938;1855;5062;2140;6000
410370;201801;11109;31171;7788;23713;1206;4106;2676;7178;3882;11284
410380;201801;1322;3698;1086;3225;132;484;418;1149;550;1633
410390;201801;2503;7113;1726;5504;490;1699;330;933;820;2632
410395;201801;895;2765;728;2396;158;578;319;1054;477;1632
410400;201801;4720;13900;3723;11839;716;2447;1389;4234;2105;6681
410405;201801;795;2129;646;1884;144;447;284;813;428;1260
410410;201801;1115;3336;1088;3303;220;833;619;1846;839;2679
410420;201801;7011;21828;5518;18538;1202;4476;1177;3589;2379;8065
410425;201801;2743;8323;2024;6845;377;1368;562;1774;939;3142
410430;201801;12798;33644;9060;26738;1591;5096;2779;7745;4370;12841
410440;201801;2893;9700;2567;9072;447;1643;1331;4928;1778;6571
410442;201801;2376;7710;2078;7066;631;2284;613;2043;1244;4327
410445;201801;2271;7002;1840;6142;431;1590;528;1803;959;3393
410450;201801;1743;4861;1320;4014;257;849;264;685;521;1534
410460;201801;1646;4576;1277;3939;269;896;392;1142;661;2038
410465;201801;2319;7291;1890;6364;448;1515;572;1869;1020;3384
410470;201801;1782;5492;1339;4511;334;1221;247;858;581;2079
410480;201801;30428;81951;17828;56686;2809;9835;1779;4910;4588;14745
410490;201801;10910;32206;7958;25905;1665;5797;2372;7234;4037;13031
410500;201801;1593;4756;1191;3883;328;1185;208;571;536;1756
410510;201801;2211;5780;1448;4213;267;793;472;1337;739;2130
410520;201801;2985;9953;2740;9453;749;2658;1195;4172;1944;6830
410530;201801;1487;4044;808;2447;142;444;89;213;231;657
410540;201801;2681;7713;1907;6115;324;1088;810;2578;1134;3666
410550;201801;6392;17858;4210;13088;824;2795;745;2046;1569;4841
410560;201801;1313;3685;1028;3138;238;794;391;1087;629;1881
410570;201801;2577;7832;2085;6911;568;2104;323;1136;891;3240
410580;201801;22566;63488;17592;54021;3705;12656;6695;19000;10400;31656
410590;201801;1389;4226;932;3046;165;571;205;593;370;1164
410600;201801;1716;4926;1350;4194;320;984;454;1449;774;2433
410610;201801;741;2072;546;1692;60;204;195;569;255;773
410620;201801;1874;5963;1257;4442;301;1152;149;448;450;1600
410630;201801;2246;6562;1479;4824;293;1058;148;373;441;1431
410640;201801;4042;10489;2824;8348;740;2469;418;1176;1158;3645
410645;201801;1101;3591;986;3405;402;1433;265;959;667;2392
410650;201801;1960;5806;1478;4782;403;1404;356;1039;759;2443
410655;201801;1358;4482;1106;3988;55;199;744;2875;799;3074
410657;201801;695;1865;444;1344;87;281;167;450;254;731
410660;201801;3031;8267;1648;5190;340;1106;237;708;577;1814
410670;201801;898;2331;598;1736;102;301;274;762;376;1063
410680;201801;2871;9024;2118;7163;548;1799;477;1717;1025;3516
410685;201801;581;1627;482;1442;84;290;250;702;334;992
410690;201801;117965;319062;79569;242667;14541;49362;22698;60550;37239;109912
410700;201801;2177;6052;1877;5531;399;1248;860;2397;1259;3645
410710;201801;881;2484;593;1904;86;286;252;765;338;1051
410712;201801;706;2085;613;1916;186;631;218;636;404;1267
410715;201801;842;2688;574;2028;113;414;151;517;264;931
410720;201801;2860;8180;2219;6835;346;1254;421;1174;767;2428
410725;201801;1062;2866;689;2139;123;401;103;292;226;693
410730;201801;553;1517;402;1235;96;334;71;209;167;543
410740;201801;911;2647;641;2108;118;425;251;824;369;1249
410750;201801;1730;4798;1406;4160;268;871;513;1441;781;2312
410752;201801;312;813;145;447;23;79;47;123;70;202
410753;201801;252;754;169;566;20;70;28;79;48;149
410754;201801;1092;3029;928;2765;57;149;604;1965;661;2114
410755;201801;710;1773;506;1414;46;144;276;726;322;870
410760;201801;2724;7755;2209;6818;624;2071;591;1799;1215;3870
410765;201801;12816;38155;9957;32551;1667;6082;1157;3588;2824;9670
410770;201801;918;2411;638;1910;112;357;225;660;337;1017
410773;201801;1302;3641;1162;3437;164;556;833;2407;997;2963
410775;201801;1396;3848;1234;3580;219;699;484;1372;703;2071
410780;201801;594;1548;357;1057;77;235;79;255;156;490
410785;201801;758;2260;624;1992;153;532;183;549;336;1081
410790;201801;535;1666;444;1458;130;455;37;94;167;549
410800;201801;2900;6868;2293;5942;213;624;1081;2738;1294;3362
410810;201801;323;932;259;807;42;155;106;312;148;467
410820;201801;806;2421;507;1616;112;363;74;227;186;590
410830;201801;28644;77401;21620;65104;5669;18982;6846;19596;12515;38578
410832;201801;1001;2744;848;2453;111;410;469;1261;580;1671
410840;201801;6924;19124;4351;13947;1016;3592;508;1289;1524;4881
410845;201801;1125;3232;928;2867;193;633;305;910;498;1543
410850;201801;2442;7285;2135;6739;454;1573;838;2658;1292;4231
410855;201801;588;1596;427;1269;44;149;184;506;228;655
410860;201801;3922;10672;3044;8997;545;1706;986;2826;1531;4532
410865;201801;1399;4516;1261;4224;277;996;686;2360;963;3356
410870;201801;1206;3454;1062;3239;103;320;707;2185;810;2505
410880;201801;3911;11641;3007;9855;556;2022;425;1459;981;3481
410890;201801;903;2811;689;2348;153;565;171;559;324;1124
410895;201801;950;3184;823;2900;318;1214;130;424;448;1638
410900;201801;866;2373;589;1811;99;335;152;387;251;722
410910;201801;365;905;225;626;13;37;116;300;129;337
410920;201801;748;2027;589;1755;135;454;219;630;354;1084
410930;201801;1505;4384;1214;3784;336;1195;271;805;607;2000
410940;201801;20847;62976;16485;54662;4725;16889;3161;10724;7886;27613
410950;201801;1856;5763;1682;5480;84;332;1370;4405;1454;4737
410960;201801;7549;20254;4742;15033;1232;4322;1287;3936;2519;8258
410965;201801;1000;2876;766;2396;149;492;327;973;476;1465
410970;201801;3995;11334;2936;9285;729;2718;443;1247;1172;3965
410975;201801;1366;3786;1055;3195;203;723;358;1049;561;1772
410980;201801;6586;17893;4364;13591;622;2100;1617;4824;2239;6924
410990;201801;1071;2985;705;2247;210;758;148;386;358;1144
411000;201801;457;1343;328;1075;43;158;75;205;118;363
411005;201801;451;1292;287;925;59;188;47;151;106;339
411007;201801;2197;6691;1897;6116;473;1640;581;1847;1054;3487
411010;201801;4117;13142;3466;11746;975;3511;360;1135;1335;4646
411020;201801;2361;7023;1993;6377;611;2072;565;1750;1176;3822
411030;201801;691;1837;455;1295;80;238;140;359;220;597
411040;201801;744;2060;330;1038;55;179;61;179;116;358
411050;201801;1855;6206;1598;5609;461;1744;241;742;702;2486
411060;201801;1564;4444;1097;3476;219;826;198;548;417;1374
411065;201801;328;933;249;783;43;135;102;319;145;454
411070;201801;6341;17766;4982;15221;1066;3585;1673;4852;2739;8437
411080;201801;2091;5902;1712;5196;475;1549;403;1232;878;2781
411090;201801;794;2091;532;1609;43;141;96;264;139;405
411095;201801;1430;3654;1030;2955;155;500;373;1007;528;1507
411100;201801;1150;3263;819;2592;111;427;216;682;327;1109
411110;201801;570;1606;266;900;25;78;17;40;42;118
411120;201801;1394;4143;1075;3467;345;1270;198;534;543;1804
411125;201801;4560;14126;4237;13537;1047;3463;1829;6023;2876;9486
411130;201801;665;1882;474;1468;93;287;158;524;251;811
411140;201801;2230;7190;1861;6343;441;1573;730;2533;1171;4106
411150;201801;3800;10416;2751;8317;578;1978;229;559;807;2537
411155;201801;958;2562;617;1911;74;246;257;731;331;977
411160;201801;295;768;209;615;32;93;52;153;84;246
411170;201801;736;2252;570;1870;131;448;169;552;300;1000
411180;201801;5346;15220;4226;13137;823;2819;1572;4734;2395;7553
411190;201801;1319;3661;1031;3088;241;782;268;699;509;1481
411200;201801;4515;12850;3360;10662;895;3054;902;2774;1797;5828
411210;201801;2027;5345;1573;4602;467;1542;165;429;632;1971
411220;201801;850;2357;675;2015;155;504;225;639;380;1143
411230;201801;1074;2964;702;2243;150;508;188;598;338;1106
411240;201801;1594;3776;914;2621;118;362;420;1156;538;1518
411250;201801;1950;5594;1560;4887;370;1322;478;1475;848;2797
411260;201801;349;908;220;661;34;105;83;228;117;333
411270;201801;1786;5282;1475;4655;252;882;660;2024;912;2906
411275;201801;1282;3475;953;2821;193;631;299;809;492;1440
411280;201801;1447;4083;912;2918;169;591;141;388;310;979
411290;201801;719;2028;514;1625;82;265;206;648;288;913
411295;201801;1056;2748;872;2405;128;391;365;959;493;1350
411300;201801;971;2532;643;1873;63;192;240;606;303;798
411310;201801;851;2183;662;1889;49;149;246;694;295;843
411320;201801;5118;14452;3747;11854;887;2900;914;2681;1801;5581
411325;201801;1510;4565;1318;4186;247;807;670;2182;917;2989
411330;201801;3133;9279;2433;7888;652;2297;592;1953;1244;4250
411340;201801;774;2244;494;1577;59;231;216;664;275;895
411342;201801;747;1951;548;1572;124;375;214;578;338;953
411345;201801;983;2816;817;2506;126;453;470;1427;596;1880
411350;201801;2632;7564;1892;6077;493;1748;178;580;671;2328
411360;201801;618;1555;434;1267;53;178;153;415;206;593
411370;201801;45346;120666;34369;101280;3994;13708;17616;48455;21610;62163
411373;201801;1342;3756;1102;3362;149;497;474;1460;623;1957
411375;201801;1044;2804;776;2313;136;438;259;708;395;1146
411380;201801;1029;2684;692;1937;80;267;316;780;396;1047
411390;201801;1710;4979;1348;4116;238;780;446;1235;684;2015
411400;201801;2074;5589;1662;4773;303;1002;636;1728;939;2730
411410;201801;2045;6003;1528;4888;354;1237;322;919;676;2156
411420;201801;3881;10327;2377;7307;373;1299;382;924;755;2223
411430;201801;3197;9261;2632;8297;581;1952;1109;3378;1690;5330
411435;201801;459;1374;328;1097;69;217;121;385;190;602
411440;201801;2594;8035;2192;7194;541;1874;596;2040;1137;3914
411450;201801;2596;7204;2041;6278;351;1084;1058;3327;1409;4411
411460;201801;3797;10591;2115;6956;347;1348;304;898;651;2246
411470;201801;746;2169;502;1617;90;315;91;268;181;583
411480;201801;4289;12558;3020;9998;592;2155;602;1879;1194;4034
411490;201801;1469;4184;1149;3595;199;730;353;967;552;1697
411500;201801;1599;4230;1107;3344;173;607;331;968;504;1575
411510;201801;1972;5653;1631;4965;421;1435;329;994;750;2429
411520;201801;25641;66505;14815;44810;2285;7577;3968;10695;6253;18272
411530;201801;918;2525;607;1932;122;424;180;541;302;965
411535;201801;468;1418;216;773;19;73;22;59;41;132
411540;201801;2908;7659;2102;6011;429;1344;637;1679;1066;3023
411545;201801;997;3057;852;2779;91;312;533;1765;624;2077
411550;201801;680;1825;528;1555;102;335;91;252;193;587
411560;201801;1975;5657;1282;4158;190;712;78;180;268;892
411570;201801;7179;18060;5046;14673;1076;3543;1238;3566;2314;7109
411573;201801;812;2281;707;2113;76;242;425;1258;501;1500
411575;201801;1599;4736;1318;4186;313;1054;361;1145;674;2199
411580;201801;4072;10538;2392;7613;266;1033;317;920;583;1953
411585;201801;756;2337;362;1259;71;259;63;184;134;443
411590;201801;357;1021;276;867;36;128;127;359;163;487
411600;201801;287;810;197;649;42;154;71;231;113;385
411605;201801;1464;3994;981;2955;146;522;382;1085;528;1607
411610;201801;2161;5878;1582;4671;286;931;646;1851;932;2782
411620;201801;2809;8219;2460;7668;443;1533;1390;4281;1833;5814
411630;201801;537;1455;360;1125;84;304;61;151;145;455
411640;201801;476;1396;336;1054;46;141;111;339;157;480
411650;201801;193;573;139;462;26;89;19;69;45;158
411660;201801;870;2307;612;1813;46;142;310;888;356;1030
411670;201801;1096;2962;838;2416;141;410;290;804;431;1214
411680;201801;1529;4361;1246;3831;187;654;613;1870;800;2524
411690;201801;3289;9274;2488;7782;500;1643;691;2232;1191;3875
411695;201801;664;2093;497;1691;77;291;153;536;230;827
411700;201801;1502;4217;1042;3307;225;773;146;414;371;1187
411705;201801;1634;5659;1458;5304;319;1131;795;3049;1114;4180
411710;201801;1715;4754;1289;3928;360;1167;177;541;537;1708
411720;201801;898;2433;699;2036;97;300;242;661;339;961
411721;201801;818;2304;644;1941;133;418;126;376;259;794
411722;201801;646;1856;396;1284;71;279;137;364;208;643
411725;201801;1280;3974;812;2837;192;706;151;533;343;1239
411727;201801;1555;4579;1079;3540;305;1025;141;426;446;1451
411729;201801;655;1694;437;1272;95;291;112;280;207;571
411730;201801;5044;14368;3965;12161;1158;3691;1148;3466;2306;7157
411740;201801;577;1613;318;1018;58;208;57;155;115;363
411745;201801;850;2475;617;1933;103;337;133;359;236;696
411750;201801;4886;14023;3686;11435;530;1806;1582;4676;2112;6482
411760;201801;7209;20407;5825;17906;2008;6528;1137;3675;3145;10203
411770;201801;3291;10277;2536;8529;692;2444;315;1023;1007;3467
411780;201801;2899;8556;2545;7905;654;2171;1028;3221;1682;5392
411790;201801;2996;8118;1835;5727;444;1534;279;789;723;2323
411800;201801;1047;3006;697;2191;96;323;115;347;211;670
411810;201801;1674;4559;1301;3843;234;760;582;1617;816;2377
411820;201801;11623;36493;9618;32399;3168;11138;2620;8871;5788;20009
411830;201801;560;1404;379;1093;95;310;45;144;140;454
411840;201801;10434;28886;7247;22385;1447;4914;1692;5003;3139;9917
411845;201801;440;1291;239;782;41;160;16;41;57;201
411850;201801;7364;20765;5693;17605;1648;5517;990;2902;2638;8419
411860;201801;801;2396;609;1982;111;392;159;476;270;868
411870;201801;750;2367;505;1719;98;365;99;300;197;665
411880;201801;2080;5847;1526;4822;382;1329;242;742;624;2071
411885;201801;808;2174;631;1871;109;388;223;637;332;1025
411890;201801;1147;3342;778;2529;119;425;49;131;168;556
411900;201801;863;2634;536;1823;131;452;51;184;182;636
411910;201801;1080;3431;803;2804;229;831;195;653;424;1484
411915;201801;16704;43189;10380;31201;1930;6319;2594;7056;4524;13375
411920;201801;909;2950;773;2617;216;809;141;449;357;1258
411925;201801;589;1603;392;1229;93;304;96;285;189;589
411930;201801;5427;17755;4723;16370;2230;8426;305;1108;2535;9534
411940;201801;3109;10006;2538;8662;617;2172;552;1739;1169;3911
411950;201801;12688;37425;10528;33574;2225;7621;4825;15043;7050;22664
411960;201801;5449;15467;4706;14066;963;3135;1768;5028;2731;8163
411965;201801;501;1369;353;1109;67;242;99;301;166;543
411970;201801;839;2202;689;1982;130;344;374;1201;504;1545
411980;201801;1482;4180;1220;3678;316;996;367;1082;683;2078
411990;201801;34246;100138;24513;80128;5402;19511;7264;22497;12666;42008
411995;201801;2611;7207;2065;6317;580;1979;594;1682;1174;3661
412000;201801;2186;5169;1590;4173;131;425;940;2260;1071;2685
412010;201801;670;2178;490;1738;67;278;106;324;173;602
412015;201801;594;1728;495;1539;80;252;242;764;322;1016
412020;201801;426;1241;264;867;45;162;97;289;142;451
412030;201801;707;2096;502;1675;80;295;177;564;257;859
412033;201801;903;2609;641;2037;81;261;229;753;310;1014
412035;201801;880;2349;561;1783;86;305;245;754;331;1059
412040;201801;587;1688;409;1314;73;239;71;217;144;456
412050;201801;1652;4554;1219;3716;235;809;296;900;531;1709
412060;201801;7102;23064;6208;21221;1893;6993;1407;4652;3300;11645
412065;201801;696;2035;525;1690;107;377;156;475;263;852
412070;201801;1238;3235;911;2571;132;401;383;1074;515;1475
412080;201801;1602;4823;1007;3440;136;518;55;166;191;684
412085;201801;334;929;110;382;12;44;12;34;24;78
412090;201801;5133;14239;4422;12988;1132;3365;2037;6163;3169;9528
412100;201801;1743;5234;1400;4561;432;1524;271;888;703;2412
412110;201801;914;2529;636;1928;130;430;147;441;277;871
412120;201801;1725;5590;1434;4946;334;1255;394;1138;728;2393
412125;201801;621;1940;519;1706;117;404;159;499;276;903
412130;201801;610;1758;445;1390;75;256;100;331;175;587
412135;201801;564;1594;284;881;50;151;82;238;132;389
412140;201801;1579;4293;1124;3433;239;815;178;489;417;1304
412150;201801;2983;8191;2497;7268;295;1000;1554;4369;1849;5369
412160;201801;1074;3455;665;2364;162;623;84;290;246;913
412170;201801;4325;12831;3611;11487;835;2865;1444;4298;2279;7163
412175;201801;1346;4266;1138;3855;250;852;446;1517;696;2369
412180;201801;1662;4809;1248;4039;224;853;498;1437;722;2290
412190;201801;3258;8774;2433;7242;380;1223;930;2881;1310;4104
412200;201801;1977;6097;1407;4696;341;1214;271;893;612;2107
412210;201801;641;1699;377;1158;70;263;75;186;145;449
412215;201801;3833;10672;3250;9555;877;2612;1355;4371;2232;6983
412217;201801;1052;2905;907;2654;75;257;614;1707;689;1964
412220;201801;5543;16655;4868;15381;1177;3682;1933;6477;3110;10159
412230;201801;2765;8759;2275;7697;416;1566;615;1891;1031;3457
412240;201801;7539;19544;4707;14278;879;2986;1106;3118;1985;6104
412250;201801;1953;5412;1528;4548;393;1218;239;639;632;1857
412260;201801;1233;3431;853;2609;122;398;282;793;404;1191
412265;201801;892;2668;765;2407;192;638;287;900;479;1538
412270;201801;801;2426;547;1821;84;314;197;619;281;933
412280;201801;543;1651;424;1416;121;425;78;248;199;673
412290;201801;1027;2750;703;2145;118;405;218;618;336;1023
412300;201801;1539;4527;1278;4010;328;1112;278;828;606;1940
412310;201801;819;2397;675;2139;79;347;331;1030;410;1377
412320;201801;813;2180;575;1711;87;331;181;522;268;853
412330;201801;1437;3997;1013;3142;190;618;372;1136;562;1754
412340;201801;969;2881;621;2031;94;326;131;404;225;730
412350;201801;2603;7348;1712;5479;329;1169;178;500;507;1669
412360;201801;259;748;163;525;22;80;58;170;80;250
412370;201801;804;2407;601;2014;125;465;60;200;185;665
412380;201801;1542;4606;1149;3706;298;984;215;728;513;1712
412382;201801;595;1600;401;1207;69;219;105;269;174;488
412385;201801;2195;6475;1871;5791;684;2139;471;1554;1155;3693
412390;201801;2219;5949;1858;5373;392;1220;835;2435;1227;3655
412395;201801;730;2109;526;1686;54;174;261;803;315;977
412400;201801;894;2639;690;2196;166;552;150;505;316;1057
412402;201801;1751;4795;1343;4077;308;1061;166;460;474;1521
412405;201801;3188;9107;2016;6542;367;1351;69;216;436;1567
412410;201801;5110;14605;3935;12432;937;3353;885;2645;1822;5998
412420;201801;434;1209;246;778;30;102;93;257;123;359
412430;201801;529;1440;354;1088;41;137;133;402;174;539
412440;201801;2852;8339;2018;6703;512;1862;368;1225;880;3087
412450;201801;293;939;220;754;29;94;16;42;45;136
412460;201801;808;2402;677;2140;143;481;216;653;359;1134
412470;201801;1775;5871;1432;5018;382;1402;292;1061;674;2463
412480;201801;995;2897;634;2018;110;381;83;201;193;582
412490;201801;967;2714;805;2394;149;426;315;899;464;1325
412500;201801;1835;5013;1449;4265;254;792;369;976;623;1768
412510;201801;2037;6484;1508;5126;384;1393;191;599;575;1992
412520;201801;1337;3794;919;2868;223;692;102;303;325;995
412530;201801;583;1665;451;1386;72;232;105;316;177;548
412535;201801;760;2149;534;1670;108;360;92;275;200;635
412540;201801;1222;3364;857;2570;122;453;245;736;367;1189
412545;201801;715;1939;478;1422;88;267;113;294;201;561
412550;201801;30762;88657;21158;68043;4400;15098;5741;17220;10141;32318
412555;201801;234;670;150;481;22;79;39;99;61;178
412560;201801;5132;15403;3840;12447;819;2948;832;2594;1651;5542
412570;201801;4037;11216;2558;8091;542;1860;347;1153;889;3013
412575;201801;919;2651;743;2253;103;352;327;924;430;1276
412580;201801;1335;3594;942;2824;158;523;372;1055;530;1578
412590;201801;481;1349;262;885;54;183;26;82;80;265
412600;201801;1381;4073;1025;3272;186;655;349;1067;535;1722
412610;201801;728;2097;463;1454;88;280;170;495;258;775
412620;201801;1241;3632;955;3103;220;830;269;789;489;1619
412625;201801;8286;23659;5737;18519;934;3258;577;1974;1511;5232
412627;201801;939;2774;642;2130;179;660;168;539;347;1199
412630;201801;2987;9206;2240;7492;420;1370;673;2140;1093;3510
412635;201801;406;1145;281;872;53;172;41;102;94;274
412640;201801;999;2824;581;1852;86;292;116;333;202;625
412650;201801;1542;4506;1280;4001;230;815;426;1200;656;2015
412660;201801;2588;7120;1831;5583;323;1091;491;1361;814;2452
412665;201801;571;1465;321;991;69;225;95;274;164;499
412667;201801;1658;4599;1277;3822;211;732;481;1354;692;2086
412670;201801;543;1602;432;1394;99;357;129;406;228;763
412680;201801;1421;4118;892;3011;148;572;267;787;415;1359
412690;201801;791;2295;594;1876;123;393;138;426;261;819
412700;201801;1990;5517;1600;4903;351;1249;623;1830;974;3079
412710;201801;6047;18690;4986;16544;1028;3684;1363;4201;2391;7885
412720;201801;1294;3960;966;3159;159;564;196;545;355;1109
412730;201801;2089;6116;1187;4004;257;915;165;527;422;1442
412740;201801;1659;4963;1127;3760;212;783;144;514;356;1297
412750;201801;3991;11552;3480;10721;464;1673;2175;6511;2639;8184
412760;201801;2680;7817;2363;7289;358;1219;1378;4134;1736;5353
412770;201801;10364;27744;5633;17725;774;2527;1056;2990;1830;5517
412780;201801;1257;3703;1062;3333;208;713;423;1290;631;2003
412785;201801;2092;5660;1531;4591;359;1075;633;1887;992;2962
412788;201801;1340;4075;1119;3617;278;993;427;1294;705;2287
412790;201801;1042;3048;680;2250;135;494;178;498;313;992
412795;201801;1077;2986;652;2014;123;407;161;468;284;875
412796;201801;2336;7156;1973;6335;388;1320;690;2060;1078;3380
412800;201801;3180;8557;2230;6585;333;1112;833;2255;1166;3367
412810;201801;11178;29719;6542;19798;898;3104;1775;4514;2673;7618
412820;201801;6841;19587;4989;15891;1060;3583;1476;4701;2536;8284
412830;201801;325;961;236;769;32;115;49;152;81;267
412840;201801;1793;4935;1374;4108;217;689;403;1185;620;1874
412850;201801;2983;8359;2271;7077;404;1384;783;2319;1187;3703
412853;201801;1801;4957;1490;4262;147;471;792;2057;939;2528
412855;201801;1241;3560;890;2740;167;581;192;495;359;1076
412860;201801;985;2866;771;2412;168;557;261;781;429;1338
412862;201801;741;1819;469;1341;76;236;162;454;238;690
412863;201801;1154;3743;1114;3680;110;379;848;2780;958;3159
412865;201801;730;2098;531;1716;93;306;180;595;273;901
412870;201801;892;2514;689;2169;233;812;130;432;363;1244
412880;201801;864;2496;589;1884;114;404;84;236;198;640
420005;201801;453;1344;263;899;38;134;97;324;135;458
420010;201801;3552;9229;2374;7150;239;779;1597;4863;1836;5642
420020;201801;573;1842;345;1256;51;227;48;146;99;373
420030;201801;272;711;143;483;32;128;17;60;49;188
420040;201801;617;1937;343;1293;53;222;16;43;69;265
420050;201801;689;1820;433;1324;67;219;225;664;292;883
420055;201801;171;520;90;323;18;76;22;73;40;149
420060;201801;150;493;107;380;19;84;19;46;38;130
420070;201801;1072;3411;802;2759;169;623;276;958;445;1581
420075;201801;144;382;75;232;12;35;12;26;24;61
420080;201801;479;1456;369;1233;108;362;97;317;205;679
420090;201801;397;1372;277;1047;62;238;54;210;116;448
420100;201801;1124;3344;1000;3165;112;383;720;2267;832;2650
420110;201801;274;905;253;858;74;263;77;240;151;503
420120;201801;319;1008;236;809;60;251;82;237;142;488
420125;201801;304;1043;262;958;69;286;120;419;189;705
420127;201801;321;909;112;400;21;85;18;53;39;138
420130;201801;1856;5973;1388;4976;345;1373;377;1226;722;2599
420140;201801;3565;10349;2567;8483;651;2435;352;1067;1003;3502
420150;201801;522;1391;331;1076;55;196;142;422;197;618
420160;201801;238;637;119;396;18;67;37;120;55;187
420165;201801;186;560;106;356;23;86;32;98;55;184
420170;201801;212;674;136;500;32;130;15;55;47;185
420180;201801;277;828;147;521;22;75;36;123;58;198
420190;201801;168;553;101;381;31;119;13;46;44;165
420195;201801;1268;3596;986;3111;260;925;153;446;413;1371
420200;201801;2822;8107;1632;5613;289;1181;408;1221;697;2402
420205;201801;1199;3612;908;3055;154;566;488;1654;642;2220
420207;201801;1493;4226;982;3204;238;883;264;803;502;1686
420208;201801;489;1302;262;909;47;204;111;391;158;595
420209;201801;192;611;121;439;32;125;41;136;73;261
420210;201801;2085;5857;1320;4569;300;1182;519;1714;819;2896
420213;201801;742;2541;683;2420;181;701;311;1094;492;1795
420215;201801;276;875;178;650;56;193;11;45;67;238
420220;201801;172;605;139;539;42;183;36;131;78;314
420230;201801;3745;10778;2803;9117;470;1791;1272;3953;1742;5744
420240;201801;10988;30233;7097;22617;967;3670;3516;10102;4483;13772
420243;201801;520;1527;398;1292;80;271;144;462;224;733
420245;201801;1249;3499;861;2764;98;389;439;1300;537;1689
420250;201801;457;1424;400;1307;91;324;177;551;268;875
420253;201801;498;1306;368;1115;31;86;200;609;231;695
420257;201801;252;681;149;489;29;99;64;211;93;310
420260;201801;1053;3234;812;2816;145;564;374;1278;519;1842
420270;201801;555;1537;236;758;25;92;75;216;100;308
420280;201801;1648;4485;989;3272;187;668;254;811;441;1479
420285;201801;107;291;49;182;10;38;4;8;14;46
420287;201801;419;1102;293;903;101;323;87;263;188;586
420290;201801;4519;13681;3307;10857;622;2224;1114;3302;1736;5526
420300;201801;6504;18974;3875;12973;810;3098;848;2495;1658;5593
420310;201801;813;2035;475;1329;68;190;308;846;376;1036
420315;201801;884;2754;656;2278;173;636;228;781;401;1417
420320;201801;3828;11672;3104;10324;993;3658;725;2242;1718;5900
420325;201801;216;694;159;570;43;152;43;159;86;311
420330;201801;873;2809;615;2179;129;501;185;606;314;1107
420340;201801;1193;3573;846;2812;158;550;58;185;216;735
420350;201801;1418;4025;992;3185;155;542;538;1710;693;2252
420360;201801;2669;7951;1505;5309;294;1142;134;482;428;1624
420370;201801;1414;3937;1119;3455;139;512;767;2291;906;2803
420380;201801;5012;14345;3277;10740;752;2656;912;2915;1664;5571
420390;201801;1057;2809;674;2023;117;389;220;483;337;872
420395;201801;1106;3359;734;2536;117;433;77;241;194;674
420400;201801;1001;3019;670;2292;130;508;144;456;274;964
420410;201801;598;1628;428;1304;38;147;309;921;347;1068
420415;201801;364;1122;271;916;84;304;73;239;157;543
420417;201801;684;2136;545;1808;116;415;208;669;324;1084
420419;201801;249;843;175;665;54;235;10;34;64;269
420420;201801;10025;28660;7384;23847;2619;9175;1496;4471;4115;13646
420425;201801;888;2341;615;1843;64;243;266;738;330;981
420430;201801;3167;9318;1997;6605;459;1623;552;1687;1011;3310
420435;201801;265;766;132;472;28;125;41;127;69;252
420440;201801;738;2176;416;1375;133;495;114;329;247;824
420445;201801;335;955;209;673;41;137;60;180;101;317
420450;201801;693;2107;493;1656;102;380;135;389;237;769
420455;201801;1889;5212;1474;4523;211;753;737;2165;948;2918
420460;201801;8411;23640;6307;19940;1211;4385;2589;7719;3800;12104
420470;201801;803;2143;437;1401;87;318;98;273;185;591
420475;201801;63;192;43;151;13;42;6;21;19;63
420480;201801;4547;12504;3127;9957;682;2343;918;2864;1600;5207
420490;201801;573;1518;304;1043;70;261;68;244;138;505
420500;201801;1353;4069;928;3230;229;864;291;999;520;1863
420510;201801;110;380;79;290;15;65;42;142;57;207
420515;201801;50;143;38;124;7;29;13;39;20;68
420517;201801;769;2209;694;2089;45;135;545;1630;590;1765
420519;201801;383;992;249;771;38;137;75;222;113;359
420520;201801;502;1321;231;786;29;94;27;72;56;166
420530;201801;1031;3126;740;2497;156;581;209;631;365;1212
420535;201801;253;713;111;369;28;98;9;31;37;129
420540;201801;22348;58429;14919;44165;2984;9827;4656;11770;7640;21597
420543;201801;302;797;238;681;50;120;115;328;165;448
420545;201801;1343;4189;1074;3616;243;867;354;1158;597;2025
420550;201801;3507;10430;2385;8241;564;2232;686;2397;1250;4629
420555;201801;321;967;243;807;43;147;93;296;136;443
420560;201801;440;1222;319;1005;59;185;175;541;234;726
420570;201801;2089;6359;1616;5367;344;1301;624;1930;968;3231
420580;201801;1692;4672;1305;4050;276;983;632;1878;908;2861
420590;201801;2960;8570;1829;6030;356;1304;328;866;684;2170
420600;201801;941;2978;809;2708;148;519;410;1381;558;1900
420610;201801;448;1340;246;875;57;219;51;169;108;388
420620;201801;490;1440;409;1295;124;418;126;385;250;803
420630;201801;820;2501;616;2017;138;505;253;761;391;1266
420640;201801;675;1949;313;1120;79;323;23;69;102;392
420650;201801;2463;7061;1584;5236;276;973;468;1358;744;2331
420660;201801;415;1199;283;924;59;211;67;205;126;416
420665;201801;548;1515;375;1221;59;241;156;451;215;692
420670;201801;1538;4389;1053;3407;184;735;341;968;525;1703
420675;201801;158;519;117;411;32;139;22;57;54;196
420680;201801;340;848;204;648;37;126;85;256;122;382
420690;201801;776;2622;543;1983;87;331;88;254;175;585
420700;201801;2870;8282;2239;7084;391;1370;894;2712;1285;4082
420710;201801;625;1969;469;1637;95;415;188;570;283;985
420720;201801;1421;4019;1068;3508;296;1016;442;1440;738;2456
420730;201801;2832;8010;2230;7050;422;1464;1087;3319;1509;4783
420740;201801;761;2291;529;1811;145;536;111;352;256;888
420750;201801;1847;5723;1301;4496;213;826;429;1335;642;2161
420757;201801;84;198;27;106;5;25;9;31;14;56
420760;201801;387;1185;182;608;40;132;24;74;64;206
420765;201801;488;1554;253;932;46;181;57;213;103;394
420768;201801;1162;3779;974;3406;263;933;539;1908;802;2841
420770;201801;518;1414;242;879;52;223;59;205;111;428
420775;201801;568;1655;314;1065;62;229;45;127;107;356
420780;201801;1106;3255;661;2264;124;444;139;439;263;883
420785;201801;187;532;138;421;27;79;40;108;67;187
420790;201801;1036;3418;809;2965;206;818;329;1148;535;1966
420800;201801;755;2063;357;1194;80;295;100;315;180;610
420810;201801;1687;5668;1363;4952;440;1807;310;982;750;2789
420820;201801;8775;24132;5948;19531;1397;5094;1965;6013;3362;11107
420830;201801;2831;8451;2254;7367;574;2061;768;2426;1342;4487
420840;201801;832;2390;381;1332;77;296;60;188;137;484
420845;201801;1651;4544;1026;3391;233;872;299;966;532;1838
420850;201801;1209;3949;759;2825;178;734;86;270;264;1004
420860;201801;310;838;190;627;47;181;42;130;89;311
420870;201801;895;2503;683;2156;239;843;213;630;452;1473
420880;201801;939;3069;724;2554;165;654;155;468;320;1122
420890;201801;7612;20732;4154;13613;739;2667;1053;2998;1792;5665
420895;201801;171;510;97;317;28;97;31;95;59;192
420900;201801;1515;4096;928;3024;172;685;293;802;465;1487
420910;201801;23416;66628;15848;52004;2755;10235;5317;15954;8072;26189
420915;201801;508;1983;353;1517;72;329;150;601;222;930
420917;201801;360;1052;192;596;32;109;79;226;111;335
420920;201801;129;379;52;192;4;16;5;15;9;31
420930;201801;17332;47905;12755;39893;2375;8128;5434;16269;7809;24397
420940;201801;2505;7031;1733;5562;448;1575;124;333;572;1908
420945;201801;151;468;111;374;30;116;36;112;66;228
420950;201801;434;1225;239;815;29;122;76;251;105;373
420960;201801;871;2415;627;1950;123;434;208;581;331;1015
420970;201801;2592;7742;1844;6272;521;1866;312;1110;833;2976
420980;201801;377;1138;294;1013;124;447;94;353;218;800
420985;201801;393;1146;189;681;34;138;61;204;95;342
420990;201801;536;1597;309;1107;58;219;42;125;100;344
421000;201801;455;1576;313;1199;65;279;57;162;122;441
421003;201801;514;1345;197;646;24;79;26;64;50;143
421005;201801;118;372;89;318;21;84;40;154;61;238
421010;201801;4024;11315;2827;9205;645;2324;601;1777;1246;4101
421020;201801;416;1234;313;1058;25;97;205;694;230;791
421030;201801;723;2427;596;2129;193;753;127;422;320;1175
421040;201801;815;1971;502;1487;61;216;274;781;335;997
421050;201801;1371;3832;780;2550;149;531;230;697;379;1228
421055;201801;166;458;84;277;26;91;21;61;47;152
421060;201801;519;1632;362;1241;75;298;131;432;206;730
421070;201801;572;1787;353;1228;78;294;46;146;124;440
421080;201801;683;2789;619;2684;76;247;462;2178;538;2425
421085;201801;440;1245;198;686;31;111;33;105;64;216
421090;201801;365;977;176;556;19;61;40;120;59;181
421100;201801;923;2401;466;1440;106;357;51;139;157;496
421105;201801;1357;3970;1081;3541;177;607;518;1773;695;2380
421110;201801;922;2929;801;2715;119;436;459;1547;578;1983
421120;201801;1085;3459;737;2677;106;438;191;593;297;1031
421125;201801;345;924;247;767;74;251;71;180;145;431
421130;201801;3184;10173;2745;9345;748;2797;1234;4123;1982;6920
421140;201801;301;870;218;696;43;138;85;250;128;388
421145;201801;465;1345;268;861;54;185;104;306;158;491
421150;201801;519;1471;346;1165;60;237;126;402;186;639
421160;201801;842;2247;458;1466;74;272;210;650;284;922
421165;201801;203;653;154;545;21;69;78;292;99;361
421170;201801;1173;3227;907;2808;145;458;548;1715;693;2173
421175;201801;1118;3114;748;2449;147;573;264;752;411;1325
421180;201801;417;1100;200;656;44;166;37;114;81;280
421185;201801;344;909;226;686;41;127;113;351;154;478
421187;201801;348;1037;227;748;34;115;87;266;121;381
421189;201801;369;1139;280;932;49;174;87;261;136;435
421190;201801;10103;27905;6153;20541;1251;4689;1024;3195;2275;7884
421200;201801;775;2446;636;2178;129;459;245;815;374;1274
421205;201801;204;570;151;473;34;129;58;168;92;297
421210;201801;1165;3326;788;2575;185;632;267;846;452;1478
421220;201801;1500;4969;1277;4460;342;1314;201;626;543;1940
421223;201801;429;1309;296;1043;64;242;102;354;166;596
421225;201801;1003;3203;858;2897;191;712;412;1406;603;2118
421227;201801;968;2653;623;1988;115;409;315;992;430;1401
421230;201801;563;1584;390;1278;110;385;133;440;243;825
421240;201801;331;1035;166;609;19;88;24;92;43;180
421250;201801;1443;3979;904;3056;224;823;234;782;458;1605
421260;201801;283;787;58;209;10;32;8;31;18;63
421265;201801;723;2162;652;2051;71;263;475;1469;546;1732
421270;201801;484;1344;249;872;49;165;70;239;119;404
421280;201801;1511;4709;1193;4112;258;994;529;1790;787;2784
421290;201801;797;2207;462;1470;84;276;77;222;161;498
421300;201801;238;705;165;550;42;165;55;171;97;336
421310;201801;186;582;144;477;28;106;47;145;75;251
421315;201801;258;780;154;550;28;102;16;61;44;163
421320;201801;650;1978;389;1322;71;252;63;155;134;407
421330;201801;566;1773;422;1489;105;386;112;398;217;784
421335;201801;401;1310;326;1154;75;310;76;265;151;575
421340;201801;1439;4055;1098;3465;186;649;522;1598;708;2247
421350;201801;1059;3278;830;2838;136;565;404;1317;540;1882
421360;201801;2463;6997;1528;5142;339;1350;504;1508;843;2858
421370;201801;491;1661;331;1246;86;343;77;290;163;633
421380;201801;796;2308;681;2100;104;340;357;1063;461;1403
421390;201801;163;439;65;210;15;55;17;42;32;97
421400;201801;257;857;185;719;56;240;72;264;128;504
421410;201801;232;675;122;440;16;70;51;182;67;252
421415;201801;344;1063;158;539;39;138;30;87;69;225
421420;201801;654;1906;511;1631;76;258;246;742;322;1000
421430;201801;158;514;122;433;20;75;30;101;50;176
421440;201801;684;1946;474;1586;86;319;226;753;312;1072
421450;201801;398;1228;237;847;36;156;34;123;70;279
421460;201801;494;1433;291;1044;60;227;76;262;136;489
421470;201801;282;899;210;751;48;214;61;196;109;410
421480;201801;2824;7725;1834;6007;563;2134;351;963;914;3097
421490;201801;206;605;97;363;15;60;16;48;31;108
421500;201801;1982;6463;1451;5315;407;1678;190;632;597;2310
421505;201801;308;960;273;899;50;170;146;477;196;647
421507;201801;439;1298;288;989;70;263;78;256;148;519
421510;201801;222;676;152;511;35;111;66;194;101;305
421520;201801;618;1717;384;1198;56;210;167;472;223;682
421530;201801;313;976;177;631;37;160;37;107;74;267
421535;201801;506;1483;311;1085;37;147;148;478;185;625
421540;201801;226;605;156;487;31;106;63;184;94;290
421545;201801;696;2118;507;1752;113;446;180;587;293;1033
421550;201801;1965;5931;1679;5465;438;1573;716;2247;1154;3820
421555;201801;218;631;65;234;16;68;10;23;26;91
421560;201801;118;364;60;224;11;44;7;29;18;73
421565;201801;755;2067;576;1799;138;493;220;694;358;1187
421567;201801;516;1837;388;1482;192;755;67;264;259;1019
421568;201801;480;1443;323;1086;57;210;103;329;160;539
421569;201801;253;738;104;369;21;70;20;78;41;148
421570;201801;1149;3288;715;2359;176;623;124;374;300;997
421575;201801;341;1067;299;954;45;155;163;494;208;649
421580;201801;2729;8469;2032;6985;457;1792;629;1905;1086;3697
421590;201801;165;514;126;435;16;59;70;232;86;291
421600;201801;450;1304;312;990;67;219;78;228;145;447
421605;201801;771;2217;522;1748;94;345;149;480;243;825
421610;201801;1240;3403;811;2566;151;529;210;627;361;1156
421620;201801;3889;11325;2379;8283;675;2541;526;1794;1201;4335
421625;201801;320;870;121;409;24;78;17;51;41;129
421630;201801;2709;7709;1505;4978;270;1040;288;855;558;1895
421635;201801;214;638;119;398;18;71;34;91;52;162
421640;201801;853;2446;586;1956;124;439;189;618;313;1057
421650;201801;2108;6428;1449;5013;328;1310;225;608;553;1918
421660;201801;7011;22029;5735;19505;1114;4197;2027;6361;3141;10558
421670;201801;909;2643;620;2019;145;544;216;664;361;1208
421680;201801;973;3076;785;2677;259;930;205;663;464;1593
421690;201801;1255;3999;917;3195;224;870;188;617;412;1487
421700;201801;457;1473;249;929;46;197;58;186;104;383
421710;201801;190;613;81;282;16;65;24;75;40;140
421715;201801;186;467;92;289;16;52;48;148;64;200
421720;201801;1829;5300;1092;3773;265;996;251;785;516;1781
421725;201801;164;445;105;334;27;98;34;90;61;188
421730;201801;427;1259;219;706;38;136;69;200;107;336
421740;201801;630;1960;436;1488;107;409;103;322;210;731
421750;201801;925;2295;504;1510;76;239;184;505;260;744
421755;201801;270;741;144;448;18;74;53;144;71;218
421760;201801;959;2791;510;1743;84;307;113;338;197;645
421770;201801;2529;7237;1863;6017;454;1514;622;2160;1076;3674
421775;201801;275;808;200;654;34;119;89;268;123;387
421780;201801;857;2872;608;2283;127;530;169;585;296;1115
421790;201801;677;1778;398;1337;135;493;123;380;258;873
421795;201801;295;862;179;564;26;95;58;168;84;263
421800;201801;2438;7129;1794;5921;407;1471;722;2272;1129;3743
421810;201801;661;1868;470;1497;103;381;173;497;276;878
421820;201801;854;2485;464;1597;97;362;61;174;158;536
421825;201801;1302;3972;1211;3826;168;589;831;2566;999;3155
421830;201801;2266;7468;1967;6880;498;1929;663;2160;1161;4089
421835;201801;207;565;127;424;26;109;63;187;89;296
421840;201801;239;743;166;586;37;138;56;190;93;328
421850;201801;402;1225;225;786;39;153;54;163;93;316
421860;201801;274;868;183;668;33;145;52;159;85;304
421870;201801;3365;9273;2336;7269;547;1900;729;2131;1276;4031
421875;201801;364;1045;161;579;27;97;16;46;43;143
421880;201801;639;1914;475;1572;130;467;77;249;207;716
421885;201801;252;754;200;675;61;223;48;145;109;368
421890;201801;765;2544;626;2262;180;737;226;737;406;1474
421895;201801;343;1046;306;988;50;181;201;641;251;822
421900;201801;887;2407;615;1871;120;400;250;713;370;1113
421910;201801;385;1224;277;983;52;222;54;161;106;383
421915;201801;438;1307;264;888;55;182;44;138;99;320
421917;201801;573;1588;374;1298;129;500;83;281;212;781
421920;201801;582;1684;382;1373;178;647;113;444;291;1091
421930;201801;2431;6487;1214;4130;342;1237;148;471;490;1708
421935;201801;508;1649;388;1402;88;358;164;554;252;912
421940;201801;227;732;126;443;23;102;40;126;63;228
421950;201801;3186;8391;1483;4925;324;1200;221;681;545;1881
421960;201801;162;445;114;369;18;71;26;87;44;158
421970;201801;2124;5709;1144;3692;264;885;256;750;520;1635
421985;201801;349;880;187;565;29;104;50;162;79;266
422000;201801;1523;4378;1267;3920;220;792;690;2085;910;2877
430003;201801;571;1716;415;1427;101;391;127;403;228;794
430005;201801;301;846;197;645;56;187;80;256;136;443
430010;201801;1857;4932;1435;4209;283;915;717;2061;1000;2976
430020;201801;613;1485;488;1326;77;242;292;760;369;1002
430030;201801;1035;2607;630;1852;178;538;179;525;357;1063
430040;201801;10155;26475;6410;19320;1639;5510;332;1054;1971;6564
430045;201801;605;1620;422;1234;51;162;210;586;261;748
430047;201801;284;659;127;378;25;76;33;93;58;169
430050;201801;940;2525;543;1666;118;367;125;360;243;727
430055;201801;291;748;133;404;13;43;67;189;80;232
430057;201801;104;240;36;109;8;29;6;12;14;41
430060;201801;16557;49622;13613;44804;3651;12933;5185;17332;8836;30265
430063;201801;884;2564;696;2146;160;484;371;1148;531;1632
430064;201801;1075;3162;806;2576;227;781;200;625;427;1406
430066;201801;136;315;90;241;4;15;57;143;61;158
430070;201801;664;1765;131;437;10;35;10;22;20;57
430080;201801;761;2049;450;1413;85;285;163;458;248;743
430085;201801;920;2297;548;1623;95;310;189;568;284;878
430087;201801;652;2003;549;1825;103;388;271;858;374;1246
430090;201801;657;1730;219;727;22;86;55;181;77;267
430100;201801;758;1915;387;1207;74;244;121;332;195;576
430105;201801;1026;2840;671;2204;119;460;287;932;406;1392
430107;201801;196;613;139;465;20;69;31;92;51;161
430110;201801;2093;5442;1545;4615;290;912;765;2199;1055;3111
430120;201801;1472;4530;942;3179;215;735;370;1316;585;2051
430130;201801;3983;10752;3185;9544;1010;2791;1068;3869;2078;6660
430140;201801;1018;3044;649;2204;169;579;203;687;372;1266
430150;201801;689;1782;384;1191;79;267;94;288;173;555
430155;201801;301;818;165;535;22;80;37;106;59;186
430160;201801;16829;46207;14072;41769;3519;10917;5025;15582;8544;26499
430163;201801;2261;5985;1637;4978;212;738;956;2853;1168;3591
430165;201801;438;1018;97;310;10;28;10;27;20;55
430170;201801;911;2553;337;1208;65;240;60;197;125;437
430175;201801;739;2334;614;2028;155;492;281;941;436;1433
430180;201801;741;1996;602;1743;102;339;341;937;443;1276
430185;201801;479;1210;293;854;53;162;122;317;175;479
430187;201801;641;1731;470;1441;86;284;191;572;277;856
430190;201801;1491;4353;1264;3897;305;996;538;1618;843;2614
430192;201801;143;434;63;198;9;29;9;23;18;52
430195;201801;377;1139;77;253;10;32;6;15;16;47
430200;201801;1207;3800;1010;3402;303;1058;296;985;599;2043
430205;201801;507;1443;403;1229;21;82;311;919;332;1001
430210;201801;5579;14321;3688;10532;543;1750;1447;3344;1990;5094
430215;201801;324;886;224;676;36;122;90;257;126;379
430220;201801;646;1636;189;631;35;116;34;104;69;220
430222;201801;226;702;185;612;26;88;73;228;99;316
430223;201801;295;837;246;742;45;139;114;344;159;483
430225;201801;35;85;14;39;3;7;5;8;8;15
430230;201801;1555;4580;1456;4449;228;637;1100;3465;1328;4102
430235;201801;234;732;181;603;25;95;69;223;94;318
430237;201801;532;1354;383;1102;32;107;238;646;270;753
430240;201801;1185;2721;710;1978;79;251;404;1096;483;1347
430245;201801;788;2386;602;2009;195;652;247;858;442;1510
430250;201801;1062;2931;862;2627;253;829;53;143;306;972
430258;201801;128;346;94;290;8;29;48;150;56;179
430260;201801;642;1804;468;1454;90;283;220;709;310;992
430265;201801;225;668;169;570;33;118;39;130;72;248
430270;201801;2783;7466;2330;6760;274;874;1530;4370;1804;5244
430280;201801;4737;12168;3604;10176;838;2429;1456;4142;2294;6571
430290;201801;2292;5874;2053;5540;95;302;1761;4691;1856;4993
430300;201801;8692;24325;6993;21177;1453;4737;3208;9672;4661;14409
430310;201801;7398;20250;5230;16321;957;3434;2261;6634;3218;10068
430320;201801;856;2454;500;1668;92;282;235;844;327;1126
430330;201801;640;1628;438;1237;112;333;182;454;294;787
430340;201801;730;1724;373;1123;70;228;184;535;254;763
430350;201801;5869;17168;4809;14947;1415;4593;1772;5315;3187;9908
430355;201801;358;897;124;395;23;80;11;36;34;116
430360;201801;831;2193;624;1816;124;374;224;628;348;1002
430367;201801;335;836;177;534;50;175;50;144;100;319
430370;201801;533;1494;277;921;61;215;59;169;120;384
430380;201801;698;1783;384;1203;116;409;98;308;214;717
430390;201801;3345;8794;1904;5914;311;1059;148;371;459;1430
430400;201801;1156;2725;865;2261;162;442;501;1271;663;1713
430410;201801;603;1544;426;1243;53;186;252;711;305;897
430420;201801;3140;8957;2399;7282;718;2293;759;2221;1477;4514
430430;201801;613;1646;344;1085;89;297;65;194;154;491
430435;201801;1726;4642;1269;3834;333;1047;352;1088;685;2135
430440;201801;3764;11248;2847;9285;584;2044;1296;4323;1880;6367
430450;201801;6474;17894;5359;15816;1220;3868;2184;6411;3404;10279
430460;201801;26885;75221;19611;63046;4612;16401;6955;21610;11567;38011
430461;201801;465;1208;143;460;17;56;32;94;49;150
430462;201801;261;704;168;544;30;111;34;124;64;235
430463;201801;4355;13145;3601;11781;722;2568;1724;5647;2446;8215
430465;201801;507;1368;421;1205;78;238;251;701;329;939
430466;201801;3670;9582;3020;8551;703;2100;1464;3951;2167;6051
430467;201801;497;1344;385;1147;63;208;174;496;237;704
430468;201801;1339;3557;1069;3149;178;573;583;1696;761;2269
430469;201801;555;1585;62;213;7;17;7;15;14;32
430470;201801;6563;17784;4682;14531;1474;4851;895;2824;2369;7675
430471;201801;512;1663;455;1535;102;354;180;599;282;953
430480;201801;965;2561;489;1569;77;280;69;193;146;473
430485;201801;148;433;63;214;9;36;11;29;20;65
430490;201801;351;969;202;644;30;105;88;280;118;385
430495;201801;382;1093;249;820;36;135;97;286;133;421
430500;201801;1136;3042;845;2552;212;709;322;905;534;1614
430510;201801;22662;63058;16793;51343;4215;14045;5563;15812;9778;29857
430511;201801;349;1055;140;490;22;69;16;48;38;117
430512;201801;950;2389;783;2120;210;582;238;668;448;1250
430513;201801;795;2053;411;1205;106;331;147;398;253;729
430515;201801;407;1163;281;912;50;145;131;439;181;584
430517;201801;1068;3330;856;2891;162;563;408;1417;570;1980
430520;201801;1413;3830;781;2484;151;508;137;391;288;899
430530;201801;1100;2877;421;1308;88;273;96;289;184;562
430535;201801;2857;8026;2046;6464;376;1240;861;2692;1237;3932
430537;201801;396;1345;329;1167;47;170;223;794;270;964
430540;201801;600;1404;366;1050;69;205;192;537;261;742
430543;201801;612;1268;403;1033;67;150;263;708;330;858
430544;201801;628;1968;482;1620;115;409;222;713;337;1122
430545;201801;1610;4732;1248;4183;357;1263;509;1758;866;3021
430550;201801;547;1538;301;988;62;215;57;164;119;379
430558;201801;103;275;53;173;14;46;15;41;29;87
430560;201801;407;960;175;533;17;59;43;126;60;185
430570;201801;976;2390;644;1805;97;333;337;849;434;1182
430580;201801;1181;2886;733;2153;124;415;334;937;458;1352
430583;201801;179;466;38;119;4;13;7;23;11;36
430585;201801;260;640;144;413;24;82;62;152;86;234
430587;201801;186;575;144;477;31;113;55;185;86;298
430590;201801;1383;3490;1201;3188;67;218;1028;2676;1095;2894
430593;201801;16;58;14;51;3;13;7;25;10;38
430595;201801;340;889;86;303;8;34;12;40;20;74
430597;201801;327;939;219;676;20;72;87;227;107;299
430600;201801;1848;5009;895;2778;157;480;217;639;374;1119
430605;201801;1197;3517;925;2952;159;608;346;1082;505;1690
430607;201801;698;1604;507;1314;38;111;331;877;369;988
430610;201801;6560;17012;4766;14230;1416;4596;756;2322;2172;6918
430613;201801;285;672;96;291;6;23;27;64;33;87
430620;201801;610;1675;493;1445;125;409;213;592;338;1001
430630;201801;462;1332;141;465;25;82;27;76;52;158
430632;201801;597;1654;285;889;34;115;109;315;143;430
430635;201801;547;1549;412;1262;75;260;239;702;314;962
430637;201801;452;1239;380;1125;58;198;209;584;267;782
430640;201801;1381;3645;722;2267;101;333;178;488;279;821
430642;201801;421;1130;274;835;43;134;125;372;168;506
430645;201801;275;621;104;289;18;53;26;71;44;124
430650;201801;1643;5203;1367;4624;345;1218;667;2284;1012;3502
430655;201801;160;391;120;339;29;86;49;129;78;215
430660;201801;5144;14038;3960;11950;905;2920;1686;5035;2591;7955
430670;201801;512;1402;404;1192;37;127;271;795;308;922
430673;201801;680;1607;275;828;52;158;83;246;135;404
430675;201801;226;666;55;194;12;52;14;43;26;95
430676;201801;4082;11137;3135;9511;616;1973;1426;4305;2042;6278
430680;201801;989;2734;600;1954;136;440;132;402;268;842
430690;201801;3482;9913;2843;8695;837;2674;724;2229;1561;4903
430692;201801;230;732;178;640;11;40;123;453;134;493
430693;201801;1104;2922;625;1933;137;477;118;321;255;798
430695;201801;554;1389;344;994;42;130;191;524;233;654
430697;201801;421;1122;305;919;55;171;141;445;196;616
430700;201801;8019;20455;4213;13439;953;3306;303;1009;1256;4315
430705;201801;285;800;168;540;21;73;67;204;88;277
430710;201801;1625;3981;1222;3319;227;691;572;1512;799;2203
430720;201801;691;1747;405;1266;91;269;138;443;229;712
430730;201801;1443;3771;922;2870;157;501;421;1354;578;1855
430740;201801;625;1768;348;1184;64;223;84;313;148;536
430745;201801;483;1363;249;802;38;131;51;158;89;289
430750;201801;1458;3923;1068;3256;221;737;525;1548;746;2285
430755;201801;480;1225;306;879;23;74;164;427;187;501
430760;201801;2331;5885;1721;4953;393;1227;688;2033;1081;3260
430770;201801;6025;16401;4596;14074;816;2707;2487;7453;3303;10160
430780;201801;2417;6231;1459;4551;273;907;458;1496;731;2403
430781;201801;415;1204;265;866;56;189;52;172;108;361
430783;201801;507;1227;292;859;37;122;137;382;174;504
430786;201801;61;213;43;166;8;30;10;40;18;70
430790;201801;4410;11707;2962;8877;559;1849;1364;3871;1923;5720
430800;201801;837;2232;580;1697;74;251;310;861;384;1112
430805;201801;528;1462;313;964;36;117;160;463;196;580
430807;201801;434;1126;279;844;33;117;119;337;152;454
430810;201801;828;2149;281;943;46;151;65;205;111;356
430820;201801;1310;3659;730;2444;160;545;144;479;304;1024
430825;201801;315;848;114;343;26;74;20;52;46;126
430830;201801;1594;4860;1394;4514;147;539;952;3084;1099;3623
430840;201801;933;2707;793;2453;160;498;429;1313;589;1811
430843;201801;111;278;36;107;6;16;12;34;18;50
430845;201801;315;832;219;654;89;286;32;77;121;363
430850;201801;2294;6483;1860;5690;423;1428;860;2598;1283;4026
430860;201801;950;2419;480;1486;85;324;185;512;270;836
430865;201801;562;1483;479;1341;142;420;204;537;346;957
430870;201801;712;1917;328;1074;59;211;86;253;145;464
430880;201801;1216;3044;796;2357;210;655;299;886;509;1541
430885;201801;238;579;116;382;11;46;77;247;88;293
430890;201801;1322;3547;883;2700;63;280;123;336;186;616
430900;201801;2843;6950;1977;5599;295;959;1006;2705;1301;3664
430905;201801;910;2482;578;1810;117;406;158;462;275;868
430910;201801;1495;4235;995;3186;202;760;380;1081;582;1841
430912;201801;487;1366;343;1108;39;137;209;683;248;820
430915;201801;538;1681;397;1427;108;385;135;529;243;914
430920;201801;20927;56934;16586;49775;2732;9042;9273;27171;12005;36213
430925;201801;140;313;62;170;11;27;22;65;33;92
430930;201801;10063;25204;6185;18898;1585;5170;1565;5068;3150;10238
430940;201801;1290;3850;699;2342;177;623;102;302;279;925
430950;201801;793;2078;524;1551;91;298;239;651;330;949
430955;201801;183;493;63;206;13;36;10;35;23;71
430957;201801;211;726;182;659;33;126;86;312;119;438
430960;201801;1378;3411;949;2681;200;623;462;1303;662;1926
430965;201801;1546;4031;1264;3568;74;252;967;2646;1041;2898
430970;201801;384;1032;200;633;22;77;96;294;118;371
430975;201801;509;1662;390;1370;88;335;146;506;234;841
430980;201801;385;964;228;685;50;161;85;250;135;411
430990;201801;544;1633;329;1082;54;214;129;405;183;619
430995;201801;624;1715;450;1394;84;264;205;610;289;874
431000;201801;1495;3672;655;1984;107;345;35;96;142;441
431010;201801;2349;6437;1381;4598;211;798;105;301;316;1099
431020;201801;9360;21957;5928;16413;1396;4152;1665;4323;3061;8475
431030;201801;324;910;139;490;38;128;14;56;52;184
431033;201801;2844;7954;2113;6825;554;1892;724;2438;1278;4330
431036;201801;283;681;66;207;6;13;15;44;21;57
431040;201801;912;2454;616;1911;114;416;281;797;395;1213
431041;201801;478;1160;378;1005;63;181;205;532;268;713
431043;201801;458;1182;233;764;88;288;58;189;146;477
431046;201801;130;348;63;188;7;21;13;37;20;58
431050;201801;1569;3926;1109;3180;234;693;531;1513;765;2206
431053;201801;519;1580;376;1271;110;394;87;294;197;688
431055;201801;651;1688;573;1566;53;148;418;1130;471;1278
431057;201801;288;848;141;479;28;103;39;119;67;222
431060;201801;5122;14794;4103;12928;1290;4456;823;2691;2113;7147
431065;201801;501;1371;339;1065;64;208;89;274;153;482
431070;201801;571;1675;320;1077;88;315;42;107;130;422
431075;201801;214;656;159;547;31;116;53;185;84;301
431080;201801;657;1901;462;1477;90;297;143;443;233;740
431085;201801;700;1934;527;1549;85;242;304;884;389;1126
431087;201801;485;1393;405;1219;27;80;278;851;305;931
431090;201801;475;1154;186;585;36;119;42;132;78;251
431100;201801;3359;8347;2517;7156;534;1647;952;2681;1486;4328
431110;201801;1472;3613;1025;2801;263;752;398;1014;661;1766
431112;201801;524;1637;460;1511;97;333;235;751;332;1084
431113;201801;410;1172;332;1022;105;341;117;366;222;707
431115;201801;1224;3475;969;3026;167;587;525;1579;692;2166
431120;201801;2540;7476;1828;6005;595;2211;432;1276;1027;3487
431123;201801;407;1162;262;856;59;184;117;396;176;580
431125;201801;1242;3710;874;2909;285;944;231;845;516;1789
431127;201801;272;749;63;214;8;20;12;32;20;52
431130;201801;3272;9239;2247;7210;497;1698;729;2348;1226;4046
431140;201801;4837;11780;2659;7769;380;1201;916;2359;1296;3560
431142;201801;489;1391;377;1190;59;195;226;705;285;900
431150;201801;979;2821;711;2270;172;573;266;826;438;1399
431160;201801;742;2094;572;1756;115;345;207;686;322;1031
431162;201801;533;1297;235;742;24;88;63;182;87;270
431164;201801;211;525;50;171;11;46;5;15;16;61
431170;201801;631;1720;408;1280;117;386;103;316;220;702
431171;201801;717;1889;593;1697;92;280;329;920;421;1200
431173;201801;426;1202;324;1020;125;420;68;211;193;631
431175;201801;942;2555;671;2059;177;547;134;417;311;964
431177;201801;736;2275;542;1907;177;654;187;651;364;1305
431179;201801;343;717;75;208;10;30;16;33;26;63
431180;201801;2164;5810;1371;4272;336;1124;244;757;580;1881
431190;201801;530;1433;286;914;41;138;59;150;100;288
431198;201801;338;1093;298;1014;105;371;88;328;193;699
431200;201801;388;1046;98;330;9;22;1;3;10;25
431205;201801;236;681;102;368;24;89;41;149;65;238
431210;201801;683;1794;561;1614;154;431;262;787;416;1218
431213;201801;231;710;181;616;21;85;100;337;121;422
431215;201801;295;900;205;681;20;74;78;237;98;311
431217;201801;154;445;98;329;15;53;47;151;62;204
431220;201801;719;1957;410;1319;39;144;177;520;216;664
431225;201801;1361;3638;1031;3027;181;544;522;1534;703;2078
431230;201801;713;2112;528;1649;90;300;254;775;344;1075
431235;201801;132;366;29;90;7;22;2;4;9;26
431237;201801;426;1259;339;1112;61;234;169;533;230;767
431238;201801;28;83;23;69;7;23;6;15;13;38
431240;201801;3911;10642;3089;9280;735;2458;1291;3717;2026;6175
431242;201801;356;1048;294;925;68;212;124;399;192;611
431244;201801;333;805;176;507;24;86;59;133;83;219
431245;201801;1125;2928;760;2203;144;454;319;883;463;1337
431247;201801;220;621;121;390;20;62;29;89;49;151
431250;201801;1395;4207;1144;3815;258;888;502;1749;760;2637
431260;201801;303;820;149;515;15;68;43;136;58;204
431261;201801;268;876;222;775;37;137;82;270;119;407
431262;201801;410;1172;172;601;18;63;90;318;108;381
431265;201801;1388;3430;615;1859;101;332;175;439;276;771
431267;201801;280;772;156;459;6;23;100;268;106;291
431270;201801;2663;6429;1458;4340;408;1315;379;1154;787;2469
431275;201801;199;585;104;369;25;95;12;33;37;128
431280;201801;261;724;76;264;5;18;10;19;15;37
431290;201801;308;909;222;738;30;116;73;210;103;326
431295;201801;79;218;28;92;4;17;7;19;11;36
431300;201801;355;844;52;186;2;6;6;19;8;25
431301;201801;244;748;68;237;7;21;4;7;11;28
431303;201801;655;1702;363;1098;44;158;123;358;167;516
431306;201801;2133;5299;1285;3811;167;565;460;1248;627;1813
431308;201801;31;101;27;88;15;51;6;19;21;70
431310;201801;626;1813;362;1188;60;204;115;384;175;588
431320;201801;675;1859;332;1128;66;239;49;156;115;395
431330;201801;2074;5071;1033;3168;245;857;167;443;412;1300
431333;201801;353;948;132;395;16;43;33;91;49;134
431335;201801;37;105;22;74;6;18;4;5;10;23
431337;201801;2698;7616;1828;6024;518;1860;337;1055;855;2915
431339;201801;494;1328;343;1023;73;237;167;487;240;724
431340;201801;21058;54649;14971;44158;3299;10635;4359;12320;7658;22955
431342;201801;517;1224;380;1012;57;187;270;684;327;871
431344;201801;368;988;240;739;12;43;158;477;170;520
431346;201801;275;697;100;314;14;44;22;72;36;116
431349;201801;743;2041;422;1288;69;215;140;395;209;610
431350;201801;3984;11153;3016;9398;735;2477;1008;3066;1743;5543
431360;201801;647;1585;383;1124;77;239;153;433;230;672
431365;201801;1710;4636;1406;4158;157;508;936;2786;1093;3294
431370;201801;4427;12027;3350;10163;793;2548;1356;4304;2149;6852
431380;201801;756;2255;665;2094;81;283;406;1279;487;1562
431390;201801;2372;6203;1380;4287;249;874;433;1213;682;2087
431395;201801;1281;3581;938;3023;238;774;366;1218;604;1992
431400;201801;398;1191;197;649;33;105;41;133;74;238
431402;201801;1007;2429;658;1813;112;323;360;948;472;1271
431403;201801;169;485;142;438;23;98;87;244;110;342
431405;201801;4009;11265;3405;10324;451;1579;2047;6079;2498;7658
431406;201801;519;1596;421;1415;104;348;211;720;315;1068
431407;201801;469;1326;316;1012;65;209;120;376;185;585
431410;201801;14300;39496;9391;30012;2107;7620;2629;7889;4736;15509
431413;201801;180;451;47;149;3;12;6;13;9;25
431415;201801;686;1835;438;1401;94;349;139;386;233;735
431417;201801;483;1215;381;1056;65;191;220;592;285;783
431420;201801;1272;3333;1082;3031;225;645;468;1381;693;2026
431430;201801;523;1365;296;905;56;185;80;225;136;410
431440;201801;22279;58424;16861;49531;4321;13456;4741;14430;9062;27886
431442;201801;113;335;63;216;9;32;6;12;15;44
431445;201801;472;1349;164;546;28;87;34;107;62;194
431446;201801;392;1143;265;848;78;254;66;194;144;448
431447;201801;621;1727;417;1311;90;283;176;550;266;833
431449;201801;733;1971;502;1498;51;163;253;745;304;908
431450;201801;2076;4700;1753;4267;146;391;1331;3136;1477;3527
431454;201801;59;185;51;164;10;33;19;68;29;101
431455;201801;664;1657;334;937;51;164;136;327;187;491
431460;201801;2868;7733;2282;6601;607;1798;736;2181;1343;3979
431470;201801;1637;4657;1178;3675;233;749;429;1339;662;2088
431475;201801;219;643;31;120;2;8;1;1;3;9
431477;201801;580;1493;353;1023;49;142;159;420;208;562
431478;201801;277;726;74;221;14;48;7;17;21;65
431480;201801;3190;8263;2459;7126;354;1152;1396;3978;1750;5130
431490;201801;99100;256667;82718;232205;8934;28810;57534;157475;66468;186285
431500;201801;504;1355;381;1110;82;236;200;569;282;805
431505;201801;448;1088;278;805;24;63;159;460;183;523
431507;201801;346;825;148;422;31;100;57;142;88;242
431510;201801;1702;4664;1227;3721;246;802;460;1382;706;2184
431513;201801;311;766;154;459;18;46;88;264;106;310
431514;201801;93;258;44;149;8;33;11;28;19;61
431515;201801;574;1523;372;1122;73;240;167;468;240;708
431517;201801;79;246;57;185;10;29;13;40;23;69
431520;201801;483;1200;197;631;41;147;45;135;86;282
431530;201801;4225;9520;2567;7141;710;2013;380;1067;1090;3080
431531;201801;214;619;151;490;17;63;47;148;64;211
431532;201801;525;1383;383;1100;83;241;142;413;225;654
431535;201801;263;637;113;340;24;83;41;110;65;193
431540;201801;1943;6349;1786;6083;108;415;1330;4578;1438;4993
431545;201801;374;1018;67;216;4;19;19;55;23;74
431550;201801;2016;5708;1673;5047;371;1181;682;1981;1053;3162
431555;201801;659;1568;432;1183;39;112;257;701;296;813
431560;201801;19891;54580;13611;43665;2904;10134;3508;12004;6412;22138
431570;201801;5432;13300;4220;11684;824;2477;2294;6216;3118;8693
431575;201801;177;550;140;464;24;79;19;56;43;135
431580;201801;530;1450;276;926;47;192;98;316;145;508
431590;201801;857;2241;551;1647;109;337;190;573;299;910
431595;201801;376;1055;253;783;36;103;124;376;160;479
431600;201801;1717;4517;1237;3729;325;1091;309;921;634;2012
431610;201801;1379;3801;972;2981;127;379;475;1495;602;1874
431620;201801;516;1440;226;690;47;141;103;299;150;440
431630;201801;1262;3359;640;2018;176;569;164;479;340;1048
431640;201801;6103;16383;5455;15471;842;2441;3580;10264;4422;12705
431642;201801;517;1347;341;992;38;103;155;437;193;540
431643;201801;360;915;160;456;22;60;50;125;72;185
431645;201801;1653;4447;1329;3902;199;619;827;2432;1026;3051
431647;201801;169;466;100;313;13;48;25;64;38;112
431650;201801;251;759;180;604;29;109;51;160;80;269
431660;201801;980;2674;547;1783;89;324;123;337;212;661
431670;201801;1172;2954;838;2397;149;496;377;1000;526;1496
431673;201801;249;675;95;352;22;75;8;24;30;99
431675;201801;677;1720;139;464;13;51;43;126;56;177
431680;201801;8169;22128;6135;18251;1618;5031;1992;6002;3610;11033
431690;201801;19963;54079;14951;45143;3848;12171;4583;14373;8431;26544
431695;201801;142;384;92;290;21;71;34;81;55;152
431697;201801;489;1248;400;1100;77;204;199;572;276;776
431700;201801;1448;3966;1239;3586;195;564;672;1931;867;2495
431710;201801;11565;31681;9150;27992;2539;8209;3216;10546;5755;18755
431720;201801;6341;17001;4316;12939;1055;3331;809;2254;1864;5585
431725;201801;29;86;19;66;3;12;6;19;9;31
431730;201801;3583;9714;2611;8064;704;2360;767;2487;1471;4847
431740;201801;4795;12527;3487;10245;1095;3584;604;1528;1699;5112
431750;201801;7602;21097;6499;19350;1381;4443;3069;9237;4450;13680
431755;201801;327;892;70;255;11;45;13;46;24;91
431760;201801;4992;12386;3414;9766;447;1467;1891;5115;2338;6582
431770;201801;1888;4839;1510;4287;201;610;972;2726;1173;3336
431775;201801;201;545;100;315;21;71;11;26;32;97
431780;201801;1954;5249;1390;4155;297;929;438;1264;735;2193
431790;201801;1033;2929;759;2357;157;523;267;791;424;1314
431795;201801;299;794;172;520;37;112;46;132;83;244
431800;201801;7374;20538;5540;17229;1804;6111;655;2101;2459;8212
431805;201801;323;766;99;324;9;33;38;118;47;151
431810;201801;3191;8116;2146;6129;426;1341;849;2289;1275;3630
431820;201801;2268;6682;1920;6065;401;1349;819;2603;1220;3952
431830;201801;9815;22842;7362;19296;1716;4905;2955;7783;4671;12688
431840;201801;2447;7057;2035;6347;400;1292;1080;3399;1480;4691
431842;201801;712;1787;252;781;35;124;68;190;103;314
431843;201801;321;899;250;755;29;90;110;320;139;410
431844;201801;267;719;77;255;18;69;14;34;32;103
431845;201801;491;1354;349;1049;19;53;216;647;235;700
431846;201801;270;792;224;724;18;85;174;546;192;631
431848;201801;194;513;100;318;7;26;14;34;21;60
431849;201801;441;1044;72;205;9;28;13;28;22;56
431850;201801;4189;12043;3404;10369;790;2574;1085;3219;1875;5793
431860;201801;720;1894;469;1395;91;281;224;631;315;912
431861;201801;119;323;49;170;6;23;14;43;20;66
431862;201801;477;1571;389;1405;81;325;181;651;262;976
431870;201801;17207;48441;13887;42578;2731;9355;6071;18033;8802;27388
431880;201801;3774;10686;2997;9236;613;2124;1208;3572;1821;5696
431890;201801;4588;12197;2985;9094;874;2860;447;1425;1321;4285
431900;201801;1064;2835;639;1977;143;497;278;808;421;1305
431910;201801;828;2033;338;991;53;153;86;232;139;385
431912;201801;450;1323;377;1183;74;228;206;659;280;887
431915;201801;1034;2812;795;2396;142;473;430;1258;572;1731
431920;201801;1204;3178;993;2850;82;248;763;2184;845;2432
431930;201801;816;2286;557;1825;142;434;260;895;402;1329
431935;201801;60;192;47;164;15;52;10;34;25;86
431936;201801;298;891;177;601;44;151;44;150;88;301
431937;201801;229;609;134;407;33;103;23;59;56;162
431940;201801;2336;6168;1476;4429;298;984;486;1353;784;2337
431950;201801;1595;4591;1344;4175;283;927;654;2012;937;2939
431960;201801;2697;7391;2196;6402;583;1772;632;1807;1215;3579
431970;201801;407;1105;179;598;46;155;43;136;89;291
431971;201801;84;230;49;166;8;24;8;24;16;48
431973;201801;464;1538;393;1398;35;122;276;997;311;1119
431975;201801;110;251;24;84;4;15;3;7;7;22
431980;201801;1202;3379;939;2907;210;685;369;1108;579;1793
431990;201801;6111;16002;4043;12752;767;2669;1173;3647;1940;6316
432000;201801;10195;27105;7845;23147;2241;6838;2918;8635;5159;15473
432010;201801;1931;5286;1515;4516;204;679;803;2299;1007;2978
432020;201801;1988;4823;1416;3914;346;1025;667;1752;1013;2777
432023;201801;495;1278;279;846;46;175;129;331;175;506
432026;201801;1028;3094;766;2535;165;526;376;1244;541;1770
432030;201801;339;925;217;665;46;143;101;292;147;435
432032;201801;477;1273;315;941;30;101;155;427;185;528
432035;201801;771;2290;678;2136;209;713;227;718;436;1431
432040;201801;948;2299;439;1359;75;255;138;407;213;662
432045;201801;248;679;129;434;33;113;30;110;63;223
432050;201801;539;1470;438;1287;120;363;172;514;292;877
432055;201801;833;2230;545;1678;146;493;193;566;339;1059
432057;201801;346;861;241;671;40;95;111;292;151;387
432060;201801;488;1208;161;528;27;110;50;138;77;248
432065;201801;243;674;170;525;41;132;54;160;95;292
432067;201801;805;2411;640;2044;105;334;353;1113;458;1447
432070;201801;2179;5855;1333;4123;267;893;260;748;527;1641
432080;201801;3690;9977;3009;8786;812;2621;1133;3212;1945;5833
432085;201801;377;984;243;764;80;231;94;313;174;544
432090;201801;1367;3771;1026;3131;264;871;400;1181;664;2052
432100;201801;1193;3359;510;1740;82;306;39;88;121;394
432110;201801;2329;6642;1594;5187;355;1364;122;363;477;1727
432120;201801;3446;10044;2829;8944;957;3246;591;1840;1548;5086
432130;201801;2707;7184;2200;6517;794;2514;746;2237;1540;4751
432132;201801;284;791;141;476;26;89;41;130;67;219
432135;201801;775;2148;580;1743;79;258;375;1096;454;1354
432140;201801;1701;5301;1269;4447;244;886;587;2129;831;3015
432143;201801;1331;3753;1063;3315;154;529;596;1856;750;2385
432145;201801;1390;4031;850;2780;134;485;149;414;283;899
432146;201801;142;431;93;316;28;101;15;47;43;148
432147;201801;390;1295;315;1141;99;378;60;220;159;598
432149;201801;388;1041;233;690;26;82;105;301;131;383
432150;201801;3389;9389;2478;7625;585;2015;655;1925;1240;3940
432160;201801;4367;13000;3578;11701;1069;3728;1057;3436;2126;7164
432162;201801;353;838;51;155;9;25;6;18;15;43
432163;201801;257;698;56;179;4;13;3;11;7;24
432166;201801;588;1732;462;1465;85;303;147;398;232;701
432170;201801;1269;3670;828;2787;178;659;183;590;361;1249
432180;201801;2403;6319;1319;4109;270;912;288;791;558;1703
432183;201801;346;1088;256;871;81;297;47;160;128;457
432185;201801;801;2187;531;1649;47;155;329;986;376;1141
432190;201801;2426;6413;1549;4641;370;1205;526;1489;896;2694
432195;201801;1015;2646;675;2057;186;530;203;639;389;1169
432200;201801;2870;8168;2177;6979;520;1764;892;2920;1412;4684
432210;201801;383;1071;264;853;49;180;105;319;154;499
432215;201801;737;2251;646;2095;90;290;406;1371;496;1661
432218;201801;250;644;142;410;21;58;49;130;70;188
432220;201801;3985;10085;3035;8539;471;1512;1698;4546;2169;6058
432225;201801;104;308;75;250;16;52;29;97;45;149
432230;201801;828;2147;470;1401;79;256;135;358;214;614
432232;201801;464;1196;340;984;56;187;168;483;224;670
432234;201801;288;758;146;449;36;106;22;56;58;162
432235;201801;105;305;40;135;6;23;6;18;12;41
432237;201801;412;1100;358;1008;17;53;233;622;250;675
432240;201801;13491;39196;10986;35656;1136;4367;6736;22726;7872;27093
432250;201801;4287;14180;3786;13190;1163;4226;1275;4591;2438;8817
432252;201801;435;1093;287;838;48;162;122;328;170;490
432253;201801;1214;3814;678;2379;154;607;34;97;188;704
432254;201801;912;2327;207;681;33;121;20;50;53;171
432255;201801;191;464;88;267;11;37;33;83;44;120
432260;201801;6323;16045;4508;12929;1085;3239;1576;4670;2661;7909
432270;201801;2201;6461;1828;5751;557;1867;290;905;847;2772
432280;201801;1247;3286;647;2025;105;338;208;619;313;957
432285;201801;190;591;23;79;2;5;1;1;3;6
432290;201801;415;1245;250;851;63;213;60;188;123;401
432300;201801;24123;67274;19661;60068;3104;10478;11451;34267;14555;44745
432310;201801;718;2101;561;1822;119;389;281;923;400;1312
432320;201801;244;595;80;252;10;41;15;42;25;83
432330;201801;281;705;92;299;13;34;19;57;32;91
432335;201801;171;485;68;246;15;62;12;34;27;96
432340;201801;329;793;153;472;30;109;42;114;72;223
432345;201801;613;1555;557;1479;45;164;394;995;439;1159
432350;201801;351;953;175;580;32;105;49;148;81;253
432360;201801;203;614;37;127;5;26;8;21;13;47
432370;201801;384;1023;257;774;20;69;157;472;177;541
432375;201801;602;1531;446;1258;62;170;253;712;315;882
432377;201801;221;716;27;96;4;18;7;15;11;33
432380;201801;1330;3873;839;2812;189;725;348;1088;537;1813
500020;201801;2174;6034;1670;5203;375;1321;736;2204;1111;3525
500025;201801;1301;3002;788;2136;66;189;464;1218;530;1407
500060;201801;6556;19350;5056;16684;747;2487;2936;10206;3683;12693
500070;201801;4197;11613;3139;9774;668;2271;1221;3918;1889;6189
500080;201801;1324;3728;927;3014;219;809;337;1063;556;1872
500085;201801;2006;4979;1367;4028;206;642;746;2148;952;2790
500090;201801;2057;5707;1405;4547;273;935;530;1810;803;2745
500100;201801;3242;8704;2487;7458;385;1311;1109;3113;1494;4424
500110;201801;7080;20249;5262;17449;1099;3930;1972;7198;3071;11128
500124;201801;2058;6551;1757;6046;416;1385;878;3332;1294;4717
500150;201801;1328;3231;838;2445;184;583;277;742;461;1325
500190;201801;4729;11791;3550;10220;716;2170;1818;5430;2534;7600
500200;201801;2243;5592;1675;4601;314;935;815;2086;1129;3021
500210;201801;4533;12868;3568;11401;864;2864;1560;5084;2424;7948
500215;201801;1214;3646;900;3024;115;433;422;1371;537;1804
500220;201801;2926;8515;2251;7328;362;1276;940;3082;1302;4358
500230;201801;2584;6345;1836;5195;268;788;967;2721;1235;3509
500240;201801;3995;12237;2781;9766;501;2025;728;2704;1229;4729
500260;201801;3042;6908;1866;5194;218;632;964;2612;1182;3244
500270;201801;115970;294355;70826;213189;15570;50306;17595;51685;33165;101991
500280;201801;1296;3324;978;2867;104;338;645;1863;749;2201
500290;201801;4100;9250;2271;6563;354;1144;772;2127;1126;3271
500295;201801;2640;7109;1530;4781;222;762;462;1239;684;2001
500310;201801;869;2081;652;1805;108;282;359;1033;467;1315
500315;201801;3264;9873;2649;8851;346;1163;1649;5746;1995;6909
500320;201801;17487;53386;12931;45091;3614;13577;3588;13313;7202;26890
500325;201801;3844;9312;2617;7505;346;1044;1537;4486;1883;5530
500330;201801;6950;16981;4503;12940;443;1412;2277;6676;2720;8088
500345;201801;1924;4846;1366;4037;369;1099;480;1409;849;2508
500348;201801;2717;7150;2134;6216;254;802;1274;3757;1528;4559
500350;201801;1250;3581;670;2231;74;261;224;762;298;1023
500370;201801;21365;60655;15075;49776;2953;11070;5463;18119;8416;29189
500375;201801;2594;7092;1801;5496;357;1199;540;1617;897;2816
500380;201801;3440;8844;2466;7280;644;1999;888;2663;1532;4662
500390;201801;555;1201;327;871;45;130;169;436;214;566
500400;201801;1229;3531;848;2686;205;681;219;670;424;1351
500410;201801;2305;6320;1805;5559;287;883;1064;3358;1351;4241
500430;201801;2634;6966;1862;5839;346;1223;706;2359;1052;3582
500440;201801;1301;3245;804;2403;131;397;297;943;428;1340
500450;201801;1299;3476;740;2373;149;494;101;279;250;773
500460;201801;3787;10771;2516;8267;574;2060;534;1796;1108;3856
500470;201801;2480;7068;1692;5415;497;1746;328;937;825;2683
500480;201801;2174;6519;1961;6237;148;433;1499;5087;1647;5520
500490;201801;889;2296;586;1808;151;529;153;484;304;1013
500500;201801;4110;11361;2868;9540;977;3752;667;2265;1644;6017
500510;201801;813;2080;509;1525;40;138;268;753;308;891
500515;201801;1983;5001;1600;4469;125;343;1111;3241;1236;3584
500520;201801;3213;10804;2679;9748;534;2146;1319;4771;1853;6917
500525;201801;1000;3065;797;2729;135;533;389;1369;524;1902
500540;201801;5427;14359;3104;10144;769;3001;289;847;1058;3848
500560;201801;5128;15602;4330;14447;360;1286;3220;10954;3580;12240
500568;201801;4215;9822;2636;7460;633;2069;746;1993;1379;4062
500570;201801;7096;17794;4147;12440;1019;3299;752;2135;1771;5434
500580;201801;3401;9511;2658;8256;397;1269;1536;4787;1933;6056
500600;201801;3528;8986;2285;6937;468;1569;718;2182;1186;3751
500620;201801;7518;20912;5328;16708;808;2719;2435;7705;3243;10424
500625;201801;482;1377;261;877;46;174;105;342;151;516
500627;201801;746;1967;461;1432;86;257;107;354;193;611
500630;201801;5847;14952;3702;11270;878;2852;1027;3169;1905;6021
500635;201801;2611;9298;2106;8534;193;798;1486;6471;1679;7269
500640;201801;1742;4020;1166;3201;61;194;781;2077;842;2271
500660;201801;18167;51217;13259;43324;4251;15396;2965;9842;7216;25238
500690;201801;2428;6956;1735;5843;800;2979;164;510;964;3489
500710;201801;3209;9200;2486;7883;644;2193;722;2257;1366;4450
500720;201801;5403;13900;3266;10349;883;3141;602;1856;1485;4997
500730;201801;922;2525;585;1875;119;394;176;576;295;970
500740;201801;4605;11721;3381;9569;267;885;1857;5335;2124;6220
500750;201801;972;2588;738;2171;120;407;328;900;448;1307
500755;201801;1023;2891;650;2160;124;430;105;300;229;730
500769;201801;5154;13250;2750;8459;508;1748;468;1155;976;2903
500770;201801;1662;4603;1070;3490;190;656;329;1088;519;1744
500780;201801;1324;3443;892;2650;204;630;234;657;438;1287
500790;201801;8675;23060;7002;20438;1334;4273;3657;10725;4991;14998
500793;201801;1986;5463;1409;4465;467;1546;205;572;672;2118
500795;201801;2367;6606;1984;6082;193;493;1492;4900;1685;5393
500797;201801;780;2085;525;1615;104;347;182;536;286;883
500800;201801;2815;7086;1984;5855;684;2293;340;1042;1024;3335
500830;201801;18379;47449;12678;37009;2087;6619;5380;15111;7467;21730
500840;201801;1176;3162;753;2332;90;296;286;830;376;1126
510010;201801;1395;3879;1074;3353;259;794;520;1687;779;2481
510020;201801;3433;9185;1961;6244;412;1378;419;1220;831;2598
510025;201801;7012;19230;4543;14561;876;3065;1287;3936;2163;7001
510030;201801;1967;4725;1397;3928;332;946;568;1639;900;2585
510035;201801;1101;2950;706;2345;117;394;393;1388;510;1782
510040;201801;2117;5081;1533;4248;149;432;928;2575;1077;3007
510050;201801;1860;4888;1263;3902;313;1096;552;1575;865;2671
510060;201801;1402;3723;1043;3148;155;497;515;1515;670;2012
510080;201801;1132;3344;831;2783;230;887;178;490;408;1377
510100;201801;696;1742;468;1325;58;175;215;573;273;748
510120;201801;284;562;162;415;8;24;111;283;119;307
510125;201801;2553;6487;1893;5398;313;1100;760;1977;1073;3077
510130;201801;1589;4237;1212;3613;304;963;331;980;635;1943
510140;201801;2864;8419;2131;7431;835;3316;630;1976;1465;5292
510160;201801;1290;4067;1098;3792;217;767;692;2421;909;3188
510170;201801;4829;13794;3674;11829;759;2622;1535;4916;2294;7538
510180;201801;12441;30992;8040;23916;2145;6875;2196;7252;4341;14127
510185;201801;1683;4491;1153;3731;350;1120;460;1786;810;2906
510190;201801;2373;6524;1589;5292;446;1660;516;1738;962;3398
510250;201801;13631;38879;11703;36161;2747;8996;5912;18952;8659;27948
510260;201801;2080;8625;1699;7878;263;1203;969;5097;1232;6300
510263;201801;3381;9477;2198;7228;466;1655;323;1004;789;2659
510267;201801;5472;15767;3495;11438;775;2667;661;2184;1436;4851
510268;201801;1376;3598;956;2849;130;398;530;1546;660;1944
510269;201801;1072;3127;701;2392;238;902;148;442;386;1344
510270;201801;2831;8868;2174;7617;460;1657;791;2730;1251;4387
510279;201801;1756;5118;1342;4307;294;1054;574;1733;868;2787
510285;201801;1184;3288;858;2732;230;776;236;747;466;1523
510300;201801;3520;9402;2751;8353;286;845;1850;5812;2136;6657
510305;201801;1377;4191;988;3423;229;833;296;1098;525;1931
510310;201801;807;2226;601;1883;213;682;178;586;391;1268
510320;201801;3757;10228;2785;8532;527;1782;873;2637;1400;4419
510325;201801;4778;14605;3889;13282;1081;3834;1842;6578;2923;10412
510330;201801;2818;8880;2051;7505;480;1833;707;2871;1187;4704
510335;201801;4914;14402;3769;12832;418;1500;2354;8535;2772;10035
510336;201801;519;1540;396;1328;71;245;187;647;258;892
510337;201801;1796;5648;1324;4779;530;2034;235;870;765;2904
510340;201801;73918;185199;48657;145801;15335;52212;9380;27330;24715;79542
510343;201801;1040;3011;726;2378;141;484;249;776;390;1260
510345;201801;1419;4172;1064;3474;186;617;428;1375;614;1992
510350;201801;2895;7784;1985;6368;489;1675;735;2414;1224;4089
510360;201801;1672;3923;1092;3186;62;248;790;2307;852;2555
510370;201801;1606;4973;1211;4287;204;765;652;2419;856;3184
510380;201801;505;1398;274;927;72;265;35;117;107;382
510385;201801;1002;3687;730;3099;82;413;395;1801;477;2214
510390;201801;1085;3336;865;3013;229;792;383;1434;612;2226
510395;201801;742;1775;511;1424;56;176;255;759;311;935
510410;201801;3939;12165;3184;10729;803;2743;1501;5322;2304;8065
510420;201801;2222;5266;1598;4363;160;535;912;2443;1072;2978
510450;201801;600;1532;361;1102;86;276;61;182;147;458
510452;201801;659;2018;468;1621;86;293;224;778;310;1071
510454;201801;840;2511;658;2179;90;322;367;1236;457;1558
510455;201801;935;2787;672;2212;118;431;234;712;352;1143
510460;201801;2122;5409;1523;4553;166;603;876;2497;1042;3100
510480;201801;4204;10469;2972;8328;463;1376;1367;3646;1830;5022
510490;201801;1511;4530;1220;4121;270;960;602;2036;872;2996
510500;201801;1548;4318;986;3258;169;655;391;1261;560;1916
510510;201801;3012;9802;2421;8638;749;2914;606;2307;1355;5221
510515;201801;5971;16461;3914;12527;895;3118;948;2737;1843;5855
510517;201801;1362;3966;1065;3436;312;1090;182;548;494;1638
510520;201801;2042;4393;1285;3445;50;153;791;2260;841;2413
510523;201801;963;2641;775;2319;97;298;487;1479;584;1777
510525;201801;5174;15388;4026;13060;799;2848;1431;4191;2230;7039
510530;201801;528;1368;392;1166;26;123;284;790;310;913
510550;201801;2824;8838;2090;7451;532;2001;677;2445;1209;4446
510558;201801;1914;5411;1595;4958;100;331;1007;3330;1107;3661
510560;201801;1661;4854;1010;3676;236;944;243;943;479;1887
510562;201801;5232;14735;3808;12009;961;3287;1110;3615;2071;6902
510590;201801;3169;8067;2335;6972;494;1396;1277;4061;1771;5457
510600;201801;1573;3832;1000;2906;242;717;330;974;572;1691
510610;201801;2774;7371;2057;6370;211;753;1241;3784;1452;4537
510615;201801;2008;5758;1556;4990;395;1282;724;2452;1119;3734
510617;201801;821;2440;670;2206;42;115;538;1861;580;1976
510618;201801;1342;3770;969;3059;192;707;449;1324;641;2031
510619;201801;728;1947;412;1361;82;312;64;193;146;505
510620;201801;1326;3259;705;2224;178;626;106;308;284;934
510621;201801;1036;3139;811;2724;179;658;245;807;424;1465
510622;201801;3825;11282;2794;9035;894;3161;560;1679;1454;4840
510623;201801;3122;8200;2258;6767;467;1644;709;2025;1176;3669
510624;201801;1663;4470;746;2558;119;461;101;293;220;754
510625;201801;2250;5872;1480;4515;367;1279;240;736;607;2015
510626;201801;1546;3894;956;3027;272;952;196;648;468;1600
510627;201801;595;1623;403;1246;112;361;97;302;209;663
510628;201801;1617;3743;1041;2962;201;567;560;1681;761;2248
510629;201801;1611;5036;1248;4269;332;1225;394;1402;726;2627
510630;201801;2902;9005;1883;6905;431;1712;297;1167;728;2879
510631;201801;438;1175;333;1010;3;6;250;775;253;781
510637;201801;2982;7901;2297;6822;651;2128;755;2203;1406;4331
510642;201801;4932;15370;4006;13981;1141;4311;1606;5865;2747;10176
510645;201801;894;1969;556;1530;155;428;170;490;325;918
510650;201801;6337;19069;5517;18111;904;3046;3883;13280;4787;16326
510665;201801;1784;4400;1067;3151;198;633;370;1121;568;1754
510670;201801;392;839;214;588;21;68;115;325;136;393
510675;201801;6100;18007;4553;15078;1275;4572;944;3107;2219;7679
510677;201801;2059;5397;1498;4606;195;640;904;2859;1099;3499
510680;201801;672;1969;466;1562;109;370;59;190;168;560
510682;201801;1849;5811;1372;4919;382;1492;293;1065;675;2557
510685;201801;882;2404;658;2012;89;297;316;905;405;1202
510700;201801;3989;10190;2663;8272;613;1944;1244;4047;1857;5991
510704;201801;9740;24943;6611;19369;1291;4138;2293;6392;3584;10530
510706;201801;2004;5731;1291;4641;255;984;615;2399;870;3383
510710;201801;2745;7439;1882;5705;387;1206;645;1868;1032;3074
510715;201801;716;1696;491;1334;70;187;196;541;266;728
510718;201801;2540;5659;1424;4330;601;1885;246;974;847;2859
510719;201801;380;858;234;661;31;111;124;343;155;454
510720;201801;1037;2626;696;2088;179;597;202;558;381;1155
510724;201801;719;2052;510;1675;100;356;211;660;311;1016
510726;201801;742;1612;476;1231;62;183;319;788;381;971
510729;201801;699;1699;345;1035;61;202;89;259;150;461
510730;201801;3043;8020;2075;6372;536;1738;651;2027;1187;3765
510735;201801;955;2914;729;2595;93;356;467;1699;560;2055
510740;201801;1272;3444;910;2863;90;256;581;1971;671;2227
510757;201801;635;2074;519;1862;207;781;175;620;382;1401
510760;201801;35629;83182;21685;62269;6222;20054;4423;11752;10645;31806
510770;201801;4596;10517;3522;9296;357;832;2254;6670;2611;7502
510774;201801;366;1030;286;864;55;158;134;427;189;585
510775;201801;629;1816;465;1534;117;451;81;239;198;690
510776;201801;461;1284;354;1062;88;263;137;424;225;687
510777;201801;1686;4727;1221;4097;108;395;937;3161;1045;3556
510779;201801;589;1710;466;1499;58;162;282;941;340;1103
510780;201801;3512;10077;2775;8925;731;2404;1046;3721;1777;6125
510785;201801;2016;5444;1212;3953;294;1067;175;569;469;1636
510787;201801;2375;6812;1762;5691;799;2709;197;600;996;3309
510788;201801;656;1630;452;1323;79;221;178;624;257;845
510790;201801;14572;40526;9313;30444;2170;8188;1113;3269;3283;11457
510792;201801;8540;23674;5558;18104;1160;4130;1111;3538;2271;7668
510794;201801;1196;3569;852;2906;254;959;186;564;440;1523
510795;201801;8014;22776;5655;18471;1500;5368;1101;3708;2601;9076
510800;201801;1570;4178;1130;3525;232;747;503;1527;735;2274
510805;201801;1876;5150;1281;4071;257;872;478;1402;735;2274
510810;201801;660;1512;457;1235;115;336;231;592;346;928
510820;201801;820;1691;455;1217;64;211;190;485;254;696
510830;201801;738;1977;540;1678;111;340;267;882;378;1222
510835;201801;608;1640;421;1321;62;204;196;594;258;798
510840;201801;42543;103984;32741;91169;7184;19964;16007;47247;23191;67211
510850;201801;1752;4454;1032;3245;326;1154;184;515;510;1669
510860;201801;2736;7901;1839;6282;606;2353;185;606;791;2959
510880;201801;596;1901;491;1701;131;483;216;761;347;1244
510885;201801;585;1574;422;1336;79;284;153;457;232;741
510890;201801;724;2186;591;1999;120;452;310;1057;430;1509
510895;201801;1251;3493;908;2884;229;812;306;884;535;1696
520005;201801;1907;5406;1554;4958;454;1383;699;2508;1153;3891
520010;201801;2140;6641;1548;5397;514;2014;264;786;778;2800
520013;201801;2859;7927;2080;6402;483;1543;584;1908;1067;3451
520015;201801;532;1444;409;1274;112;370;110;370;222;740
520017;201801;1076;3041;845;2679;190;639;399;1256;589;1895
520020;201801;391;978;313;874;72;220;168;454;240;674
520025;201801;31623;91776;28090;87225;3376;11214;20108;62465;23484;73679
520030;201801;5053;14396;4046;12788;562;1911;2261;7219;2823;9130
520050;201801;443;1097;273;782;22;56;154;461;176;517
520055;201801;886;2583;727;2281;88;266;407;1284;495;1550
520060;201801;1427;4226;1122;3650;279;1010;307;975;586;1985
520080;201801;1905;5104;1483;4532;264;786;715;2384;979;3170
520082;201801;1045;2665;901;2427;109;235;561;1558;670;1793
520085;201801;735;2169;611;1959;143;446;193;598;336;1044
520090;201801;872;1929;612;1613;113;265;356;1006;469;1271
520110;201801;39773;111142;28956;94073;10187;37677;2012;5987;12199;43664
520120;201801;191;475;110;339;10;32;40;124;50;156
520130;201801;3614;9634;3067;8771;643;1933;1547;4568;2190;6501
520140;201801;34903;105308;27821;92490;9944;36057;3030;10334;12974;46391
520145;201801;448;1167;308;936;69;224;102;290;171;514
520150;201801;536;1327;414;1178;71;205;235;675;306;880
520160;201801;843;2113;652;1837;114;325;284;819;398;1144
520170;201801;4968;10563;3658;9093;225;615;3048;7625;3273;8240
520180;201801;2132;6038;1751;5456;418;1406;750;2311;1168;3717
520215;201801;1956;4811;1476;4067;292;904;724;1935;1016;2839
520235;201801;659;1613;437;1275;59;193;163;446;222;639
520250;201801;1546;4154;1107;3465;296;1016;191;612;487;1628
520260;201801;855;2080;525;1492;88;264;200;573;288;837
520280;201801;623;1706;509;1498;157;453;190;613;347;1066
520310;201801;1236;2844;821;2198;220;599;276;809;496;1408
520320;201801;1940;5635;1548;4963;165;573;860;2810;1025;3383
520330;201801;3261;9652;2369;8087;543;2088;787;2672;1330;4760
520340;201801;2154;5090;1503;4165;167;407;996;2896;1163;3303
520350;201801;3126;8075;2305;6656;675;2097;747;2074;1422;4171
520355;201801;1710;4849;1336;4199;339;1174;526;1631;865;2805
520357;201801;826;2109;646;1836;45;140;448;1286;493;1426
520360;201801;722;1980;564;1712;171;547;162;508;333;1055
520380;201801;1338;3501;820;2489;115;396;367;1006;482;1402
520390;201801;987;2295;582;1766;186;637;142;410;328;1047
520393;201801;547;1326;391;1080;45;131;189;491;234;622
520396;201801;786;2264;661;2048;101;325;430;1318;531;1643
520400;201801;1505;4129;1234;3740;237;735;728;2233;965;2968
520410;201801;1657;3705;1082;2907;138;396;656;1766;794;2162
520420;201801;356;925;264;742;23;73;179;472;202;545
520425;201801;1382;3418;947;2694;250;734;395;1126;645;1860
520430;201801;2160;5294;1163;3603;207;701;74;230;281;931
520440;201801;3529;8780;2268;6576;611;1896;541;1528;1152;3424
520450;201801;11215;29087;7558;22960;2289;7593;474;1489;2763;9082
520455;201801;688;1948;520;1693;184;657;127;419;311;1076
520460;201801;951;2637;791;2405;109;328;544;1681;653;2009
520465;201801;841;2285;698;2054;113;377;435;1215;548;1592
520470;201801;1859;5592;1590;5217;350;1141;956;3339;1306;4480
520480;201801;841;2432;541;1886;124;476;92;306;216;782
520485;201801;1514;4340;1246;3973;153;534;864;2748;1017;3282
520490;201801;3847;11428;2999;10105;733;2462;1465;5114;2198;7576
520495;201801;1445;3519;1152;3132;79;225;857;2399;936;2624
520500;201801;1416;3847;1041;3190;246;844;402;1202;648;2046
520505;201801;732;1859;537;1594;119;344;266;793;385;1137
520510;201801;7028;19217;5135;16288;1231;4337;1356;4400;2587;8737
520520;201801;1096;2839;822;2444;244;713;264;878;508;1591
520530;201801;1855;6006;1479;5343;546;1969;338;1427;884;3396
520540;201801;2821;7653;1857;5798;448;1435;370;1210;818;2645
520545;201801;1022;2869;794;2486;154;516;272;830;426;1346
520547;201801;712;2121;571;1859;168;557;208;660;376;1217
520549;201801;10655;30786;8727;27794;1968;6462;4383;14282;6351;20744
520551;201801;4099;11855;3534;11033;541;1927;2313;7069;2854;8996
520552;201801;743;2126;662;2029;93;269;468;1493;561;1762
520570;201801;598;1533;425;1268;109;341;141;429;250;770
520580;201801;2843;6565;1974;5450;247;730;1227;3419;1474;4149
520590;201801;1337;3749;975;3098;225;732;185;608;410;1340
520620;201801;8119;22777;6642;20733;1858;6039;2806;8941;4664;14980
520630;201801;1017;2536;653;1939;103;313;226;649;329;962
520640;201801;2599;6795;2032;5862;469;1378;834;2445;1303;3823
520650;201801;880;2234;612;1763;99;298;325;942;424;1240
520660;201801;442;1074;251;757;65;214;48;158;113;372
520670;201801;991;2826;832;2600;74;250;590;1802;664;2052
520680;201801;760;1965;569;1668;124;359;253;764;377;1123
520690;201801;361;872;238;696;73;215;74;235;147;450
520710;201801;565;1418;365;1054;12;33;228;642;240;675
520725;201801;1601;3911;1147;3178;138;429;730;1977;868;2406
520735;201801;811;2109;557;1648;115;349;183;541;298;890
520740;201801;1831;4542;1453;4085;235;652;857;2479;1092;3131
520750;201801;698;1761;517;1490;102;272;232;713;334;985
520753;201801;1476;3821;1247;3444;173;466;693;1956;866;2422
520760;201801;1046;2433;920;2269;94;187;728;1895;822;2082
520780;201801;1780;4380;1319;3693;149;443;719;1954;868;2397
520790;201801;3132;7662;2265;6366;187;510;1503;4402;1690;4912
520800;201801;15774;42531;13026;39064;2445;7150;7935;25204;10380;32354
520810;201801;1282;2858;919;2444;156;468;510;1416;666;1884
520815;201801;652;1989;477;1623;139;517;68;254;207;771
520830;201801;1718;4101;1289;3600;79;154;1004;2839;1083;2993
520840;201801;2007;5863;1650;5379;674;2305;426;1503;1100;3808
520850;201801;656;1823;449;1499;125;474;106;355;231;829
520860;201801;6448;18364;4941;15982;1140;3982;1746;5781;2886;9763
520870;201801;89570;226433;63586;187165;18439;59281;15372;44085;33811;103366
520880;201801;6435;18430;5021;16222;1647;5724;1086;3499;2733;9223
520890;201801;3963;10316;2871;8537;646;2173;1184;3413;1830;5586
520910;201801;4002;10539;2651;8192;822;2774;467;1435;1289;4209
520915;201801;649;1849;478;1491;88;299;185;563;273;862
520920;201801;4043;9972;2734;8114;422;1391;1313;3926;1735;5317
520929;201801;671;1731;507;1442;100;241;250;793;350;1034
520940;201801;1137;3085;879;2719;70;231;649;2020;719;2251
520945;201801;569;1307;438;1091;46;105;289;703;335;808
520960;201801;1009;2765;794;2401;136;440;404;1196;540;1636
520970;201801;2465;7377;2075;6677;584;2064;487;1592;1071;3656
520980;201801;766;2072;624;1857;144;477;259;745;403;1222
520990;201801;2913;9052;2627;8602;375;1271;1585;5336;1960;6607
520993;201801;988;2414;699;1957;40;114;491;1386;531;1500
520995;201801;2230;5889;1830;5352;425;1244;848;2512;1273;3756
521000;201801;7656;21824;5756;18272;1677;5655;1374;4344;3051;9999
521010;201801;4053;10902;3054;9179;489;1432;1518;4600;2007;6032
521015;201801;664;1750;566;1589;77;226;397;1100;474;1326
521020;201801;2996;8179;1886;5947;515;1756;196;579;711;2335
521030;201801;600;1452;432;1186;55;128;210;619;265;747
521040;201801;7000;17749;5445;15383;1585;4698;1900;5583;3485;10281
521056;201801;838;2357;656;2063;208;685;177;610;385;1295
521060;201801;1032;2641;794;2271;73;214;451;1330;524;1544
521080;201801;1108;2619;597;1759;78;237;211;542;289;779
521090;201801;3103;8116;2276;6840;697;2229;454;1404;1151;3633
521100;201801;1843;4330;1347;3637;236;616;752;2092;988;2708
521120;201801;4876;11640;3507;9938;520;1447;1586;5022;2106;6469
521130;201801;1031;2578;690;1949;46;165;391;1082;437;1247
521140;201801;1177;3230;880;2698;162;528;323;994;485;1522
521150;201801;11911;28449;7630;21809;2150;6731;2438;7121;4588;13852
521160;201801;730;1663;486;1289;89;260;225;560;314;820
521170;201801;1115;2688;802;2213;87;249;503;1335;590;1584
521180;201801;6400;19395;5371;17510;1217;4223;1988;6494;3205;10717
521190;201801;9884;26486;5902;19315;1485;5227;1025;3471;2510;8698
521200;201801;784;2045;571;1676;66;219;307;882;373;1101
521205;201801;618;1636;472;1397;32;98;330;954;362;1052
521210;201801;821;2235;472;1483;114;396;63;153;177;549
521220;201801;4211;10332;2917;8452;606;1864;1057;3023;1663;4887
521225;201801;351;849;281;770;24;53;213;617;237;670
521230;201801;1341;3964;1234;3797;447;1332;620;2012;1067;3344
521250;201801;30877;88882;25067;80485;10480;34611;6778;23452;17258;58063
521260;201801;713;1672;545;1434;92;273;296;764;388;1037
521270;201801;1804;4847;1567;4561;135;304;1217;3682;1352;3986
521280;201801;1916;5443;1470;4636;460;1568;438;1385;898;2953
521290;201801;450;1186;335;1030;65;241;179;531;244;772
521295;201801;1185;2690;942;2391;89;202;710;1893;799;2095
521300;201801;1863;4883;1508;4391;209;595;1011;3029;1220;3624
521305;201801;742;1951;553;1638;87;250;287;865;374;1115
521308;201801;4500;12833;3400;10698;643;2058;1610;5114;2253;7172
521310;201801;8389;22979;5634;17827;1430;4845;1423;4380;2853;9225
521340;201801;374;916;308;824;22;60;240;641;262;701
521350;201801;2140;5470;1669;4769;220;666;1105;3096;1325;3762
521370;201801;1061;2849;663;2142;196;714;61;200;257;914
521375;201801;1448;3903;1088;3396;277;923;393;1284;670;2207
521377;201801;1281;2966;1028;2652;51;132;897;2317;948;2449
521380;201801;6153;16698;4152;13054;479;1584;1052;3455;1531;5039
521385;201801;600;1506;478;1362;117;339;207;634;324;973
521390;201801;761;1986;556;1678;182;603;165;509;347;1112
521400;201801;2236;5568;1799;5072;222;716;1294;3623;1516;4339
521405;201801;1390;3673;1042;3089;239;731;440;1331;679;2062
521410;201801;746;2085;625;1910;145;411;315;1041;460;1452
521440;201801;1428;3913;1085;3271;280;890;268;754;548;1644
521450;201801;3836;11926;2957;10135;828;2961;681;2422;1509;5383
521460;201801;6584;18210;5109;15591;1587;5170;1498;4400;3085;9570
521470;201801;620;1766;417;1311;81;244;94;281;175;525
521480;201801;376;1054;222;736;42;145;60;192;102;337
521483;201801;2586;6590;1891;5410;488;1456;552;1550;1040;3006
521486;201801;1682;4079;1314;3578;81;205;1002;2718;1083;2923
521487;201801;486;1248;342;1035;79;250;136;417;215;667
521490;201801;831;2300;628;1946;38;146;423;1268;461;1414
521500;201801;1633;4398;1140;3560;161;587;590;1742;751;2329
521520;201801;812;1859;569;1512;101;273;256;710;357;983
521523;201801;13054;44028;11586;41386;3773;14435;2476;9462;6249;23897
521525;201801;1036;2540;820;2229;85;250;535;1419;620;1669
521530;201801;2158;5687;1318;4044;292;960;304;959;596;1919
521540;201801;879;2300;570;1773;96;376;245;744;341;1120
521550;201801;1463;3685;908;2579;185;565;335;963;520;1528
521560;201801;3706;11055;2786;9796;732;2913;1289;4678;2021;7591
521565;201801;612;1503;501;1358;74;202;325;861;399;1063
521570;201801;4103;11114;2668;8349;578;1958;357;1145;935;3103
521580;201801;570;1366;309;933;45;142;61;182;106;324
521590;201801;615;1612;467;1361;119;392;184;496;303;888
521600;201801;415;1179;270;866;59;180;59;186;118;366
521630;201801;1434;3382;920;2638;212;677;268;730;480;1407
521640;201801;2093;5107;1555;4377;371;1048;670;1939;1041;2987
521645;201801;586;1633;382;1241;91;317;97;297;188;614
521680;201801;1207;3815;974;3343;312;1125;109;384;421;1509
521690;201801;479;1364;430;1281;103;321;212;619;315;940
521710;201801;3059;8331;2168;6766;433;1424;432;1323;865;2747
521720;201801;2015;5401;1526;4535;226;711;816;2350;1042;3061
521730;201801;3776;11538;3052;10186;1067;3919;481;1377;1548;5296
521740;201801;3843;10531;3003;9270;788;2678;1109;3628;1897;6306
521760;201801;14151;42878;11815;39110;3495;12701;3826;13016;7321;25717
521770;201801;2830;7601;2055;6186;670;2166;470;1360;1140;3526
521800;201801;6085;17833;5056;16094;1500;5007;1605;5503;3105;10510
521805;201801;864;1908;595;1543;197;486;215;615;412;1101
521810;201801;736;1777;508;1444;96;296;219;648;315;944
521830;201801;5225;15450;4379;14198;513;1844;2886;9271;3399;11115
521839;201801;690;1839;496;1482;107;345;188;540;295;885
521850;201801;5769;15141;4217;12632;1167;3788;721;2072;1888;5860
521860;201801;1866;4824;1353;4021;243;797;453;1325;696;2122
521870;201801;533;1634;417;1425;98;345;127;415;225;760
521878;201801;702;1960;497;1555;79;283;184;524;263;807
521880;201801;20609;51277;13888;40929;3520;10943;4224;13022;7744;23965
521890;201801;3220;9164;2255;7197;555;1892;302;899;857;2791
521900;201801;1494;3718;976;2943;234;703;306;919;540;1622
521910;201801;1195;2744;816;2294;92;266;491;1444;583;1710
521920;201801;374;1106;281;922;64;236;82;277;146;513
521925;201801;651;1893;505;1625;108;349;146;462;254;811
521930;201801;4112;11464;3152;9960;1000;3186;881;2947;1881;6133
521935;201801;678;1845;538;1586;133;378;225;665;358;1043
521940;201801;1237;3005;881;2517;220;717;388;1066;608;1783
521945;201801;583;1757;484;1580;90;300;230;801;320;1101
521950;201801;643;1582;513;1416;37;107;400;1111;437;1218
521960;201801;701;1981;491;1560;81;278;215;654;296;932
521970;201801;2675;6940;2241;6426;140;366;1827;5414;1967;5780
521971;201801;905;2329;612;1848;132;417;147;434;279;851
521973;201801;1047;3005;869;2731;124;435;495;1537;619;1972
521975;201801;12599;33906;10806;31579;1823;5534;6806;19955;8629;25489
521980;201801;2410;6120;1953;5527;207;533;1456;4194;1663;4727
521990;201801;1180;3299;936;2919;131;413;525;1690;656;2103
522000;201801;3120;10068;2500;9271;219;713;1657;6764;1876;7477
522005;201801;346;841;247;691;73;185;87;267;160;452
522010;201801;3631;9595;2790;8253;877;2712;676;1969;1553;4681
522015;201801;986;2700;736;2320;161;541;281;882;442;1423
522020;201801;5127;12842;3606;10419;891;2691;1504;4366;2395;7057
522026;201801;711;1935;533;1695;82;274;285;954;367;1228
522028;201801;516;1409;377;1116;73;211;150;415;223;626
522040;201801;2631;6037;1860;5064;281;789;1232;3374;1513;4163
522045;201801;16197;49475;12566;42381;3219;11720;2372;7923;5591;19643
522050;201801;1111;3050;748;2379;160;523;241;705;401;1228
522060;201801;2463;7007;1993;6300;331;1089;1085;3532;1416;4621
522068;201801;1722;4974;1459;4662;193;550;1016;3433;1209;3983
522070;201801;630;1744;522;1575;53;219;355;1018;408;1237
522100;201801;564;1549;430;1355;80;261;219;698;299;959
522108;201801;830;2470;685;2236;46;224;526;1648;572;1872
522119;201801;1587;4280;1253;3827;215;666;645;2041;860;2707
522130;201801;384;1002;279;861;72;242;132;415;204;657
522140;201801;16456;45749;12558;38890;3912;12963;1982;6008;5894;18971
522145;201801;814;2092;612;1796;147;392;326;1042;473;1434
522150;201801;963;2399;745;2078;216;588;266;772;482;1360
522155;201801;882;2439;729;2196;151;420;364;1153;515;1573
522157;201801;584;1587;489;1448;30;115;357;1031;387;1146
522160;201801;6351;17081;4259;13272;1188;4021;381;1290;1569;5311
522170;201801;2363;6635;1718;5474;565;1890;343;1119;908;3009
522180;201801;431;1148;275;880;64;214;43;155;107;369
522185;201801;15943;42170;12346;37550;4452;14333;4015;13244;8467;27577
522190;201801;855;2040;642;1731;123;315;274;791;397;1106
522200;201801;1749;5361;1230;4234;263;949;182;620;445;1569
522205;201801;1434;3659;1114;3187;100;318;790;2277;890;2595
522220;201801;1500;3732;1115;3198;171;463;611;1853;782;2316
522230;201801;1240;3277;1021;2956;174;566;584;1690;758;2256
530010;201801;175780;523014;151923;483538;34289;121033;70136;217750;104425;338783
110001;201802;3356;10400;2700;9263;706;2568;1160;4037;1866;6605
110002;201802;11775;32539;8730;27431;2704;9112;2708;8404;5412;17516
110003;201802;679;2053;516;1724;160;573;97;300;257;873
110004;201802;8631;25789;6526;21737;1949;6870;1330;4740;3279;11610
110005;201802;2200;6108;1491;4825;372;1268;525;1778;897;3046
110006;201802;1716;4979;1086;3656;312;1119;126;413;438;1532
110007;201802;1251;3624;1013;3207;330;1098;330;1208;660;2306
110008;201802;2407;7795;2170;7459;279;890;1659;5945;1938;6835
110009;201802;4248;12454;3098;10554;936;3306;938;3339;1874;6645
110010;201802;6244;21039;5190;19231;1529;5573;2174;9030;3703;14603
110011;201802;6536;19210;5142;16564;1713;5746;1188;3900;2901;9646
110012;201802;14425;39223;10407;32365;2768;9037;1899;6003;4667;15040
110013;201802;5377;16483;4412;14656;1747;5978;847;3055;2594;9033
110014;201802;3793;10485;2844;8820;837;2671;1136;3455;1973;6126
110015;201802;4869;13872;3137;10442;829;2932;428;1407;1257;4339
110018;201802;3542;9597;2349;7596;562;2070;650;2014;1212;4084
110020;201802;67993;175648;47728;147500;10681;34923;18329;60200;29010;95123
110025;201802;4553;12081;3242;9846;549;1768;1785;5333;2334;7101
110026;201802;524;1590;448;1454;133;478;186;590;319;1068
110028;201802;6126;17577;4338;14074;1256;4383;550;1743;1806;6126
110029;201802;1375;3494;877;2713;218;690;365;1134;583;1824
110030;201802;10835;28133;7813;23807;1609;5563;3117;9501;4726;15064
110032;201802;3241;9870;2479;8261;857;2909;590;1987;1447;4896
110033;201802;4419;14215;3690;12852;1320;4659;1029;3950;2349;8609
110034;201802;3361;8814;2525;7609;828;2651;1108;3358;1936;6009
110037;201802;1709;5578;1416;4993;351;1290;645;2262;996;3552
110040;201802;3021;9101;2343;7844;747;2692;607;1950;1354;4642
110045;201802;4766;14791;4022;13727;1287;4726;1593;5421;2880;10147
110050;201802;1643;5031;1290;4339;532;1846;319;1082;851;2928
110060;201802;804;2549;597;2113;212;786;66;258;278;1044
110070;201802;1915;6285;1575;5495;571;2092;380;1272;951;3364
110080;201802;4858;12814;3782;11461;1049;3276;1773;5603;2822;8879
110090;201802;674;1880;474;1515;131;451;184;568;315;1019
110092;201802;1173;3629;986;3338;165;616;549;1894;714;2510
110094;201802;3162;9291;2517;8230;872;2940;791;2646;1663;5586
110100;201802;1917;5957;1652;5435;355;1262;843;2757;1198;4019
110110;201802;1595;4762;1226;4176;436;1553;271;981;707;2534
110120;201802;1485;4550;1117;3781;330;1180;249;840;579;2020
110130;201802;2495;6672;1633;5132;412;1447;510;1558;922;3005
110140;201802;2202;7013;1675;5932;451;1690;411;1430;862;3120
110143;201802;1433;4023;1040;3290;357;1165;282;888;639;2053
110145;201802;1022;2874;677;2207;171;590;230;751;401;1341
110146;201802;428;1232;307;1036;54;172;150;538;204;710
110147;201802;647;1819;438;1407;110;371;154;457;264;828
110148;201802;1017;3069;615;2122;110;413;71;247;181;660
110149;201802;2995;8758;2238;7538;877;2908;636;2344;1513;5252
110150;201802;2153;6148;1696;5442;708;2530;397;1192;1105;3722
110155;201802;742;2302;600;1975;136;479;230;728;366;1207
110160;201802;1632;5184;1272;4430;458;1570;296;1088;754;2658
110170;201802;2379;6589;1633;5155;346;1140;780;2421;1126;3561
110175;201802;1498;4481;1180;4000;202;732;588;2095;790;2827
110180;201802;1170;3345;910;2880;261;801;393;1293;654;2094
120001;201802;3136;10494;2756;9926;494;1713;1714;6592;2208;8305
120005;201802;1748;6916;1581;6634;187;870;1172;5041;1359;5911
120010;201802;5200;16705;4538;15593;641;2152;3113;11028;3754;13180
120013;201802;2059;8063;1943;7897;525;2055;1088;4766;1613;6821
120017;201802;2028;7073;1843;6756;390;1469;1022;3972;1412;5441
120020;201802;14123;60754;13445;59428;1597;7556;9870;44681;11467;52237
120025;201802;2620;8312;2264;7863;481;1715;1367;4862;1848;6577
120030;201802;6440;25459;6211;25086;368;1819;5182;21023;5550;22842
120032;201802;1596;7551;1522;7372;106;668;1192;5741;1298;6409
120033;201802;3814;14803;3602;14438;167;860;3118;12442;3285;13302
120034;201802;2319;9023;2049;8539;143;830;1610;6620;1753;7450
120035;201802;3323;14346;3196;14110;279;1448;2554;11336;2833;12784
120038;201802;2619;9038;2396;8634;611;2276;1252;4622;1863;6898
120039;201802;1837;8471;1765;8335;162;979;1344;6379;1506;7358
120040;201802;42220;144623;37999;137574;7573;29199;21224;78383;28797;107582
120042;201802;3101;12335;2892;11871;168;873;2297;9394;2465;10267
120043;201802;1185;5304;1120;5157;65;397;957;4420;1022;4817
120045;201802;5153;15786;4695;15274;203;775;4259;13817;4462;14592
120050;201802;8435;32734;7869;31750;785;3600;5910;24303;6695;27903
120060;201802;8222;35150;7850;34504;566;3056;6483;28656;7049;31712
120070;201802;2771;9751;2599;9462;350;1270;1793;6742;2143;8012
120080;201802;3888;14043;3569;13509;601;2399;2397;9215;2998;11614
130002;201802;3151;12917;2923;12597;113;620;2615;11319;2728;11939
130006;201802;2233;9021;1903;8408;153;786;1441;6367;1594;7153
130008;201802;2409;8933;2169;8534;95;513;1795;7054;1890;7567
130010;201802;3699;10946;3241;10427;87;345;2990;9630;3077;9975
130014;201802;3102;9753;2581;8881;434;1564;1638;5732;2072;7296
130020;201802;2718;10609;2524;10278;136;791;2041;8259;2177;9050
130030;201802;9043;31427;8360;30688;173;512;7859;29369;8032;29881
130040;201802;3844;11627;3281;10890;231;770;2613;8822;2844;9592
130050;201802;7035;26597;5959;25212;220;981;5303;22816;5523;23797
130060;201802;6847;29093;6058;27975;534;3138;4703;21634;5237;24772
130063;201802;5135;19239;4624;18647;130;631;4259;17311;4389;17942
130068;201802;3292;13208;2924;12478;226;1179;2186;9353;2412;10532
130070;201802;8271;26321;7158;25078;360;1226;6213;22272;6573;23498
130080;201802;6159;25154;5590;24394;465;2598;4402;19240;4867;21838
130083;201802;2500;9096;2255;8758;213;973;1750;6767;1963;7740
130090;201802;3141;10348;2885;10004;63;272;2599;9144;2662;9416
130100;201802;6827;22691;6150;21953;87;296;5882;21227;5969;21523
130110;201802;7497;22403;6493;21202;564;1626;5432;18271;5996;19897
130115;201802;5177;17137;4708;16528;112;452;4115;14611;4227;15063
130120;201802;14926;55174;13789;53691;1374;5618;11077;43947;12451;49565
130130;201802;4782;16823;4033;15847;475;2142;3030;11857;3505;13999
130140;201802;6466;24729;6275;24511;250;1164;5772;22544;6022;23708
130150;201802;3557;13916;3385;13694;128;756;3046;12287;3174;13043
130160;201802;4665;18111;4217;17523;323;1602;3473;14640;3796;16242
130165;201802;3044;12180;2894;11926;121;677;2532;10404;2653;11081
130170;201802;10985;34754;9082;32458;736;2865;7382;26903;8118;29768
130180;201802;4142;13295;3908;13019;58;265;3719;12378;3777;12643
130185;201802;15027;41290;12398;38480;516;1208;10931;35288;11447;36496
130190;201802;17639;59927;14982;56142;1920;7238;10543;40980;12463;48218
130195;201802;2250;8711;1908;8257;94;435;1679;7350;1773;7785
130200;201802;2198;6985;1894;6567;166;574;1477;5261;1643;5835
130210;201802;1402;5345;1263;5180;113;643;990;3986;1103;4629
130220;201802;2023;7918;1852;7616;139;703;1421;5881;1560;6584
130230;201802;4054;17891;3663;17316;342;1928;2968;14161;3310;16089
130240;201802;10060;34082;8634;32059;235;1385;7590;28176;7825;29561
130250;201802;24036;75614;21371;72581;1565;5245;17747;61821;19312;67066
130255;201802;4180;14744;3788;14079;262;1165;3021;11276;3283;12441
130260;201802;243857;755515;209919;702409;62616;223913;85326;289456;147942;513369
130270;201802;7873;31088;6961;29643;845;3799;5021;22120;5866;25919
130280;201802;3461;14174;3269;13960;78;350;3064;13274;3142;13624
130290;201802;11978;41697;10905;40470;237;575;10313;39132;10550;39707
130300;201802;4618;17107;4302;16630;239;1211;3677;14167;3916;15378
130310;201802;5502;20187;4973;19456;386;1583;4065;16193;4451;17776
130320;201802;3246;11172;2843;10648;323;1156;2082;8081;2405;9237
130330;201802;4114;14076;3529;13341;155;774;3058;11555;3213;12329
130340;201802;20446;72166;18277;69601;1517;5760;15254;59692;16771;65452
130350;201802;3771;14375;3479;13992;191;1125;2973;11795;3164;12920
130353;201802;6286;18821;5356;17628;928;2957;3539;12333;4467;15290
130356;201802;4925;17129;4412;16291;537;2088;3101;11745;3638;13833
130360;201802;3322;9680;2869;9203;83;229;2672;8688;2755;8917
130370;201802;5779;22439;5166;21620;205;1208;4448;18621;4653;19829
130380;201802;7610;31832;7276;31339;522;2780;6152;26301;6674;29081
130390;201802;5405;24029;4939;23176;540;2901;3642;17129;4182;20030
130395;201802;2352;7860;2055;7331;244;916;1464;5240;1708;6156
130400;201802;2450;8349;2149;7916;121;443;1884;7031;2005;7474
130406;201802;10987;40868;9706;39120;1810;7509;6492;26827;8302;34336
130410;201802;4019;14783;3512;13895;1042;4319;1677;6855;2719;11174
130420;201802;11940;46490;10722;44929;1132;5210;8445;35926;9577;41136
130423;201802;3899;13507;3488;12998;179;917;3027;11152;3206;12069
130426;201802;2692;10747;2564;10556;83;407;2357;9796;2440;10203
130430;201802;3918;12565;3585;12099;414;1421;2789;9519;3203;10940
130440;201802;4331;14140;3881;13617;94;357;3605;12744;3699;13101
140002;201802;1907;5939;1691;5664;114;469;1337;4420;1451;4889
140005;201802;3415;9446;3225;9241;120;376;3000;8581;3120;8957
140010;201802;50905;142771;40614;127794;10342;34337;15385;51575;25727;85912
140015;201802;3379;10588;3048;10190;256;854;2520;8607;2776;9461
140017;201802;3532;11050;3144;10539;322;1016;2311;8186;2633;9202
140020;201802;4913;15448;4246;14547;379;1560;3203;10969;3582;12529
140023;201802;2218;7140;1869;6616;234;876;1302;4683;1536;5559
140028;201802;2098;5593;1817;5225;191;630;1382;3871;1573;4501
140030;201802;4054;11967;3632;11439;382;1089;2853;9253;3235;10342
140040;201802;1925;8413;1801;8239;87;505;1628;7427;1715;7932
140045;201802;2614;9693;2228;9137;418;1671;1418;6206;1836;7877
140047;201802;6108;18237;5202;16844;1063;3500;2881;9787;3944;13287
140050;201802;1436;4360;1231;4056;154;506;835;2803;989;3309
140060;201802;1474;4210;1303;3961;114;337;1051;3238;1165;3575
140070;201802;1755;9555;1698;9403;156;1082;1318;7255;1474;8337
150010;201802;40609;108740;37467;104560;1564;5060;32392;89757;33956;94817
150013;201802;1790;5007;1524;4708;140;393;1148;3688;1288;4081
150020;201802;13132;42383;12456;41478;1333;3524;10204;35372;11537;38896
150030;201802;8562;33340;7853;32454;417;1829;6859;28678;7276;30507
150034;201802;4136;11221;3581;10450;267;797;2900;8540;3167;9337
150040;201802;13426;39644;11650;37598;1061;2664;9518;32633;10579;35297
150050;201802;6481;23672;6034;23020;157;817;5468;20921;5625;21738
150060;201802;19335;56750;16580;52645;3639;11485;9225;30591;12864;42076
150070;201802;6339;24920;5664;24154;185;987;5184;22345;5369;23332
150080;201802;81531;202682;68848;185954;15996;44632;27944;83225;43940;127857
150085;201802;6191;19915;5718;19325;281;864;5154;17694;5435;18558
150090;201802;10226;38752;9637;37803;748;3196;7642;30225;8390;33421
150095;201802;5473;17289;4922;16520;302;925;4028;13918;4330;14843
150100;201802;3198;11372;2858;10774;235;910;2163;8198;2398;9108
150110;201802;3802;17381;3717;17269;216;1030;3322;15622;3538;16652
150120;201802;7024;24267;6818;23970;339;1016;5939;21511;6278;22527
150125;201802;758;2106;630;1948;114;395;382;1161;496;1556
150130;201802;22882;67882;20406;64347;2644;7596;14584;47685;17228;55281
150140;201802;191537;497557;170264;469282;25878;70004;110184;313631;136062;383635
150145;201802;4688;14173;4105;13386;661;1904;2975;10168;3636;12072
150150;201802;13424;38014;12160;36374;1194;3730;9171;27796;10365;31526
150157;201802;3228;9292;2704;8600;322;1122;1848;6024;2170;7146
150160;201802;3001;9344;2806;9025;670;2146;1551;5131;2221;7277
150170;201802;24492;82251;21523;77536;3738;13057;13280;50849;17018;63906
150172;201802;3725;11396;3089;10442;306;962;2253;7875;2559;8837
150175;201802;1752;5381;1566;5082;150;542;1171;3857;1321;4399
150178;201802;10171;29491;8539;27554;547;1801;6893;22810;7440;24611
150180;201802;20427;77685;19010;75897;1075;4544;16405;66512;17480;71056
150190;201802;7018;23991;6650;23511;245;1034;5932;21019;6177;22053
150195;201802;5557;17682;5257;17215;110;417;4816;15788;4926;16205
150200;201802;5525;16753;5077;16253;73;232;4797;15498;4870;15730
150210;201802;25303;92131;24008;90428;2068;7582;19352;75434;21420;83016
150215;201802;7499;22842;6539;21390;2064;6844;2665;9217;4729;16061
150220;201802;11228;34049;9991;32196;1855;5885;5662;18985;7517;24870
150230;201802;12514;36996;10783;34689;1574;4871;7192;24355;8766;29226
150240;201802;33697;97487;27924;87351;9313;29787;7062;22986;16375;52773
150250;201802;4238;17185;4036;16894;641;2722;2928;12584;3569;15306
150260;201802;2302;8324;2162;8105;255;942;1552;5941;1807;6883
150270;201802;8323;24242;6158;21248;1884;6692;2421;8865;4305;15557
150275;201802;6297;21566;5845;20871;421;1602;4711;16907;5132;18509
150276;201802;2267;6464;1957;6091;290;891;1421;4616;1711;5507
150277;201802;5039;14200;4239;13242;454;1345;3229;10598;3683;11943
150280;201802;6188;26786;6001;26420;565;2451;4811;21554;5376;24005
150285;201802;3165;11636;2858;11178;330;1405;1965;7849;2295;9254
150290;201802;10764;29353;9937;28456;560;1211;8724;25835;9284;27046
150293;201802;10011;25166;7233;21486;1892;5721;2970;9782;4862;15503
150295;201802;7782;21368;6047;19334;1903;6140;2693;9768;4596;15908
150300;201802;2072;6647;1887;6399;64;327;1597;5395;1661;5722
150304;201802;4139;13010;3590;12124;636;2101;2257;7932;2893;10033
150307;201802;6438;21040;6014;20406;375;1225;5035;17295;5410;18520
150309;201802;6063;19681;5167;18195;1299;4411;2483;9415;3782;13826
150310;201802;6768;27436;6408;26967;300;1534;5554;23572;5854;25106
150320;201802;9625;25571;8742;24443;547;1505;6963;19663;7510;21168
150330;201802;14369;47400;13321;45777;1796;6267;9648;34044;11444;40311
150340;201802;2720;8096;2451;7710;291;863;1768;5694;2059;6557
150345;201802;7395;22948;6728;22079;507;1778;5505;18282;6012;20060
150350;201802;8458;24259;7874;23544;835;1996;6377;19777;7212;21773
150360;201802;22989;66894;18954;61885;2491;7663;13074;44619;15565;52282
150370;201802;9657;33352;8573;31869;862;3122;6393;24710;7255;27832
150375;201802;3160;13439;2881;13008;316;1507;2270;10380;2586;11887
150380;201802;9822;27448;8337;25426;414;1291;6988;21601;7402;22892
150390;201802;7849;33213;7222;32126;1193;5092;4819;22454;6012;27546
150400;201802;6062;22978;5782;22447;363;1432;4750;18625;5113;20057
150405;201802;8694;24535;7703;23320;492;1221;6218;19526;6710;20747
150410;201802;1754;6115;1563;5774;243;901;967;3661;1210;4562
150420;201802;35464;110804;28189;99589;9555;35502;7542;30591;17097;66093
150430;201802;7842;24859;7367;24182;770;2327;5731;19389;6501;21716
150440;201802;5627;18635;5310;18187;401;1294;4348;15148;4749;16442
150442;201802;22698;61946;19552;57429;2871;8306;12161;37030;15032;45336
150445;201802;5658;18795;5135;17957;333;1166;4171;14823;4504;15989
150450;201802;4679;21323;4434;20960;377;1924;3677;17565;4054;19489
150460;201802;8068;27099;7397;26253;259;1086;6346;23326;6605;24412
150470;201802;18322;53729;17209;52415;1183;3193;14945;46320;16128;49513
150475;201802;4224;14180;3813;13557;253;932;3072;11164;3325;12096
150480;201802;14094;47646;12683;45446;1889;6725;8920;33151;10809;39876
150490;201802;7785;28276;7363;27732;233;1107;6549;24762;6782;25869
150495;201802;5057;18236;4904;18040;133;546;4532;16763;4665;17309
150497;201802;2547;8903;2215;8310;606;2352;1043;4105;1649;6457
150500;201802;3265;8745;2930;8248;341;885;2245;6390;2586;7275
150503;201802;4023;11803;3117;10511;1006;3441;1253;4581;2259;8022
150506;201802;10416;34578;9265;32948;2063;6841;5710;21906;7773;28747
150510;201802;10116;37876;8914;35553;1358;5227;5750;24240;7108;29467
150520;201802;7002;27116;6881;26961;188;846;6436;25326;6624;26172
150530;201802;12541;42799;11070;40517;1386;4326;8114;31104;9500;35430
150540;201802;4778;13874;4137;12936;197;627;3482;10907;3679;11534
150543;201802;6392;18330;5393;17002;929;2981;3571;11790;4500;14771
150548;201802;9770;30813;8950;29789;318;956;8157;27433;8475;28389
150549;201802;2026;6334;1817;6094;62;244;1623;5444;1685;5688
150550;201802;19603;60785;16844;56172;4796;16180;6738;23843;11534;40023
150553;201802;23029;74728;18594;66336;6506;24244;5009;19446;11515;43690
150555;201802;1753;5039;1425;4519;86;274;1027;3256;1113;3530
150560;201802;1848;5897;1649;5503;307;966;913;3157;1220;4123
150563;201802;2506;8170;2247;7714;484;1795;1192;4099;1676;5894
150565;201802;4029;13568;3650;12950;115;570;3068;10933;3183;11503
150570;201802;6013;21002;5796;20633;385;1473;4711;16786;5096;18259
150580;201802;10214;41852;9314;40835;652;3160;7765;34742;8417;37902
150590;201802;6676;25222;6211;24609;196;988;5674;22497;5870;23485
150600;201802;8511;31144;7963;30422;236;1055;7204;27715;7440;28770
150610;201802;2501;8142;2279;7705;164;629;1781;5942;1945;6571
150611;201802;2845;9111;2632;8759;128;479;2211;7335;2339;7814
150613;201802;12710;36356;9813;31532;2261;7540;4234;14039;6495;21579
150616;201802;3126;9088;2314;7714;592;2158;676;2172;1268;4330
150618;201802;6598;21008;5637;19366;1061;3656;3219;11550;4280;15206
150619;201802;5430;17251;4714;16149;348;1374;3646;12388;3994;13762
150620;201802;6401;22072;5662;21101;783;2904;4089;15614;4872;18518
150630;201802;6227;17358;5807;16867;339;1033;5047;14766;5386;15799
150635;201802;4147;12787;3673;11946;771;2560;1862;6189;2633;8749
150640;201802;2110;6193;1951;6019;38;118;1823;5717;1861;5835
150650;201802;11498;33891;10277;31773;3075;9309;4313;14221;7388;23530
150655;201802;5531;16747;5092;16043;312;962;4212;13370;4524;14332
150658;201802;4465;12973;3753;11994;754;2591;2230;7377;2984;9968
150660;201802;5768;17016;5188;16221;643;1954;3497;11163;4140;13117
150670;201802;7801;19696;6269;17881;638;1700;4875;14421;5513;16121
150680;201802;64842;203785;51219;182192;13356;47621;21666;86369;35022;133990
150690;201802;2270;6372;2022;6022;126;373;1664;5001;1790;5374
150700;201802;6119;18947;5579;18254;583;1824;4175;14117;4758;15941
150710;201802;4234;14013;3770;13283;324;1246;2767;9866;3091;11112
150715;201802;5203;16383;4548;15370;342;1166;3596;12358;3938;13524
150720;201802;6490;24944;6124;24298;501;2171;4875;19593;5376;21764
150730;201802;10830;35324;9685;33540;1115;4011;7243;25611;8358;29622
150740;201802;3703;11194;3244;10402;502;1594;2058;6711;2560;8305
150745;201802;4901;14939;4211;13991;860;3003;2707;9090;3567;12093
150746;201802;1382;4457;1293;4301;104;319;1012;3427;1116;3746
150747;201802;5201;16492;4597;15641;855;2624;2886;10560;3741;13184
150750;201802;3571;11408;3119;10756;206;808;2453;8589;2659;9397
150760;201802;11726;35651;10746;34438;1309;4034;7945;26160;9254;30194
150770;201802;6180;22770;5921;22402;151;479;5395;21219;5546;21698
150775;201802;988;2917;813;2635;150;559;450;1433;600;1992
150780;201802;4044;12609;3808;12339;87;329;3531;11519;3618;11848
150790;201802;5245;16203;4652;15535;263;766;3809;13759;4072;14525
150795;201802;14174;46005;12826;43806;3053;10006;7225;26161;10278;36167
150796;201802;3388;9321;2956;8811;227;694;2374;7216;2601;7910
150797;201802;3919;12721;3431;11940;127;418;2873;10107;3000;10525
150800;201802;13479;43138;12368;41788;2106;6506;8691;31074;10797;37580
150803;201802;6743;23453;6284;22732;557;2107;4983;18183;5540;20290
150805;201802;2963;9997;2638;9458;296;1036;1988;7262;2284;8298
150808;201802;5866;18186;4507;15737;1674;6420;502;1910;2176;8330
150810;201802;19668;56804;15582;51717;2885;9383;9046;32354;11931;41737
150812;201802;5362;15959;4812;14995;525;1798;3506;10706;4031;12504
150815;201802;8626;27746;7551;26399;791;2743;5808;20806;6599;23549
150820;201802;11482;32608;10028;30898;980;2717;7737;24724;8717;27441
150830;201802;12252;46125;11581;45286;481;2496;9822;39292;10303;41788
150835;201802;2209;7701;2044;7399;466;1709;1047;3908;1513;5617
150840;201802;7415;21969;5906;19348;1303;4522;2628;8716;3931;13238
160005;201802;1055;3108;975;2971;28;122;895;2690;923;2812
160010;201802;1759;5296;1730;5266;14;44;1693;5160;1707;5204
160015;201802;2085;7147;1937;6948;110;367;1736;6325;1846;6692
160020;201802;1940;6887;1753;6611;252;994;1277;4866;1529;5860
160021;201802;1109;4468;1038;4364;91;497;829;3445;920;3942
160023;201802;1182;4486;1090;4344;90;316;848;3539;938;3855
160025;201802;1612;4698;1580;4663;30;80;1525;4521;1555;4601
160027;201802;8612;24193;7854;23352;741;1983;6353;19605;7094;21588
160030;201802;55866;176340;47292;164168;11381;38243;23973;91384;35354;129627
160040;201802;5071;18045;4616;17427;122;678;4249;15924;4371;16602
160050;201802;3767;12917;3214;12121;1498;5372;1024;4643;2522;10015
160053;201802;3250;11352;3073;11122;550;1880;2158;8084;2708;9964
160055;201802;599;2295;592;2286;24;112;548;2101;572;2213
160060;201802;20042;59533;17339;56489;1400;4519;14136;46844;15536;51363
160070;201802;2994;11380;2741;10965;193;863;2195;8921;2388;9784
160080;201802;2767;9873;2623;9698;80;375;2393;8867;2473;9242
170025;201802;611;1759;483;1583;130;418;220;745;350;1163
170030;201802;1155;3720;941;3299;169;634;470;1692;639;2326
170035;201802;1436;3889;1108;3358;112;364;639;1959;751;2323
170040;201802;1813;5481;1511;5082;141;538;834;2977;975;3515
170070;201802;1675;4208;1210;3604;167;520;690;2101;857;2621
170100;201802;2384;6941;2003;6336;192;619;1411;4524;1603;5143
170105;201802;731;2260;531;1824;140;470;191;670;331;1140
170110;201802;890;2866;715;2532;138;530;333;1196;471;1726
170130;201802;1358;4204;1027;3571;205;743;487;1759;692;2502
170190;201802;1490;4321;1053;3622;348;1131;236;1045;584;2176
170200;201802;1629;4289;998;3128;273;931;194;564;467;1495
170210;201802;28485;79418;22015;68910;7446;25485;2995;10244;10441;35729
170215;201802;1288;3730;1072;3420;79;314;788;2494;867;2808
170220;201802;5731;18608;5011;17245;1282;4337;2418;8809;3700;13146
170230;201802;1268;3990;993;3425;247;865;301;1078;548;1943
170240;201802;2709;7898;2134;6963;195;797;1429;4578;1624;5375
170255;201802;3874;11760;2750;9565;684;2470;1093;3908;1777;6378
170270;201802;1045;2542;683;2046;28;82;460;1360;488;1442
170290;201802;2965;8481;2545;7999;179;436;2084;6898;2263;7334
170300;201802;1921;5594;1561;5026;194;625;985;3253;1179;3878
170305;201802;751;2196;581;1857;80;297;282;879;362;1176
170307;201802;987;3463;806;3094;159;610;399;1595;558;2205
170310;201802;1477;4072;1105;3444;218;746;529;1623;747;2369
170320;201802;1050;2907;781;2476;123;401;407;1333;530;1734
170330;201802;831;2666;749;2539;47;199;573;1904;620;2103
170360;201802;460;1372;356;1195;56;216;208;663;264;879
170370;201802;1317;3642;996;3106;160;510;489;1545;649;2055
170380;201802;1807;5587;1388;4907;163;666;783;2821;946;3487
170382;201802;578;1770;475;1589;77;272;282;938;359;1210
170384;201802;1533;5913;1319;5493;364;1603;533;2229;897;3832
170386;201802;783;2216;496;1641;92;344;108;324;200;668
170388;201802;588;1750;426;1459;63;237;195;663;258;900
170389;201802;1193;4264;1041;3997;52;223;835;3260;887;3483
170390;201802;1483;3818;1126;3366;83;265;879;2677;962;2942
170410;201802;539;1678;412;1457;25;105;265;934;290;1039
170460;201802;407;1123;310;959;38;136;179;548;217;684
170510;201802;826;2624;625;2221;82;339;319;1109;401;1448
170550;201802;6624;18272;4705;14984;1406;4913;745;2462;2151;7375
170555;201802;1345;3805;1062;3362;99;339;566;1847;665;2186
170560;201802;1129;3320;855;2946;121;469;449;1722;570;2191
170600;201802;1374;3891;1129;3538;282;799;610;2040;892;2839
170610;201802;1691;4848;1281;4147;105;408;829;2634;934;3042
170625;201802;417;1171;265;839;39;126;87;256;126;382
170650;201802;1278;3891;973;3346;222;783;376;1394;598;2177
170700;201802;3592;10856;2806;9464;606;2222;1163;4030;1769;6252
170710;201802;1643;4665;1288;4026;269;909;593;1779;862;2688
170720;201802;1876;4868;1572;4435;74;160;1346;3909;1420;4069
170730;201802;975;2883;755;2517;184;633;336;1156;520;1789
170740;201802;2090;7369;1779;6775;232;913;1142;4397;1374;5310
170755;201802;851;2553;623;2100;77;298;298;998;375;1296
170765;201802;1240;3326;862;2735;216;704;339;1155;555;1859
170770;201802;1720;5520;1505;5146;219;750;970;3360;1189;4110
170820;201802;3956;13731;3475;12842;510;1837;2037;8006;2547;9843
170825;201802;992;2405;800;2145;62;145;566;1558;628;1703
170830;201802;1382;3913;1131;3514;39;114;927;2920;966;3034
170900;201802;2512;8662;2283;8294;189;754;1824;6658;2013;7412
170930;201802;3676;10571;3002;9416;694;2349;1322;4233;2016;6582
170950;201802;12635;35733;8938;29236;2567;9504;1271;4316;3838;13820
170980;201802;491;1360;371;1172;36;141;221;659;257;800
171050;201802;1563;5089;1394;4783;73;348;1084;3662;1157;4010
171070;201802;1407;4221;1218;3942;284;822;697;2494;981;3316
171090;201802;1098;2768;898;2494;67;168;649;1799;716;1967
171110;201802;578;1668;424;1393;109;397;169;490;278;887
171150;201802;1058;2792;656;2074;72;257;406;1280;478;1537
171180;201802;724;2116;481;1615;90;319;198;688;288;1007
171190;201802;1579;5757;1402;5430;248;964;776;3145;1024;4109
171195;201802;853;2889;711;2620;133;538;409;1537;542;2075
171200;201802;583;1736;443;1485;109;397;160;516;269;913
171215;201802;440;1266;333;1064;69;245;149;459;218;704
171240;201802;738;2611;628;2376;57;282;396;1499;453;1781
171245;201802;609;1965;482;1691;85;326;225;761;310;1087
171250;201802;993;2794;757;2406;195;631;352;1137;547;1768
171270;201802;401;1552;346;1420;94;368;151;691;245;1059
171280;201802;867;2690;683;2361;149;495;303;1157;452;1652
171320;201802;3992;11533;3152;10052;652;2085;1378;4644;2030;6729
171330;201802;2745;7794;2130;6736;484;1570;1024;3337;1508;4907
171360;201802;1449;4482;1239;4188;102;390;959;3254;1061;3644
171370;201802;691;1845;546;1646;57;183;376;1149;433;1332
171380;201802;1352;4051;1090;3618;195;709;574;1917;769;2626
171395;201802;932;2737;665;2207;99;388;325;1051;424;1439
171420;201802;1808;5640;1355;4709;231;897;605;2099;836;2996
171430;201802;1053;3139;859;2786;102;363;566;1774;668;2137
171488;201802;2455;7438;1999;6702;362;1235;1084;3780;1446;5015
171500;201802;906;2495;708;2183;64;200;496;1547;560;1747
171510;201802;803;2804;719;2655;55;247;492;1840;547;2087
171515;201802;476;1332;350;1113;26;85;211;669;237;754
171525;201802;604;1891;503;1710;38;176;319;1019;357;1195
171550;201802;334;1042;238;878;43;182;114;419;157;601
171570;201802;1243;3792;1057;3450;212;662;619;2112;831;2774
171575;201802;1882;5107;1238;3927;199;676;536;1674;735;2350
171610;201802;5595;16470;4280;14198;1056;3849;1149;4012;2205;7861
171620;201802;2853;7969;2373;7314;139;495;1913;5955;2052;6450
171630;201802;951;2763;785;2524;163;568;461;1508;624;2076
171650;201802;2076;6215;1541;5198;381;1302;505;1799;886;3101
171660;201802;2349;6258;1646;4995;275;832;861;2607;1136;3439
171665;201802;1366;3935;1040;3421;199;712;483;1632;682;2344
171670;201802;1888;5137;1459;4450;248;853;758;2271;1006;3124
171700;201802;1166;3526;888;3030;136;462;472;1641;608;2103
171720;201802;795;2208;640;1938;76;251;442;1325;518;1576
171750;201802;1220;3610;882;2977;243;836;190;718;433;1554
171780;201802;1302;3400;935;2871;82;272;616;1874;698;2146
171790;201802;1459;5064;1178;4447;284;1086;511;2019;795;3105
171800;201802;723;2113;567;1867;70;255;339;1121;409;1376
171820;201802;10359;30468;8106;26598;1953;6854;2925;10038;4878;16892
171830;201802;1459;5129;1254;4713;222;890;688;2611;910;3501
171840;201802;695;1897;560;1692;31;101;421;1253;452;1354
171845;201802;642;1760;508;1559;76;285;281;874;357;1159
171850;201802;861;3064;738;2805;71;315;500;1878;571;2193
171855;201802;1102;3442;970;3210;87;299;635;2074;722;2373
171865;201802;401;1351;344;1254;64;253;167;595;231;848
171870;201802;760;2203;562;1824;90;317;279;962;369;1279
171875;201802;1219;3744;975;3341;64;266;723;2454;787;2720
171880;201802;1017;3387;924;3273;64;205;750;2756;814;2961
171884;201802;948;2525;684;2135;134;478;212;743;346;1221
171886;201802;1387;4125;1011;3432;293;1064;186;660;479;1724
171888;201802;760;2219;526;1763;45;160;331;1103;376;1263
171889;201802;479;1480;411;1346;74;274;182;608;256;882
171890;201802;1157;3291;894;2879;159;519;524;1712;683;2231
171900;201802;499;1792;383;1514;95;380;139;580;234;960
172000;201802;593;1859;487;1650;68;263;257;843;325;1106
172010;201802;1058;3729;943;3492;91;431;606;2169;697;2600
172015;201802;329;1267;267;1137;53;218;124;538;177;756
172020;201802;2295;7464;2120;7192;186;740;1582;5363;1768;6103
172025;201802;740;2118;536;1786;64;259;307;1025;371;1284
172030;201802;1218;3675;1056;3409;27;105;863;2786;890;2891
172049;201802;1376;3385;901;2658;309;957;407;1210;716;2167
172065;201802;1419;3663;1132;3321;67;166;1008;3013;1075;3179
172080;201802;2401;7343;1968;6539;142;519;1348;4491;1490;5010
172085;201802;475;1346;316;1019;58;164;105;330;163;494
172090;201802;4067;10742;3207;9533;122;436;2597;7713;2719;8149
172093;201802;510;1546;383;1306;67;275;189;613;256;888
172097;201802;648;1788;474;1510;82;287;195;622;277;909
172100;201802;40840;108612;28566;88330;6812;23155;7962;25649;14774;48804
172110;201802;1573;5981;1374;5660;146;627;1024;4368;1170;4995
172120;201802;4928;15227;3913;13579;693;2436;2046;7349;2739;9785
172125;201802;287;867;215;743;27;102;115;403;142;505
172130;201802;720;2145;582;1921;26;95;423;1421;449;1516
172208;201802;2341;6287;1890;5631;280;803;1134;3445;1414;4248
172210;201802;2641;7461;2099;6700;459;1529;1132;3619;1591;5148
210005;201802;20334;61499;16628;55681;4929;17177;6456;22708;11385;39885
210010;201802;1691;5725;1549;5477;51;218;1342;4770;1393;4988
210015;201802;3346;10326;2982;9797;161;421;2515;8487;2676;8908
210020;201802;7450;17090;6677;16225;111;294;6200;15034;6311;15328
210030;201802;5019;16740;4728;16344;258;1230;4042;13834;4300;15064
210040;201802;2126;6157;1926;5929;32;65;1787;5603;1819;5668
210043;201802;6953;18590;5708;17158;751;2118;4017;12818;4768;14936
210047;201802;6497;22425;5859;21525;310;1442;4968;18189;5278;19631
210050;201802;2254;8027;1823;7205;293;1242;1079;4366;1372;5608
210055;201802;1782;6006;1627;5757;67;278;1321;4672;1388;4950
210060;201802;6854;26623;6272;25487;879;3621;4293;17922;5172;21543
210070;201802;7428;21221;6923;20619;55;154;6564;19745;6619;19899
210080;201802;3735;13157;3656;13061;17;76;3560;12763;3577;12839
210083;201802;4888;15867;4299;15230;86;425;4036;14294;4122;14719
210087;201802;2890;8370;2607;7991;181;523;2149;6741;2330;7264
210090;201802;9965;30918;9457;30108;327;1193;8505;27013;8832;28206
210095;201802;6147;21088;5748;20584;301;1226;4972;17955;5273;19181
210100;201802;7023;21034;6461;20264;229;879;5517;17289;5746;18168
210110;201802;2753;9127;2606;8932;50;215;2422;8305;2472;8520
210120;201802;25147;68687;21218;63923;2723;7082;14436;46435;17159;53517
210125;201802;3881;11573;3609;11240;616;1498;2730;9033;3346;10531
210130;201802;4312;12049;3751;11334;207;598;3107;9436;3314;10034
210135;201802;1528;4649;1352;4382;64;244;1109;3598;1173;3842
210140;201802;17257;51666;14157;47439;3062;10420;7649;26582;10711;37002
210150;201802;4656;11489;4128;10806;68;257;3725;9603;3793;9860
210160;201802;16883;51991;15504;49985;1442;4504;11686;38799;13128;43303
210170;201802;14148;47705;13508;46887;641;2337;12091;42205;12732;44542
210173;201802;2456;9357;2327;9153;47;285;2158;8485;2205;8770
210177;201802;3065;9203;2880;8983;61;146;2732;8620;2793;8766
210180;201802;1488;4239;1363;4073;33;116;1214;3611;1247;3727
210190;201802;4844;14919;4413;14130;125;620;3577;11211;3702;11831
210193;201802;1236;3880;1124;3710;50;189;918;3041;968;3230
210197;201802;2009;6681;1845;6475;213;681;1403;5116;1616;5797
210200;201802;7766;25821;7178;24971;727;2545;5666;20103;6393;22648
210203;201802;7029;21572;6507;20875;445;1345;5584;18245;6029;19590
210207;201802;3438;10438;3103;9967;175;481;2506;8287;2681;8768
210210;201802;8285;27596;7863;27015;100;528;7236;25047;7336;25575
210215;201802;1953;6706;1786;6470;64;310;1569;5681;1633;5991
210220;201802;5829;21431;5523;20902;266;1352;4707;17648;4973;19000
210230;201802;5135;16188;4730;15598;237;688;4163;13911;4400;14599
210232;201802;12479;39176;10240;36185;1517;5499;6509;24886;8026;30385
210235;201802;3663;11080;3226;10536;123;519;2817;9233;2940;9752
210237;201802;2395;8775;2242;8585;25;129;2139;8221;2164;8350
210240;201802;2786;8792;2581;8463;109;419;2211;7217;2320;7636
210250;201802;5466;17095;5026;16552;113;588;4489;14708;4602;15296
210255;201802;2678;8323;2350;7740;307;1059;1601;5256;1908;6315
210260;201802;5250;16562;4744;15790;320;1121;3891;13023;4211;14144
210270;201802;4998;14321;4514;13673;104;504;4001;12004;4105;12508
210275;201802;3655;9258;3381;8945;68;125;3196;8577;3264;8702
210280;201802;5565;16585;4636;15204;253;1216;3400;10907;3653;12123
210290;201802;6300;19152;5823;18567;150;540;5212;16683;5362;17223
210300;201802;36027;98087;29731;90205;2005;6240;22227;70405;24232;76645
210310;201802;2991;7986;2719;7627;64;138;2435;6882;2499;7020
210312;201802;2473;7129;2235;6845;58;260;2013;6146;2071;6406
210315;201802;2837;8419;2445;7943;73;204;2150;7191;2223;7395
210317;201802;4081;12921;3810;12609;143;561;3465;11487;3608;12048
210320;201802;19212;61861;17954;60222;598;2608;16090;53994;16688;56602
210325;201802;3551;10631;3149;10047;106;391;2759;8885;2865;9276
210330;201802;29840;81086;24628;74739;5873;16867;12798;44474;18671;61341
210340;201802;10884;32863;9838;31363;1065;3180;7086;23744;8151;26924
210350;201802;9697;28763;8622;27335;304;1066;7310;23363;7614;24429
210355;201802;3965;14180;3541;13514;137;742;2961;11389;3098;12131
210360;201802;15065;44655;13586;42581;716;2711;11164;34798;11880;37509
210370;201802;10048;23412;8106;21343;303;632;7163;19421;7466;20053
210375;201802;3092;8984;2457;8121;661;2193;1166;4109;1827;6302
210380;201802;5657;15258;5076;14532;309;799;4330;12617;4639;13416
210390;201802;2785;10069;2572;9710;137;653;2134;8028;2271;8681
210400;201802;4765;14889;4401;14450;114;315;4072;13533;4186;13848
210405;201802;7464;20657;6015;18573;1253;3782;3184;10421;4437;14203
210407;201802;1964;6852;1660;6271;152;661;1252;4665;1404;5326
210408;201802;2368;9239;2241;9066;153;776;1832;7501;1985;8277
210409;201802;3685;13069;3391;12656;120;676;2909;10833;3029;11509
210410;201802;3596;11347;3222;10785;251;809;2520;8635;2771;9444
210420;201802;4056;13209;3700;12575;181;609;3108;10651;3289;11260
210430;201802;2223;6614;2100;6471;126;341;1823;5694;1949;6035
210440;201802;4141;11908;3917;11628;74;226;3709;11044;3783;11270
210450;201802;2587;8154;2314;7726;125;455;1854;6169;1979;6624
210455;201802;3844;10673;3267;9980;704;2068;2102;6685;2806;8753
210460;201802;3396;10738;3081;10284;126;529;2603;8668;2729;9197
210462;201802;1427;4925;1282;4656;59;286;1022;3675;1081;3961
210465;201802;2629;8125;2352;7736;98;296;2049;6854;2147;7150
210467;201802;6041;19911;5560;19348;319;1201;4836;17026;5155;18227
210470;201802;2120;5593;1476;4655;82;204;1110;3603;1192;3807
210480;201802;15342;47486;13151;44706;1715;5591;9234;33482;10949;39073
210490;201802;3745;9895;3123;9017;82;275;2717;7840;2799;8115
210500;201802;6137;25202;5814;24587;449;2233;4617;19460;5066;21693
210510;201802;6329;21343;5867;20796;267;784;5119;18707;5386;19491
210515;201802;3639;11014;3302;10659;123;350;2990;9857;3113;10207
210520;201802;2618;7690;2333;7319;108;387;2043;6432;2151;6819
210530;201802;49603;132789;41226;120135;7012;25639;12078;42466;19090;68105
210535;201802;3196;10921;3047;10721;87;315;2714;9633;2801;9948
210540;201802;14100;44196;12225;41722;1627;5475;8415;30037;10042;35512
210542;201802;5879;15518;5074;14638;241;513;4569;13524;4810;14037
210545;201802;2316;7283;2172;7063;45;209;1934;6217;1979;6426
210547;201802;3669;13142;3348;12554;377;1339;2389;9290;2766;10629
210550;201802;5947;17931;5191;17026;325;1040;4395;14692;4720;15732
210560;201802;3799;11745;3388;11069;116;443;2901;9400;3017;9843
210565;201802;1444;5095;1229;4756;41;208;1006;3976;1047;4184
210570;201802;11561;31843;10508;30623;388;939;9512;28162;9900;29101
210580;201802;3020;8479;2682;8065;282;516;2106;6762;2388;7278
210590;201802;4088;12730;3668;12187;151;717;3192;10517;3343;11234
210592;201802;2526;7754;2376;7513;31;172;2096;6555;2127;6727
210594;201802;2745;7581;2158;6663;98;264;1591;5094;1689;5358
210596;201802;2455;9081;2292;8746;177;766;1774;6811;1951;7577
210598;201802;1849;5462;1713;5283;52;192;1566;4836;1618;5028
210600;201802;2989;8463;2559;7886;88;280;2089;6472;2177;6752
210610;201802;2482;7762;2244;7461;88;412;1987;6511;2075;6923
210620;201802;2248;6945;1990;6627;50;135;1819;6195;1869;6330
210630;201802;3155;11027;2864;10602;186;891;2297;8378;2483;9269
210632;201802;4370;14724;3970;14131;381;1529;3054;10860;3435;12389
210635;201802;1876;6570;1757;6364;144;450;1449;5426;1593;5876
210637;201802;2497;8557;2268;8211;146;653;1761;6410;1907;7063
210640;201802;4857;18946;4776;18862;33;134;4684;18563;4717;18697
210650;201802;7096;20771;6749;20318;83;278;6455;19430;6538;19708
210660;201802;8624;25178;7743;23885;317;1162;6674;20415;6991;21577
210663;201802;2659;8108;2520;7942;118;361;2171;7021;2289;7382
210667;201802;1903;6303;1777;6104;70;283;1576;5463;1646;5746
210670;201802;4490;15942;4227;15522;183;843;3655;13410;3838;14253
210675;201802;5125;14090;4564;13361;330;809;3791;11466;4121;12275
210680;201802;4077;10665;3466;9928;143;319;3027;8850;3170;9169
210690;201802;7578;24988;6995;24368;273;1072;6157;21923;6430;22995
210700;201802;2732;7686;2341;7206;173;410;1849;6205;2022;6615
210710;201802;4877;15765;4463;15170;160;732;3873;13116;4033;13848
210720;201802;2738;9372;2568;9152;62;325;2345;8300;2407;8625
210725;201802;1207;4375;1083;4157;30;120;825;3297;855;3417
210730;201802;1221;3421;1044;3180;78;236;822;2531;900;2767
210735;201802;4504;14165;3968;13361;328;1183;3246;11048;3574;12231
210740;201802;5277;14805;4768;14285;148;634;4259;12605;4407;13239
210745;201802;4457;12412;4169;12061;188;431;3717;10903;3905;11334
210750;201802;19930;52770;17382;49835;1695;4835;13068;38382;14763;43217
210760;201802;5608;16251;5163;15778;28;90;5001;15350;5029;15440
210770;201802;5894;15982;5069;15038;61;265;4655;13830;4716;14095
210780;201802;7322;24407;6651;23265;690;2289;4963;17834;5653;20123
210790;201802;4760;14903;4398;14459;168;416;3559;12464;3727;12880
210800;201802;4933;13503;4311;12728;81;298;3899;11481;3980;11779
210805;201802;3887;15031;3748;14821;132;703;3294;13033;3426;13736
210810;201802;5130;15388;4717;14859;263;533;4129;13453;4392;13986
210820;201802;7288;21106;6338;19607;767;2360;4199;13215;4966;15575
210825;201802;6277;20275;5893;19789;302;977;5122;17523;5424;18500
210830;201802;8249;23508;7745;22895;543;1224;6610;20237;7153;21461
210840;201802;3412;9242;3093;8801;93;292;2670;7549;2763;7841
210845;201802;5961;17178;5718;16921;40;84;5626;16734;5666;16818
210850;201802;5874;20466;5258;19487;420;1861;3979;14715;4399;16576
210860;201802;18091;51663;15648;48392;976;2905;12601;39805;13577;42710
210870;201802;6190;19135;5419;18210;387;1226;4509;15454;4896;16680
210880;201802;4351;13857;4043;13490;254;987;3380;11258;3634;12245
210890;201802;4604;13849;4195;13361;286;720;3514;11717;3800;12437
210900;201802;4891;14393;3776;12431;1408;4948;756;2783;2164;7731
210905;201802;1901;5590;1640;5232;71;164;1418;4644;1489;4808
210910;201802;7665;24181;6689;22540;886;3100;4427;14995;5313;18095
210920;201802;3019;10474;2689;10019;98;525;2332;8652;2430;9177
210923;201802;1420;4687;1292;4479;98;382;954;3336;1052;3718
210927;201802;4999;15949;4533;15455;114;415;4173;14386;4287;14801
210930;201802;2477;8723;2283;8423;126;630;1837;6670;1963;7300
210940;201802;3413;11257;3233;11000;138;645;2815;9414;2953;10059
210945;201802;5931;18071;5630;17713;272;728;5005;15955;5277;16683
210950;201802;5206;15465;4131;13854;534;1626;2824;9891;3358;11517
210955;201802;1755;5564;1545;5238;148;485;1098;3831;1246;4316
210960;201802;8969;28048;8104;26818;1651;5060;4946;17603;6597;22663
210970;201802;1322;4400;1126;4060;94;431;828;2875;922;3306
210975;201802;1714;5674;1602;5466;138;503;1189;4053;1327;4556
210980;201802;10737;24114;9648;23004;228;447;9116;21960;9344;22407
210990;201802;16994;49750;13734;45440;1944;6623;8677;29649;10621;36272
211000;201802;14728;45520;12934;43494;680;2754;10738;36848;11418;39602
211003;201802;5055;17159;4451;16415;178;831;3728;14012;3906;14843
211010;201802;6423;23773;5978;23169;79;473;5524;21564;5603;22037
211020;201802;7979;25231;7530;24633;408;1540;6418;21019;6826;22559
211023;201802;2092;6986;1985;6829;112;426;1653;5660;1765;6086
211027;201802;2686;9711;2627;9610;219;878;2205;8059;2424;8937
211030;201802;3840;11178;3494;10788;297;656;2915;9387;3212;10043
211040;201802;4498;16579;4298;16282;159;863;3761;14217;3920;15080
211050;201802;9947;25304;9202;24407;210;550;8564;22728;8774;23278
211060;201802;5961;20392;5632;19891;257;1040;4992;17654;5249;18694
211065;201802;2058;6190;1803;5831;59;172;1607;5275;1666;5447
211070;201802;7793;26194;6987;24889;478;1754;5549;20027;6027;21781
211080;201802;1317;3784;1097;3448;49;265;854;2517;903;2782
211085;201802;2002;6332;1810;6051;128;408;1497;5071;1625;5479
211090;201802;3337;9415;3041;9025;65;310;2701;7910;2766;8220
211100;201802;6531;17207;6255;16842;49;167;5888;15827;5937;15994
211102;201802;2910;10810;2710;10532;163;734;2338;9121;2501;9855
211105;201802;2444;7939;2038;7230;240;881;1377;4890;1617;5771
211107;201802;4531;14284;3991;13540;203;704;3231;11328;3434;12032
211110;201802;6201;17614;4799;15535;634;1892;3260;11012;3894;12904
211120;201802;35645;99302;32533;95641;4481;12221;23850;72623;28331;84844
211125;201802;2035;6292;1755;5843;85;328;1476;4931;1561;5259
211130;201802;179371;464053;167387;449060;24395;67148;78390;234749;102785;301897
211140;201802;5036;15885;4602;15260;230;784;3881;12901;4111;13685
211150;201802;9609;27241;8497;25876;300;1110;7289;22256;7589;23366
211153;201802;2610;8029;2248;7576;436;1534;1463;5143;1899;6677
211157;201802;1097;3555;933;3296;52;282;645;2291;697;2573
211160;201802;4010;12603;3321;11461;218;1006;2380;7974;2598;8980
211163;201802;1707;5692;1608;5552;22;54;1514;5313;1536;5367
211167;201802;1516;4928;1430;4790;31;146;1343;4476;1374;4622
211170;201802;6019;15622;5726;15274;71;240;5445;14466;5516;14706
211172;201802;2440;6992;2170;6563;79;288;1817;5354;1896;5642
211174;201802;2743;8298;2534;8023;72;351;2276;7146;2348;7497
211176;201802;4107;12683;3440;11747;288;1148;2592;8861;2880;10009
211178;201802;4505;10775;4027;10247;35;134;3802;9574;3837;9708
211180;201802;4113;14079;3852;13692;270;1021;3238;11621;3508;12642
211190;201802;3033;9369;2669;8818;58;290;2300;7529;2358;7819
211195;201802;1447;4206;1215;3901;87;226;986;3293;1073;3519
211200;201802;2027;6363;1730;5964;192;690;1157;4107;1349;4797
211210;201802;6634;20341;6172;19706;306;1083;5333;17086;5639;18169
211220;201802;34168;94179;29501;88320;3811;11480;20441;63127;24252;74607
211223;201802;4931;14744;4437;13975;483;1416;3267;10535;3750;11951
211227;201802;1650;5859;1531;5676;50;257;1323;4919;1373;5176
211230;201802;7479;23648;6755;22462;603;2052;5194;17367;5797;19419
211240;201802;8056;26981;7662;26480;209;1101;6960;23736;7169;24837
211245;201802;5936;16727;5713;16502;48;91;5628;16318;5676;16409
211250;201802;13957;41337;12925;40108;653;2154;11213;34928;11866;37082
211260;201802;8045;25467;7487;24726;261;1018;6752;22373;7013;23391
211270;201802;10181;33835;8966;32289;421;2007;7322;26663;7743;28670
211280;201802;13425;38589;12086;36898;800;1999;9925;31353;10725;33352
211285;201802;1718;6157;1505;5772;269;1095;713;2842;982;3937
211290;201802;7054;22696;6639;22114;253;958;5726;19116;5979;20074
211300;201802;8269;23992;7585;23106;75;198;7166;21991;7241;22189
211400;201802;11508;35026;9683;32338;1829;6175;5521;19904;7350;26079
220005;201802;1840;5112;1645;4816;41;177;1347;3828;1388;4005
220010;201802;1464;4238;1256;3885;27;123;1002;3036;1029;3159
220020;201802;3235;10007;2965;9533;391;1313;2083;6658;2474;7971
220025;201802;2274;5401;1982;4979;35;102;1633;4003;1668;4105
220027;201802;1279;3410;1112;3184;37;121;896;2547;933;2668
220030;201802;3307;8977;3155;8741;119;344;2723;7450;2842;7794
220040;201802;7159;21883;6491;20667;1226;3828;4045;13082;5271;16910
220045;201802;1389;4489;1223;4168;44;222;956;3188;1000;3410
220050;201802;4494;13125;3821;12094;156;654;3214;10067;3370;10721
220060;201802;2216;5169;1873;4772;34;76;1710;4357;1744;4433
220070;201802;2472;6753;2173;6292;90;245;1756;5057;1846;5302
220080;201802;662;1975;604;1885;27;108;506;1518;533;1626
220090;201802;1758;4366;1449;3935;23;79;1269;3426;1292;3505
220095;201802;685;1802;641;1743;7;19;597;1615;604;1634
220100;201802;1340;3878;1093;3433;52;204;865;2658;917;2862
220105;201802;2106;6618;1842;6086;139;465;1352;4500;1491;4965
220110;201802;3420;9655;3192;9262;63;266;2795;7979;2858;8245
220115;201802;2649;8373;2487;8113;98;414;2196;7042;2294;7456
220117;201802;1335;3382;1043;2945;19;66;885;2470;904;2536
220120;201802;11617;33980;10689;32844;131;555;10024;30775;10155;31330
220130;201802;985;2968;850;2767;17;113;755;2414;772;2527
220140;201802;1703;4289;1448;3972;139;339;1200;3331;1339;3670
220150;201802;6718;20141;6273;19511;152;762;5439;16610;5591;17372
220155;201802;1094;3256;862;2825;25;94;602;1949;627;2043
220157;201802;1064;2690;897;2411;19;75;730;1905;749;1980
220160;201802;2632;7776;2289;7137;55;282;1871;5710;1926;5992
220170;201802;1375;3916;1164;3589;25;128;1000;3011;1025;3139
220173;201802;2019;5901;1627;5160;45;214;1307;4013;1352;4227
220177;201802;1827;5437;1778;5374;13;46;1724;5219;1737;5265
220180;201802;1167;2994;911;2522;12;46;664;1741;676;1787
220190;201802;5397;15757;4766;14901;421;1388;3638;11439;4059;12827
220191;201802;1398;4567;1305;4400;91;374;939;3083;1030;3457
220192;201802;1850;5132;1468;4455;35;134;1154;3440;1189;3574
220194;201802;1739;5121;1540;4797;73;295;1262;3843;1335;4138
220196;201802;2020;5629;1835;5315;62;249;1543;4371;1605;4620
220198;201802;1263;3656;1012;3317;8;27;957;3178;965;3205
220200;201802;4598;14582;4190;14050;293;1063;3405;11441;3698;12504
220202;201802;2169;6254;1865;5716;30;146;1579;4742;1609;4888
220205;201802;2641;7243;2325;6767;42;174;2012;5749;2054;5923
220207;201802;844;2556;715;2327;59;227;482;1548;541;1775
220208;201802;1747;5504;1428;4866;314;1186;631;2146;945;3332
220209;201802;1611;4712;1385;4321;32;141;1118;3466;1150;3607
220210;201802;1614;4296;1388;3911;31;133;1121;3044;1152;3177
220211;201802;1505;4157;1419;4036;19;79;1258;3583;1277;3662
220213;201802;1698;4708;1512;4344;29;116;1241;3480;1270;3596
220217;201802;1959;6189;1863;6070;38;155;1740;5704;1778;5859
220220;201802;10445;28087;8874;25652;565;1484;6510;19240;7075;20724
220225;201802;1188;3211;966;2915;21;76;816;2436;837;2512
220230;201802;5664;14518;4958;13570;184;505;4278;11726;4462;12231
220240;201802;2908;8753;2667;8304;90;336;2202;6836;2292;7172
220245;201802;1566;4006;1257;3603;13;48;1111;3251;1124;3299
220250;201802;2704;8186;2430;7801;54;233;2117;6794;2171;7027
220253;201802;1668;4704;1397;4224;129;372;1078;3231;1207;3603
220255;201802;1835;4718;1556;4283;25;144;1296;3402;1321;3546
220260;201802;4328;13744;3798;12806;203;753;2944;9939;3147;10692
220265;201802;1260;4273;1148;4095;70;292;862;3054;932;3346
220270;201802;6686;21366;6307;20691;386;1597;5130;16367;5516;17964
220271;201802;1533;4050;1318;3725;47;150;1118;3158;1165;3308
220272;201802;1708;5027;1519;4685;34;122;1188;3602;1222;3724
220273;201802;1204;3472;1027;3140;37;130;795;2417;832;2547
220275;201802;2201;5442;1709;4796;41;151;1472;4104;1513;4255
220277;201802;2140;5744;1850;5287;36;127;1529;4289;1565;4416
220280;201802;1547;4041;1313;3664;51;171;1073;2895;1124;3066
220285;201802;1521;4001;1280;3689;20;87;1161;3316;1181;3403
220290;201802;5844;18540;4870;17142;434;1730;3480;12253;3914;13983
220300;201802;1868;5922;1594;5515;53;309;1306;4412;1359;4721
220310;201802;2661;8087;2243;7602;53;276;1925;6448;1978;6724
220320;201802;2878;8660;2355;7661;152;583;1765;5654;1917;6237
220323;201802;1585;5178;1289;4706;95;391;1009;3669;1104;4060
220325;201802;1201;3705;1015;3353;43;184;805;2636;848;2820
220327;201802;1370;4201;1224;3949;44;220;1019;3190;1063;3410
220330;201802;3792;10155;3276;9455;165;497;2676;7679;2841;8176
220335;201802;1800;5427;1593;5187;18;62;1476;4821;1494;4883
220340;201802;1825;4931;1484;4367;56;206;1066;3038;1122;3244
220342;201802;1149;3577;1048;3424;35;139;852;2787;887;2926
220345;201802;3002;7144;2452;6379;16;37;2318;6027;2334;6064
220350;201802;3526;9321;2897;8306;148;485;2176;6145;2324;6630
220360;201802;1232;3215;1008;2874;30;95;796;2239;826;2334
220370;201802;9189;26074;8278;24819;231;895;7310;21745;7541;22640
220375;201802;1416;4418;1320;4294;9;30;1285;4190;1294;4220
220380;201802;1512;3786;1227;3379;39;127;1047;2838;1086;2965
220385;201802;809;2001;637;1700;11;42;535;1383;546;1425
220390;201802;8768;25667;7464;23380;1910;5987;3041;10066;4951;16053
220400;201802;1505;3760;1167;3222;26;98;909;2421;935;2519
220410;201802;1150;3295;962;2979;62;190;763;2337;825;2527
220415;201802;821;2245;712;2065;25;81;536;1522;561;1603
220420;201802;2076;5891;1682;5132;80;261;1250;3747;1330;4008
220430;201802;2462;6735;2394;6644;88;266;2146;5909;2234;6175
220435;201802;1709;4767;1520;4464;56;187;1181;3411;1237;3598
220440;201802;2456;7909;2177;7457;143;540;1782;6001;1925;6541
220450;201802;2157;6220;1800;5726;245;890;1287;4047;1532;4937
220455;201802;1336;4192;1262;4092;32;144;1113;3583;1145;3727
220460;201802;944;2483;858;2383;46;149;737;2001;783;2150
220465;201802;2371;7603;2125;7220;165;609;1605;5470;1770;6079
220470;201802;3544;10280;3190;9703;114;389;2581;7728;2695;8117
220480;201802;2424;6696;1996;5988;135;349;1467;4357;1602;4706
220490;201802;2366;6324;2151;6058;41;160;1913;5331;1954;5491
220500;201802;2796;7589;2469;7052;59;248;1970;5450;2029;5698
220510;201802;2735;7984;2219;7074;92;294;1697;5447;1789;5741
220515;201802;1745;4209;1550;3951;47;116;1375;3493;1422;3609
220520;201802;5071;13417;4617;12801;85;263;4171;11563;4256;11826
220525;201802;1236;3401;1128;3249;22;83;980;2783;1002;2866
220527;201802;1321;3866;1156;3572;39;123;944;2955;983;3078
220530;201802;1246;3457;1108;3253;32;126;1004;2888;1036;3014
220535;201802;825;2364;767;2290;56;174;605;1806;661;1980
220540;201802;3397;10774;3204;10462;98;428;2786;9027;2884;9455
220545;201802;1390;4471;1293;4286;94;375;1039;3386;1133;3761
220550;201802;8999;28084;8133;26602;584;2177;6115;19663;6699;21840
220551;201802;1435;4351;1259;4060;53;225;993;3123;1046;3348
220552;201802;1529;4607;1298;4157;39;203;1047;3229;1086;3432
220553;201802;1600;4460;1360;4087;48;150;1054;3251;1102;3401
220554;201802;838;2329;666;2045;43;112;502;1546;545;1658
220555;201802;2070;6680;1914;6422;55;280;1605;5302;1660;5582
220556;201802;1308;3935;1135;3576;50;217;845;2531;895;2748
220557;201802;1560;4821;1342;4383;86;315;958;3077;1044;3392
220558;201802;1151;3376;987;3138;36;174;800;2472;836;2646
220559;201802;1625;4366;1397;3993;17;61;1157;3313;1174;3374
220560;201802;1651;3997;1338;3568;40;98;1167;3096;1207;3194
220570;201802;7233;22727;6660;21795;617;2095;4984;16457;5601;18552
220580;201802;6544;19221;6246;18736;177;588;5565;16565;5742;17153
220585;201802;1966;6485;1775;6129;75;303;1436;4915;1511;5218
220590;201802;1296;3703;1105;3416;109;347;755;2344;864;2691
220595;201802;2441;6864;2270;6646;17;94;2128;6165;2145;6259
220600;201802;1377;3193;1123;2866;86;133;923;2423;1009;2556
220605;201802;1746;5109;1489;4671;40;177;1172;3582;1212;3759
220610;201802;2909;9090;2737;8844;47;213;2503;8085;2550;8298
220620;201802;7701;24740;7220;24083;212;934;6509;21555;6721;22489
220630;201802;380;1159;307;1032;42;161;181;618;223;779
220635;201802;1675;5426;1471;4993;81;320;1089;3646;1170;3966
220640;201802;2723;7552;2323;6956;87;305;1921;5694;2008;5999
220650;201802;2089;6055;1806;5553;71;247;1371;4179;1442;4426
220660;201802;2828;8372;2511;7954;94;404;2140;6630;2234;7034
220665;201802;1284;4008;1133;3759;25;136;961;3134;986;3270
220667;201802;1623;5324;1463;5034;72;280;1174;4047;1246;4327
220669;201802;1733;5514;1655;5376;91;406;1354;4322;1445;4728
220670;201802;2059;5735;1758;5371;46;145;1574;4803;1620;4948
220672;201802;2659;7288;2338;6894;106;315;2058;6101;2164;6416
220675;201802;1252;3514;1146;3322;62;160;891;2576;953;2736
220680;201802;2572;7421;2443;7246;124;368;2147;6361;2271;6729
220690;201802;1637;4469;1421;4117;126;324;1046;3080;1172;3404
220695;201802;937;2669;853;2506;29;103;695;2023;724;2126
220700;201802;8546;23040;7064;20907;370;1254;5397;15788;5767;17042
220710;201802;842;2440;659;2073;53;145;462;1445;515;1590
220720;201802;1999;5041;1826;4778;39;120;1578;4104;1617;4224
220730;201802;1349;3885;1123;3522;28;127;910;2794;938;2921
220735;201802;1012;2434;787;2064;25;62;654;1700;679;1762
220740;201802;1426;4096;1152;3735;35;126;971;3167;1006;3293
220750;201802;3750;10367;3387;9835;190;548;2875;8344;3065;8892
220755;201802;1136;3070;1003;2854;33;121;800;2206;833;2327
220760;201802;2939;8937;2607;8483;107;388;2202;7207;2309;7595
220770;201802;20862;66936;18213;62038;6426;22664;5643;20171;12069;42835
220775;201802;1140;3072;1073;2997;21;72;1033;2879;1054;2951
220777;201802;1558;4152;1240;3621;42;116;944;2740;986;2856
220779;201802;1354;3345;1221;3159;28;98;1060;2699;1088;2797
220780;201802;5416;14347;4676;13151;228;770;3786;10395;4014;11165
220785;201802;1415;3272;1295;3099;22;27;1220;2923;1242;2950
220790;201802;10188;29774;9217;28325;332;1378;7725;23360;8057;24738
220793;201802;839;2322;715;2114;34;107;580;1707;614;1814
220795;201802;1435;3866;1304;3700;32;126;1156;3262;1188;3388
220800;201802;16194;41234;13800;37727;884;2511;9722;26095;10606;28606
220810;201802;2956;8516;2577;7850;57;238;2137;6368;2194;6606
220820;201802;5265;14006;4622;13094;434;1154;3507;9967;3941;11121
220830;201802;7135;19848;6525;18940;345;1055;5343;15444;5688;16499
220840;201802;12819;39927;11042;36361;2221;7121;5838;19680;8059;26801
220850;201802;2962;9599;2713;9294;79;409;2409;8191;2488;8600
220855;201802;604;1754;517;1607;18;72;416;1272;434;1344
220860;201802;994;2536;866;2340;17;60;777;2080;794;2140
220865;201802;2573;6955;2019;6006;62;243;1580;4562;1642;4805
220870;201802;2477;7735;2101;7219;34;189;1899;6476;1933;6665
220880;201802;5065;12870;4545;12244;59;195;4241;11380;4300;11575
220885;201802;1270;4338;1100;4029;60;309;840;3065;900;3374
220887;201802;1340;3179;1194;2979;11;36;1120;2772;1131;2808
220890;201802;1590;5233;1352;4771;101;348;987;3532;1088;3880
220900;201802;1978;5089;1680;4672;37;93;1460;4041;1497;4134
220910;201802;1512;4412;1298;4090;34;125;1134;3576;1168;3701
220915;201802;986;2713;816;2382;22;88;638;1805;660;1893
220920;201802;1376;4723;1188;4451;85;398;911;3364;996;3762
220930;201802;1532;4603;1368;4358;33;137;1215;3803;1248;3940
220935;201802;1040;3041;842;2619;28;121;567;1643;595;1764
220937;201802;1393;3808;1203;3516;27;104;970;2775;997;2879
220940;201802;1379;4145;1172;3731;47;203;856;2640;903;2843
220945;201802;425;1518;380;1428;25;135;267;987;292;1122
220950;201802;1372;3280;923;2553;20;77;707;1896;727;1973
220955;201802;1543;4157;1347;3821;47;131;1121;3185;1168;3316
220960;201802;882;2252;689;1940;18;67;541;1500;559;1567
220965;201802;1723;4886;1560;4632;28;168;1338;3846;1366;4014
220970;201802;1890;4953;1452;4241;62;167;1131;3322;1193;3489
220975;201802;718;2234;641;2135;25;165;568;1795;593;1960
220980;201802;1216;3502;1087;3291;36;133;891;2665;927;2798
220985;201802;1197;3405;1097;3257;46;195;844;2394;890;2589
220987;201802;1477;4524;1286;4186;68;294;1030;3287;1098;3581
220990;201802;1731;4977;1485;4579;40;201;1175;3513;1215;3714
220995;201802;1204;3559;923;3092;65;264;651;2176;716;2440
220997;201802;2401;7046;2255;6837;52;214;2062;6189;2114;6403
221000;201802;4090;12009;3787;11536;167;703;3111;9287;3278;9990
221005;201802;1433;4127;1295;3875;100;295;991;2900;1091;3195
221010;201802;1214;3030;1010;2777;27;84;877;2367;904;2451
221020;201802;1594;4960;1475;4721;43;198;1089;3418;1132;3616
221030;201802;1555;4330;1351;4024;40;173;1117;3271;1157;3444
221035;201802;1368;3760;1257;3613;25;55;1152;3377;1177;3432
221037;201802;586;1744;511;1607;11;56;357;1068;368;1124
221038;201802;555;1559;428;1329;19;67;291;896;310;963
221039;201802;900;2436;789;2262;19;78;665;1856;684;1934
221040;201802;4317;13243;3922;12555;170;598;3081;9892;3251;10490
221050;201802;3576;10129;3267;9733;58;251;2957;8709;3015;8960
221060;201802;8385;23747;7030;21596;316;1056;5347;16684;5663;17740
221062;201802;1227;4149;1075;3855;47;250;835;2939;882;3189
221063;201802;1169;3516;1017;3276;72;257;734;2339;806;2596
221065;201802;2697;7094;2358;6528;40;138;2033;5543;2073;5681
221070;201802;3527;11194;3010;10189;198;754;2169;7322;2367;8076
221080;201802;3526;8749;2852;7739;76;284;2303;6177;2379;6461
221090;201802;1397;3756;1177;3375;18;72;1010;2832;1028;2904
221093;201802;1487;4363;1382;4149;163;513;874;2528;1037;3041
221095;201802;903;2410;768;2192;7;24;634;1765;641;1789
221097;201802;814;2186;640;1867;20;74;474;1328;494;1402
221100;201802;101293;289659;90291;270850;16434;50779;51563;152760;67997;203539
221110;201802;10320;31216;9450;30129;279;1296;8202;25816;8481;27112
221120;201802;4174;12657;3888;12188;331;1115;3096;9657;3427;10772
221130;201802;4725;12947;3665;10808;996;2892;1450;4357;2446;7249
221135;201802;1566;4442;1410;4228;43;157;1225;3638;1268;3795
221140;201802;1313;3186;1154;2964;12;41;1036;2617;1048;2658
221150;201802;1149;2885;913;2472;23;84;698;1807;721;1891
221160;201802;821;2058;736;1942;30;67;589;1549;619;1616
221170;201802;1093;3220;984;3040;22;75;799;2456;821;2531
230010;201802;3320;8910;2649;7732;181;607;1970;5646;2151;6253
230015;201802;2908;9818;2678;9372;264;1089;1799;6187;2063;7276
230020;201802;13397;42854;12877;42014;492;2014;10959;35352;11451;37366
230030;201802;12343;33070;10746;30789;254;887;9351;26671;9605;27558
230040;201802;4147;11292;3559;10295;134;523;2853;8107;2987;8630
230050;201802;2709;8778;2006;6991;444;1488;694;2444;1138;3932
230060;201802;2343;6601;1913;5775;53;211;1526;4509;1579;4720
230070;201802;3981;11141;3336;9848;184;635;2278;6757;2462;7392
230075;201802;9184;30486;8497;29247;425;2118;6788;22784;7213;24902
230080;201802;2557;6053;2037;5298;39;155;1763;4508;1802;4663
230090;201802;4011;10782;3473;9918;192;623;2615;7341;2807;7964
230100;201802;17795;49286;15923;46503;1929;5983;10054;29436;11983;35419
230110;201802;11909;36819;10648;34264;2027;6641;5652;18311;7679;24952
230120;201802;7577;20871;6563;19282;606;1656;4724;14186;5330;15842
230125;201802;3008;8353;2471;7430;99;353;1893;5658;1992;6011
230130;201802;5737;18311;4798;16279;491;1761;3075;10239;3566;12000
230140;201802;3567;10859;2994;9810;162;646;2140;6930;2302;7576
230150;201802;1642;4970;1397;4428;258;797;743;2409;1001;3206
230160;201802;6409;17609;5558;16311;212;783;4534;13113;4746;13896
230170;201802;6042;18113;5232;16581;250;935;3848;11946;4098;12881
230180;201802;1678;4785;1427;4289;38;173;1089;3135;1127;3308
230185;201802;4018;12384;3509;11474;339;1228;2493;8173;2832;9401
230190;201802;12840;39189;11115;35814;1728;5768;5849;18934;7577;24702
230195;201802;5168;15530;4592;14535;334;1209;3525;10981;3859;12190
230200;201802;4906;13719;4289;12523;198;602;3326;9516;3524;10118
230205;201802;4063;12837;3643;12098;195;844;2675;8718;2870;9562
230210;201802;9589;25266;8153;23145;543;1710;5904;16665;6447;18375
230220;201802;13513;36135;11994;33669;583;1819;9616;26633;10199;28452
230230;201802;6976;21646;6289;20267;549;1809;4481;14414;5030;16223
230240;201802;13124;35403;11551;32879;513;1478;9209;26092;9722;27570
230250;201802;9258;27482;9137;27280;397;1428;7164;20883;7561;22311
230260;201802;14330;45796;12933;42954;1758;6184;7489;25049;9247;31233
230270;201802;7464;21024;6054;18399;632;1998;3904;11941;4536;13939
230280;201802;20340;57195;17249;51915;842;3334;13241;38677;14083;42011
230290;201802;4749;13792;4075;12394;456;1281;2851;8794;3307;10075
230300;201802;4333;12445;4093;12113;145;595;3511;10169;3656;10764
230310;201802;4831;13983;4124;12753;131;539;2982;9036;3113;9575
230320;201802;7556;22234;6618;20516;347;1356;5022;15293;5369;16649
230330;201802;4762;13469;3942;11889;212;658;2873;8572;3085;9230
230340;201802;3582;11460;3083;10423;274;974;2108;7066;2382;8040
230350;201802;18665;53453;16631;50000;1126;3949;10744;32660;11870;36609
230360;201802;2992;8337;2370;7190;149;510;1628;4873;1777;5383
230365;201802;3030;7799;2580;7081;68;303;2172;5850;2240;6153
230370;201802;53886;161470;46844;150325;10433;34461;22223;74067;32656;108528
230380;201802;6489;18422;5240;16068;187;687;3743;11281;3930;11968
230390;201802;3324;10244;2916;9536;149;637;2192;7013;2341;7650
230393;201802;3044;9616;2566;8634;106;560;1916;6182;2022;6742
230395;201802;5649;15781;4976;14598;528;1521;3319;9881;3847;11402
230400;201802;5594;16206;4980;15173;189;833;3933;11658;4122;12491
230410;201802;14771;44955;12116;39675;1457;4915;7295;24018;8752;28933
230420;201802;25120;75384;21724;68900;3239;10997;11571;36426;14810;47423
230423;201802;4553;13974;3995;12840;146;628;3152;9944;3298;10572
230425;201802;5557;17878;5086;16876;552;1870;3415;11352;3967;13222
230426;201802;2564;7012;1963;5844;47;199;1479;4326;1526;4525
230427;201802;1815;5275;1292;4079;75;259;869;2629;944;2888
230428;201802;9533;27074;8534;25500;1315;4182;4821;14285;6136;18467
230430;201802;4492;13575;3888;12484;227;889;2868;8945;3095;9834
230435;201802;5495;15773;4740;14461;625;1954;2825;8662;3450;10616
230440;201802;388354;1043965;329605;951046;56357;170468;171011;493871;227368;664339
230445;201802;4451;11980;3736;10735;208;559;2641;7490;2849;8049
230450;201802;3550;10759;3101;9968;223;908;2230;7033;2453;7941
230460;201802;1990;6016;1734;5557;91;359;1364;4352;1455;4711
230465;201802;4064;11681;3366;10421;116;513;2449;7325;2565;7838
230470;201802;11234;38754;10268;36882;952;4103;7348;25975;8300;30078
230480;201802;1437;4351;1217;3918;113;441;871;2721;984;3162
230490;201802;2321;6853;2025;6293;223;703;1145;3463;1368;4166
230495;201802;5694;17685;5104;16595;451;1812;3338;10677;3789;12489
230500;201802;8576;29642;8054;28627;424;1874;6182;21910;6606;23784
230510;201802;1629;5337;1214;4350;229;866;477;1697;706;2563
230520;201802;4369;13041;3953;12243;315;1058;2764;8426;3079;9484
230523;201802;15214;46529;12738;41190;2976;9844;3182;10779;6158;20623
230526;201802;3982;11579;3390;10528;159;709;2596;7823;2755;8532
230530;201802;5246;16495;4566;15338;501;1782;3180;10787;3681;12569
230533;201802;4073;10668;3463;9562;164;472;2733;7490;2897;7962
230535;201802;5509;15688;4690;14206;323;974;3201;9869;3524;10843
230540;201802;16617;47063;14818;44337;375;1566;12554;37032;12929;38598
230550;201802;19640;55283;16640;49923;2208;7110;9463;28120;11671;35230
230560;201802;7470;19863;6197;17589;122;483;5016;14035;5138;14518
230565;201802;3352;9163;2703;8008;90;329;2001;5883;2091;6212
230570;201802;3553;9268;3084;8635;77;223;2574;7166;2651;7389
230580;201802;9863;28113;8822;26576;401;1482;7343;21896;7744;23378
230590;201802;8993;26683;7494;23859;564;2036;5181;16047;5745;18083
230600;201802;3758;10081;2842;8299;99;310;1853;5472;1952;5782
230610;201802;6375;18751;5717;17706;482;1510;4289;13305;4771;14815
230620;201802;2126;5887;1634;4870;155;482;961;2805;1116;3287
230625;201802;8141;24705;7124;22668;2087;6911;1875;6212;3962;13123
230630;201802;10576;32642;9398;30258;2481;7489;4003;13926;6484;21415
230640;201802;27108;84162;24583;80160;1817;6749;19031;61611;20848;68360
230650;201802;4836;14123;4224;12932;275;947;3169;9524;3444;10471
230655;201802;9364;33216;8920;32423;646;2714;6980;25455;7626;28169
230660;201802;6259;18778;5185;16703;190;984;4157;13062;4347;14046
230670;201802;6067;15255;4597;12768;183;564;3554;9609;3737;10173
230680;201802;2590;7460;2225;6755;250;771;1447;4379;1697;5150
230690;201802;6373;19855;5867;18762;573;2040;3587;11248;4160;13288
230700;201802;9451;25581;8249;23330;379;1292;6165;16887;6544;18179
230710;201802;7219;22818;6254;20993;549;1978;4515;15057;5064;17035
230720;201802;1877;5797;1568;5127;146;470;1012;3274;1158;3744
230725;201802;3552;11609;3110;10530;721;2538;1116;3739;1837;6277
230730;201802;55395;159191;46075;144119;11307;38459;15190;49763;26497;88222
230740;201802;6117;17631;5430;16460;156;602;4323;12966;4479;13568
230750;201802;8258;22922;6988;20801;239;872;5420;15748;5659;16620
230760;201802;11349;31871;10182;29872;823;2775;7279;20827;8102;23602
230763;201802;4399;12888;3797;11745;205;804;2888;8610;3093;9414
230765;201802;40056;117768;34551;108003;7864;25910;12427;39386;20291;65296
230770;201802;26189;68806;22311;63414;2982;8966;13606;38726;16588;47692
230780;201802;5889;21491;5564;20802;960;3584;3183;12336;4143;15920
230790;201802;2891;8701;2662;8320;166;576;2076;6466;2242;7042
230800;201802;7777;25999;7032;24427;963;3699;3963;13583;4926;17282
230810;201802;11675;36217;10641;34506;515;2027;8226;26228;8741;28255
230820;201802;3198;10691;2755;9724;286;1164;1675;5758;1961;6922
230830;201802;7589;21994;6520;20050;232;980;5131;15442;5363;16422
230835;201802;4036;10085;3199;8764;117;391;2574;6885;2691;7276
230837;201802;3144;10202;2701;9338;159;740;1981;6664;2140;7404
230840;201802;8928;27478;7874;25697;561;2021;5981;19538;6542;21559
230850;201802;9249;27877;8220;25941;583;2039;5833;18323;6416;20362
230860;201802;5031;13652;4288;12536;167;597;3589;10370;3756;10967
230870;201802;17421;44193;15005;40486;598;1753;11769;31575;12367;33328
230880;201802;2001;6435;1849;6164;82;422;1401;4511;1483;4933
230890;201802;4352;14733;4017;14082;371;1448;2802;9723;3173;11171
230900;201802;2988;9299;2513;8297;318;1058;1506;4912;1824;5970
230910;201802;3046;8663;2475;7672;96;451;1927;5859;2023;6310
230920;201802;4466;12744;4005;12087;149;596;3363;10035;3512;10631
230930;201802;6641;19502;5670;17615;443;1485;3745;11522;4188;13007
230940;201802;7709;21202;6812;19745;217;684;5610;16169;5827;16853
230945;201802;6455;18971;5622;17343;445;1467;3789;11791;4234;13258
230950;201802;6399;16558;5786;15797;139;332;5145;14328;5284;14660
230960;201802;13660;41411;12342;38834;1980;6439;6126;19530;8106;25969
230970;201802;13668;39176;11746;35969;2176;7034;5535;17005;7711;24039
230980;201802;2751;8285;2385;7629;533;1648;1290;4284;1823;5932
230990;201802;1777;5071;1446;4444;92;379;969;2852;1061;3231
231000;201802;2557;6895;2132;6055;95;273;1490;4156;1585;4429
231010;201802;3026;7976;2473;7049;160;537;1865;5203;2025;5740
231020;201802;8051;26288;7372;24800;1297;4183;4264;14862;5561;19045
231025;201802;7423;21947;6654;20634;1076;3414;4118;12905;5194;16319
231030;201802;6940;21772;5703;19102;991;3350;2997;10066;3988;13416
231040;201802;3146;9384;2743;8628;101;414;2085;6432;2186;6846
231050;201802;11906;32071;9712;28200;622;1768;7170;20606;7792;22374
231060;201802;2561;7810;2325;7417;94;420;1782;5625;1876;6045
231070;201802;8256;24930;7137;22834;1125;3683;3928;12662;5053;16345
231080;201802;3993;11945;3588;11225;136;688;2766;8319;2902;9007
231085;201802;5623;15592;4976;14777;368;1072;3708;11240;4076;12312
231090;201802;4210;11436;3274;9561;127;460;2291;6504;2418;6964
231095;201802;2069;6457;1762;5777;159;582;1213;3927;1372;4509
231100;201802;2990;9146;2556;8331;203;702;1835;5960;2038;6662
231110;201802;3358;10690;3304;10591;222;869;2404;7558;2626;8427
231120;201802;1919;6171;1727;5788;146;524;1156;3857;1302;4381
231123;201802;1974;5230;1662;4666;84;260;1230;3384;1314;3644
231126;201802;5903;16654;4766;14478;209;741;3423;10184;3632;10925
231130;201802;19093;54779;16624;51140;1814;6288;10971;33859;12785;40147
231135;201802;4154;11947;3503;10750;180;667;2530;7610;2710;8277
231140;201802;17257;51353;14434;46084;933;3846;9720;30135;10653;33981
231150;201802;5336;15283;4502;13660;743;2219;2228;6917;2971;9136
231160;201802;5791;18506;5335;17611;1153;3564;2799;9645;3952;13209
231170;201802;4255;13047;3566;11604;235;876;2450;7781;2685;8657
231180;201802;14166;41330;12122;37024;2645;8161;5251;15943;7896;24104
231190;201802;4063;11637;3490;10661;182;741;2623;7742;2805;8483
231195;201802;4546;14785;3937;13494;259;1129;2813;9368;3072;10497
231200;201802;7990;25829;6895;23540;281;1386;5114;16961;5395;18347
231210;201802;4767;14723;4150;13676;203;889;3098;9931;3301;10820
231220;201802;11868;32282;9696;28143;578;1743;6984;19801;7562;21544
231230;201802;9024;29237;8132;27785;587;2305;6046;20730;6633;23035
231240;201802;11754;35561;10553;33180;1836;5886;5958;18907;7794;24793
231250;201802;1972;5362;1362;3951;112;323;759;2158;871;2481
231260;201802;3212;9568;2865;9003;337;1000;1882;6069;2219;7069
231270;201802;6822;18189;5763;16505;195;784;4382;12248;4577;13032
231280;201802;1688;5402;1571;5175;140;469;1108;3661;1248;4130
231290;201802;36355;113396;31995;104425;5667;19257;14714;47581;20381;66838
231300;201802;4029;11582;3290;10065;280;904;2125;6394;2405;7298
231310;201802;7417;20301;6004;17500;702;2045;3674;10570;4376;12615
231320;201802;7282;21113;5866;18360;148;672;4503;13868;4651;14540
231325;201802;2568;7314;2177;6675;425;1273;1146;3607;1571;4880
231330;201802;10444;32688;8855;29379;1752;5746;4420;15045;6172;20791
231335;201802;5517;15035;4688;13622;117;543;3972;11290;4089;11833
231340;201802;17838;56487;16117;53606;1259;4390;11898;39875;13157;44265
231350;201802;15199;42787;13901;40979;368;1218;12420;36606;12788;37824
231355;201802;4489;13879;4032;13072;233;883;3050;9819;3283;10702
231360;201802;7644;23676;6689;22007;610;2113;4744;15744;5354;17857
231370;201802;2358;6397;1854;5517;51;152;1389;4106;1440;4258
231375;201802;4263;13798;3914;13161;146;669;3199;10599;3345;11268
231380;201802;5709;15975;5319;15479;198;474;4538;13538;4736;14012
231390;201802;3369;10207;3034;9636;202;775;2169;6707;2371;7482
231395;201802;3927;12180;3351;11200;635;2136;1800;6106;2435;8242
231400;201802;9059;27009;8118;25206;402;1589;6199;18886;6601;20475
231410;201802;14905;47346;13324;44750;908;3300;10156;33822;11064;37122
240010;201802;2535;7101;1975;6050;200;733;1200;3560;1400;4293
240020;201802;10916;32650;9582;30128;1117;3848;5908;18465;7025;22313
240030;201802;2585;6997;2474;6842;118;369;2171;5959;2289;6328
240040;201802;861;2458;714;2168;16;81;514;1492;530;1573
240050;201802;3351;9000;2766;7963;70;237;2149;6064;2219;6301
240060;201802;1385;3862;1193;3499;43;150;941;2691;984;2841
240070;201802;2263;6825;2084;6455;238;757;1494;4572;1732;5329
240080;201802;2846;7722;2419;7036;96;347;1828;5243;1924;5590
240090;201802;2269;5862;1860;5157;33;114;1485;4039;1518;4153
240100;201802;8654;23112;7195;20353;465;1445;5287;14541;5752;15986
240110;201802;4602;13845;4007;12743;381;1366;2570;8050;2951;9416
240120;201802;2564;8778;2422;8482;262;1045;1605;5550;1867;6595
240130;201802;3061;7247;2665;6645;88;288;2329;5681;2417;5969
240140;201802;2153;6433;1814;5776;210;767;1151;3596;1361;4363
240145;201802;6125;18153;5249;16629;824;2764;3189;10226;4013;12990
240150;201802;886;2719;784;2503;51;202;596;1841;647;2043
240160;201802;1395;4316;1207;3963;77;292;845;2805;922;3097
240165;201802;872;2579;746;2322;90;260;515;1619;605;1879
240170;201802;2305;6722;1974;6119;254;892;1219;3646;1473;4538
240180;201802;2778;8540;2393;7747;448;1464;1325;4378;1773;5842
240185;201802;1293;4282;1180;4092;69;296;958;3304;1027;3600
240190;201802;973;3007;857;2806;24;115;697;2253;721;2368
240200;201802;11469;30636;9583;27538;1576;4656;4487;13058;6063;17714
240210;201802;2832;7659;2556;7199;65;262;2137;5839;2202;6101
240220;201802;7228;23417;6542;22390;579;2432;4718;16082;5297;18514
240230;201802;5819;15127;4816;13460;269;739;3785;10582;4054;11321
240240;201802;1756;5334;1066;3572;161;553;233;733;394;1286
240250;201802;2716;7720;2509;7424;174;461;2018;6005;2192;6466
240260;201802;12046;38890;11187;37406;1569;5426;7128;24311;8697;29737
240270;201802;2295;6946;2090;6626;134;384;1651;5336;1785;5720
240280;201802;1604;4294;1398;3996;48;150;1153;3248;1201;3398
240290;201802;1190;3598;1004;3205;44;210;669;1970;713;2180
240300;201802;2298;6082;1673;4862;119;380;959;2709;1078;3089
240310;201802;9359;25564;7918;23143;995;3033;4322;12609;5317;15642
240320;201802;1966;5530;1494;4589;33;156;1122;3279;1155;3435
240325;201802;29704;83949;23939;73975;6641;21570;6413;20961;13054;42531
240330;201802;1490;4369;1239;3853;56;222;850;2543;906;2765
240340;201802;1986;4899;1608;4313;85;220;1233;3247;1318;3467
240350;201802;2049;5528;1885;5334;40;147;1659;4697;1699;4844
240360;201802;6986;21051;6248;19878;1331;4164;3342;11179;4673;15343
240370;201802;2039;5560;1603;4698;128;387;1021;2947;1149;3334
240375;201802;868;2277;761;2072;37;143;571;1473;608;1616
240380;201802;2349;6801;1711;5364;161;519;963;2964;1124;3483
240390;201802;932;2482;701;2002;6;16;493;1326;499;1342
240400;201802;1311;3461;1027;2924;29;107;711;1929;740;2036
240410;201802;512;1626;455;1500;56;225;284;912;340;1137
240420;201802;4616;17258;4219;16337;666;3123;2226;8411;2892;11534
240430;201802;3296;9105;2884;8303;213;737;2130;5904;2343;6641
240440;201802;2552;6093;2172;5566;229;610;1531;3871;1760;4481
240450;201802;3982;11476;3271;10108;370;1252;1923;5778;2293;7030
240460;201802;2985;8784;2777;8486;258;888;2180;6618;2438;7506
240470;201802;3624;11141;2837;9494;368;1250;1611;5410;1979;6660
240480;201802;550;1503;403;1212;37;115;192;572;229;687
240485;201802;2118;6338;1788;5676;186;590;1160;3726;1346;4316
240490;201802;1747;4355;1425;3811;35;78;1197;3202;1232;3280
240500;201802;2248;6095;1960;5693;69;239;1637;4716;1706;4955
240510;201802;1660;4625;1522;4422;118;379;1238;3512;1356;3891
240520;201802;1287;3444;1094;3168;40;162;918;2585;958;2747
240530;201802;1900;6039;1747;5772;127;489;1332;4328;1459;4817
240540;201802;2056;5470;1848;5161;64;211;1599;4413;1663;4624
240550;201802;736;2047;634;1870;37;117;473;1374;510;1491
240560;201802;3359;9113;2916;8525;313;797;2122;6336;2435;7133
240570;201802;2963;8013;2078;6020;271;842;967;2538;1238;3380
240580;201802;7593;22855;6993;21817;551;1885;5520;17121;6071;19006
240590;201802;717;1952;624;1785;21;80;472;1321;493;1401
240600;201802;1692;4725;1262;3833;98;336;780;2285;878;2621
240610;201802;4498;12652;3824;11408;246;808;2667;7826;2913;8634
240615;201802;1041;2994;830;2555;87;314;538;1571;625;1885
240620;201802;1856;5361;1587;4884;120;359;1255;3838;1375;4197
240630;201802;2045;6063;1853;5734;150;385;1269;4033;1419;4418
240640;201802;922;2552;744;2265;54;216;513;1502;567;1718
240650;201802;3945;11273;3526;10591;177;558;2772;8276;2949;8834
240660;201802;2554;7430;2386;7190;96;346;2055;6096;2151;6442
240670;201802;2477;7286;2062;6415;195;680;1284;3865;1479;4545
240680;201802;1566;4397;1252;3841;62;227;899;2695;961;2922
240690;201802;925;2431;741;2105;24;88;589;1616;613;1704
240700;201802;2454;7202;2032;6426;70;296;1582;4882;1652;5178
240710;201802;15772;43199;13868;39803;2679;7475;7425;21825;10104;29300
240720;201802;5197;13936;4567;12917;802;2361;2660;7380;3462;9741
240725;201802;1049;3131;816;2607;41;141;522;1622;563;1763
240730;201802;2122;6150;1804;5521;119;386;1352;4085;1471;4471
240740;201802;1897;5248;1602;4695;65;281;1165;3229;1230;3510
240750;201802;2048;7430;1868;7067;356;1466;975;3712;1331;5178
240760;201802;1426;3650;1034;3030;61;158;782;2320;843;2478
240770;201802;3074;8720;2719;8220;128;497;2262;6700;2390;7197
240780;201802;5476;15107;4500;13533;565;1725;2714;8329;3279;10054
240790;201802;872;2554;722;2259;21;80;546;1704;567;1784
240800;201802;36351;98957;30822;90033;5341;16259;14355;42201;19696;58460
240810;201802;80851;227135;72722;212906;16979;49617;34710;103551;51689;153168
240820;201802;5221;16663;4661;15715;943;3241;2439;8543;3382;11784
240830;201802;8718;25954;8026;24896;351;1477;6570;20018;6921;21495
240840;201802;1138;3015;932;2652;83;240;631;1743;714;1983
240850;201802;1269;3659;933;2902;64;203;516;1590;580;1793
240860;201802;1243;3473;972;2959;28;124;735;2130;763;2254
240870;201802;1168;3036;905;2585;67;199;610;1699;677;1898
240880;201802;1253;4055;1176;3905;85;314;934;3083;1019;3397
240890;201802;4807;13372;3779;11365;665;2103;1737;5146;2402;7249
240895;201802;2614;8823;2418;8497;241;902;1823;6454;2064;7356
240910;201802;3085;8875;2665;8041;73;268;2169;6466;2242;6734
240920;201802;796;2469;684;2243;77;276;371;1206;448;1482
240930;201802;3534;8658;3035;8045;95;180;2450;6626;2545;6806
240933;201802;1729;4383;1473;3969;49;181;1201;3155;1250;3336
240940;201802;6335;16084;5062;13968;367;1063;3590;9651;3957;10714
240950;201802;947;2985;848;2787;41;178;630;2022;671;2200
240960;201802;793;2409;691;2205;46;155;498;1561;544;1716
240970;201802;1842;4999;1518;4408;57;209;1223;3427;1280;3636
240980;201802;2873;9247;2624;8783;282;1069;1862;6150;2144;7219
240990;201802;2550;7499;2349;7092;309;989;1620;4814;1929;5803
241000;201802;977;2639;816;2349;38;121;565;1606;603;1727
241010;201802;2671;8878;2520;8584;267;1104;1800;5924;2067;7028
241020;201802;2053;5587;1539;4527;190;517;895;2623;1085;3140
241025;201802;1706;5059;1422;4520;83;286;964;3068;1047;3354
241030;201802;2422;7833;2051;7045;203;747;1360;4646;1563;5393
241040;201802;2286;7404;2044;6995;131;565;1575;5372;1706;5937
241050;201802;1279;3704;1075;3322;57;203;773;2341;830;2544
241060;201802;769;2188;681;2017;56;165;463;1357;519;1522
241070;201802;649;1852;571;1714;36;135;438;1241;474;1376
241080;201802;1137;3277;880;2766;17;82;645;1988;662;2070
241090;201802;1922;5801;1648;5315;67;309;1273;4041;1340;4350
241100;201802;1104;3247;924;2841;48;168;636;1903;684;2071
241105;201802;1110;3342;937;3035;254;817;361;1200;615;2017
241110;201802;864;2577;684;2176;32;122;444;1354;476;1476
241120;201802;7190;21380;6332;19846;1371;4056;3277;10937;4648;14993
241140;201802;3303;8764;2762;7707;172;474;2019;5491;2191;5965
241142;201802;776;2164;578;1770;45;159;335;983;380;1142
241150;201802;5576;15691;4965;14659;238;900;3853;11136;4091;12036
241160;201802;1539;4647;1347;4333;152;429;951;3145;1103;3574
241170;201802;1207;3273;1083;3062;52;173;878;2397;930;2570
241180;201802;975;2637;719;2120;67;195;395;1152;462;1347
241190;201802;1147;3085;924;2634;36;138;663;1799;699;1937
241200;201802;18069;50432;15816;46993;3497;10655;7520;22880;11017;33535
241210;201802;1448;3989;1118;3322;106;332;666;1948;772;2280
241220;201802;8151;25854;7329;24378;2194;7324;2984;10396;5178;17720
241230;201802;3004;8313;2709;7842;114;413;2240;6316;2354;6729
241240;201802;1174;3423;695;2267;47;184;347;1132;394;1316
241250;201802;5904;17673;4819;15590;213;1028;3520;10940;3733;11968
241255;201802;1882;6556;1677;6092;195;844;1059;3766;1254;4610
241260;201802;5042;13377;3970;11630;119;519;2964;8454;3083;8973
241270;201802;1807;5402;1547;4896;116;449;1107;3447;1223;3896
241280;201802;1903;5229;1709;4889;98;298;1382;3905;1480;4203
241290;201802;3197;8324;2526;7199;97;348;1957;5447;2054;5795
241300;201802;1472;4104;1226;3660;40;127;808;2368;848;2495
241310;201802;1841;5043;1644;4723;48;174;1387;3930;1435;4104
241320;201802;897;3085;804;2869;100;402;505;1774;605;2176
241330;201802;1426;4198;1301;4028;51;208;1130;3463;1181;3671
241335;201802;2926;8490;2632;7961;117;414;2184;6502;2301;6916
241340;201802;1768;5274;1426;4506;297;965;612;1902;909;2867
241350;201802;1876;5737;1695;5392;96;363;1279;3970;1375;4333
241355;201802;1351;3742;1090;3258;38;153;833;2463;871;2616
241360;201802;2094;5481;1673;4674;68;212;1222;3330;1290;3542
241370;201802;1358;3892;1071;3322;78;278;708;2092;786;2370
241380;201802;653;1824;522;1563;63;197;321;936;384;1133
241390;201802;2643;8344;2437;8005;189;690;1879;6159;2068;6849
241400;201802;3643;10296;3258;9745;228;750;2566;7637;2794;8387
241410;201802;2373;7147;2043;6560;418;1397;1089;3498;1507;4895
241415;201802;1633;4850;1393;4410;115;404;1030;3194;1145;3598
241420;201802;2106;7221;1867;6783;543;2099;615;2271;1158;4370
241430;201802;532;1526;403;1255;36;123;241;728;277;851
241440;201802;6896;23029;6234;21836;518;2139;4671;16209;5189;18348
241445;201802;983;2739;923;2667;28;61;842;2495;870;2556
241450;201802;2893;7457;2558;6965;283;731;1847;5064;2130;5795
241460;201802;3511;9932;3006;8854;207;717;2122;6056;2329;6773
241470;201802;1391;3757;1132;3389;53;194;911;2698;964;2892
241475;201802;1249;3659;998;3168;35;192;712;2141;747;2333
241480;201802;2645;8611;2355;8053;882;3011;630;2505;1512;5516
241490;201802;691;1758;559;1552;27;88;377;1002;404;1090
241500;201802;767;2354;657;2218;18;77;562;1889;580;1966
250010;201802;2747;8377;2284;7372;76;329;1677;5273;1753;5602
250020;201802;1563;4346;1160;3561;57;165;811;2443;868;2608
250030;201802;6825;19209;6169;18241;364;1203;4952;14382;5316;15585
250040;201802;3949;12830;3583;12093;315;1189;2520;8384;2835;9573
250050;201802;3339;9898;3077;9503;276;948;2313;7045;2589;7993
250053;201802;1224;3599;1113;3427;96;313;803;2476;899;2789
250057;201802;669;2515;645;2486;3;10;616;2411;619;2421
250060;201802;5187;14598;4760;14017;429;1280;3710;11018;4139;12298
250070;201802;3847;11467;3519;10867;61;308;2710;8074;2771;8382
250073;201802;774;2200;650;1995;17;65;495;1466;512;1531
250077;201802;2212;6170;1682;5265;100;329;1198;3727;1298;4056
250080;201802;4338;11858;3982;11342;130;464;3358;9409;3488;9873
250090;201802;2712;7260;2491;6918;124;309;2072;5725;2196;6034
250100;201802;3806;11979;3533;11480;179;750;2872;9074;3051;9824
250110;201802;4826;14008;4478;13496;425;1518;3480;10211;3905;11729
250115;201802;507;1527;455;1445;17;92;339;1034;356;1126
250120;201802;1684;5245;1482;4889;61;277;1168;3825;1229;4102
250130;201802;5364;15860;4673;14722;119;632;3748;11563;3867;12195
250135;201802;1086;3190;997;3046;20;82;840;2549;860;2631
250140;201802;2100;6608;2028;6493;95;426;1701;5380;1796;5806
250150;201802;4830;15908;4426;15144;187;910;3431;11468;3618;12378
250153;201802;1487;3867;1234;3505;25;102;1007;2813;1032;2915
250157;201802;1792;5592;1620;5231;184;577;1142;3704;1326;4281
250160;201802;3768;9964;3107;9055;49;165;2827;8240;2876;8405
250170;201802;1663;4605;1488;4342;62;227;1224;3530;1286;3757
250180;201802;16580;45431;15051;43297;1033;3477;11300;31753;12333;35230
250190;201802;4038;11420;3588;10690;507;1445;2334;6964;2841;8409
250200;201802;1873;5423;1579;4953;56;216;1293;4030;1349;4246
250205;201802;787;2684;742;2596;22;120;593;2047;615;2167
250210;201802;1492;4709;1379;4517;57;264;1076;3446;1133;3710
250215;201802;1393;4131;1220;3881;70;258;792;2507;862;2765
250220;201802;714;2035;574;1824;27;101;427;1344;454;1445
250230;201802;1646;3954;1239;3303;35;126;984;2524;1019;2650
250240;201802;2252;7143;2056;6796;73;286;1681;5498;1754;5784
250250;201802;4464;12961;3973;12267;124;428;3289;10128;3413;10556
250260;201802;1677;4825;1434;4408;45;156;1142;3503;1187;3659
250270;201802;1263;3821;1106;3626;79;254;825;2831;904;3085
250280;201802;3351;9784;2922;9089;151;534;2280;7046;2431;7580
250290;201802;1721;4648;1471;4299;18;47;1233;3606;1251;3653
250300;201802;5164;14883;4877;14531;262;1110;4119;11910;4381;13020
250310;201802;1099;3248;960;2997;33;137;746;2255;779;2392
250320;201802;9100;25023;8309;23996;635;2018;6635;18948;7270;20966
250330;201802;2389;7123;2032;6597;133;457;1569;5047;1702;5504
250340;201802;1093;3031;954;2821;14;53;808;2349;822;2402
250350;201802;4177;11477;3774;10937;159;411;3220;9456;3379;9867
250355;201802;1955;6082;1793;5879;28;152;1629;5314;1657;5466
250360;201802;1793;5173;1667;4963;43;139;1376;4086;1419;4225
250370;201802;11829;32908;10253;30821;505;1791;8469;25195;8974;26986
250375;201802;1051;3024;934;2859;17;64;833;2570;850;2634
250380;201802;1632;4464;1524;4321;55;210;1253;3420;1308;3630
250390;201802;1804;4786;1496;4272;184;505;998;2877;1182;3382
250400;201802;71731;184269;53253;155164;13950;42610;17817;53566;31767;96176
250403;201802;1609;4975;1463;4792;151;630;1024;3261;1175;3891
250407;201802;1220;3245;1038;2969;79;172;757;2182;836;2354
250410;201802;554;1672;491;1558;12;62;400;1227;412;1289
250415;201802;1913;5582;1697;5206;66;224;1335;4098;1401;4322
250420;201802;1229;3534;1115;3373;22;84;1016;3072;1038;3156
250430;201802;6242;16153;5516;15095;208;663;4515;12087;4723;12750
250435;201802;1379;4060;1205;3762;42;170;920;2823;962;2993
250440;201802;4477;12419;3983;11740;103;384;3399;9902;3502;10286
250450;201802;1858;5114;1582;4735;42;162;1308;3857;1350;4019
250460;201802;6613;19046;6152;18442;327;1012;5288;15981;5615;16993
250470;201802;1516;4013;1252;3634;63;232;940;2636;1003;2868
250480;201802;3715;10845;3378;10410;48;214;3031;9367;3079;9581
250485;201802;695;1628;509;1364;28;78;393;1010;421;1088
250490;201802;4268;11859;3932;11437;269;900;3203;9256;3472;10156
250500;201802;1894;5451;1695;5119;94;306;1355;4081;1449;4387
250510;201802;5138;13633;4485;12751;80;251;4007;11409;4087;11660
250520;201802;1799;5133;1585;4817;175;578;1041;3110;1216;3688
250523;201802;1982;5291;1826;5094;84;350;1565;4240;1649;4590
250527;201802;1611;4410;1495;4265;35;110;1364;3873;1399;3983
250530;201802;601;1785;528;1679;19;72;465;1467;484;1539
250535;201802;1351;4103;1238;3893;39;189;975;2991;1014;3180
250540;201802;2577;6624;2227;6219;55;160;1963;5470;2018;5630
250550;201802;844;2803;765;2668;28;141;620;2106;648;2247
250560;201802;1664;4927;1539;4738;49;193;1269;3799;1318;3992
250570;201802;2523;7793;2213;7224;93;415;1753;5562;1846;5977
250580;201802;1069;2805;954;2635;51;193;782;2110;833;2303
250590;201802;826;2458;739;2319;21;106;610;1852;631;1958
250600;201802;7404;20683;6749;19694;418;1112;5553;16312;5971;17424
250610;201802;3037;8679;2784;8308;162;551;2266;6700;2428;7251
250620;201802;691;1968;605;1797;32;126;458;1325;490;1451
250625;201802;2522;7551;2341;7274;51;222;2026;6167;2077;6389
250630;201802;9604;28312;8328;25882;1256;4051;4966;15128;6222;19179
250640;201802;3408;10099;3174;9777;119;524;2655;7977;2774;8501
250650;201802;877;2264;741;2084;36;119;592;1603;628;1722
250660;201802;1681;4320;1507;4084;41;114;1344;3617;1385;3731
250670;201802;2323;7475;2175;7225;59;304;1857;6015;1916;6319
250680;201802;5198;13214;4792;12752;142;480;4346;11420;4488;11900
250690;201802;6445;15605;5881;14893;185;457;5298;13322;5483;13779
250700;201802;4384;12671;3927;11961;404;1269;2873;8677;3277;9946
250710;201802;4446;13190;3866;12412;345;1230;2756;8886;3101;10116
250720;201802;2731;7436;2494;7070;49;213;2231;6248;2280;6461
250730;201802;3776;10554;3395;10037;187;671;2794;8046;2981;8717
250740;201802;1917;5145;1604;4693;135;437;1248;3559;1383;3996
250750;201802;97218;261734;86613;246316;9195;28410;58421;163061;67616;191471
250760;201802;2331;6255;2041;5804;128;387;1592;4427;1720;4814
250770;201802;3820;12272;3503;11854;296;1177;2546;8523;2842;9700
250780;201802;1726;4878;1462;4373;124;420;1019;2972;1143;3392
250790;201802;2335;7272;2120;6932;327;1122;1316;4337;1643;5459
250800;201802;2508;6873;2167;6313;95;228;1765;5144;1860;5372
250810;201802;1261;3550;1062;3256;37;141;862;2624;899;2765
250820;201802;1816;5667;1757;5593;76;319;1566;4928;1642;5247
250830;201802;5301;16601;4788;15556;368;1448;3368;10679;3736;12127
250840;201802;866;2762;737;2494;21;92;507;1728;528;1820
250850;201802;1938;5780;1725;5427;46;251;1395;4255;1441;4506
250855;201802;1049;3076;907;2827;34;150;698;2118;732;2268
250860;201802;3206;9986;2675;9036;483;1733;1338;4564;1821;6297
250870;201802;1075;3009;917;2712;33;121;741;2163;774;2284
250880;201802;1536;4101;1259;3687;153;446;829;2476;982;2922
250890;201802;9391;26796;8775;25928;685;2600;6934;19825;7619;22425
250900;201802;2727;8328;2373;7648;100;370;1910;6049;2010;6419
250905;201802;2132;6383;2024;6238;83;321;1774;5418;1857;5739
250910;201802;5121;14094;4617;13421;143;537;3940;11400;4083;11937
250915;201802;1804;4637;1402;4215;23;48;1297;3983;1320;4031
250920;201802;3202;8841;2956;8446;340;917;2126;6045;2466;6962
250930;201802;2061;5879;1909;5657;91;342;1572;4561;1663;4903
250933;201802;1127;3568;1005;3327;42;207;728;2325;770;2532
250937;201802;694;1998;579;1786;35;128;429;1301;464;1429
250939;201802;1645;4610;1447;4311;41;175;1177;3412;1218;3587
250940;201802;3745;10708;3468;10267;52;192;3080;9129;3132;9321
250950;201802;1474;4115;1233;3802;33;132;1070;3293;1103;3425
250960;201802;1060;3276;975;3134;33;141;793;2495;826;2636
250970;201802;8488;22801;7264;20830;464;1496;5384;15204;5848;16700
250980;201802;2517;7132;2293;6717;61;258;1856;5266;1917;5524
250990;201802;1917;6231;1681;5727;100;461;1231;4072;1331;4533
251000;201802;2101;5994;1748;5430;43;194;1445;4435;1488;4629
251010;201802;2640;7606;2374;7190;36;131;2130;6451;2166;6582
251020;201802;1694;4590;1558;4422;48;151;1429;4042;1477;4193
251030;201802;1011;2823;884;2569;47;156;619;1742;666;1898
251040;201802;1769;5331;1544;4941;58;281;1238;3850;1296;4131
251050;201802;1096;3068;897;2683;88;290;633;1813;721;2103
251060;201802;1026;2283;755;1927;16;73;606;1499;622;1572
251065;201802;453;1288;373;1180;17;72;255;749;272;821
251070;201802;727;2111;646;2007;16;65;548;1685;564;1750
251080;201802;19346;51533;16169;46781;2575;7805;9251;27054;11826;34859
251090;201802;2855;8466;2430;7649;85;327;1881;5830;1966;6157
251100;201802;873;2731;773;2555;36;176;543;1701;579;1877
251110;201802;1756;4955;1525;4511;59;178;1159;3380;1218;3558
251120;201802;6604;20593;5911;19595;355;1456;4504;14796;4859;16252
251130;201802;3708;9113;3357;8725;259;703;2959;7677;3218;8380
251140;201802;4304;12517;3939;11988;117;477;3236;9768;3353;10245
251150;201802;2681;8086;2449;7729;141;594;1928;5920;2069;6514
251160;201802;1944;6140;1801;5924;89;299;1551;5126;1640;5425
251170;201802;1505;4345;1387;4207;41;148;1252;3805;1293;3953
251180;201802;2517;7316;2199;6837;220;760;1446;4444;1666;5204
251190;201802;4439;11911;4178;11599;76;277;3787;10342;3863;10619
251200;201802;4040;12660;3760;12309;87;350;3363;11074;3450;11424
251203;201802;946;3141;904;3054;33;152;687;2267;720;2419
251207;201802;1023;3059;840;2721;25;128;584;1831;609;1959
251210;201802;7585;20454;6296;18812;339;1021;4979;15021;5318;16042
251220;201802;1174;2987;936;2660;46;120;731;2101;777;2221
251230;201802;4641;12912;4112;12185;161;584;3456;10033;3617;10617
251240;201802;3449;9924;2973;9235;202;671;2220;6756;2422;7427
251250;201802;10076;28464;9111;27037;850;2737;6502;18781;7352;21518
251260;201802;459;1435;412;1348;14;62;314;1010;328;1072
251270;201802;4131;13169;3729;12651;125;572;3181;10795;3306;11367
251272;201802;1294;3605;1207;3481;41;155;1066;3052;1107;3207
251274;201802;902;2654;746;2374;51;212;511;1545;562;1757
251275;201802;1244;3552;1102;3312;44;183;829;2370;873;2553
251276;201802;1173;3365;1096;3260;51;226;902;2617;953;2843
251278;201802;596;1793;524;1656;48;176;354;1110;402;1286
251280;201802;2249;6455;2054;6136;57;261;1658;4779;1715;5040
251290;201802;5514;14617;5204;14219;341;1232;4313;11393;4654;12625
251300;201802;761;2420;714;2343;14;65;599;1944;613;2009
251310;201802;2788;8196;2550;7837;98;457;2044;6101;2142;6558
251315;201802;1649;5349;1530;5146;94;337;1186;3952;1280;4289
251320;201802;1729;4656;1230;3815;53;190;861;2652;914;2842
251330;201802;1887;4754;1548;4335;41;160;1397;3883;1438;4043
251335;201802;1117;3689;1021;3537;52;222;803;2736;855;2958
251340;201802;3475;9401;2916;8659;131;457;2220;6494;2351;6951
251350;201802;1111;3421;1023;3274;35;153;834;2590;869;2743
251360;201802;1791;5367;1479;4943;26;115;1275;4296;1301;4411
251365;201802;724;2115;587;1821;12;53;455;1396;467;1449
251370;201802;22823;67049;21580;65334;2166;7104;15922;47829;18088;54933
251380;201802;1283;3814;1100;3511;25;119;925;2851;950;2970
251385;201802;720;1885;567;1619;20;66;414;1119;434;1185
251390;201802;6017;19095;5273;17690;1010;3566;2752;9135;3762;12701
251392;201802;1006;2854;864;2615;41;168;641;1879;682;2047
251394;201802;631;1997;544;1844;29;125;412;1374;441;1499
251396;201802;757;2095;646;1912;38;101;441;1286;479;1387
251398;201802;921;2507;705;2128;26;108;501;1451;527;1559
251400;201802;1135;3082;940;2811;41;146;692;1998;733;2144
251410;201802;1608;3945;1320;3518;25;96;1099;2843;1124;2939
251420;201802;1886;5221;1579;4860;63;263;1231;3694;1294;3957
251430;201802;1543;5009;1393;4760;43;215;1200;4036;1243;4251
251440;201802;1130;3318;917;2904;25;94;725;2291;750;2385
251445;201802;1530;4510;1434;4381;81;324;1154;3425;1235;3749
251450;201802;4437;13616;4042;13068;87;390;3364;10777;3451;11167
251455;201802;1009;3118;896;2901;52;227;662;2095;714;2322
251460;201802;854;2538;764;2395;30;110;630;1997;660;2107
251465;201802;439;1352;367;1190;15;69;276;879;291;948
251470;201802;1143;3241;885;2692;79;248;543;1614;622;1862
251480;201802;927;2539;794;2318;25;112;594;1666;619;1778
251490;201802;1837;5184;1540;4755;121;402;1030;3140;1151;3542
251500;201802;1767;5420;1669;5244;84;335;1405;4340;1489;4675
251510;201802;2489;8009;2218;7443;214;820;1398;4590;1612;5410
251520;201802;950;2582;731;2141;86;231;452;1313;538;1544
251530;201802;12874;33409;11364;31433;185;852;10028;27227;10213;28079
251540;201802;2796;8605;2556;8158;121;462;2024;6350;2145;6812
251550;201802;3579;9001;2891;8112;76;249;2406;6723;2482;6972
251560;201802;606;1883;547;1788;93;334;326;1013;419;1347
251570;201802;939;2738;769;2397;23;94;563;1697;586;1791
251580;201802;1883;4856;1668;4558;145;397;1311;3522;1456;3919
251590;201802;1561;4274;1387;4052;57;187;1120;3224;1177;3411
251593;201802;978;2917;894;2791;113;368;545;1660;658;2028
251597;201802;1965;5845;1875;5726;30;115;1703;5150;1733;5265
251600;201802;6459;18190;5837;17236;213;699;4853;14145;5066;14844
251610;201802;3328;9619;2888;8809;314;896;1977;6099;2291;6995
251615;201802;1152;3114;927;2731;27;118;685;1939;712;2057
251620;201802;16975;41848;14043;38376;288;717;11732;33557;12020;34274
251630;201802;4639;11484;3786;10298;216;612;2866;7730;3082;8342
251640;201802;2089;6180;1903;5824;69;297;1610;4815;1679;5112
251650;201802;4071;11138;3633;10570;169;585;3086;8912;3255;9497
251660;201802;3467;10729;3084;10046;89;442;2560;8147;2649;8589
251670;201802;4358;12516;3853;11840;38;183;3538;10885;3576;11068
251675;201802;695;2093;634;2010;97;340;402;1251;499;1591
251680;201802;2677;7510;2193;6794;59;212;1767;5447;1826;5659
251690;201802;3297;9545;2885;8757;84;293;2104;6251;2188;6544
251700;201802;1897;5963;1761;5783;80;380;1469;4706;1549;5086
251710;201802;835;2203;564;1629;54;189;287;791;341;980
251720;201802;1392;4081;1164;3658;34;150;885;2693;919;2843
251740;201802;691;1935;543;1671;37;128;371;1102;408;1230
260005;201802;27160;61691;22326;55202;2689;6660;15065;36886;17754;43546
260010;201802;9815;26161;8144;23733;590;1773;5058;15018;5648;16791
260020;201802;6620;16539;5569;15009;149;611;4640;12280;4789;12891
260030;201802;6264;17142;5398;15785;271;908;4231;12347;4502;13255
260040;201802;8363;22483;6916;20435;677;1935;4793;14437;5470;16372
260050;201802;11819;34357;10738;33070;439;1439;9215;28881;9654;30320
260060;201802;3897;10517;3362;9618;256;700;2518;7239;2774;7939
260070;201802;9985;27172;8789;25337;696;2321;6402;18099;7098;20420
260080;201802;6505;15687;5642;14426;201;593;4597;11474;4798;12067
260090;201802;5193;13576;4699;12925;586;1568;3422;9532;4008;11100
260100;201802;3233;8732;2741;8032;124;454;2229;6478;2353;6932
260105;201802;5210;14058;4672;13307;134;551;3923;10909;4057;11460
260110;201802;22524;60152;20357;57351;1062;3210;17301;48496;18363;51706
260120;201802;13629;38465;11753;35425;1848;5660;6931;21452;8779;27112
260130;201802;3097;8421;2824;7989;265;798;2069;5748;2334;6546
260140;201802;13080;31100;11120;28650;613;1708;9109;23498;9722;25206
260150;201802;3385;8567;2916;7989;161;518;2403;6503;2564;7021
260160;201802;5958;17243;5111;16118;132;575;4369;13866;4501;14441
260170;201802;17438;46261;15679;43763;1449;3921;11873;33301;13322;37222
260180;201802;3311;9531;2974;9040;160;582;2488;7461;2648;8043
260190;201802;17051;37255;14929;34740;252;751;13028;29790;13280;30541
260200;201802;11265;27759;9869;26011;376;1088;8656;22710;9032;23798
260210;201802;11985;34881;10321;32179;390;1537;8295;25766;8685;27303
260220;201802;9769;25617;9229;24936;263;895;8304;22172;8567;23067
260230;201802;10075;26906;8874;25216;366;1241;7085;19932;7451;21173
260240;201802;2842;8440;2467;7857;206;687;1840;5868;2046;6555
260250;201802;2188;6007;1901;5589;84;294;1521;4367;1605;4661
260260;201802;12392;34182;10924;31946;548;1954;8509;24534;9057;26488
260270;201802;3605;10083;3277;9610;190;798;2528;7172;2718;7970
260280;201802;13022;40545;11873;38886;561;2102;10089;32977;10650;35079
260290;201802;36172;99979;32216;93784;4495;13683;20188;58196;24683;71879
260300;201802;9143;26331;8047;24726;283;1229;6500;19888;6783;21117
260310;201802;4502;12665;4029;11988;539;1500;2780;8524;3319;10024
260320;201802;7486;22530;6706;21179;287;1017;5445;17084;5732;18101
260330;201802;2557;8063;2329;7603;89;337;1835;5849;1924;6186
260340;201802;1980;5473;1750;5142;31;120;1526;4443;1557;4563
260345;201802;23646;67268;20794;62744;4460;14438;9102;26618;13562;41056
260350;201802;4991;12909;4524;12281;141;487;3922;10522;4063;11009
260360;201802;2501;6837;2263;6416;91;389;1549;4295;1640;4684
260370;201802;5515;16437;4811;15200;259;1032;3632;11323;3891;12355
260380;201802;4869;15209;4268;14233;226;888;3137;10340;3363;11228
260390;201802;4228;13164;3652;11994;269;990;2487;8029;2756;9019
260392;201802;3463;11124;3143;10696;165;859;2586;8654;2751;9513
260400;201802;15020;38859;13397;36602;1096;3331;9944;26612;11040;29943
260410;201802;61800;165674;50720;149310;11547;36071;20987;63403;32534;99474
260415;201802;3834;11255;3311;10261;139;624;2393;7131;2532;7755
260420;201802;12782;28056;11030;26083;186;581;10006;23418;10192;23999
260430;201802;2882;9029;2489;8277;153;593;1732;5693;1885;6286
260440;201802;3506;9878;3051;9065;188;698;2298;6649;2486;7347
260450;201802;5368;14428;4947;13901;193;562;4263;12014;4456;12576
260460;201802;5445;17057;4800;15804;643;2365;2761;8873;3404;11238
260470;201802;4848;13277;4166;12495;124;321;3692;11379;3816;11700
260480;201802;4219;11379;3557;10432;374;1234;2339;6984;2713;8218
260490;201802;5123;12751;4490;11681;113;407;3861;9764;3974;10171
260500;201802;6087;16343;5149;14944;580;1623;3399;10017;3979;11640
260510;201802;9415;23496;8151;21806;235;772;7200;19070;7435;19842
260515;201802;4547;13168;3469;11059;175;625;2246;7063;2421;7688
260520;201802;17510;42527;15789;40236;1161;3050;12553;31738;13714;34788
260530;201802;9473;28327;8254;26399;237;1070;6957;22058;7194;23128
260540;201802;6342;14959;5660;14163;536;1108;4701;12061;5237;13169
260545;201802;48;145;25;98;6;22;5;21;11;43
260550;201802;2870;8716;2388;7742;212;844;1435;4572;1647;5416
260560;201802;6178;16029;5356;14868;143;590;4546;12410;4689;13000
260570;201802;7181;21308;6479;20289;593;1929;4981;15616;5574;17545
260580;201802;3995;10405;3581;9800;49;204;3218;8704;3267;8908
260590;201802;6659;16040;5760;15022;262;718;4900;12835;5162;13553
260600;201802;29712;81568;25031;74253;1453;5120;18350;53685;19803;58805
260610;201802;6545;18572;6073;17898;515;1628;4512;13197;5027;14825
260620;201802;14923;43332;13919;41737;2018;6654;8904;26144;10922;32798
260630;201802;2367;6484;1978;5880;46;205;1640;4829;1686;5034
260640;201802;18902;47257;16558;44433;1215;3630;12570;33402;13785;37032
260650;201802;5487;16168;4698;14932;202;866;3862;12162;4064;13028
260660;201802;7516;20163;6550;18929;188;785;5564;15817;5752;16602
260670;201802;2281;5979;1882;5394;97;275;1357;3877;1454;4152
260680;201802;23737;61871;20239;56504;2633;7557;11632;32234;14265;39791
260690;201802;3612;9560;3007;8612;118;380;2415;6871;2533;7251
260700;201802;5841;17384;5616;17131;22;39;5470;16868;5492;16907
260710;201802;1325;3610;1239;3496;60;196;902;2607;962;2803
260720;201802;19654;56738;17675;53689;3035;9397;10375;31457;13410;40854
260730;201802;7065;21784;6344;20743;401;1572;5125;16441;5526;18013
260740;201802;1317;3805;1159;3549;24;85;962;2954;986;3039
260750;201802;7039;19964;6039;18683;157;464;5408;16989;5565;17453
260760;201802;5304;13304;4669;12519;220;668;3796;10231;4016;10899
260765;201802;7614;24307;6859;23160;805;3268;4503;14832;5308;18100
260770;201802;3778;10065;3301;9270;109;358;2594;7231;2703;7589
260775;201802;5111;14326;4654;13656;311;1180;3454;9825;3765;11005
260780;201802;3696;11347;3348;10733;443;1586;2096;6568;2539;8154
260790;201802;113522;271634;98260;250711;17547;44868;56688;144194;74235;189062
260795;201802;3119;8657;2717;8044;157;525;2036;6057;2193;6582
260800;201802;5491;13150;4994;12463;119;409;4464;10794;4583;11203
260805;201802;3649;10820;3085;9855;223;819;2141;6766;2364;7585
260810;201802;6511;18270;5974;17265;559;1631;4375;12461;4934;14092
260820;201802;4254;10988;3758;10272;317;1099;2732;7223;3049;8322
260825;201802;2871;8937;2521;8332;142;574;1862;6099;2004;6673
260830;201802;4126;12541;3474;11299;473;1446;2291;7591;2764;9037
260840;201802;4172;11576;3664;10828;194;589;2983;8763;3177;9352
260845;201802;4074;11390;3775;10849;301;872;2780;7965;3081;8837
260850;201802;4972;15006;4323;13669;550;1834;2472;7680;3022;9514
260860;201802;3556;10369;3012;9353;115;450;2369;7209;2484;7659
260870;201802;4384;11082;3808;10355;135;484;3291;8788;3426;9272
260875;201802;6500;17604;5553;16100;772;2243;3516;10300;4288;12543
260880;201802;9883;28356;8761;26490;415;1317;7014;21307;7429;22624
260890;201802;13176;36109;11922;34257;927;3011;8583;24231;9510;27242
260900;201802;5535;16638;4739;15212;337;1316;3151;9918;3488;11234
260910;201802;3130;8997;2771;8408;125;437;2114;6367;2239;6804
260915;201802;4936;15137;4422;14508;80;361;3993;13137;4073;13498
260920;201802;3290;9452;2959;9021;127;437;2485;7666;2612;8103
260930;201802;3672;11960;3266;11251;223;867;2450;8427;2673;9294
260940;201802;14441;36124;12790;33674;1114;3202;9173;23700;10287;26902
260950;201802;6542;19227;5403;17008;736;2492;2727;8189;3463;10681
260960;201802;61614;153554;51645;139306;8146;23396;28699;76216;36845;99612
260970;201802;5038;14365;4540;13715;199;589;3558;10892;3757;11481
260980;201802;4229;13044;3869;12589;80;332;3488;11374;3568;11706
260990;201802;17478;51096;15298;48111;968;3446;11755;36883;12723;40329
261000;201802;15877;40597;13176;36743;988;3081;9045;25360;10033;28441
261010;201802;2485;6693;2236;6376;80;198;2005;5756;2085;5954
261020;201802;6409;18081;5528;16451;422;1373;4133;11951;4555;13324
261030;201802;4030;11594;3497;10726;229;670;2713;8325;2942;8995
261040;201802;5133;15929;4295;14186;290;1094;3051;9884;3341;10978
261050;201802;7498;21006;6827;19867;679;1942;4502;13076;5181;15018
261060;201802;12886;35000;11581;33113;767;2408;8996;25475;9763;27883
261070;201802;55443;128521;47022;116998;4184;10296;33346;82343;37530;92639
261080;201802;5840;15844;5491;15349;225;624;4885;13719;5110;14343
261090;201802;16867;43822;15307;41735;541;1766;12990;35131;13531;36897
261100;201802;8056;24199;7088;22642;797;2668;4752;15392;5549;18060
261110;201802;60398;176645;52326;163624;12211;39973;23687;75498;35898;115471
261120;201802;3789;9790;3267;9146;71;227;2913;8193;2984;8420
261130;201802;7490;18346;6673;17352;160;464;5898;15258;6058;15722
261140;201802;3359;8507;3000;7997;259;735;2254;5950;2513;6685
261150;201802;5288;14621;4675;13666;165;595;3944;11431;4109;12026
261153;201802;1971;5903;1688;5440;83;336;1168;3722;1251;4058
261160;201802;205264;511604;177084;471940;44518;123414;71571;194582;116089;317996
261170;201802;5663;14820;5149;14070;300;816;4111;11174;4411;11990
261180;201802;9845;26057;8843;24706;681;2134;6259;17285;6940;19419
261190;201802;4950;14942;4502;14298;403;1573;3231;10005;3634;11578
261200;201802;3494;8324;3068;7788;250;680;2423;6083;2673;6763
261210;201802;1907;4812;1687;4500;67;205;1478;3926;1545;4131
261220;201802;13557;40278;11360;35962;1585;5410;6334;19915;7919;25325
261230;201802;4693;13775;3989;12892;92;382;3353;10964;3445;11346
261240;201802;4985;13538;4430;12657;336;940;3467;9923;3803;10863
261245;201802;3516;10458;3012;9574;123;566;2360;7252;2483;7818
261247;201802;3015;9170;2555;8332;162;616;1809;5855;1971;6471
261250;201802;19455;48543;17022;45591;2957;7628;10844;30245;13801;37873
261255;201802;4033;12247;3531;11316;188;817;2719;8451;2907;9268
261260;201802;12646;34751;11031;32722;401;1522;9275;27493;9676;29015
261270;201802;3933;10974;3517;10332;241;818;2716;7773;2957;8591
261280;201802;2571;7502;2313;7061;102;420;1830;5440;1932;5860
261290;201802;2955;8120;2577;7631;130;480;2032;6053;2162;6533
261300;201802;11306;33956;9761;31153;736;2824;6798;21212;7534;24036
261310;201802;7245;20933;6493;19812;1234;3857;3846;11680;5080;15537
261320;201802;5885;17333;5204;16130;132;525;4284;13073;4416;13598
261330;201802;5722;15281;5298;14724;190;766;4569;12414;4759;13180
261340;201802;4057;12562;3575;11854;231;987;2624;8632;2855;9619
261350;201802;8211;25365;7610;24372;170;845;6260;19687;6430;20532
261360;201802;8304;21022;7161;19413;372;1092;5732;15222;6104;16314
261370;201802;19651;55024;17734;52153;3391;10178;9979;29598;13370;39776
261380;201802;3966;12919;3634;12246;535;1987;2246;7431;2781;9418
261390;201802;16229;48027;14206;44615;1588;5405;8780;27494;10368;32899
261400;201802;4663;15478;4106;14297;197;900;2993;10206;3190;11106
261410;201802;9243;24570;7908;22436;585;1708;6210;17567;6795;19275
261420;201802;7138;23121;6679;22518;1157;4405;4182;13994;5339;18399
261430;201802;3480;10255;2954;9435;131;463;2370;7565;2501;8028
261440;201802;1526;4684;1346;4343;47;225;954;2984;1001;3209
261450;201802;13914;39128;12952;37761;349;1316;11012;31949;11361;33265
261460;201802;7024;20076;6468;19273;271;911;5577;16540;5848;17451
261470;201802;4169;10926;3745;10364;58;278;3105;8614;3163;8892
261480;201802;4497;14594;3975;13711;224;950;3047;10275;3271;11225
261485;201802;5037;14803;4389;13752;445;1609;2945;9037;3390;10646
261500;201802;5584;15148;4903;14230;428;1203;3535;10539;3963;11742
261510;201802;1839;5771;1608;5353;88;355;1194;3993;1282;4348
261520;201802;2591;8017;2418;7697;90;362;1638;5327;1728;5689
261530;201802;10616;33511;9232;30761;1445;5446;4246;13943;5691;19389
261540;201802;7458;22633;6778;21557;1221;3911;3907;12737;5128;16648
261550;201802;3593;9761;3191;9144;248;816;2350;6620;2598;7436
261560;201802;7376;23027;6529;21817;473;1923;4875;16248;5348;18171
261570;201802;3458;9830;2913;8928;241;859;1953;5882;2194;6741
261580;201802;6567;17866;5932;16932;155;665;5260;14800;5415;15465
261590;201802;2671;7073;2192;6365;103;315;1687;4934;1790;5249
261600;201802;5196;13688;4398;12517;389;1097;3011;8720;3400;9817
261610;201802;2466;6712;2081;6130;76;290;1630;4784;1706;5074
261618;201802;2493;6591;2231;6238;96;300;1833;5051;1929;5351
261620;201802;3948;12004;3678;11567;832;2473;2159;7106;2991;9579
261630;201802;7030;20069;5944;18088;528;1956;3650;10626;4178;12582
261640;201802;35485;83587;31557;78902;1855;4188;25330;65032;27185;69220
261650;201802;4061;10975;3619;10394;150;578;2715;7839;2865;8417
270010;201802;4321;15430;3909;14641;200;1059;3071;11279;3271;12338
270020;201802;3923;10279;3495;9711;232;799;2836;7636;3068;8435
270030;201802;35402;101384;31299;94749;4980;15187;19154;58535;24134;73722
270040;201802;10943;30918;9648;29326;558;2034;7795;23641;8353;25675
270050;201802;4825;12097;4200;11391;234;633;3613;9875;3847;10508
270060;201802;1922;5328;1712;5054;190;544;1235;3737;1425;4281
270070;201802;4515;13358;3995;12616;157;722;3346;10312;3503;11034
270080;201802;1358;4000;1141;3601;94;318;822;2520;916;2838
270090;201802;1998;6188;1775;5748;80;370;1378;4295;1458;4665
270100;201802;5592;15903;4973;14973;362;1318;3847;11358;4209;12676
270110;201802;3056;7942;2536;7372;196;593;1979;5885;2175;6478
270120;201802;3033;8306;2665;7845;90;360;2355;6882;2445;7242
270130;201802;5347;14660;4677;13897;310;998;3749;11273;4059;12271
270135;201802;1942;4923;1694;4634;75;187;1516;4169;1591;4356
270140;201802;10456;24119;8549;21600;452;1739;6893;16455;7345;18194
270150;201802;2645;8229;2538;8098;24;74;2476;7912;2500;7986
270160;201802;5218;16202;4610;15443;118;606;4004;13282;4122;13888
270170;201802;3619;11073;3185;10467;311;1334;2243;7121;2554;8455
270180;201802;2273;7189;2082;6924;69;330;1774;5785;1843;6115
270190;201802;1734;5369;1603;5189;78;289;1314;4260;1392;4549
270200;201802;2538;7968;2239;7570;164;685;1641;5402;1805;6087
270210;201802;5373;13896;4724;13114;191;628;4172;11481;4363;12109
270220;201802;1324;3964;1167;3742;216;780;670;2082;886;2862
270230;201802;9955;29959;8533;27647;908;3516;5387;16898;6295;20414
270235;201802;6005;19096;5424;18110;274;1153;4342;14332;4616;15485
270240;201802;10625;29613;8797;27307;1190;4032;5958;18460;7148;22492
270250;201802;2928;7687;2623;7295;284;740;1983;5569;2267;6309
270255;201802;4727;13866;3660;11906;202;839;2603;8243;2805;9082
270260;201802;5654;17314;5318;16788;171;804;4574;14005;4745;14809
270270;201802;1085;2980;993;2858;160;484;630;1779;790;2263
270280;201802;3806;9841;3107;8938;411;850;2171;6570;2582;7420
270290;201802;7850;25830;7204;24742;355;1658;5922;19969;6277;21627
270300;201802;4045;11358;3259;10500;270;951;2359;7656;2629;8607
270310;201802;7260;21179;6347;19758;192;984;5273;15887;5465;16871
270320;201802;5838;17519;5300;16571;674;2228;3634;11169;4308;13397
270330;201802;3902;13201;3575;12747;320;1220;2744;9849;3064;11069
270340;201802;1648;4803;1413;4485;85;328;1130;3516;1215;3844
270350;201802;1925;4851;1640;4499;169;521;1189;3273;1358;3794
270360;201802;2262;6343;2069;6116;109;312;1841;5512;1950;5824
270370;201802;1436;4616;1314;4393;62;277;1021;3382;1083;3659
270375;201802;2997;7593;2560;7043;58;191;2298;6306;2356;6497
270380;201802;5784;17164;5058;16194;459;1551;3662;11902;4121;13453
270390;201802;1259;3309;1043;3012;31;119;828;2356;859;2475
270400;201802;6244;17790;5409;16464;238;899;4102;12107;4340;13006
270410;201802;4635;14225;4162;13405;293;1113;3102;9842;3395;10955
270420;201802;5754;17588;5352;17061;212;948;4403;13750;4615;14698
270430;201802;135870;360713;112564;329122;28260;87322;42725;128684;70985;216006
270440;201802;4892;13701;4250;12903;138;563;3473;10510;3611;11073
270450;201802;6604;18908;5976;18143;333;1250;4876;14647;5209;15897
270460;201802;3430;8429;3031;7955;82;256;2714;7022;2796;7278
270470;201802;10774;32565;9608;30834;1047;3671;6588;21370;7635;25041
270480;201802;2888;8308;2483;7664;220;825;1849;5511;2069;6336
270490;201802;986;2940;880;2811;49;191;693;2194;742;2385
270500;201802;4864;15523;4467;15003;196;920;3707;12259;3903;13179
270510;201802;5909;16602;5157;15557;563;2106;3629;10441;4192;12547
270520;201802;3749;11364;3146;10302;886;3087;1042;3574;1928;6661
270530;201802;1223;3721;1117;3563;71;236;833;2665;904;2901
270540;201802;2099;6502;1882;6214;86;421;1579;5070;1665;5491
270550;201802;6910;18887;5750;17596;546;1634;4310;13543;4856;15177
270560;201802;3197;8965;2839;8455;176;605;2191;6434;2367;7039
270570;201802;3843;11779;3364;11022;181;754;2680;8640;2861;9394
270580;201802;2175;6410;2046;6234;82;252;1791;5495;1873;5747
270590;201802;1494;4614;1403;4502;7;25;1368;4396;1375;4421
270600;201802;2806;8931;2510;8446;119;609;2090;6823;2209;7432
270610;201802;3543;9853;3030;9202;122;484;2609;7778;2731;8262
270620;201802;1354;4277;1244;4079;55;242;1033;3294;1088;3536
270630;201802;15192;43204;13543;40630;1319;4141;9908;29865;11227;34006
270640;201802;5685;16754;4958;15661;237;973;3962;12200;4199;13173
270642;201802;2359;7922;2167;7644;152;764;1690;5774;1842;6538
270644;201802;3101;8397;2610;7748;245;735;1921;5805;2166;6540
270650;201802;3513;10563;3185;10104;436;1752;2172;6541;2608;8293
270660;201802;2177;5487;1735;4876;77;247;1287;3584;1364;3831
270670;201802;16275;40055;13826;37186;1096;2953;10778;29239;11874;32192
270680;201802;4846;12863;4382;12341;89;195;4094;11614;4183;11809
270690;201802;9585;24325;8125;22665;1363;3542;5616;16148;6979;19690
270700;201802;559;1742;485;1606;54;226;325;1039;379;1265
270710;201802;5932;18009;5503;17460;293;1290;4576;14193;4869;15483
270720;201802;3396;10754;3021;10110;102;601;2524;8226;2626;8827
270730;201802;6986;18190;6466;17620;426;1058;5421;15417;5847;16475
270740;201802;2329;6311;2091;6012;100;368;1747;4937;1847;5305
270750;201802;5272;15215;4685;14365;344;1261;3652;11121;3996;12382
270760;201802;3537;10072;3073;9381;89;388;2587;7780;2676;8168
270770;201802;20669;51763;16566;46801;3110;8406;9273;28059;12383;36465
270780;201802;1809;5463;1703;5312;109;370;1402;4389;1511;4759
270790;201802;1560;4654;1394;4421;190;636;907;2895;1097;3531
270800;201802;10977;31405;9936;29952;476;2016;8383;24630;8859;26646
270810;201802;3156;9459;2514;8323;202;839;1690;5481;1892;6320
270820;201802;1731;5366;1477;4930;139;533;1053;3469;1192;4002
270830;201802;5685;13998;4777;12866;305;904;3794;10315;4099;11219
270840;201802;8232;24794;7434;23691;227;1227;6472;20042;6699;21269
270850;201802;8205;22298;7406;21267;553;2069;5887;16186;6440;18255
270860;201802;11169;29245;9363;27069;699;2325;7127;20278;7826;22603
270870;201802;2123;6256;1804;5650;200;684;1234;3817;1434;4501
270880;201802;8288;25222;7526;24135;339;1443;6157;19387;6496;20830
270890;201802;2500;7241;2207;6809;173;630;1593;4800;1766;5430
270895;201802;2951;9975;2765;9720;97;543;2421;8304;2518;8847
270900;201802;1810;4805;1424;4197;58;198;1123;3228;1181;3426
270910;201802;3623;11162;3193;10427;150;651;2414;7721;2564;8372
270915;201802;9117;28651;7801;26284;1004;3884;4863;16037;5867;19921
270920;201802;5922;18303;5548;17752;266;1264;4667;14433;4933;15697
270930;201802;16758;42232;13447;38341;2329;6279;8679;25640;11008;31919
270940;201802;5827;17818;5262;17101;330;1495;4000;12676;4330;14171
280010;201802;669;1846;572;1675;26;114;403;1088;429;1202
280020;201802;4818;13119;4155;12041;542;1583;2707;7829;3249;9412
280030;201802;71945;180329;58843;161643;15678;44489;21883;62811;37561;107300
280040;201802;3154;9001;2773;8417;295;942;1915;5769;2210;6711
280050;201802;3643;11091;3309;10563;613;2070;1917;6081;2530;8151
280060;201802;5069;14748;4200;13328;749;2513;2083;6784;2832;9297
280067;201802;6898;18518;5852;16867;591;1747;3917;11227;4508;12974
280070;201802;1956;6146;1872;6009;127;416;1547;4943;1674;5359
280100;201802;3721;10935;3286;10224;382;1326;2240;6950;2622;8276
280110;201802;1323;3941;1203;3738;50;207;995;2984;1045;3191
280120;201802;7825;23526;7067;22278;862;2524;5078;16417;5940;18941
280130;201802;8330;21297;7462;20047;753;2100;5545;14940;6298;17040
280140;201802;5662;14345;5107;13571;329;884;4169;11065;4498;11949
280150;201802;3759;10221;3432;9779;211;659;2796;7884;3007;8543
280160;201802;1262;3720;1048;3343;150;506;640;2004;790;2510
280170;201802;5090;13958;4621;13307;289;821;3754;10919;4043;11740
280190;201802;1221;2932;1014;2635;60;185;800;2005;860;2190
280200;201802;1178;3377;1023;3098;102;372;742;2182;844;2554
280210;201802;14848;40188;13045;37698;2255;6729;7403;21785;9658;28514
280220;201802;1784;4878;1574;4593;51;225;1276;3729;1327;3954
280230;201802;3433;9573;3088;9062;242;805;2338;6724;2580;7529
280240;201802;3447;9412;3118;8905;89;372;2638;7379;2727;7751
280250;201802;843;2177;668;1896;78;251;372;1007;450;1258
280260;201802;2085;5358;1918;5157;52;149;1775;4774;1827;4923
280270;201802;2223;6590;1992;6228;105;389;1674;5151;1779;5540
280280;201802;4137;13241;3723;12603;584;1740;2390;8563;2974;10303
280290;201802;17120;48886;15297;46230;1767;5968;9830;29768;11597;35736
280300;201802;10210;28054;8980;26662;481;1667;6900;21416;7381;23083
280310;201802;1357;3694;1145;3327;34;126;851;2394;885;2520
280320;201802;8685;25263;7721;23780;957;3191;4858;14736;5815;17927
280330;201802;4636;12077;4047;11217;273;868;3168;8524;3441;9392
280340;201802;4844;11164;4164;10394;253;616;3539;8978;3792;9594
280350;201802;22652;59623;19691;55297;2126;6188;13613;38230;15739;44418
280360;201802;5723;16961;5199;16060;886;2804;2960;9246;3846;12050
280370;201802;2023;5192;1688;4654;99;268;1292;3528;1391;3796
280380;201802;1016;2946;886;2749;98;358;604;1831;702;2189
280390;201802;3073;8645;2673;7922;146;508;2028;5922;2174;6430
280400;201802;3852;10567;3427;9946;675;1865;1945;5905;2620;7770
280410;201802;2141;6505;1776;5812;195;685;1042;3316;1237;4001
280420;201802;4280;11844;3898;11296;135;433;3431;9924;3566;10357
280430;201802;2114;5358;1865;5015;76;273;1466;3858;1542;4131
280440;201802;4747;12932;4162;12131;286;903;3277;9386;3563;10289
280445;201802;2363;6214;2116;5777;48;162;1610;4228;1658;4390
280450;201802;10028;23866;9026;22582;409;830;7815;19809;8224;20639
280460;201802;6665;16846;6061;15974;567;1502;4791;12640;5358;14142
280470;201802;1803;5224;1607;4884;76;266;1211;3664;1287;3930
280480;201802;34415;92799;31146;88171;3417;10746;21517;59844;24934;70590
280490;201802;3886;11301;3302;10319;121;525;2473;7512;2594;8037
280500;201802;930;2361;813;2198;32;102;678;1823;710;1925
280510;201802;2531;7167;2228;6723;116;469;1617;4825;1733;5294
280520;201802;1718;4499;1531;4248;98;252;1250;3477;1348;3729
280530;201802;2497;6366;2250;6064;128;366;1829;4909;1957;5275
280540;201802;9105;24863;8324;23764;209;980;7315;20342;7524;21322
280550;201802;6860;16905;5638;15055;317;861;4311;11325;4628;12186
280560;201802;7242;20911;6821;20312;218;866;5910;17279;6128;18145
280570;201802;6361;16516;5281;15096;309;1032;3822;10834;4131;11866
280580;201802;5331;15710;4620;14496;600;1816;3015;9626;3615;11442
280590;201802;2721;7114;2367;6661;158;649;1691;4547;1849;5196
280600;201802;3396;9802;3073;9340;232;797;2280;6868;2512;7665
280610;201802;2481;6393;2252;6088;167;467;1806;4827;1973;5294
280620;201802;5405;14413;4661;13288;450;1097;3309;9845;3759;10942
280630;201802;3651;11387;3318;10874;223;795;2570;8521;2793;9316
280640;201802;2350;6733;2169;6533;52;137;2022;6154;2074;6291
280650;201802;1083;3107;935;2899;91;330;678;2050;769;2380
280660;201802;2837;7329;2606;7055;150;403;2232;6041;2382;6444
280670;201802;17763;43245;15831;40732;1366;3747;11796;30332;13162;34079
280680;201802;2823;7196;2387;6497;161;384;1783;4803;1944;5187
280690;201802;965;2545;828;2355;51;155;611;1705;662;1860
280700;201802;1081;2938;951;2728;26;90;728;2061;754;2151
280710;201802;13926;32976;12106;30873;584;1041;10542;27715;11126;28756
280720;201802;2562;6050;2196;5616;145;400;1487;4060;1632;4460
280730;201802;1106;2820;992;2655;67;224;777;2034;844;2258
280740;201802;13631;35221;11653;32139;1225;3373;7684;21182;8909;24555
280750;201802;3472;10166;3138;9579;202;732;2258;6788;2460;7520
280760;201802;5841;16902;5202;15888;663;2073;3320;10419;3983;12492
290010;201802;3029;6602;2128;5210;15;56;1757;4091;1772;4147
290020;201802;5005;14459;4743;14098;281;662;4102;12387;4383;13049
290030;201802;3762;9999;3274;9419;201;555;2737;7889;2938;8444
290035;201802;5149;11785;4144;10472;265;558;3274;8563;3539;9121
290040;201802;4425;10865;3697;10013;172;513;2879;7971;3051;8484
290050;201802;2226;7234;1916;6642;140;568;1330;4565;1470;5133
290060;201802;1336;3371;1033;2906;110;383;694;1868;804;2251
290070;201802;33799;81105;29117;75076;3376;8903;18650;48954;22026;57857
290080;201802;5703;16836;4812;15578;632;2108;3133;10352;3765;12460
290090;201802;2342;4476;1764;3870;48;98;1616;3548;1664;3646
290100;201802;9211;25450;7852;23368;1066;3043;4803;14711;5869;17754
290110;201802;4995;14060;4611;13394;515;1563;3124;8981;3639;10544
290115;201802;4399;12775;3854;12029;200;698;3124;9805;3324;10503
290120;201802;6994;17323;5719;15773;160;572;4858;13190;5018;13762
290130;201802;4602;11661;3697;10539;126;537;2969;8271;3095;8808
290135;201802;4530;10833;3726;9563;256;722;2767;6901;3023;7623
290140;201802;4580;12885;3764;11839;153;554;3254;10256;3407;10810
290150;201802;2262;6542;2122;6319;192;606;1593;4636;1785;5242
290160;201802;3210;7898;2970;7596;375;787;2263;5914;2638;6701
290170;201802;2785;8217;2570;7948;76;318;2304;7069;2380;7387
290180;201802;2935;8224;2444;7440;109;397;1917;5784;2026;6181
290190;201802;3989;12312;3640;11819;201;867;2865;9124;3066;9991
290195;201802;2346;6130;1890;5429;59;268;1529;4322;1588;4590
290200;201802;4009;11684;3431;10776;216;705;2672;8372;2888;9077
290205;201802;3447;9142;3039;8543;129;486;2416;6602;2545;7088
290210;201802;13579;39057;12079;36993;1161;3201;9061;28695;10222;31896
290220;201802;2714;7152;2477;6855;169;526;2017;5489;2186;6015
290225;201802;3509;7578;2878;6906;40;89;2707;6520;2747;6609
290230;201802;2380;7011;2178;6775;90;358;1865;5779;1955;6137
290240;201802;3730;9692;3114;8909;145;489;2494;7026;2639;7515
290250;201802;3978;11904;3599;11409;110;286;3071;10198;3181;10484
290260;201802;5356;14092;4374;12635;237;824;3439;9836;3676;10660
290265;201802;3585;10590;2996;9526;137;583;2279;7147;2416;7730
290270;201802;11976;41462;11315;40353;839;3521;8762;30929;9601;34450
290280;201802;5800;17642;5202;16668;385;1349;3838;12228;4223;13577
290290;201802;9964;30000;8477;27338;849;2860;5861;18889;6710;21749
290300;201802;4540;12519;3272;10111;194;700;2256;6964;2450;7664
290310;201802;1527;4158;1279;3806;116;433;894;2591;1010;3024
290320;201802;25762;70661;21756;65248;5469;16725;10166;31771;15635;48496
290323;201802;3631;10030;3240;9503;79;272;2692;7792;2771;8064
290327;201802;4348;12650;3761;11560;333;1015;2655;8179;2988;9194
290330;201802;2009;4552;1707;4217;51;97;1538;3840;1589;3937
290340;201802;5727;15748;4667;14420;767;2513;3053;9518;3820;12031
290350;201802;4693;13928;3984;12710;347;1170;2823;9099;3170;10269
290360;201802;4965;13777;4303;12903;111;374;3682;11089;3793;11463
290370;201802;5132;13008;3971;11486;228;602;3068;9043;3296;9645
290380;201802;5627;15544;4854;14446;151;519;4123;12344;4274;12863
290390;201802;14930;43442;12900;40443;1454;4704;8563;27404;10017;32108
290395;201802;2744;8512;2323;7750;79;374;1804;5972;1883;6346
290400;201802;3706;10433;3022;9346;165;597;2211;6710;2376;7307
290405;201802;4738;14177;3987;12841;286;995;2754;8994;3040;9989
290410;201802;5698;16168;4585;14357;180;788;3473;10491;3653;11279
290420;201802;3054;8685;2550;7900;153;491;1964;6081;2117;6572
290430;201802;3185;9316;2655;8440;370;1233;1641;5242;2011;6475
290440;201802;2941;7465;2233;6439;86;288;1608;4687;1694;4975
290450;201802;3272;9132;2725;8334;137;526;2085;6230;2222;6756
290460;201802;12230;34601;10676;31709;2896;8827;4038;11872;6934;20699
290470;201802;4443;11833;3321;10162;537;1808;1648;5161;2185;6969
290475;201802;6111;18474;5299;17008;118;595;4209;13228;4327;13823
290480;201802;2025;5318;1787;4976;153;461;1168;3248;1321;3709
290485;201802;4679;14147;4041;13179;160;812;3396;10852;3556;11664
290490;201802;8774;21640;8071;20724;581;1518;6390;16507;6971;18025
290500;201802;3972;12174;3106;10375;403;1413;1620;5366;2023;6779
290510;201802;3296;8788;2831;8155;104;375;2407;6839;2511;7214
290515;201802;3765;10088;3138;9285;85;226;2723;8242;2808;8468
290520;201802;11431;34155;9103;29593;408;1719;6070;19317;6478;21036
290530;201802;5055;14635;4405;13601;205;650;3609;11153;3814;11803
290540;201802;3707;10175;3332;9686;96;302;2954;8548;3050;8850
290550;201802;4427;11515;3907;10926;48;152;3621;10202;3669;10354
290560;201802;6769;18126;5454;16188;580;1953;3714;10813;4294;12766
290570;201802;43662;113133;39671;108019;2934;8363;30677;83005;33611;91368
290580;201802;7596;23706;6865;22626;673;2177;5119;17259;5792;19436
290590;201802;7102;22226;6120;20466;177;757;5010;16745;5187;17502
290600;201802;18059;52345;16442;49934;947;2956;13068;40169;14015;43125
290610;201802;2490;8152;2017;7205;112;485;1389;4897;1501;5382
290620;201802;6313;18203;5678;17197;236;775;4792;14415;5028;15190
290630;201802;9085;22415;7327;20186;610;1691;5722;15855;6332;17546
290640;201802;2697;7428;2077;6407;97;319;1601;4875;1698;5194
290650;201802;11427;31642;10531;30497;2783;7806;5723;17505;8506;25311
290660;201802;3630;9714;3097;8920;108;267;2301;6975;2409;7242
290670;201802;6865;19899;5994;18493;516;1610;4449;13868;4965;15478
290680;201802;10393;30006;9006;27971;277;1371;7216;21801;7493;23172
290682;201802;4689;12756;4094;11898;144;423;3421;9913;3565;10336
290685;201802;3668;8397;2416;6661;215;567;1565;4460;1780;5027
290687;201802;6905;19610;5517;17295;872;2729;3149;10221;4021;12950
290689;201802;2968;8503;2469;7659;165;579;1783;5568;1948;6147
290690;201802;5605;15055;4666;13824;572;1694;3151;9355;3723;11049
290700;201802;2588;7311;2340;6971;82;301;2018;6021;2100;6322
290710;201802;8406;24434;7322;22945;270;1004;6271;19630;6541;20634
290720;201802;18894;52364;17332;50279;912;2815;14407;41888;15319;44703
290730;201802;7118;18516;6180;17373;307;844;4731;13302;5038;14146
290740;201802;1007;2853;767;2417;37;145;575;1794;612;1939
290750;201802;10678;28500;9244;26019;1133;3386;5925;16259;7058;19645
290755;201802;2248;6303;1755;5407;100;356;1224;3713;1324;4069
290760;201802;4005;11897;3171;10265;404;1187;1855;6294;2259;7481
290770;201802;2548;8599;2362;8359;76;369;1936;6887;2012;7256
290780;201802;8505;21616;7364;20007;482;1024;5702;15867;6184;16891
290790;201802;4529;12825;4052;12174;154;438;3466;10477;3620;10915
290800;201802;7312;15274;5464;13178;335;701;4217;10412;4552;11113
290810;201802;5746;15962;4590;14122;127;492;3525;10887;3652;11379
290820;201802;5215;14166;4657;13379;287;923;3494;10063;3781;10986
290830;201802;4639;11086;4143;10428;123;390;3405;8436;3528;8826
290840;201802;17028;47306;14897;44062;1788;4766;9809;30356;11597;35122
290850;201802;6307;16662;5769;16059;509;1248;4522;12982;5031;14230
290860;201802;5689;17589;4980;16757;245;895;4137;14157;4382;15052
290870;201802;4782;13494;3756;11703;158;573;2692;8345;2850;8918
290880;201802;1423;3657;1119;3210;82;201;780;2285;862;2486
290890;201802;7696;17781;6731;16694;206;559;6137;15150;6343;15709
290900;201802;2331;6398;1768;5409;117;392;1127;3408;1244;3800
290910;201802;5043;13073;4034;11543;60;262;3359;9517;3419;9779
290920;201802;5164;12998;4763;12490;93;208;4381;11503;4474;11711
290930;201802;8219;23398;6848;21090;228;1000;5451;16335;5679;17335
290940;201802;3796;11084;3251;10301;185;642;2432;7760;2617;8402
290950;201802;1538;4072;1301;3705;87;247;929;2667;1016;2914
290960;201802;5378;14940;4877;14282;170;533;4091;12009;4261;12542
290970;201802;3656;10799;3079;9853;181;578;2262;7259;2443;7837
290980;201802;10960;29047;9265;26148;1367;4137;4704;12955;6071;17092
290990;201802;8983;25552;7781;23562;408;1522;6169;18247;6577;19769
291000;201802;3359;9198;2699;8366;264;742;2075;6575;2339;7317
291005;201802;14930;36758;13211;34660;751;2048;10861;28553;11612;30601
291010;201802;3217;9695;2533;8305;162;547;1668;5424;1830;5971
291020;201802;1284;3320;1030;2852;42;140;689;1804;731;1944
291030;201802;2383;6190;1683;4853;95;290;1056;2950;1151;3240
291040;201802;5473;15722;4718;14625;225;939;3732;11432;3957;12371
291050;201802;7674;22976;6796;21600;1204;4219;4102;12793;5306;17012
291060;201802;6086;20684;5393;19683;516;2263;3721;13366;4237;15629
291070;201802;15756;44146;13628;40894;642;2351;10778;32045;11420;34396
291072;201802;24033;66284;18186;55347;3969;12766;6580;20327;10549;33093
291075;201802;4972;13701;4434;12793;212;639;3493;9950;3705;10589
291077;201802;1563;4246;1265;3724;56;147;916;2734;972;2881
291080;201802;82062;238520;70224;218918;26082;83067;10924;35751;37006;118818
291085;201802;5767;14819;4813;13486;209;643;4047;11312;4256;11955
291090;201802;1848;3841;1476;3412;133;179;1199;2894;1332;3073
291100;201802;3007;6873;2108;5811;103;365;1611;4352;1714;4717
291110;201802;5532;17862;4819;16643;537;2072;3387;11414;3924;13486
291120;201802;7747;19687;6765;18353;428;1265;5187;14039;5615;15304
291125;201802;2049;3801;1558;3263;89;170;1231;2638;1320;2808
291130;201802;2938;8856;2376;7806;91;428;1758;5572;1849;6000
291140;201802;4461;12651;3445;10673;472;1314;2176;6863;2648;8177
291150;201802;2196;5155;1896;4803;31;83;1671;4209;1702;4292
291160;201802;4890;14769;4299;13784;455;1575;2815;8937;3270;10512
291165;201802;2387;6588;1829;5556;23;101;1347;3987;1370;4088
291170;201802;20585;53560;17424;48497;1179;3546;11090;30821;12269;34367
291180;201802;6235;15596;4829;13526;421;1209;3468;9716;3889;10925
291185;201802;3375;9346;2937;8584;117;387;2361;6808;2478;7195
291190;201802;7594;19411;6393;17772;405;1224;5005;13884;5410;15108
291200;201802;2913;8409;2191;7057;140;463;1355;4333;1495;4796
291210;201802;6871;15768;5378;13975;200;660;4045;10410;4245;11070
291220;201802;4077;11954;3668;11313;324;1102;2644;8063;2968;9165
291230;201802;4412;10111;3471;9060;89;169;3171;8395;3260;8564
291240;201802;4370;11538;3790;10551;79;260;3215;8799;3294;9059
291250;201802;3412;10290;2728;9028;185;597;1835;6151;2020;6748
291260;201802;1241;3132;1082;2919;46;186;903;2375;949;2561
291270;201802;4952;14497;4077;13034;787;2624;2350;7613;3137;10237
291280;201802;2345;6399;1816;5526;216;695;1015;3016;1231;3711
291290;201802;6016;16256;4885;14570;583;1761;3152;9474;3735;11235
291300;201802;4070;11406;3099;9743;139;470;2235;6970;2374;7440
291310;201802;5269;14573;4498;13156;175;583;3593;10370;3768;10953
291320;201802;6158;18251;4821;15588;1152;3533;2191;7429;3343;10962
291330;201802;1724;4672;1463;4248;81;271;1066;3013;1147;3284
291340;201802;4075;10877;3430;9866;81;298;2720;7730;2801;8028
291345;201802;3119;9773;2884;9449;159;549;2327;7683;2486;8232
291350;201802;6508;17263;5071;15276;166;502;4176;12785;4342;13287
291360;201802;34055;86266;27815;78087;5292;15189;14580;42112;19872;57301
291370;201802;8019;22201;7351;21309;481;1589;5623;16191;6104;17780
291380;201802;3489;10210;3065;9525;126;518;2428;7437;2554;7955
291390;201802;12370;29341;10091;26716;559;1685;7973;21036;8532;22721
291400;201802;14222;37778;12013;34483;1861;4905;7345;22310;9206;27215
291410;201802;2942;7857;2264;6718;73;328;1710;4924;1783;5252
291420;201802;1958;5031;1624;4600;44;170;1378;3876;1422;4046
291430;201802;3117;8745;2721;8153;101;480;2214;6423;2315;6903
291440;201802;6482;19006;5644;17587;410;1336;4391;13816;4801;15152
291450;201802;8610;23149;7209;21412;173;417;6189;18902;6362;19319
291460;201802;14086;40020;12553;37754;1047;3401;8984;27146;10031;30547
291465;201802;8360;22327;6828;20484;318;1361;5549;16401;5867;17762
291470;201802;15801;39330;13527;36708;640;1695;10283;28660;10923;30355
291480;201802;39182;91054;29599;78174;3939;11041;15714;41784;19653;52825
291490;201802;4858;13633;4329;12960;323;1008;3525;10612;3848;11620
291500;201802;4815;12506;3985;11356;93;383;3492;9902;3585;10285
291510;201802;3858;10809;3176;9808;101;477;2562;7875;2663;8352
291520;201802;4324;10679;3406;9436;237;710;2407;6694;2644;7404
291530;201802;2215;5546;1656;4762;323;843;934;2964;1257;3807
291535;201802;3277;10068;3004;9631;216;696;2258;7323;2474;8019
291540;201802;2232;5096;1627;4430;83;256;1406;3792;1489;4048
291550;201802;5512;13439;4413;11963;590;1488;2645;7339;3235;8827
291560;201802;19915;44908;13609;37413;950;2481;9233;26750;10183;29231
291570;201802;2293;5567;1883;5075;100;215;1575;4353;1675;4568
291580;201802;5986;16729;4947;15320;396;1442;3535;10835;3931;12277
291590;201802;1759;5210;1610;4985;159;553;1240;3828;1399;4381
291600;201802;5223;13626;3945;11583;654;2020;2143;6185;2797;8205
291610;201802;4995;14828;4739;14543;82;281;4436;13673;4518;13954
291620;201802;3155;7155;2268;6180;116;355;1730;4781;1846;5136
291630;201802;3258;7641;2487;6651;143;428;1970;5207;2113;5635
291640;201802;15993;42045;12316;36519;2564;7787;4243;13457;6807;21244
291650;201802;8589;23594;7648;22439;486;1210;6433;19204;6919;20414
291660;201802;2250;5540;1649;4603;125;458;1082;2831;1207;3289
291670;201802;2008;5325;1739;4952;114;290;1366;3950;1480;4240
291680;201802;3997;10781;3382;9768;371;1129;2394;6900;2765;8029
291685;201802;4823;11730;3859;10484;346;783;2809;7928;3155;8711
291690;201802;4103;9687;2967;8034;104;279;2384;6383;2488;6662
291700;201802;8896;26505;7855;24646;580;1881;6095;19073;6675;20954
291710;201802;5264;13163;3992;11411;371;1185;2655;7442;3026;8627
291720;201802;4635;14525;3828;12881;318;1203;2576;8456;2894;9659
291730;201802;6353;17448;5514;16331;320;1075;4427;13142;4747;14217
291733;201802;2979;7839;2465;7132;99;312;1830;5474;1929;5786
291735;201802;3031;8055;2539;7334;95;299;2121;6131;2216;6430
291740;201802;3907;10292;3126;9097;144;460;2416;6939;2560;7399
291750;201802;20372;50756;16204;44471;2227;6225;9663;26973;11890;33198
291760;201802;10783;32549;8695;29094;2991;11231;1976;6669;4967;17900
291770;201802;7184;20260;5965;18054;608;2004;4085;12102;4693;14106
291780;201802;4732;13336;4272;12628;125;429;3691;10846;3816;11275
291790;201802;2672;7795;2471;7508;205;592;1908;5846;2113;6438
291800;201802;30811;80306;24558;71177;3267;9383;14370;42684;17637;52067
291810;201802;10950;27408;9012;24983;255;867;7611;20898;7866;21765
291820;201802;3831;10608;3342;9910;151;521;2558;7598;2709;8119
291830;201802;4236;10539;3679;9795;252;700;2946;7859;3198;8559
291835;201802;6330;19284;5102;16945;863;3004;2895;9848;3758;12852
291840;201802;46661;129664;40504;121809;5014;15249;27649;85186;32663;100435
291845;201802;2418;6976;2169;6648;137;406;1792;5561;1929;5967
291850;201802;4216;12169;3454;10887;316;899;2456;8010;2772;8909
291855;201802;1992;4355;1585;3855;81;239;1314;3152;1395;3391
291860;201802;2289;6069;1638;4816;34;112;1132;3211;1166;3323
291870;201802;1376;3582;927;2767;66;221;598;1717;664;1938
291875;201802;2792;8461;2469;7908;108;393;1797;5627;1905;6020
291880;201802;5161;15602;4600;14504;357;1118;3386;10672;3743;11790
291890;201802;1456;3305;998;2746;179;388;643;1844;822;2232
291900;201802;1228;3163;945;2685;29;114;730;2020;759;2134
291905;201802;2766;7138;2114;6030;84;285;1566;4353;1650;4638
291910;201802;2854;7370;2425;6864;83;279;2082;5888;2165;6167
291915;201802;6974;20737;5832;18773;291;1105;4468;14419;4759;15524
291920;201802;25673;72545;22823;68566;2933;9437;14764;44060;17697;53497
291930;201802;2484;7221;2169;6695;206;730;1492;4490;1698;5220
291940;201802;3463;9439;2405;7552;227;727;1460;4461;1687;5188
291950;201802;8839;27987;7712;25825;974;3319;4578;15672;5552;18991
291955;201802;12657;34419;11542;33001;1804;5031;7824;23166;9628;28197
291960;201802;3119;8706;2528;7814;150;484;1915;6032;2065;6516
291970;201802;4034;11579;3556;10868;219;885;2553;7721;2772;8606
291980;201802;10645;30358;8459;27078;595;1923;5916;19156;6511;21079
291990;201802;2036;5898;1897;5726;34;121;1762;5349;1796;5470
291992;201802;4137;10302;3058;8811;340;943;2307;6741;2647;7684
291995;201802;2198;6023;1774;5405;58;252;1439;4292;1497;4544
292000;201802;2394;6304;2019;5756;167;551;1413;4004;1580;4555
292010;201802;6249;14759;5079;13140;247;709;4177;10682;4424;11391
292020;201802;4476;13585;3870;12511;329;1134;2818;8968;3147;10102
292030;201802;1748;5611;1650;5456;114;426;1001;3223;1115;3649
292040;201802;4287;11372;3543;10380;249;663;2836;8552;3085;9215
292045;201802;3821;10579;3025;9394;83;195;2648;8377;2731;8572
292050;201802;6545;19032;5336;16715;425;1467;3335;10343;3760;11810
292060;201802;12549;29692;11467;28379;718;1734;9629;23543;10347;25277
292070;201802;5463;15087;4818;14309;300;941;4107;12196;4407;13137
292080;201802;3363;8565;2733;7765;142;471;2346;6648;2488;7119
292090;201802;4443;10091;3325;8790;240;658;2623;7048;2863;7706
292100;201802;10722;27667;9041;25432;1793;5104;4632;13406;6425;18510
292105;201802;3102;8837;2776;8315;74;333;2340;6926;2414;7259
292110;201802;6388;16469;4640;13575;1161;3396;2033;6080;3194;9476
292120;201802;6928;18606;5585;16197;628;1847;3702;10718;4330;12565
292130;201802;3152;8118;2657;7478;211;658;1990;5596;2201;6254
292140;201802;5043;12530;4167;11271;268;722;3284;8855;3552;9577
292145;201802;2281;6856;1954;6291;125;407;1400;4552;1525;4959
292150;201802;12980;37364;11751;35554;333;1289;9816;29455;10149;30744
292160;201802;2507;6871;2126;6379;74;208;1872;5653;1946;5861
292170;201802;8428;23465;6986;21021;655;2087;4703;14179;5358;16266
292180;201802;2993;8258;2206;6897;411;1205;1137;3620;1548;4825
292190;201802;2975;8206;2513;7525;275;867;1647;4982;1922;5849
292200;201802;7057;19437;5567;17163;1112;3552;2730;8625;3842;12177
292205;201802;3702;10724;3308;10128;83;400;2873;8627;2956;9027
292210;201802;6051;15317;5075;14012;121;477;4456;12154;4577;12631
292220;201802;2003;5113;1788;4803;144;398;1311;3470;1455;3868
292225;201802;3210;9603;2863;9085;99;415;2356;7378;2455;7793
292230;201802;7609;19414;7011;18586;177;735;5975;15474;6152;16209
292240;201802;4971;14648;4312;13370;368;1151;2902;8977;3270;10128
292250;201802;5344;15132;4891;14412;675;1960;3151;9420;3826;11380
292260;201802;3323;9176;2991;8719;195;541;2483;7354;2678;7895
292265;201802;3196;9332;2743;8572;86;396;2165;6590;2251;6986
292270;201802;4084;9955;3330;9036;241;706;2686;7308;2927;8014
292273;201802;2532;5753;2074;5188;86;158;1618;4195;1704;4353
292275;201802;1804;5047;1467;4565;82;200;1148;3731;1230;3931
292280;201802;2512;6257;2067;5740;94;207;1706;4917;1800;5124
292285;201802;2511;6435;2016;5723;93;320;1586;4492;1679;4812
292290;201802;6834;19666;5718;18032;262;981;4575;14396;4837;15377
292300;201802;9651;26172;7789;23808;1137;3634;4832;15024;5969;18658
292303;201802;2861;8381;2520;7861;69;245;2163;6729;2232;6974
292305;201802;2580;6936;2386;6646;50;224;2117;5788;2167;6012
292310;201802;6603;17797;5763;16704;230;700;4821;13940;5051;14640
292320;201802;6475;17567;5302;15476;306;985;4010;11434;4316;12419
292330;201802;2470;5976;2168;5598;125;321;1712;4484;1837;4805
292335;201802;4971;12884;4406;12093;326;827;3541;9838;3867;10665
292340;201802;6293;17196;5319;15476;272;796;3969;11479;4241;12275
292350;201802;2403;6663;1978;6090;81;300;1641;5089;1722;5389
292360;201802;4939;13301;4282;12130;344;1116;3068;8469;3412;9585
292370;201802;10306;24738;8980;22973;196;582;8074;20333;8270;20915
292380;201802;6987;20058;6332;18949;532;1570;4716;14166;5248;15736
292390;201802;4182;8706;3083;7406;145;269;2657;6460;2802;6729
292400;201802;21204;63556;19053;59919;2146;7116;12950;40685;15096;47801
292405;201802;4500;11059;3696;9958;192;450;3014;8196;3206;8646
292410;201802;2064;5275;1813;4979;79;234;1557;4308;1636;4542
292420;201802;3653;11351;3402;10971;189;815;2820;8992;3009;9807
292430;201802;5164;15114;3891;13184;328;1183;2553;8747;2881;9930
292440;201802;8287;26931;7651;26021;125;600;6986;23865;7111;24465
292450;201802;3778;11327;3114;10058;166;607;2394;7739;2560;8346
292460;201802;4857;13852;4029;12443;408;1243;2824;8728;3232;9971
292465;201802;2461;6823;2040;6194;105;296;1445;4554;1550;4850
292467;201802;1718;5251;1596;5088;203;626;1127;3701;1330;4327
292470;201802;2977;7564;2370;6604;83;222;1872;5225;1955;5447
292480;201802;6552;15948;5288;14394;111;409;4679;12522;4790;12931
292490;201802;2253;6034;1874;5463;119;351;1408;4139;1527;4490
292500;201802;6469;18348;5329;16330;602;1837;3481;10725;4083;12562
292510;201802;12867;35607;10472;32001;662;2465;7614;23192;8276;25657
292520;201802;6612;17262;5725;15954;912;2502;3704;10509;4616;13011
292525;201802;5621;13884;4624;12727;142;390;4006;11065;4148;11455
292530;201802;27324;75314;22805;68383;5917;17901;9084;28521;15001;46422
292540;201802;3497;7909;2844;7188;182;471;2408;6104;2590;6575
292550;201802;7386;21133;5880;19167;446;1612;4405;14614;4851;16226
292560;201802;4217;11188;3643;10352;123;500;2949;8289;3072;8789
292570;201802;4132;11037;3568;10247;61;214;3230;9235;3291;9449
292575;201802;6826;20798;6403;20220;285;942;5439;17219;5724;18161
292580;201802;7285;19632;6340;18257;207;772;5449;15515;5656;16287
292590;201802;7240;19857;6604;18944;258;900;5692;15971;5950;16871
292593;201802;2867;7203;2422;6481;155;390;1894;5063;2049;5453
292595;201802;5706;15208;4893;14198;214;725;4019;11595;4233;12320
292600;201802;11052;30501;9662;28524;584;1539;7446;22208;8030;23747
292610;201802;4545;11937;3764;10640;218;519;2683;7808;2901;8327
292620;201802;6433;18234;5535;17229;74;201;5251;16525;5325;16726
292630;201802;8813;22188;7245;19674;496;1377;5107;13955;5603;15332
292640;201802;7950;24366;7102;23011;245;978;5311;17250;5556;18228
292650;201802;4506;11563;4086;11012;199;528;3587;9602;3786;10130
292660;201802;10913;31197;9658;29345;609;2004;7521;22894;8130;24898
292665;201802;2236;6855;2050;6614;51;171;1814;5921;1865;6092
292670;201802;3574;9875;2775;8418;152;557;1867;5551;2019;6108
292680;201802;3929;10886;3264;9666;228;688;2339;6783;2567;7471
292690;201802;2648;7172;1886;5909;148;459;1227;3979;1375;4438
292700;201802;9672;27106;8347;25146;919;2639;5614;17519;6533;20158
292710;201802;2311;7490;2136;7269;56;207;1928;6601;1984;6808
292720;201802;9417;23000;7954;21374;311;938;6678;18134;6989;19072
292730;201802;4153;10722;3933;10439;194;430;3384;9033;3578;9463
292740;201802;332128;854383;303613;811280;53484;147639;176065;466068;229549;613707
292750;201802;6451;17315;5513;15932;270;821;4164;12111;4434;12932
292760;201802;3869;11514;3469;10795;265;884;2515;7799;2780;8683
292770;201802;5965;16884;5052;15495;898;2885;2909;9239;3807;12124
292780;201802;1946;4151;1457;3545;57;169;1159;2732;1216;2901
292790;201802;4047;8785;3290;7960;75;238;3007;7225;3082;7463
292800;201802;10478;27469;9174;25446;427;1209;7447;20492;7874;21701
292805;201802;3411;8708;2731;7764;234;626;2001;5729;2235;6355
292810;201802;10209;28445;8098;25237;375;1425;5925;18339;6300;19764
292820;201802;7727;21125;5626;17985;431;1667;4028;12617;4459;14284
292830;201802;2690;6446;2344;6010;53;192;2132;5404;2185;5596
292840;201802;8925;24050;8071;22900;177;704;7163;19849;7340;20553
292850;201802;2839;7583;2306;6760;168;580;1524;4314;1692;4894
292860;201802;15885;38356;14271;36300;1036;2548;11186;28608;12222;31156
292870;201802;17967;47486;15674;44085;1230;3912;10093;27948;11323;31860
292880;201802;11878;32831;10421;30767;501;1961;7804;22254;8305;24215
292890;201802;5761;17739;5141;16722;362;1343;3995;12899;4357;14242
292895;201802;3015;6802;2229;5629;122;299;1665;4188;1787;4487
292900;201802;2712;7767;2520;7457;83;378;2019;5739;2102;6117
292905;201802;4346;12012;3401;10563;256;808;2322;7278;2578;8086
292910;201802;5060;14305;4554;13454;377;1224;3186;9329;3563;10553
292920;201802;10033;27979;9435;27176;352;1365;8142;22997;8494;24362
292925;201802;5189;15073;4633;14157;256;815;3554;10772;3810;11587
292930;201802;6279;19474;5656;18257;445;1872;3678;11471;4123;13343
292935;201802;2071;5868;1676;5435;43;215;1460;4817;1503;5032
292937;201802;3128;7708;2705;7195;86;250;2341;6246;2427;6496
292940;201802;3167;8406;2554;7433;185;495;1898;5652;2083;6147
292950;201802;9363;25115;8375;23610;402;1253;6410;17727;6812;18980
292960;201802;5397;13103;4593;12032;136;409;3703;9536;3839;9945
292970;201802;4071;11896;3556;11178;125;547;2936;9229;3061;9776
292975;201802;4355;9755;3881;9208;218;441;3409;8188;3627;8629
292980;201802;3253;8245;2595;7232;131;417;1977;5408;2108;5825
292990;201802;11373;31446;9693;28754;441;1489;7705;22855;8146;24344
293000;201802;2681;6644;2415;6294;28;107;1903;5144;1931;5251
293010;201802;18073;47763;14813;42519;2020;5862;8957;25816;10977;31678
293015;201802;7602;24569;6235;21919;611;2532;4156;14490;4767;17022
293020;201802;9343;29071;8589;28050;191;869;7568;24775;7759;25644
293030;201802;5583;15360;4316;13373;150;507;2890;9224;3040;9731
293040;201802;3859;11457;3518;10992;110;421;3083;9579;3193;10000
293050;201802;21207;54534;18821;51227;1842;5177;12711;35030;14553;40207
293060;201802;3576;9433;2937;8404;205;654;2132;5976;2337;6630
293070;201802;24643;62779;20343;56933;3954;10983;10762;31514;14716;42497
293075;201802;3234;10719;2969;10264;214;935;2318;7956;2532;8891
293076;201802;3574;9459;3184;8931;109;306;2637;7486;2746;7792
293077;201802;5268;15415;4471;14282;542;1782;2918;9559;3460;11341
293080;201802;4743;14403;4211;13525;159;686;3395;10703;3554;11389
293090;201802;3129;9667;2518;8647;245;936;1617;5539;1862;6475
293100;201802;5752;16135;4745;14308;344;1039;3566;10806;3910;11845
293105;201802;3792;12161;3308;11211;257;894;2323;7831;2580;8725
293110;201802;2337;5937;1958;5415;70;228;1624;4396;1694;4624
293120;201802;4122;11947;3746;11328;144;452;3130;9418;3274;9870
293130;201802;3719;10726;3343;10256;96;395;2901;8882;2997;9277
293135;201802;31165;75735;22897;64250;4487;14080;9307;26411;13794;40491
293140;201802;2167;5433;1957;5171;88;271;1622;4176;1710;4447
293150;201802;5403;17045;4541;15344;530;1823;2972;10163;3502;11986
293160;201802;3964;9757;3382;9065;289;553;2717;7677;3006;8230
293170;201802;3790;9697;3320;9054;142;471;2606;7062;2748;7533
293180;201802;4918;13463;3971;11898;121;521;3169;9250;3290;9771
293190;201802;13663;39243;12192;37044;356;1599;10368;31128;10724;32727
293200;201802;7894;20229;6594;18374;224;830;5105;14096;5329;14926
293210;201802;5134;13993;4412;12844;238;730;3446;9996;3684;10726
293220;201802;5099;14113;3979;12189;1005;3064;1492;4805;2497;7869
293230;201802;3865;10772;3051;9581;359;1241;1978;6276;2337;7517
293240;201802;4355;11911;3508;10485;104;327;2679;8111;2783;8438
293245;201802;4151;11297;3680;10651;173;569;3042;8704;3215;9273
293250;201802;5708;14416;4903;13296;353;949;3735;10108;4088;11057
293260;201802;4429;12661;3667;11478;126;433;2624;8136;2750;8569
293270;201802;6619;15869;5395;14527;489;961;4274;12159;4763;13120
293280;201802;4975;13547;4231;12529;216;636;3220;9602;3436;10238
293290;201802;13002;41883;12016;40127;2945;9910;5585;19637;8530;29547
293300;201802;6367;15185;5429;13969;346;796;4036;10593;4382;11389
293305;201802;4363;10888;3729;10026;79;252;3211;8600;3290;8852
293310;201802;2266;5864;1822;5105;137;397;1277;3531;1414;3928
293315;201802;4209;10387;3464;9243;178;434;2772;7372;2950;7806
293317;201802;2479;6445;2199;5975;113;297;1668;4509;1781;4806
293320;201802;8491;25179;7955;24551;734;2333;6488;20198;7222;22531
293325;201802;1743;4690;1398;4160;219;681;861;2544;1080;3225
293330;201802;45829;146045;40657;136597;9110;31374;17984;61503;27094;92877
293340;201802;2482;7027;2003;6203;158;538;1292;3958;1450;4496
293345;201802;3182;9191;2723;8569;283;641;1960;6652;2243;7293
293350;201802;6863;19506;6157;18712;98;268;5704;17681;5802;17949
293360;201802;14771;39895;12904;37601;567;1862;11306;32796;11873;34658
310010;201802;832;2106;627;1808;72;238;289;785;361;1023
310020;201802;2280;6805;1812;5993;456;1659;252;808;708;2467
310030;201802;2306;6815;1841;5958;274;1036;1118;3456;1392;4492
310040;201802;975;2528;792;2250;57;209;592;1612;649;1821
310050;201802;1647;5404;1499;5125;284;1081;721;2380;1005;3461
310060;201802;3337;9674;2885;9080;164;702;2346;7297;2510;7999
310070;201802;348;869;249;696;4;9;178;485;182;494
310080;201802;788;2182;562;1740;68;256;231;674;299;930
310090;201802;4617;12959;3869;11741;406;1352;2707;8160;3113;9512
310100;201802;3459;10004;2891;9084;148;612;2254;6948;2402;7560
310110;201802;4998;13587;4045;11921;731;2426;1898;5337;2629;7763
310120;201802;660;1759;445;1393;83;317;198;539;281;856
310130;201802;388;1119;327;1014;58;219;180;500;238;719
310140;201802;189;624;150;556;44;194;42;129;86;323
310150;201802;4493;13273;3624;11559;775;2658;1239;3876;2014;6534
310160;201802;6963;20301;5561;17787;1533;5389;1227;3766;2760;9155
310163;201802;1077;3277;878;2907;267;970;242;735;509;1705
310170;201802;9055;24385;7636;22211;837;2518;5274;15365;6111;17883
310180;201802;1671;4542;1377;4085;120;458;922;2623;1042;3081
310190;201802;2980;9371;2528;8508;658;2419;310;995;968;3414
310200;201802;1760;5561;1398;4820;269;1022;510;1699;779;2721
310205;201802;1098;3126;839;2737;98;312;494;1669;592;1981
310210;201802;2736;7334;2277;6648;113;364;1706;4926;1819;5290
310220;201802;1045;2959;876;2694;96;344;606;1805;702;2149
310230;201802;2357;6881;1972;6111;247;932;1148;3334;1395;4266
310240;201802;889;3039;790;2853;82;362;526;1852;608;2214
310250;201802;928;2775;805;2548;97;395;512;1520;609;1915
310260;201802;2852;8437;1945;6708;491;1937;297;802;788;2739
310270;201802;2667;7011;2113;6239;138;535;1672;4822;1810;5357
310280;201802;2302;5709;1823;4992;224;735;1122;2945;1346;3680
310285;201802;1937;6591;1697;6171;179;735;1092;4023;1271;4758
310290;201802;1139;3226;1011;2999;225;776;535;1434;760;2210
310300;201802;1564;5016;1435;4801;279;1101;720;2249;999;3350
310310;201802;307;803;215;638;35;101;112;334;147;435
310320;201802;500;1336;320;1006;25;100;166;490;191;590
310330;201802;507;1228;313;872;39;121;129;312;168;433
310340;201802;7977;22682;6434;20060;1155;3550;3096;10031;4251;13581
310350;201802;12725;32350;8890;26126;2228;7074;2501;7160;4729;14234
310360;201802;469;1240;398;1149;16;58;307;861;323;919
310370;201802;1364;4431;1167;4044;241;886;437;1523;678;2409
310375;201802;1035;2759;693;2183;113;376;264;824;377;1200
310380;201802;369;897;201;599;38;115;72;194;110;309
310390;201802;443;1437;375;1300;102;372;81;234;183;606
310400;201802;9406;24766;6880;20682;1303;4374;2850;8244;4153;12618
310410;201802;737;2251;492;1803;128;513;106;360;234;873
310420;201802;4078;11076;2704;8300;536;1832;578;1559;1114;3391
310430;201802;1319;3955;910;3148;213;785;189;605;402;1390
310440;201802;563;1503;396;1199;40;164;209;606;249;770
310445;201802;1333;4036;1001;3392;63;233;705;2368;768;2601
310450;201802;4666;12295;3530;10526;255;827;2619;7807;2874;8634
310460;201802;1746;4866;1246;3933;273;934;330;1019;603;1953
310470;201802;3938;8712;3185;7739;296;907;2535;5992;2831;6899
310480;201802;1204;3315;870;2721;167;563;426;1277;593;1840
310490;201802;2981;9008;2425;7948;438;1685;1030;3169;1468;4854
310500;201802;1499;4454;1101;3677;223;801;462;1506;685;2307
310510;201802;1756;5192;1297;4271;335;1203;286;927;621;2130
310520;201802;1411;3563;1027;2939;97;275;635;1823;732;2098
310530;201802;890;2512;475;1534;73;255;67;178;140;433
310540;201802;3256;9804;2725;8855;719;2463;1029;3201;1748;5664
310550;201802;1215;3218;897;2694;115;442;553;1546;668;1988
310560;201802;14117;40296;11320;35436;2639;9175;3774;10890;6413;20065
310570;201802;1146;3261;946;2933;110;436;632;1875;742;2311
310590;201802;4211;11810;3504;10611;412;1406;1991;5875;2403;7281
310600;201802;1480;4571;1220;4006;191;659;550;1703;741;2362
310610;201802;515;1466;355;1182;60;243;161;486;221;729
310620;201802;154653;431248;120427;368992;27356;93902;42279;115605;69635;209507
310630;201802;4481;12810;3815;11628;311;1087;2675;8014;2986;9101
310640;201802;1017;3227;861;2919;232;869;246;784;478;1653
310650;201802;2607;7827;1963;6630;238;848;1062;3516;1300;4364
310660;201802;1280;3657;1095;3421;67;219;850;2631;917;2850
310665;201802;1294;3670;1093;3371;56;197;868;2704;924;2901
310670;201802;46149;130108;38851;116704;7205;23576;19438;55818;26643;79394
310680;201802;681;1756;576;1606;36;109;439;1200;475;1309
310690;201802;1564;4526;1208;3933;162;630;637;1967;799;2597
310700;201802;530;1223;394;1057;50;169;260;667;310;836
310710;201802;5681;17620;4247;15443;967;4104;420;1441;1387;5545
310720;201802;853;2331;717;2141;72;257;518;1509;590;1766
310730;201802;8972;26339;7818;24415;733;2643;5159;15871;5892;18514
310740;201802;5157;15297;3736;12391;755;2698;907;2862;1662;5560
310750;201802;1361;3371;967;2820;164;536;394;1070;558;1606
310760;201802;552;1576;436;1374;54;196;183;582;237;778
310770;201802;1078;3063;740;2545;110;420;347;1146;457;1566
310780;201802;3941;10308;3199;9109;206;634;2254;6314;2460;6948
310790;201802;1925;6069;1722;5721;350;1183;767;2695;1117;3878
310800;201802;2421;7554;1800;6330;500;2068;111;357;611;2425
310810;201802;1145;3061;957;2729;85;287;600;1632;685;1919
310820;201802;1183;3285;793;2549;184;649;208;643;392;1292
310825;201802;2865;9533;2326;8626;102;591;1818;6580;1920;7171
310830;201802;1438;4435;1137;3857;264;980;411;1336;675;2316
310840;201802;2115;5974;1475;4807;314;1113;350;1031;664;2144
310850;201802;1507;4267;1300;3989;80;364;998;2960;1078;3324
310855;201802;3174;8912;2541;7956;253;934;1797;5527;2050;6461
310860;201802;7008;20816;5735;18360;564;1909;3528;11337;4092;13246
310870;201802;1054;2633;792;2233;144;425;488;1362;632;1787
310880;201802;989;3011;796;2632;102;371;470;1528;572;1899
310890;201802;2393;6936;1712;5743;422;1573;269;788;691;2361
310900;201802;4558;13295;3450;11152;625;2256;1457;4357;2082;6613
310910;201802;1842;5005;1131;3629;150;548;143;369;293;917
310920;201802;1855;5186;1432;4498;247;838;751;2338;998;3176
310925;201802;968;2931;821;2675;136;497;523;1657;659;2154
310930;201802;6005;16260;4434;13767;777;2581;2300;7342;3077;9923
310940;201802;6174;16349;4988;14568;456;1496;3317;9523;3773;11019
310945;201802;1261;3460;1077;3199;82;280;707;2056;789;2336
310950;201802;2003;6085;1430;4866;299;1151;470;1461;769;2612
310960;201802;737;1880;441;1342;72;252;133;424;205;676
310970;201802;1158;3635;842;2964;203;772;209;678;412;1450
310980;201802;383;900;234;657;25;81;149;392;174;473
310990;201802;1233;3728;961;3162;212;734;350;1109;562;1843
311000;201802;4111;12121;3239;10682;922;3282;1174;3732;2096;7014
311010;201802;743;2376;641;2141;229;821;227;737;456;1558
311020;201802;973;2681;693;2155;103;362;306;885;409;1247
311030;201802;1677;4456;1118;3450;303;1064;314;858;617;1922
311040;201802;379;1227;308;1054;77;263;69;212;146;475
311050;201802;2320;6576;1907;5906;463;1592;719;2139;1182;3731
311060;201802;2675;7494;1872;5795;291;1054;677;1863;968;2917
311070;201802;1706;4964;1292;4230;206;806;574;1775;780;2581
311080;201802;873;2395;721;2126;95;340;429;1167;524;1507
311090;201802;1972;6695;1589;5987;419;1746;481;1787;900;3533
311100;201802;2033;6255;1426;5028;390;1549;179;557;569;2106
311110;201802;3248;7460;2168;5925;496;1410;917;2573;1413;3983
311115;201802;1208;3366;1001;3064;73;286;749;2237;822;2523
311120;201802;6933;18944;5148;15658;990;3364;1585;4310;2575;7674
311130;201802;1955;5656;1586;5084;187;731;772;2360;959;3091
311140;201802;1266;3236;942;2785;64;214;616;1857;680;2071
311150;201802;1494;5022;1288;4629;201;773;742;2646;943;3419
311160;201802;3769;11789;2826;10084;894;3498;650;2238;1544;5736
311170;201802;842;2378;655;2061;49;176;375;1202;424;1378
311180;201802;1229;3064;828;2446;210;686;299;876;509;1562
311190;201802;1057;3000;810;2525;139;506;294;841;433;1347
311200;201802;1723;4998;1286;4115;367;1246;232;696;599;1942
311205;201802;916;2950;775;2663;77;342;428;1447;505;1789
311210;201802;993;3052;893;2921;144;449;622;2094;766;2543
311220;201802;776;2345;639;2068;122;443;275;813;397;1256
311230;201802;8004;25022;6058;20945;1253;4594;1867;6679;3120;11273
311240;201802;938;2748;752;2456;156;558;381;1224;537;1782
311250;201802;832;2502;685;2255;163;574;270;853;433;1427
311260;201802;2279;5828;1604;4730;320;1032;607;1697;927;2729
311265;201802;1245;3360;963;2914;87;308;620;1838;707;2146
311270;201802;3259;10014;2841;9395;236;1090;1980;6220;2216;7310
311280;201802;1190;3270;622;2016;108;388;117;351;225;739
311290;201802;1917;6098;1789;5814;213;691;1196;3893;1409;4584
311300;201802;4560;13718;3864;12576;224;1055;2974;9477;3198;10532
311310;201802;629;1932;536;1747;102;349;185;552;287;901
311320;201802;3258;10477;2882;9635;476;1814;1225;3783;1701;5597
311330;201802;4645;13143;3988;12049;543;1825;2160;6603;2703;8428
311340;201802;10881;33249;8969;29601;2633;9192;2149;7181;4782;16373
311350;201802;2207;5898;1663;4912;207;677;824;2251;1031;2928
311360;201802;877;2458;718;2234;331;1121;125;392;456;1513
311370;201802;4158;11303;3223;9696;304;1177;1819;5134;2123;6311
311380;201802;437;1393;345;1203;98;343;104;382;202;725
311390;201802;1721;5762;1457;5390;600;2555;371;1187;971;3742
311400;201802;1426;4223;1069;3513;172;661;428;1260;600;1921
311410;201802;1594;5188;1389;4920;298;1161;675;2393;973;3554
311420;201802;1777;5583;1206;4275;199;763;132;359;331;1122
311430;201802;3501;9931;2346;7569;390;1337;597;1921;987;3258
311440;201802;2482;7605;1787;6289;503;1983;400;1386;903;3369
311450;201802;1871;6068;1440;5208;375;1487;285;913;660;2400
311455;201802;1012;2527;717;2053;193;561;235;666;428;1227
311460;201802;566;1831;407;1507;91;419;109;366;200;785
311470;201802;438;1444;337;1199;75;301;58;179;133;480
311480;201802;888;2227;742;2019;99;272;461;1210;560;1482
311490;201802;214;728;186;651;54;213;72;223;126;436
311500;201802;438;1192;326;1004;46;164;168;514;214;678
311510;201802;2733;7961;1965;6529;465;1774;486;1555;951;3329
311520;201802;588;1819;543;1730;131;462;264;796;395;1258
311530;201802;9687;23812;6414;18448;1539;4998;1617;4482;3156;9480
311535;201802;757;2128;508;1671;107;416;123;388;230;804
311540;201802;564;1869;516;1782;136;468;240;846;376;1314
311545;201802;2199;6217;1867;5788;123;500;1355;4098;1478;4598
311547;201802;1522;4064;1309;3724;51;175;1007;2865;1058;3040
311550;201802;2794;8357;2237;7258;395;1488;796;2443;1191;3931
311560;201802;257;613;195;541;25;74;111;285;136;359
311570;201802;1964;4801;1455;4089;60;181;1149;3340;1209;3521
311580;201802;2352;4455;1601;3597;224;421;1022;2470;1246;2891
311590;201802;499;1458;412;1329;84;316;199;625;283;941
311600;201802;1344;3666;1113;3364;98;308;860;2592;958;2900
311610;201802;2475;8589;2160;7883;515;1835;904;3375;1419;5210
311615;201802;3041;9236;2495;8349;206;840;1810;5961;2016;6801
311620;201802;401;1160;350;1079;29;108;260;783;289;891
311630;201802;1359;3861;1104;3383;79;261;767;2284;846;2545
311640;201802;604;1904;497;1695;110;415;199;665;309;1080
311650;201802;2033;5598;1744;5145;171;608;1132;3208;1303;3816
311660;201802;2897;8710;2143;7239;438;1586;399;1180;837;2766
311670;201802;1586;4279;1253;3752;229;768;536;1644;765;2412
311680;201802;2085;6289;1657;5506;254;898;1028;3390;1282;4288
311690;201802;572;1305;450;1154;29;78;336;881;365;959
311700;201802;2260;5655;1760;4971;47;177;1424;3938;1471;4115
311710;201802;1555;4638;1083;3709;310;1146;320;1121;630;2267
311720;201802;411;1305;340;1167;44;177;170;556;214;733
311730;201802;5025;12448;2970;8827;919;3058;403;1085;1322;4143
311740;201802;763;2326;712;2261;51;148;626;2020;677;2168
311750;201802;4001;12389;3363;11344;403;1626;2065;6708;2468;8334
311760;201802;642;2041;558;1864;118;459;176;504;294;963
311770;201802;1998;6129;1584;5333;353;1285;532;1697;885;2982
311780;201802;1235;3991;952;3366;210;863;242;732;452;1595
311783;201802;2061;6281;1733;5690;62;289;1409;4548;1471;4837
311787;201802;707;2166;513;1704;85;323;179;512;264;835
311790;201802;1543;4194;1063;3372;228;816;396;1241;624;2057
311800;201802;4927;15812;4186;14116;860;3191;574;1770;1434;4961
311810;201802;984;3176;819;2842;63;260;489;1687;552;1947
311820;201802;713;2003;572;1727;93;351;333;927;426;1278
311830;201802;8298;25533;6044;20527;1609;5925;560;1838;2169;7763
311840;201802;2884;8259;2533;7731;364;1273;1668;5005;2032;6278
311850;201802;304;884;256;806;28;85;160;503;188;588
311860;201802;52582;142755;42427;126045;6947;22025;23385;67967;30332;89992
311870;201802;1970;5567;1390;4463;263;964;489;1398;752;2362
311880;201802;6426;17646;5546;16432;448;1253;4151;12508;4599;13761
311890;201802;1420;3892;1148;3448;175;572;644;1863;819;2435
311900;201802;702;1931;557;1711;60;212;368;1112;428;1324
311910;201802;4323;11657;3330;10353;695;2244;1549;4868;2244;7112
311920;201802;1976;5920;1634;5342;177;636;944;3050;1121;3686
311930;201802;3272;8678;2606;7667;1023;3207;705;1918;1728;5125
311940;201802;13525;38487;10457;32524;1760;6061;4118;12085;5878;18146
311950;201802;2219;6327;1687;5417;115;499;1164;3630;1279;4129
311960;201802;566;1428;476;1285;40;177;326;759;366;936
311970;201802;440;1465;292;1080;52;221;58;191;110;412
311980;201802;459;1300;287;961;38;140;86;276;124;416
311990;201802;529;1333;360;1097;109;385;137;390;246;775
311995;201802;1006;2937;563;1889;32;120;50;108;82;228
312000;201802;568;1623;492;1507;33;103;355;1104;388;1207
312010;201802;886;2752;703;2372;81;296;368;1214;449;1510
312015;201802;1335;4104;1184;3831;96;417;854;2657;950;3074
312020;201802;1125;3537;976;3282;215;770;393;1301;608;2071
312030;201802;1961;5168;1730;4898;40;187;1576;4394;1616;4581
312040;201802;770;2562;616;2226;107;451;213;717;320;1168
312050;201802;1242;4137;1002;3635;250;1052;240;756;490;1808
312060;201802;836;2314;627;2032;164;543;276;897;440;1440
312070;201802;906;2719;645;2172;89;338;327;1051;416;1389
312080;201802;2766;7147;2060;6072;192;667;1231;3413;1423;4080
312083;201802;952;2578;757;2273;95;315;493;1428;588;1743
312087;201802;2224;6213;1920;5778;101;326;1493;4552;1594;4878
312090;201802;9181;26343;7222;23002;1694;5735;2875;9102;4569;14837
312100;201802;1508;4658;1090;3888;134;594;513;1736;647;2330
312110;201802;1003;3341;852;3016;246;978;208;655;454;1633
312120;201802;652;1963;506;1684;120;465;177;509;297;974
312125;201802;1234;3672;1099;3466;156;482;799;2559;955;3041
312130;201802;872;2318;672;1970;79;254;270;753;349;1007
312140;201802;794;2460;662;2166;155;552;234;691;389;1243
312150;201802;479;1398;406;1230;20;84;260;729;280;813
312160;201802;7711;23773;6240;20920;1123;4262;2516;7988;3639;12250
312170;201802;849;2390;681;2088;41;140;461;1362;502;1502
312180;201802;1345;3943;1105;3474;172;613;529;1573;701;2186
312190;201802;547;1702;404;1396;111;411;70;251;181;662
312200;201802;4782;13268;3898;11729;765;2358;2114;6345;2879;8703
312210;201802;1269;3143;939;2674;99;345;614;1675;713;2020
312220;201802;1972;6357;1764;6032;135;474;1306;4518;1441;4992
312230;201802;11607;33283;8193;26894;2505;9050;1056;3156;3561;12206
312235;201802;1596;4546;1364;4220;136;476;964;2933;1100;3409
312240;201802;782;2591;605;2213;143;575;145;522;288;1097
312245;201802;2416;6643;2094;6193;84;311;1726;5073;1810;5384
312247;201802;849;2306;623;1940;152;490;280;904;432;1394
312250;201802;1065;2843;736;2235;137;442;288;843;425;1285
312260;201802;931;2720;748;2431;72;273;515;1614;587;1887
312270;201802;680;1968;533;1671;38;173;273;771;311;944
312280;201802;417;1303;342;1149;109;374;36;117;145;491
312290;201802;752;2443;669;2291;129;492;229;769;358;1261
312300;201802;923;2872;676;2289;170;628;86;224;256;852
312310;201802;786;2722;691;2532;120;494;306;1096;426;1590
312320;201802;1912;5219;1452;4383;426;1397;298;846;724;2243
312330;201802;895;2627;744;2395;84;308;534;1682;618;1990
312340;201802;283;760;213;646;31;102;111;329;142;431
312350;201802;272;637;231;595;28;80;175;439;203;519
312352;201802;1629;4897;1411;4527;164;521;912;3091;1076;3612
312360;201802;2718;8414;2123;7136;485;1783;484;1545;969;3328
312370;201802;1727;4998;1470;4544;314;1081;662;1932;976;3013
312380;201802;2140;5216;1824;4807;36;94;1612;4282;1648;4376
312385;201802;1241;3539;1023;3155;161;567;606;1766;767;2333
312390;201802;1980;6023;1535;5191;310;1153;433;1326;743;2479
312400;201802;2951;9055;2377;7951;853;2971;607;2081;1460;5052
312410;201802;11371;34045;9513;30713;1883;6429;4392;14001;6275;20430
312420;201802;3737;11130;3364;10455;615;2037;1824;5609;2439;7646
312430;201802;7966;22169;6614;19779;686;2212;4357;12949;5043;15161
312440;201802;918;2903;707;2416;312;1144;91;282;403;1426
312450;201802;1177;3734;909;3202;270;996;309;1131;579;2127
312460;201802;394;1067;289;917;52;182;160;522;212;704
312470;201802;524;1399;336;1063;62;232;110;307;172;539
312480;201802;1221;3058;845;2561;120;411;501;1461;621;1872
312490;201802;1967;5023;1520;4319;257;776;816;2248;1073;3024
312500;201802;809;2149;656;1930;72;260;406;1152;478;1412
312510;201802;3690;10378;2857;8778;459;1455;1259;3754;1718;5209
312520;201802;207;620;169;561;48;163;67;231;115;394
312530;201802;560;1578;491;1485;30;107;405;1226;435;1333
312540;201802;1417;4251;933;3180;199;728;384;1298;583;2026
312550;201802;774;2221;607;1850;60;194;338;940;398;1134
312560;201802;2010;5333;1678;4863;82;329;1341;3822;1423;4151
312570;201802;2303;6300;1809;5557;512;1650;671;2091;1183;3741
312580;201802;535;1656;422;1400;48;195;176;558;224;753
312590;201802;1674;5222;1402;4675;169;711;723;2246;892;2957
312595;201802;1757;5660;1605;5347;285;936;929;3190;1214;4126
312600;201802;919;2524;592;2020;91;375;247;823;338;1198
312610;201802;6441;17167;4378;13442;898;3017;1044;3040;1942;6057
312620;201802;2436;6420;1766;5483;75;305;1348;4282;1423;4587
312630;201802;273;881;229;799;57;229;78;272;135;501
312640;201802;634;1776;425;1400;60;199;134;450;194;649
312650;201802;2082;5683;1437;4408;121;434;916;2674;1037;3108
312660;201802;1383;3502;1069;3029;113;389;705;1918;818;2307
312670;201802;5243;14616;4335;13347;498;1925;2668;7871;3166;9796
312675;201802;1305;3793;1055;3335;86;360;794;2442;880;2802
312680;201802;1358;3977;1166;3704;94;388;859;2661;953;3049
312690;201802;2201;5552;1729;4914;173;540;1214;3354;1387;3894
312695;201802;909;2825;814;2656;87;269;593;1966;680;2235
312700;201802;1954;5539;1464;4621;161;536;825;2565;986;3101
312705;201802;1283;3504;1059;3124;43;160;802;2309;845;2469
312707;201802;1412;4393;1083;3754;91;430;622;2048;713;2478
312710;201802;6549;15463;3885;11395;1185;3820;782;2344;1967;6164
312720;201802;988;2905;747;2486;92;360;363;1153;455;1513
312730;201802;1766;4193;1281;3586;75;234;856;2381;931;2615
312733;201802;1557;4137;1196;3482;43;132;767;2170;810;2302
312735;201802;730;1991;622;1801;92;330;405;1061;497;1391
312737;201802;810;1997;572;1634;119;361;257;714;376;1075
312738;201802;521;1493;353;1161;68;263;143;439;211;702
312740;201802;344;860;196;631;56;195;43;110;99;305
312750;201802;1250;4170;1082;3852;188;761;539;1818;727;2579
312760;201802;1910;5878;1389;4811;279;1014;393;1328;672;2342
312770;201802;39854;103326;27367;81868;6573;20962;7947;23120;14520;44082
312780;201802;2570;8421;2258;7884;289;1147;1353;4691;1642;5838
312790;201802;330;815;195;620;25;103;73;203;98;306
312800;201802;4916;15091;3866;12923;916;3368;1302;4244;2218;7612
312810;201802;1894;5446;1261;4253;308;1140;321;963;629;2103
312820;201802;1908;5283;1576;4702;70;269;1078;3119;1148;3388
312825;201802;1265;3233;1113;3044;38;124;928;2538;966;2662
312830;201802;2406;7218;1652;5735;413;1565;336;1147;749;2712
312840;201802;1159;3620;911;3134;156;610;288;887;444;1497
312850;201802;796;2214;588;1860;85;321;254;750;339;1071
312860;201802;1441;3758;951;2952;244;811;245;733;489;1544
312870;201802;5756;17094;3745;12714;596;2235;979;3056;1575;5291
312880;201802;1363;3718;1126;3374;56;172;697;2184;753;2356
312890;201802;1967;5567;1296;4197;207;706;478;1565;685;2271
312900;201802;1196;3367;998;3099;91;304;626;1997;717;2301
312910;201802;1569;2999;889;2116;144;370;434;998;578;1368
312920;201802;917;2704;691;2313;135;530;314;978;449;1508
312930;201802;2101;5756;1723;5166;402;1260;759;2251;1161;3511
312940;201802;862;2685;747;2478;157;551;324;1068;481;1619
312950;201802;2643;7254;2016;6259;650;2137;594;1845;1244;3982
312960;201802;1930;5296;1645;4882;123;357;1220;3696;1343;4053
312965;201802;1743;5333;1464;4796;104;363;944;3076;1048;3439
312970;201802;1036;3223;799;2825;194;769;276;923;470;1692
312980;201802;20964;63154;18035;57766;3574;12628;8500;25929;12074;38557
312990;201802;447;1278;296;1016;75;300;111;374;186;674
313000;201802;456;1415;365;1257;60;269;145;450;205;719
313005;201802;2600;7799;2277;7245;196;725;1611;5030;1807;5755
313010;201802;4387;13125;3606;11744;751;2722;1925;6038;2676;8760
313020;201802;930;2993;647;2306;101;406;80;227;181;633
313030;201802;1285;3267;896;2667;131;464;469;1345;600;1809
313040;201802;783;2521;658;2232;71;288;332;1060;403;1348
313050;201802;1773;5231;1271;4458;261;1092;339;1049;600;2141
313055;201802;1657;4933;1505;4709;55;187;1302;4057;1357;4244
313060;201802;937;2599;676;2143;205;710;131;376;336;1086
313065;201802;1826;5775;1559;5352;127;518;1160;3960;1287;4478
313070;201802;923;2579;739;2269;120;395;371;1116;491;1511
313080;201802;408;1167;296;947;75;283;83;208;158;491
313090;201802;4842;13587;4075;12307;1051;3409;1946;5838;2997;9247
313100;201802;1438;3854;1118;3374;67;227;854;2587;921;2814
313110;201802;1543;4278;1107;3459;129;469;532;1539;661;2008
313115;201802;2451;7730;2188;7197;358;1270;1080;3360;1438;4630
313120;201802;3655;8987;2873;7993;313;965;1855;5196;2168;6161
313130;201802;26450;75551;21728;66433;3490;11865;10376;30108;13866;41973
313140;201802;520;1284;357;1027;21;80;246;686;267;766
313150;201802;1303;3944;1035;3423;298;1032;260;840;558;1872
313160;201802;932;2583;729;2231;81;281;438;1292;519;1573
313170;201802;11222;35366;8206;28827;1620;5974;2624;8906;4244;14880
313180;201802;2299;6307;1697;5171;279;926;792;2337;1071;3263
313190;201802;4092;12698;3128;10609;612;2226;885;2811;1497;5037
313200;201802;1123;3341;963;3048;51;191;763;2359;814;2550
313210;201802;3916;11792;3191;10506;529;1887;1730;5521;2259;7408
313220;201802;1656;4631;1163;3669;211;766;405;1125;616;1891
313230;201802;2565;8098;2337;7801;92;316;2009;6739;2101;7055
313240;201802;8624;24115;6022;19411;1169;4206;2335;7058;3504;11264
313250;201802;6292;19298;5213;17314;581;2115;2715;8915;3296;11030
313260;201802;657;1829;447;1400;56;214;183;553;239;767
313270;201802;5525;15755;4401;13865;877;2872;2383;7541;3260;10413
313280;201802;390;1193;276;954;49;189;76;241;125;430
313290;201802;797;2662;635;2421;254;1055;116;416;370;1471
313300;201802;1695;5179;1325;4413;365;1319;198;574;563;1893
313310;201802;1011;3277;860;2974;167;661;186;537;353;1198
313320;201802;2194;6061;1553;5042;303;1106;680;2188;983;3294
313330;201802;4042;11609;3280;10369;264;1123;2128;6465;2392;7588
313340;201802;1463;3462;1064;2875;160;445;657;1792;817;2237
313350;201802;2316;6953;1735;5747;293;1067;529;1633;822;2700
313360;201802;1301;3495;919;2838;174;664;460;1307;634;1971
313370;201802;1216;3869;1093;3626;155;574;598;1919;753;2493
313375;201802;1981;5245;1328;4155;251;917;365;1080;616;1997
313380;201802;5499;15133;4119;12603;902;3092;1596;4406;2498;7498
313390;201802;864;2879;779;2728;58;253;514;1743;572;1996
313400;201802;3546;9417;2943;8647;212;621;2345;6856;2557;7477
313410;201802;1213;3298;991;2939;117;393;722;2102;839;2495
313420;201802;16185;37843;9256;26235;1922;6086;1348;3883;3270;9969
313430;201802;908;2769;689;2331;121;498;266;791;387;1289
313440;201802;5972;13377;4016;10911;319;862;2603;7173;2922;8035
313450;201802;646;1874;478;1542;101;332;139;408;240;740
313460;201802;2118;6652;1735;6023;417;1698;726;2316;1143;4014
313470;201802;3068;7854;2522;7116;243;669;1784;5062;2027;5731
313480;201802;864;2518;563;1885;88;340;165;485;253;825
313490;201802;1561;3786;761;2592;260;1050;69;233;329;1283
313500;201802;407;1309;327;1110;44;164;126;399;170;563
313505;201802;8989;25652;8061;24501;345;1131;6988;21342;7333;22473
313507;201802;1435;3757;1221;3463;59;217;949;2676;1008;2893
313510;201802;13250;37812;11250;34310;1453;4867;5846;17444;7299;22311
313520;201802;13563;40755;11203;36561;969;3606;7559;24306;8528;27912
313530;201802;503;1459;414;1314;27;92;198;596;225;688
313535;201802;2483;6994;2175;6435;178;504;1486;4369;1664;4873
313540;201802;870;2703;658;2144;159;538;211;670;370;1208
313545;201802;1186;4123;1025;3801;175;711;564;2009;739;2720
313550;201802;1768;5468;1510;4952;362;1273;728;2298;1090;3571
313560;201802;2477;5247;1838;4485;93;245;1505;3642;1598;3887
313570;201802;967;3097;788;2734;196;752;306;1010;502;1762
313580;201802;5586;15499;4370;13571;704;2309;2255;7245;2959;9554
313590;201802;923;2688;708;2357;292;1062;190;636;482;1698
313600;201802;3726;10659;3145;9718;203;772;2409;7358;2612;8130
313610;201802;993;2738;819;2417;123;367;508;1478;631;1845
313620;201802;5599;16079;4668;14411;998;3313;2034;6161;3032;9474
313630;201802;8221;21534;5791;17900;883;2990;2880;9072;3763;12062
313640;201802;961;2409;610;1899;188;631;191;560;379;1191
313650;201802;1833;5764;1557;5315;124;516;1023;3481;1147;3997
313652;201802;816;2803;755;2680;124;500;453;1535;577;2035
313655;201802;979;2911;800;2636;63;245;543;1751;606;1996
313657;201802;1366;3784;1050;3286;67;288;750;2205;817;2493
313660;201802;851;2622;724;2360;131;530;354;1069;485;1599
313665;201802;4372;12817;3532;11250;549;1971;1885;5805;2434;7776
313670;201802;43106;118467;30165;94443;6074;20715;10384;31127;16458;51842
313680;201802;999;2855;861;2632;81;282;535;1587;616;1869
313690;201802;838;2865;691;2553;143;546;209;795;352;1341
313695;201802;1541;4604;1232;4076;100;390;868;2845;968;3235
313700;201802;3347;11068;2859;10448;298;1126;2207;8172;2505;9298
313710;201802;1405;3598;1022;3007;108;329;618;1828;726;2157
313720;201802;5543;16377;4119;13397;734;2671;1468;4363;2202;7034
313730;201802;1270;3172;959;2747;82;237;607;1700;689;1937
313740;201802;1783;6419;1482;5635;367;1529;161;562;528;2091
313750;201802;1967;5688;1541;4828;376;1306;516;1455;892;2761
313753;201802;2059;5274;1478;4334;196;649;788;2263;984;2912
313760;201802;4978;14555;3747;12105;920;3216;1280;3907;2200;7123
313770;201802;3613;10723;2965;9765;338;1178;1885;6244;2223;7422
313780;201802;3958;10887;3011;9353;421;1476;860;2707;1281;4183
313790;201802;451;1472;423;1421;69;246;241;778;310;1024
313800;201802;1289;3211;1045;2859;69;221;779;2144;848;2365
313810;201802;1595;4342;1314;3930;104;353;936;2817;1040;3170
313820;201802;12724;32389;9375;26548;1507;4852;3728;9915;5235;14767
313830;201802;346;1069;303;993;67;238;138;467;205;705
313835;201802;880;2774;764;2569;74;298;426;1375;500;1673
313840;201802;6672;18473;5063;15749;1259;4210;1092;3338;2351;7548
313850;201802;1019;2657;848;2382;121;416;460;1167;581;1583
313860;201802;2725;7825;2014;6325;401;1332;671;1984;1072;3316
313862;201802;1442;3402;846;2491;81;247;437;1274;518;1521
313865;201802;2208;6490;1974;6145;181;600;1452;4476;1633;5076
313867;201802;1110;3712;939;3355;297;1109;359;1273;656;2382
313868;201802;1694;5498;1424;4946;121;502;1038;3550;1159;4052
313870;201802;806;2286;632;1991;135;468;209;582;344;1050
313880;201802;1391;3984;1088;3493;228;810;408;1174;636;1984
313890;201802;2017;4869;1491;4187;176;547;902;2594;1078;3141
313900;201802;3688;12279;3067;10986;897;3520;723;2565;1620;6085
313910;201802;658;2084;512;1799;139;515;85;300;224;815
313920;201802;3095;10015;2586;9044;523;1847;1311;4668;1834;6515
313925;201802;1725;4613;1331;3875;249;684;759;2245;1008;2929
313930;201802;6146;21041;5188;19373;478;1725;3522;13809;4000;15534
313940;201802;8587;26511;6385;22677;1463;5861;1627;6250;3090;12111
313950;201802;4392;11095;3263;9464;721;2572;1591;4310;2312;6882
313960;201802;5450;13929;3779;11197;866;2787;1180;3295;2046;6082
313970;201802;1335;3914;1180;3664;85;331;718;2256;803;2587
313980;201802;1343;3825;894;3045;141;545;313;1025;454;1570
313990;201802;1696;5965;1385;5212;410;1673;364;1254;774;2927
314000;201802;8955;25783;7733;23526;647;2426;5089;15224;5736;17650
314010;201802;1257;3246;1023;2932;51;195;777;2179;828;2374
314015;201802;2081;5963;1635;5258;224;853;891;2786;1115;3639
314020;201802;505;1469;315;1059;61;240;64;208;125;448
314030;201802;820;2560;632;2157;88;322;279;939;367;1261
314040;201802;735;2062;608;1816;111;363;265;757;376;1120
314050;201802;1564;4632;1219;3937;202;759;564;1682;766;2441
314053;201802;1688;5137;1438;4737;193;615;962;3346;1155;3961
314055;201802;2263;6396;1955;5941;48;217;1627;4928;1675;5145
314060;201802;1140;3326;890;2907;55;219;613;1971;668;2190
314070;201802;4313;12556;3395;10863;810;2688;1205;3725;2015;6413
314080;201802;1755;5257;1247;4120;216;851;363;1058;579;1909
314085;201802;2078;6545;1736;6017;407;1531;739;2544;1146;4075
314090;201802;3525;10981;3058;10180;298;1183;1955;6451;2253;7634
314100;201802;3211;7719;2644;6950;74;166;2205;5919;2279;6085
314110;201802;4116;12587;3509;11362;630;2272;1657;4996;2287;7268
314120;201802;889;2105;410;1301;101;363;60;183;161;546
314130;201802;765;2149;394;1346;61;231;118;395;179;626
314140;201802;4793;14387;3716;12180;680;2330;1526;4937;2206;7267
314150;201802;1523;4068;1191;3502;125;397;721;2054;846;2451
314160;201802;2485;6576;1829;5476;259;822;861;2651;1120;3473
314170;201802;1026;2976;835;2590;105;355;485;1426;590;1781
314180;201802;5331;15442;4467;14087;702;2376;2383;7611;3085;9987
314190;201802;740;2136;546;1821;103;371;255;865;358;1236
314200;201802;2914;8549;2455;7722;175;714;1745;5275;1920;5989
314210;201802;2002;5454;1694;4943;163;527;1016;2896;1179;3423
314220;201802;1397;4119;998;3368;280;1062;252;772;532;1834
314225;201802;1240;3554;1086;3339;73;249;801;2474;874;2723
314230;201802;725;2085;634;1961;79;296;397;1204;476;1500
314240;201802;1085;3115;856;2752;209;737;346;1134;555;1871
314250;201802;537;1555;356;1145;67;232;124;357;191;589
314260;201802;983;3222;821;2896;198;819;314;991;512;1810
314270;201802;3120;9273;2538;8268;132;532;1881;6009;2013;6541
314280;201802;3408;8383;2132;6187;376;1215;781;2117;1157;3332
314290;201802;4570;12339;3863;11160;518;1542;2439;6956;2957;8498
314300;201802;1546;4819;1196;4052;316;1133;339;1118;655;2251
314310;201802;5434;14947;4046;12498;1260;4183;952;2732;2212;6915
314315;201802;853;3157;752;2934;62;292;535;2041;597;2333
314320;201802;2847;7927;1951;6436;460;1627;733;2436;1193;4063
314330;201802;49865;144672;39835;127772;11857;40056;9502;30848;21359;70904
314340;201802;2597;6789;1416;4514;266;966;220;519;486;1485
314345;201802;1294;4130;1139;3848;145;513;729;2410;874;2923
314350;201802;1125;3117;778;2508;177;632;166;509;343;1141
314360;201802;685;2076;420;1480;70;288;94;315;164;603
314370;201802;595;1767;511;1633;45;169;372;1156;417;1325
314380;201802;1177;3457;819;2758;222;821;115;402;337;1223
314390;201802;11997;33098;8218;26025;1842;6275;1969;5596;3811;11871
314400;201802;4319;12774;3503;11449;1008;3422;1212;4104;2220;7526
314410;201802;2756;8049;1984;6543;361;1311;679;2419;1040;3730
314420;201802;743;1973;576;1730;23;124;439;1259;462;1383
314430;201802;6199;17272;4891;14979;1067;3485;1702;5205;2769;8690
314435;201802;1460;4371;1243;4018;56;252;913;2897;969;3149
314437;201802;958;2527;748;2229;33;126;460;1375;493;1501
314440;201802;534;1586;428;1402;123;458;134;381;257;839
314450;201802;1435;4090;1201;3715;181;693;665;1908;846;2601
314460;201802;3633;11707;2719;9642;654;2500;435;1513;1089;4013
314465;201802;2244;6717;1995;6231;71;303;1548;4710;1619;5013
314467;201802;955;2697;808;2460;27;85;623;1893;650;1978
314470;201802;2201;6699;1834;5932;383;1361;747;2260;1130;3621
314480;201802;5854;18303;4170;14341;769;2889;817;2527;1586;5416
314490;201802;874;2504;654;2047;98;346;369;1089;467;1435
314500;201802;1750;4748;1259;3909;254;815;401;1233;655;2048
314505;201802;1918;5121;1643;4737;134;452;1166;3320;1300;3772
314510;201802;1926;5042;1257;4088;280;997;441;1435;721;2432
314520;201802;3594;11747;2516;9273;464;1980;255;770;719;2750
314530;201802;5550;18810;5139;18046;591;2190;3440;12216;4031;14406
314535;201802;2689;7254;2216;6561;156;505;1663;4884;1819;5389
314537;201802;1094;3249;837;2798;81;314;546;1791;627;2105
314540;201802;386;1056;270;833;39;141;109;315;148;456
314545;201802;1592;4443;1409;4187;65;196;1173;3640;1238;3836
314550;201802;666;1695;475;1424;54;206;218;589;272;795
314560;201802;4084;13280;3325;11604;571;2183;1093;3615;1664;5798
314570;201802;294;853;228;725;29;106;115;363;144;469
314580;201802;484;1574;364;1312;87;340;50;175;137;515
314585;201802;753;2390;556;1962;92;398;224;730;316;1128
314587;201802;1906;5545;1510;4881;243;727;811;2688;1054;3415
314590;201802;2821;9054;2151;7569;404;1544;663;2223;1067;3767
314600;201802;1706;5106;1074;3808;253;1003;110;338;363;1341
314610;201802;7754;23043;6104;20116;1233;4645;2425;7691;3658;12336
314620;201802;1855;4900;1486;4381;84;263;1190;3478;1274;3741
314625;201802;1513;4726;1341;4467;120;586;983;3087;1103;3673
314630;201802;4908;13772;4093;12537;177;769;3249;9816;3426;10585
314640;201802;593;1560;443;1302;90;295;189;505;279;800
314650;201802;990;2618;668;2098;78;300;266;746;344;1046
314655;201802;1566;4497;1128;3651;248;774;450;1465;698;2239
314660;201802;317;799;210;594;12;28;107;286;119;314
314670;201802;1625;4125;1170;3379;95;326;715;2010;810;2336
314675;201802;1801;5081;1557;4662;126;456;1145;3358;1271;3814
314690;201802;2098;6420;1608;5562;502;1923;323;1074;825;2997
314700;201802;9448;29398;6412;22866;1545;6128;1198;4146;2743;10274
314710;201802;8150;23856;5834;18940;1157;4146;1171;3382;2328;7528
314720;201802;2231;7064;1686;5889;383;1459;410;1406;793;2865
314730;201802;2122;6159;1612;5231;417;1454;457;1373;874;2827
314740;201802;2844;8520;2335;7607;271;1034;1240;3938;1511;4972
314750;201802;338;1003;264;850;24;91;145;443;169;534
314760;201802;1809;5752;1284;4517;196;791;285;806;481;1597
314770;201802;1034;3139;539;1835;43;158;131;378;174;536
314780;201802;323;809;221;660;49;170;110;305;159;475
314790;201802;10280;30167;7704;25431;2663;9802;1005;2901;3668;12703
314795;201802;1461;4140;1255;3786;66;286;962;2775;1028;3061
314800;201802;11475;31051;7063;22428;1555;5332;971;2780;2526;8112
314810;201802;9602;26926;7153;22602;2094;6997;1620;5171;3714;12168
314820;201802;902;2411;662;2008;109;391;338;967;447;1358
314830;201802;1518;4881;1307;4481;295;1103;640;2172;935;3275
314840;201802;904;3010;726;2739;84;430;466;1682;550;2112
314850;201802;1964;5216;1540;4529;94;346;1203;3474;1297;3820
314860;201802;3223;10224;2730;9241;415;1553;1577;5186;1992;6739
314870;201802;5869;16533;4721;14929;426;1459;3444;10943;3870;12402
314875;201802;1716;5390;1580;5211;103;301;1347;4486;1450;4787
314880;201802;906;2287;719;2032;39;83;505;1511;544;1594
314890;201802;477;1406;352;1138;56;207;130;374;186;581
314900;201802;661;1815;519;1574;114;365;181;556;295;921
314910;201802;1724;5295;1345;4666;317;1293;588;1928;905;3221
314915;201802;2297;7117;1963;6521;151;628;1314;4215;1465;4843
314920;201802;465;1246;343;1081;24;81;199;608;223;689
314930;201802;5384;16528;4247;14281;925;3326;1349;4354;2274;7680
314940;201802;388;1086;335;986;38;111;198;547;236;658
314950;201802;382;1069;264;881;30;108;109;348;139;456
314960;201802;731;2026;565;1698;72;256;320;889;392;1145
314970;201802;616;1960;521;1800;108;423;199;667;307;1090
314980;201802;1264;3702;1010;3316;294;1071;120;375;414;1446
314990;201802;2372;7148;1657;5528;396;1495;327;942;723;2437
314995;201802;1575;4682;1331;4287;119;493;799;2441;918;2934
315000;201802;1079;2983;838;2588;87;311;509;1536;596;1847
315010;201802;418;1262;310;1039;68;277;114;338;182;615
315015;201802;2125;6290;1912;6009;216;731;1237;3992;1453;4723
315020;201802;829;2501;597;2036;91;357;282;901;373;1258
315030;201802;573;1677;427;1398;114;399;88;260;202;659
315040;201802;871;2590;792;2437;130;428;476;1447;606;1875
315050;201802;1202;3302;932;2911;95;347;489;1514;584;1861
315053;201802;1114;3186;898;2783;100;387;494;1480;594;1867
315057;201802;1644;5411;1450;5017;218;760;828;2884;1046;3644
315060;201802;622;1981;425;1561;102;391;77;286;179;677
315070;201802;666;1923;500;1608;137;470;145;438;282;908
315080;201802;2799;8760;2227;7506;503;1718;955;3233;1458;4951
315090;201802;799;2641;628;2271;131;515;171;581;302;1096
315100;201802;1178;3810;796;2853;155;648;276;901;431;1549
315110;201802;1362;3726;1072;3236;156;508;496;1497;652;2005
315120;201802;12536;29738;8889;24685;1153;3273;4494;13115;5647;16388
315130;201802;1297;4036;1099;3640;209;817;395;1219;604;2036
315140;201802;2809;8260;2226;7147;455;1673;978;2826;1433;4499
315150;201802;4231;11018;3028;8981;466;1523;1263;3679;1729;5202
315160;201802;1459;3858;1010;3134;207;683;403;1208;610;1891
315170;201802;1526;4815;1112;3877;240;883;183;635;423;1518
315180;201802;17073;45463;9275;29551;1495;5396;1926;5448;3421;10844
315190;201802;2038;4955;1640;4380;323;885;1071;2824;1394;3709
315200;201802;3868;12006;2907;10160;884;3356;612;2092;1496;5448
315210;201802;7925;22171;5978;17970;834;2792;2473;6844;3307;9636
315213;201802;1136;3201;986;2985;28;82;787;2372;815;2454
315217;201802;2497;8076;2009;7182;150;712;1287;4461;1437;5173
315220;201802;8852;25019;7195;22134;2183;7032;2123;6498;4306;13530
315230;201802;3003;7666;2647;7239;83;140;2371;6775;2454;6915
315240;201802;2794;8495;2368;7797;581;2074;1153;3704;1734;5778
315250;201802;10181;29499;7746;24924;1498;5269;2968;9266;4466;14535
315260;201802;949;2856;571;1982;104;377;54;163;158;540
315270;201802;761;2368;545;1922;97;412;145;452;242;864
315280;201802;2902;7811;1709;5344;392;1295;267;815;659;2110
315290;201802;1239;3299;779;2543;246;860;183;620;429;1480
315300;201802;710;1789;480;1497;241;812;112;371;353;1183
315310;201802;1278;3815;986;3236;94;346;559;1763;653;2109
315320;201802;685;2026;507;1712;59;281;222;684;281;965
315330;201802;716;2563;407;1680;74;325;102;387;176;712
315340;201802;3268;8718;2508;7594;325;1067;1372;4091;1697;5158
315350;201802;1652;4540;1220;3828;111;379;583;1799;694;2178
315360;201802;1676;5274;1244;4309;220;825;415;1358;635;2183
315370;201802;458;1389;384;1234;67;216;178;563;245;779
315380;201802;200;646;149;525;36;140;33;106;69;246
315390;201802;1194;3695;889;3049;174;641;267;856;441;1497
315400;201802;4222;12207;3336;10538;506;1671;1658;5146;2164;6817
315410;201802;2247;5375;1752;4682;385;1119;698;1821;1083;2940
315415;201802;1176;3533;971;3213;301;1097;343;1131;644;2228
315420;201802;1224;3758;860;3024;196;707;116;365;312;1072
315430;201802;3578;9292;2600;7703;643;2191;857;2392;1500;4583
315440;201802;959;2731;807;2474;115;439;417;1158;532;1597
315445;201802;2052;5322;1541;4536;183;581;997;2892;1180;3473
315450;201802;2290;6830;1983;6342;283;892;1225;4011;1508;4903
315460;201802;31271;96413;27147;88573;8467;29441;7677;23870;16144;53311
315470;201802;478;1378;382;1216;31;111;196;606;227;717
315480;201802;1527;4463;1037;3436;225;798;236;777;461;1575
315490;201802;2948;7584;2104;6374;334;1113;719;2084;1053;3197
315500;201802;483;1379;299;960;25;95;133;374;158;469
315510;201802;1272;3617;1095;3333;49;191;899;2693;948;2884
315520;201802;1111;3205;874;2818;64;256;572;1782;636;2038
315530;201802;651;2084;513;1745;173;645;174;548;347;1193
315540;201802;1157;3333;848;2750;134;482;316;1003;450;1485
315550;201802;1745;4817;1305;4129;278;1001;461;1407;739;2408
315560;201802;6099;19891;5430;18758;433;1658;3658;12678;4091;14336
315570;201802;1882;5712;1632;5236;132;508;906;2826;1038;3334
315580;201802;2280;6044;1782;5217;423;1405;555;1576;978;2981
315590;201802;907;2508;743;2245;97;337;357;1037;454;1374
315600;201802;2434;8157;1829;6953;279;1057;972;3858;1251;4915
315610;201802;955;2536;743;2141;132;485;317;754;449;1239
315620;201802;314;1045;286;1001;59;201;157;601;216;802
315630;201802;842;2520;691;2220;161;547;186;524;347;1071
315640;201802;397;1108;331;1004;44;157;172;494;216;651
315645;201802;886;2407;619;1945;190;638;151;436;341;1074
315650;201802;1798;4725;1402;4157;73;293;1055;3070;1128;3363
315660;201802;2551;6397;1949;5393;138;374;1312;3556;1450;3930
315670;201802;12379;37114;10291;33273;2191;7571;4480;13991;6671;21562
315680;201802;2926;9348;2230;7976;570;2211;766;2724;1336;4935
315690;201802;2906;7891;1920;6132;456;1544;446;1533;902;3077
315700;201802;7429;21833;5883;18789;998;3390;2677;8282;3675;11672
315710;201802;1884;5026;1354;4158;89;365;847;2457;936;2822
315720;201802;4094;12328;3546;11326;211;989;2380;7247;2591;8236
315725;201802;1670;4804;1388;4415;202;655;943;3046;1145;3701
315727;201802;596;1685;451;1410;77;271;205;592;282;863
315730;201802;696;2157;624;1997;87;323;302;909;389;1232
315733;201802;1262;3369;953;2837;208;731;342;942;550;1673
315737;201802;1188;3513;929;3026;43;185;635;2036;678;2221
315740;201802;980;2862;781;2451;137;500;375;1052;512;1552
315750;201802;1201;3390;1018;3087;67;220;724;2188;791;2408
315760;201802;1142;2885;1067;2795;28;57;977;2568;1005;2625
315765;201802;1782;5026;1515;4680;45;197;1355;4168;1400;4365
315770;201802;1219;3800;1046;3538;345;1278;337;1115;682;2393
315780;201802;24898;74770;21603;68573;2811;10383;11486;34575;14297;44958
315790;201802;3611;11517;3110;10570;271;934;2039;7102;2310;8036
315800;201802;1233;4774;942;3938;197;901;195;752;392;1653
315810;201802;1309;3381;1131;3118;79;287;873;2287;952;2574
315820;201802;2387;7424;2060;6877;272;1037;1343;4394;1615;5431
315830;201802;1140;3469;850;2939;67;285;382;1262;449;1547
315840;201802;759;1961;477;1418;62;195;174;485;236;680
315850;201802;1030;3356;909;3154;201;763;449;1447;650;2210
315860;201802;525;1653;374;1352;81;348;111;361;192;709
315870;201802;460;1274;378;1154;32;119;238;681;270;800
315880;201802;1126;2993;836;2547;75;276;335;974;410;1250
315890;201802;1504;4831;1302;4473;414;1511;517;1705;931;3216
315895;201802;5805;16836;4687;14524;709;2502;2102;6025;2811;8527
315900;201802;819;2196;720;2056;67;234;559;1520;626;1754
315910;201802;485;1547;427;1448;76;274;269;880;345;1154
315920;201802;1623;4357;832;2654;174;575;191;546;365;1121
315930;201802;1046;2613;729;2095;161;472;275;772;436;1244
315935;201802;833;2676;717;2448;163;615;215;740;378;1355
315940;201802;635;1911;525;1696;74;261;261;839;335;1100
315950;201802;1206;3463;1030;3162;162;503;716;2207;878;2710
315960;201802;3522;10535;2270;8133;741;3104;96;206;837;3310
315970;201802;662;1892;515;1687;59;182;359;1216;418;1398
315980;201802;3822;8981;2242;6346;507;1564;718;1838;1225;3402
315990;201802;3741;10016;2960;8701;351;1160;1668;4815;2019;5975
316000;201802;536;1544;429;1374;83;322;172;505;255;827
316010;201802;680;2129;541;1852;54;235;289;909;343;1144
316020;201802;978;3080;844;2825;83;390;549;1707;632;2097
316030;201802;3035;8665;2220;7198;255;871;1336;4403;1591;5274
316040;201802;3044;9831;2297;8321;342;1323;633;2404;975;3727
316045;201802;1931;5696;1812;5509;149;404;1426;4446;1575;4850
316050;201802;354;1078;270;923;43;178;141;447;184;625
316060;201802;712;1985;535;1708;61;294;315;909;376;1203
316070;201802;5784;17078;4835;15211;881;3042;2144;6516;3025;9558
316080;201802;729;2455;613;2207;165;652;67;228;232;880
316090;201802;492;1508;351;1204;61;256;129;395;190;651
316095;201802;1397;4374;1195;3997;225;792;616;2034;841;2826
316100;201802;2555;8110;1874;6509;369;1395;526;1712;895;3107
316105;201802;876;2436;660;2080;113;380;364;1139;477;1519
316110;201802;11890;37923;10400;35348;1437;5086;6593;22669;8030;27755
316120;201802;1078;3363;791;2653;175;608;204;585;379;1193
316130;201802;1441;3278;856;2387;113;348;398;1082;511;1430
316140;201802;1070;2954;739;2388;146;493;336;1092;482;1585
316150;201802;1537;3919;1296;3532;196;612;661;1695;857;2307
316160;201802;1095;3163;886;2784;93;328;510;1535;603;1863
316165;201802;908;2311;707;2008;116;396;390;1062;506;1458
316170;201802;1183;3206;868;2717;117;418;449;1347;566;1765
316180;201802;1396;4253;962;3305;204;774;124;346;328;1120
316190;201802;2793;8300;1599;5366;283;952;457;1374;740;2326
316200;201802;3561;10871;2639;9083;607;2377;585;1909;1192;4286
316210;201802;4344;13306;3235;10954;1087;3929;344;1159;1431;5088
316220;201802;663;2059;453;1597;95;366;44;187;139;553
316225;201802;1261;3212;997;2746;76;278;696;1798;772;2076
316230;201802;441;1181;348;1044;41;124;165;526;206;650
316240;201802;6217;18486;5494;17422;613;2008;3940;12493;4553;14501
316245;201802;3098;10554;2810;10086;192;1015;2143;7451;2335;8466
316250;201802;9571;25840;7157;21523;1944;6386;1594;4565;3538;10951
316255;201802;2733;7921;2366;7383;336;1150;1573;4914;1909;6064
316257;201802;1315;3348;926;2718;123;402;421;1193;544;1595
316260;201802;1888;5069;1439;4395;59;210;795;2516;854;2726
316265;201802;1273;3490;939;2901;57;191;609;1850;666;2041
316270;201802;3484;11404;3075;10458;657;2368;1284;4183;1941;6551
316280;201802;3091;9584;2756;8945;383;1400;1505;4708;1888;6108
316290;201802;3274;9781;2639;8547;443;1651;940;3018;1383;4669
316292;201802;4315;12371;3629;11236;406;1436;2510;7608;2916;9044
316294;201802;758;2319;562;1955;99;388;100;349;199;737
316295;201802;2381;7081;2053;6487;110;469;1510;4611;1620;5080
316300;201802;1003;3161;831;2845;60;233;531;1838;591;2071
316310;201802;967;2383;552;1738;93;325;224;690;317;1015
316320;201802;573;1709;457;1504;79;292;164;523;243;815
316330;201802;1077;3109;810;2555;68;256;537;1633;605;1889
316340;201802;1075;3169;799;2625;98;401;399;1218;497;1619
316350;201802;1256;3871;1103;3616;134;470;696;2273;830;2743
316360;201802;702;1852;560;1632;66;213;394;1125;460;1338
316370;201802;4593;13517;3695;11804;953;3450;926;2605;1879;6055
316380;201802;1624;4101;1243;3585;48;148;926;2665;974;2813
316390;201802;874;2399;683;2086;181;622;240;717;421;1339
316400;201802;1294;3857;901;3094;148;538;327;1076;475;1614
316410;201802;1042;3216;900;2997;81;279;712;2370;793;2649
316420;201802;1799;5497;1583;5210;111;451;1214;3924;1325;4375
316430;201802;882;2571;585;1959;124;435;135;445;259;880
316440;201802;677;2166;519;1904;150;639;77;267;227;906
316443;201802;580;1699;456;1468;107;384;133;418;240;802
316447;201802;1725;4817;1523;4518;62;207;1251;3703;1313;3910
316450;201802;2185;6950;1746;6048;201;753;1144;3922;1345;4675
316460;201802;881;2552;782;2384;243;791;357;1046;600;1837
316470;201802;6835;20450;5211;17203;1094;4101;1601;4987;2695;9088
316480;201802;194;604;164;542;34;125;63;191;97;316
316490;201802;339;966;252;780;36;120;98;270;134;390
316500;201802;1201;4049;787;2924;156;630;100;338;256;968
316510;201802;669;2451;606;2325;156;659;224;863;380;1522
316520;201802;1061;2998;838;2610;144;519;325;955;469;1474
316530;201802;931;2796;714;2370;121;520;303;890;424;1410
316540;201802;743;2301;652;2136;113;442;230;694;343;1136
316550;201802;1239;3946;1121;3722;125;470;780;2546;905;3016
316553;201802;2989;9482;2070;7250;568;2131;342;1098;910;3229
316555;201802;2759;9001;2432;8568;150;578;1887;6786;2037;7364
316556;201802;652;1599;465;1296;30;92;259;648;289;740
316557;201802;881;3020;778;2829;328;1257;231;795;559;2052
316560;201802;298;973;225;851;63;285;48;163;111;448
316570;201802;1177;3689;1019;3378;334;1129;298;995;632;2124
316580;201802;370;939;234;680;56;182;81;209;137;391
316590;201802;1379;3710;994;3020;175;590;540;1528;715;2118
316600;201802;1012;3217;898;3000;159;601;454;1488;613;2089
316610;201802;591;2000;499;1829;71;353;299;1035;370;1388
316620;201802;2179;6262;1846;5744;129;470;1305;4061;1434;4531
316630;201802;1507;4666;1204;4065;365;1221;423;1580;788;2801
316640;201802;149;428;121;375;28;104;57;144;85;248
316650;201802;986;3321;812;3059;69;287;527;2049;596;2336
316660;201802;183;464;72;230;6;29;12;28;18;57
316670;201802;1996;5315;1525;4525;458;1441;439;1239;897;2680
316680;201802;2016;5294;1570;4582;142;457;1117;3168;1259;3625
316690;201802;1147;3683;961;3321;240;938;334;1114;574;2052
316695;201802;1021;3090;888;2852;60;243;602;1891;662;2134
316700;201802;376;1019;329;962;20;95;231;615;251;710
316710;201802;2719;9637;2185;8489;675;2690;661;2716;1336;5406
316720;201802;18604;55798;14422;47297;3136;11055;5050;15869;8186;26924
316730;201802;340;1031;288;918;75;274;111;312;186;586
316740;201802;677;2101;608;2003;65;285;422;1367;487;1652
316750;201802;407;1313;321;1130;63;256;111;377;174;633
316760;201802;3634;11649;3012;10569;1312;4882;919;3208;2231;8090
316770;201802;1468;3795;1227;3467;41;140;1035;2951;1076;3091
316780;201802;590;1869;476;1644;142;548;50;138;192;686
316790;201802;725;2045;539;1701;138;460;173;535;311;995
316800;201802;5418;16570;4532;14904;526;2012;2612;8231;3138;10243
316805;201802;909;2126;795;1996;20;30;709;1864;729;1894
316810;201802;545;1580;415;1339;100;363;173;519;273;882
316820;201802;348;864;186;579;31;111;33;103;64;214
316830;201802;634;1967;540;1795;111;428;301;960;412;1388
316840;201802;2734;7926;2325;7175;471;1627;1062;3130;1533;4757
316850;201802;2057;5688;1566;4833;218;780;779;2311;997;3091
316860;201802;18275;53026;14619;47073;3021;11054;5909;18445;8930;29499
316870;201802;6460;19590;5028;16567;1184;4201;1426;4453;2610;8654
316880;201802;869;2454;747;2271;166;596;304;873;470;1469
316890;201802;1228;2835;809;2264;164;560;451;1122;615;1682
316900;201802;2409;6811;1879;5730;435;1465;584;1587;1019;3052
316905;201802;464;1484;378;1294;92;331;157;532;249;863
316910;201802;884;2588;603;2055;156;616;67;212;223;828
316920;201802;1658;4349;1132;3524;236;809;464;1444;700;2253
316930;201802;7879;25261;5947;21342;1191;4655;1155;3985;2346;8640
316935;201802;4049;11746;2874;9445;690;2424;775;2496;1465;4920
316940;201802;6728;21000;5218;17649;1058;3940;1475;4654;2533;8594
316950;201802;1739;4407;1372;3882;70;234;1071;2971;1141;3205
316960;201802;4810;11763;3648;10124;564;1719;2179;5976;2743;7695
316970;201802;3175;9767;2870;9187;640;2196;1121;3357;1761;5553
316980;201802;813;2457;572;1973;157;585;77;261;234;846
316990;201802;9962;29706;7606;24616;2087;7176;712;2131;2799;9307
317000;201802;2700;8559;2515;8294;205;691;1825;6385;2030;7076
317005;201802;2522;7478;2122;6788;398;1316;1075;3382;1473;4698
317010;201802;24715;59922;14773;44729;3666;12312;2991;9712;6657;22024
317020;201802;63143;162523;37079;113086;7282;24290;8017;22211;15299;46501
317030;201802;693;1970;559;1771;37;153;387;1199;424;1352
317040;201802;10252;27969;7628;23362;1903;6127;2817;8678;4720;14805
317043;201802;778;1991;630;1782;127;402;353;973;480;1375
317047;201802;1197;2987;853;2472;71;213;559;1606;630;1819
317050;201802;1344;4344;968;3470;158;601;321;1059;479;1660
317052;201802;2351;7157;2004;6560;252;891;1316;4240;1568;5131
317057;201802;1691;4369;1231;3593;68;258;813;2294;881;2552
317060;201802;410;1123;227;725;41;147;73;204;114;351
317065;201802;1263;3655;1062;3302;48;218;822;2450;870;2668
317070;201802;8154;24222;5506;18596;1215;4592;846;2653;2061;7245
317075;201802;1008;2963;723;2349;149;495;113;334;262;829
317080;201802;6042;15396;4797;13327;1583;4603;1249;3229;2832;7832
317090;201802;4535;14417;4168;13840;385;1331;3041;10139;3426;11470
317100;201802;2698;6867;1887;5556;623;1937;566;1634;1189;3571
317103;201802;1860;6144;1639;5732;207;955;975;3199;1182;4154
317107;201802;1362;3919;1127;3469;76;294;712;2008;788;2302
317110;201802;653;1534;358;1101;53;205;123;391;176;596
317115;201802;1139;3386;949;2992;77;242;665;2099;742;2341
317120;201802;12058;36100;9427;31244;1623;6006;4412;14063;6035;20069
317130;201802;7992;21179;5730;17330;1259;4153;1878;5634;3137;9787
317140;201802;586;1785;507;1643;70;225;296;962;366;1187
317150;201802;1008;2593;809;2349;50;177;643;1823;693;2000
317160;201802;3626;9114;2545;7517;260;807;1581;4688;1841;5495
317170;201802;1995;5229;1415;4188;224;766;498;1276;722;2042
317180;201802;1638;5422;1292;4623;301;1148;316;1077;617;2225
317190;201802;1323;3692;1007;3195;70;245;649;2028;719;2273
317200;201802;4616;13297;3537;11223;865;2983;825;2410;1690;5393
317210;201802;989;2759;811;2486;64;270;571;1748;635;2018
317220;201802;271;904;244;845;57;218;102;340;159;558
320010;201802;4755;14469;3968;12933;521;1830;2335;7448;2856;9278
320013;201802;1831;5472;1270;4209;217;717;526;1813;743;2530
320016;201802;3088;8234;2509;7411;149;437;1977;5833;2126;6270
320020;201802;3748;11056;2963;9578;788;2660;907;3028;1695;5688
320030;201802;1408;4360;1014;3504;300;1111;276;883;576;1994
320035;201802;1715;4940;1467;4531;460;1574;614;1811;1074;3385
320040;201802;3269;10145;2694;9063;501;1826;1202;4006;1703;5832
320050;201802;1650;4191;1444;3850;321;903;730;1902;1051;2805
320060;201802;9919;29841;7331;24502;1585;5799;1995;6405;3580;12204
320070;201802;1440;4374;1106;3671;229;821;335;1071;564;1892
320080;201802;5411;14869;4001;12159;845;2689;1452;4404;2297;7093
320090;201802;7395;20861;5554;17193;1378;4454;2101;6355;3479;10809
320100;201802;2473;7512;1960;6492;540;1865;698;2264;1238;4129
320110;201802;1243;3461;1013;3057;254;797;302;911;556;1708
320115;201802;1797;6158;1588;5767;773;2894;432;1611;1205;4505
320120;201802;14626;41320;10914;34599;2426;8444;3265;10008;5691;18452
320130;201802;35826;108323;30997;99674;5412;19308;15998;50011;21410;69319
320140;201802;3140;9613;2281;7756;533;2019;578;1920;1111;3939
320150;201802;13041;36049;9538;29204;2906;9527;1151;3192;4057;12719
320160;201802;5007;15148;4044;13264;842;2999;1751;5625;2593;8624
320170;201802;1632;4967;1246;4168;291;999;497;1647;788;2646
320180;201802;700;2348;578;2097;202;755;135;506;337;1261
320190;201802;3103;10460;2410;8818;613;2338;455;1645;1068;3983
320200;201802;972;2881;745;2471;230;856;197;662;427;1518
320210;201802;4667;12473;3692;10745;620;1995;1839;5114;2459;7109
320220;201802;2690;7620;2113;6662;380;1317;1133;3555;1513;4872
320225;201802;1257;4119;920;3278;320;1192;136;487;456;1679
320230;201802;4272;12939;3393;11423;915;3336;1288;4352;2203;7688
320240;201802;12975;35940;10136;31199;2240;7409;3966;12162;6206;19571
320245;201802;3024;9752;2642;8943;1018;3589;624;2075;1642;5664
320250;201802;1876;5589;1313;4274;326;1196;256;751;582;1947
320255;201802;1647;5562;1453;5219;562;2082;562;2113;1124;4195
320260;201802;993;2973;734;2372;217;782;195;530;412;1312
320265;201802;2411;7632;2046;6929;870;3077;566;1885;1436;4962
320270;201802;2518;7237;1867;6015;356;1225;890;2917;1246;4142
320280;201802;5732;17085;4840;15426;1255;4340;1419;4354;2674;8694
320290;201802;1373;4292;948;3250;288;1101;179;551;467;1652
320300;201802;3900;12700;3266;11286;1062;3870;643;2207;1705;6077
320305;201802;4531;13812;3704;12073;912;3168;1385;4393;2297;7561
320310;201802;1877;5485;1437;4577;329;1092;554;1754;883;2846
320313;201802;2066;5652;1388;4297;329;1130;273;792;602;1922
320316;201802;1540;4523;1214;3864;300;1011;498;1573;798;2584
320320;201802;19519;55107;14299;45940;3745;12888;4741;14995;8486;27883
320330;201802;2839;8201;2297;7239;661;2064;904;3033;1565;5097
320332;201802;5342;16321;4495;14810;1063;3763;2185;7055;3248;10818
320334;201802;1972;6025;1379;4730;326;1277;305;944;631;2221
320335;201802;1969;5797;1263;4148;334;1205;219;658;553;1863
320340;201802;4965;13236;4230;12077;815;2446;2123;6199;2938;8645
320350;201802;5022;12988;3587;10398;590;1791;1625;4618;2215;6409
320360;201802;1568;4096;1142;3302;191;540;483;1365;674;1905
320370;201802;2526;8257;2017;7073;574;2065;634;2209;1208;4274
320380;201802;2141;6192;1835;5674;421;1400;905;2718;1326;4118
320390;201802;7106;20345;5470;16918;1312;4307;1895;5690;3207;9997
320400;201802;3348;10042;2844;9072;690;2334;1199;3782;1889;6116
320405;201802;4472;12432;3584;10949;569;1875;1977;5947;2546;7822
320410;201802;5013;13644;3758;11731;693;2251;1766;5695;2459;7946
320420;201802;2561;7367;2015;6412;572;1991;495;1570;1067;3561
320425;201802;2004;4994;1533;4218;133;418;959;2547;1092;2965
320430;201802;2643;7128;2137;6126;378;1140;1170;3187;1548;4327
320435;201802;2474;7921;1960;6874;744;2729;505;1847;1249;4576
320440;201802;1091;3323;883;2882;171;623;371;1168;542;1791
320450;201802;1717;5182;1375;4528;337;1212;596;1879;933;3091
320455;201802;3698;11859;2688;9495;756;2850;697;2398;1453;5248
320460;201802;2363;7404;1698;5865;409;1486;347;1122;756;2608
320465;201802;1347;4011;1021;3333;132;474;537;1761;669;2235
320470;201802;3908;11257;2727;8775;731;2511;562;1748;1293;4259
320480;201802;1678;5059;1431;4561;287;1010;676;2101;963;3111
320490;201802;15370;44412;12517;39569;2695;9381;4979;15785;7674;25166
320495;201802;1371;3935;897;2948;217;751;215;717;432;1468
320500;201802;46272;131874;38783;118972;7477;24776;19643;58562;27120;83338
320501;201802;4540;13659;3392;11702;995;3891;908;2991;1903;6882
320503;201802;2001;6546;1566;5606;519;2073;455;1470;974;3543
320506;201802;3234;9814;2254;7546;648;2327;96;266;744;2593
320510;201802;8919;25905;7444;23369;1306;4544;3897;11916;5203;16460
320515;201802;1785;5065;1409;4263;417;1331;358;1061;775;2392
320517;201802;2044;6489;1612;5588;584;2175;326;1085;910;3260
320520;201802;32035;92169;25370;80803;5488;19268;9706;30544;15194;49812
320530;201802;27591;78390;22139;68736;3244;11779;12222;35753;15466;47532
330010;201802;19726;57909;16959;53094;3521;11592;8867;27735;12388;39327
330015;201802;1433;3859;1196;3439;204;663;552;1509;756;2172
330020;201802;18828;50991;16605;47671;2632;8492;10846;30287;13478;38779
330022;201802;1881;5306;1519;4734;277;949;875;2666;1152;3615
330023;201802;3320;9463;2643;8434;665;2294;942;2909;1607;5203
330025;201802;4640;12278;3375;10004;1083;3507;1008;2942;2091;6449
330030;201802;8801;26974;7291;24185;1185;4376;3817;12104;5002;16480
330040;201802;11739;33802;10255;31169;1687;5614;6067;17775;7754;23389
330045;201802;80018;203521;68022;187310;8105;22330;48607;132724;56712;155054
330050;201802;2358;6717;1887;5928;476;1601;778;2294;1254;3895
330060;201802;5245;14660;4403;13330;1026;3424;1873;5407;2899;8831
330070;201802;19988;56867;17171;52456;3507;11375;8502;25977;12009;37352
330080;201802;8552;23204;7582;21752;761;2331;5079;14372;5840;16703
330090;201802;2566;6447;2131;5822;292;864;1257;3341;1549;4205
330093;201802;1941;5434;1554;4837;205;659;994;3179;1199;3838
330095;201802;1025;3264;860;2916;116;428;402;1281;518;1709
330100;201802;61940;178601;53439;165777;5520;19934;35337;108089;40857;128023
330110;201802;2145;6581;1896;6155;379;1311;769;2450;1148;3761
330115;201802;1792;4924;1485;4461;281;955;831;2426;1112;3381
330120;201802;2984;7395;2402;6634;259;824;1694;4578;1953;5402
330130;201802;3511;10583;3014;9801;602;2087;1601;5206;2203;7293
330140;201802;3206;9228;2746;8542;489;1752;1594;4809;2083;6561
330150;201802;2000;5762;1606;5077;365;1196;568;1799;933;2995
330160;201802;1140;3375;959;3092;232;817;460;1436;692;2253
330170;201802;92145;262599;80946;246220;14411;45686;47232;143396;61643;189082
330180;201802;2082;5736;1693;5079;96;379;1179;3424;1275;3803
330185;201802;8868;25254;7427;22735;1051;3585;4665;13843;5716;17428
330187;201802;3737;10290;3107;9305;514;1709;1887;5557;2401;7266
330190;201802;27777;73130;24661;68784;2953;8467;18263;50847;21216;59314
330200;201802;13711;39654;11598;36664;2661;8434;6268;20373;8929;28807
330205;201802;1985;5306;1669;4808;127;428;1151;3242;1278;3670
330210;201802;3114;8380;2351;6922;542;1708;815;2248;1357;3956
330220;201802;9775;27962;7896;24350;1887;6298;2170;6150;4057;12448
330225;201802;3514;10299;2939;9324;299;1205;1908;5786;2207;6991
330227;201802;16455;44514;14437;41753;1771;5484;10347;29803;12118;35287
330230;201802;1239;3468;1050;3174;104;365;685;2019;789;2384
330240;201802;17758;50886;14776;45898;3661;12305;6266;18795;9927;31100
330245;201802;1305;3680;918;2994;217;754;227;726;444;1480
330250;201802;34016;95473;29644;88724;7282;22113;13418;41085;20700;63198
330260;201802;4468;12732;3594;11291;635;2171;1737;5216;2372;7387
330270;201802;22455;48259;14361;37037;2853;8125;5696;14546;8549;22671
330280;201802;2209;6253;1789;5487;267;894;903;2647;1170;3541
330285;201802;19128;50403;15955;45880;2220;7102;10255;28739;12475;35841
330290;201802;3306;9205;2778;8341;439;1432;1505;4352;1944;5784
330300;201802;3242;10076;2805;9285;449;1666;1582;5073;2031;6739
330310;201802;2279;6187;1806;5380;167;486;1139;3402;1306;3888
330320;201802;13127;36216;11648;34143;1531;4670;8348;24529;9879;29199
330330;201802;28282;72609;23943;66233;3495;10799;15402;41278;18897;52077
330340;201802;13347;37299;10479;32341;2315;7739;4084;12073;6399;19812
330350;201802;91215;245808;78457;228485;8976;28208;55246;159747;64222;187955
330360;201802;6888;18165;5975;17095;462;1389;4760;13558;5222;14947
330370;201802;3548;12055;3106;11148;932;3456;1095;3931;2027;7387
330380;201802;5004;15237;4012;13369;963;3454;1365;4399;2328;7853
330385;201802;3832;12459;3371;11672;975;3605;1339;4688;2314;8293
330390;201802;22404;69005;18400;61156;4087;14649;7815;25188;11902;39837
330395;201802;3097;8514;2707;7961;215;742;1820;5262;2035;6004
330400;201802;2753;8067;2454;7527;224;850;1672;4794;1896;5644
330410;201802;2728;8004;2077;6814;405;1449;905;2831;1310;4280
330411;201802;2269;6680;1937;6058;200;746;1316;3936;1516;4682
330412;201802;1408;4512;1158;4015;198;756;577;1892;775;2648
330414;201802;23317;62377;19508;57117;2935;8474;12362;36373;15297;44847
330415;201802;3479;10109;2754;8861;524;1682;1250;4168;1774;5850
330420;201802;9759;26122;6491;20525;1178;3973;1952;5854;3130;9827
330430;201802;7227;20139;6329;18617;948;3172;3818;10724;4766;13896
330440;201802;1616;5048;1384;4655;375;1403;541;1707;916;3110
330450;201802;1317;4149;1104;3755;203;770;534;1771;737;2541
330452;201802;13821;38563;10944;33576;2310;7660;5243;15663;7553;23323
330455;201802;527210;1351856;409128;1170147;74982;229549;221938;623239;296920;852788
330460;201802;1198;3595;954;3199;203;733;435;1417;638;2150
330470;201802;4346;11971;3442;10525;870;2857;1405;4180;2275;7037
330475;201802;8348;23646;6869;21496;1859;6401;3074;9331;4933;15732
330480;201802;5743;16065;4977;14905;712;2340;3116;9072;3828;11412
330490;201802;113081;279819;96654;256491;10796;31032;66532;173122;77328;204154
330500;201802;5042;14635;4649;14041;626;2028;3300;9878;3926;11906
330510;201802;37675;106595;31245;97107;9164;28832;13624;42944;22788;71776
330513;201802;1209;3536;1059;3265;333;1072;403;1235;736;2307
330515;201802;2869;8364;2382;7496;769;2539;778;2401;1547;4940
330520;201802;10875;31540;9314;28859;1788;6009;4415;13222;6203;19231
330530;201802;1518;4111;1210;3585;266;851;527;1505;793;2356
330540;201802;2812;8018;2267;7033;647;2080;799;2415;1446;4495
330550;201802;7702;24261;6599;22335;2515;8899;1552;5358;4067;14257
330555;201802;10394;28346;8985;26395;1538;4773;5589;16566;7127;21339
330560;201802;4171;12101;3588;11037;484;1618;2092;6247;2576;7865
330570;201802;2972;8662;2492;7836;517;1711;1333;4145;1850;5856
330575;201802;5398;14687;4699;13467;517;1714;3331;9176;3848;10890
330580;201802;12248;36855;9949;32470;2689;9302;3811;12222;6500;21524
330590;201802;1574;4501;1387;4251;168;529;983;3030;1151;3559
330600;201802;11037;31782;8868;27884;1479;4931;4324;13554;5803;18485
330610;201802;8622;25615;7526;23875;1000;3659;4589;14126;5589;17785
330615;201802;1630;5342;1446;5078;482;1815;631;2209;1113;4024
330620;201802;3529;11510;2998;10522;1075;4026;647;2192;1722;6218
330630;201802;23506;64848;18841;56830;2304;8049;11611;33570;13915;41619
350010;201802;1876;5301;1027;3380;247;836;92;237;339;1073
350020;201802;603;1609;331;1064;40;139;146;425;186;564
350030;201802;4249;12710;3181;10586;861;3069;840;2715;1701;5784
350040;201802;560;1799;374;1358;78;314;104;345;182;659
350050;201802;896;2568;667;2123;151;540;187;492;338;1032
350055;201802;688;1912;585;1756;54;191;435;1271;489;1462
350060;201802;109;327;89;296;21;77;36;125;57;202
350070;201802;3920;10977;2445;7990;472;1595;698;2071;1170;3666
350075;201802;580;1887;450;1606;177;657;61;198;238;855
350080;201802;679;1894;419;1335;58;211;178;533;236;744
350090;201802;579;1471;342;1011;77;227;103;290;180;517
350100;201802;2047;5840;1370;4563;207;820;587;1815;794;2635
350110;201802;421;1247;313;1018;26;102;186;582;212;684
350115;201802;1284;3855;1070;3385;197;678;515;1490;712;2168
350120;201802;818;2196;490;1516;68;204;256;825;324;1029
350130;201802;3109;8875;2612;7915;329;1099;1435;4101;1764;5200
350140;201802;573;1868;465;1649;41;186;261;886;302;1072
350150;201802;493;1557;420;1412;135;471;123;397;258;868
350160;201802;9785;25884;6273;19435;964;3421;3183;9146;4147;12567
350170;201802;1497;4814;1207;4151;282;1022;329;1072;611;2094
350180;201802;1114;2922;629;1934;128;428;266;791;394;1219
350190;201802;2983;8963;2259;7456;482;1793;885;2498;1367;4291
350200;201802;389;1146;333;1048;24;82;230;692;254;774
350210;201802;5301;13241;3551;10349;766;2282;1643;4722;2409;7004
350220;201802;2320;7002;1856;5994;376;1366;751;2225;1127;3591
350230;201802;849;2558;743;2376;178;599;329;1049;507;1648
350240;201802;625;1895;446;1484;79;279;166;536;245;815
350250;201802;2162;7175;1788;6486;641;2517;416;1541;1057;4058
350260;201802;838;2208;557;1677;97;297;270;799;367;1096
350270;201802;4585;13381;3767;11717;668;2277;1758;5084;2426;7361
350275;201802;2084;6294;1741;5675;397;1377;752;2363;1149;3740
350280;201802;20720;48581;12809;35607;2468;7334;3976;10708;6444;18042
350290;201802;2870;8456;2050;6772;402;1492;718;2234;1120;3726
350300;201802;622;1812;436;1393;90;288;133;388;223;676
350310;201802;834;2682;707;2384;95;370;280;881;375;1251
350315;201802;525;1542;378;1244;60;232;126;363;186;595
350320;201802;11423;33057;9363;29325;2590;8672;2080;6556;4670;15228
350330;201802;14512;37739;9930;28174;1423;4109;5132;13732;6555;17841
350335;201802;386;1121;323;1009;20;58;238;751;258;809
350340;201802;1014;2834;670;2166;137;494;216;678;353;1172
350350;201802;718;2057;585;1883;123;420;237;733;360;1153
350360;201802;917;2958;778;2632;212;701;287;965;499;1666
350370;201802;564;1600;398;1235;120;370;62;176;182;546
350380;201802;4647;13041;3177;10255;764;2603;943;2933;1707;5536
350390;201802;9424;27514;7863;24629;2205;7104;2825;8651;5030;15755
350395;201802;401;1060;195;642;21;76;61;173;82;249
350400;201802;7706;20922;5730;17469;1490;4937;1673;4825;3163;9762
350410;201802;8962;27301;6770;22966;1672;6258;1779;5554;3451;11812
350420;201802;574;1754;427;1476;85;344;65;212;150;556
350430;201802;703;2067;582;1855;77;302;344;1030;421;1332
350440;201802;1371;4047;1116;3513;232;752;536;1633;768;2385
350450;201802;6967;20952;5535;18197;1261;4408;1682;5273;2943;9681
350460;201802;1504;3905;825;2571;165;592;228;654;393;1246
350470;201802;227;587;185;514;11;41;121;317;132;358
350480;201802;794;2206;524;1667;92;323;81;221;173;544
350490;201802;1723;5073;1361;4399;307;1047;421;1256;728;2303
350500;201802;587;1704;497;1547;86;309;264;800;350;1109
350510;201802;1061;3049;791;2515;102;366;404;1224;506;1590
350520;201802;1753;6045;1363;5144;276;1155;456;1637;732;2792
350530;201802;2337;6504;1784;5388;456;1461;620;1736;1076;3197
350535;201802;1381;4087;1235;3877;136;515;858;2612;994;3127
350540;201802;1659;4515;1219;3741;254;859;511;1572;765;2431
350550;201802;9342;23686;6316;18723;889;3029;2889;7972;3778;11001
350560;201802;3480;10804;2896;9544;327;1151;1673;5401;2000;6552
350570;201802;18630;57181;15987;52021;4160;14631;6534;20303;10694;34934
350580;201802;1731;5278;1051;3596;206;736;122;343;328;1079
350590;201802;4184;12166;3139;10002;692;2556;1381;3951;2073;6507
350600;201802;40076;98366;25897;72475;3762;11641;11883;30542;15645;42183
350610;201802;6581;18958;4997;15907;1022;3453;2095;6504;3117;9957
350620;201802;384;1042;273;879;29;116;133;407;162;523
350630;201802;1526;4263;1122;3477;132;469;564;1623;696;2092
350635;201802;6750;18727;5231;16187;1096;3748;2416;7136;3512;10884
350640;201802;815;2411;494;1612;75;281;144;413;219;694
350650;201802;7567;21704;5037;16161;1073;3718;1379;4109;2452;7827
350660;201802;4732;13317;3745;11577;748;2456;1730;5324;2478;7780
350670;201802;1488;4471;1325;4187;265;857;690;2195;955;3052
350680;201802;1039;2972;720;2357;146;523;303;991;449;1514
350690;201802;1021;3085;769;2565;155;565;324;1012;479;1577
350700;201802;4122;11651;2996;9767;633;2346;1319;4009;1952;6355
350710;201802;2659;7934;2277;7213;324;1142;1290;3932;1614;5074
350715;201802;785;2333;689;2140;89;335;376;1065;465;1400
350720;201802;147;400;121;359;24;73;44;126;68;199
350730;201802;444;1461;357;1284;63;255;163;573;226;828
350740;201802;1589;4707;1072;3525;198;692;273;803;471;1495
350745;201802;583;1689;345;1125;50;182;140;397;190;579
350750;201802;8979;26234;7227;22902;1488;5320;2456;6930;3944;12250
350760;201802;12884;35416;9655;29785;2672;8890;2267;6225;4939;15115
350770;201802;670;1841;450;1397;60;201;244;741;304;942
350775;201802;581;1535;455;1327;51;173;219;637;270;810
350780;201802;1879;5372;1429;4562;355;1290;340;1162;695;2452
350790;201802;1740;5155;1207;4087;252;915;193;578;445;1493
350800;201802;3085;9804;2798;9234;507;1836;1442;4581;1949;6417
350810;201802;2012;5449;1714;5047;348;1077;923;2823;1271;3900
350820;201802;715;1814;416;1251;60;179;157;438;217;617
350830;201802;853;2526;509;1737;68;247;144;434;212;681
350840;201802;2471;7984;1910;6849;590;2293;570;1922;1160;4215
350850;201802;5937;18487;4709;15981;1395;4954;1283;4327;2678;9281
350860;201802;3139;9202;2882;8810;111;459;2240;6740;2351;7199
350870;201802;2703;8191;2097;7126;430;1661;1041;3467;1471;5128
350880;201802;1295;4083;1039;3474;235;820;295;940;530;1760
350890;201802;645;1757;403;1251;42;141;123;313;165;454
350900;201802;5762;17058;3989;13337;1255;4601;441;1371;1696;5972
350910;201802;815;2277;703;2055;139;476;414;1157;553;1633
350920;201802;11605;31016;10022;28399;679;2235;7678;20914;8357;23149
350925;201802;4537;13423;3414;11276;799;2719;1137;3373;1936;6092
350930;201802;1379;3783;970;2958;156;496;452;1312;608;1808
350940;201802;1909;5825;1605;5253;240;877;925;2925;1165;3802
350945;201802;919;2736;719;2343;121;432;318;980;439;1412
350950;201802;76783;217491;61203;185025;10318;34296;32497;92760;42815;127056
350960;201802;4848;14825;3938;13060;758;2868;1997;6267;2755;9135
350970;201802;3796;12371;3031;10623;965;3671;447;1363;1412;5034
350980;201802;587;1851;501;1656;196;678;156;514;352;1192
350990;201802;1767;5491;1365;4751;358;1387;417;1345;775;2732
350995;201802;802;2606;726;2442;71;289;441;1405;512;1694
351000;201802;2553;7245;1972;6161;387;1331;658;1928;1045;3259
351010;201802;306;832;175;558;23;76;81;252;104;328
351015;201802;673;2214;557;1993;107;424;241;823;348;1247
351020;201802;8492;24713;6911;22173;1354;4636;3947;12515;5301;17151
351030;201802;2377;7566;1961;6625;328;1293;939;2965;1267;4258
351040;201802;4225;11617;3632;10668;278;990;2721;7700;2999;8690
351050;201802;16061;41978;11035;33727;2498;8285;3779;11408;6277;19693
351060;201802;40782;110202;32297;95781;4939;15922;18853;54273;23792;70195
351070;201802;1392;3738;836;2710;241;838;85;249;326;1087
351080;201802;2538;7146;1916;6333;443;1628;858;2645;1301;4273
351090;201802;362;1139;259;939;46;180;55;201;101;381
351100;201802;2544;7327;1674;5319;429;1446;326;1051;755;2497
351110;201802;5294;14241;3516;10964;814;2803;1125;3199;1939;6002
351120;201802;693;1936;483;1529;81;268;188;536;269;804
351130;201802;953;2603;463;1593;85;298;80;270;165;568
351140;201802;1662;5351;1299;4578;371;1416;301;927;672;2343
351150;201802;1611;5136;1043;3746;229;874;113;359;342;1233
351160;201802;1137;3848;955;3434;225;871;312;986;537;1857
351170;201802;1429;4298;1196;3804;142;504;676;2016;818;2520
351190;201802;824;2541;625;2045;95;302;210;658;305;960
351200;201802;1668;4421;1293;3823;97;324;756;2124;853;2448
351210;201802;1398;3583;871;2562;110;377;422;1115;532;1492
351220;201802;2968;9256;2627;8598;386;1367;1533;4902;1919;6269
351230;201802;1759;5191;1366;4486;292;1074;605;1804;897;2878
351240;201802;1586;4455;1076;3331;242;801;452;1282;694;2083
351250;201802;1034;2959;617;2000;89;303;206;656;295;959
351260;201802;888;2560;730;2237;245;751;170;496;415;1247
351270;201802;326;1024;280;926;60;238;133;364;193;602
351280;201802;4796;13308;3636;11078;651;2220;1483;4266;2134;6486
351290;201802;944;2607;660;2064;136;449;268;801;404;1250
351300;201802;13748;40964;9955;33452;2330;8468;3195;10728;5525;19196
351310;201802;2913;8332;2288;7211;332;1228;1249;3649;1581;4877
351320;201802;888;2835;699;2359;130;465;239;757;369;1222
351330;201802;1039;4027;977;3927;62;172;826;3466;888;3638
351340;201802;6011;18836;4931;16822;1356;4799;1796;6166;3152;10965
351350;201802;9639;27006;8172;24488;1337;4206;5089;14742;6426;18948
351360;201802;3947;11557;3431;10656;864;2943;1083;3104;1947;6047
351370;201802;2245;6702;1607;5318;377;1304;560;1687;937;2991
351380;201802;39405;106579;32267;93705;6057;18539;15884;44950;21941;63489
351385;201802;269;747;176;554;32;95;55;168;87;263
351390;201802;1337;3605;918;2971;207;810;441;1288;648;2098
351400;201802;946;2874;801;2588;201;674;321;1011;522;1685
351410;201802;2344;7000;1863;6058;308;1021;932;2991;1240;4012
351420;201802;282;773;179;560;40;118;56;174;96;292
351430;201802;759;2291;692;2167;80;282;494;1514;574;1796
351440;201802;3190;9096;2248;7073;429;1462;437;1170;866;2632
351450;201802;1525;4200;1140;3500;252;816;274;843;526;1659
351460;201802;688;1952;580;1752;221;652;223;676;444;1328
351470;201802;1033;2905;859;2580;87;319;497;1387;584;1706
351480;201802;2554;8056;2200;7442;313;1301;1163;3767;1476;5068
351490;201802;1823;5724;1595;5242;126;532;1083;3371;1209;3903
351492;201802;329;989;273;863;17;63;147;435;164;498
351495;201802;189;602;147;487;23;88;65;201;88;289
351500;201802;32525;86131;24102;71347;5456;17121;10747;30469;16203;47590
351510;201802;10526;29259;8029;24624;1447;4836;4260;12629;5707;17465
351512;201802;487;1368;338;1031;59;183;134;378;193;561
351515;201802;2748;7162;1758;5339;357;1264;417;1241;774;2505
351518;201802;2233;6251;1523;4945;257;981;739;2161;996;3142
351519;201802;650;1895;444;1425;92;344;85;185;177;529
351520;201802;988;2607;389;1286;53;203;132;373;185;576
351530;201802;342;1018;194;645;27;86;60;166;87;252
351535;201802;2147;5415;1643;4612;150;520;1034;2737;1184;3257
351540;201802;1800;4987;1275;4001;448;1547;206;529;654;2076
351550;201802;5370;15096;3680;11400;566;1933;1648;4733;2214;6666
351560;201802;417;1315;354;1170;84;319;79;251;163;570
351565;201802;162;547;143;500;28;105;58;190;86;295
351570;201802;15303;43351;12281;37440;1903;6347;7352;21549;9255;27896
351580;201802;279;758;162;523;29;83;49;178;78;261
351590;201802;507;1243;288;813;31;113;161;424;192;537
351600;201802;1683;4554;1289;3822;160;530;711;1963;871;2493
351610;201802;643;1662;451;1326;40;147;251;651;291;798
351620;201802;19335;57471;14696;48553;2787;10420;5091;14989;7878;25409
351630;201802;24341;70042;20753;63953;3822;12347;12234;36869;16056;49216
351640;201802;14376;40729;11642;35978;1692;5846;7150;21346;8842;27192
351650;201802;401;1163;184;623;30;106;27;85;57;191
351660;201802;764;2373;509;1717;95;352;90;268;185;620
351670;201802;4547;13436;3428;10889;651;2214;1615;4791;2266;7005
351680;201802;470;1446;293;970;58;182;67;221;125;403
351685;201802;443;1374;364;1217;87;287;134;441;221;728
351690;201802;988;2794;678;2139;122;414;238;655;360;1069
351700;201802;944;2727;803;2460;175;519;315;954;490;1473
351710;201802;605;1896;463;1597;60;251;195;613;255;864
351720;201802;1375;3927;974;3113;182;619;369;1141;551;1760
351730;201802;988;2716;751;2325;101;374;365;1052;466;1426
351740;201802;3864;10230;3020;8598;561;1690;1254;3287;1815;4977
351750;201802;1250;3814;784;2771;135;520;275;971;410;1491
351760;201802;3209;9667;2399;7909;563;2035;674;2013;1237;4048
351770;201802;1996;6185;1660;5495;477;1639;613;1964;1090;3603
351780;201802;1355;3664;731;2298;124;443;186;549;310;992
351790;201802;1192;3174;966;2835;154;426;584;1739;738;2165
351800;201802;572;1272;288;754;37;106;94;211;131;317
351810;201802;979;2748;807;2437;68;182;578;1704;646;1886
351820;201802;2425;7393;1727;5909;362;1319;277;933;639;2252
351830;201802;4340;12519;3323;10547;443;1628;1772;5357;2215;6985
351840;201802;6798;21472;5639;19234;1207;4576;2283;7285;3490;11861
351850;201802;2004;5326;1324;4106;232;843;426;1185;658;2028
351860;201802;2852;8913;2413;8006;519;1856;1151;3755;1670;5611
351870;201802;24621;68886;19755;60585;6325;20184;7043;21846;13368;42030
351880;201802;112715;327752;89376;283978;26484;90221;24315;72953;50799;163174
351885;201802;697;2266;616;2086;144;506;274;896;418;1402
351890;201802;589;1810;478;1592;99;340;78;214;177;554
351900;201802;1129;3339;897;2943;202;691;300;999;502;1690
351905;201802;426;1253;310;1004;35;124;139;412;174;536
351907;201802;20506;56930;16613;49850;1024;3756;12048;35159;13072;38915
351910;201802;1152;3237;846;2588;163;547;359;985;522;1532
351920;201802;933;2511;723;2135;88;308;361;1012;449;1320
351925;201802;955;2742;764;2371;112;357;353;1007;465;1364
351930;201802;2745;8335;2609;8082;279;1156;2103;6260;2382;7416
351940;201802;1047;2888;791;2461;92;330;431;1312;523;1642
351950;201802;1507;3919;1083;3167;80;263;619;1772;699;2035
351960;201802;4811;13130;3516;10776;826;2712;1397;4148;2223;6860
351970;201802;5549;18911;4893;17663;1065;4270;2245;7649;3310;11919
351980;201802;911;2568;676;2077;109;396;320;892;429;1288
351990;201802;1382;3569;974;2894;141;515;328;863;469;1378
352000;201802;2247;7065;1991;6532;243;944;1173;3638;1416;4582
352010;201802;1871;5712;1525;5028;365;1316;224;781;589;2097
352020;201802;1546;4494;1224;3917;243;849;531;1599;774;2448
352030;201802;5048;14249;4062;12750;777;2718;2190;6753;2967;9471
352040;201802;2055;6032;1392;4664;286;1016;235;699;521;1715
352042;201802;3418;8893;2038;6214;408;1301;824;2509;1232;3810
352044;201802;1917;5572;1140;3985;202;768;240;784;442;1552
352050;201802;11710;33594;7805;25186;1875;6840;1317;3730;3192;10570
352060;201802;738;2156;557;1785;89;322;237;697;326;1019
352070;201802;817;1809;587;1474;97;271;258;619;355;890
352080;201802;461;1275;280;881;47;167;88;243;135;410
352090;201802;1351;4445;1062;3733;189;741;298;926;487;1667
352100;201802;3071;9082;2484;7978;555;1933;1069;3282;1624;5215
352110;201802;545;1774;445;1555;106;388;161;525;267;913
352115;201802;501;1525;417;1372;90;306;207;688;297;994
352120;201802;822;2591;661;2248;86;349;342;1053;428;1402
352130;201802;1835;5438;1181;3772;242;832;350;1061;592;1893
352140;201802;1567;4333;960;3098;151;524;375;1132;526;1656
352150;201802;762;2146;586;1829;154;469;267;845;421;1314
352160;201802;898;2414;666;2034;129;447;265;750;394;1197
352170;201802;2727;8020;2279;7043;469;1574;1086;3103;1555;4677
352180;201802;2963;8312;2415;7252;573;1846;874;2422;1447;4268
352190;201802;1175;3333;877;2799;143;529;298;845;441;1374
352200;201802;386;1255;271;1010;42;165;80;286;122;451
352210;201802;16619;43100;13547;38556;1800;5485;9128;25847;10928;31332
352215;201802;489;1391;440;1330;56;183;293;860;349;1043
352220;201802;14019;39723;10261;32771;3072;10307;2581;8150;5653;18457
352230;201802;12194;39286;9837;34572;2741;10654;3038;9882;5779;20536
352240;201802;11680;32353;8675;26965;2091;7383;3014;8465;5105;15848
352250;201802;20389;61734;17112;55865;4625;15834;7573;24333;12198;40167
352260;201802;5557;15772;3819;12211;630;2194;1905;5876;2535;8070
352265;201802;874;2634;759;2435;66;267;520;1607;586;1874
352270;201802;1520;4966;1213;4288;281;1049;344;1174;625;2223
352280;201802;2285;6388;1827;5658;218;833;937;2715;1155;3548
352290;201802;1072;3343;906;2959;162;616;412;1214;574;1830
352300;201802;969;2744;693;2168;111;417;314;855;425;1272
352310;201802;44678;124934;34247;106964;9150;29272;14089;44206;23239;73478
352320;201802;5635;16283;4560;14069;899;3072;1969;5392;2868;8464
352330;201802;1936;5858;1596;5359;420;1564;646;2038;1066;3602
352340;201802;4787;14190;3589;11976;910;3261;1110;3456;2020;6717
352350;201802;1729;5475;1457;4846;262;1006;551;1670;813;2676
352360;201802;1050;3012;920;2809;159;584;624;1803;783;2387
352370;201802;940;3000;831;2771;51;229;580;1873;631;2102
352380;201802;852;2542;683;2237;171;614;190;584;361;1198
352390;201802;17848;45380;11837;34779;1912;6231;5942;16451;7854;22682
352400;201802;3473;9855;2738;8501;655;2373;1346;3781;2001;6154
352410;201802;2857;8131;2347;7297;349;1215;1261;3762;1610;4977
352420;201802;929;2348;651;1874;104;321;245;688;349;1009
352430;201802;6651;18531;5174;16046;1574;5162;1784;5502;3358;10664
352440;201802;16413;48251;13019;41551;2845;9666;5418;16711;8263;26377
352450;201802;636;1874;360;1244;71;260;95;317;166;577
352460;201802;2605;7841;1937;6509;427;1588;597;1901;1024;3489
352470;201802;3808;10139;2786;8354;320;1105;1481;4126;1801;5231
352480;201802;3761;9658;2659;7658;501;1626;1144;3008;1645;4634
352490;201802;685;2240;531;1875;98;372;190;665;288;1037
352500;201802;9206;24895;7181;21426;3564;11548;1204;2653;4768;14201
352510;201802;3117;9103;2440;7882;637;2230;782;2409;1419;4639
352520;201802;2285;7084;1861;6241;468;1666;771;2465;1239;4131
352530;201802;8564;25628;5829;19421;1374;4939;822;2140;2196;7079
352540;201802;524;1602;380;1275;77;275;88;273;165;548
352550;201802;884;2720;630;2191;127;488;153;487;280;975
352560;201802;551;1639;389;1265;70;227;93;272;163;499
352570;201802;1883;5851;1246;4481;336;1333;201;590;537;1923
352580;201802;809;2396;626;2018;115;416;217;643;332;1059
352585;201802;250;769;202;662;20;77;98;300;118;377
352590;201802;13490;38541;9960;31558;3203;10847;3607;10500;6810;21347
352600;201802;1862;5451;1441;4546;282;961;612;1798;894;2759
352610;201802;3212;9586;2524;8359;564;2091;806;2482;1370;4573
352620;201802;5243;14999;4383;13631;1195;3816;1794;5542;2989;9358
352630;201802;784;2091;608;1807;104;380;283;767;387;1147
352640;201802;2638;7291;2065;6342;172;588;1358;4095;1530;4683
352650;201802;642;1936;468;1505;79;285;143;430;222;715
352660;201802;967;3261;821;2944;171;635;318;1112;489;1747
352670;201802;9876;28261;5935;19901;1411;5182;426;1398;1837;6580
352680;201802;3066;9635;2250;7768;432;1677;891;2836;1323;4513
352690;201802;30553;80785;22134;64973;2322;7713;12889;35893;15211;43606
352700;201802;568;1540;429;1334;158;538;124;338;282;876
352710;201802;4987;13937;3659;11351;964;3296;1330;3849;2294;7145
352720;201802;8027;24146;6621;21271;2687;8826;1264;3804;3951;12630
352725;201802;413;1138;211;684;14;51;99;302;113;353
352730;201802;2492;7639;2209;6936;421;1500;1123;3169;1544;4669
352740;201802;2162;5493;1655;4702;212;665;916;2515;1128;3180
352750;201802;445;1182;234;751;46;158;52;136;98;294
352760;201802;1396;4374;1105;3681;199;736;479;1494;678;2230
352770;201802;781;2351;608;1956;125;439;203;611;328;1050
352780;201802;620;2004;477;1660;93;331;152;526;245;857
352790;201802;613;1701;425;1342;62;206;144;417;206;623
352800;201802;1168;3945;867;3154;212;812;191;639;403;1451
352810;201802;1066;2671;657;1889;114;327;278;777;392;1104
352820;201802;567;1477;380;1174;81;259;91;269;172;528
352830;201802;564;1522;269;844;39;129;47;122;86;251
352840;201802;3864;12247;3356;11267;1040;3664;1229;3936;2269;7600
352850;201802;10348;27816;7265;22793;1908;6420;2167;6653;4075;13073
352860;201802;829;2667;729;2439;161;582;282;914;443;1496
352870;201802;830;2143;548;1524;49;158;298;754;347;912
352880;201802;1970;5081;1380;3959;211;636;635;1623;846;2259
352885;201802;268;826;216;728;31;99;131;439;162;538
352890;201802;636;1610;415;1133;67;210;181;410;248;620
352900;201802;18148;50627;12927;40273;2459;8418;5186;15112;7645;23530
352910;201802;415;1163;214;700;19;71;46;124;65;195
352920;201802;2495;6924;1812;5629;254;872;931;2705;1185;3577
352930;201802;5482;16291;4279;13807;835;2873;1655;5066;2490;7939
352940;201802;21845;65808;17571;56951;5428;19413;3113;9023;8541;28436
352950;201802;447;1206;243;790;48;172;23;58;71;230
352960;201802;648;1882;362;1213;57;206;109;336;166;542
352965;201802;318;906;188;615;49;170;34;96;83;266
352970;201802;3064;7570;2430;6593;248;683;1644;4477;1892;5160
352980;201802;1271;3770;1037;3365;206;718;508;1613;714;2331
352990;201802;4020;12082;3382;11017;757;2794;1605;4927;2362;7721
353000;201802;451;1241;225;730;42;150;54;147;96;297
353010;201802;2667;7134;1848;5549;422;1387;578;1583;1000;2970
353020;201802;3846;10281;2211;6768;310;1013;773;2163;1083;3176
353030;201802;3848;10666;2763;8583;687;2252;517;1576;1204;3828
353040;201802;516;1380;404;1171;86;272;152;404;238;676
353050;201802;4940;15473;3817;13145;960;3589;1431;4655;2391;8244
353060;201802;43807;121499;36917;110208;3480;12412;25873;74117;29353;86529
353070;201802;9673;28808;6940;23079;1576;5623;2049;6629;3625;12252
353080;201802;4611;13735;3225;10873;763;2792;938;2918;1701;5710
353090;201802;533;1768;465;1614;42;165;276;906;318;1071
353100;201802;290;792;115;387;12;45;23;72;35;117
353110;201802;7256;21565;6209;19888;1001;3514;3840;12332;4841;15846
353120;201802;545;1547;367;1159;62;223;125;341;187;564
353130;201802;2375;6440;1701;5387;500;1724;516;1572;1016;3296
353140;201802;2203;5872;1688;4916;224;724;930;2557;1154;3281
353150;201802;1510;4235;1142;3588;302;960;357;1072;659;2032
353160;201802;637;1724;434;1355;77;251;168;479;245;730
353170;201802;498;1502;417;1388;83;348;202;618;285;966
353180;201802;9274;24496;7418;21540;1064;3399;4799;13639;5863;17038
353190;201802;3442;9897;2767;8477;371;1231;1565;4495;1936;5726
353200;201802;1105;3498;766;2596;166;613;190;602;356;1215
353205;201802;331;1101;289;997;72;280;133;447;205;727
353210;201802;970;2411;628;1796;35;127;380;1043;415;1170
353215;201802;424;1256;351;1101;50;181;140;371;190;552
353220;201802;614;1773;449;1440;118;388;93;281;211;669
353230;201802;795;2420;679;2230;165;592;249;722;414;1314
353240;201802;2109;6320;1783;5691;237;883;1066;3261;1303;4144
353250;201802;1112;2790;745;2115;128;379;326;897;454;1276
353260;201802;926;2478;574;1794;123;410;163;473;286;883
353270;201802;619;1774;508;1547;71;211;241;702;312;913
353280;201802;688;2031;493;1597;86;286;144;451;230;737
353282;201802;1798;5423;1586;4990;222;768;882;2657;1104;3425
353284;201802;401;1022;213;639;37;128;71;189;108;317
353286;201802;130;384;96;319;24;80;22;61;46;141
353290;201802;1130;3257;819;2619;98;387;432;1254;530;1641
353300;201802;1586;4601;1201;3797;203;714;482;1385;685;2099
353310;201802;304;807;219;651;35;120;105;287;140;407
353320;201802;583;1611;484;1422;33;98;340;990;373;1088
353325;201802;598;1885;423;1488;79;286;127;443;206;729
353330;201802;540;1478;361;1082;46;163;194;535;240;698
353340;201802;2954;8231;1997;6447;542;1874;611;1960;1153;3834
353350;201802;3220;9360;2240;7182;536;1839;414;1173;950;3012
353360;201802;480;1538;415;1406;57;216;231;768;288;984
353370;201802;569;1849;491;1689;49;185;292;971;341;1156
353380;201802;289;942;236;821;39;148;87;297;126;445
353390;201802;5633;14912;4100;12160;767;2433;1608;4520;2375;6953
353400;201802;430;1290;342;1107;66;233;67;166;133;399
353410;201802;582;1642;470;1437;91;299;227;670;318;969
353420;201802;522;1432;298;914;61;176;31;77;92;253
353430;201802;2095;6536;1561;5342;409;1522;399;1275;808;2797
353440;201802;57510;170466;42361;139153;9746;33447;17406;55231;27152;88678
353450;201802;387;1061;265;810;41;149;109;308;150;457
353460;201802;3350;9374;2443;7559;259;906;1085;3358;1344;4264
353470;201802;6906;19769;5006;16059;1061;3700;1558;4674;2619;8374
353475;201802;1419;3954;1027;3077;149;486;413;1127;562;1613
353480;201802;1432;4191;1250;3833;88;292;884;2644;972;2936
353490;201802;937;2655;678;2090;137;422;265;783;402;1205
353500;201802;954;2423;772;2139;199;551;393;1117;592;1668
353510;201802;855;2679;622;2071;169;579;104;312;273;891
353520;201802;1138;3094;794;2469;89;309;388;1146;477;1455
353530;201802;2281;6398;1850;5562;248;852;987;2774;1235;3626
353540;201802;1925;5734;1620;5191;334;1124;805;2522;1139;3646
353550;201802;5766;16185;4638;14159;829;2740;2322;6721;3151;9461
353560;201802;2088;6499;1647;5728;545;2061;386;1264;931;3325
353570;201802;497;1454;363;1184;84;279;160;505;244;784
353580;201802;2188;6109;1769;5334;396;1254;866;2513;1262;3767
353590;201802;669;1934;426;1373;91;299;149;496;240;795
353600;201802;1663;4507;1402;3998;176;545;739;1996;915;2541
353610;201802;606;2039;464;1723;97;398;104;349;201;747
353620;201802;2376;7136;1824;6054;440;1562;460;1407;900;2969
353625;201802;516;1371;304;945;34;128;171;503;205;631
353630;201802;1257;4238;966;3514;202;771;197;671;399;1442
353640;201802;1359;3752;1045;3158;126;450;593;1745;719;2195
353650;201802;8869;25240;6652;20574;1030;3419;3256;9495;4286;12914
353657;201802;298;873;240;770;36;113;90;265;126;378
353660;201802;1060;2442;726;1901;129;389;376;872;505;1261
353670;201802;3400;10502;2823;9327;755;2693;1165;3616;1920;6309
353680;201802;711;2093;549;1829;131;468;230;737;361;1205
353690;201802;500;1315;220;701;25;77;28;79;53;156
353700;201802;1929;5669;1647;5119;237;803;944;2794;1181;3597
353710;201802;3531;8114;1799;5208;307;881;783;2100;1090;2981
353715;201802;543;1532;376;1193;25;102;103;284;128;386
353720;201802;1864;5437;1516;4920;277;1001;799;2483;1076;3484
353730;201802;4188;12175;3179;10034;559;1936;1311;3774;1870;5710
353740;201802;1786;5067;1282;4096;324;1134;326;966;650;2100
353750;201802;883;2860;614;2265;157;632;109;394;266;1026
353760;201802;11311;28718;9021;25526;1323;4187;5686;15731;7009;19918
353770;201802;666;2051;335;1176;72;274;35;76;107;350
353780;201802;4407;13937;3560;12206;1008;3784;856;2737;1864;6521
353790;201802;2154;7070;1684;6087;504;2091;383;1241;887;3332
353800;201802;16362;47812;12827;41469;2723;9466;5490;17485;8213;26951
353810;201802;1041;3074;729;2421;133;513;262;825;395;1338
353820;201802;1544;4782;1214;4026;220;826;496;1581;716;2407
353830;201802;616;1628;472;1380;63;194;247;680;310;874
353850;201802;1686;4969;1334;4259;368;1166;416;1357;784;2523
353860;201802;2512;7730;2011;6654;529;1833;698;2212;1227;4045
353870;201802;27672;77484;19218;60434;3231;11172;7791;22299;11022;33471
353880;201802;2792;8392;2267;7402;264;978;1243;3962;1507;4940
353890;201802;2306;5505;1648;4492;189;580;1008;2594;1197;3174
353900;201802;745;2218;554;1838;118;435;191;580;309;1015
353910;201802;1987;6546;1775;6198;233;843;1221;4358;1454;5201
353920;201802;2317;6628;1568;5099;344;1252;308;858;652;2110
353930;201802;4267;12313;2963;9901;768;2808;561;1726;1329;4534
353940;201802;1096;3452;798;2760;156;566;222;733;378;1299
353950;201802;2968;8979;2451;7909;485;1740;1201;3565;1686;5305
353960;201802;593;1787;409;1375;93;294;115;381;208;675
353970;201802;590;1610;474;1403;45;137;302;872;347;1009
353980;201802;13143;36742;10684;32442;1732;5589;6069;17910;7801;23499
353990;201802;732;1927;479;1445;49;162;288;827;337;989
354000;201802;2233;5911;1365;4221;273;913;210;632;483;1545
354010;201802;356;1005;267;834;38;124;162;484;200;608
354020;201802;3762;11392;3091;9921;810;2838;969;2802;1779;5640
354025;201802;771;2170;537;1731;115;390;150;494;265;884
354030;201802;487;1183;273;767;46;131;102;267;148;398
354040;201802;750;1930;483;1426;42;134;289;806;331;940
354050;201802;950;2922;687;2369;163;628;158;520;321;1148
354060;201802;4417;13243;2992;10089;800;2803;737;2299;1537;5102
354070;201802;2964;9175;2262;7688;551;2025;473;1404;1024;3429
354075;201802;2064;6859;1676;6078;292;1205;844;2985;1136;4190
354080;201802;1475;4298;967;3218;182;654;264;766;446;1420
354085;201802;402;877;331;790;4;24;234;522;238;546
354090;201802;1463;4217;1305;3909;130;452;904;2664;1034;3116
354100;201802;15045;46331;11595;40155;2829;10543;4564;15529;7393;26072
354105;201802;964;2711;826;2508;161;496;476;1447;637;1943
354110;201802;502;1373;381;1193;105;367;104;301;209;668
354120;201802;1649;4572;1139;3457;197;634;386;1057;583;1691
354130;201802;5704;15888;3920;12358;1248;4262;212;475;1460;4737
354140;201802;21985;54818;14175;40887;2993;9207;4607;12242;7600;21449
354150;201802;3474;8985;2571;7364;536;1644;1077;2946;1613;4590
354160;201802;3292;10279;2516;8556;732;2579;713;2369;1445;4948
354165;201802;523;1645;430;1456;91;354;210;670;301;1024
354170;201802;1388;4229;1124;3615;113;410;611;1836;724;2246
354180;201802;455;1380;352;1153;65;242;123;350;188;592
354190;201802;1469;4419;1138;3737;172;637;391;1259;563;1896
354200;201802;912;2519;730;2184;86;277;354;979;440;1256
354210;201802;676;2021;542;1773;58;234;310;922;368;1156
354220;201802;3018;8557;2378;7336;433;1424;1143;3392;1576;4816
354230;201802;692;1999;556;1790;71;286;308;910;379;1196
354240;201802;1338;4098;924;3188;173;657;221;660;394;1317
354250;201802;527;1421;345;1115;101;340;89;294;190;634
354260;201802;7660;21958;6065;19179;1519;5064;1964;6261;3483;11325
354270;201802;1120;3566;907;3137;176;647;334;1146;510;1793
354280;201802;720;1992;614;1828;97;364;360;973;457;1337
354290;201802;865;2960;756;2700;161;601;307;1081;468;1682
354300;201802;3686;11457;3304;10741;1050;3559;1120;3491;2170;7050
354310;201802;776;2372;624;2042;117;406;265;820;382;1226
354320;201802;847;2315;548;1739;111;406;191;547;302;953
354323;201802;522;1341;344;996;41;120;138;372;179;492
354325;201802;1208;3835;895;3124;160;587;315;1032;475;1619
354330;201802;6549;18202;5042;15379;886;3191;2657;7399;3543;10590
354340;201802;24726;69368;18163;58003;4701;16294;6667;20457;11368;36751
354350;201802;1103;3078;918;2713;151;501;531;1438;682;1939
354360;201802;516;1517;311;1087;59;202;41;142;100;344
354370;201802;1054;3430;882;3082;132;524;465;1573;597;2097
354380;201802;774;2197;543;1774;130;501;100;265;230;766
354390;201802;13403;35813;8743;27267;1690;5649;2251;6571;3941;12220
354400;201802;1591;5376;1262;4558;230;909;408;1446;638;2355
354410;201802;5065;14994;4110;13188;974;3396;1679;5172;2653;8568
354420;201802;1398;3951;999;3104;149;496;520;1533;669;2029
354425;201802;2154;5915;1714;5107;426;1326;585;1786;1011;3112
354430;201802;1474;4347;1195;3894;206;761;577;1778;783;2539
354440;201802;553;1591;368;1190;43;146;162;486;205;632
354450;201802;396;1081;224;727;33;117;50;142;83;259
354460;201802;974;2648;679;2077;112;361;288;862;400;1223
354470;201802;538;1373;377;1049;32;107;186;457;218;564
354480;201802;911;2276;668;1897;65;205;408;1102;473;1307
354490;201802;762;2439;597;2061;127;477;201;648;328;1125
354500;201802;2040;6179;1737;5720;576;2086;411;1332;987;3418
354510;201802;814;2243;675;1955;93;274;362;969;455;1243
354515;201802;270;844;210;726;41;172;86;289;127;461
354520;201802;7099;21529;4294;14163;724;2685;2031;6188;2755;8873
354530;201802;3616;11375;2917;9932;706;2550;1109;3733;1815;6283
354540;201802;1279;3683;942;3040;233;812;278;899;511;1711
354550;201802;537;1462;403;1211;69;216;220;631;289;847
354560;201802;1832;4866;1033;3141;131;425;498;1451;629;1876
354570;201802;1103;3037;469;1475;93;333;64;183;157;516
354580;201802;10090;27604;6677;21080;1165;4016;2768;8200;3933;12216
354600;201802;1667;4997;1342;4383;232;831;684;2152;916;2983
354610;201802;367;1013;201;632;41;147;60;169;101;316
354620;201802;450;1355;311;1082;56;241;110;318;166;559
354625;201802;314;940;196;674;25;89;48;136;73;225
354630;201802;2006;6363;1681;5678;690;2481;165;530;855;3011
354640;201802;3069;9675;2276;7890;459;1735;510;1605;969;3340
354650;201802;882;2489;727;2196;90;264;456;1415;546;1679
354660;201802;2492;6575;1725;5297;115;429;1189;3607;1304;4036
354670;201802;1024;3017;727;2332;163;573;216;618;379;1191
354680;201802;4465;13323;3830;12239;995;3324;1833;5849;2828;9173
354690;201802;700;2222;473;1691;103;386;104;350;207;736
354700;201802;1009;2803;704;2151;131;443;294;782;425;1225
354710;201802;517;1509;373;1190;44;156;172;499;216;655
354720;201802;268;698;137;422;40;120;22;66;62;186
354730;201802;9358;27682;6929;23039;1178;4311;3494;11116;4672;15427
354740;201802;332;942;129;467;18;84;20;68;38;152
354750;201802;2492;7025;1700;5541;333;1239;649;1947;982;3186
354760;201802;1817;5449;1352;4503;421;1500;227;750;648;2250
354765;201802;307;843;145;476;18;66;33;99;51;165
354770;201802;2232;5929;1602;4806;411;1334;539;1552;950;2886
354780;201802;54646;146052;43439;123700;6625;21008;23324;62055;29949;83063
354790;201802;869;2663;726;2390;104;360;378;1207;482;1567
354800;201802;2496;6944;1988;6109;401;1332;930;2730;1331;4062
354805;201802;981;2800;727;2274;84;292;281;768;365;1060
354810;201802;584;1802;349;1259;61;241;85;274;146;515
354820;201802;904;2900;708;2495;139;550;164;506;303;1056
354830;201802;459;1188;316;922;100;292;110;312;210;604
354840;201802;754;2160;498;1562;78;239;225;688;303;927
354850;201802;19043;54463;13643;43961;2293;8490;6897;20631;9190;29121
354860;201802;1338;4062;1008;3422;209;778;319;971;528;1749
354870;201802;46919;126664;38073;110340;6629;20909;19900;55171;26529;76080
354880;201802;5048;13244;2517;7656;340;1173;852;2117;1192;3290
354890;201802;15306;42067;12502;37164;2167;7037;6374;18239;8541;25276
354900;201802;456;1296;292;953;36;128;81;253;117;381
354910;201802;5534;15541;3055;10479;628;2325;250;808;878;3133
354920;201802;329;933;187;623;27;116;28;72;55;188
354925;201802;263;793;135;481;28;100;26;81;54;181
354930;201802;356;909;215;651;29;96;98;278;127;374
354940;201802;1750;5915;1379;5012;489;1900;137;451;626;2351
354950;201802;1448;4255;1171;3807;105;450;719;2207;824;2657
354960;201802;784;2241;620;1982;132;477;263;805;395;1282
354970;201802;3788;11803;3152;10538;514;1920;1762;5673;2276;7593
354980;201802;27245;70035;18431;53945;2613;8945;8934;24058;11547;33003
354990;201802;57513;156733;43138;129947;5866;19372;22930;66118;28796;85490
354995;201802;2183;5824;1658;5057;339;1136;912;2658;1251;3794
355000;201802;1431;4193;1165;3735;256;940;275;757;531;1697
355010;201802;3138;9446;2220;7271;771;2689;216;717;987;3406
355020;201802;3042;9375;2271;7819;761;2895;589;1944;1350;4839
355030;201802;1236869;3174021;957274;2645326;184951;557001;438729;1133335;623680;1690336
355040;201802;2752;7896;2331;7242;401;1257;1438;4491;1839;5748
355050;201802;999;2816;756;2369;230;714;169;497;399;1211
355060;201802;4849;14522;3736;12309;706;2639;1596;4723;2302;7362
355070;201802;7309;20910;5985;18630;934;3357;3283;9516;4217;12873
355080;201802;868;2801;582;2167;106;446;46;143;152;589
355090;201802;1117;3521;895;3068;198;692;282;976;480;1668
355100;201802;18729;53609;15003;47797;3193;10969;8206;25521;11399;36490
355110;201802;1064;3198;817;2764;304;1114;152;500;456;1614
355120;201802;621;1830;460;1521;79;301;165;517;244;818
355130;201802;617;1506;274;777;32;94;102;269;134;363
355140;201802;1263;3700;1155;3525;166;591;796;2372;962;2963
355150;201802;3822;10852;3074;9528;547;1820;1471;4482;2018;6302
355160;201802;1775;5266;1365;4516;372;1392;325;1007;697;2399
355170;201802;8809;23979;6817;20759;2000;6420;2589;7893;4589;14313
355180;201802;2703;8016;2041;6789;465;1822;643;1912;1108;3734
355190;201802;1599;4692;1311;4160;369;1267;522;1736;891;3003
355200;201802;798;2662;691;2465;284;1109;161;519;445;1628
355210;201802;2975;8681;2557;7844;292;1060;1607;4658;1899;5718
355220;201802;40580;115726;32499;99888;9361;30515;10455;29323;19816;59838
355230;201802;1257;3276;715;2164;146;440;176;492;322;932
355240;201802;22938;63443;15713;48925;3140;10215;6033;18438;9173;28653
355250;201802;32689;93700;25265;80203;6776;22902;8470;26085;15246;48987
355255;201802;841;2227;450;1408;78;224;144;466;222;690
355260;201802;1211;3345;929;2867;132;517;554;1583;686;2100
355270;201802;1486;4614;1171;3886;279;969;404;1264;683;2233
355280;201802;26808;74310;20114;61321;3656;11944;8520;24663;12176;36607
355290;201802;812;2515;621;2045;155;484;182;558;337;1042
355300;201802;1296;3989;1054;3476;225;780;312;1010;537;1790
355310;201802;1024;2953;784;2540;87;321;416;1339;503;1660
355320;201802;538;1515;426;1301;85;313;166;426;251;739
355330;201802;2018;5796;1495;4816;236;840;828;2532;1064;3372
355340;201802;3087;7342;2619;6666;303;788;1799;4516;2102;5304
355350;201802;1332;4228;995;3482;216;831;297;1005;513;1836
355360;201802;1216;3500;1056;3161;110;338;751;2302;861;2640
355365;201802;360;1003;189;660;40;121;24;84;64;205
355370;201802;6230;16101;4837;14160;1132;3459;2078;6485;3210;9944
355380;201802;2993;8599;2280;7121;442;1462;628;1682;1070;3144
355385;201802;1176;3529;1026;3257;193;703;487;1410;680;2113
355390;201802;731;2112;555;1740;117;376;212;617;329;993
355395;201802;1937;5773;1427;4638;225;778;574;1723;799;2501
355400;201802;8886;28199;7419;25087;2241;8232;1953;6076;4194;14308
355410;201802;21228;61808;14891;49618;3828;13920;2995;9966;6823;23886
355420;201802;696;2440;601;2232;164;710;128;474;292;1184
355430;201802;3674;9743;2890;8379;701;2059;1255;3637;1956;5696
355440;201802;831;2396;570;1827;116;389;159;467;275;856
355450;201802;3659;10197;2291;7304;439;1498;745;2175;1184;3673
355460;201802;558;1473;353;1093;56;210;142;376;198;586
355465;201802;359;1084;261;856;54;194;60;177;114;371
355470;201802;1153;3121;635;2020;171;560;180;536;351;1096
355475;201802;250;668;226;624;20;66;175;474;195;540
355480;201802;3399;10607;2923;9766;524;2007;1661;5333;2185;7340
355490;201802;953;2708;541;1777;73;262;180;559;253;821
355495;201802;793;2455;619;2104;106;395;180;576;286;971
355500;201802;6665;18910;4139;13362;671;2334;976;2948;1647;5282
355510;201802;1687;4297;860;2691;128;441;249;682;377;1123
355520;201802;410;948;203;554;24;75;103;257;127;332
355530;201802;472;1073;172;496;20;72;54;123;74;195
355535;201802;566;1638;439;1413;122;453;140;394;262;847
355540;201802;8500;24605;7351;22825;1454;4849;4201;12671;5655;17520
355550;201802;681;2086;542;1802;73;241;227;757;300;998
355560;201802;1088;3167;606;2058;120;430;31;105;151;535
355570;201802;239;709;123;419;22;87;19;62;41;149
355580;201802;1225;3212;826;2497;115;422;377;1088;492;1510
355590;201802;194;514;145;433;21;69;78;226;99;295
355600;201802;1458;3909;1018;3060;251;827;362;1014;613;1841
355610;201802;1666;4482;1184;3551;186;592;547;1563;733;2155
355620;201802;4548;13365;3517;11139;503;1838;1733;5004;2236;6842
355630;201802;2253;6600;1591;5308;353;1231;576;1916;929;3147
355635;201802;929;2849;769;2571;101;355;476;1636;577;1991
355640;201802;2704;8289;1907;6683;447;1662;354;1226;801;2888
355645;201802;4047;12500;3323;11292;415;1688;2031;6760;2446;8448
355650;201802;6891;19723;5792;17683;1377;4589;3034;8623;4411;13212
355660;201802;1269;3665;931;2973;125;492;368;1148;493;1640
355670;201802;3306;9846;2268;7351;382;1424;980;2804;1362;4228
355680;201802;2701;7969;1192;4126;334;1250;96;278;430;1528
355690;201802;592;1883;399;1474;118;460;17;46;135;506
355695;201802;237;771;133;480;13;50;17;52;30;102
355700;201802;6058;18800;5092;16610;1262;4189;2082;6551;3344;10740
355710;201802;8647;21226;5322;15160;1004;3038;1725;4463;2729;7501
355715;201802;387;1153;234;778;57;212;49;153;106;365
355720;201802;1437;4546;1161;3956;245;878;456;1409;701;2287
355730;201802;855;2638;713;2337;191;616;222;688;413;1304
410010;201802;1320;3850;1023;3193;223;767;218;659;441;1426
410020;201802;1092;3512;915;3099;300;1017;280;932;580;1949
410030;201802;1297;4051;1092;3624;234;851;429;1405;663;2256
410040;201802;10572;32182;8641;28544;1871;6784;2800;8835;4671;15619
410045;201802;1012;2764;687;2155;110;396;198;569;308;965
410050;201802;2660;6891;1653;5012;389;1271;266;698;655;1969
410060;201802;2143;6427;1737;5585;427;1428;589;1858;1016;3286
410070;201802;1669;4568;1245;3739;279;910;407;1157;686;2067
410080;201802;1386;3812;1032;3159;174;575;408;1222;582;1797
410090;201802;977;2865;905;2722;123;378;481;1519;604;1897
410100;201802;2254;6875;1618;5302;243;921;269;861;512;1782
410105;201802;371;1103;227;743;50;197;40;111;90;308
410110;201802;3089;8466;2215;6676;323;1039;788;2322;1111;3361
410115;201802;518;1360;376;1098;75;244;128;339;203;583
410120;201802;2448;7989;2191;7524;845;3058;525;1766;1370;4824
410130;201802;1086;3179;986;2995;347;1170;301;788;648;1958
410140;201802;15608;39906;9870;29378;2031;6575;2035;5633;4066;12208
410150;201802;16516;41114;8031;23576;1543;4831;1333;3757;2876;8588
410160;201802;2917;8573;2487;7778;543;1876;919;2916;1462;4792
410165;201802;642;1863;532;1611;68;231;303;868;371;1099
410170;201802;2239;6223;1635;4880;448;1460;180;512;628;1972
410180;201802;12672;38275;10305;32984;1864;6342;4786;14389;6650;20731
410185;201802;511;1428;373;1169;67;214;107;312;174;526
410190;201802;2008;5559;1562;4675;346;1087;343;976;689;2063
410200;201802;4034;10516;2590;7762;534;1847;504;1476;1038;3323
410210;201802;2566;7299;1762;5547;294;1037;452;1219;746;2256
410220;201802;622;1635;416;1241;52;176;107;328;159;504
410230;201802;1469;4354;1235;3877;244;880;569;1670;813;2550
410240;201802;4255;12309;3528;10876;1041;3564;418;1263;1459;4827
410250;201802;2664;6942;1863;5451;357;1166;568;1580;925;2746
410260;201802;1677;4472;1170;3565;226;774;507;1498;733;2272
410270;201802;517;1395;393;1157;33;109;192;558;225;667
410275;201802;753;2240;489;1613;70;241;202;645;272;886
410280;201802;2099;5969;1411;4508;296;1059;418;1205;714;2264
410290;201802;3262;9638;2501;8044;580;1834;896;2906;1476;4740
410300;201802;675;1794;531;1519;89;280;226;591;315;871
410302;201802;334;900;172;570;20;63;94;306;114;369
410304;201802;1160;3476;1009;3148;197;672;498;1535;695;2207
410305;201802;1716;4461;1283;3766;308;927;578;1695;886;2622
410310;201802;2347;7138;1970;6447;437;1574;634;2062;1071;3636
410315;201802;783;2077;423;1413;102;350;99;322;201;672
410320;201802;1136;3332;744;2441;106;401;114;354;220;755
410322;201802;533;1515;287;927;33;109;88;275;121;384
410330;201802;1398;3722;1050;3035;225;710;271;761;496;1471
410335;201802;864;2482;711;2174;119;420;309;867;428;1287
410337;201802;771;2001;543;1561;64;196;227;613;291;809
410340;201802;516;1442;351;1033;47;155;144;354;191;509
410345;201802;2060;5641;1203;3771;266;858;284;827;550;1685
410347;201802;714;1840;512;1473;53;179;150;409;203;588
410350;201802;1229;3508;905;2858;133;467;280;803;413;1270
410360;201802;4021;10323;3110;8734;285;929;1888;5129;2173;6058
410370;201802;11236;31478;7841;23849;1208;4087;2709;7266;3917;11353
410380;201802;1342;3747;1088;3230;128;471;424;1158;552;1629
410390;201802;2533;7139;1733;5508;491;1702;327;928;818;2630
410395;201802;897;2769;730;2403;155;571;319;1053;474;1624
410400;201802;4771;13986;3756;11896;726;2465;1393;4227;2119;6692
410405;201802;803;2145;648;1892;139;436;284;807;423;1243
410410;201802;1139;3394;1111;3360;219;820;635;1899;854;2719
410420;201802;7204;22338;5657;18928;1209;4497;1245;3759;2454;8256
410425;201802;2780;8430;2058;6944;383;1386;575;1804;958;3190
410430;201802;12921;33965;9122;26913;1616;5192;2791;7778;4407;12970
410440;201802;2864;9531;2540;8906;441;1616;1330;4851;1771;6467
410442;201802;2381;7721;2075;7056;631;2280;622;2078;1253;4358
410445;201802;2282;7039;1844;6163;427;1579;523;1784;950;3363
410450;201802;1757;4894;1327;4029;257;845;274;722;531;1567
410460;201802;1681;4626;1300;3978;253;843;435;1257;688;2100
410465;201802;2371;7438;1936;6494;468;1568;587;1923;1055;3491
410470;201802;1805;5531;1351;4521;337;1237;256;877;593;2114
410480;201802;30823;82832;17999;57111;2856;9978;1858;5089;4714;15067
410490;201802;11028;32487;8002;26006;1664;5773;2408;7345;4072;13118
410500;201802;1631;4837;1210;3918;331;1187;224;609;555;1796
410510;201802;2212;5778;1441;4190;264;783;463;1312;727;2095
410520;201802;3004;10006;2754;9498;751;2655;1206;4205;1957;6860
410530;201802;1507;4094;816;2472;130;402;97;227;227;629
410540;201802;2702;7792;1922;6173;325;1087;811;2584;1136;3671
410550;201802;6499;18138;4248;13189;831;2818;759;2065;1590;4883
410560;201802;1333;3700;1038;3139;237;775;399;1098;636;1873
410570;201802;2598;7847;2097;6904;570;2107;318;1116;888;3223
410580;201802;22887;64220;17797;54514;3710;12636;6841;19369;10551;32005
410590;201802;1380;4200;921;3011;161;563;193;548;354;1111
410600;201802;1735;4962;1367;4223;320;980;459;1457;779;2437
410610;201802;747;2078;548;1685;66;218;195;566;261;784
410620;201802;1894;6007;1273;4486;310;1174;163;496;473;1670
410630;201802;2264;6604;1489;4847;294;1055;151;384;445;1439
410640;201802;4115;10673;2876;8497;747;2484;427;1188;1174;3672
410645;201802;1108;3604;994;3418;401;1427;271;970;672;2397
410650;201802;1986;5861;1488;4813;403;1399;358;1045;761;2444
410655;201802;1361;4486;1108;3989;56;200;753;2895;809;3095
410657;201802;699;1877;445;1339;88;285;167;443;255;728
410660;201802;3054;8317;1657;5195;346;1111;237;707;583;1818
410670;201802;925;2396;614;1779;106;312;283;788;389;1100
410680;201802;2881;9035;2124;7165;542;1780;483;1720;1025;3500
410685;201802;584;1623;484;1432;87;293;246;684;333;977
410690;201802;119816;323022;80600;245099;14711;49870;23165;61562;37876;111432
410700;201802;2203;6095;1901;5573;400;1248;875;2412;1275;3660
410710;201802;892;2496;600;1913;84;282;261;782;345;1064
410712;201802;707;2094;613;1923;181;621;213;616;394;1237
410715;201802;843;2691;570;2015;105;385;154;524;259;909
410720;201802;2886;8249;2231;6873;350;1266;423;1174;773;2440
410725;201802;1074;2889;696;2155;120;391;107;299;227;690
410730;201802;559;1529;407;1249;95;332;73;212;168;544
410740;201802;913;2653;641;2108;118;424;252;825;370;1249
410750;201802;1746;4820;1417;4171;265;852;519;1444;784;2296
410752;201802;317;820;145;443;21;74;52;133;73;207
410753;201802;251;750;168;562;20;70;28;79;48;149
410754;201802;1129;3112;959;2837;65;168;607;1969;672;2137
410755;201802;709;1775;500;1397;48;151;271;715;319;866
410760;201802;2791;7901;2244;6912;641;2112;617;1874;1258;3986
410765;201802;12989;38611;10090;32929;1673;6100;1194;3695;2867;9795
410770;201802;923;2410;637;1895;107;344;232;679;339;1023
410773;201802;1307;3646;1161;3428;166;563;826;2378;992;2941
410775;201802;1417;3875;1248;3592;212;670;506;1418;718;2088
410780;201802;600;1564;359;1064;77;233;80;260;157;493
410785;201802;754;2247;619;1976;152;522;179;545;331;1067
410790;201802;545;1701;453;1490;135;467;36;99;171;566
410800;201802;2940;6944;2330;6018;212;620;1116;2811;1328;3431
410810;201802;325;939;261;814;42;155;108;319;150;474
410820;201802;812;2440;506;1614;111;358;75;229;186;587
410830;201802;28973;78147;21775;65486;5703;19076;6872;19605;12575;38681
410832;201802;1015;2787;856;2480;116;437;466;1248;582;1685
410840;201802;6951;19182;4339;13906;1028;3621;502;1297;1530;4918
410845;201802;1137;3257;939;2892;194;641;315;936;509;1577
410850;201802;2436;7272;2132;6731;441;1512;843;2672;1284;4184
410855;201802;591;1585;427;1257;44;146;182;495;226;641
410860;201802;3972;10803;3082;9098;553;1736;995;2836;1548;4572
410865;201802;1404;4520;1263;4219;275;985;680;2337;955;3322
410870;201802;1218;3489;1069;3263;103;322;712;2205;815;2527
410880;201802;3966;11730;3029;9884;549;1994;433;1474;982;3468
410890;201802;914;2840;695;2365;150;554;179;585;329;1139
410895;201802;961;3225;829;2924;321;1222;127;416;448;1638
410900;201802;874;2406;597;1846;102;345;154;394;256;739
410910;201802;365;902;221;615;14;39;117;303;131;342
410920;201802;759;2060;601;1789;134;451;226;654;360;1105
410930;201802;1519;4402;1218;3788;339;1198;269;797;608;1995
410940;201802;21048;63434;16559;54841;4674;16716;3238;10944;7912;27660
410950;201802;1870;5778;1691;5486;79;310;1375;4398;1454;4708
410960;201802;7601;20387;4774;15130;1228;4300;1307;3997;2535;8297
410965;201802;1006;2889;768;2392;144;474;334;998;478;1472
410970;201802;4027;11396;2951;9315;724;2695;451;1271;1175;3966
410975;201802;1380;3817;1067;3224;206;721;367;1077;573;1798
410980;201802;6645;18010;4392;13638;633;2143;1634;4865;2267;7008
410990;201802;1091;3033;724;2301;219;797;152;395;371;1192
411000;201802;464;1360;334;1091;44;160;78;208;122;368
411005;201802;452;1293;288;928;59;185;47;154;106;339
411007;201802;2232;6772;1915;6162;474;1639;589;1874;1063;3513
411010;201802;4157;13252;3488;11812;970;3499;365;1160;1335;4659
411020;201802;2369;7044;2000;6399;609;2054;565;1744;1174;3798
411030;201802;699;1846;461;1304;81;234;142;368;223;602
411040;201802;753;2071;329;1027;55;179;67;191;122;370
411050;201802;1871;6250;1609;5642;467;1762;237;732;704;2494
411060;201802;1589;4501;1119;3532;220;827;216;606;436;1433
411065;201802;330;935;250;785;44;138;101;315;145;453
411070;201802;6419;17961;5041;15375;1071;3583;1714;4982;2785;8565
411080;201802;2118;5945;1709;5179;467;1521;394;1192;861;2713
411090;201802;799;2113;540;1638;45;153;100;275;145;428
411095;201802;1456;3723;1049;3007;154;500;371;1002;525;1502
411100;201802;1152;3260;815;2581;108;420;218;683;326;1103
411110;201802;574;1608;267;894;25;78;18;48;43;126
411120;201802;1403;4164;1086;3490;346;1256;203;548;549;1804
411125;201802;4654;14366;4320;13761;1050;3479;1894;6211;2944;9690
411130;201802;669;1894;475;1473;96;299;157;519;253;818
411140;201802;2267;7293;1872;6382;448;1593;717;2492;1165;4085
411150;201802;3839;10524;2759;8330;579;1970;226;548;805;2518
411155;201802;962;2581;621;1926;74;248;263;752;337;1000
411160;201802;295;775;211;625;33;94;54;164;87;258
411170;201802;737;2259;566;1866;134;459;168;550;302;1009
411180;201802;5416;15381;4266;13234;820;2832;1591;4717;2411;7549
411190;201802;1320;3677;1032;3101;239;780;262;687;501;1467
411200;201802;4704;13298;3402;10771;892;3057;891;2721;1783;5778
411210;201802;2114;5520;1604;4678;475;1565;170;434;645;1999
411220;201802;860;2388;684;2043;152;502;232;667;384;1169
411230;201802;1081;2983;702;2248;146;492;204;661;350;1153
411240;201802;1613;3821;931;2665;108;329;437;1213;545;1542
411250;201802;1967;5631;1575;4926;363;1295;488;1517;851;2812
411260;201802;353;913;223;663;32;97;85;231;117;328
411270;201802;1794;5298;1480;4666;255;890;659;2018;914;2908
411275;201802;1361;3797;1025;3135;192;627;372;1126;564;1753
411280;201802;1455;4103;915;2931;170;596;137;379;307;975
411290;201802;722;2026;512;1615;79;254;208;655;287;909
411295;201802;1074;2796;884;2439;122;374;377;985;499;1359
411300;201802;988;2554;650;1877;63;189;244;610;307;799
411310;201802;863;2205;672;1907;48;146;257;717;305;863
411320;201802;5147;14507;3773;11902;895;2922;935;2719;1830;5641
411325;201802;1509;4550;1317;4171;248;803;666;2162;914;2965
411330;201802;3152;9290;2434;7868;644;2259;599;1971;1243;4230
411340;201802;783;2265;501;1596;64;240;213;659;277;899
411342;201802;767;2014;552;1598;113;345;232;631;345;976
411345;201802;991;2830;819;2508;126;452;471;1429;597;1881
411350;201802;2665;7645;1907;6109;490;1733;184;589;674;2322
411360;201802;616;1546;429;1247;47;154;148;399;195;553
411370;201802;45530;121054;34471;101512;3976;13632;17691;48633;21667;62265
411373;201802;1344;3762;1102;3365;145;484;476;1470;621;1954
411375;201802;1046;2805;776;2311;125;396;270;739;395;1135
411380;201802;1059;2716;708;1958;76;253;336;818;412;1071
411390;201802;1706;4950;1344;4097;236;780;451;1244;687;2024
411400;201802;2098;5635;1681;4804;307;1014;650;1757;957;2771
411410;201802;2072;6083;1551;4954;359;1248;324;927;683;2175
411420;201802;3861;10253;2358;7235;365;1273;384;922;749;2195
411430;201802;3246;9351;2666;8365;577;1935;1119;3370;1696;5305
411435;201802;450;1340;313;1045;66;208;121;386;187;594
411440;201802;2622;8093;2206;7230;541;1877;598;2035;1139;3912
411450;201802;2632;7286;2060;6326;345;1072;1080;3379;1425;4451
411460;201802;3886;10802;2153;7058;359;1392;319;948;678;2340
411470;201802;738;2147;503;1617;88;310;94;278;182;588
411480;201802;4356;12698;3063;10107;591;2155;646;1993;1237;4148
411490;201802;1472;4187;1144;3578;189;694;362;997;551;1691
411500;201802;1605;4231;1107;3335;173;601;337;983;510;1584
411510;201802;1995;5711;1653;5018;420;1422;338;1021;758;2443
411520;201802;26109;67653;15070;45500;2307;7642;4137;11111;6444;18753
411530;201802;924;2550;608;1949;120;422;180;546;300;968
411535;201802;470;1416;213;763;22;89;23;60;45;149
411540;201802;2935;7711;2109;6014;418;1304;662;1755;1080;3059
411545;201802;1009;3073;858;2789;91;313;536;1768;627;2081
411550;201802;689;1851;534;1571;106;347;93;260;199;607
411560;201802;1997;5718;1285;4173;187;701;73;164;260;865
411570;201802;7205;18108;5059;14699;1084;3567;1247;3583;2331;7150
411573;201802;810;2269;703;2095;80;251;418;1237;498;1488
411575;201802;1606;4725;1315;4151;301;997;356;1112;657;2109
411580;201802;4121;10647;2412;7670;267;1029;306;877;573;1906
411585;201802;780;2405;365;1260;76;272;63;182;139;454
411590;201802;366;1039;280;868;35;125;132;368;167;493
411600;201802;292;818;197;648;42;154;68;220;110;374
411605;201802;1466;3983;978;2932;145;513;378;1062;523;1575
411610;201802;2193;5958;1591;4694;278;899;673;1928;951;2827
411620;201802;2834;8240;2482;7689;441;1523;1400;4273;1841;5796
411630;201802;548;1481;368;1150;84;304;62;153;146;457
411640;201802;483;1410;339;1056;46;142;113;336;159;478
411650;201802;199;592;143;475;26;87;19;71;45;158
411660;201802;877;2334;625;1852;56;176;314;912;370;1088
411670;201802;1106;2982;843;2425;140;404;291;807;431;1211
411680;201802;1544;4389;1255;3849;178;626;629;1903;807;2529
411690;201802;3332;9344;2517;7829;507;1648;698;2247;1205;3895
411695;201802;669;2115;499;1709;78;294;154;550;232;844
411700;201802;1533;4282;1060;3355;231;790;150;425;381;1215
411705;201802;1635;5645;1459;5291;310;1096;797;3056;1107;4152
411710;201802;1737;4809;1304;3967;363;1172;172;525;535;1697
411720;201802;919;2483;700;2038;99;304;236;645;335;949
411721;201802;836;2336;653;1951;132;413;129;374;261;787
411722;201802;671;1930;411;1327;70;272;145;385;215;657
411725;201802;1291;4000;819;2857;193;711;159;558;352;1269
411727;201802;1560;4590;1078;3537;303;1019;142;429;445;1448
411729;201802;656;1695;438;1272;93;286;113;282;206;568
411730;201802;5159;14643;3990;12239;1149;3680;1175;3537;2324;7217
411740;201802;581;1633;316;1015;56;195;59;168;115;363
411745;201802;858;2506;613;1928;95;309;136;371;231;680
411750;201802;4935;14143;3722;11528;536;1814;1614;4759;2150;6573
411760;201802;7283;20543;5875;18006;2016;6530;1147;3701;3163;10231
411770;201802;3305;10288;2537;8520;682;2411;312;1004;994;3415
411780;201802;2924;8625;2556;7940;663;2191;1020;3198;1683;5389
411790;201802;3026;8183;1842;5748;452;1567;268;746;720;2313
411800;201802;1044;2997;698;2196;99;331;116;354;215;685
411810;201802;1686;4593;1301;3854;233;760;568;1582;801;2342
411820;201802;11719;36719;9675;32537;3156;11080;2665;8973;5821;20053
411830;201802;568;1425;388;1114;96;312;49;156;145;468
411840;201802;10546;29188;7290;22480;1429;4833;1721;5080;3150;9913
411845;201802;446;1303;237;773;42;165;16;41;58;206
411850;201802;7474;21063;5751;17788;1675;5607;984;2870;2659;8477
411860;201802;808;2417;612;1987;109;380;158;469;267;849
411870;201802;748;2365;505;1722;98;365;99;301;197;666
411880;201802;2078;5824;1528;4810;382;1324;244;746;626;2070
411885;201802;829;2233;644;1913;112;396;226;648;338;1044
411890;201802;1156;3356;786;2536;118;423;51;132;169;555
411900;201802;867;2643;533;1819;134;466;49;172;183;638
411910;201802;1084;3432;803;2799;238;864;186;618;424;1482
411915;201802;16897;43633;10493;31490;1944;6338;2667;7217;4611;13555
411920;201802;919;2977;781;2641;217;808;155;493;372;1301
411925;201802;591;1608;396;1238;92;304;101;296;193;600
411930;201802;5443;17773;4731;16371;2220;8392;302;1094;2522;9486
411940;201802;3152;10116;2554;8686;620;2159;565;1776;1185;3935
411950;201802;12869;37682;10658;33771;2245;7688;4921;15187;7166;22875
411960;201802;5495;15567;4731;14117;960;3123;1752;4956;2712;8079
411965;201802;508;1388;360;1130;67;242;110;334;177;576
411970;201802;837;2194;687;1974;131;345;371;1192;502;1537
411980;201802;1503;4215;1231;3700;317;994;378;1105;695;2099
411990;201802;34669;101110;24707;80610;5430;19547;7341;22651;12771;42198
411995;201802;2635;7253;2082;6354;579;1980;601;1700;1180;3680
412000;201802;2215;5221;1609;4207;126;402;962;2307;1088;2709
412010;201802;678;2192;487;1722;68;278;104;313;172;591
412015;201802;595;1728;495;1538;79;250;245;771;324;1021
412020;201802;427;1244;264;863;43;156;98;290;141;446
412030;201802;718;2131;510;1707;84;308;182;583;266;891
412033;201802;904;2611;642;2035;79;254;226;730;305;984
412035;201802;887;2365;564;1793;89;318;248;762;337;1080
412040;201802;590;1708;409;1325;70;232;72;223;142;455
412050;201802;1664;4584;1226;3736;235;814;296;902;531;1716
412060;201802;7119;23120;6227;21271;1881;6941;1411;4669;3292;11610
412065;201802;700;2034;523;1675;109;375;150;454;259;829
412070;201802;1248;3260;917;2589;134;406;382;1069;516;1475
412080;201802;1637;4910;1027;3487;140;528;62;187;202;715
412085;201802;332;931;109;381;11;41;11;31;22;72
412090;201802;5180;14340;4439;13037;1153;3429;2031;6134;3184;9563
412100;201802;1753;5249;1401;4558;429;1517;270;880;699;2397
412110;201802;913;2528;639;1937;127;420;151;456;278;876
412120;201802;1757;5669;1444;4973;331;1248;399;1135;730;2383
412125;201802;621;1937;515;1693;116;400;161;506;277;906
412130;201802;614;1775;449;1405;77;262;99;330;176;592
412135;201802;569;1606;283;872;48;145;85;246;133;391
412140;201802;1625;4403;1135;3459;235;796;175;478;410;1274
412150;201802;2987;8196;2498;7265;300;1010;1540;4326;1840;5336
412160;201802;1078;3453;664;2343;159;610;86;294;245;904
412170;201802;4347;12869;3624;11505;830;2831;1445;4294;2275;7125
412175;201802;1352;4273;1140;3855;251;848;437;1488;688;2336
412180;201802;1675;4840;1254;4056;215;819;515;1498;730;2317
412190;201802;3292;8804;2448;7238;372;1193;966;2951;1338;4144
412200;201802;1985;6140;1406;4719;344;1228;261;859;605;2087
412210;201802;643;1702;377;1162;71;259;75;189;146;448
412215;201802;3839;10666;3247;9530;877;2611;1354;4358;2231;6969
412217;201802;1053;2906;905;2648;76;258;612;1703;688;1961
412220;201802;5574;16717;4880;15410;1185;3703;1923;6451;3108;10154
412230;201802;2794;8832;2287;7726;416;1573;632;1927;1048;3500
412240;201802;7606;19693;4744;14366;888;2994;1119;3152;2007;6146
412250;201802;1951;5400;1524;4534;397;1227;238;636;635;1863
412260;201802;1234;3426;852;2606;124;399;272;762;396;1161
412265;201802;902;2683;771;2413;190;630;291;905;481;1535
412270;201802;799;2423;541;1802;80;299;192;603;272;902
412280;201802;549;1663;429;1427;119;414;79;249;198;663
412290;201802;1034;2757;701;2123;117;396;214;602;331;998
412300;201802;1540;4508;1276;3983;321;1080;278;829;599;1909
412310;201802;827;2417;683;2158;81;353;334;1039;415;1392
412320;201802;820;2205;576;1718;87;333;181;519;268;852
412330;201802;1446;4004;1006;3117;190;614;368;1123;558;1737
412340;201802;971;2880;623;2037;96;335;129;393;225;728
412350;201802;2658;7518;1748;5592;330;1163;212;616;542;1779
412360;201802;260;747;162;518;19;69;59;175;78;244
412370;201802;812;2429;603;2023;126;467;59;197;185;664
412380;201802;1550;4632;1151;3721;293;972;212;732;505;1704
412382;201802;593;1593;398;1199;69;221;105;269;174;490
412385;201802;2203;6482;1869;5782;682;2140;469;1543;1151;3683
412390;201802;2240;5981;1861;5370;392;1198;827;2415;1219;3613
412395;201802;734;2112;528;1680;54;168;260;796;314;964
412400;201802;896;2644;689;2193;165;546;152;519;317;1065
412402;201802;1763;4808;1351;4087;301;1028;173;487;474;1515
412405;201802;3228;9198;2038;6589;380;1402;66;204;446;1606
412410;201802;5163;14751;3959;12501;934;3347;903;2688;1837;6035
412420;201802;443;1224;250;785;29;98;97;271;126;369
412430;201802;537;1458;361;1105;43;146;137;406;180;552
412440;201802;2874;8407;2033;6745;520;1879;376;1248;896;3127
412450;201802;299;953;223;760;30;95;17;44;47;139
412460;201802;817;2414;686;2159;142;488;229;685;371;1173
412470;201802;1776;5867;1429;5001;376;1383;297;1075;673;2458
412480;201802;1000;2913;640;2034;111;385;82;198;193;583
412490;201802;983;2730;817;2404;152;440;328;916;480;1356
412500;201802;1838;5008;1445;4252;251;778;365;967;616;1745
412510;201802;2041;6472;1513;5113;381;1370;186;576;567;1946
412520;201802;1344;3796;917;2848;220;683;103;306;323;989
412530;201802;592;1690;453;1393;71;233;111;324;182;557
412535;201802;772;2180;541;1689;110;373;92;271;202;644
412540;201802;1229;3372;865;2583;115;425;250;743;365;1168
412545;201802;725;1960;487;1443;86;260;119;311;205;571
412550;201802;31050;89290;21314;68424;4413;15085;5843;17480;10256;32565
412555;201802;239;687;157;503;22;80;41;106;63;186
412560;201802;5171;15487;3867;12496;812;2911;876;2735;1688;5646
412570;201802;4082;11319;2580;8125;535;1816;354;1169;889;2985
412575;201802;932;2671;752;2262;94;318;343;963;437;1281
412580;201802;1350;3643;956;2870;160;527;383;1087;543;1614
412590;201802;482;1350;263;886;54;183;27;83;81;266
412600;201802;1385;4069;1028;3270;182;633;360;1111;542;1744
412610;201802;741;2130;470;1471;84;267;179;522;263;789
412620;201802;1245;3635;953;3095;220;825;272;805;492;1630
412625;201802;8415;23990;5789;18669;947;3299;577;1973;1524;5272
412627;201802;957;2825;653;2168;175;648;173;550;348;1198
412630;201802;3018;9259;2256;7511;426;1398;677;2125;1103;3523
412635;201802;408;1143;279;866;55;173;44;115;99;288
412640;201802;996;2815;580;1847;85;287;116;333;201;620
412650;201802;1543;4521;1282;4007;230;820;426;1191;656;2011
412660;201802;2584;7109;1827;5567;324;1093;483;1338;807;2431
412665;201802;575;1479;325;1004;68;227;101;288;169;515
412667;201802;1677;4636;1289;3846;212;732;483;1351;695;2083
412670;201802;546;1617;434;1404;99;361;133;414;232;775
412680;201802;1439;4160;906;3048;147;566;280;826;427;1392
412690;201802;801;2318;604;1902;129;410;139;424;268;834
412700;201802;2025;5610;1625;4970;350;1242;642;1877;992;3119
412710;201802;6095;18767;5001;16545;1045;3754;1372;4190;2417;7944
412720;201802;1299;3971;973;3178;166;587;195;547;361;1134
412730;201802;2092;6113;1190;4010;261;928;164;518;425;1446
412740;201802;1661;4959;1124;3745;207;764;141;499;348;1263
412750;201802;4014;11593;3499;10758;470;1697;2178;6502;2648;8199
412760;201802;2711;7891;2386;7346;365;1240;1377;4127;1742;5367
412770;201802;10407;27842;5649;17752;781;2555;1064;2993;1845;5548
412780;201802;1265;3724;1066;3343;214;726;418;1279;632;2005
412785;201802;2108;5693;1530;4596;357;1068;628;1866;985;2934
412788;201802;1343;4063;1119;3600;278;982;432;1305;710;2287
412790;201802;1057;3088;686;2270;137;502;178;496;315;998
412795;201802;1092;3043;657;2026;125;410;160;473;285;883
412796;201802;2320;7115;1951;6277;376;1282;662;1977;1038;3259
412800;201802;3238;8724;2269;6713;328;1096;849;2303;1177;3399
412810;201802;11256;29895;6604;19930;900;3086;1806;4587;2706;7673
412820;201802;6910;19739;5032;16000;1086;3644;1473;4679;2559;8323
412830;201802;335;988;241;786;33;112;51;160;84;272
412840;201802;1821;4997;1385;4142;219;692;409;1198;628;1890
412850;201802;3012;8423;2296;7139;406;1380;789;2333;1195;3713
412853;201802;1805;4966;1493;4266;150;477;788;2040;938;2517
412855;201802;1250;3572;892;2744;167;575;195;507;362;1082
412860;201802;987;2876;773;2421;169;559;260;780;429;1339
412862;201802;749;1830;471;1334;78;243;163;451;241;694
412863;201802;1154;3745;1112;3678;110;378;843;2764;953;3142
412865;201802;733;2106;536;1727;91;299;183;604;274;903
412870;201802;903;2546;699;2198;234;814;136;448;370;1262
412880;201802;867;2498;593;1887;114;404;86;241;200;645
420005;201802;454;1344;264;900;38;133;99;331;137;464
420010;201802;3588;9309;2390;7189;237;779;1608;4890;1845;5669
420020;201802;575;1840;348;1258;49;216;51;151;100;367
420030;201802;271;707;142;479;31;124;17;60;48;184
420040;201802;618;1935;345;1294;55;228;15;39;70;267
420050;201802;700;1837;439;1334;64;208;231;672;295;880
420055;201802;169;507;88;313;16;68;23;76;39;144
420060;201802;149;485;104;366;18;81;19;43;37;124
420070;201802;1081;3422;806;2761;166;618;278;948;444;1566
420075;201802;144;383;75;231;11;33;12;23;23;56
420080;201802;481;1455;370;1229;106;357;98;315;204;672
420090;201802;406;1392;276;1043;60;232;56;220;116;452
420100;201802;1140;3374;1016;3192;107;367;738;2304;845;2671
420110;201802;276;908;254;860;73;260;78;244;151;504
420120;201802;332;1046;245;838;62;257;87;254;149;511
420125;201802;308;1061;266;976;71;297;124;432;195;729
420127;201802;319;904;110;397;21;85;16;50;37;135
420130;201802;1877;6006;1405;5003;350;1389;392;1258;742;2647
420140;201802;3578;10372;2578;8510;658;2457;344;1048;1002;3505
420150;201802;527;1406;333;1085;61;222;142;424;203;646
420160;201802;242;642;120;397;19;68;37;120;56;188
420165;201802;189;568;108;363;24;90;32;98;56;188
420170;201802;216;690;138;512;30;125;18;65;48;190
420180;201802;274;821;144;515;22;75;34;118;56;193
420190;201802;172;571;103;392;31;122;14;51;45;173
420195;201802;1289;3666;1001;3173;258;922;154;443;412;1365
420200;201802;2864;8210;1657;5674;296;1203;413;1222;709;2425
420205;201802;1206;3603;909;3036;150;550;495;1660;645;2210
420207;201802;1514;4271;987;3214;242;898;264;806;506;1704
420208;201802;490;1310;261;914;47;204;107;378;154;582
420209;201802;191;607;118;421;33;127;39;130;72;257
420210;201802;2140;5997;1352;4666;314;1212;519;1710;833;2922
420213;201802;745;2555;686;2434;181;706;307;1069;488;1775
420215;201802;277;874;175;640;54;186;13;50;67;236
420220;201802;172;601;137;530;41;178;35;127;76;305
420230;201802;3575;10344;2707;8809;455;1739;1270;3945;1725;5684
420240;201802;11098;30544;7161;22807;972;3688;3547;10171;4519;13859
420243;201802;518;1520;397;1286;80;273;141;448;221;721
420245;201802;1247;3495;857;2752;98;391;435;1287;533;1678
420250;201802;463;1436;403;1316;90;318;179;556;269;874
420253;201802;510;1338;374;1134;36;103;196;598;232;701
420257;201802;252;679;147;481;27;93;66;219;93;312
420260;201802;1056;3237;815;2819;147;573;373;1264;520;1837
420270;201802;561;1563;239;782;25;95;77;235;102;330
420280;201802;1638;4487;998;3311;187;669;259;835;446;1504
420285;201802;107;291;51;184;9;33;6;11;15;44
420287;201802;424;1114;293;906;102;329;89;273;191;602
420290;201802;4555;13769;3335;10923;618;2207;1151;3389;1769;5596
420300;201802;6590;19219;3918;13104;816;3128;860;2505;1676;5633
420310;201802;838;2085;473;1324;67;188;305;832;372;1020
420315;201802;898;2796;663;2307;173;633;231;796;404;1429
420320;201802;3859;11710;3122;10338;1012;3689;721;2211;1733;5900
420325;201802;220;709;161;581;44;157;44;162;88;319
420330;201802;875;2809;613;2168;129;497;186;605;315;1102
420340;201802;1202;3591;844;2808;161;552;59;192;220;744
420350;201802;1455;4098;1003;3212;156;541;545;1729;701;2270
420360;201802;2673;7940;1513;5323;297;1146;134;481;431;1627
420370;201802;1427;3959;1117;3451;137;509;757;2263;894;2772
420380;201802;5045;14401;3295;10767;749;2627;925;2950;1674;5577
420390;201802;1066;2831;685;2048;116;381;222;488;338;869
420395;201802;1121;3389;733;2526;116;428;78;237;194;665
420400;201802;1008;3038;673;2295;136;526;144;461;280;987
420410;201802;605;1651;428;1309;38;150;305;909;343;1059
420415;201802;368;1133;275;928;82;295;74;241;156;536
420417;201802;686;2141;544;1809;116;412;207;677;323;1089
420419;201802;249;844;175;666;54;234;9;31;63;265
420420;201802;10142;28927;7439;23969;2597;9070;1532;4588;4129;13658
420425;201802;889;2349;616;1848;58;220;267;751;325;971
420430;201802;3202;9443;2023;6707;457;1611;563;1735;1020;3346
420435;201802;273;787;135;480;28;127;43;133;71;260
420440;201802;749;2217;425;1405;137;510;117;336;254;846
420445;201802;339;962;211;677;44;149;61;179;105;328
420450;201802;697;2112;493;1647;101;375;137;401;238;776
420455;201802;1895;5215;1473;4507;213;754;734;2149;947;2903
420460;201802;8483;23819;6350;20057;1211;4387;2601;7740;3812;12127
420470;201802;782;2089;435;1389;81;295;104;283;185;578
420475;201802;63;190;43;149;13;42;6;21;19;63
420480;201802;4621;12642;3167;10038;685;2354;941;2889;1626;5243
420490;201802;570;1519;301;1044;72;270;66;239;138;509
420500;201802;1364;4092;936;3246;233;875;297;1014;530;1889
420510;201802;112;382;75;273;14;54;39;134;53;188
420515;201802;51;147;39;128;7;29;13;39;20;68
420517;201802;776;2222;698;2099;45;130;545;1634;590;1764
420519;201802;385;988;249;764;38;137;75;219;113;356
420520;201802;503;1325;232;789;29;94;28;77;57;171
420530;201802;1025;3101;739;2484;157;590;204;607;361;1197
420535;201802;252;711;111;369;28;98;9;31;37;129
420540;201802;22790;59345;15135;44645;3026;9916;4740;11917;7766;21833
420543;201802;304;803;238;680;51;123;111;317;162;440
420545;201802;1353;4209;1079;3624;247;876;350;1138;597;2014
420550;201802;3574;10587;2414;8337;554;2181;719;2521;1273;4702
420555;201802;321;964;240;796;42;143;94;297;136;440
420560;201802;443;1230;321;1010;64;202;177;548;241;750
420570;201802;2102;6379;1622;5374;338;1272;614;1894;952;3166
420580;201802;1703;4695;1311;4064;272;973;643;1906;915;2879
420590;201802;2973;8584;1827;6011;353;1304;334;871;687;2175
420600;201802;959;3039;817;2747;147;517;409;1384;556;1901
420610;201802;442;1322;240;853;57;219;48;158;105;377
420620;201802;492;1454;412;1310;120;407;128;394;248;801
420630;201802;839;2561;629;2060;138;503;265;804;403;1307
420640;201802;673;1944;312;1119;80;327;23;69;103;396
420650;201802;2473;7096;1593;5270;277;981;485;1407;762;2388
420660;201802;416;1198;284;923;59;212;64;193;123;405
420665;201802;553;1529;374;1218;58;240;154;440;212;680
420670;201802;1564;4461;1067;3461;173;695;351;1000;524;1695
420675;201802;158;517;116;408;32;137;22;58;54;195
420680;201802;350;868;208;659;36;122;90;273;126;395
420690;201802;790;2645;550;1989;86;325;93;261;179;586
420700;201802;2875;8274;2244;7068;390;1360;905;2731;1295;4091
420710;201802;638;2001;483;1670;99;430;192;574;291;1004
420720;201802;1433;4036;1075;3518;295;1012;447;1451;742;2463
420730;201802;2868;8105;2254;7115;426;1482;1100;3341;1526;4823
420740;201802;762;2287;528;1805;147;537;109;347;256;884
420750;201802;1855;5731;1310;4509;215;828;431;1330;646;2158
420757;201802;86;204;29;112;5;25;11;37;16;62
420760;201802;395;1209;184;610;39;126;24;74;63;200
420765;201802;488;1553;253;931;46;181;57;212;103;393
420768;201802;1177;3802;990;3429;243;859;570;1984;813;2843
420770;201802;537;1471;247;896;52;221;60;207;112;428
420775;201802;568;1652;312;1060;62;228;45;127;107;355
420780;201802;1113;3257;654;2234;125;441;139;443;264;884
420785;201802;185;527;136;416;27;79;38;103;65;182
420790;201802;1038;3418;810;2961;207;820;329;1148;536;1968
420800;201802;759;2074;358;1199;78;287;102;320;180;607
420810;201802;1692;5689;1368;4971;433;1790;313;984;746;2774
420820;201802;8902;24338;6030;19667;1414;5138;2025;6098;3439;11236
420830;201802;2854;8492;2273;7407;571;2043;778;2450;1349;4493
420840;201802;825;2373;379;1327;76;292;60;185;136;477
420845;201802;1662;4552;1027;3385;238;884;301;970;539;1854
420850;201802;1215;3965;764;2840;176;727;89;274;265;1001
420860;201802;317;856;188;624;47;181;42;131;89;312
420870;201802;906;2524;693;2177;236;835;226;660;462;1495
420880;201802;936;3061;721;2546;165;654;154;464;319;1118
420890;201802;7642;20803;4185;13707;741;2679;1072;3038;1813;5717
420895;201802;171;508;97;315;28;96;31;95;59;191
420900;201802;1526;4096;923;2990;173;682;294;804;467;1486
420910;201802;23672;67280;15964;52341;2778;10301;5374;16079;8152;26380
420915;201802;512;1998;356;1528;72;327;155;623;227;950
420917;201802;362;1050;189;583;30;100;78;225;108;325
420920;201802;128;378;51;191;4;16;4;14;8;30
420930;201802;17520;48361;12853;40146;2392;8208;5497;16395;7889;24603
420940;201802;2545;7118;1756;5618;446;1569;139;363;585;1932
420945;201802;151;468;111;372;29;113;38;117;67;230
420950;201802;440;1239;246;835;30;126;78;257;108;383
420960;201802;884;2459;632;1976;127;456;207;577;334;1033
420970;201802;2601;7760;1846;6258;499;1764;314;1114;813;2878
420980;201802;379;1141;296;1016;126;450;94;353;220;803
420985;201802;397;1158;191;689;34;141;63;209;97;350
420990;201802;538;1602;312;1117;57;211;41;118;98;329
421000;201802;461;1598;315;1212;66;278;55;164;121;442
421003;201802;521;1362;197;646;23;75;27;66;50;141
421005;201802;120;378;91;324;22;88;41;157;63;245
421010;201802;4032;11337;2833;9221;637;2292;595;1772;1232;4064
421020;201802;413;1225;310;1049;24;95;202;685;226;780
421030;201802;724;2426;594;2127;193;761;129;428;322;1189
421040;201802;821;1989;507;1500;61;219;278;784;339;1003
421050;201802;1381;3841;791;2567;149;536;233;694;382;1230
421055;201802;169;473;84;280;26;91;21;65;47;156
421060;201802;522;1639;368;1255;75;299;135;441;210;740
421070;201802;573;1786;353;1222;77;284;46;145;123;429
421080;201802;685;2795;621;2690;75;244;463;2176;538;2420
421085;201802;441;1250;196;684;28;100;35;115;63;215
421090;201802;372;1003;183;582;19;62;42;126;61;188
421100;201802;927;2414;466;1445;105;361;52;143;157;504
421105;201802;1380;3997;1093;3555;178;599;528;1797;706;2396
421110;201802;924;2919;799;2701;105;386;481;1618;586;2004
421120;201802;1089;3477;739;2689;108;450;188;588;296;1038
421125;201802;345;921;247;764;75;254;70;173;145;427
421130;201802;3199;10197;2756;9359;750;2796;1241;4122;1991;6918
421140;201802;304;878;220;700;45;143;79;228;124;371
421145;201802;470;1353;272;868;58;199;101;297;159;496
421150;201802;527;1494;348;1176;61;242;126;398;187;640
421160;201802;851;2271;462;1480;74;271;215;667;289;938
421165;201802;203;652;155;545;22;72;78;288;100;360
421170;201802;1182;3254;916;2836;149;467;557;1741;706;2208
421175;201802;1128;3128;753;2455;150;583;268;767;418;1350
421180;201802;414;1084;200;650;44;168;39;115;83;283
421185;201802;345;904;226;677;40;121;113;344;153;465
421187;201802;354;1057;230;760;35;117;87;270;122;387
421189;201802;371;1145;282;941;45;158;91;277;136;435
421190;201802;10257;28313;6254;20838;1252;4657;1069;3335;2321;7992
421200;201802;776;2444;638;2181;125;446;251;834;376;1280
421205;201802;210;590;156;493;34;129;63;188;97;317
421210;201802;1180;3364;793;2592;189;642;261;828;450;1470
421220;201802;1511;4994;1289;4488;343;1321;212;650;555;1971
421223;201802;434;1312;300;1046;65;243;102;347;167;590
421225;201802;1009;3201;863;2893;193;718;417;1406;610;2124
421227;201802;994;2725;641;2038;116;413;331;1037;447;1450
421230;201802;580;1620;397;1299;110;385;134;443;244;828
421240;201802;331;1037;163;606;16;76;24;92;40;168
421250;201802;1471;4047;931;3126;228;833;247;814;475;1647
421260;201802;292;819;57;207;9;31;7;27;16;58
421265;201802;729;2185;658;2074;69;254;483;1500;552;1754
421270;201802;484;1344;249;872;49;165;70;239;119;404
421280;201802;1536;4776;1208;4159;258;989;538;1814;796;2803
421290;201802;794;2199;462;1463;80;265;81;230;161;495
421300;201802;240;703;165;542;43;166;52;158;95;324
421310;201802;187;585;145;480;28;106;47;144;75;250
421315;201802;260;784;155;552;28;102;16;61;44;163
421320;201802;650;1966;389;1310;72;253;61;142;133;395
421330;201802;569;1776;424;1492;102;372;110;392;212;764
421335;201802;403;1307;326;1151;75;313;78;265;153;578
421340;201802;1451;4090;1093;3464;188;655;506;1552;694;2207
421350;201802;1078;3321;840;2860;138;573;404;1312;542;1885
421360;201802;2466;6990;1524;5119;337;1341;501;1498;838;2839
421370;201802;497;1686;333;1255;86;337;78;305;164;642
421380;201802;804;2326;686;2113;107;351;359;1062;466;1413
421390;201802;161;440;64;212;13;48;18;45;31;93
421400;201802;263;866;189;725;50;211;76;273;126;484
421410;201802;233;675;123;441;16;69;52;187;68;256
421415;201802;344;1067;159;545;38;138;30;87;68;225
421420;201802;659;1926;517;1651;79;269;253;761;332;1030
421430;201802;159;515;122;428;20;75;31;102;51;177
421440;201802;685;1943;473;1581;86;315;225;753;311;1068
421450;201802;401;1236;238;848;35;148;37;137;72;285
421460;201802;501;1447;296;1053;61;227;77;263;138;490
421470;201802;282;899;210;748;44;196;59;187;103;383
421480;201802;2865;7837;1860;6083;560;2119;370;1016;930;3135
421490;201802;203;600;97;362;15;60;15;44;30;104
421500;201802;1994;6498;1467;5364;414;1697;205;683;619;2380
421505;201802;312;969;274;903;49;170;148;482;197;652
421507;201802;438;1298;280;972;67;255;78;261;145;516
421510;201802;225;689;153;519;32;102;69;205;101;307
421520;201802;619;1718;387;1206;56;211;172;484;228;695
421530;201802;319;997;182;651;35;153;40;117;75;270
421535;201802;507;1489;311;1086;35;140;148;477;183;617
421540;201802;229;607;159;489;30;100;65;186;95;286
421545;201802;704;2135;513;1764;115;454;185;601;300;1055
421550;201802;1995;6010;1702;5535;440;1576;734;2307;1174;3883
421555;201802;217;626;66;236;16;69;12;30;28;99
421560;201802;118;364;60;224;11;44;7;29;18;73
421565;201802;768;2097;585;1822;140;508;223;692;363;1200
421567;201802;519;1841;385;1466;185;724;66;259;251;983
421568;201802;475;1426;319;1072;56;200;106;340;162;540
421569;201802;253;738;99;351;20;67;20;78;40;145
421570;201802;1164;3323;725;2380;181;635;124;369;305;1004
421575;201802;345;1077;303;964;43;149;169;511;212;660
421580;201802;2751;8526;2045;7025;462;1823;635;1910;1097;3733
421590;201802;165;514;126;435;16;59;70;232;86;291
421600;201802;446;1289;309;980;67;217;75;220;142;437
421605;201802;790;2230;529;1749;99;363;154;484;253;847
421610;201802;1241;3409;804;2556;149;526;208;612;357;1138
421620;201802;3906;11359;2384;8285;671;2518;527;1793;1198;4311
421625;201802;321;873;121;408;24;78;17;51;41;129
421630;201802;2726;7757;1511;4998;273;1050;291;861;564;1911
421635;201802;222;665;125;421;19;74;38;105;57;179
421640;201802;841;2412;580;1929;122;429;188;614;310;1043
421650;201802;2128;6484;1456;5053;332;1330;221;600;553;1930
421660;201802;7094;22227;5801;19672;1137;4265;2051;6399;3188;10664
421670;201802;907;2640;619;2017;151;567;213;659;364;1226
421680;201802;982;3082;790;2672;255;909;210;666;465;1575
421690;201802;1262;4016;928;3223;224;870;191;625;415;1495
421700;201802;459;1472;246;920;45;193;56;177;101;370
421710;201802;197;640;86;297;19;77;27;82;46;159
421715;201802;186;467;92;289;16;52;48;148;64;200
421720;201802;1851;5323;1105;3783;267;973;249;771;516;1744
421725;201802;172;462;108;339;28;101;36;92;64;193
421730;201802;433;1279;221;712;37;135;67;191;104;326
421740;201802;634;1960;437;1483;108;411;105;327;213;738
421750;201802;942;2333;508;1531;82;255;189;520;271;775
421755;201802;271;745;141;441;18;74;52;143;70;217
421760;201802;965;2815;517;1768;86;319;114;335;200;654
421770;201802;2551;7288;1878;6050;455;1510;638;2205;1093;3715
421775;201802;254;757;192;625;35;123;89;270;124;393
421780;201802;865;2895;613;2295;133;543;167;582;300;1125
421790;201802;687;1795;401;1342;133;482;129;400;262;882
421795;201802;290;847;176;555;26;95;59;169;85;264
421800;201802;2470;7202;1815;5985;400;1442;732;2293;1132;3735
421810;201802;670;1900;474;1513;94;349;186;544;280;893
421820;201802;880;2553;480;1643;100;373;68;201;168;574
421825;201802;1311;3984;1211;3820;175;618;817;2510;992;3128
421830;201802;2276;7483;1977;6894;499;1931;678;2205;1177;4136
421835;201802;210;569;126;419;24;101;58;170;82;271
421840;201802;239;739;166;582;38;142;53;177;91;319
421850;201802;413;1259;233;814;39;153;56;169;95;322
421860;201802;282;893;190;692;34;153;53;155;87;308
421870;201802;3377;9293;2339;7259;553;1910;735;2141;1288;4051
421875;201802;322;949;152;547;26;94;19;52;45;146
421880;201802;641;1924;479;1588;135;489;72;226;207;715
421885;201802;252;753;200;674;63;228;48;144;111;372
421890;201802;772;2561;629;2270;184;745;224;729;408;1474
421895;201802;347;1053;310;996;49;175;207;658;256;833
421900;201802;889;2398;618;1862;116;388;256;723;372;1111
421910;201802;384;1210;274;964;57;240;53;147;110;387
421915;201802;438;1308;265;893;53;174;44;143;97;317
421917;201802;583;1606;380;1313;125;481;85;292;210;773
421920;201802;584;1683;384;1372;179;650;110;429;289;1079
421930;201802;2446;6530;1220;4155;341;1231;148;475;489;1706
421935;201802;514;1668;393;1419;88;355;168;568;256;923
421940;201802;240;764;131;456;21;96;42;132;63;228
421950;201802;3215;8448;1500;4957;327;1194;226;694;553;1888
421960;201802;162;445;113;367;18;71;27;90;45;161
421970;201802;2141;5750;1147;3701;265;886;257;746;522;1632
421985;201802;348;877;186;562;30;106;49;158;79;264
422000;201802;1541;4411;1273;3936;218;791;687;2070;905;2861
430003;201802;571;1716;415;1427;100;389;129;407;229;796
430005;201802;298;838;193;632;56;186;77;249;133;435
430010;201802;1875;4963;1447;4229;269;860;726;2088;995;2948
430020;201802;617;1501;489;1334;75;236;291;760;366;996
430030;201802;1036;2607;629;1846;176;535;182;532;358;1067
430040;201802;10205;26597;6433;19375;1665;5572;340;1082;2005;6654
430045;201802;605;1614;421;1226;52;165;209;581;261;746
430047;201802;284;661;121;365;24;76;33;93;57;169
430050;201802;944;2534;544;1668;119;372;127;366;246;738
430055;201802;292;751;133;405;13;43;67;190;80;233
430057;201802;109;255;39;119;8;29;6;12;14;41
430060;201802;16852;50213;13785;45199;3661;12908;5238;17437;8899;30345
430063;201802;890;2575;700;2156;158;478;376;1161;534;1639
430064;201802;1074;3157;805;2571;227;781;198;617;425;1398
430066;201802;137;314;90;238;4;15;57;140;61;155
430070;201802;665;1768;129;430;10;35;10;22;20;57
430080;201802;772;2086;458;1444;88;295;168;475;256;770
430085;201802;922;2300;550;1627;96;307;192;579;288;886
430087;201802;647;1987;542;1806;105;389;265;843;370;1232
430090;201802;653;1720;218;723;22;87;57;185;79;272
430100;201802;768;1933;391;1213;74;242;125;343;199;585
430105;201802;1043;2877;677;2226;116;448;299;974;415;1422
430107;201802;195;609;138;461;19;65;31;92;50;157
430110;201802;2109;5483;1552;4632;292;914;768;2204;1060;3118
430120;201802;1487;4569;946;3189;217;747;366;1294;583;2041
430130;201802;3991;10747;3188;9538;1012;2795;1062;3840;2074;6635
430140;201802;1018;3036;644;2186;170;583;199;671;369;1254
430150;201802;693;1785;383;1184;76;257;93;280;169;537
430155;201802;303;816;162;521;20;73;39;109;59;182
430160;201802;17735;47577;14337;42240;3525;10908;5047;15518;8572;26426
430163;201802;2296;6035;1655;4997;209;729;976;2892;1185;3621
430165;201802;442;1028;94;302;10;28;9;25;19;53
430170;201802;919;2570;337;1203;61;230;64;207;125;437
430175;201802;741;2333;611;2013;158;496;280;938;438;1434
430180;201802;753;2018;609;1758;101;333;344;939;445;1272
430185;201802;495;1240;303;870;52;154;129;327;181;481
430187;201802;641;1728;470;1442;84;280;194;584;278;864
430190;201802;1503;4383;1276;3927;305;996;540;1621;845;2617
430192;201802;144;435;64;200;9;29;10;27;19;56
430195;201802;377;1139;75;256;12;40;6;17;18;57
430200;201802;1209;3804;1010;3402;301;1050;296;986;597;2036
430205;201802;511;1452;404;1231;20;82;315;926;335;1008
430210;201802;5682;14606;3752;10729;561;1794;1459;3380;2020;5174
430215;201802;322;881;223;671;38;126;87;248;125;374
430220;201802;647;1632;186;617;34;112;37;112;71;224
430222;201802;224;694;181;599;25;86;72;224;97;310
430223;201802;298;843;248;746;43;135;119;354;162;489
430225;201802;35;85;14;39;3;7;5;8;8;15
430230;201802;1561;4594;1460;4459;220;615;1111;3493;1331;4108
430235;201802;245;758;188;617;27;98;72;226;99;324
430237;201802;533;1359;381;1098;29;97;241;659;270;756
430240;201802;1227;2781;728;2006;79;249;413;1102;492;1351
430245;201802;802;2419;606;2011;196;654;248;854;444;1508
430250;201802;1060;2923;859;2616;252;826;52;142;304;968
430258;201802;128;346;93;288;8;29;48;150;56;179
430260;201802;650;1827;471;1463;89;278;222;715;311;993
430265;201802;225;665;168;564;33;118;40;131;73;249
430270;201802;2855;7600;2357;6817;275;872;1549;4405;1824;5277
430280;201802;4763;12207;3599;10151;831;2413;1451;4125;2282;6538
430290;201802;2296;5864;2050;5523;95;301;1756;4666;1851;4967
430300;201802;8787;24531;7030;21264;1465;4769;3209;9661;4674;14430
430310;201802;7635;20767;5357;16635;965;3452;2325;6777;3290;10229
430320;201802;890;2522;498;1651;92;277;232;827;324;1104
430330;201802;648;1640;442;1241;113;330;184;460;297;790
430340;201802;730;1732;372;1127;70;228;185;546;255;774
430350;201802;5892;17179;4822;14935;1383;4472;1819;5449;3202;9921
430355;201802;365;922;128;414;31;105;11;37;42;142
430360;201802;834;2199;621;1805;126;386;218;606;344;992
430367;201802;337;844;176;538;49;173;50;148;99;321
430370;201802;538;1505;280;923;63;220;60;172;123;392
430380;201802;702;1788;387;1210;112;393;100;318;212;711
430390;201802;3395;8889;1927;5958;317;1072;152;385;469;1457
430400;201802;1161;2734;863;2257;156;428;506;1278;662;1706
430410;201802;604;1545;427;1245;54;189;253;713;307;902
430420;201802;3147;8972;2404;7286;731;2331;754;2201;1485;4532
430430;201802;615;1644;346;1082;86;287;66;194;152;481
430435;201802;1728;4632;1270;3819;323;1010;374;1140;697;2150
430440;201802;3861;11447;2883;9370;592;2070;1301;4321;1893;6391
430450;201802;6489;17924;5389;15873;1186;3775;2252;6583;3438;10358
430460;201802;27675;76858;20041;64094;4646;16498;7219;22225;11865;38723
430461;201802;463;1204;141;453;18;59;31;91;49;150
430462;201802;259;700;166;538;30;110;34;124;64;234
430463;201802;4421;13288;3656;11903;729;2587;1763;5718;2492;8305
430465;201802;509;1373;422;1208;80;244;250;694;330;938
430466;201802;3709;9697;3042;8627;716;2127;1463;3968;2179;6095
430467;201802;508;1364;391;1159;65;214;176;500;241;714
430468;201802;1367;3601;1086;3174;181;574;583;1691;764;2265
430469;201802;561;1607;64;218;7;17;8;16;15;33
430470;201802;6631;17923;4713;14592;1476;4838;915;2895;2391;7733
430471;201802;512;1646;454;1515;101;351;181;587;282;938
430480;201802;982;2587;496;1570;77;274;73;201;150;475
430485;201802;151;438;61;206;9;36;10;25;19;61
430490;201802;367;1002;212;663;32;110;94;290;126;400
430495;201802;386;1101;249;816;31;113;99;293;130;406
430500;201802;1148;3064;845;2546;209;700;323;903;532;1603
430510;201802;22980;63820;16971;51796;4226;14035;5654;16055;9880;30090
430511;201802;346;1040;136;473;21;66;17;51;38;117
430512;201802;961;2404;791;2132;210;578;241;673;451;1251
430513;201802;797;2050;413;1203;104;320;152;410;256;730
430515;201802;413;1180;286;927;52;153;131;435;183;588
430517;201802;1075;3346;861;2903;162;557;411;1426;573;1983
430520;201802;1417;3853;779;2491;156;531;135;381;291;912
430530;201802;1110;2903;418;1302;93;288;93;276;186;564
430535;201802;2902;8116;2065;6494;379;1245;864;2692;1243;3937
430537;201802;395;1343;329;1168;47;169;223;796;270;965
430540;201802;600;1398;365;1042;70;205;190;528;260;733
430543;201802;617;1277;408;1040;63;142;270;723;333;865
430544;201802;629;1967;482;1617;113;396;223;717;336;1113
430545;201802;1627;4773;1262;4219;356;1257;517;1781;873;3038
430550;201802;547;1540;300;985;61;210;60;176;121;386
430558;201802;141;366;68;218;15;50;18;52;33;102
430560;201802;408;963;177;540;17;56;45;135;62;191
430570;201802;986;2410;652;1823;100;339;346;876;446;1215
430580;201802;1177;2872;729;2139;125;416;330;925;455;1341
430583;201802;179;466;37;116;4;13;7;23;11;36
430585;201802;263;644;145;415;22;76;64;155;86;231
430587;201802;187;577;145;479;31;110;56;190;87;300
430590;201802;1408;3538;1220;3224;65;207;1049;2725;1114;2932
430593;201802;16;58;14;51;2;10;8;28;10;38
430595;201802;437;1066;89;315;8;34;12;40;20;74
430597;201802;326;937;218;675;20;72;86;224;106;296
430600;201802;1875;5063;897;2773;158;475;218;638;376;1113
430605;201802;1207;3542;924;2952;153;588;351;1093;504;1681
430607;201802;700;1613;507;1316;38;111;332;884;370;995
430610;201802;6611;17132;4792;14292;1419;4609;752;2310;2171;6919
430613;201802;288;679;96;292;6;23;27;64;33;87
430620;201802;609;1670;488;1433;127;415;209;581;336;996
430630;201802;462;1329;141;463;24;80;26;73;50;153
430632;201802;603;1659;289;889;35;117;113;320;148;437
430635;201802;550;1544;412;1250;79;264;239;700;318;964
430637;201802;456;1242;381;1122;61;199;209;580;270;779
430640;201802;1389;3672;719;2260;103;337;176;487;279;824
430642;201802;423;1137;274;833;42;127;126;376;168;503
430645;201802;275;620;102;285;18;53;23;65;41;118
430650;201802;1645;5210;1368;4626;346;1215;655;2245;1001;3460
430655;201802;164;401;121;345;30;89;48;124;78;213
430660;201802;5187;14139;3986;12012;895;2895;1700;5084;2595;7979
430670;201802;518;1409;407;1198;36;126;270;792;306;918
430673;201802;682;1614;273;824;52;158;82;245;134;403
430675;201802;229;673;53;187;12;48;12;38;24;86
430676;201802;4166;11300;3195;9634;611;1949;1481;4424;2092;6373
430680;201802;997;2752;604;1965;139;452;136;415;275;867
430690;201802;3489;9926;2848;8704;845;2704;726;2222;1571;4926
430692;201802;230;729;179;640;12;42;124;454;136;496
430693;201802;1111;2940;628;1940;138;481;116;313;254;794
430695;201802;558;1390;340;984;41;120;187;516;228;636
430697;201802;422;1121;303;910;55;163;143;449;198;612
430700;201802;8079;20604;4222;13474;961;3318;307;1027;1268;4345
430705;201802;283;796;165;533;20;71;67;205;87;276
430710;201802;1639;3995;1226;3318;229;689;579;1530;808;2219
430720;201802;705;1775;407;1265;90;274;144;446;234;720
430730;201802;1442;3770;922;2869;154;489;424;1364;578;1853
430740;201802;626;1765;349;1185;64;223;85;314;149;537
430745;201802;484;1364;248;798;38;130;50;151;88;281
430750;201802;1470;3949;1070;3262;221;737;531;1564;752;2301
430755;201802;484;1234;306;877;22;69;166;434;188;503
430760;201802;2359;5950;1744;5008;404;1261;687;2026;1091;3287
430770;201802;6094;16503;4643;14154;820;2733;2508;7444;3328;10177
430780;201802;2511;6404;1478;4615;282;936;455;1487;737;2423
430781;201802;417;1210;267;872;58;195;52;172;110;367
430783;201802;508;1228;290;856;37;121;135;379;172;500
430786;201802;62;218;43;168;8;30;9;38;17;68
430790;201802;4491;11893;3014;9007;557;1831;1411;3990;1968;5821
430800;201802;857;2281;598;1744;71;237;328;905;399;1142
430805;201802;532;1477;315;972;36;122;161;464;197;586
430807;201802;436;1127;282;847;33;119;119;331;152;450
430810;201802;861;2218;283;945;43;135;68;215;111;350
430820;201802;1315;3671;731;2445;161;548;145;481;306;1029
430825;201802;315;848;114;343;26;74;20;52;46;126
430830;201802;1612;4895;1396;4508;138;502;955;3094;1093;3596
430840;201802;947;2728;797;2458;158;486;430;1316;588;1802
430843;201802;111;278;36;107;6;16;12;34;18;50
430845;201802;315;832;219;654;89;286;32;77;121;363
430850;201802;2321;6540;1874;5729;415;1397;866;2620;1281;4017
430860;201802;953;2421;480;1489;83;318;186;512;269;830
430865;201802;569;1506;482;1357;141;418;196;514;337;932
430870;201802;711;1910;325;1059;56;199;85;249;141;448
430880;201802;1227;3059;805;2368;212;648;302;897;514;1545
430885;201802;236;571;108;359;10;42;68;218;78;260
430890;201802;1308;3501;869;2648;61;268;120;336;181;604
430900;201802;2883;7005;1992;5608;290;933;1027;2747;1317;3680
430905;201802;917;2493;580;1813;119;412;158;461;277;873
430910;201802;1515;4281;1012;3231;206;774;379;1079;585;1853
430912;201802;488;1366;342;1105;42;145;206;677;248;822
430915;201802;538;1680;396;1424;107;378;134;526;241;904
430920;201802;21625;58270;16978;50663;2772;9104;9441;27513;12213;36617
430925;201802;143;319;61;169;11;27;22;65;33;92
430930;201802;10356;25780;6325;19252;1611;5209;1624;5262;3235;10471
430940;201802;1315;3911;708;2365;174;609;110;321;284;930
430950;201802;800;2085;521;1537;92;304;240;650;332;954
430955;201802;182;489;61;201;13;36;9;33;22;69
430957;201802;211;728;182;661;33;126;86;314;119;440
430960;201802;1386;3430;952;2691;199;624;466;1311;665;1935
430965;201802;1548;4024;1261;3555;73;247;967;2646;1040;2893
430970;201802;383;1027;200;632;24;86;97;295;121;381
430975;201802;510;1662;390;1369;88;332;145;501;233;833
430980;201802;392;983;233;698;48;154;85;249;133;403
430990;201802;555;1669;327;1083;52;203;131;417;183;620
430995;201802;626;1720;447;1390;82;259;203;610;285;869
431000;201802;1519;3734;651;1984;109;357;31;82;140;439
431010;201802;2385;6529;1403;4669;214;813;112;314;326;1127
431020;201802;9384;21952;5911;16340;1394;4141;1655;4284;3049;8425
431030;201802;326;923;142;508;36;124;17;70;53;194
431033;201802;2947;8074;2141;6827;561;1911;731;2394;1292;4305
431036;201802;309;727;65;204;6;13;16;46;22;59
431040;201802;915;2460;611;1897;109;398;280;793;389;1191
431041;201802;481;1164;379;1006;58;163;209;545;267;708
431043;201802;464;1194;237;773;85;281;62;197;147;478
431046;201802;129;344;62;184;7;21;12;33;19;54
431050;201802;1567;3917;1108;3173;232;691;536;1521;768;2212
431053;201802;542;1635;383;1298;103;372;91;303;194;675
431055;201802;652;1688;572;1563;51;142;417;1126;468;1268
431057;201802;290;853;142;483;27;99;39;119;66;218
431060;201802;5180;14894;4115;12946;1290;4427;827;2706;2117;7133
431065;201802;506;1374;340;1064;64;206;93;283;157;489
431070;201802;569;1667;320;1074;85;304;43;111;128;415
431075;201802;215;657;159;544;32;118;53;185;85;303
431080;201802;663;1907;461;1462;86;281;145;441;231;722
431085;201802;700;1937;523;1542;84;239;297;865;381;1104
431087;201802;485;1391;404;1214;28;84;276;844;304;928
431090;201802;477;1153;182;566;36;119;40;125;76;244
431100;201802;3379;8368;2528;7167;530;1629;969;2717;1499;4346
431110;201802;1485;3627;1032;2805;264;744;405;1026;669;1770
431112;201802;524;1637;460;1508;93;310;235;753;328;1063
431113;201802;415;1186;335;1030;106;344;118;368;224;712
431115;201802;1227;3484;969;3030;167;584;521;1572;688;2156
431120;201802;2559;7511;1834;6014;602;2228;429;1262;1031;3490
431123;201802;408;1167;261;858;57;174;120;413;177;587
431125;201802;1255;3732;882;2919;291;958;236;851;527;1809
431127;201802;278;764;67;224;9;25;12;32;21;57
431130;201802;3352;9395;2280;7276;492;1685;758;2418;1250;4103
431140;201802;4730;11655;2647;7742;382;1204;922;2377;1304;3581
431142;201802;494;1405;381;1202;63;204;225;701;288;905
431150;201802;988;2829;717;2268;173;573;273;843;446;1416
431160;201802;740;2091;570;1751;115;345;204;677;319;1022
431162;201802;546;1320;236;740;25;94;62;173;87;267
431164;201802;226;552;51;173;11;46;5;15;16;61
431170;201802;633;1726;409;1283;116;385;101;309;217;694
431171;201802;727;1898;598;1698;94;285;333;926;427;1211
431173;201802;426;1204;324;1022;125;419;68;214;193;633
431175;201802;948;2559;673;2053;182;564;131;400;313;964
431177;201802;758;2330;563;1965;180;661;204;710;384;1371
431179;201802;349;729;77;212;11;31;17;36;28;67
431180;201802;2209;5898;1400;4332;347;1150;249;761;596;1911
431190;201802;534;1441;287;912;41;128;58;153;99;281
431198;201802;338;1091;297;1012;104;368;89;329;193;697
431200;201802;388;1046;98;330;9;22;1;3;10;25
431205;201802;235;677;101;364;23;86;41;148;64;234
431210;201802;688;1798;563;1614;149;418;262;792;411;1210
431213;201802;233;719;183;626;22;90;99;338;121;428
431215;201802;328;971;214;709;21;76;84;253;105;329
431217;201802;159;457;100;335;15;53;50;158;65;211
431220;201802;717;1950;409;1315;39;144;177;520;216;664
431225;201802;1412;3725;1074;3117;178;536;568;1648;746;2184
431230;201802;720;2127;533;1659;88;291;262;797;350;1088
431235;201802;133;367;29;89;6;17;2;4;8;21
431237;201802;427;1261;338;1111;60;232;170;536;230;768
431238;201802;28;82;23;68;7;23;6;15;13;38
431240;201802;3963;10756;3138;9389;745;2494;1303;3710;2048;6204
431242;201802;360;1054;297;928;66;208;130;411;196;619
431244;201802;335;810;174;504;23;83;59;136;82;219
431245;201802;1133;2934;767;2212;138;436;328;899;466;1335
431247;201802;221;626;121;392;21;65;27;82;48;147
431250;201802;1410;4249;1154;3845;260;880;503;1756;763;2636
431260;201802;305;828;151;523;16;73;44;138;60;211
431261;201802;270;880;224;780;37;138;85;277;122;415
431262;201802;414;1184;174;608;19;65;90;317;109;382
431265;201802;1397;3447;612;1853;97;321;177;445;274;766
431267;201802;281;774;156;458;6;23;102;273;108;296
431270;201802;2687;6491;1467;4363;414;1339;376;1141;790;2480
431275;201802;198;578;102;359;23;88;13;35;36;123
431280;201802;262;726;78;267;6;20;12;26;18;46
431290;201802;320;943;231;768;31;120;79;224;110;344
431295;201802;79;217;28;92;4;17;7;19;11;36
431300;201802;356;845;53;187;2;6;8;24;10;30
431301;201802;245;741;64;226;7;21;4;7;11;28
431303;201802;655;1709;363;1097;43;156;124;355;167;511
431306;201802;2169;5361;1308;3850;174;589;468;1259;642;1848
431308;201802;31;101;27;88;15;51;6;19;21;70
431310;201802;627;1810;356;1162;57;195;116;389;173;584
431320;201802;681;1877;327;1120;64;226;46;146;110;372
431330;201802;2082;5095;1027;3154;246;864;168;446;414;1310
431333;201802;354;950;132;395;16;43;33;91;49;134
431335;201802;37;104;22;73;6;18;4;5;10;23
431337;201802;2728;7688;1842;6069;523;1889;347;1081;870;2970
431339;201802;494;1326;344;1026;77;244;161;471;238;715
431340;201802;21402;55262;15158;44528;3304;10609;4507;12633;7811;23242
431342;201802;515;1216;378;1004;58;192;267;671;325;863
431344;201802;372;1002;245;755;13;45;160;486;173;531
431346;201802;276;700;101;319;15;46;21;71;36;117
431349;201802;747;2048;421;1286;71;224;140;395;211;619
431350;201802;4038;11261;3037;9445;734;2468;1037;3156;1771;5624
431360;201802;647;1582;381;1113;76;235;156;437;232;672
431365;201802;1731;4681;1426;4201;159;515;948;2808;1107;3323
431370;201802;4461;12087;3356;10160;815;2605;1341;4239;2156;6844
431380;201802;753;2242;659;2076;79;277;404;1272;483;1549
431390;201802;2431;6316;1394;4315;256;896;450;1255;706;2151
431395;201802;1298;3619;951;3051;233;753;370;1233;603;1986
431400;201802;401;1196;197;648;35;113;41;128;76;241
431402;201802;1015;2430;660;1803;111;313;366;957;477;1270
431403;201802;172;490;143;439;23;97;88;247;111;344
431405;201802;4067;11391;3445;10420;437;1527;2085;6177;2522;7704
431406;201802;519;1597;421;1416;104;348;209;714;313;1062
431407;201802;473;1336;319;1019;67;215;120;373;187;588
431410;201802;14591;40200;9561;30479;2098;7612;2775;8290;4873;15902
431413;201802;183;461;48;153;3;12;6;13;9;25
431415;201802;693;1854;446;1425;95;351;141;395;236;746
431417;201802;486;1215;385;1057;67;193;216;574;283;767
431420;201802;1276;3340;1081;3030;220;633;463;1365;683;1998
431430;201802;530;1391;294;910;62;219;70;182;132;401
431440;201802;22625;59182;17091;50048;4352;13523;4832;14585;9184;28108
431442;201802;112;328;61;208;9;33;6;12;15;45
431445;201802;472;1348;163;546;27;85;34;107;61;192
431446;201802;393;1141;264;843;80;261;65;191;145;452
431447;201802;624;1736;414;1299;90;284;176;549;266;833
431449;201802;734;1978;496;1486;51;165;249;738;300;903
431450;201802;2090;4723;1760;4281;153;405;1326;3122;1479;3527
431454;201802;58;179;50;158;10;33;18;62;28;95
431455;201802;669;1678;330;934;51;159;138;334;189;493
431460;201802;2876;7752;2290;6619;609;1808;737;2185;1346;3993
431470;201802;1642;4665;1179;3674;236;756;433;1352;669;2108
431475;201802;227;669;33;131;3;12;0;0;3;12
431477;201802;581;1487;352;1013;47;134;158;410;205;544
431478;201802;278;730;71;212;15;50;7;17;22;67
431480;201802;3212;8301;2475;7149;358;1160;1400;3976;1758;5136
431490;201802;100571;259630;83642;234260;8979;28987;58196;158706;67175;187693
431500;201802;508;1359;383;1111;84;236;200;568;284;804
431505;201802;449;1088;280;806;24;63;160;457;184;520
431507;201802;343;821;145;418;29;95;55;140;84;235
431510;201802;1709;4664;1232;3720;246;792;458;1383;704;2175
431513;201802;313;764;152;450;17;43;89;265;106;308
431514;201802;96;265;45;153;8;34;11;28;19;62
431515;201802;578;1534;373;1122;74;244;169;471;243;715
431517;201802;80;247;60;191;10;26;13;40;23;66
431520;201802;488;1214;196;635;40;144;49;150;89;294
431530;201802;4236;9537;2572;7146;710;2015;374;1047;1084;3062
431531;201802;215;618;149;484;18;64;47;148;65;212
431532;201802;525;1383;383;1100;83;241;142;413;225;654
431535;201802;263;632;113;337;24;83;39;105;63;188
431540;201802;1951;6350;1791;6083;110;416;1333;4585;1443;5001
431545;201802;375;1014;67;210;5;21;17;45;22;66
431550;201802;2039;5751;1692;5085;373;1188;692;2001;1065;3189
431555;201802;659;1560;433;1179;39;112;258;695;297;807
431560;201802;20164;55132;13769;44017;2926;10131;3561;12157;6487;22288
431570;201802;5448;13346;4224;11699;814;2456;2303;6223;3117;8679
431575;201802;174;546;135;457;21;73;18;54;39;127
431580;201802;532;1452;276;923;46;189;100;318;146;507
431590;201802;863;2252;557;1658;109;335;193;576;302;911
431595;201802;379;1059;251;777;36;103;122;368;158;471
431600;201802;1725;4534;1247;3751;321;1084;317;940;638;2024
431610;201802;1381;3805;974;2985;127;379;476;1496;603;1875
431620;201802;519;1439;227;686;47;142;107;303;154;445
431630;201802;1261;3360;636;2006;177;577;163;470;340;1047
431640;201802;6138;16442;5483;15512;844;2426;3597;10293;4441;12719
431642;201802;519;1349;340;989;37;102;155;434;192;536
431643;201802;364;931;163;470;23;65;47;118;70;183
431645;201802;1666;4470;1333;3908;188;594;842;2467;1030;3061
431647;201802;173;472;101;311;13;48;25;64;38;112
431650;201802;251;758;180;603;28;108;53;165;81;273
431660;201802;985;2692;552;1797;86;314;125;341;211;655
431670;201802;1179;2958;839;2387;148;490;382;1009;530;1499
431673;201802;250;681;96;356;22;76;8;24;30;100
431675;201802;684;1731;138;455;13;50;41;117;54;167
431680;201802;8242;22239;6173;18307;1626;5053;2025;6063;3651;11116
431690;201802;20498;55406;15195;45796;3889;12292;4618;14437;8507;26729
431695;201802;146;395;96;301;19;64;39;95;58;159
431697;201802;498;1264;406;1109;77;203;206;587;283;790
431700;201802;1452;3961;1238;3572;200;565;670;1926;870;2491
431710;201802;11714;31979;9249;28215;2532;8162;3285;10715;5817;18877
431720;201802;6446;17244;4340;13022;1060;3375;813;2256;1873;5631
431725;201802;29;86;19;66;3;12;6;19;9;31
431730;201802;3620;9798;2616;8090;699;2361;766;2479;1465;4840
431740;201802;4888;12752;3519;10353;1084;3537;618;1563;1702;5100
431750;201802;7646;21163;6516;19380;1372;4422;3088;9283;4460;13705
431755;201802;328;887;70;250;12;49;13;44;25;93
431760;201802;5348;13032;3503;9958;450;1486;1943;5207;2393;6693
431770;201802;1897;4841;1513;4281;190;574;987;2757;1177;3331
431775;201802;201;542;99;310;19;64;11;26;30;90
431780;201802;2010;5384;1401;4190;285;891;440;1269;725;2160
431790;201802;1035;2923;757;2343;159;528;271;799;430;1327
431795;201802;299;792;169;512;37;112;45;130;82;242
431800;201802;7426;20631;5564;17275;1785;6047;670;2147;2455;8194
431805;201802;324;767;98;325;9;33;37;116;46;149
431810;201802;3234;8203;2141;6101;424;1342;856;2303;1280;3645
431820;201802;2295;6746;1941;6123;410;1371;819;2606;1229;3977
431830;201802;9868;22917;7393;19354;1704;4877;2971;7797;4675;12674
431840;201802;2482;7124;2050;6374;406;1303;1079;3387;1485;4690
431842;201802;712;1783;249;767;36;127;70;197;106;324
431843;201802;328;914;252;760;31;99;112;321;143;420
431844;201802;266;715;76;252;20;75;14;34;34;109
431845;201802;494;1358;353;1057;20;56;216;644;236;700
431846;201802;271;791;223;721;18;86;173;542;191;628
431848;201802;194;510;99;313;7;26;14;34;21;60
431849;201802;447;1062;72;202;9;29;12;22;21;51
431850;201802;4207;12089;3406;10379;793;2584;1086;3219;1879;5803
431860;201802;716;1864;462;1363;89;274;222;614;311;888
431861;201802;123;332;53;181;8;28;15;47;23;75
431862;201802;481;1576;393;1408;84;341;178;624;262;965
431870;201802;17392;48806;14022;42866;2721;9317;6191;18279;8912;27596
431880;201802;3810;10752;3017;9277;611;2111;1218;3589;1829;5700
431890;201802;4636;12308;3006;9139;878;2876;438;1389;1316;4265
431900;201802;1094;2920;658;2030;146;509;285;816;431;1325
431910;201802;826;2026;337;986;53;153;86;232;139;385
431912;201802;453;1329;376;1180;79;247;204;649;283;896
431915;201802;1045;2835;804;2418;136;449;449;1315;585;1764
431920;201802;1216;3192;1001;2860;73;229;787;2234;860;2463
431930;201802;823;2303;557;1826;142;433;261;899;403;1332
431935;201802;60;192;47;164;15;52;10;34;25;86
431936;201802;295;884;175;594;43;148;44;150;87;298
431937;201802;229;610;131;401;34;108;21;54;55;162
431940;201802;2362;6222;1480;4440;294;975;510;1419;804;2394
431950;201802;1635;4699;1382;4281;294;958;669;2051;963;3009
431960;201802;2703;7390;2199;6393;584;1769;624;1781;1208;3550
431970;201802;408;1109;180;602;46;155;44;139;90;294
431971;201802;84;230;49;166;8;24;8;24;16;48
431973;201802;466;1544;394;1400;35;123;276;998;311;1121
431975;201802;110;251;24;84;4;15;3;7;7;22
431980;201802;1212;3395;942;2905;205;670;375;1116;580;1786
431990;201802;6178;16119;4084;12839;770;2676;1208;3738;1978;6414
432000;201802;10389;27498;7947;23398;2236;6832;2988;8802;5224;15634
432010;201802;1952;5330;1534;4564;215;712;803;2282;1018;2994
432020;201802;1998;4856;1411;3913;343;1011;659;1738;1002;2749
432023;201802;498;1284;282;852;47;178;129;332;176;510
432026;201802;1041;3119;773;2553;164;522;377;1244;541;1766
432030;201802;335;914;213;654;47;146;98;284;145;430
432032;201802;475;1268;315;940;30;101;155;426;185;527
432035;201802;772;2291;678;2134;206;710;227;716;433;1426
432040;201802;956;2317;439;1354;73;250;138;402;211;652
432045;201802;248;683;130;439;33;113;31;115;64;228
432050;201802;539;1471;437;1285;119;361;172;514;291;875
432055;201802;833;2230;545;1679;148;497;191;562;339;1059
432057;201802;347;867;241;671;41;96;107;281;148;377
432060;201802;490;1210;159;525;28;113;50;138;78;251
432065;201802;244;673;172;526;43;136;52;156;95;292
432067;201802;806;2407;637;2028;101;326;360;1128;461;1454
432070;201802;2184;5863;1333;4114;268;888;256;732;524;1620
432080;201802;3728;10046;3025;8819;818;2645;1128;3184;1946;5829
432085;201802;385;997;249;777;81;239;89;298;170;537
432090;201802;1375;3782;1030;3133;263;868;407;1194;670;2062
432100;201802;1194;3343;508;1725;83;310;40;90;123;400
432110;201802;2342;6664;1604;5209;350;1339;125;377;475;1716
432120;201802;3443;10021;2827;8922;947;3209;591;1834;1538;5043
432130;201802;2727;7237;2222;6569;801;2506;757;2286;1558;4792
432132;201802;285;791;139;465;27;92;42;132;69;224
432135;201802;773;2141;580;1743;77;250;377;1102;454;1352
432140;201802;1707;5313;1271;4452;245;886;592;2143;837;3029
432143;201802;1340;3772;1069;3330;150;520;604;1877;754;2397
432145;201802;1411;4079;861;2805;136;490;150;412;286;902
432146;201802;142;435;93;318;28;100;14;43;42;143
432147;201802;394;1302;314;1133;96;357;61;225;157;582
432149;201802;389;1041;233;696;25;76;107;308;132;384
432150;201802;3410;9423;2497;7658;590;2022;656;1914;1246;3936
432160;201802;4445;13186;3628;11828;1089;3783;1061;3434;2150;7217
432162;201802;353;838;51;155;9;25;6;18;15;43
432163;201802;257;698;56;179;4;13;3;11;7;24
432166;201802;594;1746;467;1476;87;309;147;400;234;709
432170;201802;1288;3726;840;2826;180;671;185;586;365;1257
432180;201802;2420;6377;1329;4133;272;917;299;825;571;1742
432183;201802;347;1089;257;872;80;292;47;160;127;452
432185;201802;818;2213;530;1641;47;154;324;968;371;1122
432190;201802;2316;6173;1498;4515;364;1211;513;1439;877;2650
432195;201802;1021;2652;673;2039;191;532;198;633;389;1165
432200;201802;2917;8254;2197;7008;517;1738;908;2959;1425;4697
432210;201802;386;1088;266;867;50;191;105;318;155;509
432215;201802;734;2236;639;2075;90;288;404;1367;494;1655
432218;201802;251;646;139;400;22;64;48;126;70;190
432220;201802;3994;10076;3036;8524;474;1523;1698;4528;2172;6051
432225;201802;107;318;77;258;16;52;30;102;46;154
432230;201802;828;2147;469;1400;78;253;136;362;214;615
432232;201802;462;1181;337;966;59;197;164;463;223;660
432234;201802;289;761;148;455;35;103;22;56;57;159
432235;201802;105;305;40;135;5;19;7;22;12;41
432237;201802;411;1095;357;1003;17;53;232;617;249;670
432240;201802;13682;39550;11095;35882;1140;4308;6776;22826;7916;27134
432250;201802;4329;14266;3788;13187;1165;4230;1260;4511;2425;8741
432252;201802;436;1098;289;844;48;162;119;318;167;480
432253;201802;1217;3822;681;2390;162;637;34;92;196;729
432254;201802;954;2426;212;696;31;113;22;55;53;168
432255;201802;190;465;86;266;10;34;34;94;44;128
432260;201802;6353;16132;4508;12947;1104;3299;1547;4588;2651;7887
432270;201802;2224;6508;1827;5739;562;1872;280;872;842;2744
432280;201802;1253;3290;651;2035;103;332;211;629;314;961
432285;201802;190;591;23;79;2;5;1;1;3;6
432290;201802;417;1253;250;853;62;206;60;189;122;395
432300;201802;24827;68613;20003;60853;3161;10620;11548;34416;14709;45036
432310;201802;733;2138;565;1836;119;389;284;934;403;1323
432320;201802;249;604;82;254;11;43;16;43;27;86
432330;201802;276;693;86;288;14;41;17;55;31;96
432335;201802;173;496;67;246;15;62;11;33;26;95
432340;201802;334;801;156;480;30;109;43;115;73;224
432345;201802;617;1561;561;1485;43;155;401;1010;444;1165
432350;201802;350;952;174;578;32;105;48;146;80;251
432360;201802;205;616;37;127;5;26;8;21;13;47
432370;201802;384;1020;253;763;22;75;152;457;174;532
432375;201802;603;1527;445;1251;63;166;249;704;312;870
432377;201802;224;724;30;107;5;21;9;22;14;43
432380;201802;1355;3931;861;2881;196;742;356;1112;552;1854
500020;201802;2186;6074;1679;5235;380;1337;735;2198;1115;3535
500025;201802;1313;3043;801;2174;71;202;467;1226;538;1428
500060;201802;6628;19459;5086;16724;762;2521;2928;10145;3690;12666
500070;201802;4234;11703;3154;9807;679;2289;1222;3935;1901;6224
500080;201802;1322;3719;925;3005;217;803;337;1061;554;1864
500085;201802;2049;5081;1395;4097;231;721;740;2124;971;2845
500090;201802;2068;5715;1399;4515;269;916;527;1795;796;2711
500100;201802;3302;8864;2528;7586;385;1292;1127;3184;1512;4476
500110;201802;7299;20709;5311;17580;1102;3922;1932;7075;3034;10997
500124;201802;2060;6539;1757;6030;417;1386;873;3295;1290;4681
500150;201802;1324;3219;835;2434;183;580;276;737;459;1317
500190;201802;4758;11828;3560;10225;709;2145;1821;5420;2530;7565
500200;201802;2262;5642;1685;4636;301;898;837;2151;1138;3049
500210;201802;4590;12924;3577;11389;879;2887;1542;5005;2421;7892
500215;201802;1234;3696;914;3063;115;430;434;1408;549;1838
500220;201802;2921;8476;2243;7290;363;1284;933;3047;1296;4331
500230;201802;2612;6393;1864;5252;271;802;987;2759;1258;3561
500240;201802;4018;12294;2790;9786;493;1987;729;2711;1222;4698
500260;201802;3066;6944;1884;5226;227;665;968;2603;1195;3268
500270;201802;117986;299575;71846;216086;15672;50581;18025;52721;33697;103302
500280;201802;1308;3368;979;2884;116;381;622;1799;738;2180
500290;201802;4145;9380;2271;6595;350;1133;762;2096;1112;3229
500295;201802;2703;7250;1564;4870;234;794;485;1304;719;2098
500310;201802;892;2113;658;1809;111;288;354;1012;465;1300
500315;201802;3295;9921;2667;8889;347;1168;1656;5753;2003;6921
500320;201802;17650;53669;13004;45219;3637;13595;3597;13312;7234;26907
500325;201802;3900;9448;2664;7624;364;1117;1520;4396;1884;5513
500330;201802;7001;17057;4527;12963;449;1434;2287;6666;2736;8100
500345;201802;1968;4932;1376;4072;379;1137;470;1375;849;2512
500348;201802;2761;7223;2155;6247;259;810;1278;3756;1537;4566
500350;201802;1247;3571;667;2220;78;276;219;748;297;1024
500370;201802;21726;61465;15287;50305;2951;11037;5604;18474;8555;29511
500375;201802;2609;7153;1810;5529;361;1207;550;1647;911;2854
500380;201802;3477;8910;2479;7300;655;2038;884;2640;1539;4678
500390;201802;561;1220;335;893;47;134;175;453;222;587
500400;201802;1239;3556;856;2707;205;683;223;682;428;1365
500410;201802;2326;6346;1798;5518;291;889;1055;3323;1346;4212
500430;201802;2644;6985;1852;5813;338;1203;700;2339;1038;3542
500440;201802;1321;3260;804;2395;128;386;297;939;425;1325
500450;201802;1307;3476;743;2372;147;485;109;302;256;787
500460;201802;3816;10855;2521;8292;563;2037;543;1836;1106;3873
500470;201802;2479;7065;1687;5403;493;1729;329;937;822;2666
500480;201802;2193;6546;1965;6245;152;455;1484;5024;1636;5479
500490;201802;896;2313;589;1821;148;520;156;496;304;1016
500500;201802;4157;11498;2887;9614;987;3803;660;2242;1647;6045
500510;201802;813;2085;508;1524;41;145;268;754;309;899
500515;201802;2004;5030;1621;4500;125;337;1133;3285;1258;3622
500520;201802;3225;10821;2680;9744;546;2192;1307;4724;1853;6916
500525;201802;1005;3075;803;2740;131;519;393;1371;524;1890
500540;201802;5451;14373;3111;10146;776;3012;285;842;1061;3854
500560;201802;5137;15572;4322;14397;342;1215;3224;10945;3566;12160
500568;201802;4225;9815;2640;7450;629;2044;751;2005;1380;4049
500570;201802;7196;18018;4201;12585;1018;3297;780;2209;1798;5506
500580;201802;3422;9529;2660;8233;405;1301;1523;4713;1928;6014
500600;201802;3552;9025;2297;6954;474;1582;714;2167;1188;3749
500620;201802;7575;21019;5338;16702;833;2785;2402;7552;3235;10337
500625;201802;486;1381;263;876;44;164;108;348;152;512
500627;201802;751;1982;463;1438;87;262;106;345;193;607
500630;201802;5892;15055;3719;11317;880;2848;1028;3167;1908;6015
500635;201802;2617;9280;2103;8503;190;787;1476;6428;1666;7215
500640;201802;1751;4035;1170;3206;59;190;792;2100;851;2290
500660;201802;18296;51538;13309;43489;4313;15615;2932;9707;7245;25322
500690;201802;2443;6986;1743;5863;789;2939;163;509;952;3448
500710;201802;3242;9261;2511;7924;663;2244;718;2217;1381;4461
500720;201802;5451;14024;3301;10443;897;3177;600;1841;1497;5018
500730;201802;937;2556;598;1906;109;360;189;620;298;980
500740;201802;4636;11744;3393;9553;285;935;1858;5299;2143;6234
500750;201802;977;2604;741;2181;122;410;322;882;444;1292
500755;201802;1020;2878;646;2147;123;427;104;296;227;723
500769;201802;5226;13474;2748;8453;512;1746;454;1127;966;2873
500770;201802;1658;4598;1068;3487;190;656;328;1086;518;1742
500780;201802;1340;3483;905;2685;217;674;230;642;447;1316
500790;201802;8746;23158;7048;20495;1343;4300;3680;10733;5023;15033
500793;201802;1979;5440;1405;4449;468;1551;204;568;672;2119
500795;201802;2385;6632;1997;6105;195;503;1507;4920;1702;5423
500797;201802;792;2115;528;1618;102;337;185;541;287;878
500800;201802;2844;7136;1990;5868;687;2300;334;1026;1021;3326
500830;201802;18580;47978;12787;37322;2089;6616;5461;15304;7550;21920
500840;201802;1184;3178;760;2340;94;301;289;839;383;1140
510010;201802;1413;3901;1078;3360;257;790;528;1700;785;2490
510020;201802;3481;9297;1971;6241;410;1368;423;1218;833;2586
510025;201802;7022;19256;4536;14532;885;3103;1276;3885;2161;6988
510030;201802;2023;4848;1438;4034;345;987;567;1647;912;2634
510035;201802;1109;2953;703;2327;121;404;388;1371;509;1775
510040;201802;2145;5139;1551;4295;145;419;944;2610;1089;3029
510050;201802;1887;4936;1277;3935;314;1108;568;1616;882;2724
510060;201802;1413;3753;1053;3174;158;498;524;1540;682;2038
510080;201802;1152;3390;840;2807;237;895;182;523;419;1418
510100;201802;701;1759;467;1330;59;180;216;582;275;762
510120;201802;291;576;164;424;8;24;112;289;120;313
510125;201802;2580;6538;1907;5432;311;1102;760;1960;1071;3062
510130;201802;1602;4266;1212;3619;304;952;328;976;632;1928
510140;201802;2903;8494;2150;7482;837;3320;635;1987;1472;5307
510160;201802;1286;4052;1094;3777;216;763;689;2410;905;3173
510170;201802;4876;13871;3700;11880;773;2660;1536;4901;2309;7561
510180;201802;12707;31531;8136;24143;2137;6834;2235;7349;4372;14183
510185;201802;1713;4561;1169;3781;378;1205;445;1743;823;2948
510190;201802;2382;6549;1596;5315;452;1686;509;1714;961;3400
510250;201802;13787;39166;11817;36385;2746;8961;5979;19085;8725;28046
510260;201802;2089;8659;1705;7904;271;1254;957;5020;1228;6274
510263;201802;3414;9576;2211;7256;465;1658;329;1017;794;2675
510267;201802;5529;15922;3517;11515;771;2644;656;2172;1427;4816
510268;201802;1408;3686;979;2915;134;409;535;1561;669;1970
510269;201802;1084;3161;707;2411;236;896;153;457;389;1353
510270;201802;2850;8926;2177;7639;462;1687;789;2715;1251;4402
510279;201802;1769;5147;1342;4313;289;1027;582;1770;871;2797
510285;201802;1188;3296;859;2733;233;788;235;741;468;1529
510300;201802;3601;9576;2794;8485;289;862;1865;5866;2154;6728
510305;201802;1383;4206;980;3399;225;820;294;1087;519;1907
510310;201802;821;2262;611;1907;214;684;177;579;391;1263
510320;201802;3795;10316;2814;8595;593;1965;818;2479;1411;4444
510325;201802;4769;14593;3880;13265;1074;3812;1834;6555;2908;10367
510330;201802;2859;8976;2066;7550;480;1832;706;2871;1186;4703
510335;201802;4902;14322;3750;12739;419;1503;2316;8376;2735;9879
510336;201802;534;1582;404;1356;71;243;191;664;262;907
510337;201802;1844;5752;1342;4824;532;2045;224;832;756;2877
510340;201802;75346;188419;49428;147736;15472;52622;9614;27697;25086;80319
510343;201802;1050;3034;734;2402;139;475;255;796;394;1271
510345;201802;1420;4178;1060;3464;188;623;427;1373;615;1996
510350;201802;2968;7954;2006;6428;494;1676;742;2455;1236;4131
510360;201802;1715;3986;1122;3233;64;245;819;2365;883;2610
510370;201802;1614;4988;1210;4281;204;764;652;2416;856;3180
510380;201802;507;1396;276;926;71;257;35;113;106;370
510385;201802;1010;3688;736;3097;80;393;405;1827;485;2220
510390;201802;1093;3379;867;3046;228;798;391;1478;619;2276
510395;201802;750;1782;514;1422;55;172;259;759;314;931
510410;201802;4044;12398;3238;10873;805;2753;1508;5327;2313;8080
510420;201802;2225;5266;1593;4344;160;533;912;2441;1072;2974
510450;201802;602;1540;358;1092;85;271;61;181;146;452
510452;201802;669;2044;470;1623;85;282;222;772;307;1054
510454;201802;844;2528;656;2188;86;308;370;1261;456;1569
510455;201802;939;2790;673;2207;117;424;236;710;353;1134
510460;201802;2136;5443;1529;4569;167;606;873;2484;1040;3090
510480;201802;4241;10556;2983;8361;479;1422;1363;3638;1842;5060
510490;201802;1524;4570;1228;4155;269;958;608;2050;877;3008
510500;201802;1561;4336;990;3265;173;668;386;1238;559;1906
510510;201802;3053;9901;2459;8727;766;2967;608;2317;1374;5284
510515;201802;5966;16428;3899;12460;883;3074;944;2724;1827;5798
510517;201802;1363;3967;1064;3434;307;1074;184;557;491;1631
510520;201802;2084;4464;1306;3489;49;143;803;2291;852;2434
510523;201802;979;2665;786;2335;111;330;484;1467;595;1797
510525;201802;5238;15534;4044;13100;801;2855;1436;4212;2237;7067
510530;201802;530;1372;394;1170;25;117;284;790;309;907
510550;201802;2846;8870;2099;7458;531;1989;683;2452;1214;4441
510558;201802;1941;5461;1606;4982;107;351;983;3246;1090;3597
510560;201802;1667;4862;1006;3658;234;932;241;933;475;1865
510562;201802;5274;14808;3821;12022;969;3294;1120;3623;2089;6917
510590;201802;3178;8081;2332;6964;492;1400;1274;4041;1766;5441
510600;201802;1574;3828;991;2878;240;706;327;962;567;1668
510610;201802;2793;7386;2073;6386;209;736;1258;3814;1467;4550
510615;201802;2069;5902;1588;5079;381;1246;765;2557;1146;3803
510617;201802;864;2533;684;2250;63;178;514;1797;577;1975
510618;201802;1341;3759;965;3042;192;704;447;1320;639;2024
510619;201802;732;1958;413;1364;81;308;66;200;147;508
510620;201802;1473;3464;721;2242;167;589;100;280;267;869
510621;201802;1172;3461;859;2860;184;675;245;793;429;1468
510622;201802;3929;11611;2836;9190;902;3201;549;1634;1451;4835
510623;201802;3153;8279;2281;6824;472;1665;713;2026;1185;3691
510624;201802;1653;4435;738;2532;117;455;101;294;218;749
510625;201802;2323;6044;1505;4581;363;1266;247;756;610;2022
510626;201802;1556;3914;967;3046;276;962;199;645;475;1607
510627;201802;595;1621;399;1234;112;362;95;296;207;658
510628;201802;1627;3744;1047;2963;200;559;566;1690;766;2249
510629;201802;1632;5089;1265;4307;328;1203;402;1417;730;2620
510630;201802;2927;9034;1887;6894;435;1724;301;1177;736;2901
510631;201802;451;1187;336;1006;8;15;244;752;252;767
510637;201802;3036;8017;2331;6911;665;2196;752;2175;1417;4371
510642;201802;4996;15486;4043;14054;1140;4307;1618;5868;2758;10175
510645;201802;914;2005;565;1550;162;455;162;458;324;913
510650;201802;6497;19279;5585;18222;910;3004;3904;13329;4814;16333
510665;201802;1897;4595;1109;3224;205;644;373;1126;578;1770
510670;201802;393;842;212;585;21;73;114;319;135;392
510675;201802;6164;18118;4573;15098;1264;4514;952;3126;2216;7640
510677;201802;2097;5487;1520;4665;193;620;905;2858;1098;3478
510680;201802;672;1960;464;1548;105;354;55;180;160;534
510682;201802;1852;5803;1371;4904;390;1517;293;1060;683;2577
510685;201802;879;2396;655;2003;89;294;314;902;403;1196
510700;201802;4047;10312;2707;8360;607;1916;1296;4172;1903;6088
510704;201802;9922;25309;6686;19517;1303;4162;2258;6269;3561;10431
510706;201802;2028;5801;1307;4693;261;1020;619;2406;880;3426
510710;201802;2759;7473;1890;5734;386;1205;647;1874;1033;3079
510715;201802;722;1705;498;1344;70;185;204;557;274;742
510718;201802;2583;5717;1446;4361;606;1888;245;976;851;2864
510719;201802;391;883;241;681;34;120;131;360;165;480
510720;201802;1039;2632;700;2093;182;595;196;544;378;1139
510724;201802;730;2072;518;1683;95;345;224;684;319;1029
510726;201802;878;1814;511;1297;90;241;267;672;357;913
510729;201802;704;1713;347;1045;59;197;91;269;150;466
510730;201802;3079;8084;2100;6424;538;1742;667;2056;1205;3798
510735;201802;979;2966;746;2636;98;369;474;1715;572;2084
510740;201802;1267;3329;906;2750;89;252;579;1865;668;2117
510757;201802;635;2067;517;1854;205;780;171;603;376;1383
510760;201802;36102;84096;21889;62743;6259;20158;4507;11906;10766;32064
510770;201802;4621;10546;3536;9308;363;849;2248;6631;2611;7480
510774;201802;367;1038;287;875;56;159;132;422;188;581
510775;201802;634;1836;469;1553;119;457;82;244;201;701
510776;201802;488;1344;364;1085;89;265;145;436;234;701
510777;201802;1692;4730;1215;4080;115;422;913;3086;1028;3508
510779;201802;606;1753;477;1537;61;172;287;960;348;1132
510780;201802;3555;10162;2805;8995;738;2400;1056;3745;1794;6145
510785;201802;2038;5492;1219;3967;295;1062;177;575;472;1637
510787;201802;2409;6909;1765;5694;775;2603;186;567;961;3170
510788;201802;655;1638;454;1335;80;226;178;625;258;851
510790;201802;14790;41081;9397;30702;2169;8174;1130;3303;3299;11477
510792;201802;8708;24072;5645;18347;1168;4134;1146;3630;2314;7764
510794;201802;1214;3615;856;2925;255;961;185;562;440;1523
510795;201802;8104;22977;5697;18577;1502;5374;1118;3743;2620;9117
510800;201802;1595;4231;1144;3556;238;779;488;1458;726;2237
510805;201802;1885;5168;1284;4074;254;868;474;1372;728;2240
510810;201802;672;1529;459;1236;114;329;230;592;344;921
510820;201802;821;1684;455;1209;62;205;190;479;252;684
510830;201802;746;1999;546;1700;105;315;277;922;382;1237
510835;201802;613;1651;423;1327;59;193;201;607;260;800
510840;201802;43066;104935;33045;91805;7233;20029;16123;47518;23356;67547
510850;201802;1789;4526;1051;3291;337;1196;179;494;516;1690
510860;201802;2753;7946;1852;6319;613;2379;188;614;801;2993
510880;201802;608;1934;499;1723;133;491;221;775;354;1266
510885;201802;584;1558;418;1320;76;262;146;437;222;699
510890;201802;730;2203;593;2009;126;468;302;1033;428;1501
510895;201802;1265;3533;917;2915;230;821;314;903;544;1724
520005;201802;1939;5485;1573;5022;445;1346;720;2585;1165;3931
520010;201802;2165;6699;1555;5412;506;1979;273;817;779;2796
520013;201802;2885;7961;2084;6383;497;1604;565;1810;1062;3414
520015;201802;537;1452;411;1278;112;366;110;372;222;738
520017;201802;1088;3068;850;2692;193;657;398;1239;591;1896
520020;201802;392;986;315;884;69;215;173;467;242;682
520025;201802;31864;92355;28251;87687;3423;11348;20090;62394;23513;73742
520030;201802;5112;14468;4074;12811;551;1861;2304;7301;2855;9162
520050;201802;444;1093;273;774;24;61;152;453;176;514
520055;201802;904;2618;742;2312;80;242;429;1341;509;1583
520060;201802;1441;4256;1132;3670;283;1016;303;965;586;1981
520080;201802;1920;5127;1491;4544;265;786;714;2382;979;3168
520082;201802;1049;2677;901;2431;104;221;551;1534;655;1755
520085;201802;743;2177;611;1952;139;426;193;595;332;1021
520090;201802;877;1933;614;1614;113;257;361;1019;474;1276
520110;201802;40144;112155;29141;94672;10143;37513;2028;6010;12171;43523
520120;201802;194;479;111;337;10;34;41;124;51;158
520130;201802;3645;9689;3084;8803;646;1945;1541;4522;2187;6467
520140;201802;35430;106519;28146;93323;10039;36234;3077;10416;13116;46650
520145;201802;449;1163;307;928;67;215;109;304;176;519
520150;201802;539;1335;417;1186;73;206;233;674;306;880
520160;201802;855;2136;656;1847;112;318;287;825;399;1143
520170;201802;5043;10670;3696;9163;227;614;3067;7642;3294;8256
520180;201802;2152;6091;1763;5489;423;1418;747;2307;1170;3725
520215;201802;2000;4906;1499;4132;300;922;721;1927;1021;2849
520235;201802;667;1631;442;1288;60;193;163;447;223;640
520250;201802;1548;4146;1110;3464;293;1004;196;631;489;1635
520260;201802;859;2086;526;1491;85;257;197;563;282;820
520280;201802;641;1741;521;1521;161;465;193;617;354;1082
520310;201802;1239;2847;825;2209;216;585;283;834;499;1419
520320;201802;1961;5677;1558;4985;163;566;863;2805;1026;3371
520330;201802;3307;9763;2404;8178;520;1988;821;2794;1341;4782
520340;201802;2188;5152;1513;4194;166;413;1001;2907;1167;3320
520350;201802;3158;8130;2325;6680;694;2137;746;2054;1440;4191
520355;201802;1731;4924;1347;4235;344;1188;521;1615;865;2803
520357;201802;831;2116;648;1836;44;134;449;1283;493;1417
520360;201802;727;1984;559;1692;168;527;156;488;324;1015
520380;201802;1343;3509;821;2492;114;393;363;993;477;1386
520390;201802;992;2300;585;1771;188;644;141;404;329;1048
520393;201802;555;1350;395;1095;47;136;189;493;236;629
520396;201802;800;2293;673;2073;102;331;425;1290;527;1621
520400;201802;1536;4187;1254;3777;249;773;732;2222;981;2995
520410;201802;1682;3746;1089;2920;139;396;656;1760;795;2156
520420;201802;358;926;264;738;22;69;183;480;205;549
520425;201802;1410;3494;970;2756;248;722;410;1175;658;1897
520430;201802;2182;5348;1170;3632;203;697;70;212;273;909
520440;201802;3547;8815;2253;6543;616;1909;536;1514;1152;3423
520450;201802;11331;29321;7626;23135;2311;7605;496;1556;2807;9161
520455;201802;685;1930;511;1660;180;632;123;410;303;1042
520460;201802;955;2626;797;2398;108;319;553;1691;661;2010
520465;201802;848;2297;701;2061;113;376;439;1226;552;1602
520470;201802;1890;5640;1614;5255;361;1155;957;3337;1318;4492
520480;201802;862;2496;555;1926;128;486;99;327;227;813
520485;201802;1541;4389;1269;4015;146;505;869;2728;1015;3233
520490;201802;3887;11480;3024;10141;732;2443;1466;5094;2198;7537
520495;201802;1462;3552;1161;3150;79;221;861;2396;940;2617
520500;201802;1438;3897;1048;3206;250;860;396;1177;646;2037
520505;201802;735;1858;537;1589;115;333;268;792;383;1125
520510;201802;7145;19481;5197;16482;1249;4392;1333;4341;2582;8733
520520;201802;1104;2855;825;2448;242;707;261;865;503;1572
520530;201802;1881;6064;1487;5354;552;1993;336;1415;888;3408
520540;201802;2893;7829;1889;5875;457;1460;381;1231;838;2691
520545;201802;1031;2883;798;2491;148;488;282;867;430;1355
520547;201802;731;2177;582;1896;169;566;212;671;381;1237
520549;201802;10884;31328;8905;28244;1998;6521;4499;14595;6497;21116
520551;201802;4144;11973;3573;11141;538;1925;2350;7170;2888;9095
520552;201802;758;2164;677;2067;102;293;473;1508;575;1801
520570;201802;602;1544;426;1273;107;338;143;437;250;775
520580;201802;2870;6581;1998;5465;252;757;1247;3405;1499;4162
520590;201802;1346;3774;975;3093;227;733;177;582;404;1315
520620;201802;8194;22892;6695;20813;1867;6017;2832;8997;4699;15014
520630;201802;1017;2546;653;1945;101;312;218;629;319;941
520640;201802;2630;6856;2051;5899;485;1415;823;2419;1308;3834
520650;201802;880;2230;609;1755;98;298;325;944;423;1242
520660;201802;441;1077;246;741;65;214;45;149;110;363
520670;201802;1000;2843;836;2609;79;267;586;1783;665;2050
520680;201802;761;1967;571;1670;122;351;260;782;382;1133
520690;201802;362;876;238;698;71;208;74;238;145;446
520710;201802;566;1417;367;1057;12;38;232;650;244;688
520725;201802;1627;3955;1158;3198;136;419;743;2009;879;2428
520735;201802;814;2108;557;1643;117;355;178;523;295;878
520740;201802;1836;4543;1453;4079;238;648;851;2464;1089;3112
520750;201802;694;1749;515;1482;102;272;228;701;330;973
520753;201802;1481;3850;1237;3432;181;507;653;1816;834;2323
520760;201802;1093;2498;964;2331;96;189;758;1942;854;2131
520780;201802;1780;4361;1321;3678;150;441;717;1933;867;2374
520790;201802;3154;7703;2265;6363;183;502;1496;4378;1679;4880
520800;201802;15886;42839;13080;39260;2451;7193;7918;25145;10369;32338
520810;201802;1297;2871;934;2458;157;459;523;1439;680;1898
520815;201802;660;2010;483;1634;139;515;73;268;212;783
520830;201802;1747;4134;1307;3621;82;157;1016;2848;1098;3005
520840;201802;2062;5976;1688;5466;706;2381;433;1522;1139;3903
520850;201802;661;1831;452;1502;126;480;109;358;235;838
520860;201802;6505;18524;4989;16128;1140;3970;1765;5860;2905;9830
520870;201802;91262;230079;64701;189825;18623;59609;15878;45324;34501;104933
520880;201802;6527;18676;5080;16396;1638;5662;1127;3632;2765;9294
520890;201802;4003;10396;2895;8592;648;2171;1175;3390;1823;5561
520910;201802;4046;10643;2679;8263;811;2740;472;1458;1283;4198
520915;201802;653;1865;481;1504;89;310;184;559;273;869
520920;201802;4098;10062;2781;8202;426;1382;1343;3988;1769;5370
520929;201802;679;1741;516;1455;115;282;241;761;356;1043
520940;201802;1145;3089;885;2720;73;247;652;2008;725;2255
520945;201802;570;1308;437;1090;42;92;290;707;332;799
520960;201802;1027;2790;803;2412;133;433;418;1221;551;1654
520970;201802;2493;7429;2085;6697;584;2061;497;1616;1081;3677
520980;201802;770;2080;625;1860;146;480;254;732;400;1212
520990;201802;2932;9070;2635;8601;381;1281;1581;5322;1962;6603
520993;201802;1019;2487;717;2003;42;120;502;1414;544;1534
520995;201802;2250;5946;1839;5385;426;1247;839;2494;1265;3741
521000;201802;7814;22144;5829;18453;1638;5477;1446;4566;3084;10043
521010;201802;4095;10991;3084;9252;474;1388;1547;4670;2021;6058
521015;201802;664;1749;562;1582;74;217;388;1079;462;1296
521020;201802;3030;8267;1893;5977;511;1749;188;565;699;2314
521030;201802;606;1462;435;1196;56;131;209;619;265;750
521040;201802;7115;17973;5520;15542;1574;4671;1966;5722;3540;10393
521056;201802;843;2366;663;2077;211;692;178;612;389;1304
521060;201802;1044;2668;800;2289;73;215;450;1328;523;1543
521080;201802;1118;2645;598;1763;83;258;205;520;288;778
521090;201802;3139;8226;2301;6916;701;2245;446;1372;1147;3617
521100;201802;1851;4343;1352;3641;240;627;752;2083;992;2710
521120;201802;4920;11707;3527;9979;496;1368;1618;5135;2114;6503
521130;201802;1049;2616;697;1964;46;160;398;1106;444;1266
521140;201802;1189;3254;887;2715;159;519;328;1008;487;1527
521150;201802;12123;28827;7749;22067;2104;6596;2548;7383;4652;13979
521160;201802;752;1716;504;1336;90;264;239;596;329;860
521170;201802;1125;2719;805;2235;86;249;506;1353;592;1602
521180;201802;6542;19754;5478;17778;1218;4219;2052;6600;3270;10819
521190;201802;9950;26614;5920;19348;1485;5212;1045;3557;2530;8769
521200;201802;797;2061;575;1679;69;220;305;869;374;1089
521205;201802;614;1623;468;1385;30;90;328;955;358;1045
521210;201802;827;2235;473;1469;114;392;65;154;179;546
521220;201802;4260;10473;2942;8529;614;1889;1038;2957;1652;4846
521225;201802;352;849;282;770;25;54;214;620;239;674
521230;201802;1382;4263;1275;4096;448;1338;655;2289;1103;3627
521250;201802;30788;88546;24965;80103;10372;34172;6804;23547;17176;57719
521260;201802;722;1689;545;1431;94;275;296;761;390;1036
521270;201802;1837;4890;1594;4596;141;320;1226;3668;1367;3988
521280;201802;1973;5561;1501;4714;465;1579;441;1396;906;2975
521290;201802;459;1211;344;1056;63;235;185;547;248;782
521295;201802;1184;2686;939;2385;89;202;708;1889;797;2091
521300;201802;1884;4911;1522;4404;214;590;1021;3068;1235;3658
521305;201802;743;1952;551;1633;86;249;284;854;370;1103
521308;201802;4542;12906;3409;10695;641;2050;1612;5089;2253;7139
521310;201802;8519;23280;5698;18007;1435;4839;1463;4495;2898;9334
521340;201802;386;935;312;831;23;65;244;647;267;712
521350;201802;2157;5487;1675;4774;220;669;1111;3097;1331;3766
521370;201802;1090;2912;677;2175;195;716;67;205;262;921
521375;201802;1477;3989;1110;3473;279;933;401;1314;680;2247
521377;201802;1309;3014;1042;2681;51;135;901;2324;952;2459
521380;201802;6178;16775;4162;13086;475;1571;1028;3397;1503;4968
521385;201802;607;1519;482;1364;117;337;207;630;324;967
521390;201802;765;1998;560;1689;180;594;172;534;352;1128
521400;201802;2284;5654;1842;5153;228;722;1320;3675;1548;4397
521405;201802;1394;3682;1044;3093;243;746;435;1308;678;2054
521410;201802;763;2116;635;1931;146;419;316;1035;462;1454
521440;201802;1443;3950;1094;3301;278;884;278;792;556;1676
521450;201802;3886;12089;2983;10232;815;2893;698;2488;1513;5381
521460;201802;6625;18275;5118;15601;1605;5211;1453;4263;3058;9474
521470;201802;641;1813;398;1265;75;226;96;286;171;512
521480;201802;379;1054;219;724;45;155;57;172;102;327
521483;201802;2603;6618;1896;5414;493;1470;556;1552;1049;3022
521486;201802;1707;4132;1325;3615;85;224;1008;2735;1093;2959
521487;201802;494;1262;341;1028;73;226;134;410;207;636
521490;201802;841;2327;637;1972;37;142;438;1316;475;1458
521500;201802;1664;4456;1168;3618;150;539;642;1902;792;2441
521520;201802;819;1861;570;1505;102;268;253;698;355;966
521523;201802;11311;38461;10017;36203;3719;14264;2454;9322;6173;23586
521525;201802;1035;2530;819;2217;85;248;540;1429;625;1677
521530;201802;2186;5761;1324;4044;297;965;299;940;596;1905
521540;201802;875;2281;564;1750;96;373;240;730;336;1103
521550;201802;1474;3732;907;2596;183;563;327;950;510;1513
521560;201802;3757;11123;2800;9821;723;2896;1296;4670;2019;7566
521565;201802;627;1533;505;1369;75;201;330;873;405;1074
521570;201802;4150;11194;2698;8400;597;1995;359;1139;956;3134
521580;201802;573;1375;312;934;47;152;59;166;106;318
521590;201802;622;1632;472;1375;124;412;185;499;309;911
521600;201802;422;1194;274;865;61;181;59;180;120;361
521630;201802;1497;3523;937;2683;215;681;272;749;487;1430
521640;201802;2117;5165;1559;4396;370;1060;665;1917;1035;2977
521645;201802;591;1640;389;1257;93;318;101;313;194;631
521680;201802;1227;3858;982;3360;309;1105;112;401;421;1506
521690;201802;483;1374;433;1289;105;325;212;618;317;943
521710;201802;3096;8404;2187;6813;432;1428;438;1329;870;2757
521720;201802;2056;5458;1547;4570;237;741;820;2349;1057;3090
521730;201802;3797;11590;3066;10217;1049;3857;490;1395;1539;5252
521740;201802;3910;10683;3043;9378;822;2792;1104;3598;1926;6390
521760;201802;14276;43616;11898;39762;3500;12719;3850;13526;7350;26245
521770;201802;2868;7690;2083;6259;678;2186;468;1353;1146;3539
521800;201802;6257;18180;5153;16314;1528;5065;1609;5494;3137;10559
521805;201802;861;1900;593;1530;197;479;210;598;407;1077
521810;201802;748;1788;514;1444;90;274;228;662;318;936
521830;201802;5269;15549;4399;14250;511;1848;2888;9257;3399;11105
521839;201802;696;1849;502;1497;107;341;185;528;292;869
521850;201802;5843;15264;4244;12680;1159;3758;713;2027;1872;5785
521860;201802;1887;4890;1363;4055;243;800;459;1339;702;2139
521870;201802;540;1653;425;1451;100;353;128;413;228;766
521878;201802;710;1983;504;1577;85;304;185;529;270;833
521880;201802;20848;51839;14063;41377;3595;11107;4255;13106;7850;24213
521890;201802;3245;9202;2252;7176;556;1893;292;867;848;2760
521900;201802;1504;3738;976;2939;243;724;292;884;535;1608
521910;201802;1210;2782;829;2328;92;271;496;1458;588;1729
521920;201802;385;1141;292;958;65;244;90;301;155;545
521925;201802;663;1913;511;1639;109;356;150;467;259;823
521930;201802;4224;11667;3218;10097;1017;3211;899;2989;1916;6200
521935;201802;682;1852;540;1586;132;384;227;656;359;1040
521940;201802;1249;3018;886;2523;216;700;382;1045;598;1745
521945;201802;587;1762;487;1584;90;295;228;794;318;1089
521950;201802;652;1597;518;1427;38;110;402;1111;440;1221
521960;201802;726;2035;497;1569;77;265;222;667;299;932
521970;201802;2690;6961;2248;6440;144;367;1826;5407;1970;5774
521971;201802;916;2362;620;1872;131;416;149;442;280;858
521973;201802;1050;2998;871;2724;125;438;494;1522;619;1960
521975;201802;12706;34136;10881;31755;1838;5549;6833;20025;8671;25574
521980;201802;2436;6171;1966;5552;213;546;1452;4177;1665;4723
521990;201802;1186;3310;938;2920;133;419;521;1669;654;2088
522000;201802;3570;11868;2937;11048;245;807;2038;8346;2283;9153
522005;201802;346;842;246;692;74;190;87;267;161;457
522010;201802;3693;9758;2827;8367;885;2737;679;1969;1564;4706
522015;201802;986;2709;731;2313;157;528;277;870;434;1398
522020;201802;5219;13042;3642;10492;897;2697;1516;4395;2413;7092
522026;201802;714;1934;533;1688;86;289;270;888;356;1177
522028;201802;522;1424;381;1124;81;231;146;401;227;632
522040;201802;2715;6220;1925;5211;275;765;1284;3496;1559;4261
522045;201802;16500;50240;12762;42916;3229;11724;2483;8225;5712;19949
522050;201802;1118;3062;751;2388;164;544;242;705;406;1249
522060;201802;2499;7091;2013;6354;330;1088;1098;3566;1428;4654
522068;201802;1747;5018;1471;4688;194;562;1004;3376;1198;3938
522070;201802;635;1752;527;1583;55;220;353;1008;408;1228
522100;201802;568;1564;431;1363;78;258;223;713;301;971
522108;201802;832;2466;683;2220;45;217;532;1659;577;1876
522119;201802;1593;4295;1253;3827;219;683;645;2038;864;2721
522130;201802;391;1013;283;869;74;249;134;416;208;665
522140;201802;16692;46314;12708;39306;3918;12958;2024;6110;5942;19068
522145;201802;831;2128;622;1823;147;390;333;1062;480;1452
522150;201802;973;2418;747;2089;218;601;262;768;480;1369
522155;201802;892;2464;731;2203;150;417;363;1150;513;1567
522157;201802;585;1591;490;1452;30;116;358;1033;388;1149
522160;201802;6431;17263;4292;13362;1187;4015;375;1285;1562;5300
522170;201802;2418;6738;1756;5572;569;1892;381;1227;950;3119
522180;201802;441;1178;284;907;64;211;44;161;108;372
522185;201802;16170;42664;12474;37885;4564;14674;3952;13009;8516;27683
522190;201802;863;2053;645;1737;125;326;266;757;391;1083
522200;201802;1773;5412;1236;4248;257;922;178;600;435;1522
522205;201802;1461;3713;1135;3232;97;301;813;2336;910;2637
522220;201802;1501;3721;1113;3185;177;481;603;1822;780;2303
522230;201802;1259;3328;1036;3002;176;577;592;1711;768;2288
530010;201802;177147;525748;152822;485493;34181;120448;70690;218987;104871;339435
110001;201803;3227;9963;2557;8796;658;2393;1095;3792;1753;6185
110002;201803;10827;29819;7955;24938;2433;8125;2456;7649;4889;15774
110003;201803;665;1980;497;1643;154;546;91;284;245;830
110004;201803;8208;24364;6124;20346;1777;6211;1311;4671;3088;10882
110005;201803;2127;5859;1394;4509;357;1204;464;1595;821;2799
110006;201803;1657;4798;1041;3508;278;1006;127;423;405;1429
110007;201803;1140;3363;893;2929;311;1048;295;1079;606;2127
110008;201803;2334;7633;2098;7298;263;860;1617;5800;1880;6660
110009;201803;3722;11021;2644;9211;804;2881;861;3117;1665;5998
110010;201803;5924;20158;4902;18378;1416;5215;2083;8751;3499;13966
110011;201803;6097;17928;4756;15354;1599;5331;1030;3407;2629;8738
110012;201803;12774;34588;9002;28117;2334;7614;1477;4746;3811;12360
110013;201803;5182;15890;4223;14063;1682;5752;757;2765;2439;8517
110014;201803;3633;10017;2683;8332;776;2451;1055;3224;1831;5675
110015;201803;4817;13634;2958;9875;772;2730;405;1343;1177;4073
110018;201803;3394;9131;2199;7095;513;1897;583;1771;1096;3668
110020;201803;64744;168296;45690;141357;10213;33274;17483;57575;27696;90849
110025;201803;4369;11559;3068;9318;542;1733;1656;4951;2198;6684
110026;201803;465;1433;397;1311;116;418;165;521;281;939
110028;201803;5820;16590;4083;13213;1163;4022;539;1717;1702;5739
110029;201803;1297;3286;799;2502;194;617;341;1067;535;1684
110030;201803;10742;27525;7600;23021;1510;5198;2973;9067;4483;14265
110032;201803;2992;9128;2229;7498;756;2575;535;1839;1291;4414
110033;201803;4035;13151;3337;11824;1175;4201;906;3570;2081;7771
110034;201803;3203;8382;2358;7154;774;2475;1013;3109;1787;5584
110037;201803;1626;5323;1339;4748;341;1252;617;2173;958;3425
110040;201803;2860;8596;2208;7376;698;2506;561;1793;1259;4299
110045;201803;4471;13955;3799;12926;1200;4375;1485;5054;2685;9429
110050;201803;1578;4847;1227;4149;512;1786;289;979;801;2765
110060;201803;779;2465;574;2033;204;756;66;257;270;1013
110070;201803;1844;6057;1508;5275;547;1993;351;1175;898;3168
110080;201803;4714;12433;3642;11074;1047;3260;1652;5269;2699;8529
110090;201803;625;1747;444;1412;129;426;170;527;299;953
110092;201803;1065;3349;890;3065;148;556;487;1724;635;2280
110094;201803;2866;8691;2264;7681;791;2759;679;2412;1470;5171
110100;201803;1822;5671;1554;5134;336;1210;790;2585;1126;3795
110110;201803;1538;4623;1171;4031;411;1475;250;934;661;2409
110120;201803;1364;4173;1031;3484;300;1062;256;860;556;1922
110130;201803;2475;6611;1574;4941;388;1360;508;1556;896;2916
110140;201803;2098;6745;1597;5689;439;1660;383;1341;822;3001
110143;201803;1304;3659;950;2998;334;1075;257;828;591;1903
110145;201803;970;2744;633;2086;161;560;206;682;367;1242
110146;201803;428;1202;304;1003;55;168;148;522;203;690
110147;201803;613;1706;414;1307;95;314;155;445;250;759
110148;201803;976;2937;588;2022;116;429;57;194;173;623
110149;201803;2669;7930;2046;6936;814;2693;578;2158;1392;4851
110150;201803;2018;5788;1564;5088;669;2401;383;1159;1052;3560
110155;201803;679;2138;547;1834;128;457;200;643;328;1100
110160;201803;1451;4684;1137;4007;418;1454;271;1009;689;2463
110170;201803;2189;6070;1470;4662;299;994;718;2226;1017;3220
110175;201803;1395;4208;1098;3754;186;679;556;1986;742;2665
110180;201803;1114;3252;854;2747;233;730;371;1227;604;1957
120001;201803;3174;10961;2798;10402;487;1676;1775;7100;2262;8776
120005;201803;1719;6837;1555;6559;184;857;1161;5004;1345;5861
120010;201803;5103;16426;4423;15282;667;2240;2971;10608;3638;12848
120013;201803;2006;7891;1895;7731;512;2010;1054;4624;1566;6634
120017;201803;1965;6914;1795;6622;382;1437;1006;3909;1388;5346
120020;201803;13698;59217;13033;57914;1463;7033;9694;43992;11157;51025
120025;201803;2548;8079;2176;7603;440;1581;1358;4849;1798;6430
120030;201803;6315;25225;6099;24867;367;1843;5060;20715;5427;22558
120032;201803;1580;7470;1509;7299;97;612;1193;5732;1290;6344
120033;201803;3815;14788;3601;14420;165;857;3119;12429;3284;13286
120034;201803;2351;9131;2063;8600;140;824;1621;6661;1761;7485
120035;201803;3305;14296;3180;14057;265;1388;2569;11407;2834;12795
120038;201803;2536;8767;2310;8360;588;2200;1221;4512;1809;6712
120039;201803;1843;8465;1771;8327;170;1017;1337;6316;1507;7333
120040;201803;39860;137030;35907;130365;6770;26124;20497;75790;27267;101914
120042;201803;3119;12389;2907;11922;161;846;2329;9505;2490;10351
120043;201803;1183;5318;1118;5172;71;429;952;4405;1023;4834
120045;201803;5139;15632;4681;15121;187;749;4262;13672;4449;14421
120050;201803;8284;32214;7747;31285;697;3297;5942;24312;6639;27609
120060;201803;8153;34956;7788;34309;528;2900;6511;28762;7039;31662
120070;201803;2711;9561;2532;9259;332;1231;1760;6645;2092;7876
120080;201803;3921;14127;3586;13565;617;2467;2389;9156;3006;11623
130002;201803;3098;12748;2873;12434;104;577;2583;11219;2687;11796
130006;201803;2230;8997;1898;8380;153;789;1441;6353;1594;7142
130008;201803;2411;8904;2172;8501;89;488;1806;7051;1895;7539
130010;201803;3695;10927;3234;10403;76;312;3002;9661;3078;9973
130014;201803;2942;9327;2429;8456;407;1472;1555;5510;1962;6982
130020;201803;2667;10522;2466;10177;142;837;1966;8059;2108;8896
130030;201803;9027;31235;8344;30494;158;493;7858;29190;8016;29683
130040;201803;3776;11447;3221;10717;216;713;2573;8700;2789;9413
130050;201803;6981;26454;5878;25030;202;923;5276;22754;5478;23677
130060;201803;6824;28949;6038;27843;522;3079;4713;21639;5235;24718
130063;201803;5185;19227;4668;18627;119;588;4321;17362;4440;17950
130068;201803;3208;12961;2860;12260;204;1104;2175;9302;2379;10406
130070;201803;8101;25877;7038;24682;328;1103;6164;22088;6492;23191
130080;201803;6122;24975;5555;24218;421;2405;4438;19367;4859;21772
130083;201803;2446;8916;2209;8594;184;857;1764;6806;1948;7663
130090;201803;3103;10231;2853;9892;62;267;2572;9037;2634;9304
130100;201803;6878;22718;6160;21936;78;257;5885;21232;5963;21489
130110;201803;7395;22126;6375;20910;528;1548;5365;18066;5893;19614
130115;201803;5184;17085;4683;16442;106;430;4090;14527;4196;14957
130120;201803;14556;53918;13396;52400;1287;5325;10833;43107;12120;48432
130130;201803;4769;16735;3984;15716;467;2126;2997;11775;3464;13901
130140;201803;6433;24598;6220;24351;254;1227;5675;22206;5929;23433
130150;201803;3478;13726;3317;13516;114;682;2995;12194;3109;12876
130160;201803;4684;18105;4214;17478;324;1593;3467;14601;3791;16194
130165;201803;3022;12133;2875;11882;113;635;2527;10416;2640;11051
130170;201803;10835;34298;8970;32017;701;2761;7366;26669;8067;29430
130180;201803;4195;13387;3957;13106;55;250;3781;12500;3836;12750
130185;201803;15099;41215;12430;38365;497;1192;11025;35272;11522;36464
130190;201803;17455;59409;14800;55566;1805;6825;10488;40765;12293;47590
130195;201803;2252;8703;1895;8221;86;422;1671;7300;1757;7722
130200;201803;2206;6984;1891;6546;158;560;1489;5286;1647;5846
130210;201803;1376;5240;1238;5076;108;628;973;3908;1081;4536
130220;201803;2011;7846;1833;7540;120;631;1440;5949;1560;6580
130230;201803;4022;17784;3631;17209;330;1864;2962;14137;3292;16001
130240;201803;10051;33993;8597;31924;233;1375;7567;28060;7800;29435
130250;201803;23811;75016;21180;72032;1478;4935;17741;61870;19219;66805
130255;201803;4059;14422;3666;13743;254;1148;2914;10936;3168;12084
130260;201803;230960;712845;197731;660885;58410;208057;81639;276505;140049;484562
130270;201803;7990;31147;6995;29558;883;3916;4973;21740;5856;25656
130280;201803;3421;14080;3231;13868;78;352;3028;13196;3106;13548
130290;201803;11973;41667;10863;40398;237;584;10249;39007;10486;39591
130300;201803;4550;16882;4243;16411;225;1173;3616;13898;3841;15071
130310;201803;5398;19894;4882;19172;378;1535;4003;16003;4381;17538
130320;201803;3199;11001;2792;10472;288;1049;2093;8096;2381;9145
130330;201803;4096;14032;3504;13290;153;765;3038;11526;3191;12291
130340;201803;20248;71217;18031;68615;1458;5515;15144;59137;16602;64652
130350;201803;3708;14149;3422;13772;182;1075;2948;11687;3130;12762
130353;201803;5864;17956;5028;16872;883;2929;3316;11636;4199;14565
130356;201803;4762;16651;4240;15799;520;2054;2978;11311;3498;13365
130360;201803;3226;9529;2776;9051;78;232;2593;8543;2671;8775
130370;201803;5698;22251;5111;21465;201;1199;4446;18623;4647;19822
130380;201803;7433;31191;7094;30683;499;2707;5976;25627;6475;28334
130390;201803;5341;23803;4872;22924;523;2816;3598;16975;4121;19791
130395;201803;2319;7777;2027;7248;225;842;1458;5233;1683;6075
130400;201803;2460;8345;2154;7909;116;415;1893;7042;2009;7457
130406;201803;10788;40176;9553;38470;1766;7334;6452;26517;8218;33851
130410;201803;4005;14761;3499;13874;1041;4328;1667;6815;2708;11143
130420;201803;11841;46078;10570;44455;1051;4925;8409;35788;9460;40713
130423;201803;3864;13341;3454;12833;167;851;3014;11071;3181;11922
130426;201803;2671;10733;2553;10555;75;374;2364;9850;2439;10224
130430;201803;3864;12295;3507;11799;398;1372;2738;9287;3136;10659
130440;201803;4345;14139;3888;13600;86;337;3627;12789;3713;13126
140002;201803;1842;5775;1642;5512;99;432;1320;4350;1419;4782
140005;201803;3292;9107;3099;8896;126;393;2842;8162;2968;8555
140010;201803;49507;137922;39020;122533;9935;32769;14385;48346;24320;81115
140015;201803;3274;10452;2942;10052;268;938;2407;8385;2675;9323
140017;201803;3464;10873;3091;10380;316;989;2280;8074;2596;9063
140020;201803;4793;15132;4137;14247;354;1473;3142;10814;3496;12287
140023;201803;2131;6912;1795;6411;225;865;1268;4580;1493;5445
140028;201803;2053;5479;1768;5104;177;585;1341;3767;1518;4352
140030;201803;4057;11923;3632;11392;364;1034;2889;9307;3253;10341
140040;201803;1923;8331;1789;8142;90;535;1604;7250;1694;7785
140045;201803;2531;9488;2164;8962;398;1619;1385;6078;1783;7697
140047;201803;5789;17604;4957;16298;970;3252;2872;9784;3842;13036
140050;201803;1385;4237;1192;3947;135;449;829;2779;964;3228
140060;201803;1419;4088;1253;3842;91;273;1037;3217;1128;3490
140070;201803;1759;9532;1701;9379;151;1046;1317;7204;1468;8250
150010;201803;39981;107304;36867;103128;1425;4639;32018;88871;33443;93510
150013;201803;1765;4938;1498;4639;140;381;1126;3654;1266;4035
150020;201803;12935;41882;12276;40996;1258;3334;10145;35179;11403;38513
150030;201803;8531;33190;7814;32290;396;1795;6854;28575;7250;30370
150034;201803;4077;11043;3512;10266;267;814;2816;8298;3083;9112
150040;201803;13189;38950;11439;36945;999;2479;9513;32409;10512;34888
150050;201803;6477;23570;6026;22911;139;701;5506;21019;5645;21720
150060;201803;19060;55792;16296;51680;3484;11007;9148;30240;12632;41247
150070;201803;6298;24765;5632;23998;171;920;5178;22286;5349;23206
150080;201803;79857;198790;67129;181878;15521;43264;27093;81413;42614;124677
150085;201803;6032;19525;5577;18959;244;768;5097;17538;5341;18306
150090;201803;9911;37836;9384;36953;675;2937;7540;29871;8215;32808
150095;201803;5378;17032;4834;16280;270;851;4003;13840;4273;14691
150100;201803;3116;11080;2775;10479;213;805;2120;8068;2333;8873
150110;201803;3806;17368;3713;17243;217;1050;3321;15585;3538;16635
150120;201803;6903;23907;6706;23615;302;893;5933;21462;6235;22355
150125;201803;730;2059;601;1897;114;403;363;1127;477;1530
150130;201803;21730;65242;19376;61822;2520;7241;13949;46207;16469;53448
150140;201803;187048;483399;164968;453700;25186;68045;105109;298389;130295;366434
150145;201803;4548;13867;3975;13083;668;1918;2862;9915;3530;11833
150150;201803;13195;37306;11941;35685;1111;3490;9094;27492;10205;30982
150157;201803;3081;8996;2605;8361;291;1020;1799;5919;2090;6939
150160;201803;2926;9168;2741;8854;667;2138;1522;5059;2189;7197
150170;201803;23800;80103;20844;75359;3563;12436;12997;49937;16560;62373
150172;201803;3767;11468;3116;10491;301;921;2270;7925;2571;8846
150175;201803;1691;5266;1507;4960;155;572;1099;3673;1254;4245
150178;201803;9993;28949;8402;27059;504;1651;6832;22545;7336;24196
150180;201803;20181;76965;18759;75164;986;4249;16308;66243;17294;70492
150190;201803;6909;23756;6550;23286;226;1035;5863;20810;6089;21845
150195;201803;5421;17411;5140;16967;95;387;4746;15638;4841;16025
150200;201803;5267;16297;4860;15844;60;194;4619;15178;4679;15372
150210;201803;24678;90164;23408;88485;1901;6970;19073;74508;20974;81478
150215;201803;7120;21835;6203;20442;1915;6338;2591;9063;4506;15401
150220;201803;10791;33024;9636;31247;1698;5431;5629;18839;7327;24270
150230;201803;12295;36349;10664;34164;1498;4638;7230;24294;8728;28932
150240;201803;31965;92974;26456;83172;8789;28117;6725;21999;15514;50116
150250;201803;4086;16750;3892;16467;598;2554;2888;12467;3486;15021
150260;201803;2231;8132;2119;7949;230;859;1564;5950;1794;6809
150270;201803;8076;23623;6000;20687;1859;6610;2293;8356;4152;14966
150275;201803;6161;21203;5735;20547;363;1388;4703;16898;5066;18286
150276;201803;2165;6188;1871;5828;256;779;1369;4451;1625;5230
150277;201803;4901;13872;4128;12947;419;1223;3184;10457;3603;11680
150280;201803;6162;26590;5989;26250;540;2322;4864;21645;5404;23967
150285;201803;3138;11531;2826;11065;329;1395;1954;7801;2283;9196
150290;201803;10496;28913;9701;28047;481;1092;8618;25599;9099;26691
150293;201803;9805;24689;7097;21083;1755;5280;3062;10062;4817;15342
150295;201803;7655;21032;5932;18989;1961;6383;2537;9204;4498;15587
150300;201803;2055;6662;1868;6410;58;306;1605;5445;1663;5751
150304;201803;3892;12494;3393;11663;587;1959;2188;7750;2775;9709
150307;201803;6319;20693;5917;20087;379;1230;4954;17043;5333;18273
150309;201803;5909;19270;5022;17774;1256;4291;2440;9267;3696;13558
150310;201803;6810;27482;6452;27009;292;1509;5607;23673;5899;25182
150320;201803;9277;25099;8471;24039;478;1416;6812;19376;7290;20792
150330;201803;13972;46289;12966;44699;1697;5921;9482;33530;11179;39451
150340;201803;2666;7987;2405;7610;284;863;1742;5613;2026;6476
150345;201803;7353;22792;6676;21908;478;1665;5508;18263;5986;19928
150350;201803;8330;23783;7756;23074;792;1810;6371;19677;7163;21487
150360;201803;22450;65167;18426;60171;2287;6967;12859;43895;15146;50862
150370;201803;9415;32603;8329;31107;817;2962;6213;24067;7030;27029
150375;201803;3149;13415;2867;12979;299;1422;2281;10474;2580;11896
150380;201803;9659;27007;8219;25045;381;1196;6955;21460;7336;22656
150390;201803;7637;32423;7027;31362;1134;4836;4752;22198;5886;27034
150400;201803;6048;22861;5782;22344;343;1362;4791;18674;5134;20036
150405;201803;8728;24424;7734;23211;509;1287;6230;19365;6739;20652
150410;201803;1732;6033;1534;5681;226;836;964;3653;1190;4489
150420;201803;33220;103703;26174;92770;8902;32921;6943;28568;15845;61489
150430;201803;7771;24636;7323;23999;748;2205;5760;19457;6508;21662
150440;201803;5564;18476;5248;18026;389;1245;4308;15017;4697;16262
150442;201803;22576;61087;19314;56428;2697;7726;12157;36799;14854;44525
150445;201803;5621;18652;5100;17814;302;1053;4174;14807;4476;15860
150450;201803;4666;21226;4427;20870;372;1877;3689;17570;4061;19447
150460;201803;7814;26692;7297;26007;235;993;6333;23278;6568;24271
150470;201803;17634;52499;16620;51296;1123;3126;14466;45329;15589;48455
150475;201803;4126;13951;3741;13358;214;801;3073;11176;3287;11977
150480;201803;13762;46670;12384;44518;1912;6762;8678;32420;10590;39182
150490;201803;7755;28163;7334;27624;227;1105;6541;24695;6768;25800
150495;201803;4975;18029;4829;17839;113;481;4482;16637;4595;17118
150497;201803;2605;8950;2182;8170;592;2319;1012;3982;1604;6301
150500;201803;3236;8659;2894;8149;331;864;2227;6330;2558;7194
150503;201803;3948;11533;3023;10211;972;3317;1171;4323;2143;7640
150506;201803;9694;32627;8693;31188;1892;6270;5517;21222;7409;27492
150510;201803;9865;37115;8687;34806;1308;5091;5644;23840;6952;28931
150520;201803;6982;27038;6849;26868;185;873;6403;25187;6588;26060
150530;201803;12215;41908;10774;39669;1330;4206;7951;30605;9281;34811
150540;201803;4743;13700;4111;12764;182;561;3487;10843;3669;11404
150543;201803;6304;18102;5310;16784;876;2826;3582;11837;4458;14663
150548;201803;9590;30430;8788;29416;313;959;7997;27021;8310;27980
150549;201803;1980;6212;1768;5968;59;239;1578;5322;1637;5561
150550;201803;18763;58552;16169;54195;4518;15292;6620;23523;11138;38815
150553;201803;21908;70932;17622;62791;6140;22652;4811;18775;10951;41427
150555;201803;1721;4974;1400;4463;84;278;1006;3193;1090;3471
150560;201803;1808;5796;1615;5413;296;931;900;3114;1196;4045
150563;201803;2407;7869;2162;7433;462;1708;1168;4001;1630;5709
150565;201803;3950;13363;3580;12749;116;583;3018;10742;3134;11325
150570;201803;5967;20814;5751;20452;355;1381;4709;16750;5064;18131
150580;201803;10123;41582;9218;40559;641;3136;7682;34488;8323;37624
150590;201803;6714;25255;6217;24595;193;1024;5676;22415;5869;23439
150600;201803;8422;30890;7893;30200;219;975;7189;27682;7408;28657
150610;201803;2446;7973;2236;7559;157;611;1768;5895;1925;6506
150611;201803;2808;8966;2602;8629;118;473;2207;7269;2325;7742
150613;201803;12325;35384;9479;30584;2089;6990;4135;13731;6224;20721
150616;201803;3008;8792;2245;7470;557;2032;692;2222;1249;4254
150618;201803;6469;20553;5493;18871;994;3419;3178;11391;4172;14810
150619;201803;5468;17158;4702;15982;313;1210;3669;12443;3982;13653
150620;201803;6193;21406;5484;20468;745;2760;3974;15196;4719;17956
150630;201803;6099;17061;5685;16574;328;1002;4935;14493;5263;15495
150635;201803;3991;12296;3512;11448;709;2354;1830;6081;2539;8435
150640;201803;2127;6229;1963;6046;38;121;1837;5738;1875;5859
150650;201803;11089;32736;9902;30637;2980;8916;4167;13748;7147;22664
150655;201803;5436;16497;5017;15821;280;861;4201;13321;4481;14182
150658;201803;4279;12573;3601;11620;705;2415;2168;7257;2873;9672
150660;201803;5723;16918;5154;16131;615;1874;3499;11170;4114;13044
150670;201803;7677;19345;6151;17536;599;1572;4829;14250;5428;15822
150680;201803;63600;199987;49898;178019;12853;45739;21291;85048;34144;130787
150690;201803;2274;6314;2017;5955;124;362;1676;4985;1800;5347
150700;201803;5967;18599;5475;17957;531;1680;4185;14101;4716;15781
150710;201803;3942;13362;3601;12797;284;1113;2732;9747;3016;10860
150715;201803;4965;15685;4348;14711;314;1031;3512;12065;3826;13096
150720;201803;6312;24492;5977;23892;458;2050;4857;19530;5315;21580
150730;201803;10670;34794;9500;32970;1057;3816;7120;25209;8177;29025
150740;201803;3517;10745;3122;10043;479;1507;2021;6611;2500;8118
150745;201803;4799;14584;4112;13631;847;2961;2643;8857;3490;11818
150746;201803;1348;4391;1259;4233;88;285;1001;3412;1089;3697
150747;201803;5098;16314;4518;15471;853;2648;2844;10427;3697;13075
150750;201803;3538;11329;3090;10681;201;789;2429;8541;2630;9330
150760;201803;11451;34938;10499;33738;1255;3856;7827;25756;9082;29612
150770;201803;6012;22545;5765;22195;144;466;5360;21148;5504;21614
150775;201803;926;2739;763;2479;142;530;420;1348;562;1878
150780;201803;4097;12753;3853;12469;79;304;3589;11687;3668;11991
150790;201803;5226;16071;4624;15398;253;709;3811;13719;4064;14428
150795;201803;13935;45332;12620;43142;3023;9851;7077;25652;10100;35503
150796;201803;3313;9161;2900;8669;209;648;2348;7126;2557;7774
150797;201803;3850;12502;3358;11714;122;388;2813;9940;2935;10328
150800;201803;12788;41627;11770;40378;1891;5941;8476;30512;10367;36453
150803;201803;6494;22934;6118;22322;486;1845;4968;18192;5454;20037
150805;201803;2941;9950;2605;9389;287;1024;1980;7235;2267;8259
150808;201803;5727;17701;4365;15237;1604;6125;512;1950;2116;8075
150810;201803;19148;55552;15219;50638;2899;9494;8731;31355;11630;40849
150812;201803;5170;15459;4652;14545;497;1689;3421;10494;3918;12183
150815;201803;8527;27392;7445;26027;752;2600;5764;20613;6516;23213
150820;201803;11318;32200;9854;30469;968;2710;7583;24309;8551;27019
150830;201803;11671;44422;11061;43656;402;2177;9534;38402;9936;40579
150835;201803;2148;7505;1984;7202;440;1612;1026;3834;1466;5446
150840;201803;7018;21108;5631;18649;1230;4307;2590;8658;3820;12965
160005;201803;1093;3187;1005;3045;25;111;934;2791;959;2902
160010;201803;1732;5227;1702;5196;10;40;1668;5090;1678;5130
160015;201803;2149;7233;1985;7006;104;346;1789;6401;1893;6747
160020;201803;1902;6771;1720;6500;242;947;1276;4863;1518;5810
160021;201803;1105;4447;1035;4345;88;475;831;3450;919;3925
160023;201803;1177;4415;1075;4256;86;303;834;3475;920;3778
160025;201803;1612;4699;1581;4663;30;80;1527;4524;1557;4604
160027;201803;8413;23726;7689;22916;651;1757;6358;19543;7009;21300
160030;201803;53498;168989;45470;158018;10856;36310;23585;90002;34441;126312
160040;201803;5005;17934;4553;17315;111;627;4193;15864;4304;16491
160050;201803;3668;12606;3130;11817;1464;5245;993;4526;2457;9771
160053;201803;3221;11306;3056;11094;507;1739;2195;8234;2702;9973
160055;201803;600;2293;592;2283;26;115;546;2095;572;2210
160060;201803;20265;59473;17302;56098;1282;4147;14033;46536;15315;50683
160070;201803;2941;11211;2689;10798;196;857;2148;8785;2344;9642
160080;201803;2650;9621;2505;9444;78;365;2280;8633;2358;8998
170025;201803;595;1706;463;1521;120;378;216;739;336;1117
170030;201803;1144;3688;938;3279;166;624;473;1697;639;2321
170035;201803;1429;3867;1098;3325;115;375;618;1897;733;2272
170040;201803;1775;5374;1490;4998;136;514;829;2936;965;3450
170070;201803;1612;4067;1154;3471;140;448;674;2068;814;2516
170100;201803;2369;6928;1980;6299;184;600;1377;4425;1561;5025
170105;201803;717;2211;518;1781;129;427;186;655;315;1082
170110;201803;876;2840;704;2503;134;502;325;1185;459;1687
170130;201803;1326;4135;989;3471;193;706;474;1732;667;2438
170190;201803;1431;4172;1010;3483;341;1118;228;1016;569;2134
170200;201803;1665;4341;1004;3136;264;896;199;582;463;1478
170210;201803;26390;74150;20316;64133;6909;23748;2521;8959;9430;32707
170215;201803;1295;3718;1080;3408;73;290;789;2473;862;2763
170220;201803;5640;18294;4930;16944;1247;4191;2394;8703;3641;12894
170230;201803;1235;3880;963;3321;257;913;265;939;522;1852
170240;201803;2630;7680;2078;6779;182;752;1404;4490;1586;5242
170255;201803;3867;11710;2710;9449;646;2342;1078;3848;1724;6190
170270;201803;1038;2526;675;2022;30;87;450;1331;480;1418
170290;201803;2923;8414;2504;7930;155;393;2065;6843;2220;7236
170300;201803;1891;5517;1546;4971;182;590;993;3252;1175;3842
170305;201803;736;2171;572;1839;85;317;280;873;365;1190
170307;201803;943;3349;772;2994;144;554;390;1573;534;2127
170310;201803;1411;3913;1050;3293;200;701;509;1567;709;2268
170320;201803;1002;2774;749;2367;110;356;403;1298;513;1654
170330;201803;812;2630;735;2514;44;186;568;1895;612;2081
170360;201803;459;1348;350;1161;56;216;203;633;259;849
170370;201803;1302;3597;980;3057;156;492;481;1528;637;2020
170380;201803;1757;5425;1348;4758;153;616;768;2753;921;3369
170382;201803;552;1715;456;1543;75;269;272;914;347;1183
170384;201803;1482;5741;1268;5311;355;1552;501;2114;856;3666
170386;201803;750;2129;479;1585;82;311;106;314;188;625
170388;201803;572;1701;416;1422;56;211;194;656;250;867
170389;201803;1167;4130;1017;3862;49;210;810;3124;859;3334
170390;201803;1481;3796;1123;3343;81;264;881;2661;962;2925
170410;201803;535;1658;403;1429;22;102;264;926;286;1028
170460;201803;389;1082;304;934;34;113;186;575;220;688
170510;201803;837;2639;632;2228;82;343;328;1126;410;1469
170550;201803;6440;17714;4543;14464;1310;4517;750;2519;2060;7036
170555;201803;1327;3783;1053;3344;90;306;565;1848;655;2154
170560;201803;1111;3257;832;2871;112;423;442;1709;554;2132
170600;201803;1355;3830;1108;3462;271;752;600;2011;871;2763
170610;201803;1676;4789;1260;4078;103;409;801;2520;904;2929
170625;201803;410;1163;258;834;35;107;83;252;118;359
170650;201803;1217;3769;933;3249;210;759;368;1364;578;2123
170700;201803;3449;10428;2678;9047;590;2181;1091;3778;1681;5959
170710;201803;1545;4385;1220;3801;237;810;590;1761;827;2571
170720;201803;1849;4809;1544;4369;65;140;1329;3862;1394;4002
170730;201803;972;2853;749;2482;186;639;331;1134;517;1773
170740;201803;1975;7085;1698;6534;219;873;1109;4299;1328;5172
170755;201803;847;2526;618;2072;74;287;296;985;370;1272
170765;201803;1228;3281;850;2695;215;706;330;1123;545;1829
170770;201803;1695;5437;1479;5063;202;689;963;3347;1165;4036
170820;201803;3802;13260;3338;12397;469;1709;1993;7839;2462;9548
170825;201803;975;2364;788;2113;63;161;554;1506;617;1667
170830;201803;1369;3870;1123;3477;39;116;912;2856;951;2972
170900;201803;2476;8530;2230;8141;181;745;1794;6567;1975;7312
170930;201803;3594;10296;2912;9116;669;2239;1268;4064;1937;6303
170950;201803;11439;32889;8056;26789;2344;8757;1159;4012;3503;12769
170980;201803;434;1258;350;1112;30;127;218;653;248;780
171050;201803;1549;5038;1379;4732;68;320;1075;3641;1143;3961
171070;201803;1354;4115;1176;3848;255;744;687;2468;942;3212
171090;201803;1064;2714;881;2455;65;166;640;1782;705;1948
171110;201803;565;1634;416;1366;109;398;161;462;270;860
171150;201803;1048;2744;646;2028;67;243;402;1258;469;1501
171180;201803;714;2087;471;1583;88;312;194;671;282;983
171190;201803;1536;5610;1360;5280;236;916;764;3099;1000;4015
171195;201803;836;2829;697;2561;156;598;367;1377;523;1975
171200;201803;546;1633;418;1399;100;365;159;511;259;876
171215;201803;418;1200;314;1004;63;216;145;454;208;670
171240;201803;719;2551;613;2334;53;272;389;1479;442;1751
171245;201803;597;1938;469;1658;78;299;223;763;301;1062
171250;201803;970;2730;737;2338;215;689;313;1008;528;1697
171270;201803;380;1497;327;1367;89;356;144;668;233;1024
171280;201803;838;2629;663;2310;147;488;294;1128;441;1616
171320;201803;3853;11189;3032;9721;598;1912;1344;4573;1942;6485
171330;201803;2646;7527;2050;6477;460;1477;990;3231;1450;4708
171360;201803;1418;4392;1206;4096;86;336;944;3228;1030;3564
171370;201803;676;1798;532;1599;52;164;375;1140;427;1304
171380;201803;1337;3987;1079;3561;172;613;602;2007;774;2620
171395;201803;915;2698;648;2160;96;376;317;1028;413;1404
171420;201803;1774;5574;1328;4657;219;860;596;2092;815;2952
171430;201803;1019;3079;837;2730;100;355;554;1748;654;2103
171488;201803;2412;7299;1955;6557;343;1194;1049;3636;1392;4830
171500;201803;906;2482;705;2167;56;174;505;1571;561;1745
171510;201803;776;2716;696;2567;49;224;484;1800;533;2024
171515;201803;469;1324;347;1111;29;108;207;646;236;754
171525;201803;602;1886;503;1707;36;160;316;1012;352;1172
171550;201803;318;1000;228;841;40;166;115;415;155;581
171570;201803;1171;3655;1002;3336;193;628;597;2071;790;2699
171575;201803;1859;5043;1209;3854;195;664;516;1620;711;2284
171610;201803;5442;15900;4123;13620;1002;3607;1119;3890;2121;7497
171620;201803;2778;7849;2337;7240;138;516;1881;5873;2019;6389
171630;201803;940;2720;774;2483;159;548;461;1504;620;2052
171650;201803;1982;5944;1469;4964;343;1193;504;1791;847;2984
171660;201803;2338;6238;1634;4969;273;817;841;2564;1114;3381
171665;201803;1305;3813;1014;3349;185;669;478;1611;663;2280
171670;201803;1801;4945;1400;4297;227;782;745;2236;972;3018
171700;201803;1158;3507;881;3011;133;453;470;1628;603;2081
171720;201803;760;2134;612;1874;67;237;436;1317;503;1554
171750;201803;1193;3536;859;2910;234;815;181;686;415;1501
171780;201803;1266;3310;915;2803;72;252;614;1862;686;2114
171790;201803;1429;4970;1152;4349;279;1055;497;1971;776;3026
171800;201803;721;2117;564;1870;67;243;333;1115;400;1358
171820;201803;10099;29818;7829;25852;1860;6547;2718;9468;4578;16015
171830;201803;1433;5069;1229;4649;199;828;702;2658;901;3486
171840;201803;679;1859;551;1658;30;100;413;1222;443;1322
171845;201803;623;1690;485;1485;74;263;269;843;343;1106
171850;201803;839;2985;725;2746;71;312;495;1851;566;2163
171855;201803;1071;3347;943;3119;84;270;612;2019;696;2289
171865;201803;385;1286;329;1191;60;237;163;568;223;805
171870;201803;753;2194;554;1809;85;304;282;961;367;1265
171875;201803;1201;3705;965;3310;63;259;716;2428;779;2687
171880;201803;1000;3316;906;3199;54;177;743;2706;797;2883
171884;201803;898;2414;651;2037;127;455;208;724;335;1179
171886;201803;1370;4069;990;3375;296;1078;179;626;475;1704
171888;201803;761;2214;526;1755;50;173;324;1075;374;1248
171889;201803;464;1460;400;1333;72;268;179;605;251;873
171890;201803;1129;3226;875;2824;154;500;520;1699;674;2199
171900;201803;494;1787;374;1496;91;367;136;579;227;946
172000;201803;571;1803;472;1609;69;279;246;801;315;1080
172010;201803;1034;3697;912;3444;85;407;584;2130;669;2537
172015;201803;324;1244;262;1113;51;206;121;528;172;734
172020;201803;2261;7350;2080;7067;181;736;1553;5260;1734;5996
172025;201803;720;2072;525;1752;56;227;313;1047;369;1274
172030;201803;1198;3641;1040;3381;23;98;853;2768;876;2866
172049;201803;1361;3358;884;2621;308;955;393;1175;701;2130
172065;201803;1391;3624;1123;3298;63;150;1005;3012;1068;3162
172080;201803;2330;7147;1905;6349;134;485;1310;4390;1444;4875
172085;201803;465;1327;310;1004;56;160;100;320;156;480
172090;201803;3982;10543;3127;9332;137;500;2499;7405;2636;7905
172093;201803;502;1518;374;1275;56;232;191;619;247;851
172097;201803;619;1743;456;1480;78;266;190;635;268;901
172100;201803;40498;107233;28193;86940;6544;22018;7999;25896;14543;47914
172110;201803;1571;5977;1372;5655;142;618;1027;4378;1169;4996
172120;201803;4853;15072;3852;13408;684;2405;1987;7158;2671;9563
172125;201803;286;841;212;716;24;83;119;410;143;493
172130;201803;699;2088;564;1866;25;90;411;1378;436;1468
172208;201803;2321;6219;1869;5572;265;774;1141;3474;1406;4248
172210;201803;2645;7405;2071;6611;439;1462;1114;3578;1553;5040
210005;201803;19510;59283;15961;53612;4685;16333;6265;22101;10950;38434
210010;201803;1715;5767;1564;5514;47;205;1369;4848;1416;5053
210015;201803;3299;10185;2947;9677;141;373;2512;8443;2653;8816
210020;201803;7350;16889;6588;16029;96;256;6143;14921;6239;15177
210030;201803;4821;16252;4576;15908;218;1066;3960;13617;4178;14683
210040;201803;2099;6043;1895;5812;33;65;1764;5504;1797;5569
210043;201803;6673;17980;5505;16648;701;1982;3921;12549;4622;14531
210047;201803;6321;21805;5687;20905;259;1262;4921;17978;5180;19240
210050;201803;2142;7662;1727;6866;259;1121;1064;4284;1323;5405
210055;201803;1754;5969;1621;5742;67;275;1324;4680;1391;4955
210060;201803;6594;25845;6048;24766;820;3436;4211;17659;5031;21095
210070;201803;7116;20713;6706;20225;41;125;6446;19593;6487;19718
210080;201803;3690;13125;3608;13025;17;78;3513;12725;3530;12803
210083;201803;4876;15767;4299;15142;72;397;4062;14249;4134;14646
210087;201803;2791;8174;2537;7824;159;457;2108;6644;2267;7101
210090;201803;9542;29905;9108;29200;281;1032;8298;26476;8579;27508
210095;201803;5921;20494;5546;20018;260;1102;4854;17624;5114;18726
210100;201803;6795;20593;6284;19861;235;903;5364;16940;5599;17843
210110;201803;2696;8962;2553;8769;35;162;2392;8214;2427;8376
210120;201803;23595;66591;20223;62363;2666;7001;13660;44966;16326;51967
210125;201803;3858;11500;3589;11163;642;1577;2694;8893;3336;10470
210130;201803;4087;11522;3567;10862;163;486;3038;9267;3201;9753
210135;201803;1459;4536;1311;4303;55;226;1088;3564;1143;3790
210140;201803;16758;50163;13750;46046;2953;9961;7494;26024;10447;35985
210150;201803;4463;11104;4007;10502;67;250;3624;9351;3691;9601
210160;201803;15955;49518;14657;47620;1281;4184;11111;36973;12392;41157
210170;201803;13860;46799;13224;45984;596;2195;11874;41475;12470;43670
210173;201803;2423;9258;2297;9059;47;289;2132;8403;2179;8692
210177;201803;3021;9116;2850;8910;61;151;2709;8561;2770;8712
210180;201803;1444;4137;1321;3972;32;115;1179;3529;1211;3644
210190;201803;4670;14436;4263;13684;108;561;3517;11039;3625;11600
210193;201803;1180;3733;1080;3579;41;163;897;2985;938;3148
210197;201803;1937;6550;1791;6363;197;655;1374;5042;1571;5697
210200;201803;7361;24782;6856;24035;643;2284;5510;19631;6153;21915
210203;201803;6905;21297;6387;20604;469;1472;5427;17758;5896;19230
210207;201803;3377;10229;3035;9755;164;441;2477;8197;2641;8638
210210;201803;8101;27221;7684;26643;94;529;7158;24780;7252;25309
210215;201803;1966;6740;1805;6516;61;308;1606;5768;1667;6076
210220;201803;5800;21204;5513;20703;246;1306;4776;17699;5022;19005
210230;201803;4979;15750;4602;15202;220;625;4079;13643;4299;14268
210232;201803;11453;37151;9553;34501;1381;5145;6286;24057;7667;29202
210235;201803;3541;10809;3129;10283;117;503;2754;9053;2871;9556
210237;201803;2352;8677;2195;8483;21;111;2097;8129;2118;8240
210240;201803;2665;8562;2475;8239;92;374;2142;7082;2234;7456
210250;201803;5310;16778;4899;16269;106;560;4385;14501;4491;15061
210255;201803;2604;8159;2287;7589;294;1022;1569;5176;1863;6198
210260;201803;5117;16237;4619;15473;283;1015;3838;12903;4121;13918
210270;201803;4884;14059;4426;13433;92;456;3943;11850;4035;12306
210275;201803;3477;9098;3194;8766;61;116;3020;8409;3081;8525
210280;201803;5477;16360;4579;14995;246;1205;3348;10680;3594;11885
210290;201803;6265;19016;5805;18446;144;530;5217;16606;5361;17136
210300;201803;34560;94679;28743;87320;1868;5797;21633;68568;23501;74365
210310;201803;2950;7887;2682;7529;61;132;2421;6844;2482;6976
210312;201803;2411;6949;2163;6650;61;230;1959;6016;2020;6246
210315;201803;2773;8203;2386;7733;64;180;2124;7065;2188;7245
210317;201803;3864;12475;3616;12187;119;507;3336;11211;3455;11718
210320;201803;18683;60540;17517;59009;525;2429;15782;53038;16307;55467
210325;201803;3444;10390;3064;9838;90;340;2717;8816;2807;9156
210330;201803;27688;77039;22874;71065;5568;16426;11662;41527;17230;57953
210340;201803;10403;31786;9429;30360;1013;3103;6848;23021;7861;26124
210350;201803;9266;27842;8336;26600;266;915;7178;23059;7444;23974
210355;201803;3938;14084;3514;13416;132;730;2937;11279;3069;12009
210360;201803;14512;43610;13112;41637;649;2535;10832;34183;11481;36718
210370;201803;9698;22798;7773;20752;261;568;6949;19005;7210;19573
210375;201803;3029;8785;2396;7925;649;2146;1139;4016;1788;6162
210380;201803;5421;14785;4910;14130;265;694;4241;12360;4506;13054
210390;201803;2652;9810;2486;9521;139;668;2067;7875;2206;8543
210400;201803;4645;14636;4284;14198;116;307;3951;13283;4067;13590
210405;201803;7191;20048;5846;18093;1174;3532;3152;10320;4326;13852
210407;201803;1925;6722;1624;6142;143;646;1239;4603;1382;5249
210408;201803;2324;9124;2205;8959;145;747;1810;7439;1955;8186
210409;201803;3632;12946;3354;12550;112;641;2877;10738;2989;11379
210410;201803;3490;11123;3104;10518;224;746;2414;8331;2638;9077
210420;201803;3938;12947;3629;12391;171;578;3073;10578;3244;11156
210430;201803;2172;6501;2058;6366;119;323;1802;5649;1921;5972
210440;201803;4045;11710;3816;11419;73;236;3607;10817;3680;11053
210450;201803;2496;7980;2254;7579;125;470;1816;6068;1941;6538
210455;201803;3748;10354;3134;9615;680;2018;1993;6342;2673;8360
210460;201803;3288;10434;2994;10007;116;479;2555;8515;2671;8994
210462;201803;1414;4876;1273;4614;57;275;1025;3669;1082;3944
210465;201803;2565;7924;2276;7519;89;278;1978;6627;2067;6905
210467;201803;5847;19518;5403;18986;273;1131;4750;16756;5023;17887
210470;201803;2110;5569;1460;4621;80;198;1105;3607;1185;3805
210480;201803;14746;46118;12708;43527;1536;5073;9125;33106;10661;38179
210490;201803;3709;9802;3085;8909;77;261;2697;7782;2774;8043
210500;201803;6043;24868;5715;24248;404;2053;4590;19350;4994;21403
210510;201803;5953;20792;5566;20320;141;630;5008;18506;5149;19136
210515;201803;3513;10762;3184;10415;122;375;2888;9606;3010;9981
210520;201803;2557;7519;2287;7167;101;354;2016;6341;2117;6695
210530;201803;48559;129665;40272;117040;6660;24221;11697;41261;18357;65482
210535;201803;3082;10664;2945;10475;83;311;2615;9392;2698;9703
210540;201803;13414;42505;11714;40261;1427;4860;8389;29892;9816;34752
210542;201803;5807;15336;5029;14478;241;493;4529;13390;4770;13883
210545;201803;2289;7217;2146;6994;46;211;1909;6144;1955;6355
210547;201803;3511;12705;3219;12150;343;1227;2325;9089;2668;10316
210550;201803;5765;17639;4997;16705;301;1039;4198;14289;4499;15328
210560;201803;3565;11177;3235;10611;105;389;2800;9112;2905;9501
210565;201803;1404;5028;1202;4708;39;213;991;3942;1030;4155
210570;201803;10988;30628;10026;29485;314;784;9159;27263;9473;28047
210580;201803;2892;8268;2564;7861;227;433;2061;6670;2288;7103
210590;201803;4012;12586;3617;12066;133;668;3176;10480;3309;11148
210592;201803;2501;7682;2361;7452;29;165;2090;6512;2119;6677
210594;201803;2716;7498;2131;6582;92;241;1570;5035;1662;5276
210596;201803;2394;8882;2237;8556;168;717;1744;6719;1912;7436
210598;201803;1748;5252;1636;5102;36;152;1516;4712;1552;4864
210600;201803;2913;8254;2482;7677;80;237;2031;6321;2111;6558
210610;201803;2419;7616;2201;7341;82;392;1955;6426;2037;6818
210620;201803;2220;6886;1964;6573;44;127;1801;6154;1845;6281
210630;201803;3089;10790;2811;10384;167;808;2286;8320;2453;9128
210632;201803;4189;14242;3812;13671;347;1409;2967;10610;3314;12019
210635;201803;1832;6467;1725;6283;141;458;1427;5352;1568;5810
210637;201803;2433;8401;2200;8044;137;643;1703;6251;1840;6894
210640;201803;4848;19134;4777;19060;34;135;4687;18764;4721;18899
210650;201803;6987;20593;6637;20130;81;293;6325;19154;6406;19447
210660;201803;8565;24994;7674;23682;325;1180;6611;20253;6936;21433
210663;201803;2498;7723;2383;7591;103;305;2114;6892;2217;7197
210667;201803;1870;6240;1757;6065;64;262;1571;5465;1635;5727
210670;201803;4423;15687;4157;15263;152;730;3641;13312;3793;14042
210675;201803;4952;13794;4403;13071;307;752;3682;11290;3989;12042
210680;201803;3960;10427;3362;9700;139;307;2957;8722;3096;9029
210690;201803;7343;24430;6763;23811;245;1020;6000;21495;6245;22515
210700;201803;2735;7668;2324;7160;169;415;1839;6162;2008;6577
210710;201803;4766;15530;4369;14962;148;685;3831;13045;3979;13730
210720;201803;2713;9304;2554;9099;58;319;2339;8260;2397;8579
210725;201803;1234;4428;1105;4204;37;152;815;3225;852;3377
210730;201803;1192;3351;1025;3118;74;225;813;2483;887;2708
210735;201803;4423;13901;3897;13116;311;1124;3223;10942;3534;12066
210740;201803;5169;14547;4679;14045;146;607;4169;12388;4315;12995
210745;201803;4367;12404;4141;12120;148;360;3735;11034;3883;11394
210750;201803;19434;51381;16896;48435;1542;4417;12793;37511;14335;41928
210760;201803;5476;15979;5040;15510;24;85;4887;15089;4911;15174
210770;201803;5750;15739;4981;14863;56;242;4587;13714;4643;13956
210780;201803;7047;23706;6428;22648;637;2109;4881;17618;5518;19727
210790;201803;4546;14584;4240;14192;123;373;3497;12340;3620;12713
210800;201803;4829;13305;4234;12558;69;282;3860;11343;3929;11625
210805;201803;3777;14617;3651;14421;112;630;3270;12861;3382;13491
210810;201803;4964;15044;4567;14534;215;465;4038;13218;4253;13683
210820;201803;7010;20463;6084;18962;709;2199;4050;12829;4759;15028
210825;201803;6145;19981;5804;19545;280;903;5093;17456;5373;18359
210830;201803;7600;22143;7210;21647;470;1023;6258;19455;6728;20478
210840;201803;3341;9048;3025;8612;81;268;2646;7466;2727;7734
210845;201803;5904;17028;5659;16768;30;66;5595;16623;5625;16689
210850;201803;5651;19927;5079;19009;379;1704;3899;14561;4278;16265
210860;201803;17537;50357;15284;47316;878;2601;12485;39488;13363;42089
210870;201803;5923;18602;5195;17732;304;1081;4407;15185;4711;16266
210880;201803;4202;13494;3902;13135;229;915;3291;11049;3520;11964
210890;201803;4352;13296;3990;12861;241;598;3378;11354;3619;11952
210900;201803;4665;13832;3583;11888;1337;4738;698;2580;2035;7318
210905;201803;1852;5499;1602;5149;48;124;1415;4630;1463;4754
210910;201803;7357;23342;6404;21732;827;2936;4265;14513;5092;17449
210920;201803;3007;10432;2675;9980;98;524;2331;8648;2429;9172
210923;201803;1376;4528;1250;4322;79;325;952;3283;1031;3608
210927;201803;4941;15865;4475;15368;117;442;4102;14243;4219;14685
210930;201803;2397;8554;2219;8261;111;575;1796;6583;1907;7158
210940;201803;3442;11184;3259;10926;123;587;2864;9413;2987;10000
210945;201803;5824;17805;5508;17429;241;686;4908;15697;5149;16383
210950;201803;5021;15051;3993;13490;537;1648;2721;9609;3258;11257
210955;201803;1685;5421;1493;5117;147;488;1059;3707;1206;4195
210960;201803;8669;27242;7828;26024;1576;4838;4806;17099;6382;21937
210970;201803;1280;4263;1086;3922;82;388;801;2777;883;3165
210975;201803;1650;5508;1541;5304;129;481;1154;3953;1283;4434
210980;201803;10484;23746;9406;22648;172;356;8956;21736;9128;22092
210990;201803;15601;46941;12879;43261;1630;5633;8560;29377;10190;35010
211000;201803;14161;44121;12420;42149;607;2565;10333;35760;10940;38325
211003;201803;4963;16836;4350;16082;157;741;3722;13960;3879;14701
211010;201803;6330;23480;5894;22880;79;483;5428;21218;5507;21701
211020;201803;7814;24791;7360;24183;378;1419;6299;20766;6677;22185
211023;201803;2066;6928;1959;6773;113;446;1632;5588;1745;6034
211027;201803;2608;9425;2555;9335;199;797;2172;7919;2371;8716
211030;201803;3730;10960;3416;10593;271;617;2873;9201;3144;9818
211040;201803;4360;16244;4174;15967;138;784;3705;14103;3843;14887
211050;201803;9580;24616;8843;23715;194;507;8224;22083;8418;22590
211060;201803;5865;20051;5529;19541;216;910;4974;17559;5190;18469
211065;201803;2057;6174;1798;5811;55;170;1594;5226;1649;5396
211070;201803;7538;25509;6776;24284;469;1737;5398;19552;5867;21289
211080;201803;1296;3735;1083;3411;44;241;845;2504;889;2745
211085;201803;1944;6147;1755;5871;113;357;1468;4968;1581;5325
211090;201803;3251;9204;2953;8807;50;250;2660;7827;2710;8077
211100;201803;6305;16828;6038;16470;46;161;5672;15454;5718;15615
211102;201803;2824;10598;2627;10320;166;767;2261;8894;2427;9661
211105;201803;2292;7617;1956;6990;230;852;1333;4747;1563;5599
211107;201803;4336;13954;3884;13310;180;652;3196;11231;3376;11883
211110;201803;5826;16801;4616;14976;591;1756;3207;10805;3798;12561
211120;201803;34061;96239;31540;93215;4235;11568;23420;71403;27655;82971
211125;201803;1906;6012;1676;5630;70;293;1433;4808;1503;5101
211130;201803;178911;462008;167154;447118;24253;66223;77390;232286;101643;298509
211140;201803;4904;15509;4495;14923;224;747;3825;12730;4049;13477
211150;201803;9138;26264;8146;25031;256;996;7071;21703;7327;22699
211153;201803;2564;7892;2194;7428;413;1478;1432;5030;1845;6508
211157;201803;1085;3538;920;3272;48;269;646;2301;694;2570
211160;201803;3864;12186;3220;11110;200;924;2334;7813;2534;8737
211163;201803;1661;5610;1569;5481;13;44;1492;5273;1505;5317
211167;201803;1495;4897;1412;4762;31;147;1323;4432;1354;4579
211170;201803;5884;15416;5607;15083;62;224;5347;14319;5409;14543
211172;201803;2405;6896;2132;6459;77;281;1783;5244;1860;5525
211174;201803;2700;8230;2505;7970;73;360;2254;7091;2327;7451
211176;201803;3967;12346;3312;11414;254;1041;2512;8650;2766;9691
211178;201803;4488;10730;3982;10145;32;132;3765;9486;3797;9618
211180;201803;3991;13759;3744;13390;234;917;3179;11438;3413;12355
211190;201803;2982;9228;2626;8691;50;257;2282;7473;2332;7730
211195;201803;1360;4033;1158;3760;75;207;959;3210;1034;3417
211200;201803;1976;6198;1682;5803;185;658;1131;4010;1316;4668
211210;201803;6465;19951;6001;19309;276;1001;5210;16813;5486;17814
211220;201803;33418;91942;28889;86243;3475;10409;20409;62627;23884;73036
211223;201803;4840;14444;4350;13681;479;1388;3187;10265;3666;11653
211227;201803;1627;5767;1512;5589;46;236;1304;4839;1350;5075
211230;201803;7121;22762;6513;21741;539;1825;5096;17066;5635;18891
211240;201803;7897;26542;7536;26077;173;949;6881;23505;7054;24454
211245;201803;5864;16548;5636;16318;46;86;5549;16131;5595;16217
211250;201803;13489;40473;12490;39277;508;1910;10977;34374;11485;36284
211260;201803;7429;24676;6868;23929;207;909;6225;21768;6432;22677
211270;201803;10081;33500;8921;32002;393;1901;7347;26579;7740;28480
211280;201803;13223;38053;11915;36379;783;1916;9774;30965;10557;32881
211285;201803;1627;5916;1441;5572;243;983;706;2844;949;3827
211290;201803;6898;22299;6487;21727;216;858;5605;18785;5821;19643
211300;201803;8181;23771;7490;22861;64;182;7107;21813;7171;21995
211400;201803;11070;33956;9335;31348;1696;5708;5458;19680;7154;25388
220005;201803;1814;5030;1630;4748;35;148;1335;3786;1370;3934
220010;201803;1454;4204;1241;3841;25;117;988;2992;1013;3109
220020;201803;3165;9777;2894;9311;364;1229;2071;6610;2435;7839
220025;201803;2205;5245;1931;4844;34;95;1598;3915;1632;4010
220027;201803;1241;3327;1082;3111;34;115;874;2495;908;2610
220030;201803;3249;8973;3102;8744;105;314;2709;7534;2814;7848
220040;201803;6882;21100;6232;19890;1161;3629;3914;12671;5075;16300
220045;201803;1368;4413;1198;4093;40;195;947;3176;987;3371
220050;201803;4383;12866;3745;11883;139;596;3211;10089;3350;10685
220060;201803;2214;5117;1864;4709;34;78;1705;4305;1739;4383
220070;201803;2440;6639;2146;6190;85;230;1746;4999;1831;5229
220080;201803;655;1967;596;1871;27;111;501;1510;528;1621
220090;201803;1713;4285;1411;3865;14;49;1237;3378;1251;3427
220095;201803;657;1756;625;1711;7;18;582;1589;589;1607
220100;201803;1324;3838;1087;3405;50;198;866;2646;916;2844
220105;201803;2037;6457;1787;5945;135;458;1320;4410;1455;4868
220110;201803;3362;9538;3155;9176;57;251;2777;7940;2834;8191
220115;201803;2607;8234;2439;7967;81;351;2168;6966;2249;7317
220117;201803;1328;3371;1039;2934;19;69;884;2459;903;2528
220120;201803;11247;33388;10387;32309;120;515;9747;30286;9867;30801
220130;201803;985;2938;847;2727;17;115;755;2379;772;2494
220140;201803;1656;4159;1414;3856;163;418;1154;3171;1317;3589
220150;201803;6496;19643;6105;19065;143;736;5301;16226;5444;16962
220155;201803;1081;3222;859;2811;23;92;603;1950;626;2042
220157;201803;1047;2662;885;2387;18;79;721;1879;739;1958
220160;201803;2586;7649;2255;7019;47;250;1856;5641;1903;5891
220170;201803;1355;3845;1155;3525;19;97;1007;3012;1026;3109
220173;201803;1957;5758;1593;5071;42;210;1294;3980;1336;4190
220177;201803;1802;5399;1757;5342;13;51;1706;5193;1719;5244
220180;201803;1145;2954;896;2486;11;43;657;1729;668;1772
220190;201803;5427;15688;4762;14788;420;1362;3592;11232;4012;12594
220191;201803;1366;4465;1277;4303;83;345;917;3008;1000;3353
220192;201803;1803;5051;1446;4410;34;143;1143;3408;1177;3551
220194;201803;1688;5008;1514;4721;68;266;1253;3820;1321;4086
220196;201803;1961;5465;1785;5162;51;205;1512;4281;1563;4486
220198;201803;1210;3564;1009;3284;6;15;956;3161;962;3176
220200;201803;4571;14465;4174;13943;294;1048;3373;11282;3667;12330
220202;201803;2144;6208;1848;5683;31;150;1560;4703;1591;4853
220205;201803;2524;7045;2246;6612;45;185;1950;5641;1995;5826
220207;201803;817;2499;694;2278;59;225;467;1516;526;1741
220208;201803;1701;5396;1397;4771;310;1172;615;2084;925;3256
220209;201803;1601;4681;1374;4287;30;136;1114;3449;1144;3585
220210;201803;1581;4212;1359;3831;27;121;1104;3006;1131;3127
220211;201803;1492;4124;1407;4004;20;80;1245;3547;1265;3627
220213;201803;1673;4664;1488;4294;27;106;1227;3453;1254;3559
220217;201803;1940;6152;1854;6043;41;172;1725;5651;1766;5823
220220;201803;10071;27276;8592;24968;516;1400;6347;18765;6863;20165
220225;201803;1123;3062;928;2804;14;55;808;2409;822;2464
220230;201803;5615;14390;4906;13439;176;491;4255;11677;4431;12168
220240;201803;2848;8615;2621;8191;84;313;2166;6747;2250;7060
220245;201803;1547;3986;1249;3596;11;43;1111;3260;1122;3303
220250;201803;2685;8129;2393;7733;42;185;2118;6830;2160;7015
220253;201803;1645;4623;1383;4157;108;324;1099;3250;1207;3574
220255;201803;1830;4689;1548;4253;25;139;1290;3383;1315;3522
220260;201803;4306;13636;3780;12707;198;723;2947;9913;3145;10636
220265;201803;1219;4139;1111;3970;64;289;848;2985;912;3274
220270;201803;6466;20806;6100;20151;349;1450;5010;16076;5359;17526
220271;201803;1449;3907;1254;3610;44;152;1067;3066;1111;3218
220272;201803;1687;4947;1501;4607;33;117;1170;3521;1203;3638
220273;201803;1164;3404;997;3083;33;123;777;2385;810;2508
220275;201803;2180;5387;1682;4726;38;136;1448;4044;1486;4180
220277;201803;2061;5545;1795;5125;31;113;1502;4203;1533;4316
220280;201803;1528;3972;1297;3598;48;164;1056;2823;1104;2987
220285;201803;1492;3939;1255;3632;18;80;1121;3210;1139;3290
220290;201803;5733;18050;4754;16635;387;1546;3420;11958;3807;13504
220300;201803;1827;5801;1559;5394;43;261;1288;4361;1331;4622
220310;201803;2642;7990;2211;7490;47;259;1896;6308;1943;6567
220320;201803;2811;8524;2302;7540;136;534;1746;5627;1882;6161
220323;201803;1576;5135;1274;4650;90;380;1000;3625;1090;4005
220325;201803;1224;3724;1038;3371;43;180;834;2681;877;2861
220327;201803;1357;4156;1215;3909;43;212;1018;3181;1061;3393
220330;201803;3811;10162;3269;9422;150;449;2677;7685;2827;8134
220335;201803;1722;5302;1546;5099;24;68;1431;4751;1455;4819
220340;201803;1785;4861;1448;4296;54;196;1024;2927;1078;3123
220342;201803;1128;3525;1022;3360;34;135;826;2717;860;2852
220345;201803;2979;7086;2435;6334;12;33;2310;5999;2322;6032
220350;201803;3447;9125;2820;8106;148;481;2106;5961;2254;6442
220360;201803;1211;3174;990;2833;26;90;787;2218;813;2308
220370;201803;8920;25566;8092;24419;216;885;7181;21447;7397;22332
220375;201803;1388;4388;1297;4263;8;26;1262;4155;1270;4181
220380;201803;1469;3709;1216;3345;36;122;1043;2821;1079;2943
220385;201803;800;1988;628;1685;9;33;531;1387;540;1420
220390;201803;8377;24425;7112;22189;1801;5573;2980;9832;4781;15405
220400;201803;1496;3726;1158;3191;24;86;899;2393;923;2479
220410;201803;1154;3293;959;2970;58;181;762;2327;820;2508
220415;201803;813;2212;707;2036;25;80;530;1494;555;1574
220420;201803;1980;5663;1620;4964;64;203;1230;3707;1294;3910
220430;201803;2405;6589;2338;6499;81;243;2114;5829;2195;6072
220435;201803;1669;4667;1488;4377;56;193;1159;3347;1215;3540
220440;201803;2431;7818;2144;7350;135;522;1756;5920;1891;6442
220450;201803;2151;6160;1782;5655;229;830;1290;4053;1519;4883
220455;201803;1305;4140;1240;4050;29;137;1098;3552;1127;3689
220460;201803;932;2432;842;2328;44;138;725;1963;769;2101
220465;201803;2299;7402;2065;7037;147;553;1596;5437;1743;5990
220470;201803;3475;10069;3123;9491;107;370;2530;7570;2637;7940
220480;201803;2396;6602;1960;5879;150;382;1429;4251;1579;4633
220490;201803;2295;6151;2103;5917;36;150;1879;5220;1915;5370
220500;201803;2645;7218;2379;6777;52;221;1933;5329;1985;5550
220510;201803;2645;7797;2173;6940;83;266;1676;5380;1759;5646
220515;201803;1699;4139;1517;3893;51;116;1343;3442;1394;3558
220520;201803;4889;13036;4466;12443;84;262;4047;11248;4131;11510
220525;201803;1211;3343;1107;3197;17;61;972;2769;989;2830
220527;201803;1279;3763;1133;3504;30;107;949;2951;979;3058
220530;201803;1190;3371;1071;3191;27;105;983;2876;1010;2981
220535;201803;796;2299;738;2222;50;153;593;1787;643;1940
220540;201803;3313;10578;3138;10283;94;410;2740;8918;2834;9328
220545;201803;1343;4335;1257;4167;82;325;1025;3339;1107;3664
220550;201803;8764;27490;7930;26029;572;2095;5956;19262;6528;21357
220551;201803;1413;4280;1244;3993;50;214;982;3081;1032;3295
220552;201803;1487;4486;1269;4060;32;163;1033;3199;1065;3362
220553;201803;1567;4408;1336;4047;50;149;1040;3233;1090;3382
220554;201803;841;2325;654;2012;39;106;495;1512;534;1618
220555;201803;2005;6588;1869;6351;54;273;1557;5225;1611;5498
220556;201803;1284;3874;1112;3513;47;210;831;2502;878;2712
220557;201803;1528;4761;1314;4319;82;306;946;3045;1028;3351
220558;201803;1190;3416;993;3129;31;152;820;2524;851;2676
220559;201803;1603;4319;1378;3952;15;57;1142;3277;1157;3334
220560;201803;1632;3937;1326;3514;38;95;1168;3077;1206;3172
220570;201803;7005;22015;6449;21121;556;1886;4953;16309;5509;18195
220580;201803;6433;18944;6130;18444;166;582;5446;16235;5612;16817
220585;201803;1920;6365;1737;6012;67;281;1417;4865;1484;5146
220590;201803;1253;3602;1068;3322;100;320;750;2339;850;2659
220595;201803;2385;6739;2231;6542;16;88;2095;6077;2111;6165
220600;201803;1367;3176;1119;2854;80;127;923;2411;1003;2538
220605;201803;1691;4999;1463;4599;39;167;1153;3536;1192;3703
220610;201803;2837;8960;2677;8729;41;188;2457;8003;2498;8191
220620;201803;7614;24519;7128;23843;192;873;6453;21421;6645;22294
220630;201803;366;1121;293;995;39;143;174;607;213;750
220635;201803;1661;5383;1464;4960;77;311;1085;3623;1162;3934
220640;201803;2631;7350;2255;6784;79;298;1875;5562;1954;5860
220650;201803;2020;5880;1749;5393;66;235;1345;4106;1411;4341
220660;201803;2756;8281;2444;7856;92;406;2064;6452;2156;6858
220665;201803;1268;3986;1112;3725;28;157;940;3092;968;3249
220667;201803;1607;5255;1446;4960;70;270;1156;3981;1226;4251
220669;201803;1693;5384;1624;5255;81;367;1354;4288;1435;4655
220670;201803;2021;5641;1730;5291;38;126;1564;4764;1602;4890
220672;201803;2618;7165;2282;6754;101;300;2026;6006;2127;6306
220675;201803;1214;3428;1114;3245;49;136;881;2546;930;2682
220680;201803;2524;7292;2403;7126;108;324;2140;6328;2248;6652
220690;201803;1560;4304;1373;3990;122;313;1021;3012;1143;3325
220695;201803;916;2616;841;2466;22;74;696;2023;718;2097
220700;201803;8446;22635;6926;20444;342;1137;5329;15559;5671;16696
220710;201803;839;2434;653;2064;53;150;458;1441;511;1591
220720;201803;1981;5009;1809;4739;36;119;1564;4064;1600;4183
220730;201803;1282;3731;1089;3414;25;118;896;2747;921;2865
220735;201803;990;2386;759;2008;24;63;640;1674;664;1737
220740;201803;1393;4009;1122;3651;34;130;950;3100;984;3230
220750;201803;3521;9883;3214;9425;163;480;2781;8138;2944;8618
220755;201803;1116;3000;981;2783;32;119;781;2142;813;2261
220760;201803;2905;8843;2570;8380;113;407;2171;7129;2284;7536
220770;201803;19990;64028;17412;59235;6043;21227;5518;19713;11561;40940
220775;201803;1109;3015;1047;2944;20;69;1009;2831;1029;2900
220777;201803;1548;4124;1229;3592;38;103;932;2705;970;2808
220779;201803;1342;3319;1212;3134;25;88;1055;2685;1080;2773
220780;201803;5436;14370;4692;13155;221;769;3808;10398;4029;11167
220785;201803;1386;3191;1261;3013;20;28;1190;2852;1210;2880
220790;201803;9960;29274;9019;27879;300;1309;7596;23086;7896;24395
220793;201803;822;2275;697;2063;28;90;572;1683;600;1773
220795;201803;1394;3768;1262;3601;27;112;1122;3180;1149;3292
220800;201803;15791;40144;13438;36683;815;2304;9526;25555;10341;27859
220810;201803;2905;8409;2538;7741;50;217;2116;6316;2166;6533
220820;201803;5136;13707;4466;12750;415;1092;3352;9634;3767;10726
220830;201803;6898;19306;6311;18423;298;922;5243;15232;5541;16154
220840;201803;12337;38570;10646;35155;2164;6899;5622;19041;7786;25940
220850;201803;2911;9481;2677;9193;77;419;2386;8107;2463;8526
220855;201803;570;1668;493;1536;15;71;404;1236;419;1307
220860;201803;988;2516;856;2311;18;60;768;2059;786;2119
220865;201803;2517;6840;1990;5936;59;228;1556;4509;1615;4737
220870;201803;2464;7670;2087;7154;31;170;1895;6450;1926;6620
220880;201803;4984;12675;4467;12050;67;233;4145;11117;4212;11350
220885;201803;1266;4307;1096;3996;54;286;847;3085;901;3371
220887;201803;1303;3117;1175;2939;7;30;1106;2737;1113;2767
220890;201803;1551;5107;1319;4647;101;358;972;3463;1073;3821
220900;201803;1957;5022;1659;4605;36;93;1439;3969;1475;4062
220910;201803;1475;4323;1262;3995;34;118;1090;3452;1124;3570
220915;201803;980;2685;796;2322;18;72;627;1771;645;1843
220920;201803;1382;4706;1184;4424;83;379;913;3376;996;3755
220930;201803;1539;4575;1364;4304;31;125;1216;3779;1247;3904
220935;201803;1040;3025;840;2601;33;133;561;1621;594;1754
220937;201803;1343;3705;1179;3450;29;110;964;2761;993;2871
220940;201803;1331;4020;1126;3614;39;171;835;2591;874;2762
220945;201803;411;1466;368;1383;23;124;265;975;288;1099
220950;201803;1372;3285;917;2550;19;76;707;1899;726;1975
220955;201803;1499;4085;1314;3763;37;107;1105;3172;1142;3279
220960;201803;871;2230;679;1920;16;61;540;1499;556;1560
220965;201803;1704;4845;1541;4595;28;168;1325;3824;1353;3992
220970;201803;1771;4701;1381;4062;56;153;1099;3239;1155;3392
220975;201803;699;2171;618;2067;22;147;547;1737;569;1884
220980;201803;1191;3450;1072;3255;34;141;886;2643;920;2784
220985;201803;1170;3330;1069;3180;42;179;824;2339;866;2518
220987;201803;1456;4447;1264;4110;64;278;1021;3251;1085;3529
220990;201803;1695;4876;1461;4501;33;174;1177;3523;1210;3697
220995;201803;1180;3530;911;3067;63;256;644;2154;707;2410
220997;201803;2357;6970;2217;6766;51;211;2035;6146;2086;6357
221000;201803;3970;11659;3674;11197;120;579;3086;9169;3206;9748
221005;201803;1409;4045;1277;3800;84;258;1001;2892;1085;3150
221010;201803;1190;2962;984;2710;22;68;858;2329;880;2397
221020;201803;1541;4818;1431;4596;37;177;1063;3347;1100;3524
221030;201803;1544;4278;1345;3984;35;156;1123;3275;1158;3431
221035;201803;1316;3684;1209;3543;23;52;1110;3317;1133;3369
221037;201803;583;1737;510;1603;11;56;360;1077;371;1133
221038;201803;523;1501;413;1293;17;57;292;905;309;962
221039;201803;871;2381;772;2222;21;85;654;1829;675;1914
221040;201803;4164;12887;3791;12226;154;559;3000;9685;3154;10244
221050;201803;3529;10006;3224;9614;53;234;2931;8641;2984;8875
221060;201803;8164;23189;6849;21093;288;965;5269;16472;5557;17437
221062;201803;1193;4056;1042;3761;45;241;805;2847;850;3088
221063;201803;1168;3521;1014;3279;64;238;734;2342;798;2580
221065;201803;2639;6962;2332;6437;32;114;2027;5508;2059;5622
221070;201803;3346;10757;2844;9769;205;781;2024;6952;2229;7733
221080;201803;3437;8579;2778;7584;66;263;2252;6068;2318;6331
221090;201803;1344;3644;1136;3283;18;75;984;2767;1002;2842
221093;201803;1407;4139;1309;3934;139;437;848;2462;987;2899
221095;201803;880;2358;748;2145;5;15;621;1741;626;1756
221097;201803;809;2159;634;1834;20;69;467;1294;487;1363
221100;201803;97302;277716;86512;259090;15065;46146;50183;148510;65248;194656
221110;201803;9830;30223;9126;29298;218;1111;8026;25389;8244;26500
221120;201803;4029;12247;3775;11821;264;902;3098;9631;3362;10533
221130;201803;4713;12893;3639;10708;974;2822;1458;4366;2432;7188
221135;201803;1548;4405;1392;4192;40;156;1213;3609;1253;3765
221140;201803;1292;3157;1131;2933;11;43;1014;2581;1025;2624
221150;201803;1101;2788;881;2403;21;92;688;1779;709;1871
221160;201803;799;2009;715;1894;29;61;576;1523;605;1584
221170;201803;1062;3134;960;2966;20;65;784;2413;804;2478
230010;201803;3126;8506;2534;7458;171;565;1909;5522;2080;6087
230015;201803;2882;9727;2649;9275;258;1064;1788;6132;2046;7196
230020;201803;13029;41877;12516;41038;450;1879;10687;34607;11137;36486
230030;201803;11991;32239;10498;30088;219;771;9222;26316;9441;27087
230040;201803;4092;11168;3527;10205;125;490;2845;8088;2970;8578
230050;201803;2701;8736;1990;6916;431;1450;703;2464;1134;3914
230060;201803;2296;6494;1878;5686;47;191;1510;4472;1557;4663
230070;201803;3875;10882;3248;9607;173;598;2208;6552;2381;7150
230075;201803;8834;29427;8220;28310;383;1923;6698;22501;7081;24424
230080;201803;2550;6014;2028;5264;31;133;1767;4513;1798;4646
230090;201803;3963;10638;3445;9799;187;616;2621;7321;2808;7937
230100;201803;17270;47936;15514;45340;1765;5477;10057;29406;11822;34883
230110;201803;11686;35937;10409;33345;1931;6239;5577;18015;7508;24254
230120;201803;7332;20426;6476;19029;592;1611;4692;14066;5284;15677
230125;201803;2979;8249;2450;7348;92;337;1882;5595;1974;5932
230130;201803;5640;18015;4723;16012;453;1663;3057;10146;3510;11809
230140;201803;3416;10572;2913;9612;136;582;2125;6883;2261;7465
230150;201803;1590;4837;1346;4290;233;723;726;2370;959;3093
230160;201803;6253;17234;5446;16003;185;702;4508;13037;4693;13739
230170;201803;5874;17629;5093;16139;239;882;3760;11668;3999;12550
230180;201803;1567;4527;1344;4064;29;139;1051;3051;1080;3190
230185;201803;3972;12255;3466;11356;320;1200;2481;8109;2801;9309
230190;201803;12745;38718;10972;35259;1652;5489;5819;18747;7471;24236
230195;201803;5068;15267;4511;14302;342;1210;3473;10846;3815;12056
230200;201803;4756;13332;4170;12178;190;557;3275;9387;3465;9944
230205;201803;3931;12520;3551;11836;179;778;2646;8650;2825;9428
230210;201803;9311;24603;7991;22654;486;1553;5888;16573;6374;18126
230220;201803;13195;35394;11786;33094;547;1691;9576;26557;10123;28248
230230;201803;6819;21176;6147;19801;506;1655;4395;14105;4901;15760
230240;201803;12785;34618;11313;32227;450;1332;9152;25860;9602;27192
230250;201803;9010;26724;8882;26511;351;1289;6963;20263;7314;21552
230260;201803;14032;44886;12656;42071;1701;5958;7352;24649;9053;30607
230270;201803;7393;20825;5979;18182;606;1896;3889;11898;4495;13794
230280;201803;19985;56185;16893;50872;752;3108;13058;38026;13810;41134
230290;201803;4572;13368;3961;12082;422;1174;2834;8754;3256;9928
230300;201803;4259;12232;4021;11903;113;477;3514;10172;3627;10649
230310;201803;4744;13795;4067;12614;131;532;2953;8974;3084;9506
230320;201803;7407;21873;6502;20197;327;1289;4970;15157;5297;16446
230330;201803;4659;13181;3854;11603;189;581;2848;8470;3037;9051
230340;201803;3491;11234;3001;10207;262;943;2060;6956;2322;7899
230350;201803;18386;52683;16435;49356;1095;3839;10625;32252;11720;36091
230360;201803;2887;8121;2309;7040;137;493;1593;4771;1730;5264
230365;201803;2989;7699;2548;6982;64;297;2148;5770;2212;6067
230370;201803;51788;154831;44902;143862;9627;31555;21676;72111;31303;103666
230380;201803;6346;18110;5143;15823;179;675;3695;11170;3874;11845
230390;201803;3255;10062;2856;9364;142;610;2149;6889;2291;7499
230393;201803;2890;9190;2460;8299;91;494;1878;6072;1969;6566
230395;201803;5597;15632;4922;14437;494;1374;3308;9877;3802;11251
230400;201803;5493;15979;4908;14973;170;765;3912;11598;4082;12363
230410;201803;14438;44095;11831;38892;1386;4714;7203;23796;8589;28510
230420;201803;24743;74013;21279;67350;3024;10210;11603;36441;14627;46651
230423;201803;4535;13861;3970;12711;142;599;3144;9879;3286;10478
230425;201803;5332;17164;4907;16253;504;1689;3384;11235;3888;12924
230426;201803;2512;6883;1936;5749;44;186;1466;4275;1510;4461
230427;201803;1794;5240;1271;4021;64;214;869;2646;933;2860
230428;201803;9356;26483;8341;24879;1244;3928;4763;14062;6007;17990
230430;201803;4397;13324;3807;12250;212;840;2822;8815;3034;9655
230435;201803;5378;15457;4649;14176;591;1850;2822;8619;3413;10469
230440;201803;379655;1015289;321020;922215;52265;156469;169701;487740;221966;644209
230445;201803;4333;11710;3631;10468;197;525;2555;7271;2752;7796
230450;201803;3458;10528;3040;9784;211;864;2187;6911;2398;7775
230460;201803;1953;5899;1713;5474;85;337;1368;4343;1453;4680
230465;201803;3867;11275;3295;10215;105;469;2416;7242;2521;7711
230470;201803;10989;37933;10068;36136;902;3896;7276;25705;8178;29601
230480;201803;1400;4246;1194;3837;107;418;866;2698;973;3116
230490;201803;2244;6662;1966;6120;212;656;1130;3432;1342;4088
230495;201803;5639;17496;5051;16402;444;1790;3300;10518;3744;12308
230500;201803;8241;28556;7737;27563;352;1573;6072;21574;6424;23147
230510;201803;1619;5311;1206;4326;222;834;485;1732;707;2566
230520;201803;4262;12774;3846;11975;299;1002;2703;8284;3002;9286
230523;201803;14872;45444;12413;40109;2885;9464;3107;10491;5992;19955
230526;201803;3833;11252;3281;10236;144;638;2535;7688;2679;8326
230530;201803;5187;16354;4505;15151;461;1656;3168;10734;3629;12390
230533;201803;3990;10503;3426;9446;144;410;2735;7486;2879;7896
230535;201803;5406;15453;4608;13995;319;995;3156;9730;3475;10725
230540;201803;15982;45481;14377;43027;331;1411;12283;36232;12614;37643
230550;201803;19480;54607;16380;49053;2027;6441;9433;28054;11460;34495
230560;201803;7352;19607;6114;17376;112;448;4989;13987;5101;14435
230565;201803;3139;8681;2590;7700;77;297;1968;5791;2045;6088
230570;201803;3450;9073;3015;8482;73;209;2526;7071;2599;7280
230580;201803;9531;27267;8534;25791;351;1325;7143;21348;7494;22673
230590;201803;8751;26065;7339;23370;561;1994;5104;15806;5665;17800
230600;201803;3737;10003;2821;8218;95;302;1831;5394;1926;5696
230610;201803;6296;18522;5644;17484;457;1453;4257;13187;4714;14640
230620;201803;2064;5736;1591;4758;140;436;957;2793;1097;3229
230625;201803;7858;23900;6893;21951;2038;6743;1816;6016;3854;12759
230630;201803;10107;31462;9017;29205;2383;7223;3874;13525;6257;20748
230640;201803;26263;82326;24049;78692;1677;6318;18821;61014;20498;67332
230650;201803;4839;14047;4224;12864;274;934;3194;9539;3468;10473
230655;201803;9105;32444;8703;31717;611;2543;6852;25071;7463;27614
230660;201803;6239;18662;5143;16556;178;934;4150;13036;4328;13970
230670;201803;5966;15036;4524;12580;186;578;3514;9505;3700;10083
230680;201803;2497;7234;2158;6565;230;704;1428;4333;1658;5037
230690;201803;6310;19635;5787;18500;542;1930;3564;11150;4106;13080
230700;201803;9264;25076;8082;22849;346;1186;6085;16673;6431;17859
230710;201803;6921;22135;6073;20432;505;1842;4408;14688;4913;16530
230720;201803;1838;5678;1536;5015;133;426;999;3221;1132;3647
230725;201803;3471;11370;3057;10357;685;2432;1171;3896;1856;6328
230730;201803;54181;155284;44963;140318;10751;36298;15145;49579;25896;85877
230740;201803;5959;17233;5303;16102;150;596;4250;12756;4400;13352
230750;201803;8111;22655;6892;20585;222;823;5361;15639;5583;16462
230760;201803;11051;30982;9900;29009;748;2512;7154;20453;7902;22965
230763;201803;4324;12689;3731;11563;188;746;2868;8563;3056;9309
230765;201803;38788;113799;33314;104038;7329;24035;12316;38975;19645;63010
230770;201803;25231;66781;21662;61739;2883;8725;13288;37867;16171;46592
230780;201803;5798;21127;5478;20455;928;3460;3164;12257;4092;15717
230790;201803;2883;8660;2628;8229;164;593;2013;6239;2177;6832
230800;201803;7560;25262;6835;23729;888;3403;3912;13421;4800;16824
230810;201803;11491;35610;10464;33897;486;1912;8086;25719;8572;27631
230820;201803;3160;10580;2727;9624;273;1121;1671;5734;1944;6855
230830;201803;7331;21356;6326;19501;202;870;5049;15230;5251;16100
230835;201803;4006;9961;3171;8648;109;356;2564;6835;2673;7191
230837;201803;3114;10090;2668;9208;152;708;1976;6628;2128;7336
230840;201803;8688;26743;7660;24996;524;1889;5867;19123;6391;21012
230850;201803;8979;27244;8022;25385;528;1874;5723;17983;6251;19857
230860;201803;4962;13475;4217;12348;152;524;3547;10283;3699;10807
230870;201803;16855;42877;14569;39301;539;1566;11473;30786;12012;32352
230880;201803;1967;6312;1819;6049;73;382;1400;4499;1473;4881
230890;201803;4272;14476;3958;13863;347;1358;2800;9690;3147;11048
230900;201803;2953;9127;2486;8154;283;943;1526;4931;1809;5874
230910;201803;2996;8519;2445;7547;92;428;1918;5817;2010;6245
230920;201803;4467;12714;4007;12045;143;575;3369;10020;3512;10595
230930;201803;6426;18939;5487;17106;419;1420;3624;11188;4043;12608
230940;201803;7601;20868;6736;19463;213;661;5576;16009;5789;16670
230945;201803;6396;18858;5575;17198;430;1429;3796;11777;4226;13206
230950;201803;6265;16284;5729;15628;130;319;5130;14246;5260;14565
230960;201803;13382;40553;12100;38026;1911;6140;6024;19235;7935;25375
230970;201803;13195;37760;11377;34722;2088;6687;5420;16608;7508;23295
230980;201803;2680;8090;2327;7462;508;1577;1272;4242;1780;5819
230990;201803;1670;4835;1389;4273;78;335;954;2805;1032;3140
231000;201803;2430;6601;2070;5870;83;239;1477;4117;1560;4356
231010;201803;2983;7878;2466;6999;150;502;1894;5261;2044;5763
231020;201803;7894;25778;7226;24300;1270;4077;4216;14693;5486;18770
231025;201803;7156;21152;6424;19883;1007;3187;4061;12664;5068;15851
231030;201803;6815;21391;5574;18682;967;3246;2943;9898;3910;13144
231040;201803;3089;9212;2687;8457;98;406;2066;6361;2164;6767
231050;201803;11681;31503;9528;27648;637;1768;7024;20165;7661;21933
231060;201803;2496;7616;2269;7234;78;343;1775;5617;1853;5960
231070;201803;7944;24040;6868;22011;1048;3424;3866;12473;4914;15897
231080;201803;3888;11675;3516;10997;128;660;2726;8188;2854;8848
231085;201803;5619;15515;4952;14675;337;996;3713;11192;4050;12188
231090;201803;4180;11370;3230;9443;124;462;2268;6453;2392;6915
231095;201803;1996;6259;1705;5596;154;560;1185;3835;1339;4395
231100;201803;2947;9017;2525;8222;194;680;1829;5932;2023;6612
231110;201803;3296;10468;3239;10363;197;779;2369;7429;2566;8208
231120;201803;1911;6131;1715;5739;138;483;1150;3834;1288;4317
231123;201803;1849;4986;1575;4476;72;225;1185;3303;1257;3528
231126;201803;5709;16176;4622;14057;199;711;3332;9917;3531;10628
231130;201803;18930;53920;16496;50383;1713;5948;11039;33798;12752;39746
231135;201803;4130;11931;3489;10736;177;649;2528;7645;2705;8294
231140;201803;16940;50089;14132;44861;872;3561;9558;29470;10430;33031
231150;201803;5259;15086;4412;13410;736;2191;2141;6662;2877;8853
231160;201803;5718;18295;5272;17410;1135;3516;2785;9596;3920;13112
231170;201803;4216;12916;3517;11450;224;844;2404;7605;2628;8449
231180;201803;13434;39603;11592;35582;2532;7887;5009;15259;7541;23146
231190;201803;3796;11099;3347;10277;160;650;2561;7589;2721;8239
231195;201803;4438;14440;3850;13181;242;1064;2787;9256;3029;10320
231200;201803;7716;25112;6745;23053;263;1300;5097;16895;5360;18195
231210;201803;4651;14433;4057;13387;205;865;3036;9756;3241;10621
231220;201803;11551;31491;9440;27424;550;1659;6816;19323;7366;20982
231230;201803;8927;28865;8026;27393;567;2216;5943;20371;6510;22587
231240;201803;11405;34566;10236;32212;1762;5586;5789;18405;7551;23991
231250;201803;1959;5308;1348;3902;100;291;758;2148;858;2439
231260;201803;3142;9392;2804;8839;316;944;1861;6016;2177;6960
231270;201803;6439;17307;5517;15808;171;707;4232;11840;4403;12547
231280;201803;1641;5249;1534;5036;141;483;1100;3595;1241;4078
231290;201803;35545;110949;31294;102135;5448;18427;14657;47470;20105;65897
231300;201803;3880;11232;3177;9775;266;864;2061;6225;2327;7089
231310;201803;7121;19609;5851;17050;660;1909;3660;10524;4320;12433
231320;201803;7263;21058;5838;18283;147;666;4487;13818;4634;14484
231325;201803;2496;7160;2130;6557;415;1236;1131;3578;1546;4814
231330;201803;10087;31573;8502;28270;1678;5504;4223;14421;5901;19925
231335;201803;5447;14907;4679;13590;107;498;4009;11402;4116;11900
231340;201803;17340;55140;15694;52347;1168;4100;11654;39121;12822;43221
231350;201803;15127;42542;13813;40713;337;1165;12360;36349;12697;37514
231355;201803;4476;13804;4015;12985;228;842;3055;9836;3283;10678
231360;201803;7313;22790;6412;21208;518;1791;4638;15443;5156;17234
231370;201803;2272;6198;1809;5380;45;139;1377;4059;1422;4198
231375;201803;4229;13678;3881;13029;138;626;3182;10537;3320;11163
231380;201803;5676;15847;5285;15354;190;464;4528;13457;4718;13921
231390;201803;3277;9964;2957;9413;186;714;2136;6622;2322;7336
231395;201803;3877;11974;3279;10956;620;2075;1767;5999;2387;8074
231400;201803;8857;26499;7969;24777;373;1481;6150;18752;6523;20233
231410;201803;14791;46943;13197;44307;851;3098;10141;33744;10992;36842
240010;201803;2452;6903;1914;5892;186;678;1180;3521;1366;4199
240020;201803;10792;32295;9470;29789;1050;3646;5885;18331;6935;21977
240030;201803;2566;6900;2451;6731;123;380;2136;5813;2259;6193
240040;201803;837;2406;694;2122;15;77;502;1471;517;1548
240050;201803;3229;8727;2690;7758;62;202;2109;5976;2171;6178
240060;201803;1362;3789;1168;3422;32;118;932;2667;964;2785
240070;201803;2177;6592;2006;6234;216;695;1455;4453;1671;5148
240080;201803;2727;7532;2343;6893;77;299;1794;5201;1871;5500
240090;201803;2184;5673;1807;5013;30;104;1460;3980;1490;4084
240100;201803;8565;22761;7110;20005;421;1298;5288;14468;5709;15766
240110;201803;4303;13038;3786;12054;320;1146;2520;7918;2840;9064
240120;201803;2714;8936;2449;8507;233;943;1637;5650;1870;6593
240130;201803;3098;7233;2674;6596;73;237;2363;5703;2436;5940
240140;201803;2084;6249;1763;5634;215;806;1104;3446;1319;4252
240145;201803;6006;17809;5149;16310;797;2689;3142;10049;3939;12738
240150;201803;864;2662;779;2480;54;209;593;1820;647;2029
240160;201803;1377;4280;1204;3950;77;299;847;2802;924;3101
240165;201803;871;2582;750;2336;82;240;528;1646;610;1886
240170;201803;2260;6591;1940;6003;231;818;1214;3610;1445;4428
240180;201803;2847;8614;2379;7667;443;1419;1321;4371;1764;5790
240185;201803;1256;4165;1138;3967;62;278;933;3227;995;3505
240190;201803;944;2941;837;2755;23;109;693;2250;716;2359
240200;201803;10727;29186;9081;26332;1425;4249;4346;12667;5771;16916
240210;201803;2798;7545;2515;7071;55;230;2120;5777;2175;6007
240220;201803;7128;23167;6475;22161;549;2314;4689;15955;5238;18269
240230;201803;5760;14978;4764;13319;251;686;3762;10533;4013;11219
240240;201803;1868;6020;1184;4270;149;502;368;1485;517;1987
240250;201803;2683;7610;2483;7319;164;430;2005;5949;2169;6379
240260;201803;11739;37805;10857;36268;1498;5076;6907;23615;8405;28691
240270;201803;2230;6765;2034;6458;125;353;1620;5244;1745;5597
240280;201803;1575;4207;1367;3898;46;136;1135;3191;1181;3327
240290;201803;1166;3530;981;3136;38;187;661;1955;699;2142
240300;201803;2189;5848;1615;4712;104;336;957;2698;1061;3034
240310;201803;9018;24681;7612;22292;928;2821;4150;12077;5078;14898
240320;201803;1973;5543;1497;4595;31;150;1131;3304;1162;3454
240325;201803;27974;79752;22554;70172;6119;19881;6273;20573;12392;40454
240330;201803;1481;4315;1224;3796;53;207;833;2480;886;2687
240340;201803;1941;4801;1564;4216;72;192;1209;3189;1281;3381
240350;201803;2009;5459;1862;5281;38;136;1639;4658;1677;4794
240360;201803;6856;20626;6162;19503;1240;3878;3407;11282;4647;15160
240370;201803;2008;5470;1563;4584;118;353;997;2884;1115;3237
240375;201803;856;2251;750;2044;34;138;574;1479;608;1617
240380;201803;2279;6641;1663;5248;156;508;957;2959;1113;3467
240390;201803;925;2463;691;1974;6;16;484;1300;490;1316
240400;201803;1352;3735;1087;3222;31;113;781;2268;812;2381
240410;201803;513;1643;448;1493;47;186;285;927;332;1113
240420;201803;4544;16991;4158;16098;641;3013;2210;8329;2851;11342
240430;201803;3240;8956;2834;8166;211;732;2091;5802;2302;6534
240440;201803;2466;5848;2089;5322;194;496;1509;3788;1703;4284
240450;201803;4005;11537;3282;10139;365;1249;1939;5820;2304;7069
240460;201803;2918;8591;2716;8296;236;792;2157;6552;2393;7344
240470;201803;3594;11069;2824;9451;371;1254;1606;5398;1977;6652
240480;201803;546;1503;397;1210;37;114;189;575;226;689
240485;201803;2105;6288;1769;5613;189;583;1136;3662;1325;4245
240490;201803;1738;4359;1414;3806;37;82;1184;3198;1221;3280
240500;201803;2174;5942;1901;5559;57;200;1611;4669;1668;4869
240510;201803;1621;4522;1489;4331;108;351;1229;3484;1337;3835
240520;201803;1272;3402;1079;3128;36;148;909;2566;945;2714
240530;201803;1836;5912;1712;5672;118;446;1325;4322;1443;4768
240540;201803;2065;5471;1856;5160;60;188;1609;4434;1669;4622
240550;201803;670;1912;599;1781;33;108;460;1342;493;1450
240560;201803;3255;8836;2821;8258;295;743;2072;6205;2367;6948
240570;201803;2909;7876;2025;5882;259;816;924;2430;1183;3246
240580;201803;7457;22475;6863;21451;537;1826;5458;16982;5995;18808
240590;201803;700;1911;609;1747;21;77;461;1294;482;1371
240600;201803;1670;4670;1250;3800;98;330;780;2288;878;2618
240610;201803;4455;12499;3770;11225;227;747;2664;7793;2891;8540
240615;201803;1015;2939;822;2534;82;295;541;1580;623;1875
240620;201803;1809;5261;1564;4816;108;312;1252;3836;1360;4148
240630;201803;2002;5964;1809;5631;139;380;1251;3976;1390;4356
240640;201803;864;2448;713;2197;48;203;500;1470;548;1673
240650;201803;3875;11093;3467;10423;173;542;2739;8180;2912;8722
240660;201803;2441;7183;2286;6955;71;290;2014;6002;2085;6292
240670;201803;2436;7134;2036;6292;185;643;1286;3837;1471;4480
240680;201803;1557;4340;1250;3786;61;221;902;2651;963;2872
240690;201803;895;2340;714;2017;24;87;570;1554;594;1641
240700;201803;2399;7083;1996;6336;67;287;1557;4818;1624;5105
240710;201803;15228;41845;13369;38489;2556;7165;7210;21187;9766;28352
240720;201803;5155;13755;4507;12689;722;2110;2701;7448;3423;9558
240725;201803;1014;3055;798;2557;35;119;527;1647;562;1766
240730;201803;2088;6031;1771;5403;108;347;1336;4015;1444;4362
240740;201803;1860;5164;1567;4611;61;269;1157;3215;1218;3484
240750;201803;2032;7339;1843;6944;347;1384;980;3717;1327;5101
240760;201803;1441;3670;1028;3020;59;160;780;2305;839;2465
240770;201803;3036;8642;2686;8146;123;466;2236;6655;2359;7121
240780;201803;5376;14891;4382;13233;543;1640;2629;8120;3172;9760
240790;201803;827;2453;697;2190;24;90;538;1674;562;1764
240800;201803;35472;96678;30330;88289;4906;14900;14279;41750;19185;56650
240810;201803;78389;219693;70273;205388;15829;45966;34147;101528;49976;147494
240820;201803;5283;16707;4675;15677;936;3182;2447;8531;3383;11713
240830;201803;8567;25572;7891;24536;321;1362;6486;19810;6807;21172
240840;201803;1124;2990;928;2634;84;241;626;1723;710;1964
240850;201803;1258;3620;917;2845;61;197;516;1579;577;1776
240860;201803;1227;3425;954;2904;23;100;722;2095;745;2195
240870;201803;1137;2969;891;2549;68;204;594;1658;662;1862
240880;201803;1249;4020;1174;3872;79;274;942;3097;1021;3371
240890;201803;4621;12911;3634;10974;626;1984;1699;5026;2325;7010
240895;201803;2570;8691;2374;8362;216;809;1848;6537;2064;7346
240910;201803;3046;8793;2635;7959;63;239;2163;6442;2226;6681
240920;201803;800;2467;683;2234;73;261;375;1218;448;1479
240930;201803;3530;8626;3035;8012;106;196;2428;6554;2534;6750
240933;201803;1757;4397;1487;3965;48;176;1221;3178;1269;3354
240940;201803;6196;15668;4939;13577;315;937;3551;9498;3866;10435
240950;201803;902;2861;807;2662;35;146;626;2019;661;2165
240960;201803;772;2366;671;2163;43;155;487;1534;530;1689
240970;201803;1761;4816;1479;4284;57;223;1203;3352;1260;3575
240980;201803;2844;9127;2595;8663;260;991;1860;6132;2120;7123
240990;201803;2505;7418;2312;7015;298;967;1603;4766;1901;5733
241000;201803;940;2543;778;2233;37;112;545;1548;582;1660
241010;201803;2592;8629;2443;8335;242;1003;1771;5858;2013;6861
241020;201803;2020;5507;1507;4457;181;479;878;2583;1059;3062
241025;201803;1713;5074;1429;4539;79;272;969;3074;1048;3346
241030;201803;2407;7779;2032;6985;195;707;1354;4643;1549;5350
241040;201803;2244;7290;2014;6899;124;554;1567;5332;1691;5886
241050;201803;1258;3619;1054;3234;45;152;770;2311;815;2463
241060;201803;734;2104;648;1933;52;159;442;1306;494;1465
241070;201803;646;1814;563;1670;33;122;439;1236;472;1358
241080;201803;1099;3181;856;2693;15;74;636;1967;651;2041
241090;201803;1914;5770;1609;5227;61;294;1261;4029;1322;4323
241100;201803;1095;3215;916;2807;44;149;633;1880;677;2029
241105;201803;1076;3257;902;2938;253;825;335;1115;588;1940
241110;201803;849;2550;670;2143;30;119;441;1352;471;1471
241120;201803;7122;21120;6269;19601;1342;3976;3217;10696;4559;14672
241140;201803;3203;8572;2677;7522;151;425;1977;5411;2128;5836
241142;201803;742;2082;560;1707;39;139;337;989;376;1128
241150;201803;5468;15375;4885;14393;209;817;3850;11060;4059;11877
241160;201803;1526;4630;1341;4324;150;418;960;3166;1110;3584
241170;201803;1208;3240;1084;3025;50;166;888;2391;938;2557
241180;201803;957;2594;705;2083;64;175;393;1157;457;1332
241190;201803;1107;2996;898;2567;29;111;651;1777;680;1888
241200;201803;17612;49032;15383;45603;3286;9930;7436;22511;10722;32441
241210;201803;1385;3846;1066;3200;98;315;646;1914;744;2229
241220;201803;8046;25477;7189;23929;2139;7162;2956;10291;5095;17453
241230;201803;2908;8069;2634;7615;103;383;2195;6177;2298;6560
241240;201803;1176;3430;695;2274;48;189;345;1130;393;1319
241250;201803;5661;17079;4655;15111;208;1008;3420;10631;3628;11639
241255;201803;1841;6404;1636;5936;173;750;1081;3823;1254;4573
241260;201803;4766;12897;3816;11297;100;456;2885;8314;2985;8770
241270;201803;1760;5277;1520;4808;124;471;1085;3365;1209;3836
241280;201803;1896;5198;1699;4842;92;274;1391;3926;1483;4200
241290;201803;3175;8268;2505;7148;85;313;1958;5452;2043;5765
241300;201803;1428;3990;1200;3570;39;129;803;2337;842;2466
241310;201803;1814;4981;1623;4661;45;154;1385;3929;1430;4083
241320;201803;875;3005;780;2789;89;364;489;1717;578;2081
241330;201803;1514;4280;1324;4034;44;177;1149;3478;1193;3655
241335;201803;2885;8385;2613;7888;96;343;2197;6534;2293;6877
241340;201803;1698;5078;1365;4313;283;916;597;1851;880;2767
241350;201803;1857;5675;1666;5316;93;353;1259;3928;1352;4281
241355;201803;1315;3666;1073;3210;34;140;827;2446;861;2586
241360;201803;2074;5427;1657;4624;71;217;1203;3263;1274;3480
241370;201803;1346;3863;1065;3300;76;274;704;2071;780;2345
241380;201803;658;1824;528;1565;61;185;326;944;387;1129
241390;201803;2584;8197;2390;7874;179;652;1854;6083;2033;6735
241400;201803;3550;10091;3190;9564;212;678;2530;7542;2742;8220
241410;201803;2313;7031;1994;6450;406;1366;1061;3436;1467;4802
241415;201803;1596;4800;1357;4355;108;370;995;3139;1103;3509
241420;201803;2003;6951;1792;6535;516;1963;639;2357;1155;4320
241430;201803;505;1464;388;1218;34;116;241;730;275;846
241440;201803;6825;22783;6173;21596;491;2026;4642;16082;5133;18108
241445;201803;994;2742;928;2661;20;54;848;2473;868;2527
241450;201803;2835;7327;2518;6854;277;697;1830;5013;2107;5710
241460;201803;3464;9807;2965;8733;200;678;2086;5962;2286;6640
241470;201803;1367;3701;1113;3331;48;171;891;2642;939;2813
241475;201803;1200;3541;960;3063;32;179;691;2092;723;2271
241480;201803;2573;8432;2290;7857;856;2918;626;2488;1482;5406
241490;201803;691;1751;555;1539;29;93;361;954;390;1047
241500;201803;768;2351;659;2212;16;67;568;1903;584;1970
250010;201803;2701;8262;2246;7265;71;306;1643;5177;1714;5483
250020;201803;1558;4342;1155;3554;56;164;809;2441;865;2605
250030;201803;6711;18968;6064;18003;343;1177;4864;14133;5207;15310
250040;201803;3823;12442;3463;11712;288;1106;2460;8199;2748;9305
250050;201803;3323;9800;3067;9408;253;871;2337;7071;2590;7942
250053;201803;1190;3518;1077;3343;84;284;783;2421;867;2705
250057;201803;662;2480;639;2452;3;10;609;2374;612;2384
250060;201803;5049;14231;4646;13692;391;1167;3663;10891;4054;12058
250070;201803;3798;11309;3468;10700;62;313;2663;7930;2725;8243
250073;201803;762;2166;640;1964;12;48;492;1457;504;1505
250077;201803;2189;6107;1663;5206;97;324;1187;3685;1284;4009
250080;201803;4261;11667;3896;11137;118;422;3307;9290;3425;9712
250090;201803;2714;7248;2493;6909;114;283;2083;5750;2197;6033
250100;201803;3718;11719;3447;11221;165;682;2824;8951;2989;9633
250110;201803;4682;13629;4341;13122;389;1402;3386;9957;3775;11359
250115;201803;503;1509;452;1428;13;70;334;1021;347;1091
250120;201803;1678;5209;1478;4860;56;253;1171;3818;1227;4071
250130;201803;5284;15625;4570;14464;116;631;3668;11375;3784;12006
250135;201803;1066;3118;977;2973;15;64;846;2555;861;2619
250140;201803;2022;6410;1952;6297;85;397;1668;5298;1753;5695
250150;201803;4676;15440;4291;14687;173;888;3374;11231;3547;12119
250153;201803;1465;3831;1218;3475;31;125;983;2753;1014;2878
250157;201803;1770;5479;1596;5113;169;528;1136;3644;1305;4172
250160;201803;3718;9824;3052;8906;44;146;2778;8104;2822;8250
250170;201803;1662;4568;1480;4292;54;198;1239;3545;1293;3743
250180;201803;16390;44730;14854;42566;951;3202;11205;31347;12156;34549
250190;201803;3990;11272;3545;10543;487;1356;2330;6934;2817;8290
250200;201803;1830;5303;1545;4845;53;203;1292;4014;1345;4217
250205;201803;766;2627;725;2544;22;122;586;2032;608;2154
250210;201803;1486;4662;1366;4460;48;235;1078;3428;1126;3663
250215;201803;1415;4132;1216;3834;62;215;788;2480;850;2695
250220;201803;688;1984;558;1785;25;90;412;1301;437;1391
250230;201803;1605;3857;1197;3210;30;105;950;2455;980;2560
250240;201803;2137;6825;1963;6514;55;225;1649;5400;1704;5625
250250;201803;4373;12773;3894;12087;116;408;3226;9985;3342;10393
250260;201803;1650;4749;1409;4330;39;130;1124;3447;1163;3577
250270;201803;1218;3745;1082;3576;75;250;810;2792;885;3042
250280;201803;3239;9483;2824;8807;127;457;2230;6911;2357;7368
250290;201803;1683;4533;1438;4193;20;54;1199;3492;1219;3546
250300;201803;5140;14731;4846;14363;236;1014;4093;11761;4329;12775
250310;201803;1076;3187;942;2942;31;124;734;2223;765;2347
250320;201803;9113;24854;8305;23806;571;1784;6755;19173;7326;20957
250330;201803;2334;6955;1980;6430;122;418;1543;4959;1665;5377
250340;201803;1058;2935;941;2756;14;53;809;2326;823;2379
250350;201803;4066;11259;3692;10747;153;383;3154;9313;3307;9696
250355;201803;1914;5993;1762;5799;24;136;1606;5265;1630;5401
250360;201803;1767;5082;1641;4871;47;151;1346;3987;1393;4138
250370;201803;11613;32425;10116;30399;474;1713;8343;24769;8817;26482
250375;201803;1039;2980;925;2822;17;64;827;2540;844;2604
250380;201803;1612;4384;1501;4238;49;195;1241;3367;1290;3562
250390;201803;1795;4754;1489;4248;185;504;989;2843;1174;3347
250400;201803;67313;173939;49821;145822;13057;39851;16439;49551;29496;89402
250403;201803;1567;4861;1432;4691;143;627;1007;3183;1150;3810
250407;201803;1189;3184;1015;2922;76;159;745;2166;821;2325
250410;201803;551;1637;487;1522;11;55;398;1207;409;1262
250415;201803;1866;5471;1668;5129;65;229;1319;4044;1384;4273
250420;201803;1208;3494;1097;3337;22;86;1006;3054;1028;3140
250430;201803;6080;15717;5341;14642;182;582;4371;11706;4553;12288
250435;201803;1349;3996;1192;3724;39;160;916;2811;955;2971
250440;201803;4377;12197;3914;11558;95;351;3345;9765;3440;10116
250450;201803;1824;5056;1552;4682;43;162;1279;3807;1322;3969
250460;201803;6539;18836;6069;18214;320;1013;5218;15732;5538;16745
250470;201803;1490;3930;1229;3554;63;219;921;2583;984;2802
250480;201803;3655;10723;3337;10314;45;199;3015;9353;3060;9552
250485;201803;693;1621;503;1351;28;76;384;992;412;1068
250490;201803;4237;11695;3901;11278;249;855;3212;9169;3461;10024
250500;201803;1891;5426;1684;5077;85;269;1353;4064;1438;4333
250510;201803;5121;13521;4473;12643;79;234;3996;11326;4075;11560
250520;201803;1776;5058;1560;4735;172;581;1032;3065;1204;3646
250523;201803;1985;5267;1828;5070;75;318;1581;4254;1656;4572
250527;201803;1589;4337;1472;4195;36;129;1339;3786;1375;3915
250530;201803;588;1715;512;1606;19;71;445;1383;464;1454
250535;201803;1314;4003;1212;3812;38;182;966;2953;1004;3135
250540;201803;2567;6570;2210;6156;57;162;1943;5401;2000;5563
250550;201803;834;2766;757;2634;28;147;614;2074;642;2221
250560;201803;1604;4745;1479;4557;43;175;1220;3648;1263;3823
250570;201803;2502;7735;2195;7169;82;374;1747;5542;1829;5916
250580;201803;1047;2741;941;2593;51;184;778;2105;829;2289
250590;201803;813;2407;726;2271;19;96;605;1831;624;1927
250600;201803;7163;20113;6512;19125;374;993;5392;15928;5766;16921
250610;201803;2942;8486;2706;8133;147;515;2221;6615;2368;7130
250620;201803;690;1967;605;1798;28;112;462;1339;490;1451
250625;201803;2510;7524;2318;7227;53;232;1989;6066;2042;6298
250630;201803;9398;27575;8103;25122;1136;3663;4930;14921;6066;18584
250640;201803;3291;9759;3068;9454;107;485;2578;7748;2685;8233
250650;201803;878;2256;740;2072;36;120;595;1607;631;1727
250660;201803;1646;4254;1478;4023;43;113;1296;3499;1339;3612
250670;201803;2234;7226;2109;7009;48;252;1822;5915;1870;6167
250680;201803;5276;13222;4848;12736;133;441;4407;11416;4540;11857
250690;201803;6336;15324;5761;14592;169;402;5208;13115;5377;13517
250700;201803;4222;12261;3800;11586;358;1123;2839;8565;3197;9688
250710;201803;4403;13043;3832;12271;321;1168;2758;8839;3079;10007
250720;201803;2686;7313;2450;6946;48;207;2200;6163;2248;6370
250730;201803;3739;10391;3352;9871;165;597;2798;8029;2963;8626
250740;201803;1894;5099;1587;4659;134;434;1234;3526;1368;3960
250750;201803;93449;251546;83085;236325;8244;25472;56634;158007;64878;183479
250760;201803;2292;6163;2009;5719;121;362;1574;4388;1695;4750
250770;201803;3739;11978;3425;11564;277;1096;2511;8398;2788;9494
250780;201803;1698;4783;1433;4281;119;402;1005;2929;1124;3331
250790;201803;2307;7203;2089;6856;307;1059;1313;4343;1620;5402
250800;201803;2464;6769;2122;6203;97;234;1728;5061;1825;5295
250810;201803;1237;3500;1040;3206;31;117;856;2626;887;2743
250820;201803;1764;5501;1705;5427;64;265;1531;4823;1595;5088
250830;201803;5194;16242;4673;15186;337;1329;3338;10591;3675;11920
250840;201803;822;2672;719;2442;18;80;506;1727;524;1807
250850;201803;1855;5592;1660;5266;43;235;1368;4209;1411;4444
250855;201803;1016;3010;877;2763;38;158;666;2050;704;2208
250860;201803;3110;9712;2591;8784;455;1648;1326;4522;1781;6170
250870;201803;1060;2962;903;2663;33;119;733;2133;766;2252
250880;201803;1501;4048;1243;3661;148;432;832;2489;980;2921
250890;201803;9198;26233;8607;25408;630;2421;6886;19656;7516;22077
250900;201803;2676;8151;2331;7484;88;324;1896;5976;1984;6300
250905;201803;2129;6345;2019;6192;70;275;1796;5454;1866;5729
250910;201803;5133;14083;4584;13355;123;462;3917;11387;4040;11849
250915;201803;1787;4594;1383;4175;18;38;1289;3967;1307;4005
250920;201803;3090;8572;2865;8205;326;871;2083;5938;2409;6809
250930;201803;2072;5882;1922;5664;94;351;1598;4612;1692;4963
250933;201803;1103;3509;979;3262;39;196;717;2299;756;2495
250937;201803;681;1960;567;1751;32;116;423;1288;455;1404
250939;201803;1653;4610;1449;4298;43;176;1175;3397;1218;3573
250940;201803;3708;10639;3425;10190;57;226;3024;8991;3081;9217
250950;201803;1467;4068;1227;3754;32;139;1074;3264;1106;3403
250960;201803;1046;3232;958;3085;35;150;772;2418;807;2568
250970;201803;8214;22248;7059;20355;425;1413;5300;15008;5725;16421
250980;201803;2487;6986;2257;6562;55;229;1838;5180;1893;5409
250990;201803;1859;6061;1629;5567;90;414;1219;4057;1309;4471
251000;201803;2067;5908;1721;5354;38;174;1426;4386;1464;4560
251010;201803;2570;7488;2323;7098;30;113;2099;6419;2129;6532
251020;201803;1659;4524;1540;4377;44;137;1420;4025;1464;4162
251030;201803;993;2764;862;2504;43;141;609;1715;652;1856
251040;201803;1760;5283;1535;4895;58;278;1236;3830;1294;4108
251050;201803;1095;3064;895;2677;81;268;640;1833;721;2101
251060;201803;1034;2296;763;1940;13;64;623;1535;636;1599
251065;201803;443;1260;364;1150;19;75;250;733;269;808
251070;201803;724;2093;639;1980;15;63;543;1660;558;1723
251080;201803;18721;49903;15614;45234;2369;7162;9119;26671;11488;33833
251090;201803;2784;8272;2383;7492;80;296;1852;5747;1932;6043
251100;201803;854;2685;759;2514;32;164;537;1683;569;1847
251110;201803;1716;4828;1492;4395;51;144;1147;3345;1198;3489
251120;201803;6573;20412;5873;19409;334;1400;4485;14675;4819;16075
251130;201803;3586;8897;3278;8552;251;685;2885;7509;3136;8194
251140;201803;4206;12221;3849;11702;101;414;3196;9639;3297;10053
251150;201803;2657;8012;2421;7645;129;545;1925;5923;2054;6468
251160;201803;1932;6106;1776;5856;92;314;1512;5005;1604;5319
251170;201803;1499;4298;1370;4151;39;133;1229;3724;1268;3857
251180;201803;2453;7094;2136;6624;199;691;1421;4352;1620;5043
251190;201803;4366;11730;4102;11412;64;271;3735;10180;3799;10451
251200;201803;3989;12505;3708;12152;82;342;3306;10875;3388;11217
251203;201803;944;3118;899;3024;35;158;683;2236;718;2394
251207;201803;1010;3028;828;2686;28;143;572;1796;600;1939
251210;201803;7189;19554;6065;18117;299;901;4838;14564;5137;15465
251220;201803;1109;2855;904;2572;48;125;712;2044;760;2169
251230;201803;4567;12705;4045;11981;158;561;3382;9809;3540;10370
251240;201803;3396;9771;2919;9073;189;631;2186;6655;2375;7286
251250;201803;9680;27426;8765;26052;804;2595;6309;18232;7113;20827
251260;201803;453;1425;412;1346;13;57;316;1018;329;1075
251270;201803;4035;12971;3636;12457;115;524;3123;10711;3238;11235
251272;201803;1296;3610;1208;3485;37;144;1077;3078;1114;3222
251274;201803;889;2618;734;2337;43;179;514;1563;557;1742
251275;201803;1206;3477;1063;3236;42;173;795;2312;837;2485
251276;201803;1164;3331;1082;3218;48;211;890;2573;938;2784
251278;201803;561;1659;501;1543;49;150;351;1091;400;1241
251280;201803;2190;6287;1996;5972;50;227;1623;4695;1673;4922
251290;201803;5396;14306;5087;13911;309;1117;4233;11170;4542;12287
251300;201803;759;2409;714;2335;14;61;601;1954;615;2015
251310;201803;2734;8048;2495;7676;79;375;2008;6016;2087;6391
251315;201803;1597;5198;1486;5005;84;299;1170;3901;1254;4200
251320;201803;1694;4566;1209;3745;48;172;854;2635;902;2807
251330;201803;1872;4714;1539;4304;37;144;1397;3886;1434;4030
251335;201803;1080;3631;989;3487;41;187;804;2785;845;2972
251340;201803;3438;9257;2880;8517;126;451;2189;6379;2315;6830
251350;201803;1081;3329;998;3190;32;139;817;2534;849;2673
251360;201803;1759;5267;1464;4858;24;115;1255;4186;1279;4301
251365;201803;720;2098;578;1792;12;53;452;1386;464;1439
251370;201803;21997;64393;20760;62670;2071;6712;15163;45460;17234;52172
251380;201803;1207;3632;1067;3395;22;101;903;2776;925;2877
251385;201803;715;1875;565;1612;21;67;413;1116;434;1183
251390;201803;5946;18818;5204;17419;970;3420;2768;9158;3738;12578
251392;201803;962;2761;825;2527;33;140;616;1835;649;1975
251394;201803;613;1951;529;1800;27;116;407;1364;434;1480
251396;201803;719;1996;621;1833;34;89;429;1246;463;1335
251398;201803;885;2405;671;2030;25;102;476;1387;501;1489
251400;201803;1121;3022;926;2751;37;131;691;1983;728;2114
251410;201803;1598;3919;1315;3497;24;95;1099;2837;1123;2932
251420;201803;1843;5114;1551;4773;58;248;1222;3659;1280;3907
251430;201803;1503;4887;1353;4636;42;215;1175;3960;1217;4175
251440;201803;1087;3224;890;2834;19;73;714;2273;733;2346
251445;201803;1489;4409;1397;4285;77;312;1130;3360;1207;3672
251450;201803;4330;13284;3951;12752;73;331;3304;10561;3377;10892
251455;201803;975;3033;880;2846;49;210;655;2075;704;2285
251460;201803;850;2529;763;2388;28;103;630;1994;658;2097
251465;201803;431;1330;361;1175;16;75;270;859;286;934
251470;201803;1143;3232;883;2682;83;258;543;1609;626;1867
251480;201803;913;2499;784;2289;22;99;588;1654;610;1753
251490;201803;1806;5092;1506;4653;110;359;1019;3110;1129;3469
251500;201803;1739;5343;1643;5171;73;298;1399;4328;1472;4626
251510;201803;2393;7761;2141;7217;190;742;1389;4571;1579;5313
251520;201803;927;2527;712;2084;78;215;452;1303;530;1518
251530;201803;12739;32950;11209;30957;160;777;9941;26953;10101;27730
251540;201803;2736;8439;2531;8055;116;442;2027;6326;2143;6768
251550;201803;3486;8759;2821;7898;74;233;2365;6595;2439;6828
251560;201803;591;1818;532;1724;85;291;321;1005;406;1296
251570;201803;881;2594;733;2293;18;79;546;1649;564;1728
251580;201803;1831;4743;1628;4460;120;344;1308;3503;1428;3847
251590;201803;1556;4243;1379;4015;53;173;1117;3203;1170;3376
251593;201803;940;2821;862;2703;101;333;531;1624;632;1957
251597;201803;1959;5817;1866;5694;28;105;1700;5139;1728;5244
251600;201803;6276;17711;5662;16762;186;614;4722;13786;4908;14400
251610;201803;3295;9550;2853;8732;310;885;1938;6010;2248;6895
251615;201803;1126;3057;914;2697;24;109;689;1951;713;2060
251620;201803;16771;41226;13884;37806;241;566;11722;33371;11963;33937
251630;201803;4567;11286;3717;10103;212;604;2823;7602;3035;8206
251640;201803;2047;6073;1871;5728;67;292;1586;4744;1653;5036
251650;201803;4050;11062;3612;10495;169;572;3060;8826;3229;9398
251660;201803;3421;10574;3031;9869;81;394;2516;8002;2597;8396
251670;201803;4216;12215;3755;11584;40;199;3453;10649;3493;10848
251675;201803;653;1981;599;1906;93;330;381;1192;474;1522
251680;201803;2654;7449;2174;6736;55;203;1747;5389;1802;5592
251690;201803;3233;9374;2826;8593;78;275;2076;6164;2154;6439
251700;201803;1841;5818;1716;5648;66;312;1441;4630;1507;4942
251710;201803;826;2177;558;1606;53;186;296;809;349;995
251720;201803;1352;3974;1132;3565;32;141;864;2632;896;2773
251740;201803;665;1865;520;1609;36;128;357;1063;393;1191
260005;201803;26890;60759;22087;54309;2450;6017;15218;37014;17668;43031
260010;201803;9628;25765;8042;23429;551;1661;4986;14785;5537;16446
260020;201803;6561;16351;5539;14860;143;588;4641;12218;4784;12806
260030;201803;6158;16869;5298;15513;254;882;4171;12161;4425;13043
260040;201803;7915;21832;6710;20026;635;1858;4674;14158;5309;16016
260050;201803;11802;34129;10778;32906;408;1312;9297;28908;9705;30220
260060;201803;3814;10316;3300;9448;245;667;2486;7152;2731;7819
260070;201803;9900;26952;8713;25120;649;2180;6403;18106;7052;20286
260080;201803;6461;15527;5610;14275;190;569;4582;11373;4772;11942
260090;201803;5091;13330;4599;12679;585;1582;3318;9238;3903;10820
260100;201803;3167;8566;2683;7873;107;401;2192;6387;2299;6788
260105;201803;5209;14036;4668;13275;137;560;3918;10880;4055;11440
260110;201803;22075;59305;20043;56621;1038;3141;17034;47821;18072;50962
260120;201803;13457;37980;11612;34985;1757;5389;6940;21412;8697;26801
260130;201803;3024;8244;2758;7824;242;749;2033;5650;2275;6399
260140;201803;12451;30099;10765;27956;565;1573;8912;23110;9477;24683
260150;201803;3330;8442;2876;7885;148;493;2408;6485;2556;6978
260160;201803;5995;17208;5142;16071;132;581;4413;13866;4545;14447
260170;201803;17103;45385;15307;42817;1485;3982;11449;32271;12934;36253
260180;201803;3249;9393;2948;8946;152;547;2476;7412;2628;7959
260190;201803;16805;36693;14744;34238;219;662;12893;29418;13112;30080
260200;201803;11005;27298;9663;25615;376;1082;8441;22281;8817;23363
260210;201803;11813;34372;10147;31663;362;1451;8157;25348;8519;26799
260220;201803;9739;25403;9191;24717;250;861;8284;21987;8534;22848
260230;201803;9901;26363;8724;24695;332;1119;7008;19615;7340;20734
260240;201803;2748;8283;2418;7748;198;673;1815;5816;2013;6489
260250;201803;2143;5909;1859;5494;76;263;1479;4270;1555;4533
260260;201803;12272;33784;10801;31520;509;1845;8424;24186;8933;26031
260270;201803;3544;9885;3219;9416;167;730;2492;7030;2659;7760
260280;201803;12770;39945;11681;38378;529;2034;9983;32698;10512;34732
260290;201803;36048;99150;31884;92617;4319;13053;20000;57519;24319;70572
260300;201803;9011;25996;7965;24465;276;1213;6455;19721;6731;20934
260310;201803;4434;12405;3967;11736;503;1391;2786;8466;3289;9857
260320;201803;7311;22012;6554;20686;272;933;5346;16785;5618;17718
260330;201803;2470;7799;2241;7330;77;282;1784;5711;1861;5993
260340;201803;1954;5417;1722;5078;27;119;1511;4405;1538;4524
260345;201803;23162;65397;20265;60805;4192;13383;9005;26339;13197;39722
260350;201803;4882;12659;4436;12062;129;440;3872;10404;4001;10844
260360;201803;2481;6759;2253;6352;80;347;1554;4281;1634;4628
260370;201803;5374;16045;4712;14879;237;945;3595;11207;3832;12152
260380;201803;4770;14919;4174;13933;212;841;3096;10214;3308;11055
260390;201803;4165;12976;3588;11792;248;902;2436;7868;2684;8770
260392;201803;3368;10949;3049;10521;150;813;2519;8561;2669;9374
260400;201803;14767;38064;13164;35841;974;2937;9890;26347;10864;29284
260410;201803;60352;161031;49259;144672;10807;33694;20948;63015;31755;96709
260415;201803;3772;11033;3276;10087;124;553;2398;7115;2522;7668
260420;201803;12551;27673;10821;25713;185;586;9792;23028;9977;23614
260430;201803;2840;8885;2447;8134;135;523;1726;5669;1861;6192
260440;201803;3504;9846;3053;9035;174;645;2322;6693;2496;7338
260450;201803;5322;14251;4894;13710;191;550;4211;11865;4402;12415
260460;201803;5290;16661;4644;15391;617;2278;2667;8639;3284;10917
260470;201803;4828;13174;4145;12385;151;396;3648;11191;3799;11587
260480;201803;4119;11165;3482;10237;352;1159;2296;6875;2648;8034
260490;201803;5096;12602;4464;11543;105;381;3862;9716;3967;10097
260500;201803;5880;15730;4976;14382;545;1509;3303;9712;3848;11221
260510;201803;9117;22902;7856;21204;208;701;6956;18583;7164;19284
260515;201803;4382;12696;3379;10730;154;553;2218;6923;2372;7476
260520;201803;17133;41639;15427;39344;1009;2703;12426;31335;13435;34038
260530;201803;9244;27745;8070;25872;227;1027;6835;21720;7062;22747
260540;201803;6362;14877;5690;14075;513;1055;4753;12034;5266;13089
260545;201803;46;140;23;93;5;19;5;21;10;40
260550;201803;2813;8547;2348;7609;204;833;1422;4520;1626;5353
260560;201803;6035;15745;5230;14612;141;581;4448;12218;4589;12799
260570;201803;7022;20868;6350;19895;539;1781;4958;15508;5497;17289
260580;201803;4017;10401;3604;9799;42;176;3252;8750;3294;8926
260590;201803;6587;15861;5680;14832;269;745;4804;12581;5073;13326
260600;201803;29242;80120;24520;72682;1337;4702;18061;52784;19398;57486
260610;201803;6484;18361;6004;17676;482;1518;4509;13165;4991;14683
260620;201803;14469;41769;13407;40082;1851;6055;8654;25373;10505;31428
260630;201803;2327;6388;1943;5785;45;204;1611;4748;1656;4952
260640;201803;18665;46364;16244;43469;1086;3191;12487;33108;13573;36299
260650;201803;5400;15914;4639;14721;188;815;3845;12077;4033;12892
260660;201803;7350;19855;6406;18634;182;768;5433;15536;5615;16304
260670;201803;2237;5882;1840;5296;88;237;1330;3805;1418;4042
260680;201803;23451;60843;19918;55398;2456;7007;11688;32216;14144;39223
260690;201803;3590;9495;2988;8546;117;378;2392;6793;2509;7171
260700;201803;5732;17209;5522;16965;23;50;5379;16698;5402;16748
260710;201803;1322;3601;1240;3493;61;209;903;2598;964;2807
260720;201803;19550;56027;17534;52930;2928;9007;10396;31281;13324;40288
260730;201803;6984;21469;6257;20407;377;1464;5080;16269;5457;17733
260740;201803;1313;3789;1144;3516;21;80;944;2912;965;2992
260750;201803;6813;19538;5938;18396;140;430;5353;16817;5493;17247
260760;201803;5220;13070;4586;12282;209;636;3723;10029;3932;10665
260765;201803;7469;23715;6721;22578;751;3069;4465;14610;5216;17679
260770;201803;3737;9962;3268;9174;108;349;2578;7173;2686;7522
260775;201803;4974;13934;4532;13280;277;1048;3390;9633;3667;10681
260780;201803;3631;11128;3282;10527;401;1437;2074;6498;2475;7935
260790;201803;110273;262427;94700;241054;16418;41518;54915;139396;71333;180914
260795;201803;3060;8504;2666;7907;140;463;2003;5965;2143;6428
260800;201803;5394;12944;4935;12289;122;404;4407;10629;4529;11033
260805;201803;3575;10622;3029;9675;218;796;2122;6687;2340;7483
260810;201803;6428;18013;5871;16966;562;1651;4253;12100;4815;13751
260820;201803;4192;10833;3720;10144;283;1010;2765;7264;3048;8274
260825;201803;2820;8787;2480;8190;139;550;1821;5969;1960;6519
260830;201803;4143;12404;3489;11168;469;1387;2273;7487;2742;8874
260840;201803;4128;11454;3655;10751;184;551;2999;8770;3183;9321
260845;201803;3977;11141;3689;10621;271;783;2736;7843;3007;8626
260850;201803;4852;14624;4220;13318;510;1681;2452;7597;2962;9278
260860;201803;3510;10223;2964;9203;111;422;2347;7157;2458;7579
260870;201803;4365;11028;3793;10304;131;479;3284;8744;3415;9223
260875;201803;6315;17193;5400;15727;762;2196;3436;10122;4198;12318
260880;201803;9671;27824;8531;25893;396;1242;6828;20840;7224;22082
260890;201803;13037;35609;11775;33742;857;2817;8525;23962;9382;26779
260900;201803;5295;15961;4542;14626;307;1188;3058;9666;3365;10854
260910;201803;3079;8878;2738;8314;121;429;2103;6329;2224;6758
260915;201803;4904;15044;4398;14426;76;326;3974;13090;4050;13416
260920;201803;3221;9285;2898;8865;124;412;2437;7544;2561;7956
260930;201803;3576;11715;3192;11044;211;826;2399;8279;2610;9105
260940;201803;14189;35573;12549;33120;1023;2968;9102;23535;10125;26503
260950;201803;6372;18682;5215;16410;671;2261;2655;7970;3326;10231
260960;201803;60245;148890;50165;134511;7598;21542;28193;74410;35791;95952
260970;201803;5005;14232;4506;13571;184;532;3530;10780;3714;11312
260980;201803;4185;12990;3833;12536;76;312;3463;11363;3539;11675
260990;201803;17128;50250;15007;47322;940;3351;11560;36338;12500;39689
261000;201803;15056;38962;12850;35830;835;2684;9177;25561;10012;28245
261010;201803;2463;6639;2205;6306;80;204;1969;5653;2049;5857
261020;201803;6323;17966;5465;16350;397;1289;4128;12049;4525;13338
261030;201803;3978;11431;3467;10596;215;631;2708;8268;2923;8899
261040;201803;5035;15699;4215;13970;277;1047;3001;9758;3278;10805
261050;201803;7382;20606;6719;19465;634;1751;4557;13254;5191;15005
261060;201803;12739;34505;11421;32594;723;2249;8951;25326;9674;27575
261070;201803;54344;125375;45830;113709;3801;9252;32834;80765;36635;90017
261080;201803;5749;15563;5412;15081;199;555;4866;13609;5065;14164
261090;201803;16712;43349;15180;41298;487;1597;12950;34953;13437;36550
261100;201803;7920;23777;6960;22198;735;2472;4726;15272;5461;17744
261110;201803;58136;170454;50319;157712;11351;37257;23208;73919;34559;111176
261120;201803;3737;9686;3246;9072;67;233;2910;8146;2977;8379
261130;201803;7455;18325;6623;17298;149;444;5859;15222;6008;15666
261140;201803;3297;8364;2962;7889;246;692;2247;5923;2493;6615
261150;201803;5226;14435;4637;13508;150;555;3949;11377;4099;11932
261153;201803;1941;5832;1669;5382;84;338;1149;3669;1233;4007
261160;201803;199240;493573;170035;452241;42151;116158;68432;185727;110583;301885
261170;201803;5629;14750;5110;13992;306;834;4058;11060;4364;11894
261180;201803;9780;25830;8781;24478;655;2033;6238;17195;6893;19228
261190;201803;4851;14738;4413;14083;364;1452;3186;9890;3550;11342
261200;201803;3292;7959;2904;7468;208;578;2345;5950;2553;6528
261210;201803;1861;4700;1637;4384;59;176;1436;3828;1495;4004
261220;201803;13426;39852;11244;35579;1549;5335;6280;19698;7829;25033
261230;201803;4584;13486;3893;12613;81;351;3286;10754;3367;11105
261240;201803;4916;13353;4357;12471;307;870;3440;9844;3747;10714
261245;201803;3419;10241;2942;9392;115;530;2314;7141;2429;7671
261247;201803;2925;8962;2490;8164;153;596;1778;5775;1931;6371
261250;201803;19000;47282;16602;44374;2760;7114;10781;29846;13541;36960
261255;201803;3943;12030;3467;11129;176;782;2675;8312;2851;9094
261260;201803;12427;34374;10838;32361;382;1518;9117;27126;9499;28644
261270;201803;3924;10906;3516;10271;235;782;2740;7807;2975;8589
261280;201803;2524;7375;2266;6938;95;407;1802;5361;1897;5768
261290;201803;2905;8027;2531;7542;124;481;2001;5977;2125;6458
261300;201803;11290;33763;9723;30942;713;2727;6802;21161;7515;23888
261310;201803;7113;20422;6356;19300;1116;3486;3891;11718;5007;15204
261320;201803;5777;17071;5112;15888;115;463;4226;12947;4341;13410
261330;201803;5620;14986;5197;14425;182;706;4488;12207;4670;12913
261340;201803;3988;12275;3491;11550;216;928;2575;8433;2791;9361
261350;201803;8151;25107;7541;24092;154;759;6221;19532;6375;20291
261360;201803;8161;20663;7060;19105;341;1008;5680;15054;6021;16062
261370;201803;18981;52937;17029;50039;3125;9289;9706;28794;12831;38083
261380;201803;3876;12614;3535;11922;503;1870;2202;7292;2705;9162
261390;201803;15875;46946;13849;43509;1482;5068;8662;27107;10144;32175
261400;201803;4611;15274;4061;14103;185;826;2972;10136;3157;10962
261410;201803;9048;24127;7754;22038;567;1651;6099;17289;6666;18940
261420;201803;6907;22409;6448;21804;1059;4034;4080;13692;5139;17726
261430;201803;3437;10138;2920;9324;132;468;2340;7452;2472;7920
261440;201803;1501;4636;1325;4287;44;211;939;2948;983;3159
261450;201803;13739;38712;12750;37279;336;1284;10810;31465;11146;32749
261460;201803;6898;19751;6362;18969;258;877;5481;16258;5739;17135
261470;201803;4145;10833;3721;10269;54;273;3088;8535;3142;8808
261480;201803;4447;14419;3930;13545;221;941;3018;10160;3239;11101
261485;201803;4917;14490;4296;13480;416;1507;2921;8969;3337;10476
261500;201803;5447;14808;4809;13941;426;1183;3403;10145;3829;11328
261510;201803;1746;5518;1534;5122;81;314;1146;3842;1227;4156
261520;201803;2527;7875;2374;7588;87;355;1610;5247;1697;5602
261530;201803;10369;32732;8998;29974;1377;5206;4155;13631;5532;18837
261540;201803;7315;22133;6642;21066;1162;3696;3841;12494;5003;16190
261550;201803;3545;9647;3148;9031;241;789;2299;6499;2540;7288
261560;201803;7359;22901;6516;21693;457;1845;4876;16157;5333;18002
261570;201803;3367;9606;2836;8717;221;804;1919;5776;2140;6580
261580;201803;6382;17482;5809;16637;141;629;5194;14651;5335;15280
261590;201803;2643;7022;2165;6308;97;299;1662;4885;1759;5184
261600;201803;5170;13623;4368;12434;399;1115;2974;8626;3373;9741
261610;201803;2446;6655;2063;6073;78;304;1596;4666;1674;4970
261618;201803;2463;6537;2214;6198;88;269;1820;5027;1908;5296
261620;201803;3879;11805;3619;11382;810;2410;2141;7037;2951;9447
261630;201803;6800;19469;5764;17543;488;1818;3598;10471;4086;12289
261640;201803;35759;83989;31613;78899;1814;4122;25209;64488;27023;68610
261650;201803;4015;10834;3595;10283;144;550;2707;7750;2851;8300
270010;201803;4262;15180;3838;14370;185;992;3035;11142;3220;12134
270020;201803;3912;10164;3481;9597;221;738;2825;7577;3046;8315
270030;201803;34113;97204;29943;90445;4547;13692;18556;56552;23103;70244
270040;201803;10824;30455;9509;28841;483;1804;7792;23525;8275;25329
270050;201803;4885;12078;4242;11352;224;599;3690;9923;3914;10522
270060;201803;1949;5307;1716;5007;174;503;1255;3722;1429;4225
270070;201803;4491;13259;3964;12512;146;685;3322;10232;3468;10917
270080;201803;1348;3960;1132;3558;88;294;829;2533;917;2827
270090;201803;1945;6035;1720;5589;73;338;1335;4181;1408;4519
270100;201803;5431;15434;4801;14478;315;1171;3778;11186;4093;12357
270110;201803;3031;7818;2510;7242;178;532;1989;5856;2167;6388
270120;201803;3024;8288;2657;7832;88;357;2346;6866;2434;7223
270130;201803;5266;14373;4590;13599;294;931;3699;11084;3993;12015
270135;201803;1956;4910;1703;4616;74;206;1524;4131;1598;4337
270140;201803;10100;23370;8271;20928;415;1590;6705;16027;7120;17617
270150;201803;2629;8191;2522;8060;20;57;2465;7894;2485;7951
270160;201803;5115;15852;4519;15105;89;502;3996;13212;4085;13714
270170;201803;3546;10826;3107;10209;294;1301;2205;6958;2499;8259
270180;201803;2237;7082;2054;6825;62;286;1764;5766;1826;6052
270190;201803;1698;5277;1572;5102;77;293;1289;4175;1366;4468
270200;201803;2485;7783;2189;7389;157;657;1615;5301;1772;5958
270210;201803;5351;13767;4701;12985;176;577;4174;11424;4350;12001
270220;201803;1307;3882;1147;3653;219;774;655;2021;874;2795
270230;201803;9586;28779;8198;26513;837;3216;5279;16544;6116;19760
270235;201803;5819;18561;5240;17572;240;1017;4218;14000;4458;15017
270240;201803;10444;29159;8652;26873;1118;3802;5944;18431;7062;22233
270250;201803;2824;7427;2534;7052;277;707;1895;5345;2172;6052
270255;201803;4633;13567;3578;11615;196;810;2546;8059;2742;8869
270260;201803;5549;17010;5207;16474;156;751;4491;13769;4647;14520
270270;201803;1034;2839;947;2722;151;454;623;1759;774;2213
270280;201803;3790;9767;3086;8857;409;836;2160;6522;2569;7358
270290;201803;7714;25264;7017;24113;322;1514;5813;19612;6135;21126
270300;201803;4064;11319;3254;10433;269;937;2331;7536;2600;8473
270310;201803;7094;20722;6196;19313;180;931;5161;15567;5341;16498
270320;201803;5772;17325;5241;16379;650;2158;3601;11034;4251;13192
270330;201803;3764;12798;3461;12370;289;1128;2683;9629;2972;10757
270340;201803;1617;4705;1385;4394;76;299;1119;3480;1195;3779
270350;201803;1892;4749;1612;4402;176;532;1158;3179;1334;3711
270360;201803;2249;6282;2051;6050;87;262;1841;5476;1928;5738
270370;201803;1409;4529;1286;4303;56;245;1011;3357;1067;3602
270375;201803;2969;7504;2522;6943;54;186;2266;6219;2320;6405
270380;201803;5711;16983;4979;15997;461;1583;3588;11694;4049;13277
270390;201803;1208;3207;1013;2936;27;110;810;2305;837;2415
270400;201803;6186;17588;5344;16243;227;856;4059;11949;4286;12805
270410;201803;4444;13665;3979;12860;263;994;3029;9662;3292;10656
270420;201803;5562;17057;5160;16522;189;831;4274;13432;4463;14263
270430;201803;132624;348910;108914;316841;26136;80160;42271;126269;68407;206429
270440;201803;4821;13481;4177;12675;131;557;3430;10356;3561;10913
270450;201803;6446;18474;5845;17740;299;1128;4797;14411;5096;15539
270460;201803;3380;8275;3005;7831;68;243;2728;6983;2796;7226
270470;201803;10573;31822;9419;30103;969;3378;6586;21259;7555;24637
270480;201803;2758;7949;2377;7346;197;744;1798;5366;1995;6110
270490;201803;974;2910;867;2778;49;190;687;2174;736;2364
270500;201803;4803;15291;4408;14774;186;874;3669;12109;3855;12983
270510;201803;5774;16221;5033;15187;540;2032;3529;10122;4069;12154
270520;201803;3739;11281;3101;10160;856;2962;1055;3632;1911;6594
270530;201803;1199;3630;1088;3459;63;200;812;2593;875;2793
270540;201803;2084;6437;1873;6156;83;407;1572;5022;1655;5429
270550;201803;6727;18389;5602;17129;515;1523;4223;13254;4738;14777
270560;201803;3121;8794;2779;8306;165;578;2155;6343;2320;6921
270570;201803;3849;11706;3342;10904;167;709;2656;8516;2823;9225
270580;201803;2159;6387;2025;6197;82;246;1780;5467;1862;5713
270590;201803;1499;4621;1412;4515;6;21;1378;4414;1384;4435
270600;201803;2774;8807;2483;8323;107;543;2078;6777;2185;7320
270610;201803;3500;9752;3001;9115;111;455;2589;7708;2700;8163
270620;201803;1311;4149;1203;3954;49;214;1004;3218;1053;3432
270630;201803;14469;41191;12917;38754;1157;3687;9666;28977;10823;32664
270640;201803;5546;16307;4815;15182;209;853;3874;11914;4083;12767
270642;201803;2329;7825;2139;7544;149;757;1674;5702;1823;6459
270644;201803;3062;8296;2585;7660;234;701;1910;5747;2144;6448
270650;201803;3335;10086;3002;9611;408;1601;2066;6318;2474;7919
270660;201803;2174;5472;1732;4859;75;238;1284;3558;1359;3796
270670;201803;15515;38764;13336;36153;957;2638;10577;28678;11534;31316
270680;201803;4876;12868;4405;12338;104;228;4109;11594;4213;11822
270690;201803;9272;23686;7875;22086;1253;3247;5525;15926;6778;19173
270700;201803;544;1704;472;1570;46;190;324;1050;370;1240
270710;201803;5799;17642;5380;17093;270;1173;4498;14002;4768;15175
270720;201803;3299;10467;2941;9856;95;563;2477;8082;2572;8645
270730;201803;7009;18012;6461;17414;398;1011;5375;15161;5773;16172
270740;201803;2307;6262;2073;5968;95;352;1739;4921;1834;5273
270750;201803;5218;14999;4622;14136;301;1090;3650;11112;3951;12202
270760;201803;3356;9671;2965;9095;82;383;2532;7629;2614;8012
270770;201803;20116;50457;16091;45560;2977;7977;9088;27565;12065;35542
270780;201803;1755;5354;1655;5212;93;331;1379;4350;1472;4681
270790;201803;1547;4582;1371;4329;158;518;909;2883;1067;3401
270800;201803;10712;30720;9716;29316;455;1963;8182;24006;8637;25969
270810;201803;3088;9295;2473;8197;198;813;1684;5467;1882;6280
270820;201803;1704;5280;1446;4839;128;491;1049;3453;1177;3944
270830;201803;5448;13416;4559;12307;252;759;3651;9875;3903;10634
270840;201803;8153;24523;7339;23393;216;1213;6408;19827;6624;21040
270850;201803;8175;22035;7379;21007;533;1962;5919;16154;6452;18116
270860;201803;11024;28911;9252;26735;655;2190;7124;20254;7779;22444
270870;201803;2031;5978;1760;5490;186;644;1240;3835;1426;4479
270880;201803;8053;24654;7308;23562;306;1330;6002;19008;6308;20338
270890;201803;2389;6873;2108;6465;152;555;1533;4584;1685;5139
270895;201803;2877;9765;2697;9515;92;528;2365;8125;2457;8653
270900;201803;1807;4804;1422;4192;56;191;1123;3231;1179;3422
270910;201803;3614;11079;3165;10312;139;596;2396;7656;2535;8252
270915;201803;8769;27635;7524;25368;920;3596;4767;15695;5687;19291
270920;201803;5675;17748;5318;17201;248;1166;4446;13920;4694;15086
270930;201803;16416;41232;13123;37335;2235;5992;8516;25021;10751;31013
270940;201803;5827;17674;5249;16943;305;1407;4020;12643;4325;14050
280010;201803;670;1844;570;1659;27;104;395;1053;422;1157
280020;201803;4641;12643;4018;11629;504;1450;2664;7696;3168;9146
280030;201803;68912;171996;56008;153576;14572;41158;21084;60385;35656;101543
280040;201803;3097;8871;2739;8313;286;919;1895;5700;2181;6619
280050;201803;3571;10832;3231;10287;570;1937;1912;6033;2482;7970
280060;201803;4990;14454;4107;13011;733;2468;2030;6599;2763;9067
280067;201803;6718;18034;5721;16452;543;1612;3878;11075;4421;12687
280070;201803;1901;5958;1821;5826;117;390;1513;4798;1630;5188
280100;201803;3606;10593;3192;9916;353;1219;2218;6826;2571;8045
280110;201803;1304;3877;1184;3670;49;200;980;2933;1029;3133
280120;201803;7435;22638;6751;21480;751;2233;4967;16099;5718;18332
280130;201803;8256;21004;7397;19766;723;1988;5555;14905;6278;16893
280140;201803;5520;14034;4976;13271;305;842;4096;10879;4401;11721
280150;201803;3715;10060;3386;9616;206;607;2769;7803;2975;8410
280160;201803;1234;3644;1016;3260;146;494;616;1937;762;2431
280170;201803;5010;13786;4556;13153;267;759;3739;10881;4006;11640
280190;201803;1192;2836;995;2557;55;163;793;1978;848;2141
280200;201803;1200;3379;1027;3072;107;383;722;2104;829;2487
280210;201803;14567;39505;12801;37042;2146;6424;7310;21469;9456;27893
280220;201803;1764;4822;1548;4533;47;223;1255;3674;1302;3897
280230;201803;3430;9480;3092;8985;225;745;2361;6704;2586;7449
280240;201803;3365;9218;3051;8736;81;358;2611;7299;2692;7657
280250;201803;826;2142;653;1872;69;226;369;1002;438;1228
280260;201803;2050;5310;1895;5121;50;152;1754;4737;1804;4889
280270;201803;2209;6550;1969;6165;102;373;1664;5140;1766;5513
280280;201803;4041;13002;3655;12402;561;1708;2377;8502;2938;10210
280290;201803;16543;47179;14863;44749;1663;5580;9691;29173;11354;34753
280300;201803;9879;27337;8710;26010;388;1410;6808;21176;7196;22586
280310;201803;1339;3642;1136;3287;35;130;849;2378;884;2508
280320;201803;8377;24376;7452;22952;848;2839;4865;14707;5713;17546
280330;201803;4625;11986;4017;11088;264;837;3122;8394;3386;9231
280340;201803;4895;11127;4225;10369;250;585;3610;9008;3860;9593
280350;201803;22186;58228;19379;54101;1945;5609;13577;37834;15522;43443
280360;201803;5614;16594;5093;15687;857;2689;2864;8896;3721;11585
280370;201803;1999;5133;1666;4590;93;248;1294;3540;1387;3788
280380;201803;965;2847;845;2661;93;343;573;1757;666;2100
280390;201803;3000;8412;2600;7702;126;456;2021;5881;2147;6337
280400;201803;3795;10378;3355;9734;627;1752;1943;5862;2570;7614
280410;201803;2075;6272;1714;5590;179;617;1021;3250;1200;3867
280420;201803;4168;11624;3815;11121;111;386;3403;9878;3514;10264
280430;201803;2031;5221;1791;4890;74;264;1393;3738;1467;4002
280440;201803;4562;12491;4018;11734;249;820;3198;9116;3447;9936
280445;201803;2306;6083;2082;5683;43;148;1582;4150;1625;4298
280450;201803;9837;23375;8849;22100;383;749;7671;19411;8054;20160
280460;201803;6477;16388;5928;15600;538;1422;4743;12454;5281;13876
280470;201803;1769;5138;1580;4806;83;298;1173;3530;1256;3828
280480;201803;34046;91219;30712;86467;3149;9857;21410;59123;24559;68980
280490;201803;3808;11101;3248;10156;104;464;2458;7471;2562;7935
280500;201803;925;2347;808;2181;34;111;677;1814;711;1925
280510;201803;2502;7041;2198;6602;110;447;1592;4738;1702;5185
280520;201803;1683;4401;1496;4148;88;233;1224;3396;1312;3629
280530;201803;2498;6307;2238;5989;130;361;1821;4849;1951;5210
280540;201803;8902;24421;8165;23387;199;942;7216;20147;7415;21089
280550;201803;6502;16208;5418;14535;278;788;4208;11075;4486;11863
280560;201803;7041;20386;6661;19840;198;794;5811;17001;6009;17795
280570;201803;6173;16028;5125;14651;281;955;3747;10622;4028;11577
280580;201803;5261;15442;4541;14214;574;1724;3023;9602;3597;11326
280590;201803;2718;7048;2356;6583;150;635;1694;4502;1844;5137
280600;201803;3334;9582;3008;9116;223;777;2210;6607;2433;7384
280610;201803;2468;6344;2245;6046;172;474;1807;4815;1979;5289
280620;201803;5171;13942;4518;12964;428;1056;3297;9823;3725;10879
280630;201803;3562;11158;3245;10664;204;774;2529;8354;2733;9128
280640;201803;2292;6658;2130;6477;51;135;1986;6104;2037;6239
280650;201803;1098;3092;926;2856;84;310;677;2022;761;2332
280660;201803;2858;7268;2601;6968;129;357;2260;6038;2389;6395
280670;201803;17640;42631;15660;40050;1264;3387;11831;30265;13095;33652
280680;201803;2734;6973;2329;6318;155;359;1742;4683;1897;5042
280690;201803;955;2521;822;2332;49;146;607;1694;656;1840
280700;201803;1057;2859;929;2653;21;71;722;2035;743;2106
280710;201803;13888;32887;12080;30793;573;1025;10503;27585;11076;28610
280720;201803;2553;6022;2176;5568;141;382;1465;3992;1606;4374
280730;201803;1075;2766;966;2609;71;230;747;1984;818;2214
280740;201803;13388;34626;11511;31666;1181;3234;7656;21023;8837;24257
280750;201803;3413;9999;3084;9409;191;703;2233;6696;2424;7399
280760;201803;5833;16874;5200;15855;657;2010;3345;10485;4002;12495
290010;201803;3027;6607;2126;5211;14;52;1758;4101;1772;4153
290020;201803;4968;14263;4698;13898;276;617;4077;12276;4353;12893
290030;201803;3712;9877;3244;9326;182;520;2729;7835;2911;8355
290035;201803;5086;11619;4095;10323;269;547;3244;8470;3513;9017
290040;201803;4318;10695;3634;9881;158;480;2850;7902;3008;8382
290050;201803;2187;7112;1871;6495;134;535;1301;4466;1435;5001
290060;201803;1277;3261;988;2797;105;367;665;1804;770;2171
290070;201803;32741;78945;28421;73302;3039;7959;18706;48924;21745;56883
290080;201803;5547;16537;4694;15314;585;1985;3097;10266;3682;12251
290090;201803;2297;4413;1724;3810;42;84;1572;3474;1614;3558
290100;201803;9219;25460;7841;23349;1043;2975;4790;14664;5833;17639
290110;201803;4925;13854;4532;13166;481;1461;3095;8901;3576;10362
290115;201803;4328;12590;3773;11813;216;760;3009;9451;3225;10211
290120;201803;6864;17027;5640;15535;150;545;4823;13068;4973;13613
290130;201803;4538;11517;3651;10412;116;497;2933;8179;3049;8676
290135;201803;4386;10492;3592;9222;248;674;2671;6676;2919;7350
290140;201803;4505;12688;3705;11659;137;508;3216;10124;3353;10632
290150;201803;2234;6497;2100;6276;194;620;1574;4591;1768;5211
290160;201803;3143;7748;2894;7432;362;766;2185;5732;2547;6498
290170;201803;2750;8102;2552;7850;67;271;2302;7036;2369;7307
290180;201803;2883;8097;2404;7327;101;369;1884;5685;1985;6054
290190;201803;3899;12002;3541;11489;177;768;2842;9038;3019;9806
290195;201803;2303;6027;1850;5333;55;255;1495;4257;1550;4512
290200;201803;3936;11497;3368;10592;210;690;2618;8215;2828;8905
290205;201803;3380;8944;2985;8356;121;446;2406;6546;2527;6992
290210;201803;13141;38191;11761;36237;1091;3030;8893;28243;9984;31273
290220;201803;2690;7079;2454;6782;168;514;2004;5451;2172;5965
290225;201803;3457;7476;2830;6809;37;84;2658;6416;2695;6500
290230;201803;2379;6901;2175;6660;71;285;1891;5759;1962;6044
290240;201803;3661;9540;3048;8764;128;453;2465;6963;2593;7416
290250;201803;3952;11832;3574;11339;111;291;3046;10125;3157;10416
290260;201803;5253;13815;4308;12417;228;787;3410;9734;3638;10521
290265;201803;3550;10486;2965;9425;128;539;2243;7028;2371;7567
290270;201803;11710;40635;11085;39566;791;3373;8630;30436;9421;33809
290280;201803;5804;17590;5176;16566;389;1375;3780;12007;4169;13382
290290;201803;9796;29541;8316;26863;804;2723;5724;18428;6528;21151
290300;201803;4402;12186;3194;9877;189;688;2245;6941;2434;7629
290310;201803;1498;4047;1259;3712;105;388;898;2573;1003;2961
290320;201803;23909;66012;20266;60934;5123;15528;9455;29715;14578;45243
290323;201803;3581;9932;3208;9422;75;257;2668;7744;2743;8001
290327;201803;4272;12478;3700;11396;324;981;2624;8112;2948;9093
290330;201803;1999;4524;1686;4178;52;113;1513;3769;1565;3882
290340;201803;5583;15323;4528;13980;728;2365;2997;9321;3725;11686
290350;201803;4610;13686;3921;12495;320;1087;2799;8996;3119;10083
290360;201803;4910;13620;4290;12802;119;389;3690;11043;3809;11432
290370;201803;5169;13041;3980;11479;242;634;3042;8934;3284;9568
290380;201803;5478;15128;4737;14080;131;423;4086;12234;4217;12657
290390;201803;14586;42493;12584;39502;1391;4515;8403;26881;9794;31396
290395;201803;2704;8358;2290;7611;72;351;1784;5880;1856;6231
290400;201803;3570;10066;2903;8992;130;493;2146;6509;2276;7002
290405;201803;4666;13978;3926;12659;273;955;2725;8881;2998;9836
290410;201803;5599;15942;4532;14196;162;730;3446;10407;3608;11137
290420;201803;2938;8454;2475;7706;147;468;1908;5952;2055;6420
290430;201803;3071;9020;2571;8192;340;1135;1613;5154;1953;6289
290440;201803;2775;7142;2113;6161;67;227;1551;4568;1618;4795
290450;201803;3236;9028;2685;8215;138;521;2068;6184;2206;6705
290460;201803;11773;33417;10262;30570;2758;8423;3927;11578;6685;20001
290470;201803;4328;11566;3247;9944;496;1681;1651;5156;2147;6837
290475;201803;6140;18516;5299;16983;115;578;4213;13206;4328;13784
290480;201803;1934;5098;1707;4763;137;417;1119;3113;1256;3530
290485;201803;4474;13650;3935;12825;139;721;3341;10659;3480;11380
290490;201803;8558;21184;7868;20271;539;1404;6238;16149;6777;17553
290500;201803;3811;11671;2953;9882;366;1269;1567;5170;1933;6439
290510;201803;3235;8670;2790;8059;96;352;2379;6783;2475;7135
290515;201803;3707;9988;3108;9217;81;225;2717;8231;2798;8456
290520;201803;11277;33650;8942;29041;392;1620;5942;18900;6334;20520
290530;201803;4949;14381;4308;13341;183;597;3545;10972;3728;11569
290540;201803;3641;9980;3274;9504;84;284;2922;8436;3006;8720
290550;201803;4289;11309;3816;10773;41;118;3540;10090;3581;10208
290560;201803;6635;17743;5318;15780;556;1883;3606;10455;4162;12338
290570;201803;42470;110066;38597;105086;2765;7894;30042;81291;32807;89185
290580;201803;7517;23419;6780;22331;639;2057;5099;17169;5738;19226
290590;201803;6841;21601;5965;20029;159;682;4916;16490;5075;17172
290600;201803;17790;51663;16202;49270;864;2721;12951;39848;13815;42569
290610;201803;2455;8034;1984;7081;101;433;1376;4863;1477;5296
290620;201803;6214;17864;5552;16823;220;712;4708;14162;4928;14874
290630;201803;8940;22109;7215;19893;604;1669;5605;15521;6209;17190
290640;201803;2677;7364;2052;6330;98;317;1576;4807;1674;5124
290650;201803;11322;31221;10411;30049;2752;7675;5675;17315;8427;24990
290660;201803;3560;9577;3064;8831;108;270;2263;6859;2371;7129
290670;201803;6797;19676;5919;18249;486;1508;4429;13787;4915;15295
290680;201803;10208;29523;8852;27511;256;1291;7114;21528;7370;22819
290682;201803;4572;12496;4025;11699;144;416;3373;9784;3517;10200
290685;201803;3594;8248;2372;6535;208;544;1539;4399;1747;4943
290687;201803;6692;19071;5371;16841;813;2539;3130;10153;3943;12692
290689;201803;2885;8328;2391;7487;154;557;1718;5410;1872;5967
290690;201803;5465;14708;4531;13462;528;1571;3055;9040;3583;10611
290700;201803;2582;7303;2334;6961;84;313;2002;5970;2086;6283
290710;201803;8290;24083;7195;22587;256;945;6180;19380;6436;20325
290720;201803;18417;51499;17035;49602;865;2759;14219;41361;15084;44120
290730;201803;7000;18151;6089;17032;275;743;4686;13101;4961;13844
290740;201803;1013;2855;775;2421;38;144;584;1804;622;1948
290750;201803;10251;27488;8961;25201;1038;3095;5909;16194;6947;19289
290755;201803;2197;6196;1715;5309;96;347;1196;3646;1292;3993
290760;201803;3897;11638;3101;10055;383;1140;1832;6204;2215;7344
290770;201803;2477;8394;2302;8165;63;321;1908;6795;1971;7116
290780;201803;8285;21343;7213;19821;427;916;5661;15909;6088;16825
290790;201803;4374;12457;3930;11848;156;461;3373;10216;3529;10677
290800;201803;7148;15054;5351;13008;321;712;4126;10227;4447;10939
290810;201803;5647;15698;4528;13906;115;443;3477;10712;3592;11155
290820;201803;5105;13901;4561;13112;270;868;3402;9794;3672;10662
290830;201803;4539;10856;4071;10229;103;315;3377;8366;3480;8681
290840;201803;16490;46049;14515;42961;1721;4550;9628;29732;11349;34282
290850;201803;6246;16440;5695;15826;499;1207;4475;12830;4974;14037
290860;201803;5595;17345;4902;16521;233;860;4095;14030;4328;14890
290870;201803;4654;13151;3647;11389;140;501;2625;8154;2765;8655
290880;201803;1405;3605;1102;3163;81;199;772;2261;853;2460
290890;201803;7646;17571;6736;16546;182;499;6217;15176;6399;15675
290900;201803;2299;6311;1748;5345;112;370;1125;3388;1237;3758
290910;201803;4978;12916;3976;11388;60;266;3311;9380;3371;9646
290920;201803;5050;12771;4674;12293;76;175;4347;11435;4423;11610
290930;201803;8023;22899;6701;20638;215;967;5376;16080;5591;17047
290940;201803;3750;10979;3207;10194;177;627;2403;7682;2580;8309
290950;201803;1487;3972;1271;3630;81;229;912;2624;993;2853
290960;201803;5240;14631;4778;14023;159;513;4031;11845;4190;12358
290970;201803;3584;10627;3022;9694;174;559;2237;7182;2411;7741
290980;201803;10609;27950;8978;25155;1183;3571;4780;13003;5963;16574
290990;201803;8743;25006;7678;23214;376;1426;6159;18173;6535;19599
291000;201803;3262;9024;2651;8246;262;766;2041;6468;2303;7234
291005;201803;14399;35589;12806;33626;656;1819;10688;28026;11344;29845
291010;201803;3038;9268;2444;8029;137;460;1650;5379;1787;5839
291020;201803;1247;3236;1010;2788;36;125;692;1805;728;1930
291030;201803;2376;6166;1670;4819;96;286;1045;2928;1141;3214
291040;201803;5275;15283;4596;14281;213;885;3652;11185;3865;12070
291050;201803;7329;21702;6460;20350;1093;3747;3988;12344;5081;16091
291060;201803;5873;19868;5170;18860;471;2113;3597;12894;4068;15007
291070;201803;15283;43012;13225;39837;587;2169;10536;31415;11123;33584
291072;201803;23241;64178;17484;53302;3719;11954;6449;19879;10168;31833
291075;201803;4911;13512;4393;12629;196;584;3487;9898;3683;10482
291077;201803;1538;4179;1248;3664;48;131;911;2703;959;2834
291080;201803;79098;228583;67394;209123;25036;79139;10410;34037;35446;113176
291085;201803;5650;14600;4730;13297;199;615;3995;11199;4194;11814
291090;201803;1780;3683;1407;3254;119;167;1144;2734;1263;2901
291100;201803;2989;6812;2088;5747;96;348;1597;4299;1693;4647
291110;201803;5499;17698;4776;16461;518;2001;3351;11251;3869;13252
291120;201803;7673;19547;6697;18211;410;1261;5151;13916;5561;15177
291125;201803;2053;3792;1550;3238;96;177;1213;2598;1309;2775
291130;201803;2927;8806;2349;7711;83;392;1751;5561;1834;5953
291140;201803;4483;12669;3414;10584;454;1249;2180;6882;2634;8131
291150;201803;2182;5144;1882;4790;28;77;1676;4234;1704;4311
291160;201803;4802;14438;4212;13461;419;1487;2815;8855;3234;10342
291165;201803;2280;6348;1775;5400;20;87;1320;3915;1340;4002
291170;201803;20260;52807;17188;47816;1126;3372;10972;30482;12098;33854
291180;201803;5991;15070;4653;13068;401;1144;3376;9458;3777;10602
291185;201803;3172;8904;2775;8189;104;343;2234;6499;2338;6842
291190;201803;7470;19105;6302;17507;406;1227;4918;13622;5324;14849
291200;201803;2857;8269;2155;6930;153;498;1326;4222;1479;4720
291210;201803;6743;15465;5269;13691;183;599;3963;10223;4146;10822
291220;201803;3922;11555;3537;10948;287;987;2575;7873;2862;8860
291230;201803;4320;9900;3378;8847;94;193;3069;8153;3163;8346
291240;201803;4249;11265;3716;10354;67;229;3183;8723;3250;8952
291250;201803;3343;10115;2690;8896;174;574;1822;6072;1996;6646
291260;201803;1238;3102;1075;2880;47;188;906;2374;953;2562
291270;201803;4933;14323;4039;12840;752;2462;2354;7628;3106;10090
291280;201803;2322;6319;1798;5452;202;662;1022;3021;1224;3683
291290;201803;5787;15727;4687;14056;519;1581;3058;9215;3577;10796
291300;201803;3958;11083;3008;9458;126;422;2193;6846;2319;7268
291310;201803;5153;14285;4404;12902;163;545;3554;10269;3717;10814
291320;201803;5940;17713;4690;15197;1115;3412;2155;7330;3270;10742
291330;201803;1731;4647;1470;4222;81;251;1068;2986;1149;3237
291340;201803;4037;10790;3412;9788;78;293;2707;7669;2785;7962
291345;201803;2972;9389;2770;9102;142;479;2237;7412;2379;7891
291350;201803;6467;17092;5025;15117;148;444;4178;12765;4326;13209
291360;201803;33433;84173;27155;75956;4785;13719;14566;41850;19351;55569
291370;201803;7786;21615;7124;20715;433;1438;5498;15871;5931;17309
291380;201803;3328;9844;2962;9240;115;483;2405;7362;2520;7845
291390;201803;12221;28902;9956;26298;495;1502;7916;20821;8411;22323
291400;201803;13644;36563;11652;33556;1779;4725;7136;21726;8915;26451
291410;201803;2892;7742;2220;6599;72;318;1677;4834;1749;5152
291420;201803;1899;4914;1575;4493;42;164;1341;3803;1383;3967
291430;201803;3028;8539;2648;7967;88;424;2156;6279;2244;6703
291440;201803;6390;18760;5564;17354;375;1253;4361;13713;4736;14966
291450;201803;8455;22844;7132;21204;144;350;6182;18877;6326;19227
291460;201803;13904;39500;12410;37259;1010;3257;8935;26910;9945;30167
291465;201803;8137;21781;6635;19971;283;1225;5431;16121;5714;17346
291470;201803;15564;38538;13294;35914;609;1617;10086;27968;10695;29585
291480;201803;38406;89090;28805;76085;3796;10546;15112;40199;18908;50745
291490;201803;4780;13275;4239;12586;276;862;3499;10421;3775;11283
291500;201803;4833;12461;3997;11299;79;338;3533;9934;3612;10272
291510;201803;3731;10523;3065;9541;96;477;2463;7621;2559;8098
291520;201803;4261;10551;3362;9332;215;644;2408;6712;2623;7356
291530;201803;2180;5450;1632;4673;313;802;924;2919;1237;3721
291535;201803;3114;9665;2867;9253;205;657;2181;7123;2386;7780
291540;201803;2210;5050;1593;4364;71;230;1393;3769;1464;3999
291550;201803;5325;13008;4226;11515;523;1345;2565;7126;3088;8471
291560;201803;19733;44527;13445;37029;907;2320;9112;26472;10019;28792
291570;201803;2262;5523;1863;5040;99;210;1553;4310;1652;4520
291580;201803;5929;16478;4853;15013;367;1345;3492;10669;3859;12014
291590;201803;1717;5088;1572;4867;151;519;1235;3805;1386;4324
291600;201803;5122;13311;3859;11285;617;1899;2149;6179;2766;8078
291610;201803;4973;14761;4719;14479;78;273;4430;13625;4508;13898
291620;201803;3089;7025;2225;6073;108;327;1703;4707;1811;5034
291630;201803;3226;7580;2474;6612;156;469;1945;5139;2101;5608
291640;201803;15364;40622;11859;35275;2342;7107;4230;13417;6572;20524
291650;201803;8485;23324;7563;22188;476;1181;6362;18979;6838;20160
291660;201803;2214;5433;1613;4495;125;445;1058;2771;1183;3216
291670;201803;1993;5272;1722;4892;108;269;1354;3901;1462;4170
291680;201803;3870;10388;3282;9412;326;982;2398;6854;2724;7836
291685;201803;4717;11531;3776;10307;311;690;2795;7917;3106;8607
291690;201803;4088;9590;2956;7948;102;270;2384;6335;2486;6605
291700;201803;8563;25681;7602;23935;533;1765;5991;18764;6524;20529
291710;201803;5170;12920;3928;11196;343;1090;2638;7379;2981;8469
291720;201803;4534;14277;3767;12696;329;1251;2538;8334;2867;9585
291730;201803;6234;17053;5396;15932;299;1006;4354;12857;4653;13863
291733;201803;2925;7731;2447;7063;84;273;1847;5498;1931;5771
291735;201803;2958;7897;2494;7211;89;288;2094;6075;2183;6363
291740;201803;3845;10125;3078;8949;136;434;2382;6830;2518;7264
291750;201803;19459;48738;15643;42917;2028;5644;9604;26668;11632;32312
291760;201803;10487;31691;8443;28287;2872;10782;1956;6599;4828;17381
291770;201803;6945;19732;5812;17649;571;1890;4023;11928;4594;13818
291780;201803;4675;13173;4229;12489;116;404;3671;10759;3787;11163
291790;201803;2624;7667;2426;7383;202;565;1863;5735;2065;6300
291800;201803;29193;76230;23160;67314;3089;8803;13390;39951;16479;48754
291810;201803;10614;26639;8812;24378;230;797;7540;20632;7770;21429
291820;201803;3706;10326;3268;9680;137;481;2539;7503;2676;7984
291830;201803;4151;10355;3597;9609;242;677;2877;7691;3119;8368
291835;201803;6235;19050;5031;16726;836;2932;2877;9762;3713;12694
291840;201803;45279;126543;39364;118902;4666;14241;27066;83585;31732;97826
291845;201803;2312;6678;2072;6355;125;382;1710;5296;1835;5678
291850;201803;4086;11872;3345;10600;286;813;2404;7874;2690;8687
291855;201803;1956;4274;1566;3796;71;212;1313;3141;1384;3353
291860;201803;2244;5968;1599;4720;36;123;1106;3140;1142;3263
291870;201803;1353;3573;906;2752;64;201;595;1776;659;1977
291875;201803;2663;8150;2377;7638;94;335;1760;5518;1854;5853
291880;201803;5180;15617;4615;14513;350;1099;3397;10677;3747;11776
291890;201803;1451;3274;991;2711;173;371;638;1813;811;2184
291900;201803;1201;3099;926;2630;26;106;721;1990;747;2096
291905;201803;2726;7030;2081;5932;81;282;1542;4290;1623;4572
291910;201803;2781;7286;2390;6809;79;259;2060;5853;2139;6112
291915;201803;6944;20551;5801;18561;275;1032;4417;14153;4692;15185
291920;201803;24775;69807;21927;65805;2732;8772;14299;42517;17031;51289
291930;201803;2403;6995;2094;6478;198;689;1444;4372;1642;5061
291940;201803;3493;9482;2414;7559;225;719;1467;4477;1692;5196
291950;201803;8671;27467;7577;25348;864;2974;4597;15633;5461;18607
291955;201803;12663;34262;11530;32813;1658;4575;8030;23604;9688;28179
291960;201803;3046;8514;2479;7661;150;473;1883;5935;2033;6408
291970;201803;3961;11335;3485;10630;205;841;2537;7647;2742;8488
291980;201803;10304;29544;8259;26424;596;1923;5767;18618;6363;20541
291990;201803;1975;5736;1854;5593;23;101;1748;5277;1771;5378
291992;201803;4121;10173;3004;8631;319;875;2279;6642;2598;7517
291995;201803;2155;5958;1753;5362;50;227;1436;4297;1486;4524
292000;201803;2332;6150;1966;5609;165;558;1393;3939;1558;4497
292010;201803;6129;14503;5022;12971;223;669;4151;10572;4374;11241
292020;201803;4458;13493;3825;12357;325;1133;2780;8844;3105;9977
292030;201803;1688;5479;1623;5368;99;379;1010;3241;1109;3620
292040;201803;4218;11235;3489;10234;236;635;2784;8385;3020;9020
292045;201803;3822;10540;2990;9306;80;193;2613;8300;2693;8493
292050;201803;6385;18676;5243;16480;413;1441;3281;10176;3694;11617
292060;201803;12364;29168;11303;27868;680;1642;9544;23249;10224;24891
292070;201803;5477;15065;4820;14275;292;931;4107;12127;4399;13058
292080;201803;3234;8337;2632;7570;131;443;2280;6527;2411;6970
292090;201803;4420;9973;3303;8667;248;669;2570;6869;2818;7538
292100;201803;10177;26588;8668;24542;1653;4735;4590;13287;6243;18022
292105;201803;3059;8736;2760;8256;75;348;2323;6837;2398;7185
292110;201803;6239;16113;4528;13264;1104;3250;1982;5895;3086;9145
292120;201803;6689;18063;5426;15783;551;1633;3713;10723;4264;12356
292130;201803;3087;7942;2618;7345;188;587;1993;5591;2181;6178
292140;201803;4899;12213;4099;11048;238;644;3278;8778;3516;9422
292145;201803;2242;6778;1922;6213;108;361;1399;4545;1507;4906
292150;201803;12855;36931;11654;35138;325;1281;9747;29106;10072;30387
292160;201803;2548;6952;2149;6436;72;205;1883;5691;1955;5896
292170;201803;8130;22670;6768;20348;601;1895;4619;13911;5220;15806
292180;201803;2869;7952;2110;6630;377;1117;1106;3523;1483;4640
292190;201803;2890;7961;2448;7317;232;714;1655;5009;1887;5723
292200;201803;7125;19514;5593;17180;1083;3419;2774;8741;3857;12160
292205;201803;3672;10651;3282;10055;80;372;2853;8582;2933;8954
292210;201803;5959;15074;5004;13795;109;463;4422;12016;4531;12479
292220;201803;1991;5066;1776;4756;133;369;1317;3467;1450;3836
292225;201803;3166;9491;2829;8981;88;369;2332;7315;2420;7684
292230;201803;7693;19517;7056;18640;159;664;6006;15526;6165;16190
292240;201803;4951;14582;4286;13294;381;1190;2858;8834;3239;10024
292250;201803;5217;14770;4769;14053;632;1815;3120;9315;3752;11130
292260;201803;3276;9078;2953;8629;185;513;2476;7342;2661;7855
292265;201803;3218;9357;2754;8569;84;376;2165;6571;2249;6947
292270;201803;3961;9679;3245;8808;222;656;2642;7176;2864;7832
292273;201803;2503;5692;2060;5141;87;160;1605;4163;1692;4323
292275;201803;1784;4991;1446;4511;75;180;1137;3703;1212;3883
292280;201803;2484;6200;2051;5695;93;207;1699;4891;1792;5098
292285;201803;2426;6253;1947;5560;86;285;1536;4386;1622;4671
292290;201803;6735;19341;5651;17759;240;883;4577;14360;4817;15243
292300;201803;9518;25735;7641;23338;1044;3334;4795;14851;5839;18185
292303;201803;2822;8294;2488;7778;62;212;2138;6671;2200;6883
292305;201803;2496;6727;2307;6444;48;213;2045;5606;2093;5819
292310;201803;6437;17347;5603;16274;212;659;4752;13734;4964;14393
292320;201803;6316;17255;5200;15220;291;943;3943;11241;4234;12184
292330;201803;2423;5840;2120;5458;119;282;1683;4424;1802;4706
292335;201803;4798;12604;4317;11906;313;789;3482;9719;3795;10508
292340;201803;6123;16878;5186;15183;264;783;3901;11320;4165;12103
292350;201803;2383;6579;1956;6001;70;260;1638;5060;1708;5320
292360;201803;4826;13074;4159;11864;332;1084;2938;8167;3270;9251
292370;201803;10234;24505;8926;22754;172;537;8107;20324;8279;20861
292380;201803;6755;19471;6135;18408;490;1458;4606;13840;5096;15298
292390;201803;4151;8590;3053;7296;158;287;2620;6346;2778;6633
292400;201803;20967;62788;18789;59097;2050;6816;12797;40172;14847;46988
292405;201803;4434;10947;3647;9866;181;423;2969;8097;3150;8520
292410;201803;1978;5156;1748;4879;67;225;1514;4243;1581;4468
292420;201803;3618;11272;3371;10894;183;797;2794;8915;2977;9712
292430;201803;4762;14373;3714;12720;309;1124;2501;8662;2810;9786
292440;201803;7975;26217;7437;25457;104;517;6874;23626;6978;24143
292450;201803;3711;11165;3059;9896;146;539;2379;7692;2525;8231
292460;201803;4743;13575;3945;12189;377;1146;2793;8634;3170;9780
292465;201803;2422;6718;2008;6100;95;257;1432;4515;1527;4772
292467;201803;1717;5208;1594;5042;209;632;1110;3621;1319;4253
292470;201803;2961;7512;2337;6510;84;213;1835;5133;1919;5346
292480;201803;6452;15741;5207;14211;101;377;4627;12409;4728;12786
292490;201803;2119;5764;1786;5241;103;304;1363;4030;1466;4334
292500;201803;6395;18118;5270;16104;597;1826;3437;10546;4034;12372
292510;201803;12630;35026;10284;31466;639;2373;7517;22888;8156;25261
292520;201803;6495;16957;5620;15656;848;2307;3715;10520;4563;12827
292525;201803;5495;13606;4551;12515;128;356;3972;10945;4100;11301
292530;201803;26181;72178;21659;65139;5636;17026;8376;26411;14012;43437
292540;201803;3435;7734;2797;7026;168;435;2382;5990;2550;6425
292550;201803;7279;20794;5796;18855;414;1514;4331;14393;4745;15907
292560;201803;4183;11080;3607;10240;118;480;2934;8234;3052;8714
292570;201803;4009;10763;3487;9998;60;218;3152;8957;3212;9175
292575;201803;6735;20490;6305;19904;317;1100;5299;16721;5616;17821
292580;201803;7130;19202;6195;17821;199;721;5302;15091;5501;15812
292590;201803;7097;19469;6495;18596;248;859;5604;15687;5852;16546
292593;201803;2807;7068;2381;6368;143;364;1879;5012;2022;5376
292595;201803;5394;14659;4731;13818;183;646;3934;11370;4117;12016
292600;201803;10768;29906;9434;27982;548;1505;7311;21836;7859;23341
292610;201803;4426;11668;3682;10410;208;494;2638;7660;2846;8154
292620;201803;6304;17946;5453;16997;61;151;5190;16360;5251;16511
292630;201803;8668;21866;7121;19348;473;1297;4963;13566;5436;14863
292640;201803;7896;24131;7048;22776;245;981;5269;17042;5514;18023
292650;201803;4388;11242;3996;10720;163;468;3550;9397;3713;9865
292660;201803;10816;30761;9445;28741;555;1838;7366;22429;7921;24267
292665;201803;2168;6683;1988;6450;54;185;1749;5743;1803;5928
292670;201803;3491;9684;2725;8268;143;523;1842;5479;1985;6002
292680;201803;3869;10742;3208;9511;217;635;2298;6677;2515;7312
292690;201803;2596;7010;1848;5774;147;440;1204;3902;1351;4342
292700;201803;9400;26531;8213;24741;872;2489;5597;17426;6469;19915
292710;201803;2291;7455;2115;7232;56;208;1913;6577;1969;6785
292720;201803;9274;22713;7851;21130;304;930;6563;17833;6867;18763
292730;201803;4143;10598;3929;10329;197;422;3389;8973;3586;9395
292740;201803;320784;822971;291907;778905;50292;137714;169215;447394;219507;585108
292750;201803;6302;17019;5407;15685;258;795;4083;11924;4341;12719
292760;201803;3836;11398;3443;10690;264;877;2504;7754;2768;8631
292770;201803;5739;16216;4851;14857;855;2745;2784;8830;3639;11575
292780;201803;1904;4059;1427;3468;45;138;1154;2701;1199;2839
292790;201803;3997;8728;3242;7902;83;247;2958;7177;3041;7424
292800;201803;10428;27195;9117;25151;409;1145;7431;20335;7840;21480
292805;201803;3355;8606;2696;7688;222;589;1990;5716;2212;6305
292810;201803;10059;28097;8000;24941;322;1258;5904;18217;6226;19475
292820;201803;7609;20860;5512;17695;428;1649;3928;12347;4356;13996
292830;201803;2703;6475;2361;6047;57;203;2149;5445;2206;5648
292840;201803;8750;23544;7882;22369;171;676;6981;19347;7152;20023
292850;201803;2646;7221;2193;6495;150;529;1472;4203;1622;4732
292860;201803;15689;37789;14108;35765;980;2411;11155;28408;12135;30819
292870;201803;17076;45417;14995;42265;1079;3476;9782;27106;10861;30582
292880;201803;11423;31586;10008;29562;420;1704;7581;21616;8001;23320
292890;201803;5695;17501;5105;16526;332;1250;4019;12894;4351;14144
292895;201803;2925;6605;2169;5469;102;249;1650;4133;1752;4382
292900;201803;2671;7630;2482;7322;79;363;1991;5646;2070;6009
292905;201803;4238;11806;3296;10351;242;790;2231;7069;2473;7859
292910;201803;4957;14043;4475;13232;354;1181;3201;9342;3555;10523
292920;201803;9729;27260;9146;26466;308;1245;7954;22560;8262;23805
292925;201803;5151;14943;4605;14041;248;798;3539;10672;3787;11470
292930;201803;6142;19045;5519;17819;437;1838;3567;11102;4004;12940
292935;201803;2108;5930;1716;5499;45;226;1495;4863;1540;5089
292937;201803;3073;7577;2672;7092;75;225;2328;6199;2403;6424
292940;201803;3121;8276;2508;7294;176;458;1857;5543;2033;6001
292950;201803;9301;24882;8298;23350;362;1134;6417;17709;6779;18843
292960;201803;5275;12795;4504;11763;112;324;3659;9403;3771;9727
292970;201803;3995;11717;3474;10978;115;530;2868;9050;2983;9580
292975;201803;4350;9733;3869;9176;207;406;3412;8209;3619;8615
292980;201803;3221;8168;2576;7161;132;419;1970;5366;2102;5785
292990;201803;10960;30531;9428;28018;455;1565;7449;22072;7904;23637
293000;201803;2625;6487;2368;6141;31;135;1854;4955;1885;5090
293010;201803;17495;46585;14449;41557;1960;5722;8792;25264;10752;30986
293015;201803;7401;23929;6028;21254;556;2343;4066;14181;4622;16524
293020;201803;9204;28576;8460;27577;161;748;7498;24518;7659;25266
293030;201803;5516;15169;4241;13170;141;477;2829;9063;2970;9540
293040;201803;3844;11348;3471;10835;108;407;3041;9424;3149;9831
293050;201803;20914;53771;18605;50510;1731;4829;12750;34982;14481;39811
293060;201803;3389;9033;2792;8055;181;580;2052;5793;2233;6373
293070;201803;23791;60523;19684;54940;3680;10165;10707;31180;14387;41345
293075;201803;3206;10614;2925;10137;202;887;2295;7897;2497;8784
293076;201803;3516;9279;3143;8769;100;273;2619;7386;2719;7659
293077;201803;5216;15260;4417;14119;512;1677;2919;9565;3431;11242
293080;201803;4707;14330;4187;13459;154;667;3375;10647;3529;11314
293090;201803;3080;9465;2458;8420;238;919;1569;5332;1807;6251
293100;201803;5665;15885;4668;14063;313;940;3542;10715;3855;11655
293105;201803;3702;11914;3237;10985;235;814;2308;7771;2543;8585
293110;201803;2316;5880;1943;5364;67;232;1624;4384;1691;4616
293120;201803;4079;11777;3701;11151;138;412;3112;9336;3250;9748
293130;201803;3707;10637;3331;10162;96;388;2887;8782;2983;9170
293135;201803;29276;72146;21806;61591;4229;13267;8995;25634;13224;38901
293140;201803;2171;5413;1949;5140;83;260;1628;4187;1711;4447
293150;201803;5266;16673;4437;15015;498;1697;2921;10005;3419;11702
293160;201803;3859;9581;3286;8899;253;494;2681;7609;2934;8103
293170;201803;3793;9630;3324;8986;126;431;2645;7096;2771;7527
293180;201803;4703;12919;3825;11472;108;483;3101;9064;3209;9547
293190;201803;13299;38347;11916;36259;323;1446;10197;30691;10520;32137
293200;201803;7866;20138;6548;18250;230;860;5063;13956;5293;14816
293210;201803;5018;13721;4324;12617;219;660;3405;9907;3624;10567
293220;201803;4883;13622;3801;11726;952;2920;1421;4625;2373;7545
293230;201803;3814;10569;2974;9335;330;1127;1940;6171;2270;7298
293240;201803;4333;11844;3491;10428;99;306;2661;8073;2760;8379
293245;201803;4025;11015;3583;10402;157;525;2984;8558;3141;9083
293250;201803;5457;13820;4702;12766;310;831;3650;9891;3960;10722
293260;201803;4405;12585;3649;11410;123;421;2606;8084;2729;8505
293270;201803;6534;15664;5311;14324;541;1087;4097;11705;4638;12792
293280;201803;4859;13222;4159;12250;219;647;3156;9330;3375;9977
293290;201803;12246;39660;11336;38026;2716;9084;5443;19206;8159;28290
293300;201803;6137;14721;5261;13564;326;745;3902;10267;4228;11012
293305;201803;4120;10447;3612;9755;62;202;3165;8515;3227;8717
293310;201803;2163;5647;1766;4964;114;327;1275;3535;1389;3862
293315;201803;4124;10233;3395;9111;162;414;2725;7268;2887;7682
293317;201803;2432;6324;2167;5881;107;285;1676;4525;1783;4810
293320;201803;8579;25179;8032;24532;688;2165;6619;20363;7307;22528
293325;201803;1711;4594;1365;4059;199;617;856;2530;1055;3147
293330;201803;43809;140069;38759;130739;8561;29432;17305;59386;25866;88818
293340;201803;2404;6845;1964;6082;149;510;1290;3952;1439;4462
293345;201803;3169;9149;2701;8508;287;647;1929;6550;2216;7197
293350;201803;6703;19183;5995;18386;79;239;5578;17414;5657;17653
293360;201803;14639;39491;12828;37263;539;1810;11283;32588;11822;34398
310010;201803;821;2057;609;1748;68;223;272;734;340;957
310020;201803;2167;6417;1709;5634;428;1555;245;786;673;2341
310030;201803;2212;6521;1774;5733;260;974;1099;3391;1359;4365
310040;201803;959;2487;783;2220;53;199;586;1589;639;1788
310050;201803;1566;5139;1426;4875;271;1021;685;2262;956;3283
310060;201803;3311;9594;2868;9008;151;677;2343;7243;2494;7920
310070;201803;347;857;250;688;6;14;181;487;187;501
310080;201803;798;2219;558;1732;67;250;230;669;297;919
310090;201803;4342;12330;3691;11245;350;1172;2649;7995;2999;9167
310100;201803;3276;9610;2813;8839;130;551;2232;6859;2362;7410
310110;201803;4892;13296;3939;11604;706;2345;1853;5198;2559;7543
310120;201803;645;1687;432;1323;72;270;195;521;267;791
310130;201803;370;1071;312;969;54;207;172;474;226;681
310140;201803;185;602;145;532;41;178;41;123;82;301
310150;201803;4376;12915;3491;11151;726;2498;1212;3801;1938;6299
310160;201803;6530;18800;5155;16334;1333;4598;1248;3834;2581;8432
310163;201803;1032;3118;846;2780;247;900;236;705;483;1605
310170;201803;8793;23651;7378;21476;768;2305;5087;14836;5855;17141
310180;201803;1626;4387;1333;3937;104;401;908;2567;1012;2968
310190;201803;2983;9346;2521;8454;649;2381;313;1001;962;3382
310200;201803;1693;5330;1334;4585;249;940;502;1673;751;2613
310205;201803;1102;3132;839;2733;104;338;495;1659;599;1997
310210;201803;2737;7364;2276;6667;112;359;1702;4925;1814;5284
310220;201803;1032;2905;859;2629;93;326;615;1821;708;2147
310230;201803;2286;6654;1912;5898;237;900;1123;3229;1360;4129
310240;201803;858;2940;758;2754;73;328;513;1822;586;2150
310250;201803;917;2719;794;2497;83;340;526;1554;609;1894
310260;201803;2645;7780;1775;6131;453;1777;275;722;728;2499
310270;201803;2644;6947;2092;6181;134;539;1664;4780;1798;5319
310280;201803;2268;5612;1797;4905;210;673;1115;2914;1325;3587
310285;201803;1872;6398;1646;6008;182;762;1036;3823;1218;4585
310290;201803;1100;3101;974;2874;205;701;521;1388;726;2089
310300;201803;1467;4725;1348;4522;249;998;678;2121;927;3119
310310;201803;302;785;211;624;30;89;112;332;142;421
310320;201803;488;1308;310;982;24;98;160;478;184;576
310330;201803;503;1217;310;867;35;111;128;314;163;425
310340;201803;7818;22189;6281;19571;1115;3392;3019;9790;4134;13182
310350;201803;11923;30370;8346;24519;2053;6527;2421;6925;4474;13452
310360;201803;460;1193;385;1096;13;44;300;833;313;877
310370;201803;1303;4238;1107;3855;226;837;404;1414;630;2251
310375;201803;993;2639;663;2090;110;372;255;789;365;1161
310380;201803;368;889;198;588;36;106;69;183;105;289
310390;201803;434;1408;364;1266;91;333;79;229;170;562
310400;201803;9068;23721;6583;19709;1179;3918;2848;8204;4027;12122
310410;201803;705;2151;463;1703;120;476;97;331;217;807
310420;201803;3873;10479;2534;7771;499;1717;561;1518;1060;3235
310430;201803;1310;3862;883;3025;189;694;204;654;393;1348
310440;201803;565;1498;395;1187;31;123;217;636;248;759
310445;201803;1333;4017;1001;3375;63;241;703;2342;766;2583
310450;201803;4615;12196;3500;10440;226;768;2620;7772;2846;8540
310460;201803;1672;4624;1173;3683;234;797;318;980;552;1777
310470;201803;3876;8588;3128;7603;290;891;2464;5803;2754;6694
310480;201803;1145;3146;830;2582;156;520;431;1291;587;1811
310490;201803;2921;8781;2369;7713;413;1582;1032;3141;1445;4723
310500;201803;1458;4321;1068;3559;209;744;465;1512;674;2256
310510;201803;1695;4958;1233;4034;301;1074;281;904;582;1978
310520;201803;1381;3494;1008;2877;112;313;601;1728;713;2041
310530;201803;857;2424;455;1469;70;247;65;168;135;415
310540;201803;3272;9806;2738;8844;708;2392;1026;3184;1734;5576
310550;201803;1212;3213;885;2665;100;387;549;1552;649;1939
310560;201803;13355;37927;10645;33212;2401;8335;3628;10361;6029;18696
310570;201803;1117;3193;921;2868;107;422;604;1805;711;2227
310590;201803;4132;11609;3438;10400;388;1325;1962;5754;2350;7079
310600;201803;1452;4477;1196;3916;182;625;539;1661;721;2286
310610;201803;496;1415;338;1131;55;225;158;479;213;704
310620;201803;148195;409175;113912;346561;24842;84461;40411;109594;65253;194055
310630;201803;4423;12642;3752;11431;320;1124;2592;7727;2912;8851
310640;201803;968;3063;814;2753;205;748;245;778;450;1526
310650;201803;2485;7530;1873;6373;224;817;1016;3387;1240;4204
310660;201803;1242;3551;1070;3339;60;195;839;2580;899;2775
310665;201803;1268;3609;1067;3307;52;188;850;2645;902;2833
310670;201803;44661;125403;37629;112516;6573;21451;19838;56630;26411;78081
310680;201803;660;1703;558;1560;33;98;428;1176;461;1274
310690;201803;1576;4516;1206;3891;154;587;645;1976;799;2563
310700;201803;514;1171;381;1009;45;142;259;664;304;806
310710;201803;5302;16345;3936;14283;881;3758;399;1395;1280;5153
310720;201803;835;2254;699;2063;77;262;495;1429;572;1691
310730;201803;8802;25805;7673;23901;655;2400;5156;15811;5811;18211
310740;201803;5055;14937;3625;11999;696;2458;888;2813;1584;5271
310750;201803;1318;3279;932;2731;156;517;382;1045;538;1562
310760;201803;526;1495;409;1289;51;179;171;543;222;722
310770;201803;1056;2991;718;2473;103;390;341;1130;444;1520
310780;201803;3927;10258;3186;9053;188;573;2243;6272;2431;6845
310790;201803;1888;5998;1674;5590;331;1105;745;2636;1076;3741
310800;201803;2352;7347;1751;6132;461;1909;110;354;571;2263
310810;201803;1098;2934;917;2609;77;264;582;1589;659;1853
310820;201803;1089;3055;736;2383;163;572;199;614;362;1186
310825;201803;2765;9289;2289;8464;95;561;1811;6518;1906;7079
310830;201803;1351;4173;1055;3597;242;912;392;1278;634;2190
310840;201803;2008;5662;1395;4551;302;1085;336;991;638;2076
310850;201803;1455;4141;1266;3888;72;344;984;2891;1056;3235
310855;201803;3125;8719;2499;7759;241;890;1770;5393;2011;6283
310860;201803;6827;20326;5582;17899;518;1784;3471;11134;3989;12918
310870;201803;1030;2561;776;2168;121;356;498;1371;619;1727
310880;201803;989;3015;800;2642;106;379;473;1537;579;1916
310890;201803;2331;6745;1646;5536;397;1492;252;733;649;2225
310900;201803;4448;12934;3354;10813;581;2091;1418;4231;1999;6322
310910;201803;1674;4555;1017;3272;130;468;137;361;267;829
310920;201803;1815;5072;1407;4396;237;791;741;2294;978;3085
310925;201803;948;2863;803;2611;126;452;519;1644;645;2096
310930;201803;5721;15734;4287;13411;746;2490;2253;7209;2999;9699
310940;201803;6097;16108;4915;14331;427;1422;3284;9375;3711;10797
310945;201803;1229;3375;1041;3101;91;322;661;1915;752;2237
310950;201803;1894;5765;1356;4614;288;1110;441;1370;729;2480
310960;201803;738;1878;442;1337;67;229;139;443;206;672
310970;201803;1143;3547;822;2869;202;765;205;665;407;1430
310980;201803;368;861;225;631;22;64;143;380;165;444
310990;201803;1213;3642;941;3075;196;672;355;1120;551;1792
311000;201803;3954;11540;3091;10119;874;3059;1142;3619;2016;6678
311010;201803;737;2368;631;2126;232;836;218;714;450;1550
311020;201803;971;2656;679;2100;96;341;302;868;398;1209
311030;201803;1502;4014;1014;3133;285;997;304;815;589;1812
311040;201803;341;1104;274;939;66;222;67;205;133;427
311050;201803;2212;6243;1798;5559;433;1476;656;1939;1089;3415
311060;201803;2576;7217;1793;5551;276;1009;669;1825;945;2834
311070;201803;1690;4876;1267;4122;201;768;561;1721;762;2489
311080;201803;875;2369;724;2097;82;293;452;1216;534;1509
311090;201803;1980;6702;1583;5964;417;1734;474;1757;891;3491
311100;201803;1968;6010;1349;4757;359;1437;168;522;527;1959
311110;201803;3027;6995;2031;5570;466;1348;874;2422;1340;3770
311115;201803;1181;3297;973;2994;70;270;732;2201;802;2471
311120;201803;6603;18084;4903;14914;918;3147;1535;4164;2453;7311
311130;201803;1900;5472;1540;4908;170;676;768;2332;938;3008
311140;201803;1255;3230;930;2776;65;216;599;1832;664;2048
311150;201803;1454;4870;1238;4451;191;749;688;2416;879;3165
311160;201803;3609;11283;2669;9557;812;3205;613;2101;1425;5306
311170;201803;816;2292;635;1989;40;144;383;1217;423;1361
311180;201803;1206;2968;806;2353;190;622;307;880;497;1502
311190;201803;1056;2934;787;2439;134;496;299;842;433;1338
311200;201803;1633;4738;1220;3914;350;1189;220;657;570;1846
311205;201803;896;2882;751;2587;70;312;416;1401;486;1713
311210;201803;958;2959;859;2828;133;417;610;2059;743;2476
311220;201803;735;2215;610;1964;104;367;278;823;382;1190
311230;201803;7751;24352;5876;20370;1198;4381;1816;6513;3014;10894
311240;201803;900;2625;721;2346;144;513;381;1220;525;1733
311250;201803;792;2366;646;2120;150;525;272;854;422;1379
311260;201803;2240;5687;1543;4550;303;956;554;1540;857;2496
311265;201803;1186;3242;927;2820;74;265;613;1820;687;2085
311270;201803;3122;9624;2728;9025;199;941;1938;6111;2137;7052
311280;201803;1158;3165;593;1920;99;352;107;321;206;673
311290;201803;1871;5942;1748;5664;193;631;1182;3825;1375;4456
311300;201803;4455;13388;3780;12277;195;966;2942;9338;3137;10304
311310;201803;634;1936;540;1749;100;339;190;564;290;903
311320;201803;3132;10081;2767;9253;436;1631;1184;3671;1620;5302
311330;201803;4517;12811;3911;11797;480;1595;2159;6612;2639;8207
311340;201803;10526;32069;8627;28388;2482;8633;2054;6860;4536;15493
311350;201803;2125;5714;1606;4755;180;592;818;2224;998;2816
311360;201803;854;2393;698;2175;315;1067;129;403;444;1470
311370;201803;4108;11113;3174;9498;273;1074;1832;5129;2105;6203
311380;201803;418;1334;333;1156;88;302;105;388;193;690
311390;201803;1682;5607;1409;5215;593;2491;348;1126;941;3617
311400;201803;1411;4189;1033;3403;162;621;403;1183;565;1804
311410;201803;1543;4969;1330;4684;273;1055;647;2282;920;3337
311420;201803;1644;5169;1122;3965;191;715;136;373;327;1088
311430;201803;3327;9488;2263;7278;387;1308;587;1899;974;3207
311440;201803;2364;7235;1694;5950;455;1801;411;1404;866;3205
311450;201803;1780;5710;1339;4829;338;1336;272;866;610;2202
311455;201803;934;2336;659;1885;172;485;208;596;380;1081
311460;201803;548;1787;389;1457;87;407;100;338;187;745
311470;201803;427;1401;320;1146;70;282;52;166;122;448
311480;201803;863;2171;720;1965;81;224;463;1227;544;1451
311490;201803;213;712;182;632;46;177;72;225;118;402
311500;201803;413;1109;306;923;40;133;164;493;204;626
311510;201803;2649;7713;1893;6287;417;1572;487;1566;904;3138
311520;201803;565;1750;520;1657;128;449;261;789;389;1238
311530;201803;8952;22100;5959;17107;1417;4546;1516;4232;2933;8778
311535;201803;737;2074;498;1631;101;395;122;380;223;775
311540;201803;529;1751;481;1662;125;425;227;807;352;1232
311545;201803;2058;5898;1749;5491;100;419;1303;3988;1403;4407
311547;201803;1504;4017;1298;3688;45;149;1000;2852;1045;3001
311550;201803;2679;7979;2142;6923;380;1412;763;2335;1143;3747
311560;201803;249;591;186;513;26;74;104;261;130;335
311570;201803;1876;4590;1403;3930;51;156;1130;3246;1181;3402
311580;201803;2209;4216;1491;3382;206;398;934;2222;1140;2620
311590;201803;496;1447;413;1322;80;298;200;617;280;915
311600;201803;1377;3647;1136;3337;85;264;912;2656;997;2920
311610;201803;2402;8362;2087;7644;472;1678;897;3355;1369;5033
311615;201803;2964;9063;2436;8199;184;759;1791;5938;1975;6697
311620;201803;386;1125;338;1049;22;90;257;777;279;867
311630;201803;1342;3806;1092;3333;78;256;755;2238;833;2494
311640;201803;545;1717;448;1523;95;366;179;584;274;950
311650;201803;1966;5412;1686;4967;154;560;1114;3141;1268;3701
311660;201803;2833;8474;2077;7015;422;1531;393;1157;815;2688
311670;201803;1540;4154;1210;3628;198;669;541;1665;739;2334
311680;201803;2042;6146;1609;5357;242;867;1006;3311;1248;4178
311690;201803;551;1259;442;1129;30;80;331;868;361;948
311700;201803;2238;5584;1737;4901;41;152;1412;3897;1453;4049
311710;201803;1475;4430;1034;3550;279;1024;315;1105;594;2129
311720;201803;395;1254;326;1119;39;159;169;556;208;715
311730;201803;4647;11721;2774;8327;863;2871;352;1001;1215;3872
311740;201803;747;2274;695;2205;38;107;623;2008;661;2115
311750;201803;3894;12086;3265;11044;376;1533;2000;6487;2376;8020
311760;201803;610;1917;526;1745;101;390;167;476;268;866
311770;201803;1889;5799;1497;5043;317;1151;517;1635;834;2786
311780;201803;1195;3817;906;3186;184;744;236;714;420;1458
311783;201803;2051;6246;1726;5657;60;282;1410;4538;1470;4820
311787;201803;715;2175;516;1706;78;293;185;530;263;823
311790;201803;1497;4026;1005;3173;218;770;360;1114;578;1884
311800;201803;4982;15906;4199;14102;852;3128;599;1836;1451;4964
311810;201803;954;3089;794;2766;61;254;471;1634;532;1888
311820;201803;692;1920;557;1665;85;314;332;920;417;1234
311830;201803;8069;24590;5795;19536;1494;5445;560;1839;2054;7284
311840;201803;2855;8061;2461;7474;325;1096;1634;4930;1959;6026
311850;201803;298;872;249;792;26;85;155;485;181;570
311860;201803;50514;136002;40390;119318;6457;20209;22441;64894;28898;85103
311870;201803;1913;5409;1344;4309;251;918;481;1371;732;2289
311880;201803;6028;16811;5256;15712;378;1088;3999;12065;4377;13153
311890;201803;1389;3786;1124;3359;151;494;665;1918;816;2412
311900;201803;685;1883;534;1651;50;184;363;1099;413;1283
311910;201803;4228;11330;3242;10035;660;2099;1529;4809;2189;6908
311920;201803;1924;5749;1586;5179;173;615;923;2984;1096;3599
311930;201803;3083;8155;2449;7188;949;2953;681;1860;1630;4813
311940;201803;13219;37425;10136;31392;1642;5591;4149;12113;5791;17704
311950;201803;2162;6197;1649;5306;106;462;1139;3570;1245;4032
311960;201803;569;1415;475;1267;39;173;325;740;364;913
311970;201803;437;1456;289;1069;52;221;59;195;111;416
311980;201803;456;1299;277;933;37;136;81;261;118;397
311990;201803;501;1272;348;1056;101;354;133;380;234;734
311995;201803;977;2834;538;1795;31;114;49;104;80;218
312000;201803;548;1560;475;1447;33;105;349;1081;382;1186
312010;201803;873;2717;695;2339;80;290;373;1230;453;1520
312015;201803;1286;4004;1152;3761;90;391;847;2648;937;3039
312020;201803;1105;3496;961;3239;210;748;375;1244;585;1992
312030;201803;1956;5142;1722;4870;40;191;1573;4376;1613;4567
312040;201803;728;2411;578;2092;90;369;211;723;301;1092
312050;201803;1216;4060;975;3555;245;1023;237;756;482;1779
312060;201803;780;2141;574;1862;128;428;275;889;403;1317
312070;201803;871;2626;621;2102;82;308;321;1041;403;1349
312080;201803;2678;6905;1996;5858;163;562;1212;3347;1375;3909
312083;201803;906;2464;708;2151;88;300;459;1340;547;1640
312087;201803;2145;6047;1863;5646;86;304;1462;4463;1548;4767
312090;201803;8970;25578;7016;22215;1583;5322;2833;8890;4416;14212
312100;201803;1503;4655;1082;3870;134;589;512;1727;646;2316
312110;201803;990;3288;842;2966;250;983;207;655;457;1638
312120;201803;644;1918;489;1630;123;464;170;497;293;961
312125;201803;1257;3708;1124;3501;145;458;816;2546;961;3004
312130;201803;836;2210;641;1865;71;225;265;730;336;955
312140;201803;785;2441;649;2130;147;518;241;729;388;1247
312150;201803;467;1358;401;1202;15;62;265;741;280;803
312160;201803;7570;23293;6087;20402;1079;4126;2450;7713;3529;11839
312170;201803;827;2330;670;2051;37;125;460;1362;497;1487
312180;201803;1341;3953;1101;3465;167;592;531;1579;698;2171
312190;201803;524;1646;386;1348;97;373;65;233;162;606
312200;201803;4646;12978;3815;11511;756;2342;2066;6208;2822;8550
312210;201803;1267;3131;929;2649;87;312;620;1691;707;2003
312220;201803;1946;6217;1735;5877;140;486;1209;4128;1349;4614
312230;201803;10891;30918;7592;24680;2223;7969;1007;2946;3230;10915
312235;201803;1567;4453;1337;4128;132;461;940;2854;1072;3315
312240;201803;732;2428;567;2064;127;515;139;486;266;1001
312245;201803;2401;6604;2083;6159;84;315;1711;5023;1795;5338
312247;201803;811;2203;596;1860;151;484;271;876;422;1360
312250;201803;995;2655;684;2078;121;382;269;797;390;1179
312260;201803;908;2669;732;2387;61;235;509;1607;570;1842
312270;201803;677;1956;531;1665;34;155;276;788;310;943
312280;201803;414;1288;335;1129;108;374;37;119;145;493
312290;201803;715;2312;621;2140;117;445;210;706;327;1151
312300;201803;852;2633;621;2077;157;581;87;229;244;810
312310;201803;770;2658;667;2447;106;445;294;1049;400;1494
312320;201803;1885;5117;1427;4296;416;1360;285;809;701;2169
312330;201803;865;2547;730;2337;82;287;518;1619;600;1906
312340;201803;274;735;205;622;33;110;103;302;136;412
312350;201803;257;591;219;553;26;76;160;391;186;467
312352;201803;1605;4846;1391;4477;150;480;904;3067;1054;3547
312360;201803;2612;8100;2026;6829;443;1630;459;1472;902;3102
312370;201803;1690;4858;1430;4391;298;1031;649;1875;947;2906
312380;201803;2078;5109;1795;4744;28;71;1600;4257;1628;4328
312385;201803;1228;3511;1007;3120;160;569;570;1666;730;2235
312390;201803;1942;5877;1497;5043;297;1103;436;1329;733;2432
312400;201803;2900;8869;2311;7723;813;2836;607;2067;1420;4903
312410;201803;11056;33034;9224;29734;1783;6034;4339;13809;6122;19843
312420;201803;3611;10741;3235;10048;584;1946;1732;5306;2316;7252
312430;201803;7858;21854;6497;19435;653;2115;4304;12751;4957;14866
312440;201803;904;2878;693;2392;313;1150;82;253;395;1403
312450;201803;1124;3558;865;3040;254;938;296;1069;550;2007
312460;201803;385;1052;279;899;48;175;156;512;204;687
312470;201803;504;1329;325;1013;58;214;105;288;163;502
312480;201803;1182;2985;809;2488;111;375;473;1411;584;1786
312490;201803;1940;4970;1504;4285;251;754;809;2239;1060;2993
312500;201803;806;2140;652;1919;72;257;406;1156;478;1413
312510;201803;3653;10287;2809;8646;473;1488;1197;3582;1670;5070
312520;201803;175;528;148;488;42;138;63;211;105;349
312530;201803;570;1590;497;1495;30;104;412;1241;442;1345
312540;201803;1403;4212;920;3140;197;719;375;1273;572;1992
312550;201803;735;2128;582;1770;58;186;334;927;392;1113
312560;201803;1942;5181;1625;4731;72;280;1302;3735;1374;4015
312570;201803;2218;6022;1721;5279;509;1639;626;1952;1135;3591
312580;201803;539;1663;425;1405;47;188;182;576;229;764
312590;201803;1635;5089;1363;4540;154;654;718;2237;872;2891
312595;201803;1634;5288;1500;5011;260;848;903;3110;1163;3958
312600;201803;906;2460;569;1941;83;342;230;767;313;1109
312610;201803;6219;16454;4169;12717;797;2649;1016;2958;1813;5607
312620;201803;2369;6297;1732;5407;64;273;1331;4242;1395;4515
312630;201803;245;791;209;723;44;173;79;277;123;450
312640;201803;595;1675;396;1322;55;184;133;451;188;635
312650;201803;2054;5600;1415;4324;115;418;911;2644;1026;3062
312660;201803;1362;3438;1056;2974;108;362;700;1897;808;2259
312670;201803;5008;13925;4082;12583;378;1505;2627;7781;3005;9286
312675;201803;1264;3674;1029;3246;83;356;785;2404;868;2760
312680;201803;1324;3888;1138;3615;85;355;853;2632;938;2987
312690;201803;2203;5543;1740;4918;159;495;1248;3421;1407;3916
312695;201803;905;2808;802;2619;79;241;593;1968;672;2209
312700;201803;1925;5439;1423;4502;148;501;799;2483;947;2984
312705;201803;1272;3474;1051;3101;39;143;806;2328;845;2471
312707;201803;1376;4309;1055;3678;90;416;606;2014;696;2430
312710;201803;6252;14621;3653;10649;1090;3483;780;2338;1870;5821
312720;201803;974;2842;735;2427;89;343;363;1140;452;1483
312730;201803;1600;3942;1241;3482;65;205;838;2335;903;2540
312733;201803;1522;4069;1182;3447;41;131;769;2171;810;2302
312735;201803;694;1914;595;1735;82;289;396;1053;478;1342
312737;201803;749;1875;537;1546;98;316;260;708;358;1024
312738;201803;529;1505;358;1171;65;243;146;453;211;696
312740;201803;355;895;204;656;58;202;44;109;102;311
312750;201803;1238;4121;1067;3795;179;730;528;1784;707;2514
312760;201803;1824;5674;1341;4651;264;959;388;1322;652;2281
312770;201803;39037;100765;26565;79273;6281;19872;7744;22544;14025;42416
312780;201803;2441;8015;2133;7460;243;970;1310;4568;1553;5538
312790;201803;288;747;188;605;23;96;74;208;97;304
312800;201803;4690;14396;3679;12288;814;2990;1350;4385;2164;7375
312810;201803;1804;5166;1203;4051;289;1077;317;950;606;2027
312820;201803;1834;5113;1529;4577;68;264;1058;3057;1126;3321
312825;201803;1242;3179;1098;2997;37;121;911;2488;948;2609
312830;201803;2313;6902;1567;5433;385;1440;322;1105;707;2545
312840;201803;1114;3510;869;2989;154;602;278;863;432;1465
312850;201803;788;2183;579;1834;72;272;264;790;336;1062
312860;201803;1417;3690;926;2883;237;780;234;701;471;1481
312870;201803;5784;17162;3746;12717;586;2218;984;3063;1570;5281
312880;201803;1356;3686;1118;3332;56;171;692;2150;748;2321
312890;201803;1975;5571;1298;4187;198;668;483;1578;681;2246
312900;201803;1132;3201;933;2927;83;286;594;1901;677;2187
312910;201803;1530;2933;867;2070;139;349;419;982;558;1331
312920;201803;895;2646;671;2252;131;508;308;958;439;1466
312930;201803;2073;5673;1696;5080;392;1213;737;2187;1129;3400
312940;201803;848;2636;731;2421;140;482;329;1087;469;1569
312950;201803;2505;6833;1893;5856;602;1948;573;1779;1175;3727
312960;201803;1921;5272;1628;4848;118;347;1202;3646;1320;3993
312965;201803;1725;5276;1450;4745;98;343;936;3048;1034;3391
312970;201803;1017;3120;775;2706;186;731;281;931;467;1662
312980;201803;20348;60867;17421;55484;3213;11338;8541;25910;11754;37248
312990;201803;424;1222;286;990;70;284;114;385;184;669
313000;201803;422;1319;343;1178;53;237;144;449;197;686
313005;201803;2545;7632;2219;7075;175;652;1593;4961;1768;5613
313010;201803;4240;12561;3458;11186;666;2380;1900;5963;2566;8343
313020;201803;899;2894;624;2237;95;389;76;222;171;611
313030;201803;1275;3223;879;2602;120;429;461;1313;581;1742
313040;201803;769;2486;645;2196;63;256;333;1071;396;1327
313050;201803;1755;5168;1260;4402;246;1028;346;1066;592;2094
313055;201803;1666;4923;1515;4695;47;159;1323;4084;1370;4243
313060;201803;928;2561;666;2100;208;716;120;334;328;1050
313065;201803;1786;5646;1534;5246;112;456;1147;3889;1259;4345
313070;201803;844;2385;687;2114;106;357;363;1083;469;1440
313080;201803;383;1105;280;895;66;242;75;188;141;430
313090;201803;4654;13138;3948;11936;1006;3251;1927;5757;2933;9008
313100;201803;1421;3793;1101;3311;62;217;846;2546;908;2763
313110;201803;1501;4152;1074;3357;116;441;524;1502;640;1943
313115;201803;2371;7450;2105;6907;341;1207;1032;3198;1373;4405
313120;201803;3629;8896;2827;7863;294;901;1825;5095;2119;5996
313130;201803;26020;74050;21225;64699;3285;11182;10327;29832;13612;41014
313140;201803;514;1261;351;1002;19;70;244;679;263;749
313150;201803;1255;3788;984;3256;277;961;245;785;522;1746
313160;201803;909;2497;707;2152;64;219;441;1296;505;1515
313170;201803;11194;35133;8139;28565;1613;5934;2617;8869;4230;14803
313180;201803;2205;6072;1602;4883;247;824;767;2256;1014;3080
313190;201803;3987;12286;3018;10200;575;2041;882;2804;1457;4845
313200;201803;1081;3222;927;2936;36;139;751;2320;787;2459
313210;201803;3847;11599;3118;10282;482;1722;1715;5504;2197;7226
313220;201803;1618;4529;1136;3581;195;713;420;1175;615;1888
313230;201803;2557;8059;2341;7776;83;263;2032;6792;2115;7055
313240;201803;8330;23102;5670;18310;1085;3896;2198;6604;3283;10500
313250;201803;6144;18884;5063;16869;579;2106;2586;8506;3165;10612
313260;201803;626;1735;427;1326;56;215;181;540;237;755
313270;201803;5405;15490;4317;13644;858;2827;2357;7495;3215;10322
313280;201803;361;1110;259;896;44;169;81;259;125;428
313290;201803;733;2463;584;2236;237;973;122;442;359;1415
313300;201803;1628;4918;1259;4156;341;1217;197;568;538;1785
313310;201803;987;3182;837;2877;155;608;183;524;338;1132
313320;201803;2148;5938;1515;4919;302;1096;661;2139;963;3235
313330;201803;3895;11228;3167;10040;236;1011;2094;6383;2330;7394
313340;201803;1406;3310;1007;2726;153;425;622;1709;775;2134
313350;201803;2162;6419;1573;5183;248;898;516;1563;764;2461
313360;201803;1251;3364;875;2711;156;594;442;1262;598;1856
313370;201803;1221;3805;1103;3575;153;568;614;1898;767;2466
313375;201803;1805;4817;1203;3796;217;800;324;955;541;1755
313380;201803;5280;14348;3918;11852;816;2718;1576;4343;2392;7061
313390;201803;864;2881;779;2729;59;258;511;1740;570;1998
313400;201803;3474;9285;2878;8512;200;591;2294;6749;2494;7340
313410;201803;1210;3286;981;2919;109;370;710;2072;819;2442
313420;201803;15382;35967;8698;24704;1794;5665;1236;3591;3030;9256
313430;201803;874;2655;664;2232;104;419;262;781;366;1200
313440;201803;5807;13060;3888;10590;322;886;2471;6813;2793;7699
313450;201803;608;1763;453;1456;102;341;132;381;234;722
313460;201803;2053;6384;1675;5767;399;1621;711;2233;1110;3854
313470;201803;3038;7742;2486;6989;223;609;1773;5020;1996;5629
313480;201803;854;2510;532;1800;78;298;150;439;228;737
313490;201803;1428;3472;715;2393;238;944;56;189;294;1133
313500;201803;405;1294;326;1094;41;145;123;385;164;530
313505;201803;8900;25412;7945;24218;324;1129;6861;20939;7185;22068
313507;201803;1431;3749;1217;3455;59;221;953;2681;1012;2902
313510;201803;12722;36394;10723;32841;1400;4750;5446;16236;6846;20986
313520;201803;13043;39386;10841;35445;886;3333;7422;23867;8308;27200
313530;201803;509;1485;420;1338;23;78;197;596;220;674
313535;201803;2416;6836;2127;6307;173;486;1456;4283;1629;4769
313540;201803;836;2611;637;2082;149;508;214;679;363;1187
313545;201803;1164;4043;1006;3725;171;685;553;1968;724;2653
313550;201803;1730;5335;1470;4811;337;1173;715;2264;1052;3437
313560;201803;2448;5153;1817;4396;83;207;1512;3619;1595;3826
313570;201803;935;2992;759;2635;187;717;300;994;487;1711
313580;201803;5419;15141;4267;13285;681;2249;2209;7128;2890;9377
313590;201803;906;2656;699;2333;276;1006;204;691;480;1697
313600;201803;3653;10434;3079;9505;173;680;2405;7326;2578;8006
313610;201803;984;2706;808;2378;120;355;499;1450;619;1805
313620;201803;5490;15630;4535;13934;905;2998;2037;6113;2942;9111
313630;201803;7935;20748;5599;17245;819;2759;2816;8816;3635;11575
313640;201803;983;2451;627;1936;194;649;201;585;395;1234
313650;201803;1792;5633;1519;5188;110;456;1004;3426;1114;3882
313652;201803;783;2712;730;2599;126;503;436;1480;562;1983
313655;201803;994;2894;806;2609;57;213;576;1832;633;2045
313657;201803;1307;3626;1004;3136;58;259;734;2152;792;2411
313660;201803;829;2544;699;2278;121;478;349;1060;470;1538
313665;201803;4332;12591;3475;10984;533;1898;1863;5668;2396;7566
313670;201803;41267;112445;28506;88742;5455;18457;10052;29838;15507;48295
313680;201803;977;2762;837;2544;73;252;524;1550;597;1802
313690;201803;802;2742;654;2422;136;519;205;784;341;1303
313695;201803;1539;4575;1223;4031;97;371;852;2788;949;3159
313700;201803;3179;10669;2745;10094;264;1003;2157;8008;2421;9011
313710;201803;1406;3592;1019;2991;105;320;627;1833;732;2153
313720;201803;5395;15947;3992;12950;688;2506;1431;4241;2119;6747
313730;201803;1259;3165;958;2747;82;233;611;1710;693;1943
313740;201803;1740;6292;1450;5529;347;1457;161;546;508;2003
313750;201803;1886;5451;1479;4629;349;1215;507;1437;856;2652
313753;201803;1990;5090;1423;4165;176;577;778;2242;954;2819
313760;201803;4900;14273;3656;11781;871;3050;1268;3840;2139;6890
313770;201803;3537;10455;2883;9483;309;1067;1879;6216;2188;7283
313780;201803;3932;10863;2975;9263;396;1398;827;2622;1223;4020
313790;201803;443;1443;414;1390;68;240;229;741;297;981
313800;201803;1289;3197;1044;2845;66;215;779;2133;845;2348
313810;201803;1564;4283;1286;3874;101;346;910;2761;1011;3107
313820;201803;12406;31483;9061;25622;1422;4565;3574;9487;4996;14052
313830;201803;325;984;283;910;58;197;131;436;189;633
313835;201803;877;2759;759;2548;75;300;414;1325;489;1625
313840;201803;6324;17403;4747;14711;1171;3884;1029;3159;2200;7043
313850;201803;978;2576;816;2311;119;407;441;1132;560;1539
313860;201803;2632;7550;1953;6122;371;1238;665;1941;1036;3179
313862;201803;1396;3302;797;2380;68;209;427;1240;495;1449
313865;201803;2164;6328;1934;5987;169;565;1436;4385;1605;4950
313867;201803;1080;3631;917;3285;292;1095;360;1277;652;2372
313868;201803;1661;5410;1409;4887;113;475;1036;3534;1149;4009
313870;201803;792;2237;609;1916;125;425;206;577;331;1002
313880;201803;1352;3842;1052;3345;215;747;394;1117;609;1864
313890;201803;1981;4771;1458;4091;167;519;887;2545;1054;3064
313900;201803;3499;11495;2863;10170;824;3202;656;2309;1480;5511
313910;201803;622;1954;480;1674;118;436;84;289;202;725
313920;201803;2966;9684;2485;8737;488;1741;1268;4529;1756;6270
313925;201803;1688;4526;1306;3810;256;706;737;2184;993;2890
313930;201803;5985;20658;5086;19066;453;1656;3477;13634;3930;15290
313940;201803;8191;25149;6039;21360;1317;5301;1528;5859;2845;11160
313950;201803;4363;10887;3225;9258;650;2329;1691;4579;2341;6908
313960;201803;5272;13522;3629;10808;782;2522;1185;3328;1967;5850
313970;201803;1290;3809;1144;3563;72;290;699;2179;771;2469
313980;201803;1324;3725;869;2930;130;497;306;986;436;1483
313990;201803;1661;5810;1326;4977;390;1599;364;1251;754;2850
314000;201803;8827;25398;7636;23192;599;2272;5069;15126;5668;17398
314010;201803;1264;3258;1032;2946;49;188;795;2221;844;2409
314015;201803;2052;5840;1604;5134;212;803;875;2724;1087;3527
314020;201803;518;1483;318;1056;60;231;63;201;123;432
314030;201803;792;2468;612;2073;84;311;277;926;361;1237
314040;201803;723;2026;592;1769;103;333;264;754;367;1087
314050;201803;1516;4449;1175;3773;189;700;537;1574;726;2274
314053;201803;1642;5014;1391;4605;185;608;925;3214;1110;3822
314055;201803;2221;6298;1935;5868;52;229;1615;4878;1667;5107
314060;201803;1136;3272;883;2845;52;200;606;1907;658;2107
314070;201803;4201;12206;3307;10537;780;2554;1206;3729;1986;6283
314080;201803;1737;5188;1232;4062;212;831;361;1045;573;1876
314085;201803;2026;6404;1691;5874;395;1471;727;2500;1122;3971
314090;201803;3511;10857;3046;10076;278;1102;2000;6543;2278;7645
314100;201803;3139;7579;2586;6827;62;136;2145;5773;2207;5909
314110;201803;4007;12247;3402;11011;577;2091;1663;4993;2240;7084
314120;201803;833;1955;382;1202;88;323;61;180;149;503
314130;201803;755;2129;390;1333;55;208;126;425;181;633
314140;201803;4630;13931;3590;11769;653;2281;1481;4734;2134;7015
314150;201803;1460;3896;1133;3326;112;344;710;2021;822;2365
314160;201803;2412;6454;1778;5364;254;807;812;2527;1066;3334
314170;201803;997;2916;820;2557;101;345;472;1385;573;1730
314180;201803;5093;14932;4301;13645;639;2152;2362;7587;3001;9739
314190;201803;726;2075;531;1759;100;356;251;845;351;1201
314200;201803;2826;8300;2377;7491;149;605;1706;5176;1855;5781
314210;201803;1915;5227;1619;4739;141;450;983;2815;1124;3265
314220;201803;1234;3656;885;3002;245;925;239;736;484;1661
314225;201803;1217;3503;1065;3287;72;244;785;2438;857;2682
314230;201803;725;2063;629;1941;106;362;370;1136;476;1498
314240;201803;1047;3021;834;2683;204;727;326;1060;530;1787
314250;201803;522;1523;347;1128;62;214;124;365;186;579
314260;201803;943;3041;783;2717;181;727;315;982;496;1709
314270;201803;3084;9202;2502;8195;122;499;1850;5924;1972;6423
314280;201803;3289;8061;2058;5942;358;1142;771;2088;1129;3230
314290;201803;4425;11943;3738;10799;482;1426;2387;6798;2869;8224
314300;201803;1478;4623;1132;3844;295;1064;329;1091;624;2155
314310;201803;5152;14155;3815;11785;1185;3926;873;2514;2058;6440
314315;201803;851;3138;747;2909;62;300;530;2004;592;2304
314320;201803;2778;7738;1901;6255;436;1535;681;2248;1117;3783
314330;201803;47274;136976;37402;120170;10938;36844;8641;28155;19579;64999
314340;201803;2395;6226;1297;4108;239;884;225;545;464;1429
314345;201803;1291;4087;1122;3781;138;484;721;2376;859;2860
314350;201803;963;2797;673;2237;144;520;148;463;292;983
314360;201803;646;1966;400;1412;63;258;98;317;161;575
314370;201803;594;1758;512;1622;41;154;378;1169;419;1323
314380;201803;1135;3349;790;2664;213;808;109;368;322;1176
314390;201803;11494;31668;7811;24747;1698;5727;1901;5452;3599;11179
314400;201803;4100;12256;3305;10934;934;3208;1152;3937;2086;7145
314410;201803;2649;7744;1905;6280;338;1226;662;2352;1000;3578
314420;201803;737;1940;575;1707;19;103;445;1264;464;1367
314430;201803;6181;17052;4789;14617;991;3236;1669;5078;2660;8314
314435;201803;1406;4251;1200;3912;50;225;879;2818;929;3043
314437;201803;909;2411;704;2117;36;136;412;1247;448;1383
314440;201803;519;1527;408;1331;116;430;126;362;242;792
314450;201803;1368;3895;1144;3530;154;584;651;1874;805;2458
314460;201803;3485;11171;2586;9138;627;2356;402;1402;1029;3758
314465;201803;2199;6588;1953;6101;66;281;1532;4671;1598;4952
314467;201803;888;2543;752;2321;24;74;590;1811;614;1885
314470;201803;2158;6563;1797;5808;376;1319;729;2201;1105;3520
314480;201803;5599;17482;4014;13786;736;2746;839;2608;1575;5354
314490;201803;837;2417;638;1995;96;336;368;1082;464;1418
314500;201803;1699;4563;1208;3717;251;796;394;1195;645;1991
314505;201803;1885;5033;1610;4648;121;417;1161;3301;1282;3718
314510;201803;1674;4551;1146;3772;256;915;440;1427;696;2342
314520;201803;3498;11366;2440;8917;438;1845;245;735;683;2580
314530;201803;5424;18420;5006;17621;536;2030;3387;12029;3923;14059
314535;201803;2553;6967;2114;6314;141;478;1614;4746;1755;5224
314537;201803;1075;3195;820;2749;76;292;544;1778;620;2070
314540;201803;387;1063;268;835;38;143;111;328;149;471
314545;201803;1594;4422;1421;4178;61;186;1185;3642;1246;3828
314550;201803;655;1689;477;1436;55;212;222;600;277;812
314560;201803;3942;12804;3181;11121;545;2090;1038;3425;1583;5515
314570;201803;299;861;234;735;36;122;108;341;144;463
314580;201803;475;1546;353;1281;83;325;49;173;132;498
314585;201803;718;2301;538;1895;77;344;227;736;304;1080
314587;201803;1913;5558;1516;4893;245;730;816;2689;1061;3419
314590;201803;2741;8714;2079;7246;384;1457;668;2214;1052;3671
314600;201803;1713;5107;1068;3785;250;998;112;349;362;1347
314610;201803;7672;22415;5906;19340;1196;4480;2328;7346;3524;11826
314620;201803;1806;4835;1472;4355;73;239;1197;3497;1270;3736
314625;201803;1477;4626;1307;4369;108;536;965;3041;1073;3577
314630;201803;4827;13543;4048;12355;160;693;3249;9807;3409;10500
314640;201803;558;1468;417;1226;81;276;185;486;266;762
314650;201803;933;2459;631;1968;66;252;255;715;321;967
314655;201803;1524;4398;1098;3564;238;758;445;1453;683;2211
314660;201803;317;789;208;584;12;28;111;293;123;321
314670;201803;1603;4075;1161;3352;79;284;720;2027;799;2311
314675;201803;1750;4922;1510;4506;115;411;1121;3272;1236;3683
314690;201803;2046;6247;1559;5394;488;1879;327;1093;815;2972
314700;201803;9270;28568;6219;22031;1436;5641;1217;4157;2653;9798
314710;201803;7919;23241;5694;18445;1128;4001;1180;3387;2308;7388
314720;201803;2162;6854;1617;5671;361;1377;397;1378;758;2755
314730;201803;1986;5779;1499;4863;379;1303;417;1263;796;2566
314740;201803;2735;8205;2244;7310;239;906;1215;3861;1454;4767
314750;201803;337;981;262;825;25;89;146;440;171;529
314760;201803;1812;5754;1276;4486;194;778;286;816;480;1594
314770;201803;1031;3127;527;1801;41;149;129;377;170;526
314780;201803;317;791;216;644;46;160;109;302;155;462
314790;201803;10201;29688;7557;24801;2486;9060;1044;3019;3530;12079
314795;201803;1438;4054;1236;3704;62;266;957;2752;1019;3018
314800;201803;11037;29664;6683;21151;1417;4817;961;2727;2378;7544
314810;201803;8972;25523;6638;21339;1840;6096;1564;5379;3404;11475
314820;201803;877;2339;644;1949;92;342;353;1010;445;1352
314830;201803;1495;4790;1286;4391;300;1112;605;2038;905;3150
314840;201803;894;2977;717;2708;77;409;465;1669;542;2078
314850;201803;1934;5086;1535;4437;87;315;1231;3506;1318;3821
314860;201803;3165;10042;2681;9073;408;1511;1553;5112;1961;6623
314870;201803;5813;16376;4661;14758;415;1405;3394;10817;3809;12222
314875;201803;1694;5329;1553;5146;98;290;1335;4460;1433;4750
314880;201803;891;2248;706;1996;36;76;497;1483;533;1559
314890;201803;452;1325;330;1064;52;197;117;331;169;528
314900;201803;649;1777;507;1536;115;369;177;534;292;903
314910;201803;1631;4976;1260;4370;281;1154;586;1910;867;3064
314915;201803;2224;6932;1910;6361;144;593;1282;4128;1426;4721
314920;201803;436;1161;316;997;17;57;189;578;206;635
314930;201803;5201;15936;4067;13673;874;3140;1319;4242;2193;7382
314940;201803;384;1068;331;966;35;101;196;536;231;637
314950;201803;380;1060;257;857;29;111;104;325;133;436
314960;201803;719;1983;552;1655;58;212;332;920;390;1132
314970;201803;603;1896;494;1705;100;389;213;705;313;1094
314980;201803;1234;3600;980;3216;274;999;168;528;442;1527
314990;201803;2220;6638;1530;5055;342;1283;303;855;645;2138
314995;201803;1511;4491;1273;4092;108;448;759;2308;867;2756
315000;201803;1041;2904;816;2531;84;305;502;1509;586;1814
315010;201803;395;1194;295;984;62;251;109;320;171;571
315015;201803;2083;6234;1891;5969;213;729;1232;3973;1445;4702
315020;201803;820;2470;597;2025;87;343;282;899;369;1242
315030;201803;562;1639;411;1345;113;398;84;244;197;642
315040;201803;816;2432;736;2274;112;366;448;1372;560;1738
315050;201803;1116;3082;877;2738;85;311;464;1438;549;1749
315053;201803;1110;3141;886;2720;91;348;494;1470;585;1818
315057;201803;1589;5260;1408;4887;204;711;834;2903;1038;3614
315060;201803;614;1949;417;1528;96;365;81;300;177;665
315070;201803;627;1798;458;1470;123;419;128;382;251;801
315080;201803;2583;8143;2045;6945;456;1546;901;3073;1357;4619
315090;201803;783;2580;612;2208;124;481;176;605;300;1086
315100;201803;1130;3643;754;2695;137;569;271;886;408;1455
315110;201803;1362;3710;1064;3195;140;445;505;1521;645;1966
315120;201803;11839;28431;8534;23746;1096;3118;4354;12693;5450;15811
315130;201803;1232;3807;1031;3397;188;712;379;1177;567;1889
315140;201803;2737;8018;2159;6918;429;1561;972;2809;1401;4370
315150;201803;4099;10707;2938;8733;469;1540;1226;3562;1695;5102
315160;201803;1425;3715;962;2962;196;631;376;1123;572;1754
315170;201803;1474;4686;1047;3694;225;822;160;569;385;1391
315180;201803;16733;44321;8971;28435;1386;4953;1928;5382;3314;10335
315190;201803;1971;4782;1590;4234;296;816;1063;2787;1359;3603
315200;201803;3564;11076;2720;9503;816;3085;582;1988;1398;5073
315210;201803;7728;21549;5791;17339;767;2541;2465;6791;3232;9332
315213;201803;1105;3114;959;2903;29;93;766;2305;795;2398
315217;201803;2406;7848;1953;7002;136;673;1290;4453;1426;5126
315220;201803;8585;24284;6956;21433;2053;6633;2097;6414;4150;13047
315230;201803;3007;7610;2644;7180;79;137;2363;6680;2442;6817
315240;201803;2549;7921;2214;7364;565;2029;1091;3536;1656;5565
315250;201803;9652;27974;7363;23657;1344;4712;2913;9059;4257;13771
315260;201803;924;2763;542;1881;93;340;51;147;144;487
315270;201803;744;2302;527;1850;92;394;135;406;227;800
315280;201803;2686;7203;1580;4927;360;1187;247;749;607;1936
315290;201803;1203;3169;738;2406;220;763;175;593;395;1356
315300;201803;695;1766;480;1493;242;813;109;356;351;1169
315310;201803;1284;3808;988;3225;96;346;552;1723;648;2069
315320;201803;662;1974;488;1663;55;264;213;672;268;936
315330;201803;718;2573;407;1683;75;341;105;396;180;737
315340;201803;3115;8255;2385;7181;256;836;1362;4040;1618;4876
315350;201803;1549;4307;1152;3635;104;365;556;1721;660;2086
315360;201803;1640;5159;1221;4229;217;821;423;1378;640;2199
315370;201803;437;1330;366;1178;62;196;163;516;225;712
315380;201803;187;604;143;505;35;138;35;115;70;253
315390;201803;1163;3597;861;2953;171;624;261;843;432;1467
315400;201803;4045;11717;3211;10134;466;1535;1641;5064;2107;6599
315410;201803;2261;5386;1767;4696;396;1173;663;1701;1059;2874
315415;201803;1138;3405;938;3089;269;993;350;1131;619;2124
315420;201803;1114;3380;770;2694;161;572;105;326;266;898
315430;201803;3459;8954;2516;7417;612;2063;856;2380;1468;4443
315440;201803;950;2690;801;2442;104;392;424;1174;528;1566
315445;201803;1968;5133;1484;4386;170;543;963;2805;1133;3348
315450;201803;2211;6614;1919;6138;270;844;1202;3925;1472;4769
315460;201803;29203;89649;25188;81955;7560;26090;7682;23857;15242;49947
315470;201803;445;1306;355;1147;31;110;180;564;211;674
315480;201803;1418;4157;965;3184;209;730;222;729;431;1459
315490;201803;2897;7437;2062;6243;317;1050;712;2068;1029;3118
315500;201803;488;1392;301;960;23;88;138;389;161;477
315510;201803;1251;3555;1075;3279;45;183;887;2656;932;2839
315520;201803;1094;3145;859;2760;57;224;560;1744;617;1968
315530;201803;620;1969;499;1689;165;610;167;527;332;1137
315540;201803;1140;3281;833;2696;123;458;319;1002;442;1460
315550;201803;1721;4762;1276;4052;270;979;439;1328;709;2307
315560;201803;5917;19407;5293;18307;410;1557;3563;12371;3973;13928
315570;201803;1834;5532;1579;5038;119;461;870;2682;989;3143
315580;201803;2201;5823;1725;5039;403;1338;543;1537;946;2875
315590;201803;887;2462;725;2199;94;328;351;1025;445;1353
315600;201803;2350;7943;1766;6780;265;1016;957;3816;1222;4832
315610;201803;921;2461;716;2074;132;478;298;712;430;1190
315620;201803;308;1020;281;978;58;201;153;575;211;776
315630;201803;836;2489;692;2211;165;564;193;543;358;1107
315640;201803;372;1018;313;923;39;132;164;462;203;594
315645;201803;860;2344;597;1892;180;615;149;435;329;1050
315650;201803;1738;4588;1370;4058;65;273;1047;3026;1112;3299
315660;201803;2478;6239;1885;5239;123;352;1278;3465;1401;3817
315670;201803;12074;35883;9917;31893;2057;7036;4355;13541;6412;20577
315680;201803;2900;9258;2209;7887;508;2009;817;2872;1325;4881
315690;201803;2731;7382;1790;5686;419;1401;419;1437;838;2838
315700;201803;7046;20904;5643;18090;939;3196;2595;8042;3534;11238
315710;201803;1867;4975;1333;4097;84;365;851;2461;935;2826
315720;201803;4077;12270;3528;11265;202;947;2357;7173;2559;8120
315725;201803;1566;4501;1322;4164;175;566;918;2939;1093;3505
315727;201803;565;1587;424;1315;70;247;194;552;264;799
315730;201803;677;2102;602;1937;82;301;290;884;372;1185
315733;201803;1287;3432;943;2828;186;659;338;938;524;1597
315737;201803;1124;3361;891;2916;39;171;623;2004;662;2175
315740;201803;956;2798;759;2390;133;482;359;1012;492;1494
315750;201803;1195;3369;1011;3062;86;278;695;2109;781;2387
315760;201803;1133;2860;1059;2771;31;62;965;2540;996;2602
315765;201803;1785;5000;1499;4631;39;161;1340;4139;1379;4300
315770;201803;1154;3596;984;3340;341;1264;311;1016;652;2280
315780;201803;24432;73000;21159;66861;2468;9137;11840;35516;14308;44653
315790;201803;3558;11343;3063;10403;254;870;2026;7057;2280;7927
315800;201803;1201;4649;907;3794;180;828;190;739;370;1567
315810;201803;1280;3329;1115;3085;72;262;873;2295;945;2557
315820;201803;2338;7229;2008;6674;240;921;1344;4371;1584;5292
315830;201803;1109;3354;820;2824;63;258;369;1212;432;1470
315840;201803;762;1944;477;1399;60;195;180;483;240;678
315850;201803;1017;3308;895;3105;195;736;437;1412;632;2148
315860;201803;495;1559;345;1251;75;309;101;342;176;651
315870;201803;444;1223;367;1107;24;94;241;681;265;775
315880;201803;1105;2935;812;2476;67;250;310;892;377;1142
315890;201803;1452;4694;1262;4357;398;1465;504;1667;902;3132
315895;201803;5671;16423;4548;14078;656;2312;2076;5920;2732;8232
315900;201803;814;2181;714;2040;61;212;558;1522;619;1734
315910;201803;479;1519;422;1422;72;264;268;868;340;1132
315920;201803;1558;4228;810;2593;160;529;200;592;360;1121
315930;201803;1022;2533;708;2024;145;424;282;785;427;1209
315935;201803;793;2559;681;2338;151;569;206;724;357;1293
315940;201803;604;1841;504;1637;67;237;257;825;324;1062
315950;201803;1186;3393;1011;3099;147;450;713;2202;860;2652
315960;201803;3470;10303;2219;7878;706;2930;101;214;807;3144
315970;201803;638;1845;510;1661;51;164;363;1213;414;1377
315980;201803;3621;8502;2109;5967;464;1428;697;1794;1161;3222
315990;201803;3684;9831;2907;8519;323;1050;1652;4755;1975;5805
316000;201803;520;1493;419;1330;73;282;172;500;245;782
316010;201803;677;2124;536;1841;55;237;285;897;340;1134
316020;201803;953;3000;817;2740;81;380;533;1658;614;2038
316030;201803;2943;8433;2148;6991;234;805;1324;4378;1558;5183
316040;201803;2976;9705;2259;8262;324;1232;698;2745;1022;3977
316045;201803;1895;5537;1778;5357;143;374;1424;4401;1567;4775
316050;201803;350;1070;266;909;45;183;137;438;182;621
316060;201803;688;1913;521;1654;54;223;312;904;366;1127
316070;201803;5602;16472;4670;14635;839;2882;2081;6268;2920;9150
316080;201803;699;2337;577;2073;155;619;67;229;222;848
316090;201803;472;1444;331;1139;51;203;124;389;175;592
316095;201803;1348;4251;1162;3894;217;763;602;1993;819;2756
316100;201803;2525;7985;1837;6366;345;1310;534;1732;879;3042
316105;201803;865;2408;647;2048;99;334;380;1197;479;1531
316110;201803;11765;37401;10244;34754;1365;4839;6528;22301;7893;27140
316120;201803;1006;3135;734;2454;150;517;197;560;347;1077
316130;201803;1381;3163;823;2292;99;304;379;1022;478;1326
316140;201803;1059;2919;725;2341;143;489;328;1057;471;1546
316150;201803;1538;3888;1300;3507;230;703;614;1550;844;2253
316160;201803;1074;3097;873;2730;91;328;507;1520;598;1848
316165;201803;884;2274;692;1974;111;382;377;1019;488;1401
316170;201803;1113;3069;846;2649;107;395;462;1371;569;1766
316180;201803;1355;4128;919;3165;190;723;109;294;299;1017
316190;201803;2553;7642;1495;5018;276;931;462;1402;738;2333
316200;201803;3399;10402;2530;8707;563;2228;562;1800;1125;4028
316210;201803;4260;13042;3150;10662;1037;3728;360;1217;1397;4945
316220;201803;607;1901;410;1456;82;317;44;189;126;506
316225;201803;1289;3244;1002;2746;71;261;708;1824;779;2085
316230;201803;411;1117;320;987;39;117;159;510;198;627
316240;201803;5930;17682;5239;16645;566;1855;3816;12118;4382;13973
316245;201803;3008;10333;2732;9872;170;924;2114;7396;2284;8320
316250;201803;9104;24336;6706;20036;1768;5763;1518;4349;3286;10112
316255;201803;2692;7800;2331;7259;312;1049;1570;4917;1882;5966
316257;201803;1236;3175;865;2564;113;374;412;1177;525;1551
316260;201803;1849;4926;1397;4234;46;160;782;2453;828;2613
316265;201803;1270;3462;929;2859;52;172;615;1856;667;2028
316270;201803;3370;11024;2964;10084;608;2188;1254;4099;1862;6287
316280;201803;3037;9429;2704;8788;374;1367;1463;4583;1837;5950
316290;201803;3187;9545;2545;8266;424;1589;889;2856;1313;4445
316292;201803;4289;12271;3586;11106;385;1361;2487;7554;2872;8915
316294;201803;725;2212;541;1880;91;355;102;356;193;711
316295;201803;2366;6981;2024;6356;97;426;1497;4538;1594;4964
316300;201803;963;3079;813;2790;60;239;520;1797;580;2036
316310;201803;958;2364;544;1708;93;320;221;681;314;1001
316320;201803;549;1623;432;1420;74;275;162;517;236;792
316330;201803;1055;3040;797;2509;67;247;536;1630;603;1877
316340;201803;1054;3129;782;2582;88;371;400;1234;488;1605
316350;201803;1218;3768;1071;3525;130;461;682;2234;812;2695
316360;201803;689;1819;553;1607;62;198;390;1110;452;1308
316370;201803;4450;13051;3564;11331;854;3060;947;2661;1801;5721
316380;201803;1612;4086;1240;3580;46;142;915;2628;961;2770
316390;201803;851;2321;649;1978;176;598;224;662;400;1260
316400;201803;1270;3762;872;2994;144;515;317;1040;461;1555
316410;201803;1003;3110;862;2889;69;242;688;2284;757;2526
316420;201803;1723;5325;1528;5063;101;418;1188;3867;1289;4285
316430;201803;865;2534;565;1921;115;410;126;415;241;825
316440;201803;658;2103;499;1834;140;593;67;235;207;828
316443;201803;561;1666;443;1437;106;383;119;372;225;755
316447;201803;1722;4822;1511;4505;59;198;1239;3684;1298;3882
316450;201803;2147;6853;1707;5939;199;737;1114;3834;1313;4571
316460;201803;847;2439;744;2263;224;724;354;1047;578;1771
316470;201803;5739;17516;4575;15190;952;3582;1490;4606;2442;8188
316480;201803;193;601;164;540;32;118;66;203;98;321
316490;201803;318;892;233;709;33;110;92;245;125;355
316500;201803;1200;4029;780;2899;153;617;105;354;258;971
316510;201803;618;2257;556;2126;141;592;217;837;358;1429
316520;201803;965;2786;775;2442;135;500;312;907;447;1407
316530;201803;955;2834;725;2391;122;516;310;908;432;1424
316540;201803;713;2176;622;2013;105;405;217;640;322;1045
316550;201803;1238;3939;1115;3707;115;448;780;2534;895;2982
316553;201803;3017;9566;2060;7201;554;2091;338;1068;892;3159
316555;201803;2607;8734;2359;8386;138;547;1838;6658;1976;7205
316556;201803;641;1577;460;1284;32;96;249;618;281;714
316557;201803;870;2989;770;2802;319;1220;230;792;549;2012
316560;201803;266;846;200;752;54;241;48;167;102;408
316570;201803;1109;3520;988;3280;300;1014;314;1047;614;2061
316580;201803;371;941;233;678;53;171;82;211;135;382
316590;201803;1315;3595;981;2982;177;595;532;1504;709;2099
316600;201803;963;3065;855;2858;150;565;448;1471;598;2036
316610;201803;578;1949;486;1779;68;335;291;1008;359;1343
316620;201803;2043;5931;1759;5500;110;410;1278;3989;1388;4399
316630;201803;1484;4585;1184;3988;348;1155;432;1614;780;2769
316640;201803;141;398;114;346;25;90;56;139;81;229
316650;201803;975;3273;803;3012;63;261;517;1996;580;2257
316660;201803;186;473;75;239;8;38;12;30;20;68
316670;201803;1948;5220;1488;4435;449;1414;416;1175;865;2589
316680;201803;2001;5273;1560;4558;146;478;1101;3110;1247;3588
316690;201803;1056;3369;882;3039;220;853;324;1074;544;1927
316695;201803;999;3027;868;2791;56;236;596;1865;652;2101
316700;201803;364;971;317;914;16;78;227;601;243;679
316710;201803;2634;9376;2118;8265;629;2505;653;2681;1282;5186
316720;201803;18376;54769;14131;46114;2957;10342;5088;15924;8045;26266
316730;201803;331;983;278;870;72;256;109;302;181;558
316740;201803;661;2058;601;1972;59;259;424;1375;483;1634
316750;201803;398;1272;309;1088;60;238;108;370;168;608
316760;201803;3583;11487;2961;10381;1291;4803;893;3118;2184;7921
316770;201803;1449;3727;1198;3384;39;139;1012;2878;1051;3017
316780;201803;581;1836;465;1609;140;545;53;152;193;697
316790;201803;701;1962;515;1620;122;409;171;523;293;932
316800;201803;5354;16280;4445;14568;466;1781;2605;8213;3071;9994
316805;201803;913;2127;797;1996;18;27;713;1864;731;1891
316810;201803;512;1482;387;1247;88;321;160;478;248;799
316820;201803;327;818;170;536;27;98;28;93;55;191
316830;201803;617;1901;523;1728;100;380;298;948;398;1328
316840;201803;2567;7490;2203;6817;428;1493;1067;3129;1495;4622
316850;201803;1992;5469;1499;4590;200;719;737;2165;937;2884
316860;201803;16896;48867;13503;43393;2654;9699;5665;17603;8319;27302
316870;201803;6283;18892;4853;15882;1100;3874;1449;4504;2549;8378
316880;201803;833;2342;709;2153;151;532;293;849;444;1381
316890;201803;1200;2805;792;2247;164;570;435;1088;599;1658
316900;201803;2284;6506;1816;5534;415;1406;588;1603;1003;3009
316905;201803;463;1468;380;1286;90;323;158;529;248;852
316910;201803;854;2489;581;1977;147;578;60;191;207;769
316920;201803;1626;4286;1108;3460;209;714;477;1487;686;2201
316930;201803;7739;24582;5785;20613;1071;4133;1160;3990;2231;8123
316935;201803;3930;11412;2780;9159;664;2331;758;2462;1422;4793
316940;201803;6590;20584;5095;17241;1008;3755;1505;4735;2513;8490
316950;201803;1720;4372;1357;3851;67;228;1062;2951;1129;3179
316960;201803;4662;11381;3521;9770;533;1646;2131;5824;2664;7470
316970;201803;3097;9535;2789;8937;651;2185;1058;3193;1709;5378
316980;201803;774;2335;536;1854;144;538;65;226;209;764
316990;201803;9786;28998;7434;23912;2011;6861;729;2156;2740;9017
317000;201803;2635;8418;2449;8146;198;661;1784;6208;1982;6869
317005;201803;2435;7200;2030;6488;361;1193;1034;3254;1395;4447
317010;201803;22344;54569;13512;40930;3302;10984;2835;9238;6137;20222
317020;201803;57941;148406;33774;102545;6477;21472;7619;21044;14096;42516
317030;201803;674;1917;541;1722;33;135;380;1186;413;1321
317040;201803;9858;26688;7254;22135;1775;5681;2700;8304;4475;13985
317043;201803;770;1944;618;1730;121;371;362;1002;483;1373
317047;201803;1172;2908;825;2385;81;225;524;1503;605;1728
317050;201803;1287;4150;920;3282;138;514;319;1043;457;1557
317052;201803;2256;6876;1900;6257;240;847;1245;4050;1485;4897
317057;201803;1644;4245;1189;3469;55;218;794;2250;849;2468
317060;201803;408;1122;225;723;41;146;73;207;114;353
317065;201803;1253;3634;1050;3276;51;227;793;2357;844;2584
317070;201803;7919;23259;5272;17646;1135;4232;857;2663;1992;6895
317075;201803;950;2834;676;2233;139;466;104;313;243;779
317080;201803;5798;14762;4576;12728;1503;4354;1173;3007;2676;7361
317090;201803;4411;13999;4059;13444;389;1334;2958;9821;3347;11155
317100;201803;2583;6534;1776;5224;592;1842;518;1483;1110;3325
317103;201803;1810;6001;1608;5624;205;940;964;3146;1169;4086
317107;201803;1308;3781;1083;3335;63;255;683;1914;746;2169
317110;201803;594;1370;322;979;45;168;115;364;160;532
317115;201803;1111;3302;926;2927;76;235;656;2080;732;2315
317120;201803;11600;34521;9071;29958;1485;5467;4377;13899;5862;19366
317130;201803;7964;20839;5598;16838;1218;3980;1813;5383;3031;9363
317140;201803;569;1741;492;1602;61;200;292;952;353;1152
317150;201803;987;2509;789;2269;47;172;621;1736;668;1908
317160;201803;3568;9013;2509;7417;259;799;1531;4545;1790;5344
317170;201803;1962;5141;1383;4087;218;744;482;1227;700;1971
317180;201803;1607;5325;1261;4515;296;1129;299;1007;595;2136
317190;201803;1298;3623;977;3114;73;253;631;1978;704;2231
317200;201803;4436;12742;3400;10765;839;2901;771;2239;1610;5140
317210;201803;991;2756;810;2479;57;243;577;1765;634;2008
317220;201803;268;891;241;828;57;213;96;313;153;526
320010;201803;4499;13675;3754;12214;456;1625;2282;7243;2738;8868
320013;201803;1657;5055;1198;3987;196;649;519;1792;715;2441
320016;201803;3014;8049;2459;7254;141;415;1947;5730;2088;6145
320020;201803;3649;10700;2859;9215;750;2539;878;2921;1628;5460
320030;201803;1420;4379;1012;3494;289;1066;274;873;563;1939
320035;201803;1644;4767;1410;4374;437;1483;604;1803;1041;3286
320040;201803;3173;9803;2605;8735;464;1683;1207;4003;1671;5686
320050;201803;1643;4157;1452;3836;313;891;752;1929;1065;2820
320060;201803;9381;28178;6933;23091;1419;5166;2047;6525;3466;11691
320070;201803;1378;4172;1046;3477;209;737;322;1051;531;1788
320080;201803;5279;14554;3909;11869;794;2508;1443;4350;2237;6858
320090;201803;6621;18869;5041;15667;1232;4007;2027;6112;3259;10119
320100;201803;2432;7363;1899;6306;509;1767;707;2294;1216;4061
320110;201803;1237;3416;991;2975;238;748;313;944;551;1692
320115;201803;1756;5987;1538;5587;737;2770;421;1579;1158;4349
320120;201803;13957;38994;10236;32208;2126;7298;3151;9569;5277;16867
320130;201803;33940;102220;29210;93697;4871;17180;15507;48396;20378;65576
320140;201803;2848;8678;2077;7018;484;1839;582;1922;1066;3761
320150;201803;12482;34428;9006;27554;2726;8894;1119;3105;3845;11999
320160;201803;4988;15078;3965;13037;782;2777;1728;5600;2510;8377
320170;201803;1529;4672;1166;3903;292;968;469;1566;761;2534
320180;201803;692;2301;564;2036;197;749;132;485;329;1234
320190;201803;2909;9743;2223;8146;560;2133;431;1571;991;3704
320200;201803;950;2803;724;2396;222;831;194;643;416;1474
320210;201803;4466;11961;3520;10269;580;1862;1789;4986;2369;6848
320220;201803;2571;7326;2003;6344;336;1137;1092;3462;1428;4599
320225;201803;1249;4108;902;3228;313;1180;133;475;446;1655
320230;201803;4211;12724;3312;11152;883;3243;1266;4232;2149;7475
320240;201803;12829;35355;9983;30604;2152;7096;4001;12220;6153;19316
320245;201803;2840;9104;2435;8245;951;3340;597;1989;1548;5329
320250;201803;1865;5546;1299;4212;307;1123;269;790;576;1913
320255;201803;1621;5476;1433;5141;549;2024;571;2139;1120;4163
320260;201803;1001;3006;730;2368;212;763;193;532;405;1295
320265;201803;2333;7441;1986;6753;843;2986;533;1796;1376;4782
320270;201803;2238;6613;1737;5602;334;1143;854;2776;1188;3919
320280;201803;5334;15782;4466;14162;1155;3936;1375;4244;2530;8180
320290;201803;1300;4084;891;3071;272;1052;174;547;446;1599
320300;201803;3628;11827;3006;10443;993;3617;599;2064;1592;5681
320305;201803;4415;13438;3575;11662;849;2942;1368;4320;2217;7262
320310;201803;1771;5142;1320;4201;286;927;528;1678;814;2605
320313;201803;1948;5340;1321;4071;301;1040;264;769;565;1809
320316;201803;1483;4338;1170;3711;269;906;518;1633;787;2539
320320;201803;18861;52868;13629;43596;3460;11728;4581;14487;8041;26215
320330;201803;2779;8064;2245;7091;645;2020;883;2952;1528;4972
320332;201803;5136;15678;4315;14192;981;3487;2169;6974;3150;10461
320334;201803;1975;6022;1359;4667;307;1213;288;882;595;2095
320335;201803;1792;5346;1157;3838;310;1120;208;627;518;1747
320340;201803;4756;12769;4073;11699;745;2249;2071;6095;2816;8344
320350;201803;4868;12669;3464;10090;547;1663;1591;4521;2138;6184
320360;201803;1505;3965;1092;3174;185;530;485;1377;670;1907
320370;201803;2401;7859;1899;6685;532;1924;615;2145;1147;4069
320380;201803;2080;6021;1770;5483;380;1266;885;2665;1265;3931
320390;201803;6891;19710;5279;16312;1231;4047;1894;5675;3125;9722
320400;201803;3244;9766;2726;8718;673;2267;1158;3655;1831;5922
320405;201803;4383;12177;3475;10634;534;1741;1907;5778;2441;7519
320410;201803;4774;13136;3606;11295;621;2015;1722;5580;2343;7595
320420;201803;2584;7433;2030;6450;558;1958;483;1514;1041;3472
320425;201803;1968;4905;1504;4135;129;406;945;2503;1074;2909
320430;201803;2511;6710;2006;5715;336;1015;1125;3031;1461;4046
320435;201803;2270;7363;1797;6382;671;2481;476;1759;1147;4240
320440;201803;1039;3131;831;2705;158;576;376;1185;534;1761
320450;201803;1597;4866;1281;4242;309;1109;573;1818;882;2927
320455;201803;3563;11405;2573;9070;728;2726;687;2370;1415;5096
320460;201803;2187;6898;1564;5442;370;1331;331;1086;701;2417
320465;201803;1225;3660;945;3077;124;448;516;1683;640;2131
320470;201803;3712;10716;2573;8303;688;2380;536;1635;1224;4015
320480;201803;1622;4887;1386;4409;261;907;665;2067;926;2974
320490;201803;15231;43630;12211;38411;2426;8439;4970;15696;7396;24135
320495;201803;1314;3751;862;2801;203;702;235;765;438;1467
320500;201803;43101;122722;36158;110629;6675;21927;18725;55567;25400;77494
320501;201803;4553;13610;3354;11527;951;3712;888;2895;1839;6607
320503;201803;2015;6509;1545;5488;497;1954;444;1429;941;3383
320506;201803;3174;9633;2185;7331;618;2236;102;289;720;2525
320510;201803;8617;24925;7148;22360;1208;4166;3827;11682;5035;15848
320515;201803;1761;4971;1388;4169;404;1275;352;1049;756;2324
320517;201803;1901;6132;1531;5327;569;2125;331;1100;900;3225
320520;201803;30181;86135;23702;75062;4882;16970;9183;28705;14065;45675
320530;201803;26540;75162;21140;65551;2917;10519;11914;34864;14831;45383
330010;201803;18813;55148;16081;50361;3248;10577;8481;26590;11729;37167
330015;201803;1326;3581;1113;3205;190;625;538;1461;728;2086
330020;201803;18360;49603;16189;46350;2506;8079;10711;29782;13217;37861
330022;201803;1791;5047;1450;4511;257;869;855;2614;1112;3483
330023;201803;3084;8610;2402;7577;570;1927;902;2775;1472;4702
330025;201803;4470;11803;3213;9531;1026;3319;941;2756;1967;6075
330030;201803;8647;26277;7099;23437;1099;4057;3765;11844;4864;15901
330040;201803;10982;31444;9546;28899;1442;4795;5818;16955;7260;21750
330045;201803;76999;194847;65368;179151;7478;20216;47474;129094;54952;149310
330050;201803;2225;6268;1756;5480;408;1360;754;2211;1162;3571
330060;201803;5058;14098;4236;12774;963;3178;1793;5148;2756;8326
330070;201803;18690;52726;15945;48456;3163;10144;8048;24491;11211;34635
330080;201803;8259;22614;7312;21161;770;2366;4854;13882;5624;16248
330090;201803;2398;6054;1997;5471;250;731;1226;3255;1476;3986
330093;201803;1922;5386;1537;4772;192;607;1013;3225;1205;3832
330095;201803;996;3187;829;2834;106;401;398;1274;504;1675
330100;201803;59398;171744;51368;159484;4883;17748;35009;106830;39892;124578
330110;201803;2058;6329;1820;5917;356;1254;767;2419;1123;3673
330115;201803;1729;4742;1418;4271;270;911;799;2334;1069;3245
330120;201803;2886;7171;2319;6419;217;691;1694;4592;1911;5283
330130;201803;3404;10204;2895;9397;564;1944;1564;5102;2128;7046
330140;201803;3187;9145;2716;8433;487;1735;1569;4709;2056;6444
330150;201803;1966;5650;1584;4995;355;1154;602;1894;957;3048
330160;201803;1091;3208;913;2931;213;739;448;1389;661;2128
330170;201803;87367;246153;75882;229429;13001;40537;44646;134925;57647;175462
330180;201803;2018;5525;1628;4877;107;405;1113;3227;1220;3632
330185;201803;8686;24595;7269;22111;967;3286;4683;13779;5650;17065
330187;201803;3461;9590;2900;8708;473;1561;1753;5172;2226;6733
330190;201803;27049;71002;24017;66763;2684;7666;18050;50014;20734;57680
330200;201803;12847;37096;10961;34468;2495;7738;6110;19772;8605;27510
330205;201803;1879;5028;1589;4571;106;360;1109;3087;1215;3447
330210;201803;3137;8427;2358;6936;545;1714;820;2255;1365;3969
330220;201803;9311;26471;7413;22789;1700;5642;2118;5966;3818;11608
330225;201803;3423;9945;2812;8916;276;1121;1851;5599;2127;6720
330227;201803;15692;42096;13726;39397;1431;4410;10266;29268;11697;33678
330230;201803;1196;3308;1011;3024;94;313;658;1921;752;2234
330240;201803;17223;49002;14226;44000;3345;11173;6376;19049;9721;30222
330245;201803;1282;3611;897;2928;213;741;225;717;438;1458
330250;201803;32464;91009;28194;84350;6807;20597;12979;39674;19786;60271
330260;201803;4288;12162;3443;10781;579;1984;1743;5180;2322;7164
330270;201803;21982;46613;13818;35238;2662;7447;5603;14176;8265;21623
330280;201803;2143;6042;1721;5273;256;862;892;2601;1148;3463
330285;201803;18696;48803;15482;44194;2002;6373;10103;28022;12105;34395
330290;201803;3161;8800;2655;7963;410;1326;1456;4212;1866;5538
330300;201803;3122;9698;2696;8914;419;1548;1557;4991;1976;6539
330310;201803;2211;6027;1755;5246;152;425;1121;3367;1273;3792
330320;201803;12548;34285;11078;32221;1453;4344;7938;23156;9391;27500
330330;201803;27059;69131;22825;62897;3104;9506;15006;40096;18110;49602
330340;201803;12663;35261;9934;30528;2110;7043;4015;11782;6125;18825
330350;201803;89010;237724;76174;220295;8151;25276;54179;155702;62330;180978
330360;201803;6897;18082;5976;16998;418;1231;4813;13637;5231;14868
330370;201803;3400;11557;2964;10657;835;3099;1091;3916;1926;7015
330380;201803;4738;14325;3775;12535;871;3127;1346;4287;2217;7414
330385;201803;3702;11999;3236;11204;910;3395;1308;4560;2218;7955
330390;201803;21215;65045;17307;57353;3699;13202;7532;24196;11231;37398
330395;201803;3005;8252;2604;7677;206;686;1746;5090;1952;5776
330400;201803;2711;7864;2410;7319;206;772;1656;4706;1862;5478
330410;201803;2686;7843;2038;6667;397;1416;888;2761;1285;4177
330411;201803;2224;6513;1885;5871;176;652;1308;3902;1484;4554
330412;201803;1354;4320;1117;3856;187;705;572;1860;759;2565
330414;201803;22336;59452;18551;54200;2628;7485;11897;34973;14525;42458
330415;201803;3439;9947;2696;8672;484;1548;1266;4215;1750;5763
330420;201803;9019;23880;5985;18698;1051;3482;1943;5779;2994;9261
330430;201803;7322;20315;6416;18779;902;3011;3994;11195;4896;14206
330440;201803;1534;4786;1315;4417;353;1321;539;1705;892;3026
330450;201803;1272;4021;1056;3617;184;697;501;1666;685;2363
330452;201803;13519;37564;10659;32605;2206;7264;5173;15441;7379;22705
330455;201803;509017;1300038;393678;1122090;69540;211256;217265;607730;286805;818986
330460;201803;1176;3517;928;3117;195;702;432;1403;627;2105
330470;201803;4100;11249;3211;9822;841;2745;1291;3851;2132;6596
330475;201803;8093;22872;6665;20807;1751;6030;3122;9445;4873;15475
330480;201803;5678;15896;4901;14709;691;2305;3019;8756;3710;11061
330490;201803;109607;270100;93435;247100;10174;29117;64541;167156;74715;196273
330500;201803;4901;14167;4505;13572;613;1961;3196;9557;3809;11518
330510;201803;36379;101551;29720;91683;8281;25916;13401;41611;21682;67527
330513;201803;1139;3331;993;3065;309;998;380;1154;689;2152
330515;201803;2670;7738;2201;6898;693;2270;766;2359;1459;4629
330520;201803;9896;28802;8445;26294;1537;5215;4114;12338;5651;17553
330530;201803;1505;4065;1189;3524;264;857;519;1471;783;2328
330540;201803;2685;7669;2160;6723;621;1986;757;2310;1378;4296
330550;201803;7335;22997;6248;21099;2380;8386;1520;5240;3900;13626
330555;201803;10306;27724;8848;25702;1437;4413;5615;16428;7052;20841
330560;201803;4091;11807;3486;10687;457;1509;2049;6109;2506;7618
330570;201803;2812;8223;2369;7456;463;1545;1315;4088;1778;5633
330575;201803;5182;14063;4517;12903;459;1506;3270;8968;3729;10474
330580;201803;11217;33453;9008;29268;2323;8002;3528;11268;5851;19270
330590;201803;1505;4320;1336;4095;149;462;961;2959;1110;3421
330600;201803;10778;31048;8648;27216;1390;4621;4303;13501;5693;18122
330610;201803;8408;24904;7317;23173;919;3357;4525;13904;5444;17261
330615;201803;1561;5095;1374;4827;438;1672;640;2223;1078;3895
330620;201803;3410;11073;2873;10058;991;3699;660;2213;1651;5912
330630;201803;22762;62566;18231;54765;2089;7281;11438;32887;13527;40168
350010;201803;1823;5145;981;3227;234;789;88;228;322;1017
350020;201803;600;1615;324;1057;36;131;138;405;174;536
350030;201803;3769;11366;2877;9622;768;2714;810;2647;1578;5361
350040;201803;565;1799;373;1344;74;293;103;338;177;631
350050;201803;849;2403;620;1954;138;487;171;441;309;928
350055;201803;684;1884;579;1727;51;174;437;1273;488;1447
350060;201803;105;313;85;282;20;73;34;117;54;190
350070;201803;3823;10567;2339;7575;439;1466;677;1978;1116;3444
350075;201803;582;1877;449;1588;171;628;57;179;228;807
350080;201803;665;1840;413;1307;49;172;178;529;227;701
350090;201803;580;1456;330;975;79;234;96;279;175;513
350100;201803;1982;5620;1318;4375;188;749;593;1823;781;2572
350110;201803;402;1187;300;970;25;91;181;565;206;656
350115;201803;1246;3750;1034;3284;190;648;498;1453;688;2101
350120;201803;789;2093;479;1451;61;164;256;801;317;965
350130;201803;3090;8792;2564;7764;319;1060;1400;4012;1719;5072
350140;201803;575;1879;466;1659;40;180;255;860;295;1040
350150;201803;500;1579;426;1429;129;448;128;417;257;865
350160;201803;9724;25377;6209;18955;885;3104;3268;9247;4153;12351
350170;201803;1439;4603;1140;3897;259;928;328;1062;587;1990
350180;201803;1117;2917;618;1892;123;412;246;718;369;1130
350190;201803;2787;8374;2074;6873;435;1615;784;2186;1219;3801
350200;201803;348;1020;296;927;19;65;213;641;232;706
350210;201803;4952;12318;3317;9610;690;2041;1608;4581;2298;6622
350220;201803;2233;6716;1767;5691;362;1307;691;2007;1053;3314
350230;201803;850;2550;739;2353;165;556;340;1071;505;1627
350240;201803;638;1915;444;1469;79;274;160;517;239;791
350250;201803;2084;6881;1699;6169;591;2314;383;1453;974;3767
350260;201803;808;2128;526;1593;82;259;270;799;352;1058
350270;201803;4457;12984;3650;11326;645;2187;1728;4996;2373;7183
350275;201803;2021;6084;1678;5461;369;1273;749;2356;1118;3629
350280;201803;19688;46070;12107;33546;2259;6697;3923;10504;6182;17201
350290;201803;2806;8222;1953;6439;388;1413;706;2181;1094;3594
350300;201803;628;1829;441;1406;92;297;138;400;230;697
350310;201803;784;2492;661;2205;84;325;272;846;356;1171
350315;201803;509;1482;361;1184;56;215;120;345;176;560
350320;201803;11018;31588;8935;27808;2408;7972;2073;6493;4481;14465
350330;201803;14408;37378;9835;27846;1367;3992;5157;13778;6524;17770
350335;201803;373;1088;311;978;20;65;222;698;242;763
350340;201803;982;2702;633;2029;128;447;201;631;329;1078
350350;201803;700;2018;568;1847;107;363;247;777;354;1140
350360;201803;878;2818;742;2506;199;654;277;933;476;1587
350370;201803;547;1539;381;1183;112;349;65;180;177;529
350380;201803;4549;12719;3073;9894;749;2521;868;2721;1617;5242
350390;201803;9123;26513;7551;23610;2085;6709;2749;8366;4834;15075
350395;201803;405;1069;199;654;21;73;68;194;89;267
350400;201803;7224;19600;5313;16218;1391;4611;1513;4348;2904;8959
350410;201803;8691;26204;6493;21832;1568;5825;1797;5552;3365;11377
350420;201803;577;1757;436;1484;81;323;76;242;157;565
350430;201803;680;1978;565;1772;67;261;341;999;408;1260
350440;201803;1375;4033;1116;3497;213;703;575;1732;788;2435
350450;201803;6269;18926;5031;16503;1135;3938;1651;5181;2786;9119
350460;201803;1468;3832;809;2530;154;555;214;606;368;1161
350470;201803;207;543;172;479;9;34;114;297;123;331
350480;201803;787;2177;519;1636;95;336;81;213;176;549
350490;201803;1655;4889;1296;4206;294;998;410;1239;704;2237
350500;201803;580;1684;485;1515;85;301;255;773;340;1074
350510;201803;1052;2991;775;2440;99;352;399;1180;498;1532
350520;201803;1771;6066;1372;5145;261;1100;469;1660;730;2760
350530;201803;2262;6263;1710;5125;415;1310;637;1796;1052;3106
350535;201803;1350;3991;1203;3775;133;496;835;2549;968;3045
350540;201803;1572;4279;1162;3556;243;817;499;1527;742;2344
350550;201803;8872;22348;5945;17530;789;2690;2782;7659;3571;10349
350560;201803;3402;10465;2818;9219;308;1073;1679;5381;1987;6454
350570;201803;17852;54336;15177;49065;3826;13326;6364;19683;10190;33009
350580;201803;1667;5030;994;3369;201;704;113;310;314;1014
350590;201803;3950;11472;2971;9395;619;2237;1366;3925;1985;6162
350600;201803;36732;91452;23918;67325;3334;10404;11227;28915;14561;39319
350610;201803;6357;18270;4817;15292;997;3376;1987;6154;2984;9530
350620;201803;371;1022;268;868;28;110;128;398;156;508
350630;201803;1489;4128;1094;3360;114;406;570;1623;684;2029
350635;201803;6406;17647;4951;15208;1017;3469;2362;6921;3379;10390
350640;201803;786;2319;471;1532;79;301;144;400;223;701
350650;201803;7503;21460;4980;15939;1031;3528;1384;4120;2415;7648
350660;201803;4624;12993;3653;11275;716;2333;1689;5207;2405;7540
350670;201803;1444;4330;1277;4043;258;829;652;2086;910;2915
350680;201803;1011;2884;699;2275;139;501;294;949;433;1450
350690;201803;985;2957;740;2453;145;531;318;985;463;1516
350700;201803;4075;11446;2951;9567;629;2277;1294;3925;1923;6202
350710;201803;2601;7715;2226;7003;308;1099;1256;3782;1564;4881
350715;201803;790;2335;685;2124;86;325;371;1033;457;1358
350720;201803;149;409;123;366;23;68;45;131;68;199
350730;201803;434;1419;345;1237;61;243;158;546;219;789
350740;201803;1532;4567;1013;3369;177;627;249;749;426;1376
350745;201803;583;1676;344;1114;44;158;141;392;185;550
350750;201803;8439;24639;6823;21541;1364;4852;2431;6831;3795;11683
350760;201803;12444;33799;9152;28087;2528;8348;2084;5666;4612;14014
350770;201803;645;1786;446;1380;63;207;256;769;319;976
350775;201803;577;1524;452;1318;52;177;215;621;267;798
350780;201803;1789;5091;1373;4346;339;1190;346;1196;685;2386
350790;201803;1611;4715;1075;3650;214;772;171;523;385;1295
350800;201803;3016;9574;2715;8984;490;1757;1376;4405;1866;6162
350810;201803;1990;5389;1696;4990;334;1024;930;2854;1264;3878
350820;201803;727;1843;421;1263;59;176;167;463;226;639
350830;201803;825;2451;485;1659;69;251;143;426;212;677
350840;201803;2448;7839;1890;6713;562;2162;580;1924;1142;4086
350850;201803;5864;18046;4614;15493;1324;4659;1299;4308;2623;8967
350860;201803;3023;8874;2770;8483;106;440;2149;6457;2255;6897
350870;201803;2643;8016;2035;6926;399;1540;1023;3397;1422;4937
350880;201803;1235;3870;985;3282;228;785;282;898;510;1683
350890;201803;646;1747;399;1227;44;144;124;314;168;458
350900;201803;5661;16655;3866;12872;1205;4411;443;1351;1648;5762
350910;201803;788;2202;677;1983;129;445;401;1126;530;1571
350920;201803;11411;30468;9818;27820;619;2032;7562;20612;8181;22644
350925;201803;4409;12995;3281;10827;751;2555;1096;3270;1847;5825
350930;201803;1342;3698;935;2875;153;488;417;1214;570;1702
350940;201803;1838;5561;1530;4977;215;783;890;2796;1105;3579
350945;201803;880;2628;683;2232;124;441;291;896;415;1337
350950;201803;73426;207370;58540;176032;9391;31008;31860;90473;41251;121481
350960;201803;4729;14224;3793;12417;692;2608;1931;5949;2623;8557
350970;201803;3541;11462;2793;9751;895;3382;403;1223;1298;4605
350980;201803;559;1750;474;1552;180;600;144;472;324;1072
350990;201803;1705;5318;1320;4596;345;1339;413;1330;758;2669
350995;201803;785;2556;709;2390;60;244;439;1409;499;1653
351000;201803;2444;6841;1877;5784;373;1269;592;1688;965;2957
351010;201803;292;790;166;521;20;66;80;242;100;308
351015;201803;661;2177;545;1950;100;394;238;818;338;1212
351020;201803;8456;24534;6854;21955;1272;4349;3953;12487;5225;16836
351030;201803;2353;7485;1931;6527;310;1225;931;2941;1241;4166
351040;201803;4146;11351;3550;10393;251;909;2694;7600;2945;8509
351050;201803;15528;40375;10616;32309;2366;7787;3709;11137;6075;18924
351060;201803;39445;106062;31171;91850;4634;14695;18615;53306;23249;68001
351070;201803;1332;3580;789;2569;228;790;76;236;304;1026
351080;201803;2458;6921;1845;6118;424;1553;831;2574;1255;4127
351090;201803;355;1107;249;900;43;168;53;196;96;364
351100;201803;2431;7005;1578;5033;398;1345;315;1036;713;2381
351110;201803;5172;13935;3484;10783;815;2793;1149;3222;1964;6015
351120;201803;697;1926;484;1506;76;244;196;553;272;797
351130;201803;958;2585;464;1574;85;302;87;277;172;579
351140;201803;1590;5114;1224;4327;341;1303;290;890;631;2193
351150;201803;1559;4916;990;3540;217;828;133;421;350;1249
351160;201803;1096;3692;913;3275;207;802;289;914;496;1716
351170;201803;1296;3937;1133;3578;133;475;677;2004;810;2479
351190;201803;781;2426;588;1934;92;289;209;662;301;951
351200;201803;1642;4294;1263;3689;82;267;743;2050;825;2317
351210;201803;1346;3457;832;2451;100;339;420;1115;520;1454
351220;201803;2934;9081;2581;8403;381;1320;1490;4766;1871;6086
351230;201803;1720;5039;1315;4302;285;1060;555;1624;840;2684
351240;201803;1616;4510;1086;3346;243;802;456;1285;699;2087
351250;201803;1029;2936;602;1954;86;301;205;652;291;953
351260;201803;871;2499;714;2180;223;673;178;520;401;1193
351270;201803;312;979;267;882;55;216;126;346;181;562
351280;201803;4089;11541;3237;9856;572;1928;1430;4119;2002;6047
351290;201803;935;2564;646;2006;119;380;265;785;384;1165
351300;201803;13352;39353;9523;31761;2147;7708;3083;10255;5230;17963
351310;201803;2815;7980;2191;6867;292;1085;1231;3571;1523;4656
351320;201803;845;2689;660;2219;119;424;228;719;347;1143
351330;201803;1035;4021;972;3915;56;145;827;3464;883;3609
351340;201803;5843;18118;4765;16116;1296;4523;1752;5993;3048;10516
351350;201803;9624;26758;8141;24217;1214;3797;5313;15294;6527;19091
351360;201803;3743;10917;3222;10006;803;2739;1053;3017;1856;5756
351370;201803;2173;6446;1527;5035;361;1255;514;1527;875;2782
351380;201803;38394;103264;31117;90054;5694;17316;15482;43626;21176;60942
351385;201803;268;739;170;536;23;65;59;185;82;250
351390;201803;1280;3375;847;2726;162;627;431;1266;593;1893
351400;201803;926;2816;775;2501;185;608;325;1035;510;1643
351410;201803;2229;6662;1767;5745;291;956;853;2737;1144;3693
351420;201803;283;769;176;548;34;105;61;183;95;288
351430;201803;724;2185;660;2067;81;294;466;1424;547;1718
351440;201803;3112;8779;2164;6739;402;1359;448;1187;850;2546
351450;201803;1497;4141;1106;3415;236;773;260;787;496;1560
351460;201803;674;1920;566;1720;203;598;232;709;435;1307
351470;201803;1023;2890;848;2559;85;312;496;1391;581;1703
351480;201803;2466;7791;2115;7175;293;1210;1116;3615;1409;4825
351490;201803;1739;5442;1518;4973;103;432;1048;3258;1151;3690
351492;201803;329;986;272;854;19;70;145;424;164;494
351495;201803;174;553;138;453;19;70;64;199;83;269
351500;201803;32295;85060;23798;70070;5179;16117;10809;30445;15988;46562
351510;201803;10334;28591;7820;23889;1359;4539;4228;12448;5587;16987
351512;201803;489;1373;334;1023;54;166;126;352;180;518
351515;201803;2707;6908;1717;5132;345;1183;425;1255;770;2438
351518;201803;2185;6060;1478;4747;225;847;752;2183;977;3030
351519;201803;615;1811;416;1342;92;333;77;175;169;508
351520;201803;997;2662;392;1312;57;213;134;388;191;601
351530;201803;340;1003;188;626;28;95;59;161;87;256
351535;201803;2001;5105;1541;4361;135;474;977;2606;1112;3080
351540;201803;1772;4887;1246;3899;424;1456;203;530;627;1986
351550;201803;5350;14939;3645;11207;523;1796;1672;4753;2195;6549
351560;201803;396;1250;336;1112;78;299;76;242;154;541
351565;201803;161;542;141;495;29;109;56;186;85;295
351570;201803;14846;41877;11852;35970;1718;5723;7200;20962;8918;26685
351580;201803;281;762;160;520;23;67;52;186;75;253
351590;201803;496;1197;279;773;30;108;153;386;183;494
351600;201803;1638;4439;1254;3724;146;476;698;1932;844;2408
351610;201803;625;1620;435;1286;32;116;241;626;273;742
351620;201803;18524;54686;14039;46045;2591;9581;5011;14645;7602;24226
351630;201803;24029;68816;20315;62404;3646;11722;12013;36053;15659;47775
351640;201803;13987;39440;11306;34661;1569;5396;7043;20826;8612;26222
351650;201803;378;1098;171;580;28;97;29;95;57;192
351660;201803;742;2308;485;1648;86;324;85;257;171;581
351670;201803;4437;13035;3331;10517;627;2066;1585;4699;2212;6765
351680;201803;445;1371;274;905;52;154;71;231;123;385
351685;201803;429;1330;349;1174;91;302;112;371;203;673
351690;201803;941;2663;637;2018;116;391;226;630;342;1021
351700;201803;889;2544;745;2273;159;463;307;926;466;1389
351710;201803;594;1835;447;1530;55;228;192;600;247;828
351720;201803;1350;3852;946;3029;181;620;355;1106;536;1726
351730;201803;872;2518;710;2221;97;357;357;1024;454;1381
351740;201803;3800;10000;2950;8357;551;1632;1231;3230;1782;4862
351750;201803;1219;3704;756;2672;128;491;263;917;391;1408
351760;201803;3129;9381;2310;7595;525;1892;659;1964;1184;3856
351770;201803;1964;6069;1625;5371;451;1556;624;1995;1075;3551
351780;201803;1314;3546;689;2166;117;423;181;530;298;953
351790;201803;1166;3079;943;2743;171;471;548;1620;719;2091
351800;201803;565;1276;283;760;39;118;81;186;120;304
351810;201803;962;2685;787;2370;70;194;560;1641;630;1835
351820;201803;2407;7324;1709;5833;372;1343;294;977;666;2320
351830;201803;4251;12223;3234;10251;439;1608;1725;5197;2164;6805
351840;201803;6472;20202;5293;17931;1079;4048;2195;6962;3274;11010
351850;201803;1940;5160;1270;3949;230;830;400;1118;630;1948
351860;201803;2716;8489;2285;7604;477;1707;1116;3651;1593;5358
351870;201803;22993;63794;18240;55645;5832;18423;6449;19882;12281;38305
351880;201803;109831;316096;86110;271671;25090;84736;23397;69625;48487;154361
351885;201803;675;2195;596;2018;130;450;272;895;402;1345
351890;201803;574;1763;467;1554;96;332;77;215;173;547
351900;201803;998;2952;785;2587;172;586;285;949;457;1535
351905;201803;389;1133;275;889;33;119;108;304;141;423
351907;201803;19937;55246;16057;48093;1001;3610;11623;33776;12624;37386
351910;201803;1140;3196;826;2527;149;499;348;948;497;1447
351920;201803;913;2458;702;2075;78;272;363;1015;441;1287
351925;201803;951;2746;758;2367;103;328;353;1020;456;1348
351930;201803;2681;8118;2541;7858;255;1033;2042;6094;2297;7127
351940;201803;1013;2782;752;2330;82;294;407;1234;489;1528
351950;201803;1322;3477;1012;2960;63;209;613;1752;676;1961
351960;201803;4645;12800;3440;10566;812;2669;1370;4024;2182;6693
351970;201803;5268;17933;4651;16752;976;3891;2205;7499;3181;11390
351980;201803;862;2409;635;1939;94;345;323;901;417;1246
351990;201803;1366;3518;959;2835;131;477;333;882;464;1359
352000;201803;2193;6882;1933;6342;221;868;1184;3656;1405;4524
352010;201803;1865;5593;1506;4890;357;1257;217;750;574;2007
352020;201803;1498;4331;1177;3764;227;794;518;1562;745;2356
352030;201803;4987;14081;3997;12560;794;2757;2107;6526;2901;9283
352040;201803;1955;5681;1285;4280;242;856;222;636;464;1492
352042;201803;3184;8238;1886;5728;377;1186;758;2311;1135;3497
352044;201803;1917;5556;1127;3934;194;745;239;773;433;1518
352050;201803;11742;33548;7763;24957;1894;6868;1167;3231;3061;10099
352060;201803;728;2139;549;1773;89;331;233;686;322;1017
352070;201803;792;1752;562;1418;86;234;253;620;339;854
352080;201803;444;1217;265;825;41;147;83;221;124;368
352090;201803;1343;4393;1052;3677;187;733;301;919;488;1652
352100;201803;3075;9054;2467;7909;548;1917;1060;3228;1608;5145
352110;201803;522;1685;417;1453;99;367;150;478;249;845
352115;201803;512;1548;431;1403;94;320;217;704;311;1024
352120;201803;818;2574;656;2226;80;321;343;1060;423;1381
352130;201803;1801;5329;1156;3673;239;819;347;1045;586;1864
352140;201803;1414;3876;858;2750;134;456;357;1075;491;1531
352150;201803;775;2206;594;1874;160;499;268;856;428;1355
352160;201803;879;2342;645;1951;120;418;266;740;386;1158
352170;201803;2664;7859;2214;6869;442;1492;1043;2981;1485;4473
352180;201803;2772;7734;2217;6663;521;1661;787;2163;1308;3824
352190;201803;1122;3168;827;2639;137;492;288;832;425;1324
352200;201803;371;1208;253;945;37;150;73;264;110;414
352210;201803;16229;41975;13174;37429;1663;5072;8982;25331;10645;30403
352215;201803;496;1404;444;1338;57;185;297;868;354;1053
352220;201803;13728;38302;9870;31141;2872;9426;2541;7920;5413;17346
352230;201803;11763;37688;9338;32817;2540;9867;2867;9344;5407;19211
352240;201803;11251;30801;8256;25435;1870;6485;2961;8292;4831;14777
352250;201803;20168;60636;16844;54680;4419;15045;7611;24251;12030;39296
352260;201803;5229;14841;3610;11514;589;2047;1842;5674;2431;7721
352265;201803;880;2641;764;2438;63;256;528;1617;591;1873
352270;201803;1419;4663;1132;4008;256;953;330;1114;586;2067
352280;201803;2218;6141;1763;5417;196;732;920;2648;1116;3380
352290;201803;1043;3245;881;2874;159;568;399;1179;558;1747
352300;201803;934;2661;663;2089;100;374;304;842;404;1216
352310;201803;43199;119777;32696;101514;8571;27143;13213;41178;21784;68321
352320;201803;5505;15828;4424;13573;836;2848;1937;5251;2773;8099
352330;201803;1854;5558;1513;5057;372;1381;629;1995;1001;3376
352340;201803;4588;13454;3415;11318;841;2992;1116;3465;1957;6457
352350;201803;1687;5340;1404;4667;240;927;536;1609;776;2536
352360;201803;1024;2936;893;2729;144;530;612;1777;756;2307
352370;201803;930;2964;822;2736;46;210;584;1875;630;2085
352380;201803;829;2464;661;2160;157;560;191;591;348;1151
352390;201803;17344;43821;11389;33302;1781;5742;5767;15933;7548;21675
352400;201803;3279;9305;2648;8160;600;2183;1400;3923;2000;6106
352410;201803;2754;7783;2245;6936;322;1125;1224;3625;1546;4750
352420;201803;913;2309;634;1837;104;316;224;631;328;947
352430;201803;6619;18346;5114;15777;1531;5002;1773;5402;3304;10404
352440;201803;15737;46174;12423;39592;2667;9045;5271;16194;7938;25239
352450;201803;646;1875;352;1203;65;234;91;301;156;535
352460;201803;2509;7536;1837;6172;387;1440;597;1916;984;3356
352470;201803;3700;9722;2689;7968;289;984;1456;4007;1745;4991
352480;201803;3569;9108;2487;7132;439;1399;1108;2902;1547;4301
352490;201803;685;2229;534;1880;106;401;200;687;306;1088
352500;201803;8858;23725;6746;20053;3346;10737;1012;2129;4358;12866
352510;201803;3025;8738;2336;7504;593;2061;769;2350;1362;4411
352520;201803;2161;6613;1736;5772;425;1514;746;2342;1171;3856
352530;201803;8373;24813;5628;18570;1277;4573;827;2089;2104;6662
352540;201803;527;1607;381;1273;76;266;83;257;159;523
352550;201803;890;2736;634;2205;130;494;157;496;287;990
352560;201803;549;1607;374;1209;66;209;92;266;158;475
352570;201803;1885;5829;1242;4443;323;1264;203;609;526;1873
352580;201803;794;2357;621;2003;117;422;212;635;329;1057
352585;201803;238;724;191;624;15;55;95;293;110;348
352590;201803;12797;35956;9264;28950;2886;9637;3400;9745;6286;19382
352600;201803;1864;5451;1437;4538;274;917;622;1837;896;2754
352610;201803;3093;9189;2407;7964;519;1923;784;2419;1303;4342
352620;201803;5197;14780;4296;13335;1189;3796;1711;5289;2900;9085
352630;201803;765;2023;586;1741;101;364;276;751;377;1115
352640;201803;2605;7184;2024;6218;171;578;1327;3997;1498;4575
352650;201803;616;1845;450;1428;74;256;143;422;217;678
352660;201803;948;3176;799;2859;169;613;316;1107;485;1720
352670;201803;9690;27499;5744;19132;1329;4841;426;1408;1755;6249
352680;201803;2997;9388;2172;7478;405;1566;886;2819;1291;4385
352690;201803;29638;78158;21450;62769;2144;7099;12671;35147;14815;42246
352700;201803;551;1463;410;1254;146;486;115;305;261;791
352710;201803;4765;13277;3474;10770;915;3110;1270;3652;2185;6762
352720;201803;7765;23205;6318;20228;2633;8578;1097;3224;3730;11802
352725;201803;411;1134;211;688;13;47;97;300;110;347
352730;201803;2453;7450;2161;6731;402;1422;1114;3118;1516;4540
352740;201803;2133;5430;1643;4658;206;630;889;2431;1095;3061
352750;201803;435;1143;224;712;42;133;56;151;98;284
352760;201803;1364;4271;1074;3578;186;688;470;1466;656;2154
352770;201803;761;2295;589;1903;118;414;203;616;321;1030
352780;201803;603;1941;457;1589;84;302;146;495;230;797
352790;201803;607;1683;419;1326;60;199;142;411;202;610
352800;201803;1119;3782;842;3048;203;759;183;613;386;1372
352810;201803;1049;2631;640;1847;99;288;287;798;386;1086
352820;201803;556;1452;372;1152;78;251;88;265;166;516
352830;201803;560;1516;266;843;37;129;49;125;86;254
352840;201803;3736;11776;3223;10782;1009;3529;1134;3613;2143;7142
352850;201803;9920;26451;6850;21410;1780;5954;2006;6153;3786;12107
352860;201803;813;2603;710;2367;139;499;285;924;424;1423
352870;201803;816;2147;544;1544;52;171;294;769;346;940
352880;201803;1901;4884;1326;3797;199;600;629;1603;828;2203
352885;201803;258;796;206;698;26;89;128;427;154;516
352890;201803;648;1630;414;1121;63;199;185;417;248;616
352900;201803;17131;47627;12138;37682;2233;7565;4973;14409;7206;21974
352910;201803;414;1158;212;691;24;78;42;116;66;194
352920;201803;2399;6616;1728;5338;214;732;929;2693;1143;3425
352930;201803;5281;15659;4111;13230;789;2715;1596;4864;2385;7579
352940;201803;21127;63051;16838;54142;4981;17708;3276;9433;8257;27141
352950;201803;459;1222;252;800;46;165;21;50;67;215
352960;201803;636;1847;344;1163;51;191;95;296;146;487
352965;201803;313;881;175;576;45;155;29;83;74;238
352970;201803;3003;7423;2365;6434;235;638;1591;4348;1826;4986
352980;201803;1268;3764;1030;3350;204;713;502;1587;706;2300
352990;201803;3906;11679;3271;10613;718;2618;1581;4831;2299;7449
353000;201803;458;1260;228;742;45;162;53;146;98;308
353010;201803;2508;6713;1726;5190;404;1330;545;1504;949;2834
353020;201803;3726;9952;2153;6575;295;968;765;2141;1060;3109
353030;201803;3764;10339;2643;8178;654;2147;513;1543;1167;3690
353040;201803;522;1363;398;1149;86;270;150;390;236;660
353050;201803;4719;14706;3640;12474;919;3408;1399;4543;2318;7951
353060;201803;43162;118983;36225;107562;3331;11800;25376;72248;28707;84048
353070;201803;9288;27436;6565;21731;1459;5163;1927;6170;3386;11333
353080;201803;4432;13137;3068;10321;687;2506;910;2821;1597;5327
353090;201803;521;1725;450;1562;40;150;266;875;306;1025
353100;201803;291;795;111;369;12;47;24;70;36;117
353110;201803;6994;20705;5936;19003;938;3297;3668;11789;4606;15086
353120;201803;542;1516;360;1119;57;199;126;336;183;535
353130;201803;2308;6202;1632;5144;473;1616;502;1514;975;3130
353140;201803;2096;5611;1592;4663;200;640;892;2466;1092;3106
353150;201803;1408;3929;1058;3313;265;826;345;1033;610;1859
353160;201803;633;1723;436;1363;86;290;162;458;248;748
353170;201803;491;1477;406;1356;75;311;199;616;274;927
353180;201803;9182;24118;7327;21159;1025;3217;4809;13625;5834;16842
353190;201803;3347;9580;2677;8167;342;1125;1555;4444;1897;5569
353200;201803;1104;3498;749;2538;155;573;182;574;337;1147
353205;201803;318;1057;275;949;67;257;125;421;192;678
353210;201803;941;2355;609;1752;33;120;365;1008;398;1128
353215;201803;410;1223;339;1071;45;162;136;369;181;531
353220;201803;612;1754;440;1404;109;350;89;269;198;619
353230;201803;753;2290;640;2105;167;603;243;694;410;1297
353240;201803;1998;5971;1681;5360;218;804;1006;3076;1224;3880
353250;201803;1145;2795;716;2020;116;336;324;890;440;1226
353260;201803;957;2464;556;1733;117;385;161;472;278;857
353270;201803;594;1707;483;1478;61;185;238;692;299;877
353280;201803;670;1957;478;1529;83;273;149;459;232;732
353282;201803;1751;5295;1535;4852;209;735;851;2576;1060;3311
353284;201803;394;998;204;608;32;110;69;184;101;294
353286;201803;121;361;89;299;24;80;21;59;45;139
353290;201803;1153;3314;819;2616;108;417;420;1217;528;1634
353300;201803;1531;4412;1156;3628;185;647;472;1340;657;1987
353310;201803;303;798;216;639;30;108;105;282;135;390
353320;201803;569;1570;472;1385;29;89;341;991;370;1080
353325;201803;594;1875;420;1472;82;303;123;422;205;725
353330;201803;529;1446;346;1043;45;158;189;528;234;686
353340;201803;2857;7901;1899;6103;491;1693;568;1813;1059;3506
353350;201803;3115;8985;2129;6789;484;1651;377;1047;861;2698
353360;201803;469;1485;400;1344;63;240;201;655;264;895
353370;201803;543;1759;461;1592;41;159;286;960;327;1119
353380;201803;252;819;200;695;33;121;67;221;100;342
353390;201803;5074;13729;3862;11437;702;2196;1617;4541;2319;6737
353400;201803;402;1200;314;1017;66;233;58;143;124;376
353410;201803;553;1574;440;1365;90;302;208;622;298;924
353420;201803;476;1340;282;884;51;152;27;69;78;221
353430;201803;1994;6161;1497;5108;384;1417;412;1322;796;2739
353440;201803;55216;162462;40153;131359;8832;30062;17072;53898;25904;83960
353450;201803;390;1051;268;808;38;138;107;293;145;431
353460;201803;3312;9289;2427;7502;250;879;1068;3275;1318;4154
353470;201803;6574;18665;4756;15115;990;3426;1524;4508;2514;7934
353475;201803;1359;3858;991;3006;137;453;409;1135;546;1588
353480;201803;1428;4174;1246;3801;85;285;884;2622;969;2907
353490;201803;890;2508;643;1972;129;390;256;750;385;1140
353500;201803;944;2377;758;2084;189;520;391;1105;580;1625
353510;201803;833;2616;606;2031;167;571;97;296;264;867
353520;201803;1117;3020;765;2371;84;290;372;1092;456;1382
353530;201803;2268;6310;1815;5425;236;806;962;2676;1198;3482
353540;201803;1876;5601;1579;5068;319;1071;799;2508;1118;3579
353550;201803;5635;15862;4511;13822;848;2801;2208;6413;3056;9214
353560;201803;2023;6223;1575;5438;515;1942;371;1194;886;3136
353570;201803;494;1434;362;1167;88;286;154;473;242;759
353580;201803;2042;5660;1638;4911;359;1107;783;2272;1142;3379
353590;201803;675;1938;426;1361;95;316;143;466;238;782
353600;201803;1636;4435;1371;3912;168;520;719;1952;887;2472
353610;201803;571;1894;431;1583;93;381;97;322;190;703
353620;201803;2352;7002;1775;5874;412;1472;453;1380;865;2852
353625;201803;509;1361;312;959;34;126;182;531;216;657
353630;201803;1194;4021;919;3347;197;749;198;680;395;1429
353640;201803;1264;3495;970;2942;112;406;564;1664;676;2070
353650;201803;8385;23962;6312;19512;953;3188;3241;9418;4194;12606
353657;201803;298;880;238;774;36;113;96;293;132;406
353660;201803;1015;2326;692;1817;121;368;370;860;491;1228
353670;201803;3290;10110;2720;8943;694;2454;1155;3553;1849;6007
353680;201803;696;2025;530;1759;115;400;232;747;347;1147
353690;201803;495;1309;214;691;23;71;27;77;50;148
353700;201803;1848;5431;1580;4914;215;722;937;2777;1152;3499
353710;201803;3459;7907;1789;5101;282;781;828;2203;1110;2984
353715;201803;540;1529;373;1182;23;97;101;278;124;375
353720;201803;1829;5299;1482;4778;254;932;821;2529;1075;3461
353730;201803;3999;11580;3026;9505;516;1774;1293;3731;1809;5505
353740;201803;1731;4881;1227;3897;294;1036;315;909;609;1945
353750;201803;850;2736;584;2152;148;583;101;377;249;960
353760;201803;11074;28115;8844;24983;1263;3984;5634;15530;6897;19514
353770;201803;669;2053;337;1181;70;264;37;81;107;345
353780;201803;4212;13237;3372;11505;938;3501;809;2550;1747;6051
353790;201803;2147;6999;1667;5989;502;2066;354;1123;856;3189
353800;201803;15737;45883;12273;39595;2497;8675;5433;17282;7930;25957
353810;201803;1012;2957;694;2298;125;478;243;758;368;1236
353820;201803;1550;4743;1182;3908;212;781;455;1453;667;2234
353830;201803;603;1594;466;1362;57;170;246;680;303;850
353850;201803;1646;4822;1284;4095;357;1122;383;1257;740;2379
353860;201803;2467;7557;1978;6510;510;1754;703;2211;1213;3965
353870;201803;26966;75107;18561;58100;3014;10352;7728;22003;10742;32355
353880;201803;2752;8244;2222;7242;256;944;1204;3814;1460;4758
353890;201803;2268;5385;1595;4359;172;525;986;2549;1158;3074
353900;201803;699;2067;521;1708;110;406;187;568;297;974
353910;201803;1951;6379;1736;6028;224;818;1207;4261;1431;5079
353920;201803;2221;6348;1511;4886;327;1185;300;822;627;2007
353930;201803;4031;11573;2760;9200;711;2562;528;1631;1239;4193
353940;201803;1063;3360;754;2632;150;545;201;664;351;1209
353950;201803;2912;8774;2391;7689;478;1717;1162;3406;1640;5123
353960;201803;588;1768;401;1355;89;284;120;397;209;681
353970;201803;582;1589;464;1377;45;138;293;845;338;983
353980;201803;12693;35281;10238;30983;1583;5055;5915;17441;7498;22496
353990;201803;753;1983;494;1491;53;174;292;839;345;1013
354000;201803;2224;5875;1363;4191;273;886;244;754;517;1640
354010;201803;349;982;261;812;36;117;160;476;196;593
354020;201803;3610;10940;2932;9427;741;2584;928;2693;1669;5277
354025;201803;762;2142;528;1696;108;368;142;458;250;826
354030;201803;473;1151;267;746;46;132;99;261;145;393
354040;201803;730;1855;465;1359;39;123;279;774;318;897
354050;201803;917;2817;658;2271;159;608;153;508;312;1116
354060;201803;4071;12209;2735;9231;722;2533;647;2003;1369;4536
354070;201803;2872;8807;2151;7287;514;1895;468;1360;982;3255
354075;201803;2043;6745;1641;5935;267;1123;830;2893;1097;4016
354080;201803;1420;4135;926;3089;179;627;239;712;418;1339
354085;201803;398;864;325;775;3;15;225;504;228;519
354090;201803;1406;4093;1251;3779;115;403;874;2598;989;3001
354100;201803;14454;43818;10857;37359;2578;9531;4334;14683;6912;24214
354105;201803;971;2742;828;2518;150;462;483;1466;633;1928
354110;201803;454;1272;354;1116;92;318;106;309;198;627
354120;201803;1561;4352;1053;3227;183;582;353;974;536;1556
354130;201803;5534;15302;3732;11730;1119;3811;189;416;1308;4227
354140;201803;20831;51957;13403;38577;2773;8516;4483;11882;7256;20398
354150;201803;3266;8384;2408;6850;494;1516;1010;2723;1504;4239
354160;201803;3144;9778;2366;8052;666;2352;671;2247;1337;4599
354165;201803;507;1582;415;1396;86;337;200;620;286;957
354170;201803;1371;4196;1117;3600;105;387;611;1838;716;2225
354180;201803;453;1358;346;1120;57;201;116;331;173;532
354190;201803;1434;4290;1093;3594;150;553;382;1238;532;1791
354200;201803;889;2443;706;2106;81;261;343;941;424;1202
354210;201803;647;1921;512;1669;50;192;302;896;352;1088
354220;201803;2932;8327;2287;7088;405;1333;1096;3266;1501;4599
354230;201803;664;1892;529;1684;62;251;307;911;369;1162
354240;201803;1363;4111;920;3162;170;636;224;670;394;1306
354250;201803;518;1403;339;1105;102;343;88;291;190;634
354260;201803;7605;21701;5996;18868;1473;4873;1951;6186;3424;11059
354270;201803;1105;3477;886;3039;171;616;319;1085;490;1701
354280;201803;706;1944;601;1778;92;332;350;949;442;1281
354290;201803;834;2841;723;2572;148;542;298;1057;446;1599
354300;201803;3643;11294;3249;10542;1039;3511;1068;3304;2107;6815
354310;201803;737;2256;593;1943;105;361;246;760;351;1121
354320;201803;835;2275;541;1711;110;391;188;529;298;920
354323;201803;526;1347;343;987;42;118;138;377;180;495
354325;201803;1189;3764;882;3072;163;596;310;1017;473;1613
354330;201803;6290;17267;4769;14394;801;2836;2568;7100;3369;9936
354340;201803;23598;65142;16948;53650;4199;14329;6326;19270;10525;33599
354350;201803;1094;3047;910;2681;147;484;528;1422;675;1906
354360;201803;517;1519;306;1078;57;200;43;148;100;348
354370;201803;1020;3316;854;2977;130;491;448;1522;578;2013
354380;201803;746;2078;513;1655;110;419;105;278;215;697
354390;201803;12824;33738;8244;25335;1579;5169;2206;6340;3785;11509
354400;201803;1537;5199;1206;4373;215;856;393;1406;608;2262
354410;201803;4821;14274;3890;12476;906;3151;1621;4977;2527;8128
354420;201803;1370;3847;978;3009;143;467;521;1522;664;1989
354425;201803;2088;5684;1622;4819;391;1201;558;1702;949;2903
354430;201803;1443;4237;1161;3773;192;710;560;1716;752;2426
354440;201803;528;1536;353;1151;38;127;163;493;201;620
354450;201803;370;1014;216;707;34;119;48;139;82;258
354460;201803;918;2557;637;1973;107;342;268;808;375;1150
354470;201803;517;1328;356;1004;28;85;179;453;207;538
354480;201803;958;2349;673;1900;63;195;412;1104;475;1299
354490;201803;764;2420;588;2025;128;486;194;618;322;1104
354500;201803;1995;6004;1694;5555;558;1998;404;1317;962;3315
354510;201803;807;2225;667;1935;91;266;350;945;441;1211
354515;201803;267;834;204;710;38;158;85;292;123;450
354520;201803;6879;20720;4170;13664;677;2464;1992;6010;2669;8474
354530;201803;3565;11216;2848;9729;678;2459;1063;3600;1741;6059
354540;201803;1271;3633;943;3007;220;762;283;907;503;1669
354550;201803;532;1447;398;1190;62;192;225;643;287;835
354560;201803;1835;4867;1026;3119;125;406;502;1459;627;1865
354570;201803;1100;3026;466;1465;101;347;60;175;161;522
354580;201803;9624;26318;6299;19892;1054;3638;2649;7847;3703;11485
354600;201803;1640;4879;1306;4241;216;765;672;2095;888;2860
354610;201803;361;994;192;608;44;156;54;155;98;311
354620;201803;441;1321;303;1049;50;208;107;308;157;516
354625;201803;307;910;188;642;22;74;48;136;70;210
354630;201803;1928;6103;1602;5410;650;2350;150;460;800;2810
354640;201803;3006;9406;2218;7638;441;1674;515;1602;956;3276
354650;201803;869;2439;710;2129;86;257;438;1336;524;1593
354660;201803;2429;6396;1663;5121;101;386;1156;3518;1257;3904
354670;201803;983;2862;692;2201;141;494;218;618;359;1112
354680;201803;4197;12422;3570;11341;923;3053;1744;5549;2667;8602
354690;201803;613;1975;414;1493;94;351;102;346;196;697
354700;201803;1002;2758;694;2105;122;401;288;760;410;1161
354710;201803;503;1458;354;1133;40;146;167;483;207;629
354720;201803;275;719;145;444;46;135;24;71;70;206
354730;201803;9090;26636;6645;21941;1072;3864;3366;10657;4438;14521
354740;201803;334;940;128;459;20;87;22;71;42;158
354750;201803;2486;6961;1681;5445;328;1200;620;1846;948;3046
354760;201803;1726;5131;1264;4199;389;1375;224;740;613;2115
354765;201803;281;787;130;431;18;70;27;81;45;151
354770;201803;2163;5720;1537;4601;371;1200;537;1542;908;2742
354780;201803;52936;140909;41707;118389;6195;19522;22388;59374;28583;78896
354790;201803;838;2550;701;2296;102;352;372;1188;474;1540
354800;201803;2450;6829;1939;5988;388;1305;890;2615;1278;3920
354805;201803;984;2778;728;2250;82;276;298;809;380;1085
354810;201803;565;1744;336;1218;55;218;82;265;137;483
354820;201803;886;2817;689;2407;135;530;162;494;297;1024
354830;201803;452;1151;307;888;95;282;106;286;201;568
354840;201803;738;2123;482;1507;75;225;222;683;297;908
354850;201803;19014;54091;13546;43425;2219;8219;6949;20679;9168;28898
354860;201803;1331;4026;978;3328;195;723;294;895;489;1618
354870;201803;45345;121140;36407;104622;5894;18288;19422;53394;25316;71682
354880;201803;5049;13204;2482;7520;336;1155;827;2041;1163;3196
354890;201803;14870;40539;12048;35625;1994;6414;6266;17857;8260;24271
354900;201803;443;1255;282;920;36;128;74;233;110;361
354910;201803;4822;13780;2874;9839;591;2181;257;823;848;3004
354920;201803;314;884;168;563;22;101;26;72;48;173
354925;201803;264;800;135;483;26;95;30;91;56;186
354930;201803;361;916;218;655;29;96;99;276;128;372
354940;201803;1667;5608;1299;4707;446;1726;140;463;586;2189
354950;201803;1435;4205;1159;3754;95;408;716;2185;811;2593
354960;201803;756;2160;595;1906;130;468;247;767;377;1235
354970;201803;3577;11097;2955;9853;474;1767;1668;5340;2142;7107
354980;201803;26698;68176;17978;52254;2437;8256;8884;23801;11321;32057
354990;201803;55552;150496;41389;123937;5362;17473;22281;63813;27643;81286
354995;201803;2184;5790;1640;4998;328;1091;898;2626;1226;3717
355000;201803;1383;4010;1122;3560;235;852;286;788;521;1640
355010;201803;2945;8861;2072;6811;726;2525;174;581;900;3106
355020;201803;3047;9312;2247;7699;728;2749;576;1886;1304;4635
355030;201803;1193756;3054858;911049;2515562;170026;509554;420185;1081137;590211;1590691
355040;201803;2696;7697;2270;7033;391;1226;1394;4354;1785;5580
355050;201803;967;2686;722;2234;214;651;169;492;383;1143
355060;201803;4673;13912;3570;11698;673;2493;1567;4633;2240;7126
355070;201803;7080;20188;5759;17903;863;3091;3188;9237;4051;12328
355080;201803;795;2527;519;1926;105;436;41;128;146;564
355090;201803;1084;3402;859;2949;194;682;263;922;457;1604
355100;201803;18414;52161;14640;46312;2987;10200;8182;25200;11169;35400
355110;201803;1002;2997;760;2576;272;994;136;456;408;1450
355120;201803;614;1787;453;1480;70;257;154;470;224;727
355130;201803;580;1417;261;739;30;85;107;289;137;374
355140;201803;1257;3634;1147;3451;153;532;800;2346;953;2878
355150;201803;3661;10425;2941;9118;515;1686;1423;4341;1938;6027
355160;201803;1723;5117;1319;4370;350;1313;307;955;657;2268
355170;201803;7873;21732;6320;19162;1881;6012;2568;7731;4449;13743
355180;201803;2632;7798;1976;6575;435;1693;625;1856;1060;3549
355190;201803;1584;4624;1296;4091;358;1220;534;1760;892;2980
355200;201803;775;2585;668;2388;276;1080;161;520;437;1600
355210;201803;2903;8439;2479;7585;267;977;1550;4460;1817;5437
355220;201803;39702;112418;31588;96443;8787;28338;10495;29263;19282;57601
355230;201803;1197;3142;671;2047;135;404;160;457;295;861
355240;201803;21674;59297;14590;45075;2756;8840;5641;17135;8397;25975
355250;201803;31589;89877;24154;76268;6327;21249;8225;25216;14552;46465
355255;201803;819;2176;434;1375;78;226;138;454;216;680
355260;201803;1183;3225;908;2762;117;453;564;1593;681;2046
355270;201803;1457;4526;1141;3792;274;946;375;1170;649;2116
355280;201803;25476;70388;18991;57665;3388;10979;8123;23352;11511;34331
355290;201803;778;2394;600;1977;154;482;173;534;327;1016
355300;201803;1252;3851;1013;3338;220;774;301;965;521;1739
355310;201803;998;2873;757;2449;84;314;395;1268;479;1582
355320;201803;513;1439;398;1219;75;276;149;383;224;659
355330;201803;1979;5664;1459;4689;211;754;844;2586;1055;3340
355340;201803;2998;7081;2555;6447;281;715;1775;4436;2056;5151
355350;201803;1271;4005;937;3271;198;743;275;950;473;1693
355360;201803;1200;3457;1032;3093;99;306;732;2225;831;2531
355365;201803;361;1006;192;667;39;118;25;85;64;203
355370;201803;5925;15370;4579;13461;1085;3304;1902;5958;2987;9262
355380;201803;2878;8244;2185;6814;402;1318;623;1679;1025;2997
355385;201803;1185;3540;1033;3266;179;650;507;1465;686;2115
355390;201803;721;2075;547;1701;118;372;208;609;326;981
355395;201803;1906;5674;1386;4509;217;753;551;1647;768;2400
355400;201803;8414;26623;6967;23516;2064;7594;1853;5745;3917;13339
355410;201803;21122;61039;14507;48123;3612;13081;2967;9789;6579;22870
355420;201803;677;2366;578;2145;155;674;124;455;279;1129
355430;201803;3618;9597;2820;8178;695;2037;1201;3488;1896;5525
355440;201803;805;2315;544;1746;111;376;151;449;262;825
355450;201803;3597;9999;2230;7103;420;1425;737;2155;1157;3580
355460;201803;547;1447;344;1064;54;205;144;381;198;586
355465;201803;350;1063;251;831;49;178;60;186;109;364
355470;201803;1134;3058;621;1966;171;555;169;498;340;1053
355475;201803;251;662;227;618;20;61;175;471;195;532
355480;201803;3357;10406;2876;9554;499;1898;1655;5295;2154;7193
355490;201803;941;2665;514;1690;65;236;174;539;239;775
355495;201803;765;2359;589;2002;101;377;168;541;269;918
355500;201803;6447;18316;4009;12930;630;2209;998;2984;1628;5193
355510;201803;1369;3682;821;2555;122;417;252;681;374;1098
355520;201803;389;898;188;517;20;61;97;247;117;308
355530;201803;458;1041;163;472;19;66;58;134;77;200
355535;201803;551;1596;425;1374;110;414;141;391;251;805
355540;201803;8328;23800;7080;21843;1325;4393;4092;12277;5417;16670
355550;201803;676;2075;535;1780;72;241;229;767;301;1008
355560;201803;1051;3043;574;1952;119;419;27;97;146;516
355570;201803;241;726;126;442;23;91;22;73;45;164
355580;201803;1208;3158;803;2430;111;398;361;1039;472;1437
355590;201803;186;486;138;408;16;51;82;235;98;286
355600;201803;1440;3835;1002;2994;255;836;363;1013;618;1849
355610;201803;1650;4445;1162;3497;180;573;522;1486;702;2059
355620;201803;4366;12749;3336;10524;467;1706;1669;4791;2136;6497
355630;201803;2114;6190;1490;4976;327;1136;570;1894;897;3030
355635;201803;913;2792;755;2511;103;357;447;1525;550;1882
355640;201803;2561;7809;1791;6264;435;1598;345;1209;780;2807
355645;201803;3998;12232;3253;10964;386;1541;1977;6542;2363;8083
355650;201803;6481;18347;5376;16271;1323;4310;2741;7726;4064;12036
355660;201803;1226;3515;887;2821;110;447;347;1057;457;1504
355670;201803;3183;9527;2204;7117;361;1353;959;2719;1320;4072
355680;201803;2684;7898;1156;4002;336;1255;88;260;424;1515
355690;201803;595;1902;402;1491;118;461;17;47;135;508
355695;201803;231;751;130;469;12;46;17;49;29;95
355700;201803;5878;18096;4904;15903;1181;3897;2057;6446;3238;10343
355710;201803;7943;19570;4970;14116;920;2776;1741;4498;2661;7274
355715;201803;349;1065;213;722;55;204;43;138;98;342
355720;201803;1413;4429;1120;3805;232;832;451;1385;683;2217
355730;201803;846;2608;708;2316;187;602;217;662;404;1264
410010;201803;1236;3596;946;2958;197;681;208;636;405;1317
410020;201803;1032;3319;856;2912;287;972;262;877;549;1849
410030;201803;1309;4066;1105;3649;214;774;483;1583;697;2357
410040;201803;9880;29838;7930;26132;1657;5996;2588;8101;4245;14097
410045;201803;1008;2754;680;2132;106;375;196;570;302;945
410050;201803;2550;6570;1578;4759;369;1202;271;720;640;1922
410060;201803;2059;6179;1662;5339;410;1372;565;1771;975;3143
410070;201803;1614;4436;1223;3667;255;829;411;1167;666;1996
410080;201803;1335;3661;983;3008;166;536;394;1191;560;1727
410090;201803;947;2762;871;2612;109;334;473;1486;582;1820
410100;201803;2075;6338;1506;4919;216;812;255;824;471;1636
410105;201803;360;1101;229;754;49;188;44;130;93;318
410110;201803;2995;8188;2118;6383;301;965;764;2256;1065;3221
410115;201803;494;1288;355;1031;73;234;121;326;194;560
410120;201803;2377;7726;2112;7244;797;2869;514;1721;1311;4590
410130;201803;1083;3141;979;2947;336;1127;312;815;648;1942
410140;201803;14701;37516;9206;27321;1877;6019;1851;5062;3728;11081
410150;201803;15524;38791;7480;21920;1431;4480;1271;3571;2702;8051
410160;201803;2789;8221;2377;7456;503;1746;889;2807;1392;4553
410165;201803;646;1868;533;1609;65;221;312;893;377;1114
410170;201803;2229;6166;1564;4659;403;1298;149;436;552;1734
410180;201803;12465;37603;10082;32235;1774;5985;4752;14295;6526;20280
410185;201803;502;1400;364;1139;67;216;105;303;172;519
410190;201803;1947;5347;1500;4467;336;1058;335;959;671;2017
410200;201803;4179;10740;2580;7726;517;1786;507;1484;1024;3270
410210;201803;2516;7118;1709;5358;280;983;444;1196;724;2179
410220;201803;609;1614;409;1225;53;181;98;298;151;479
410230;201803;1404;4150;1179;3685;219;800;564;1644;783;2444
410240;201803;4078;11779;3349;10349;973;3359;389;1196;1362;4555
410250;201803;2617;6786;1826;5318;315;1020;594;1667;909;2687
410260;201803;1627;4289;1115;3396;210;730;481;1417;691;2147
410270;201803;492;1330;369;1091;30;99;178;515;208;614
410275;201803;707;2127;468;1560;64;221;202;644;266;865
410280;201803;2019;5737;1335;4272;279;1013;384;1101;663;2114
410290;201803;3155;9339;2406;7748;537;1704;869;2827;1406;4531
410300;201803;655;1740;514;1471;83;259;215;562;298;821
410302;201803;343;914;169;558;22;66;94;311;116;377
410304;201803;1114;3316;968;3008;182;614;485;1493;667;2107
410305;201803;1647;4299;1222;3617;294;884;549;1628;843;2512
410310;201803;2282;6939;1905;6238;427;1530;593;1929;1020;3459
410315;201803;704;1841;353;1196;84;294;87;287;171;581
410320;201803;1107;3274;730;2413;105;404;108;347;213;751
410322;201803;509;1458;278;898;29;96;93;291;122;387
410330;201803;1385;3698;1039;3008;232;735;262;738;494;1473
410335;201803;839;2404;689;2103;114;396;298;832;412;1228
410337;201803;744;1917;525;1494;58;170;217;580;275;750
410340;201803;515;1427;350;1022;41;136;148;367;189;503
410345;201803;1989;5407;1128;3540;239;777;260;749;499;1526
410347;201803;685;1765;497;1420;51;177;147;399;198;576
410350;201803;1220;3456;894;2806;129;454;295;834;424;1288
410360;201803;3950;10128;3056;8562;247;815;1890;5097;2137;5912
410370;201803;10695;29899;7453;22623;1094;3693;2626;7032;3720;10725
410380;201803;1359;3777;1079;3197;128;472;416;1131;544;1603
410390;201803;2460;6890;1664;5262;441;1527;319;907;760;2434
410395;201803;876;2710;718;2364;146;526;314;1047;460;1573
410400;201803;4715;13763;3694;11646;691;2335;1384;4180;2075;6515
410405;201803;781;2096;633;1847;135;418;284;802;419;1220
410410;201803;1103;3261;1081;3234;197;728;646;1925;843;2653
410420;201803;6974;21497;5458;18141;1126;4121;1286;3903;2412;8024
410425;201803;2679;8117;1985;6684;367;1325;577;1824;944;3149
410430;201803;12319;32309;8644;25458;1486;4770;2660;7453;4146;12223
410440;201803;2728;9117;2424;8534;396;1456;1317;4813;1713;6269
410442;201803;2282;7385;1981;6720;607;2166;607;2030;1214;4196
410445;201803;2204;6826;1784;5975;405;1496;497;1714;902;3210
410450;201803;1543;4331;1190;3617;225;747;262;700;487;1447
410460;201803;1628;4429;1262;3818;229;758;462;1320;691;2078
410465;201803;2336;7306;1885;6305;457;1518;567;1858;1024;3376
410470;201803;1733;5298;1285;4290;319;1169;254;877;573;2046
410480;201803;29681;79523;17087;54181;2613;9113;1828;4972;4441;14085
410490;201803;10595;31167;7649;24781;1571;5433;2384;7235;3955;12668
410500;201803;1572;4646;1170;3765;305;1091;240;666;545;1757
410510;201803;2112;5529;1371;3994;256;755;424;1209;680;1964
410520;201803;2941;9771;2698;9274;734;2590;1189;4123;1923;6713
410530;201803;1488;4068;776;2371;124;378;85;199;209;577
410540;201803;2506;7264;1816;5830;289;971;808;2580;1097;3551
410550;201803;6287;17537;4079;12644;795;2697;744;2027;1539;4724
410560;201803;1295;3616;1016;3076;229;745;397;1102;626;1847
410570;201803;2512;7595;2002;6616;543;2019;261;928;804;2947
410580;201803;22000;61356;16984;51785;3469;11673;6729;19007;10198;30680
410590;201803;1378;4174;915;2979;159;558;201;570;360;1128
410600;201803;1688;4841;1332;4115;304;920;451;1441;755;2361
410610;201803;736;2038;541;1651;66;219;197;563;263;782
410620;201803;1893;5990;1262;4441;303;1143;188;580;491;1723
410630;201803;2185;6347;1432;4643;282;998;156;406;438;1404
410640;201803;4169;10753;2873;8446;734;2414;422;1164;1156;3578
410645;201803;1064;3470;951;3286;373;1335;276;987;649;2322
410650;201803;1865;5518;1398;4513;368;1285;359;1043;727;2328
410655;201803;1345;4449;1097;3958;51;175;763;2918;814;3093
410657;201803;653;1760;413;1240;77;251;151;390;228;641
410660;201803;3060;8345;1644;5153;342;1104;245;727;587;1831
410670;201803;905;2351;580;1680;98;275;272;752;370;1027
410680;201803;2816;8824;2062;6963;529;1734;467;1666;996;3400
410685;201803;564;1575;469;1399;89;307;228;635;317;942
410690;201803;114808;307683;76659;231919;13602;45816;22642;59927;36244;105743
410700;201803;2144;5895;1844;5381;377;1176;866;2366;1243;3542
410710;201803;861;2381;568;1788;71;237;265;785;336;1022
410712;201803;662;1966;568;1787;165;565;183;520;348;1085
410715;201803;832;2652;558;1969;100;358;146;508;246;866
410720;201803;2864;8092;2180;6653;331;1189;411;1129;742;2318
410725;201803;1031;2769;660;2044;113;374;103;289;216;663
410730;201803;539;1468;389;1191;95;340;67;185;162;525
410740;201803;933;2711;659;2164;123;437;258;843;381;1280
410750;201803;1666;4598;1359;3992;250;807;490;1358;740;2165
410752;201803;312;808;142;431;23;79;53;136;76;215
410753;201803;221;673;151;508;18;61;25;72;43;133
410754;201803;1114;3043;934;2751;63;155;590;1902;653;2057
410755;201803;668;1696;476;1333;42;125;253;663;295;788
410760;201803;2811;7865;2227;6816;646;2106;592;1802;1238;3908
410765;201803;12187;36210;9493;30848;1533;5536;1206;3738;2739;9274
410770;201803;902;2348;624;1846;99;320;240;697;339;1017
410773;201803;1264;3547;1126;3329;156;536;801;2305;957;2841
410775;201803;1377;3779;1221;3520;188;585;522;1478;710;2063
410780;201803;573;1514;350;1037;71;214;77;250;148;464
410785;201803;732;2179;596;1900;137;452;177;543;314;995
410790;201803;556;1720;462;1507;132;448;39;101;171;549
410800;201803;2849;6734;2287;5913;191;560;1137;2859;1328;3419
410810;201803;340;978;267;833;37;129;116;347;153;476
410820;201803;749;2236;451;1434;95;314;70;204;165;518
410830;201803;27311;73195;20325;60836;5147;17159;6469;18345;11616;35504
410832;201803;993;2726;841;2428;116;433;455;1211;571;1644
410840;201803;6959;19125;4322;13797;1020;3600;525;1360;1545;4960
410845;201803;1109;3188;920;2837;188;623;321;963;509;1586
410850;201803;2370;7116;2085;6590;413;1413;841;2666;1254;4079
410855;201803;579;1562;421;1247;46;152;182;499;228;651
410860;201803;3766;10344;2939;8728;529;1668;967;2741;1496;4409
410865;201803;1352;4367;1212;4062;263;949;643;2220;906;3169
410870;201803;1187;3407;1043;3188;97;311;694;2134;791;2445
410880;201803;3877;11430;2938;9576;531;1949;419;1431;950;3380
410890;201803;885;2755;672;2280;149;540;182;608;331;1148
410895;201803;913;3078;791;2799;310;1176;125;416;435;1592
410900;201803;867;2391;590;1834;103;348;152;388;255;736
410910;201803;356;885;213;598;14;41;109;281;123;322
410920;201803;724;1979;571;1712;124;415;212;622;336;1037
410930;201803;1387;4035;1107;3458;307;1081;246;743;553;1824
410940;201803;20307;60880;15804;52202;4281;15241;3158;10635;7439;25876
410950;201803;1837;5663;1664;5383;77;304;1355;4323;1432;4627
410960;201803;7118;19165;4512;14395;1186;4186;1275;3905;2461;8091
410965;201803;964;2773;735;2298;128;420;338;1017;466;1437
410970;201803;3754;10634;2756;8693;663;2463;427;1202;1090;3665
410975;201803;1279;3553;990;2991;192;659;326;963;518;1622
410980;201803;6384;17326;4236;13131;598;2004;1621;4830;2219;6834
410990;201803;1108;3057;729;2305;231;829;149;390;380;1219
411000;201803;476;1388;346;1120;45;152;85;228;130;380
411005;201803;432;1230;277;888;60;186;43;144;103;330
411007;201803;2182;6621;1869;6017;449;1544;577;1842;1026;3386
411010;201803;3997;12687;3322;11227;902;3228;339;1066;1241;4294
411020;201803;2337;6955;1971;6305;597;2024;550;1706;1147;3730
411030;201803;693;1832;455;1290;79;224;141;370;220;594
411040;201803;747;2035;325;1000;54;176;66;186;120;362
411050;201803;1781;5930;1529;5341;442;1662;233;715;675;2377
411060;201803;1539;4314;1069;3350;204;762;218;603;422;1365
411065;201803;323;917;244;764;36;113;104;322;140;435
411070;201803;6167;17168;4881;14785;1024;3404;1726;5004;2750;8408
411080;201803;2066;5812;1660;5044;451;1464;390;1186;841;2650
411090;201803;799;2136;537;1636;47;165;94;251;141;416
411095;201803;1415;3590;1006;2875;151;485;350;936;501;1421
411100;201803;1125;3161;791;2488;101;385;206;636;307;1021
411110;201803;545;1510;250;822;28;82;17;42;45;124
411120;201803;1332;3975;1037;3336;332;1222;193;502;525;1724
411125;201803;4598;14157;4260;13544;968;3213;1991;6503;2959;9716
411130;201803;645;1839;460;1430;98;308;151;496;249;804
411140;201803;2159;6941;1782;6070;430;1533;696;2429;1126;3962
411150;201803;3501;9663;2554;7681;536;1828;215;509;751;2337
411155;201803;936;2508;590;1836;63;215;254;732;317;947
411160;201803;300;774;214;622;33;93;56;170;89;263
411170;201803;713;2198;542;1793;127;439;170;554;297;993
411180;201803;5201;14731;4074;12622;772;2635;1539;4562;2311;7197
411190;201803;1259;3481;983;2933;216;700;255;671;471;1371
411200;201803;4614;12992;3313;10436;872;2969;850;2557;1722;5526
411210;201803;2116;5394;1553;4451;448;1454;160;394;608;1848
411220;201803;841;2316;643;1921;141;458;219;631;360;1089
411230;201803;968;2655;640;2026;133;443;194;619;327;1062
411240;201803;1326;3337;831;2404;80;252;429;1209;509;1461
411250;201803;1908;5471;1509;4743;341;1223;469;1459;810;2682
411260;201803;343;892;217;647;31;94;84;227;115;321
411270;201803;1751;5161;1421;4483;247;859;633;1935;880;2794
411275;201803;1304;3572;964;2922;176;572;380;1145;556;1717
411280;201803;1399;3934;878;2799;168;590;121;323;289;913
411290;201803;703;1978;494;1561;72;235;212;667;284;902
411295;201803;1042;2710;858;2363;101;319;396;1031;497;1350
411300;201803;989;2553;641;1851;59;176;241;608;300;784
411310;201803;858;2167;663;1865;44;130;259;716;303;846
411320;201803;5056;14143;3683;11549;872;2829;964;2793;1836;5622
411325;201803;1459;4414;1275;4056;234;765;655;2141;889;2906
411330;201803;3054;8976;2355;7586;615;2160;591;1922;1206;4082
411340;201803;766;2209;489;1552;64;237;207;635;271;872
411342;201803;768;2031;541;1574;112;339;234;643;346;982
411345;201803;962;2765;791;2442;109;388;484;1482;593;1870
411350;201803;2498;7186;1796;5756;466;1638;171;556;637;2194
411360;201803;614;1536;425;1234;53;178;139;368;192;546
411370;201803;43745;115543;32840;96279;3535;12056;17220;47203;20755;59259
411373;201803;1332;3717;1094;3324;143;481;485;1479;628;1960
411375;201803;1015;2718;764;2260;129;401;262;714;391;1115
411380;201803;1044;2658;712;1943;69;231;348;837;417;1068
411390;201803;1637;4777;1297;3952;215;719;449;1243;664;1962
411400;201803;2037;5478;1637;4688;293;971;663;1804;956;2775
411410;201803;1985;5815;1468;4694;349;1230;291;824;640;2054
411420;201803;3736;9847;2245;6853;341;1192;376;908;717;2100
411430;201803;3110;8888;2530;7890;549;1837;1034;3063;1583;4900
411435;201803;421;1235;287;948;54;166;112;346;166;512
411440;201803;2555;7889;2146;7030;509;1771;614;2086;1123;3857
411450;201803;2560;7126;1996;6163;337;1062;1025;3205;1362;4267
411460;201803;3727;10389;2059;6754;350;1355;300;897;650;2252
411470;201803;684;1966;477;1510;79;275;100;293;179;568
411480;201803;4256;12364;2992;9804;570;2087;668;2032;1238;4119
411490;201803;1447;4107;1118;3492;173;639;357;986;530;1625
411500;201803;1525;4062;1061;3188;161;562;325;937;486;1499
411510;201803;1965;5588;1628;4912;414;1392;337;1006;751;2398
411520;201803;25249;65109;14413;43361;2127;7019;4097;11005;6224;18024
411530;201803;888;2469;584;1883;118;421;151;452;269;873
411535;201803;458;1380;202;718;21;86;23;60;44;146
411540;201803;2755;7295;1958;5643;376;1177;624;1715;1000;2892
411545;201803;944;2903;810;2646;80;278;520;1705;600;1983
411550;201803;647;1760;495;1476;88;291;84;242;172;533
411560;201803;1932;5507;1228;3979;170;630;66;145;236;775
411570;201803;6786;17153;4773;13922;1019;3333;1217;3508;2236;6841
411573;201803;773;2171;674;2011;74;226;409;1214;483;1440
411575;201803;1573;4649;1281;4066;293;983;338;1063;631;2046
411580;201803;4040;10368;2372;7486;265;1020;296;845;561;1865
411585;201803;773;2365;352;1204;76;260;57;173;133;433
411590;201803;369;1076;271;858;30;110;129;367;159;477
411600;201803;281;785;187;616;40;148;67;212;107;360
411605;201803;1345;3655;912;2712;133;466;352;962;485;1428
411610;201803;2170;5899;1545;4569;257;822;679;1968;936;2790
411620;201803;2777;8054;2429;7506;413;1423;1383;4192;1796;5615
411630;201803;564;1537;380;1193;86;313;73;186;159;499
411640;201803;488;1399;342;1041;45;137;121;341;166;478
411650;201803;183;539;126;415;19;57;19;73;38;130
411660;201803;867;2308;625;1835;66;197;300;871;366;1068
411670;201803;1049;2820;781;2234;122;351;277;764;399;1115
411680;201803;1518;4329;1232;3790;157;552;634;1932;791;2484
411690;201803;3182;8950;2439;7563;510;1640;684;2196;1194;3836
411695;201803;655;2052;484;1647;72;268;156;549;228;817
411700;201803;1479;4138;1016;3232;233;799;131;364;364;1163
411705;201803;1578;5435;1401;5086;287;1011;793;3032;1080;4043
411710;201803;1725;4749;1282;3892;352;1129;157;488;509;1617
411720;201803;917;2448;678;1960;93;286;223;601;316;887
411721;201803;804;2229;621;1847;127;396;130;375;257;771
411722;201803;652;1867;386;1244;67;262;142;383;209;645
411725;201803;1267;3916;805;2804;187;686;159;562;346;1248
411727;201803;1519;4442;1035;3389;299;1015;135;405;434;1420
411729;201803;640;1654;430;1243;92;278;110;276;202;554
411730;201803;5100;14449;3886;11948;1109;3554;1159;3522;2268;7076
411740;201803;560;1567;299;959;52;180;54;154;106;334
411745;201803;808;2369;577;1823;85;279;128;355;213;634
411750;201803;4669;13239;3535;10881;488;1628;1586;4654;2074;6282
411760;201803;6928;19499;5510;16910;1882;6066;1041;3405;2923;9471
411770;201803;3100;9595;2381;7931;635;2211;304;973;939;3184
411780;201803;2870;8495;2495;7783;661;2191;963;3012;1624;5203
411790;201803;2866;7665;1705;5269;389;1348;232;625;621;1973
411800;201803;1003;2903;675;2146;97;324;117;363;214;687
411810;201803;1645;4497;1265;3756;220;712;554;1530;774;2242
411820;201803;10909;34093;8950;30054;2854;10005;2618;8735;5472;18740
411830;201803;571;1425;390;1116;95;303;53;165;148;468
411840;201803;10258;28329;6988;21526;1350;4528;1678;4929;3028;9457
411845;201803;415;1240;224;756;39;155;18;59;57;214
411850;201803;7222;20185;5464;16815;1593;5300;887;2591;2480;7891
411860;201803;774;2339;589;1926;100;347;158;479;258;826
411870;201803;661;2092;466;1589;94;343;97;298;191;641
411880;201803;2028;5676;1487;4678;364;1258;237;740;601;1998
411885;201803;843;2267;651;1929;114;409;233;669;347;1078
411890;201803;1042;3027;711;2305;109;393;48;134;157;527
411900;201803;841;2542;517;1747;134;466;51;169;185;635
411910;201803;1030;3243;758;2633;223;802;178;590;401;1392
411915;201803;16268;41897;10054;30103;1816;5901;2604;7042;4420;12943
411920;201803;893;2879;760;2565;205;751;168;546;373;1297
411925;201803;570;1546;380;1184;91;301;100;295;191;596
411930;201803;5288;17223;4594;15829;2123;7976;278;1019;2401;8995
411940;201803;3057;9774;2449;8297;594;2050;553;1712;1147;3762
411950;201803;12785;37309;10567;33386;2182;7466;4896;15014;7078;22480
411960;201803;5371;15211;4598;13733;954;3121;1662;4678;2616;7799
411965;201803;442;1264;322;1038;56;211;112;339;168;550
411970;201803;828;2175;677;1951;124;321;380;1220;504;1541
411980;201803;1453;4037;1179;3519;302;927;374;1071;676;1998
411990;201803;33707;97461;23636;76685;5038;17993;7116;21746;12154;39739
411995;201803;2516;6843;1968;5956;553;1875;575;1611;1128;3486
412000;201803;2119;5075;1535;4086;97;319;935;2294;1032;2613
412010;201803;660;2120;461;1635;66;268;95;281;161;549
412015;201803;560;1638;469;1469;74;233;243;762;317;995
412020;201803;417;1213;259;847;42;153;95;286;137;439
412030;201803;691;2048;490;1636;81;293;175;564;256;857
412033;201803;887;2590;624;2004;77;261;224;731;301;992
412035;201803;838;2231;536;1696;77;270;242;735;319;1005
412040;201803;574;1644;385;1240;67;214;62;189;129;403
412050;201803;1638;4493;1200;3644;226;778;287;869;513;1647
412060;201803;6966;22502;6064;20626;1816;6696;1376;4521;3192;11217
412065;201803;648;1885;490;1557;97;330;144;433;241;763
412070;201803;1225;3187;895;2510;133;396;364;1009;497;1405
412080;201803;1637;4871;1027;3464;139;523;65;193;204;716
412085;201803;317;887;102;361;10;39;9;25;19;64
412090;201803;5119;14090;4346;12720;1134;3361;1956;5878;3090;9239
412100;201803;1757;5129;1374;4406;418;1434;256;853;674;2287
412110;201803;834;2367;605;1841;121;402;152;456;273;858
412120;201803;1705;5489;1394;4789;320;1189;380;1078;700;2267
412125;201803;598;1854;493;1610;110;370;156;489;266;859
412130;201803;601;1730;437;1367;70;233;98;322;168;555
412135;201803;574;1610;278;854;44;132;86;246;130;378
412140;201803;1552;4164;1063;3221;227;773;161;430;388;1203
412150;201803;2945;8085;2459;7160;305;1019;1512;4249;1817;5268
412160;201803;1055;3374;644;2271;156;601;80;274;236;875
412170;201803;4097;12153;3441;10920;790;2689;1407;4175;2197;6864
412175;201803;1294;4114;1102;3736;254;845;414;1418;668;2263
412180;201803;1623;4707;1210;3934;194;749;507;1488;701;2237
412190;201803;3239;8677;2417;7137;361;1165;973;2961;1334;4126
412200;201803;1853;5744;1328;4453;339;1205;238;781;577;1986
412210;201803;580;1542;356;1087;66;235;77;197;143;432
412215;201803;3707;10240;3111;9075;843;2473;1276;4112;2119;6585
412217;201803;1027;2849;877;2587;73;248;589;1656;662;1904
412220;201803;5507;16443;4746;14977;1150;3607;1814;6092;2964;9699
412230;201803;2726;8617;2223;7515;401;1529;606;1832;1007;3361
412240;201803;6791;18009;4329;13171;804;2697;1069;3024;1873;5721
412250;201803;1905;5268;1485;4422;381;1176;233;636;614;1812
412260;201803;1190;3360;845;2611;128;394;262;757;390;1151
412265;201803;847;2539;721;2269;174;580;277;860;451;1440
412270;201803;768;2312;512;1694;73;264;186;582;259;846
412280;201803;509;1566;418;1389;110;389;91;284;201;673
412290;201803;978;2583;658;1973;106;356;201;565;307;921
412300;201803;1461;4281;1212;3773;302;1006;265;792;567;1798
412310;201803;797;2331;661;2082;72;325;325;1000;397;1325
412320;201803;815;2189;561;1682;86;331;179;518;265;849
412330;201803;1392;3862;969;2999;194;632;346;1067;540;1699
412340;201803;958;2826;613;1976;97;338;120;345;217;683
412350;201803;2573;7188;1677;5302;308;1060;232;689;540;1749
412360;201803;239;692;148;477;16;57;55;172;71;229
412370;201803;791;2389;589;1991;124;465;49;172;173;637
412380;201803;1491;4382;1077;3435;269;886;201;686;470;1572
412382;201803;557;1478;370;1106;60;191;100;255;160;446
412385;201803;2159;6281;1822;5582;642;1992;489;1584;1131;3576
412390;201803;2248;5939;1844;5288;382;1164;790;2268;1172;3432
412395;201803;709;2045;502;1599;54;171;239;729;293;900
412400;201803;878;2557;665;2092;156;504;153;518;309;1022
412402;201803;1679;4570;1288;3889;283;949;154;444;437;1393
412405;201803;3096;8860;1973;6382;384;1387;67;235;451;1622
412410;201803;4999;14222;3808;11985;882;3148;892;2624;1774;5772
412420;201803;438;1193;244;753;29;97;101;276;130;373
412430;201803;530;1437;353;1083;39;130;136;406;175;536
412440;201803;2792;8137;1944;6454;490;1761;345;1156;835;2917
412450;201803;306;968;227;767;30;98;19;45;49;143
412460;201803;835;2451;705;2200;138;481;251;758;389;1239
412470;201803;1692;5606;1362;4792;354;1302;283;1035;637;2337
412480;201803;938;2719;597;1881;104;350;79;195;183;545
412490;201803;1004;2778;827;2425;143;407;347;968;490;1375
412500;201803;1776;4838;1379;4071;243;750;331;888;574;1638
412510;201803;1948;6153;1437;4843;365;1306;164;502;529;1808
412520;201803;1261;3563;848;2641;195;600;91;275;286;875
412530;201803;580;1635;438;1335;65;215;110;324;175;539
412535;201803;751;2092;525;1613;108;367;99;283;207;650
412540;201803;1210;3310;850;2525;113;410;245;734;358;1144
412545;201803;686;1849;459;1355;87;271;113;295;200;566
412550;201803;29546;84898;20240;64804;4112;13972;5725;17010;9837;30982
412555;201803;227;639;147;460;22;78;38;93;60;171
412560;201803;4986;14992;3726;12062;798;2851;843;2632;1641;5483
412570;201803;3771;10407;2357;7424;481;1626;316;1073;797;2699
412575;201803;909;2612;739;2230;86;294;360;1004;446;1298
412580;201803;1326;3578;938;2815;159;527;376;1061;535;1588
412590;201803;483;1342;259;862;49;165;24;70;73;235
412600;201803;1358;3987;1002;3186;176;604;369;1153;545;1757
412610;201803;724;2075;461;1431;74;242;190;547;264;789
412620;201803;1212;3518;915;2966;202;763;269;786;471;1549
412625;201803;7880;22366;5308;17095;828;2881;516;1781;1344;4662
412627;201803;924;2738;640;2127;180;658;172;541;352;1199
412630;201803;2930;8966;2166;7208;398;1313;660;2058;1058;3371
412635;201803;352;984;242;745;45;145;46;123;91;268
412640;201803;1001;2830;582;1854;85;289;121;345;206;634
412650;201803;1462;4275;1213;3790;216;784;416;1157;632;1941
412660;201803;2514;6884;1763;5356;308;1025;469;1302;777;2327
412665;201803;558;1416;314;962;63;207;105;298;168;505
412667;201803;1662;4583;1264;3776;200;692;490;1382;690;2074
412670;201803;537;1574;432;1374;91;325;139;427;230;752
412680;201803;1354;3907;856;2871;131;509;285;827;416;1336
412690;201803;799;2318;595;1892;125;406;138;416;263;822
412700;201803;2001;5531;1605;4891;324;1156;662;1927;986;3083
412710;201803;5844;17965;4745;15705;975;3470;1315;4035;2290;7505
412720;201803;1208;3684;906;2955;157;555;191;546;348;1101
412730;201803;2045;5945;1149;3830;237;832;172;532;409;1364
412740;201803;1628;4835;1090;3613;198;738;139;492;337;1230
412750;201803;3823;11096;3356;10322;420;1529;2136;6368;2556;7897
412760;201803;2649;7692;2322;7133;348;1167;1336;4002;1684;5169
412770;201803;9940;26547;5365;16784;736;2375;1036;2904;1772;5279
412780;201803;1236;3650;1033;3242;213;708;392;1217;605;1925
412785;201803;1998;5363;1442;4315;332;999;610;1789;942;2788
412788;201803;1325;3983;1094;3504;268;922;439;1324;707;2246
412790;201803;1021;2990;660;2187;132;487;172;486;304;973
412795;201803;1110;3085;653;2020;125;410;144;424;269;834
412796;201803;2312;7092;1934;6229;378;1302;647;1916;1025;3218
412800;201803;3119;8349;2191;6450;309;1029;832;2246;1141;3275
412810;201803;10485;27644;6176;18474;854;2890;1773;4479;2627;7369
412820;201803;6560;18763;4793;15219;1026;3429;1438;4565;2464;7994
412830;201803;324;965;234;767;33;105;50;160;83;265
412840;201803;1774;4875;1343;4025;214;677;398;1172;612;1849
412850;201803;2937;8152;2214;6845;378;1265;760;2243;1138;3508
412853;201803;1774;4841;1460;4139;149;463;753;1923;902;2386
412855;201803;1216;3460;860;2637;151;515;202;537;353;1052
412860;201803;915;2675;709;2238;152;505;236;719;388;1224
412862;201803;675;1647;432;1214;71;220;165;456;236;676
412863;201803;1132;3681;1091;3617;107;363;831;2742;938;3105
412865;201803;716;2080;520;1699;89;295;181;606;270;901
412870;201803;893;2514;690;2170;226;788;139;461;365;1249
412880;201803;816;2357;553;1760;99;357;76;221;175;578
420005;201803;430;1282;247;854;37;134;97;327;134;461
420010;201803;3535;9110;2340;6993;225;749;1573;4719;1798;5468
420020;201803;527;1686;313;1130;44;183;43;121;87;304
420030;201803;185;531;98;371;20;91;12;44;32;135
420040;201803;587;1835;328;1233;48;194;13;37;61;231
420050;201803;637;1653;419;1254;60;192;229;658;289;850
420055;201803;147;454;71;268;13;58;21;78;34;136
420060;201803;135;427;92;317;14;59;18;38;32;97
420070;201803;936;2983;698;2414;143;532;233;799;376;1331
420075;201803;100;275;57;177;11;34;13;26;24;60
420080;201803;446;1356;343;1144;99;334;94;300;193;634
420090;201803;364;1258;249;941;51;195;55;216;106;411
420100;201803;1084;3200;961;3021;82;284;732;2276;814;2560
420110;201803;244;822;227;784;60;224;77;242;137;466
420120;201803;332;1022;239;803;56;222;87;259;143;481
420125;201803;298;1005;249;903;61;257;118;409;179;666
420127;201803;270;757;95;337;19;76;16;48;35;124
420130;201803;1857;5883;1385;4888;320;1234;422;1340;742;2574
420140;201803;3194;9224;2322;7589;604;2236;309;953;913;3189
420150;201803;514;1379;329;1075;65;236;129;386;194;622
420160;201803;221;586;105;351;15;54;32;104;47;158
420165;201803;157;479;100;336;26;94;28;82;54;176
420170;201803;227;723;142;522;34;141;20;69;54;210
420180;201803;228;704;121;444;17;61;31;103;48;164
420190;201803;166;542;96;359;30;119;16;57;46;176
420195;201803;1237;3519;951;3026;252;893;124;364;376;1257
420200;201803;2821;8018;1617;5481;287;1168;416;1210;703;2378
420205;201803;1193;3536;887;2946;143;525;481;1612;624;2137
420207;201803;1422;3992;928;3015;222;829;265;816;487;1645
420208;201803;431;1199;249;878;44;194;106;378;150;572
420209;201803;164;547;103;374;31;125;35;118;66;243
420210;201803;2181;6082;1370;4695;306;1166;537;1761;843;2927
420213;201803;742;2521;669;2373;171;664;300;1048;471;1712
420215;201803;269;847;170;615;53;185;13;50;66;235
420220;201803;144;490;108;417;32;135;32;115;64;250
420230;201803;3539;10181;2662;8618;413;1554;1271;3946;1684;5500
420240;201803;10729;29317;6804;21550;891;3390;3347;9492;4238;12882
420243;201803;413;1253;328;1084;61;216;139;436;200;652
420245;201803;1126;3153;787;2519;89;356;418;1235;507;1591
420250;201803;439;1366;387;1260;87;315;172;523;259;838
420253;201803;509;1331;373;1125;32;95;200;597;232;692
420257;201803;207;557;126;404;24;81;61;200;85;281
420260;201803;1003;3067;773;2673;136;522;372;1264;508;1786
420270;201803;480;1333;223;715;24;93;79;241;103;334
420280;201803;1559;4245;948;3128;185;658;239;750;424;1408
420285;201803;105;282;50;177;10;38;6;14;16;52
420287;201803;410;1079;281;874;93;305;87;264;180;569
420290;201803;3892;11822;2952;9666;522;1863;1085;3224;1607;5087
420300;201803;6351;18512;3714;12441;772;2955;817;2357;1589;5312
420310;201803;791;1965;414;1170;68;183;241;656;309;839
420315;201803;822;2622;611;2166;154;571;220;770;374;1341
420320;201803;3800;11505;3063;10134;993;3599;681;2067;1674;5666
420325;201803;216;698;156;570;44;163;41;152;85;315
420330;201803;812;2603;576;2041;121;468;177;574;298;1042
420340;201803;1101;3297;777;2607;150;513;57;191;207;704
420350;201803;1413;3972;977;3107;141;498;546;1710;687;2208
420360;201803;2432;7208;1382;4824;268;1031;116;398;384;1429
420370;201803;1275;3587;993;3110;130;495;653;1960;783;2455
420380;201803;4922;13937;3170;10321;729;2524;903;2888;1632;5412
420390;201803;975;2588;636;1899;104;340;225;498;329;838
420395;201803;1019;3064;664;2276;101;362;75;227;176;589
420400;201803;954;2904;628;2173;116;461;138;449;254;910
420410;201803;543;1530;401;1247;34;136;287;865;321;1001
420415;201803;325;1012;251;849;73;268;71;234;144;502
420417;201803;637;2009;511;1715;106;377;197;654;303;1031
420419;201803;217;753;156;598;53;230;7;24;60;254
420420;201803;9653;27518;7009;22590;2431;8460;1451;4321;3882;12781
420425;201803;803;2151;565;1714;53;201;243;691;296;892
420430;201803;3101;9110;1931;6382;423;1480;535;1628;958;3108
420435;201803;256;736;121;432;23;104;37;116;60;220
420440;201803;731;2191;408;1378;129;493;108;316;237;809
420445;201803;319;899;193;617;43;147;55;156;98;303
420450;201803;651;1996;465;1572;96;374;129;395;225;769
420455;201803;1853;5064;1424;4339;199;687;711;2096;910;2783
420460;201803;7947;22344;5977;18838;1090;3896;2537;7539;3627;11435
420470;201803;690;1855;404;1291;78;291;98;267;176;558
420475;201803;37;114;30;97;11;34;5;16;16;50
420480;201803;4548;12305;3049;9642;625;2143;917;2797;1542;4940
420490;201803;538;1449;292;1011;71;266;64;230;135;496
420500;201803;1251;3814;889;3079;199;738;298;1012;497;1750
420510;201803;110;375;71;255;11;39;36;125;47;164
420515;201803;48;135;37;118;5;19;14;40;19;59
420517;201803;755;2184;677;2049;42;124;534;1612;576;1736
420519;201803;358;916;228;703;34;125;76;229;110;354
420520;201803;457;1244;215;749;20;62;20;62;40;124
420530;201803;980;2964;696;2342;143;546;198;591;341;1137
420535;201803;225;644;99;333;24;80;14;53;38;133
420540;201803;22498;58335;14693;43237;2772;9013;4566;11393;7338;20406
420543;201803;230;664;183;569;30;105;91;261;121;366
420545;201803;1222;3827;980;3307;220;784;325;1067;545;1851
420550;201803;3360;9950;2261;7844;513;2007;711;2519;1224;4526
420555;201803;305;936;222;754;42;148;88;286;130;434
420560;201803;420;1158;315;984;66;202;171;531;237;733
420570;201803;2011;6096;1539;5098;320;1189;574;1764;894;2953
420580;201803;1652;4499;1256;3853;255;914;604;1742;859;2656
420590;201803;2881;8306;1734;5721;332;1234;310;791;642;2025
420600;201803;831;2639;697;2374;111;410;384;1304;495;1714
420610;201803;386;1171;214;756;53;198;40;132;93;330
420620;201803;445;1318;371;1178;102;350;122;377;224;727
420630;201803;778;2388;583;1920;124;444;247;755;371;1199
420640;201803;570;1668;273;989;74;300;22;63;96;363
420650;201803;2491;7067;1541;5070;264;925;496;1433;760;2358
420660;201803;401;1151;271;874;53;191;64;192;117;383
420665;201803;499;1386;332;1089;52;215;140;407;192;622
420670;201803;1485;4214;1006;3253;165;670;341;948;506;1618
420675;201803;145;471;107;378;29;117;19;46;48;163
420680;201803;331;820;192;616;34;120;86;267;120;387
420690;201803;746;2480;513;1846;73;267;96;266;169;533
420700;201803;2778;7960;2162;6775;366;1266;883;2653;1249;3919
420710;201803;599;1890;462;1599;89;386;193;576;282;962
420720;201803;1323;3766;1000;3289;270;905;413;1352;683;2257
420730;201803;2672;7522;2091;6590;383;1327;1066;3243;1449;4570
420740;201803;712;2165;474;1661;129;474;81;282;210;756
420750;201803;1748;5400;1236;4247;204;791;419;1284;623;2075
420757;201803;79;184;23;93;4;21;9;34;13;55
420760;201803;372;1140;165;544;37;124;19;55;56;179
420765;201803;417;1350;220;807;42;166;54;200;96;366
420768;201803;1150;3708;979;3373;226;808;582;2003;808;2811
420770;201803;511;1405;231;842;48;195;60;214;108;409
420775;201803;470;1378;266;916;58;213;46;138;104;351
420780;201803;1070;3130;638;2169;117;410;148;474;265;884
420785;201803;185;525;135;414;27;79;37;99;64;178
420790;201803;985;3240;764;2789;185;735;327;1127;512;1862
420800;201803;724;1980;337;1136;73;273;96;299;169;572
420810;201803;1528;5228;1270;4625;395;1618;299;928;694;2546
420820;201803;8480;23088;5760;18618;1322;4766;1968;5826;3290;10592
420830;201803;2726;8030;2157;6969;511;1796;744;2321;1255;4117
420840;201803;673;1978;302;1067;70;268;59;184;129;452
420845;201803;1635;4455;987;3259;223;820;299;969;522;1789
420850;201803;1048;3515;675;2549;160;668;83;257;243;925
420860;201803;283;790;175;589;46;173;34;101;80;274
420870;201803;860;2436;667;2103;222;787;228;667;450;1454
420880;201803;857;2782;664;2327;152;594;159;479;311;1073
420890;201803;7315;20092;4039;13292;714;2567;1040;2943;1754;5510
420895;201803;166;495;97;313;29;98;31;96;60;194
420900;201803;1426;3836;855;2777;155;612;284;798;439;1410
420910;201803;22654;64114;15084;49303;2529;9265;5153;15344;7682;24609
420915;201803;527;2020;354;1493;63;284;156;626;219;910
420917;201803;342;989;179;545;29;95;76;215;105;310
420920;201803;107;315;42;156;4;16;2;6;6;22
420930;201803;16986;46781;12324;38506;2209;7537;5345;15912;7554;23449
420940;201803;2286;6314;1526;4897;367;1280;133;349;500;1629
420945;201803;148;468;108;361;30;116;34;108;64;224
420950;201803;397;1145;219;757;29;120;74;249;103;369
420960;201803;855;2372;600;1869;115;413;201;560;316;973
420970;201803;2529;7573;1777;6066;473;1683;296;1061;769;2744
420980;201803;350;1079;278;971;121;439;87;331;208;770
420985;201803;311;948;161;581;29;125;56;180;85;305
420990;201803;506;1513;283;1027;60;231;40;105;100;336
421000;201803;448;1561;309;1179;69;285;53;160;122;445
421003;201803;481;1220;167;531;18;55;25;57;43;112
421005;201803;64;224;57;211;16;65;22;87;38;152
421010;201803;3772;10648;2669;8675;586;2096;567;1677;1153;3773
421020;201803;394;1189;304;1031;18;74;205;699;223;773
421030;201803;714;2372;578;2055;189;737;127;426;316;1163
421040;201803;758;1840;460;1376;49;184;267;760;316;944
421050;201803;1255;3570;738;2408;142;510;227;682;369;1192
421055;201803;171;473;86;279;24;87;24;68;48;155
421060;201803;519;1614;365;1224;73;289;131;413;204;702
421070;201803;527;1657;318;1120;75;284;38;119;113;403
421080;201803;640;2653;593;2581;67;220;460;2150;527;2370
421085;201803;427;1223;185;661;24;83;34;117;58;200
421090;201803;379;1022;188;599;20;67;50;149;70;216
421100;201803;897;2301;442;1352;103;349;51;140;154;489
421105;201803;1329;3832;1048;3409;166;547;531;1808;697;2355
421110;201803;891;2783;769;2572;80;284;489;1639;569;1923
421120;201803;1007;3226;681;2471;96;402;184;577;280;979
421125;201803;285;777;207;653;72;245;64;155;136;400
421130;201803;3172;9991;2717;9124;717;2619;1251;4086;1968;6705
421140;201803;287;834;202;649;39;124;66;188;105;312
421145;201803;462;1330;272;866;57;201;102;291;159;492
421150;201803;481;1378;309;1068;51;210;111;360;162;570
421160;201803;800;2159;426;1389;62;231;199;634;261;865
421165;201803;188;595;139;479;25;87;70;243;95;330
421170;201803;1130;3093;875;2695;139;429;536;1668;675;2097
421175;201803;1062;2926;696;2265;136;531;253;720;389;1251
421180;201803;411;1084;194;634;42;166;37;110;79;276
421185;201803;319;852;210;639;38;117;110;335;148;452
421187;201803;335;1017;225;739;31;99;87;271;118;370
421189;201803;351;1085;265;890;43;151;83;261;126;412
421190;201803;9781;27104;6021;20023;1218;4496;1088;3394;2306;7890
421200;201803;711;2217;588;1981;110;397;251;804;361;1201
421205;201803;191;541;146;463;30;112;66;197;96;309
421210;201803;1035;2947;701;2288;169;575;240;762;409;1337
421220;201803;1355;4467;1147;3989;290;1114;203;611;493;1725
421223;201803;393;1172;265;915;58;218;97;324;155;542
421225;201803;960;3026;824;2742;177;645;417;1404;594;2049
421227;201803;955;2641;609;1961;107;386;309;993;416;1379
421230;201803;565;1556;375;1216;102;356;125;413;227;769
421240;201803;325;1018;149;563;16;80;20;77;36;157
421250;201803;1382;3762;868;2889;185;670;252;826;437;1496
421260;201803;266;772;52;189;11;41;7;26;18;67
421265;201803;677;2027;615;1935;53;192;476;1482;529;1674
421270;201803;445;1244;215;775;41;148;69;242;110;390
421280;201803;1465;4564;1150;3962;243;914;495;1683;738;2597
421290;201803;768;2141;446;1415;81;266;81;233;162;499
421300;201803;211;636;143;486;37;143;38;129;75;272
421310;201803;179;559;138;457;25;91;46;146;71;237
421315;201803;239;728;145;508;23;82;18;68;41;150
421320;201803;628;1905;365;1245;65;233;57;134;122;367
421330;201803;552;1722;414;1448;99;368;105;369;204;737
421335;201803;357;1172;292;1040;65;266;72;250;137;516
421340;201803;1363;3914;1030;3311;196;689;461;1427;657;2116
421350;201803;1034;3131;803;2704;133;550;385;1227;518;1777
421360;201803;2224;6392;1395;4706;318;1263;474;1431;792;2694
421370;201803;437;1480;285;1082;73;289;61;236;134;525
421380;201803;778;2246;668;2047;104;344;358;1058;462;1402
421390;201803;156;413;62;195;10;37;18;39;28;76
421400;201803;247;801;178;671;44;182;73;260;117;442
421410;201803;238;692;113;415;15;64;44;157;59;221
421415;201803;333;1036;154;529;38;139;29;81;67;220
421420;201803;600;1773;482;1555;80;274;249;765;329;1039
421430;201803;135;464;107;392;17;69;30;102;47;171
421440;201803;635;1789;436;1447;76;268;211;707;287;975
421450;201803;380;1166;226;798;29;118;40;154;69;272
421460;201803;414;1184;251;880;55;212;69;221;124;433
421470;201803;252;822;185;672;37;163;55;184;92;347
421480;201803;2606;7171;1695;5564;495;1870;365;1006;860;2876
421490;201803;145;443;77;287;12;49;17;47;29;96
421500;201803;1944;6252;1402;5084;378;1522;218;717;596;2239
421505;201803;300;940;265;880;47;169;142;464;189;633
421507;201803;381;1161;236;838;61;239;74;251;135;490
421510;201803;225;664;144;474;30;94;62;175;92;269
421520;201803;559;1573;355;1109;52;196;167;473;219;669
421530;201803;318;994;179;641;32;140;38;115;70;255
421535;201803;430;1267;285;978;35;139;144;459;179;598
421540;201803;214;572;151;467;21;80;65;183;86;263
421545;201803;643;1956;469;1616;102;402;189;619;291;1021
421550;201803;1889;5679;1610;5235;401;1435;734;2304;1135;3739
421555;201803;215;632;68;248;16;69;11;27;27;96
421560;201803;109;344;56;211;11;48;10;36;21;84
421565;201803;746;2041;553;1737;127;457;204;644;331;1101
421567;201803;481;1716;351;1346;169;660;55;221;224;881
421568;201803;408;1258;280;953;44;158;107;345;151;503
421569;201803;190;576;70;256;18;62;17;67;35;129
421570;201803;1069;3056;681;2233;172;615;123;364;295;979
421575;201803;332;1038;293;931;41;145;162;486;203;631
421580;201803;2633;8125;1933;6648;412;1637;621;1880;1033;3517
421590;201803;149;495;126;432;18;65;69;228;87;293
421600;201803;456;1321;314;997;70;227;75;223;145;450
421605;201803;757;2131;506;1670;95;327;144;456;239;783
421610;201803;1198;3315;748;2422;144;501;160;468;304;969
421620;201803;3617;10496;2170;7592;596;2272;472;1603;1068;3875
421625;201803;264;723;103;349;22;69;15;43;37;112
421630;201803;2496;7193;1409;4650;244;932;300;889;544;1821
421635;201803;227;678;130;435;16;64;46;129;62;193
421640;201803;818;2323;557;1836;122;432;176;570;298;1002
421650;201803;2016;6104;1346;4678;307;1244;221;595;528;1839
421660;201803;6663;20808;5407;18292;1006;3798;1949;6045;2955;9843
421670;201803;853;2519;586;1917;144;534;204;634;348;1168
421680;201803;912;2891;730;2504;229;838;207;658;436;1496
421690;201803;1158;3708;845;2952;200;793;190;631;390;1424
421700;201803;461;1473;245;912;43;179;59;196;102;375
421710;201803;193;629;86;298;20;81;27;84;47;165
421715;201803;108;308;73;232;14;46;45;133;59;179
421720;201803;1795;5206;1072;3678;261;968;257;786;518;1754
421725;201803;169;450;103;322;24;86;35;88;59;174
421730;201803;365;1136;198;642;34;127;67;190;101;317
421740;201803;607;1858;420;1410;102;385;110;330;212;715
421750;201803;864;2147;460;1402;71;228;173;494;244;722
421755;201803;212;605;106;353;15;63;42;123;57;186
421760;201803;901;2639;487;1688;77;286;110;325;187;611
421770;201803;2289;6522;1680;5440;411;1358;590;2068;1001;3426
421775;201803;243;717;176;573;30;105;81;248;111;353
421780;201803;823;2737;576;2154;129;509;158;565;287;1074
421790;201803;609;1616;367;1232;120;428;129;405;249;833
421795;201803;235;714;143;461;23;85;54;153;77;238
421800;201803;2313;6814;1710;5678;365;1329;714;2249;1079;3578
421810;201803;618;1772;443;1428;75;277;189;566;264;843
421820;201803;803;2327;422;1444;86;315;61;176;147;491
421825;201803;1281;3867;1176;3698;170;592;793;2433;963;3025
421830;201803;2158;7086;1859;6489;454;1754;624;2056;1078;3810
421835;201803;210;566;123;408;22;90;56;163;78;253
421840;201803;229;719;157;565;37;144;47;158;84;302
421850;201803;395;1225;223;788;36;140;50;145;86;285
421860;201803;267;826;178;631;27;114;52;153;79;267
421870;201803;3173;8653;2205;6766;491;1678;727;2074;1218;3752
421875;201803;273;831;122;454;22;86;18;50;40;136
421880;201803;558;1644;412;1358;116;420;62;197;178;617
421885;201803;234;693;184;614;60;214;42;121;102;335
421890;201803;739;2453;601;2178;163;665;222;719;385;1384
421895;201803;322;979;294;939;44;157;199;626;243;783
421900;201803;872;2337;603;1804;108;363;262;723;370;1086
421910;201803;365;1152;259;915;58;243;48;135;106;378
421915;201803;418;1238;245;819;45;141;38;128;83;269
421917;201803;553;1547;365;1276;127;492;80;277;207;769
421920;201803;519;1532;345;1256;164;612;101;388;265;1000
421930;201803;2229;6066;1113;3832;303;1109;126;389;429;1498
421935;201803;466;1560;368;1349;78;307;170;580;248;887
421940;201803;239;764;126;441;22;98;39;124;61;222
421950;201803;2931;7621;1386;4555;294;1074;217;648;511;1722
421960;201803;150;409;104;337;16;62;28;94;44;156
421970;201803;1954;5270;1056;3406;229;762;243;703;472;1465
421985;201803;324;821;173;525;27;94;48;155;75;249
422000;201803;1570;4489;1284;3969;212;775;693;2077;905;2852
430003;201803;538;1594;384;1315;82;323;131;424;213;747
430005;201803;278;780;179;588;51;164;70;235;121;399
430010;201803;1692;4583;1331;3944;234;745;729;2112;963;2857
430020;201803;591;1432;465;1267;70;221;274;711;344;932
430030;201803;1017;2545;608;1783;169;513;176;514;345;1027
430040;201803;9631;25149;5993;18132;1539;5161;296;970;1835;6131
430045;201803;562;1517;392;1161;47;146;202;569;249;715
430047;201803;267;626;111;338;23;76;33;99;56;175
430050;201803;929;2498;530;1630;115;362;125;361;240;723
430055;201803;280;724;130;395;13;43;60;162;73;205
430057;201803;104;244;37;114;9;35;5;9;14;44
430060;201803;15713;46605;12805;41861;3368;11753;4870;16136;8238;27889
430063;201803;847;2458;673;2071;147;448;369;1131;516;1579
430064;201803;1011;2995;762;2427;222;769;190;585;412;1354
430066;201803;125;292;88;230;4;15;58;142;62;157
430070;201803;658;1749;119;404;10;33;9;18;19;51
430080;201803;743;2006;440;1379;83;278;171;481;254;759
430085;201803;873;2193;524;1556;86;279;187;560;273;839
430087;201803;590;1830;490;1658;97;361;238;781;335;1142
430090;201803;633;1662;210;685;21;81;56;178;77;259
430100;201803;667;1718;354;1096;64;216;121;331;185;547
430105;201803;977;2690;633;2075;106;410;284;932;390;1342
430107;201803;172;533;122;409;18;61;30;88;48;149
430110;201803;2075;5369;1513;4507;286;890;765;2202;1051;3092
430120;201803;1398;4340;884;3007;203;711;346;1226;549;1937
430130;201803;3809;10306;3051;9159;997;2739;970;3583;1967;6322
430140;201803;953;2861;606;2064;162;550;196;665;358;1215
430150;201803;574;1501;319;999;67;212;87;267;154;479
430155;201803;284;756;145;465;19;70;36;98;55;168
430160;201803;17174;45924;13813;40646;3339;10305;4882;15026;8221;25331
430163;201803;2250;5918;1616;4887;194;669;961;2865;1155;3534
430165;201803;435;1015;85;274;10;26;7;21;17;47
430170;201803;888;2488;324;1161;59;222;64;208;123;430
430175;201803;688;2208;568;1903;149;470;267;904;416;1374
430180;201803;681;1812;550;1582;94;303;329;892;423;1195
430185;201803;456;1148;286;819;48;144;127;322;175;466
430187;201803;613;1649;445;1370;79;265;189;571;268;836
430190;201803;1420;4139;1196;3683;285;916;490;1486;775;2402
430192;201803;134;411;59;185;9;29;10;27;19;56
430195;201803;367;1113;70;242;10;34;6;17;16;51
430200;201803;1088;3475;922;3142;281;1001;286;965;567;1966
430205;201803;500;1413;392;1193;18;71;308;905;326;976
430210;201803;5103;13250;3483;9936;526;1661;1396;3231;1922;4892
430215;201803;312;851;215;647;37;120;87;252;124;372
430220;201803;649;1633;177;599;33;117;39;116;72;233
430222;201803;195;601;159;519;22;74;68;209;90;283
430223;201803;269;776;225;685;40;130;109;324;149;454
430225;201803;16;42;14;38;2;3;7;12;9;15
430230;201803;1558;4596;1456;4459;210;596;1112;3492;1322;4088
430235;201803;230;720;175;588;26;102;63;202;89;304
430237;201803;518;1323;368;1061;24;81;244;658;268;739
430240;201803;1156;2635;688;1910;70;228;400;1075;470;1303
430245;201803;717;2208;552;1856;177;605;243;838;420;1443
430250;201803;1011;2805;816;2505;236;773;46;136;282;909
430258;201803;114;328;89;284;8;29;47;151;55;180
430260;201803;601;1695;439;1367;83;255;215;688;298;943
430265;201803;207;615;153;515;28;102;41;135;69;237
430270;201803;2746;7253;2253;6488;252;786;1499;4257;1751;5043
430280;201803;4562;11681;3459;9700;792;2282;1422;4010;2214;6292
430290;201803;2185;5587;1944;5254;82;260;1666;4439;1748;4699
430300;201803;8290;23200;6617;20057;1368;4469;3069;9241;4437;13710
430310;201803;7529;20337;5190;16001;866;3068;2310;6678;3176;9746
430320;201803;901;2543;499;1646;90;273;237;836;327;1109
430330;201803;624;1588;423;1189;104;313;181;448;285;761
430340;201803;733;1727;367;1114;69;216;186;553;255;769
430350;201803;5629;16419;4589;14226;1264;4065;1797;5424;3061;9489
430355;201803;358;915;124;404;28;99;13;42;41;141
430360;201803;748;2009;546;1630;104;330;190;541;294;871
430367;201803;336;838;174;524;49;166;50;148;99;314
430370;201803;518;1454;260;854;56;192;56;158;112;350
430380;201803;674;1725;365;1153;108;383;92;299;200;682
430390;201803;3163;8237;1756;5431;291;961;130;333;421;1294
430400;201803;1120;2621;835;2160;130;342;510;1273;640;1615
430410;201803;578;1482;411;1196;51;179;251;707;302;886
430420;201803;2862;8230;2216;6747;677;2158;692;2034;1369;4192
430430;201803;554;1521;322;1015;79;268;66;189;145;457
430435;201803;1561;4199;1144;3459;281;878;360;1100;641;1978
430440;201803;3571;10601;2681;8727;544;1899;1256;4136;1800;6035
430450;201803;5966;16635;5045;14884;1018;3267;2324;6761;3342;10028
430460;201803;25968;71632;18623;59380;4199;14834;7104;21768;11303;36602
430461;201803;464;1203;140;446;25;86;30;83;55;169
430462;201803;251;685;163;527;26;95;37;132;63;227
430463;201803;4268;12756;3511;11387;667;2362;1724;5546;2391;7908
430465;201803;482;1316;400;1154;78;243;234;653;312;896
430466;201803;3546;9256;2905;8225;671;1984;1400;3801;2071;5785
430467;201803;498;1328;375;1114;62;211;167;471;229;682
430468;201803;1320;3465;1047;3051;169;538;569;1645;738;2183
430469;201803;565;1611;67;227;8;18;9;20;17;38
430470;201803;6047;16515;4304;13406;1362;4478;852;2706;2214;7184
430471;201803;481;1538;424;1403;95;324;175;558;270;882
430480;201803;916;2447;463;1488;68;245;71;203;139;448
430485;201803;142;399;52;176;8;29;9;27;17;56
430490;201803;360;975;206;640;35;120;89;272;124;392
430495;201803;378;1089;241;798;27;98;97;290;124;388
430500;201803;1079;2889;801;2416;197;663;309;852;506;1515
430510;201803;21925;60601;16005;48636;3789;12574;5496;15444;9285;28018
430511;201803;336;1009;134;463;21;65;18;54;39;119
430512;201803;897;2238;733;1972;188;520;233;648;421;1168
430513;201803;789;2033;397;1154;95;290;152;413;247;703
430515;201803;380;1110;277;900;47;140;133;441;180;581
430517;201803;960;3041;779;2662;139;475;374;1332;513;1807
430520;201803;1308;3569;713;2279;144;480;114;323;258;803
430530;201803;1094;2861;402;1260;78;239;89;270;167;509
430535;201803;2832;7911;2003;6286;356;1164;862;2680;1218;3844
430537;201803;351;1250;311;1117;45;161;218;787;263;948
430540;201803;580;1363;352;1011;61;180;181;503;242;683
430543;201803;599;1244;394;1008;60;136;258;693;318;829
430544;201803;607;1891;461;1545;102;359;216;693;318;1052
430545;201803;1593;4669;1230;4105;330;1162;517;1779;847;2941
430550;201803;510;1452;276;912;59;201;60;177;119;378
430558;201803;136;347;65;209;15;51;17;50;32;101
430560;201803;406;955;176;533;19;61;43;129;62;190
430570;201803;878;2164;594;1668;83;280;331;844;414;1124
430580;201803;1088;2656;680;2005;119;397;320;906;439;1303
430583;201803;180;468;37;117;4;13;6;19;10;32
430585;201803;231;573;131;372;21;69;64;155;85;224
430587;201803;173;537;137;454;27;93;57;195;84;288
430590;201803;1379;3468;1193;3160;57;193;1033;2682;1090;2875
430593;201803;14;45;13;44;1;3;8;28;9;31
430595;201803;433;1053;85;302;7;31;11;34;18;65
430597;201803;322;928;219;675;21;76;89;232;110;308
430600;201803;1789;4837;855;2644;161;497;211;613;372;1110
430605;201803;1135;3342;877;2797;133;519;331;1024;464;1543
430607;201803;671;1537;486;1254;37;110;322;849;359;959
430610;201803;5889;15323;4267;12767;1244;4043;624;1928;1868;5971
430613;201803;292;685;91;273;6;23;27;65;33;88
430620;201803;565;1534;447;1305;119;385;195;536;314;921
430630;201803;443;1283;131;432;21;71;24;65;45;136
430632;201803;589;1609;276;846;32;101;114;332;146;433
430635;201803;520;1471;393;1198;73;247;236;691;309;938
430637;201803;409;1118;340;1010;55;176;189;530;244;706
430640;201803;1272;3369;685;2119;99;318;191;522;290;840
430642;201803;381;1043;257;780;40;120;125;371;165;491
430645;201803;264;594;95;265;17;50;18;54;35;104
430650;201803;1558;4974;1306;4434;319;1110;641;2204;960;3314
430655;201803;161;408;117;331;28;80;48;122;76;202
430660;201803;4828;13242;3721;11246;824;2706;1614;4803;2438;7509
430670;201803;524;1422;410;1208;39;133;271;798;310;931
430673;201803;605;1444;241;723;49;151;78;232;127;383
430675;201803;225;669;52;188;13;51;11;37;24;88
430676;201803;4078;11025;3138;9395;556;1750;1507;4461;2063;6211
430680;201803;980;2706;590;1914;133;420;128;398;261;818
430690;201803;3266;9308;2665;8171;787;2502;715;2183;1502;4685
430692;201803;210;665;165;590;12;42;114;417;126;459
430693;201803;1040;2743;580;1787;121;431;121;327;242;758
430695;201803;546;1366;330;960;37;112;176;483;213;595
430697;201803;413;1100;298;897;55;166;142;448;197;614
430700;201803;7264;18776;3903;12489;913;3165;313;1051;1226;4216
430705;201803;281;791;156;509;19;68;63;195;82;263
430710;201803;1695;3972;1227;3246;218;642;604;1554;822;2196
430720;201803;688;1726;386;1197;84;260;132;402;216;662
430730;201803;1278;3423;834;2618;139;447;404;1290;543;1737
430740;201803;577;1659;319;1094;59;205;81;302;140;507
430745;201803;468;1320;239;772;38;134;52;155;90;289
430750;201803;1337;3605;960;2954;197;661;498;1469;695;2130
430755;201803;478;1201;304;849;21;64;168;429;189;493
430760;201803;2020;5367;1529;4562;361;1115;641;1882;1002;2997
430770;201803;5836;15840;4431;13547;757;2526;2423;7216;3180;9742
430780;201803;2185;5628;1300;4088;254;843;412;1364;666;2207
430781;201803;383;1132;247;811;56;190;52;166;108;356
430783;201803;465;1134;269;803;28;98;132;372;160;470
430786;201803;57;197;37;146;8;29;4;21;12;50
430790;201803;4181;11198;2859;8594;522;1733;1410;3988;1932;5721
430800;201803;796;2119;566;1641;52;181;331;909;383;1090
430805;201803;514;1434;300;927;34;115;154;444;188;559
430807;201803;387;983;248;733;25;84;116;325;141;409
430810;201803;874;2231;278;929;44;143;65;207;109;350
430820;201803;1236;3440;684;2309;158;543;131;437;289;980
430825;201803;273;722;94;269;22;61;20;52;42;113
430830;201803;1546;4722;1323;4315;126;465;898;2941;1024;3406
430840;201803;876;2528;745;2294;146;444;415;1275;561;1719
430843;201803;111;283;37;114;7;20;11;30;18;50
430845;201803;314;820;219;648;83;261;34;82;117;343
430850;201803;2261;6322;1789;5449;376;1275;835;2504;1211;3779
430860;201803;900;2224;440;1341;79;299;176;472;255;771
430865;201803;527;1409;450;1276;122;364;189;502;311;866
430870;201803;653;1792;293;981;49;180;79;234;128;414
430880;201803;1175;2931;778;2285;204;616;293;866;497;1482
430885;201803;226;551;101;342;8;36;63;206;71;242
430890;201803;1236;3312;819;2490;58;257;113;314;171;571
430900;201803;2859;6924;1967;5522;272;869;1028;2732;1300;3601
430905;201803;852;2324;542;1701;104;363;158;468;262;831
430910;201803;1431;4013;946;3000;179;670;368;1046;547;1716
430912;201803;480;1353;331;1083;43;150;196;653;239;803
430915;201803;513;1605;377;1356;106;379;131;509;237;888
430920;201803;20754;55422;16221;48104;2536;8206;9164;26541;11700;34747
430925;201803;143;318;60;167;11;28;21;62;32;90
430930;201803;9805;24159;5923;17905;1484;4776;1568;5000;3052;9776
430940;201803;1262;3772;680;2267;173;593;102;291;275;884
430950;201803;735;1920;471;1404;79;269;228;619;307;888
430955;201803;181;477;58;188;12;31;9;34;21;65
430957;201803;186;653;170;617;34;127;85;306;119;433
430960;201803;1289;3168;855;2424;186;576;422;1177;608;1753
430965;201803;1555;4036;1242;3522;75;256;944;2598;1019;2854
430970;201803;374;999;195;615;23;81;100;302;123;383
430975;201803;457;1521;362;1280;83;313;144;504;227;817
430980;201803;382;967;231;694;48;155;84;245;132;400
430990;201803;542;1636;314;1049;53;200;130;428;183;628
430995;201803;577;1583;415;1283;74;231;193;578;267;809
431000;201803;1405;3448;601;1820;106;351;28;71;134;422
431010;201803;2210;6049;1288;4276;183;704;107;297;290;1001
431020;201803;8566;20002;5379;14858;1261;3742;1581;4053;2842;7795
431030;201803;329;931;144;515;34;115;18;72;52;187
431033;201803;2870;7808;2034;6495;542;1852;662;2192;1204;4044
431036;201803;334;744;61;188;7;15;12;35;19;50
431040;201803;901;2437;596;1862;98;359;270;777;368;1136
431041;201803;470;1139;363;973;49;139;212;563;261;702
431043;201803;429;1095;217;707;76;255;60;188;136;443
431046;201803;124;329;58;171;6;18;12;33;18;51
431050;201803;1532;3811;1078;3086;223;673;528;1492;751;2165
431053;201803;506;1510;345;1172;87;312;92;309;179;621
431055;201803;594;1547;523;1436;43;121;396;1074;439;1195
431057;201803;283;832;136;464;26;96;37;112;63;208
431060;201803;4886;14015;3807;12015;1151;3955;713;2387;1864;6342
431065;201803;496;1339;330;1027;63;198;89;269;152;467
431070;201803;506;1512;295;992;78;282;39;106;117;388
431075;201803;202;626;150;525;33;121;50;176;83;297
431080;201803;646;1846;445;1405;81;265;133;408;214;673
431085;201803;687;1915;509;1509;81;228;285;837;366;1065
431087;201803;447;1302;373;1138;22;73;266;819;288;892
431090;201803;436;1041;157;489;30;100;38;118;68;218
431100;201803;3068;7553;2281;6460;434;1348;943;2628;1377;3976
431110;201803;1376;3368;988;2674;259;729;405;1023;664;1752
431112;201803;506;1601;444;1475;78;271;233;753;311;1024
431113;201803;382;1097;313;962;100;320;117;368;217;688
431115;201803;1157;3320;919;2893;153;538;502;1521;655;2059
431120;201803;2447;7180;1731;5688;576;2129;388;1152;964;3281
431123;201803;397;1149;253;843;56;176;115;401;171;577
431125;201803;1150;3491;826;2767;290;948;235;855;525;1803
431127;201803;281;774;69;229;8;24;13;33;21;57
431130;201803;3269;9132;2202;7012;469;1621;768;2405;1237;4026
431140;201803;4734;11633;2608;7607;356;1119;931;2396;1287;3515
431142;201803;472;1343;358;1139;58;185;212;671;270;856
431150;201803;978;2790;703;2228;168;554;277;861;445;1415
431160;201803;660;1908;496;1574;105;329;193;633;298;962
431162;201803;524;1256;217;685;28;103;61;180;89;283
431164;201803;225;546;48;159;12;50;3;7;15;57
431170;201803;572;1555;362;1137;102;332;96;299;198;631
431171;201803;680;1765;564;1591;83;241;331;916;414;1157
431173;201803;411;1158;311;980;119;392;70;225;189;617
431175;201803;898;2419;618;1899;171;527;115;363;286;890
431177;201803;729;2208;540;1857;167;603;204;697;371;1300
431179;201803;344;718;75;214;11;31;16;33;27;64
431180;201803;2097;5575;1294;4011;322;1058;223;689;545;1747
431190;201803;493;1335;267;847;36;110;53;140;89;250
431198;201803;313;1007;276;935;95;337;89;329;184;666
431200;201803;386;1040;98;330;9;22;1;3;10;25
431205;201803;214;624;90;331;22;84;35;132;57;216
431210;201803;640;1685;518;1504;135;382;253;771;388;1153
431213;201803;231;705;178;607;19;74;95;326;114;400
431215;201803;337;976;209;685;19;67;86;257;105;324
431217;201803;141;411;95;319;11;37;49;155;60;192
431220;201803;682;1873;391;1268;34;133;173;510;207;643
431225;201803;1367;3595;1048;3022;161;479;580;1692;741;2171
431230;201803;684;2037;510;1592;84;283;261;787;345;1070
431235;201803;130;359;26;79;5;13;2;4;7;17
431237;201803;386;1166;312;1033;54;209;155;490;209;699
431238;201803;27;78;22;64;6;19;5;12;11;31
431240;201803;3801;10289;3010;8967;682;2274;1268;3600;1950;5874
431242;201803;344;995;282;870;58;182;130;404;188;586
431244;201803;317;763;158;455;21;76;54;123;75;199
431245;201803;1118;2888;753;2173;122;392;330;906;452;1298
431247;201803;215;615;108;363;17;53;23;77;40;130
431250;201803;1390;4183;1119;3743;254;853;492;1728;746;2581
431260;201803;241;688;134;468;12;57;42;132;54;189
431261;201803;260;846;213;745;33;124;84;277;117;401
431262;201803;409;1180;176;616;17;60;97;343;114;403
431265;201803;1348;3330;588;1778;101;339;176;442;277;781
431267;201803;279;770;155;456;6;23;101;270;107;293
431270;201803;2622;6342;1419;4241;396;1286;363;1112;759;2398
431275;201803;165;463;80;267;18;64;12;33;30;97
431280;201803;248;689;68;235;8;27;7;17;15;44
431290;201803;303;886;220;724;27;99;84;243;111;342
431295;201803;74;201;26;83;4;17;6;17;10;34
431300;201803;385;955;54;186;3;12;11;33;14;45
431301;201803;242;730;60;210;7;21;3;4;10;25
431303;201803;586;1556;327;1000;40;146;119;339;159;485
431306;201803;2099;5124;1235;3618;163;551;444;1185;607;1736
431308;201803;25;85;23;78;12;43;6;19;18;62
431310;201803;601;1745;344;1117;58;197;116;385;174;582
431320;201803;637;1766;300;1033;59;208;39;123;98;331
431330;201803;1831;4534;909;2805;219;772;168;448;387;1220
431333;201803;328;887;115;351;15;42;30;83;45;125
431335;201803;35;100;21;70;5;12;3;4;8;16
431337;201803;2533;7078;1706;5564;486;1741;363;1115;849;2856
431339;201803;485;1289;331;987;76;233;152;450;228;683
431340;201803;19793;51290;14040;41282;2974;9538;4394;12277;7368;21815
431342;201803;461;1104;352;937;45;150;263;666;308;816
431344;201803;375;1005;248;758;13;44;163;491;176;535
431346;201803;274;698;100;318;14;42;20;70;34;112
431349;201803;686;1904;381;1175;67;214;134;378;201;592
431350;201803;3819;10628;2858;8877;672;2250;1011;3071;1683;5321
431360;201803;598;1485;354;1048;67;206;150;428;217;634
431365;201803;1703;4619;1401;4141;154;503;944;2801;1098;3304
431370;201803;4141;11182;3105;9373;743;2351;1291;4076;2034;6427
431380;201803;737;2182;644;2018;73;263;397;1232;470;1495
431390;201803;2411;6262;1376;4252;241;839;445;1236;686;2075
431395;201803;1247;3511;913;2958;220;726;355;1190;575;1916
431400;201803;389;1179;196;644;35;116;41;126;76;242
431402;201803;976;2331;645;1754;109;312;366;955;475;1267
431403;201803;160;461;135;417;17;80;89;251;106;331
431405;201803;4103;11303;3366;10168;417;1457;2042;6038;2459;7495
431406;201803;470;1466;382;1304;94;313;192;666;286;979
431407;201803;453;1269;302;954;58;189;119;370;177;559
431410;201803;14087;38776;9163;29122;1920;6939;2850;8471;4770;15410
431413;201803;177;455;48;156;2;7;6;19;8;26
431415;201803;669;1753;416;1321;80;300;137;379;217;679
431417;201803;488;1213;379;1041;63;180;214;567;277;747
431420;201803;1236;3246;1045;2939;214;619;434;1285;648;1904
431430;201803;514;1376;279;881;51;180;68;183;119;363
431440;201803;21602;56224;16236;47286;4003;12391;4653;13823;8656;26214
431442;201803;104;301;55;185;6;20;6;12;12;32
431445;201803;469;1346;158;541;26;81;30;98;56;179
431446;201803;358;1056;239;786;75;254;58;178;133;432
431447;201803;591;1663;396;1250;89;281;170;537;259;818
431449;201803;695;1923;466;1413;49;157;231;693;280;850
431450;201803;2038;4608;1722;4186;138;365;1296;3033;1434;3398
431454;201803;38;119;36;115;6;20;14;54;20;74
431455;201803;623;1550;310;871;46;143;138;334;184;477
431460;201803;2744;7410;2180;6306;578;1724;699;2065;1277;3789
431470;201803;1526;4375;1118;3492;229;733;438;1374;667;2107
431475;201803;226;666;32;126;2;8;0;0;2;8
431477;201803;524;1355;312;914;43;121;145;392;188;513
431478;201803;272;709;66;201;15;50;6;16;21;66
431480;201803;3103;8013;2389;6881;353;1124;1364;3870;1717;4994
431490;201803;94258;242780;78138;218353;7878;25294;54909;149353;62787;174647
431500;201803;488;1313;371;1080;83;230;193;551;276;781
431505;201803;430;1047;266;769;25;69;147;418;172;487
431507;201803;339;809;142;406;28;90;55;137;83;227
431510;201803;1566;4304;1127;3438;231;743;437;1343;668;2086
431513;201803;291;706;142;408;14;35;88;254;102;289
431514;201803;84;234;43;149;8;34;14;42;22;76
431515;201803;550;1462;360;1086;73;242;167;469;240;711
431517;201803;74;222;54;166;9;21;12;39;21;60
431520;201803;435;1073;161;529;34;128;48;143;82;271
431530;201803;3966;8956;2407;6671;655;1853;336;934;991;2787
431531;201803;192;558;136;441;18;64;49;148;67;212
431532;201803;473;1264;340;993;71;211;137;408;208;619
431535;201803;260;630;103;309;20;65;32;89;52;154
431540;201803;1811;6030;1679;5805;91;372;1294;4474;1385;4846
431545;201803;379;1020;68;211;5;21;18;46;23;67
431550;201803;1926;5412;1582;4738;332;1049;656;1878;988;2927
431555;201803;674;1595;431;1182;42;122;253;684;295;806
431560;201803;19291;52490;13199;41974;2783;9491;3482;11876;6265;21367
431570;201803;4970;12226;3877;10734;641;1930;2235;6042;2876;7972
431575;201803;171;540;131;446;18;63;18;54;36;117
431580;201803;513;1398;264;884;41;174;101;321;142;495
431590;201803;765;2072;539;1600;103;312;186;546;289;858
431595;201803;347;998;233;743;37;107;110;344;147;451
431600;201803;1504;3938;1089;3259;281;929;302;900;583;1829
431610;201803;1352;3730;962;2948;124;353;466;1479;590;1832
431620;201803;513;1416;229;692;49;146;102;286;151;432
431630;201803;1207;3241;598;1907;173;578;158;445;331;1023
431640;201803;5885;15827;5293;14967;777;2254;3565;10163;4342;12417
431642;201803;497;1294;321;938;32;91;153;429;185;520
431643;201803;342;889;150;444;23;61;41;110;64;171
431645;201803;1629;4359;1305;3818;171;540;850;2482;1021;3022
431647;201803;173;468;100;307;13;48;24;60;37;108
431650;201803;218;656;154;514;26;100;46;139;72;239
431660;201803;898;2459;499;1637;83;296;113;308;196;604
431670;201803;1145;2883;813;2317;139;454;378;1016;517;1470
431673;201803;248;671;92;343;18;63;9;29;27;92
431675;201803;679;1717;133;440;11;47;41;114;52;161
431680;201803;7307;20177;5574;16702;1487;4648;1928;5782;3415;10430
431690;201803;19102;51589;14013;42217;3493;10998;4342;13558;7835;24556
431695;201803;145;393;96;304;19;64;40;99;59;163
431697;201803;454;1149;367;1003;67;175;201;577;268;752
431700;201803;1382;3792;1191;3444;190;527;664;1920;854;2447
431710;201803;11008;29953;8647;26351;2318;7416;3190;10395;5508;17811
431720;201803;6045;16197;4009;12067;976;3110;714;1958;1690;5068
431725;201803;28;81;18;61;3;12;6;19;9;31
431730;201803;3436;9276;2474;7638;660;2224;736;2371;1396;4595
431740;201803;4678;12157;3326;9786;998;3294;605;1510;1603;4804
431750;201803;7161;19968;6110;18299;1242;4042;2978;8993;4220;13035
431755;201803;337;920;69;249;11;45;12;44;23;89
431760;201803;5333;12786;3415;9609;412;1363;1952;5178;2364;6541
431770;201803;1769;4530;1417;4020;162;499;956;2669;1118;3168
431775;201803;202;542;99;309;17;56;11;25;28;81
431780;201803;1881;5092;1317;3970;249;778;428;1244;677;2022
431790;201803;946;2685;693;2151;143;470;250;736;393;1206
431795;201803;265;705;146;444;31;95;41;120;72;215
431800;201803;6986;19450;5222;16279;1676;5720;628;2038;2304;7758
431805;201803;292;698;91;299;5;20;39;119;44;139
431810;201803;3175;8009;2047;5845;401;1262;830;2233;1231;3495
431820;201803;2137;6298;1803;5707;385;1264;750;2415;1135;3679
431830;201803;9204;21548;6973;18299;1573;4525;2785;7299;4358;11824
431840;201803;2396;6898;1982;6173;401;1292;1040;3255;1441;4547
431842;201803;713;1780;249;765;36;127;72;202;108;329
431843;201803;308;872;239;728;30;99;106;310;136;409
431844;201803;263;705;75;245;22;80;13;32;35;112
431845;201803;481;1326;340;1025;17;48;212;635;229;683
431846;201803;239;713;207;665;13;61;166;518;179;579
431848;201803;190;499;95;302;5;18;13;31;18;49
431849;201803;428;1034;65;189;8;25;6;12;14;37
431850;201803;3998;11459;3208;9783;735;2377;1007;2983;1742;5360
431860;201803;686;1785;441;1298;85;253;216;602;301;855
431861;201803;122;325;53;179;6;20;16;48;22;68
431862;201803;441;1462;363;1313;83;334;168;589;251;923
431870;201803;16603;46462;13384;40757;2502;8575;6041;17729;8543;26304
431880;201803;3608;10162;2850;8747;566;1954;1181;3475;1747;5429
431890;201803;4366;11700;2818;8613;827;2735;400;1275;1227;4010
431900;201803;1010;2715;610;1883;133;464;279;802;412;1266
431910;201803;785;1941;313;926;49;144;84;230;133;374
431912;201803;429;1267;358;1129;75;243;200;630;275;873
431915;201803;945;2617;753;2284;104;347;460;1350;564;1697
431920;201803;1140;3057;968;2779;64;204;781;2224;845;2428
431930;201803;760;2176;535;1766;136;406;248;862;384;1268
431935;201803;71;210;49;166;14;48;11;33;25;81
431936;201803;297;894;175;598;44;154;41;141;85;295
431937;201803;177;483;111;342;29;93;25;66;54;159
431940;201803;2204;5834;1398;4202;277;932;514;1438;791;2370
431950;201803;1585;4529;1339;4116;293;936;635;1936;928;2872
431960;201803;2594;7068;2097;6080;552;1673;600;1705;1152;3378
431970;201803;391;1058;176;587;38;126;35;106;73;232
431971;201803;75;203;43;142;7;23;8;20;15;43
431973;201803;462;1516;389;1365;32;100;280;1006;312;1106
431975;201803;110;250;24;82;4;15;3;7;7;22
431980;201803;1116;3125;862;2661;183;600;363;1081;546;1681
431990;201803;5659;14696;3697;11594;667;2315;1165;3598;1832;5913
432000;201803;9689;25403;7366;21593;2049;6193;2864;8396;4913;14589
432010;201803;1872;5137;1470;4392;213;709;773;2200;986;2909
432020;201803;1893;4632;1320;3694;327;956;609;1630;936;2586
432023;201803;481;1226;268;801;41;156;127;324;168;480
432026;201803;988;2952;734;2421;165;523;366;1212;531;1735
432030;201803;319;872;197;609;36;110;99;293;135;403
432032;201803;436;1175;296;886;28;94;149;414;177;508
432035;201803;762;2250;668;2094;197;673;231;724;428;1397
432040;201803;931;2272;421;1307;70;242;134;402;204;644
432045;201803;238;661;124;424;31;106;30;112;61;218
432050;201803;514;1396;411;1206;124;381;131;389;255;770
432055;201803;774;2083;497;1552;135;456;168;497;303;953
432057;201803;289;747;214;595;40;89;95;253;135;342
432060;201803;466;1169;144;481;24;99;49;140;73;239
432065;201803;214;608;163;493;39;123;50;149;89;272
432067;201803;761;2289;609;1944;87;285;361;1131;448;1416
432070;201803;2006;5426;1235;3817;260;869;239;668;499;1537
432080;201803;3557;9571;2897;8437;773;2514;1107;3108;1880;5622
432085;201803;379;973;241;753;79;238;86;283;165;521
432090;201803;1252;3470;937;2865;226;746;386;1132;612;1878
432100;201803;1090;3042;472;1592;77;285;33;65;110;350
432110;201803;2239;6384;1535;4984;346;1305;104;328;450;1633
432120;201803;3054;8996;2504;8002;813;2788;512;1617;1325;4405
432130;201803;2532;6928;2146;6390;780;2443;734;2222;1514;4665
432132;201803;262;730;126;426;25;86;42;134;67;220
432135;201803;776;2138;570;1713;73;241;374;1093;447;1334
432140;201803;1542;4889;1180;4170;223;814;573;2094;796;2908
432143;201803;1299;3664;1034;3232;127;445;601;1868;728;2313
432145;201803;1315;3788;800;2602;126;452;146;396;272;848
432146;201803;112;343;80;272;25;89;16;48;41;137
432147;201803;346;1159;284;1024;83;309;59;216;142;525
432149;201803;371;1003;223;669;24;70;101;298;125;368
432150;201803;2934;8124;2167;6642;543;1870;600;1764;1143;3634
432160;201803;4233;12483;3433;11147;1025;3517;982;3164;2007;6681
432162;201803;341;803;46;137;5;12;6;18;11;30
432163;201803;208;567;42;138;3;11;3;11;6;22
432166;201803;526;1573;418;1339;81;290;123;340;204;630
432170;201803;1265;3621;817;2715;176;654;193;598;369;1252
432180;201803;2364;6253;1304;4053;271;921;319;874;590;1795
432183;201803;325;1024;236;806;62;228;48;165;110;393
432185;201803;831;2227;518;1605;39;128;314;937;353;1065
432190;201803;2126;5685;1386;4192;340;1149;490;1364;830;2513
432195;201803;1001;2597;645;1959;184;516;188;607;372;1123
432200;201803;2841;7992;2097;6682;487;1638;869;2846;1356;4484
432210;201803;362;1008;250;799;44;154;98;297;142;451
432215;201803;664;2063;586;1930;82;260;384;1304;466;1564
432218;201803;242;630;134;389;20;59;48;127;68;186
432220;201803;3839;9686;2904;8152;440;1409;1642;4378;2082;5787
432225;201803;104;308;75;249;16;51;29;99;45;150
432230;201803;749;1962;425;1285;65;212;144;392;209;604
432232;201803;446;1151;328;948;57;189;158;454;215;643
432234;201803;284;742;136;414;31;89;21;55;52;144
432235;201803;102;296;38;129;5;19;8;24;13;43
432237;201803;384;1026;335;939;16;47;226;599;242;646
432240;201803;12889;37108;10400;33518;965;3605;6390;21466;7355;25071
432250;201803;4066;13452;3532;12375;1095;3969;1179;4262;2274;8231
432252;201803;411;1049;277;803;49;166;116;309;165;475
432253;201803;1178;3689;654;2293;153;601;32;88;185;689
432254;201803;926;2354;191;636;27;104;18;51;45;155
432255;201803;161;413;75;238;9;32;31;87;40;119
432260;201803;5490;14222;3998;11603;1013;3046;1321;3927;2334;6973
432270;201803;2013;6044;1677;5348;528;1780;236;735;764;2515
432280;201803;1145;3030;607;1898;99;327;204;613;303;940
432285;201803;185;570;19;63;2;5;1;1;3;6
432290;201803;390;1178;227;786;62;208;56;178;118;386
432300;201803;24054;65869;19089;57854;2916;9743;11028;32703;13944;42446
432310;201803;689;2016;532;1728;101;333;288;929;389;1262
432320;201803;229;557;73;220;10;39;16;43;26;82
432330;201803;264;670;84;282;14;39;15;50;29;89
432335;201803;172;487;66;240;15;62;12;34;27;96
432340;201803;315;756;147;449;28;102;43;114;71;216
432345;201803;560;1408;511;1343;40;142;388;975;428;1117
432350;201803;344;932;168;557;30;97;51;158;81;255
432360;201803;207;620;39;131;5;26;8;21;13;47
432370;201803;330;894;222;676;20;69;139;411;159;480
432375;201803;529;1393;409;1179;59;159;231;666;290;825
432377;201803;226;728;31;106;6;22;9;22;15;44
432380;201803;1358;3939;852;2867;187;713;358;1128;545;1841
500020;201803;2036;5685;1572;4919;376;1304;674;2027;1050;3331
500025;201803;1263;2941;775;2109;68;194;458;1214;526;1408
500060;201803;6159;18322;4745;15775;699;2349;2775;9681;3474;12030
500070;201803;4032;11072;2942;9140;616;1995;1192;3881;1808;5876
500080;201803;1083;3187;815;2688;202;748;317;1007;519;1755
500085;201803;1994;4989;1364;4029;237;743;709;2043;946;2786
500090;201803;1931;5429;1326;4319;244;831;511;1744;755;2575
500100;201803;3245;8673;2474;7396;366;1212;1132;3216;1498;4428
500110;201803;6919;19567;4863;16248;988;3542;1702;6330;2690;9872
500124;201803;1913;6168;1644;5705;374;1251;846;3198;1220;4449
500150;201803;1273;3057;795;2295;170;516;262;685;432;1201
500190;201803;4565;11402;3387;9811;670;2027;1646;4942;2316;6969
500200;201803;2164;5423;1625;4472;268;803;841;2163;1109;2966
500210;201803;4444;12463;3448;10972;859;2807;1481;4807;2340;7614
500215;201803;1252;3742;923;3092;112;411;443;1444;555;1855
500220;201803;2784;8075;2116;6913;345;1235;863;2810;1208;4045
500230;201803;2285;5693;1658;4715;222;669;942;2637;1164;3306
500240;201803;3473;11073;2445;8817;438;1837;637;2415;1075;4252
500260;201803;3032;6846;1860;5153;216;613;951;2570;1167;3183
500270;201803;111700;284839;67679;203978;14389;46314;17623;51635;32012;97949
500280;201803;1271;3281;949;2800;116;382;591;1705;707;2087
500290;201803;3867;8874;2151;6298;332;1057;729;2029;1061;3086
500295;201803;2673;7162;1541;4813;242;824;483;1306;725;2130
500310;201803;890;2081;650;1766;113;269;342;985;455;1254
500315;201803;3196;9661;2582;8643;331;1113;1616;5649;1947;6762
500320;201803;17226;52230;12598;43840;3474;12964;3545;13137;7019;26101
500325;201803;3678;9028;2503;7251;310;968;1398;4053;1708;5021
500330;201803;6719;16348;4351;12433;412;1320;2253;6548;2665;7868
500345;201803;1793;4566;1259;3771;350;1048;426;1270;776;2318
500348;201803;2646;6912;2054;5953;237;729;1236;3638;1473;4367
500350;201803;1225;3500;649;2154;78;280;214;726;292;1006
500370;201803;20262;57284;14218;46683;2612;9703;5579;18361;8191;28064
500375;201803;2428;6819;1735;5338;351;1176;535;1605;886;2781
500380;201803;3428;8757;2426;7136;632;1950;873;2603;1505;4553
500390;201803;508;1110;303;812;42;119;156;407;198;526
500400;201803;1123;3238;788;2495;183;613;209;634;392;1247
500410;201803;2234;6093;1724;5289;268;805;1015;3179;1283;3984
500430;201803;2487;6629;1730;5456;305;1076;662;2215;967;3291
500440;201803;1257;3064;748;2208;116;343;271;835;387;1178
500450;201803;1270;3353;704;2258;137;444;107;303;244;747
500460;201803;3716;10543;2414;7946;512;1853;542;1838;1054;3691
500470;201803;2324;6649;1565;5029;459;1613;313;869;772;2482
500480;201803;2112;6348;1887;6051;144;438;1427;4869;1571;5307
500490;201803;823;2138;526;1659;135;486;157;501;292;987
500500;201803;3974;11095;2772;9289;930;3591;664;2278;1594;5869
500510;201803;733;1880;454;1361;31;113;256;721;287;834
500515;201803;1920;4856;1570;4360;129;341;1130;3253;1259;3594
500520;201803;3093;10509;2561;9426;567;2268;1176;4323;1743;6591
500525;201803;936;2914;758;2625;119;482;386;1364;505;1846
500540;201803;4762;12660;2755;9024;740;2842;266;827;1006;3669
500560;201803;5069;15375;4275;14227;317;1128;3211;10865;3528;11993
500568;201803;4070;9458;2501;7108;595;1949;687;1874;1282;3823
500570;201803;6976;17354;4016;12003;949;3069;764;2149;1713;5218
500580;201803;3161;8905;2473;7723;403;1308;1406;4370;1809;5678
500600;201803;3272;8444;2123;6522;440;1468;688;2122;1128;3590
500620;201803;7361;20527;5124;16128;906;3038;2151;6737;3057;9775
500625;201803;485;1380;262;875;48;182;108;347;156;529
500627;201803;729;1949;446;1407;86;265;105;348;191;613
500630;201803;5792;14780;3625;11014;850;2751;979;3009;1829;5760
500635;201803;2522;8995;2036;8244;172;708;1447;6283;1619;6991
500640;201803;1682;3919;1129;3117;53;180;774;2068;827;2248
500660;201803;17047;48480;12344;40831;4062;14865;2695;9048;6757;23913
500690;201803;2273;6579;1614;5498;723;2701;123;396;846;3097
500710;201803;3016;8719;2342;7447;637;2149;635;1995;1272;4144
500720;201803;5213;13404;3134;9920;846;2969;594;1826;1440;4795
500730;201803;902;2445;579;1827;98;305;199;643;297;948
500740;201803;4522;11449;3311;9313;289;949;1792;5103;2081;6052
500750;201803;940;2514;703;2085;103;351;310;851;413;1202
500755;201803;966;2730;595;1993;114;395;84;245;198;640
500769;201803;5079;13141;2615;8082;475;1620;405;972;880;2592
500770;201803;1567;4359;997;3272;175;609;312;1026;487;1635
500780;201803;1264;3289;842;2510;199;615;204;580;403;1195
500790;201803;8218;21954;6628;19428;1245;3955;3525;10417;4770;14372
500793;201803;1891;5191;1331;4217;446;1462;193;544;639;2006
500795;201803;2320;6469;1926;5934;176;470;1489;4840;1665;5310
500797;201803;718;1985;489;1535;102;340;170;507;272;847
500800;201803;2668;6707;1848;5473;632;2104;311;969;943;3073
500830;201803;17711;46052;12249;35900;1943;6183;5399;15161;7342;21344
500840;201803;1115;3019;723;2242;89;294;287;835;376;1129
510010;201803;1434;3907;1081;3340;238;719;547;1757;785;2476
510020;201803;3301;8866;1858;5895;395;1316;374;1041;769;2357
510025;201803;6784;18607;4319;13886;798;2805;1214;3727;2012;6532
510030;201803;1983;4705;1382;3856;329;931;530;1546;859;2477
510035;201803;1102;2915;687;2263;112;371;377;1332;489;1703
510040;201803;2103;5012;1508;4170;129;367;943;2610;1072;2977
510050;201803;1779;4650;1220;3742;307;1072;566;1591;873;2663
510060;201803;1377;3649;1014;3060;148;476;507;1488;655;1964
510080;201803;1125;3272;803;2672;223;822;186;538;409;1360
510100;201803;682;1703;446;1269;61;189;210;568;271;757
510120;201803;279;545;162;401;7;21;114;281;121;302
510125;201803;2396;6052;1805;5121;287;1015;753;1961;1040;2976
510130;201803;1475;3972;1106;3347;279;877;298;901;577;1778
510140;201803;2825;8180;2066;7159;795;3139;627;1970;1422;5109
510160;201803;1285;4036;1091;3763;216;761;689;2397;905;3158
510170;201803;4417;12677;3373;10921;736;2518;1425;4592;2161;7110
510180;201803;12198;30344;7712;23019;1990;6401;2146;7114;4136;13515
510185;201803;1717;4579;1164;3785;383;1222;432;1721;815;2943
510190;201803;2300;6354;1544;5160;448;1663;481;1639;929;3302
510250;201803;13379;37956;11440;35235;2567;8300;5942;18954;8509;27254
510260;201803;1982;8400;1648;7732;258;1208;966;5063;1224;6271
510263;201803;3188;9050;2070;6860;440;1574;288;922;728;2496
510267;201803;4880;14352;3125;10392;673;2352;582;1969;1255;4321
510268;201803;1394;3628;951;2821;131;402;516;1492;647;1894
510269;201803;1091;3158;706;2388;231;866;164;493;395;1359
510270;201803;2748;8651;2087;7370;442;1615;737;2571;1179;4186
510279;201803;1727;4976;1286;4117;264;945;591;1786;855;2731
510285;201803;1118;3148;812;2612;229;792;219;686;448;1478
510300;201803;3486;9294;2701;8225;284;836;1790;5679;2074;6515
510305;201803;1331;4045;933;3245;210;762;275;1024;485;1786
510310;201803;764;2100;563;1758;197;621;168;562;365;1183
510320;201803;3692;9972;2724;8266;611;1988;757;2299;1368;4287
510325;201803;4552;13964;3687;12652;1009;3581;1717;6167;2726;9748
510330;201803;2815;8847;2020;7403;455;1732;690;2826;1145;4558
510335;201803;4734;13909;3610;12364;412;1506;2188;7929;2600;9435
510336;201803;511;1518;380;1290;68;223;178;642;246;865
510337;201803;1711;5307;1214;4389;490;1883;200;743;690;2626
510340;201803;72480;180401;47060;140110;14419;48913;9386;26578;23805;75491
510343;201803;999;2916;693;2286;137;476;227;721;364;1197
510345;201803;1347;4001;1005;3317;177;590;423;1367;600;1957
510350;201803;2776;7545;1858;6037;458;1541;691;2329;1149;3870
510360;201803;1717;3952;1118;3183;59;213;815;2335;874;2548
510370;201803;1607;4969;1197;4246;207;775;626;2326;833;3101
510380;201803;496;1362;265;893;69;252;34;108;103;360
510385;201803;980;3615;715;3042;77;376;408;1857;485;2233
510390;201803;1051;3323;838;3000;223;787;376;1471;599;2258
510395;201803;723;1718;485;1350;44;140;261;761;305;901
510410;201803;3950;12119;3115;10521;775;2653;1445;5144;2220;7797
510420;201803;2137;5047;1533;4163;162;517;876;2339;1038;2856
510450;201803;580;1493;346;1057;82;262;57;173;139;435
510452;201803;634;1928;440;1522;85;283;202;706;287;989
510454;201803;794;2371;606;2029;75;259;347;1196;422;1455
510455;201803;908;2713;649;2139;109;400;234;714;343;1114
510460;201803;2003;5161;1432;4321;151;557;825;2355;976;2912
510480;201803;4064;10161;2840;7958;460;1376;1316;3512;1776;4888
510490;201803;1476;4444;1189;4041;252;874;592;2024;844;2898
510500;201803;1396;3914;891;2964;156;612;358;1151;514;1763
510510;201803;3002;9698;2377;8452;747;2897;560;2126;1307;5023
510515;201803;5662;15624;3659;11735;835;2903;901;2625;1736;5528
510517;201803;1281;3749;990;3213;279;994;154;452;433;1446
510520;201803;2011;4307;1270;3389;46;134;779;2216;825;2350
510523;201803;944;2595;754;2268;110;334;459;1392;569;1726
510525;201803;5008;14838;3837;12430;728;2597;1393;4050;2121;6647
510530;201803;531;1373;392;1163;23;107;281;788;304;895
510550;201803;2693;8412;1972;7044;495;1846;665;2408;1160;4254
510558;201803;1905;5376;1561;4875;122;404;913;3054;1035;3458
510560;201803;1542;4593;925;3423;209;847;217;855;426;1702
510562;201803;5184;14530;3753;11780;916;3105;1157;3718;2073;6823
510590;201803;3100;7919;2266;6817;461;1325;1257;4005;1718;5330
510600;201803;1509;3696;932;2750;229;671;315;950;544;1621
510610;201803;2485;6630;1831;5712;180;629;1123;3452;1303;4081
510615;201803;1934;5558;1476;4764;330;1075;741;2476;1071;3551
510617;201803;862;2551;680;2265;75;227;494;1739;569;1966
510618;201803;1275;3592;920;2912;187;685;424;1260;611;1945
510619;201803;733;1966;414;1372;74;280;74;239;148;519
510620;201803;1459;3417;713;2213;162;568;98;272;260;840
510621;201803;1175;3423;827;2747;175;626;232;763;407;1389
510622;201803;3753;11218;2734;8886;899;3198;522;1559;1421;4757
510623;201803;2856;7587;2085;6304;424;1534;641;1866;1065;3400
510624;201803;1577;4273;700;2429;106;414;95;280;201;694
510625;201803;2081;5511;1321;4103;316;1109;239;736;555;1845
510626;201803;1499;3767;937;2932;268;926;196;643;464;1569
510627;201803;598;1611;375;1162;95;307;89;282;184;589
510628;201803;1554;3626;1020;2901;186;517;582;1730;768;2247
510629;201803;1574;4910;1220;4159;312;1132;393;1380;705;2512
510630;201803;2914;8939;1865;6799;434;1711;297;1155;731;2866
510631;201803;456;1193;339;1010;16;35;236;722;252;757
510637;201803;2928;7731;2245;6636;658;2159;697;2004;1355;4163
510642;201803;4788;14913;3866;13510;1057;3997;1573;5733;2630;9730
510645;201803;906;1976;537;1493;152;426;149;427;301;853
510650;201803;6358;18878;5428;17806;850;2820;3855;13175;4705;15995
510665;201803;1850;4479;1084;3143;206;640;368;1106;574;1746
510670;201803;388;831;209;578;20;71;115;322;135;393
510675;201803;5977;17549;4399;14541;1236;4438;854;2783;2090;7221
510677;201803;2025;5331;1452;4498;192;621;850;2682;1042;3303
510680;201803;647;1876;438;1468;97;332;51;171;148;503
510682;201803;1709;5477;1273;4642;373;1474;261;957;634;2431
510685;201803;761;2201;581;1848;81;266;272;821;353;1087
510700;201803;3484;9267;2442;7703;528;1723;1240;4045;1768;5768
510704;201803;9622;24517;6428;18759;1282;4081;2064;5703;3346;9784
510706;201803;1792;5405;1218;4488;243;979;602;2362;845;3341
510710;201803;2566;6962;1770;5367;369;1150;610;1763;979;2913
510715;201803;714;1687;493;1330;66;178;201;550;267;728
510718;201803;2494;5534;1379;4189;559;1749;233;950;792;2699
510719;201803;388;865;240;666;38;118;132;356;170;474
510720;201803;1005;2580;675;2043;182;602;169;487;351;1089
510724;201803;703;1992;495;1612;92;330;217;663;309;993
510726;201803;859;1767;499;1262;81;211;270;686;351;897
510729;201803;658;1599;315;951;51;173;78;222;129;395
510730;201803;2992;7848;2048;6245;511;1657;669;2035;1180;3692
510735;201803;972;2934;735;2596;89;340;483;1738;572;2078
510740;201803;1230;3234;879;2665;84;237;554;1785;638;2022
510757;201803;614;1997;498;1787;204;768;161;569;365;1337
510760;201803;34675;80779;20946;60016;5972;19198;4390;11546;10362;30744
510770;201803;4016;9717;3035;8570;278;730;2108;6294;2386;7024
510774;201803;357;1011;271;844;50;136;132;434;182;570
510775;201803;603;1759;446;1485;112;430;79;242;191;672
510776;201803;432;1223;324;987;75;235;132;387;207;622
510777;201803;1658;4638;1197;4005;130;477;874;2941;1004;3418
510779;201803;584;1693;461;1487;55;153;277;939;332;1092
510780;201803;3318;9595;2639;8506;682;2215;1014;3629;1696;5844
510785;201803;2030;5431;1188;3856;286;1047;166;529;452;1576
510787;201803;2376;6830;1715;5566;728;2448;160;500;888;2948
510788;201803;658;1641;456;1336;78;222;178;614;256;836
510790;201803;13874;38736;8796;28759;2027;7617;1125;3230;3152;10847
510792;201803;8538;23602;5496;17861;1126;3945;1153;3650;2279;7595
510794;201803;1158;3406;801;2717;244;912;169;512;413;1424
510795;201803;7098;20340;5047;16529;1331;4768;1054;3507;2385;8275
510800;201803;1521;4089;1090;3422;231;755;444;1340;675;2095
510805;201803;1802;4973;1208;3870;240;831;431;1255;671;2086
510810;201803;661;1490;444;1191;113;326;216;545;329;871
510820;201803;822;1674;449;1187;56;178;193;489;249;667
510830;201803;734;1965;531;1670;100;304;276;919;376;1223
510835;201803;572;1540;394;1243;53;177;188;574;241;751
510840;201803;39677;97491;30492;85307;6513;17904;15231;45214;21744;63118
510850;201803;1789;4544;1036;3274;318;1122;148;394;466;1516
510860;201803;2648;7548;1751;5932;560;2163;184;608;744;2771
510880;201803;570;1809;463;1604;116;430;215;752;331;1182
510885;201803;566;1518;400;1273;67;228;134;406;201;634
510890;201803;697;2104;562;1904;122;447;275;948;397;1395
510895;201803;1162;3235;817;2616;202;734;280;820;482;1554
520005;201803;1905;5392;1538;4927;439;1323;687;2506;1126;3829
520010;201803;2172;6720;1548;5397;489;1910;283;865;772;2775
520013;201803;2649;7345;1923;5894;464;1501;516;1669;980;3170
520015;201803;524;1403;396;1223;113;365;107;364;220;729
520017;201803;1075;3009;836;2629;180;607;405;1256;585;1863
520020;201803;376;952;299;848;64;203;165;448;229;651
520025;201803;30952;89883;27348;85171;3318;11012;19295;60125;22613;71137
520030;201803;4959;14024;3955;12401;514;1733;2296;7225;2810;8958
520050;201803;437;1074;266;754;20;50;146;440;166;490
520055;201803;900;2569;737;2265;69;196;438;1355;507;1551
520060;201803;1388;4109;1077;3513;275;987;282;899;557;1886
520080;201803;1867;5023;1457;4456;250;752;692;2317;942;3069
520082;201803;1034;2614;877;2346;105;219;512;1424;617;1643
520085;201803;671;1963;543;1745;116;348;177;555;293;903
520090;201803;851;1865;601;1566;106;239;368;1027;474;1266
520110;201803;38006;106698;27350;89458;9391;34765;1729;5139;11120;39904
520120;201803;196;495;111;342;12;45;40;119;52;164
520130;201803;3545;9451;2994;8548;611;1863;1488;4354;2099;6217
520140;201803;34114;101950;26819;88675;9509;34117;2823;9609;12332;43726
520145;201803;448;1169;313;946;59;189;122;350;181;539
520150;201803;533;1325;408;1167;73;208;227;659;300;867
520160;201803;849;2068;616;1716;102;294;270;752;372;1046
520170;201803;4981;10528;3628;9006;218;572;3001;7504;3219;8076
520180;201803;1989;5709;1642;5155;413;1385;689;2136;1102;3521
520215;201803;1907;4723;1418;3958;291;901;661;1791;952;2692
520235;201803;629;1550;419;1220;56;181;158;435;214;616
520250;201803;1544;4077;1095;3383;285;966;195;630;480;1596
520260;201803;838;2029;503;1429;81;246;192;540;273;786
520280;201803;640;1725;507;1479;153;430;189;606;342;1036
520310;201803;1211;2798;803;2166;204;561;292;847;496;1408
520320;201803;1851;5351;1468;4692;168;579;794;2572;962;3151
520330;201803;3105;9140;2234;7607;470;1821;837;2837;1307;4658
520340;201803;2166;5098;1485;4128;157;395;989;2868;1146;3263
520350;201803;3036;7816;2212;6381;665;2042;689;1906;1354;3948
520355;201803;1715;4860;1321;4141;331;1127;504;1559;835;2686
520357;201803;807;2059;629;1788;36;108;444;1269;480;1377
520360;201803;709;1943;542;1649;162;507;147;468;309;975
520380;201803;1298;3382;784;2380;102;353;357;980;459;1333
520390;201803;948;2188;548;1663;174;591;124;366;298;957
520393;201803;534;1291;380;1046;44;128;187;483;231;611
520396;201803;784;2266;666;2045;97;300;418;1268;515;1568
520400;201803;1480;3993;1191;3568;227;684;697;2118;924;2802
520410;201803;1605;3597;1029;2780;128;366;616;1658;744;2024
520420;201803;358;925;269;747;22;70;191;498;213;568
520425;201803;1402;3465;949;2711;243;709;395;1141;638;1850
520430;201803;2186;5337;1153;3591;204;719;61;177;265;896
520440;201803;3363;8373;2117;6158;552;1713;516;1459;1068;3172
520450;201803;11353;29249;7604;22984;2319;7606;488;1521;2807;9127
520455;201803;663;1864;497;1601;166;571;117;372;283;943
520460;201803;889;2434;752;2238;92;258;557;1689;649;1947
520465;201803;838;2266;695;2040;113;368;436;1220;549;1588
520470;201803;1855;5515;1585;5143;359;1139;928;3237;1287;4376
520480;201803;816;2385;532;1854;127;475;93;322;220;797
520485;201803;1529;4323;1258;3952;129;436;877;2733;1006;3169
520490;201803;3810;11231;2962;9916;737;2439;1419;4943;2156;7382
520495;201803;1436;3487;1137;3086;78;215;844;2352;922;2567
520500;201803;1390;3760;996;3053;232;796;368;1111;600;1907
520505;201803;711;1800;518;1535;103;298;265;776;368;1074
520510;201803;6721;18384;4876;15529;1145;4032;1233;4071;2378;8103
520520;201803;1061;2773;795;2370;234;667;238;806;472;1473
520530;201803;1821;5878;1427;5150;538;1961;319;1353;857;3314
520540;201803;2825;7634;1802;5615;426;1361;360;1170;786;2531
520545;201803;985;2743;753;2353;130;428;275;857;405;1285
520547;201803;729;2161;571;1853;160;539;213;671;373;1210
520549;201803;10559;30502;8616;27388;1850;6041;4477;14526;6327;20567
520551;201803;4075;11774;3507;10939;504;1828;2327;7088;2831;8916
520552;201803;753;2138;675;2044;103;294;474;1499;577;1793
520570;201803;606;1543;419;1251;103;319;140;426;243;745
520580;201803;2829;6451;1966;5350;232;680;1242;3386;1474;4066
520590;201803;1296;3662;940;2997;218;702;157;520;375;1222
520620;201803;8024;22388;6516;20278;1778;5736;2753;8748;4531;14484
520630;201803;997;2485;633;1881;102;303;195;556;297;859
520640;201803;2540;6628;1974;5666;474;1381;774;2268;1248;3649
520650;201803;876;2229;609;1764;100;307;324;950;424;1257
520660;201803;436;1071;242;735;58;193;44;147;102;340
520670;201803;971;2781;814;2554;80;271;567;1735;647;2006
520680;201803;730;1895;545;1596;108;306;258;781;366;1087
520690;201803;352;834;230;662;71;208;68;216;139;424
520710;201803;555;1376;356;1018;12;38;221;612;233;650
520725;201803;1614;3930;1137;3149;128;392;732;1977;860;2369
520735;201803;795;2056;544;1600;115;341;168;504;283;845
520740;201803;1854;4567;1470;4092;246;656;889;2563;1135;3219
520750;201803;676;1706;496;1437;96;257;223;679;319;936
520753;201803;1429;3744;1183;3317;175;506;597;1650;772;2156
520760;201803;1122;2532;993;2366;92;181;799;2001;891;2182
520780;201803;1679;4134;1245;3491;129;377;670;1819;799;2196
520790;201803;3090;7587;2213;6259;182;521;1456;4273;1638;4794
520800;201803;14986;40393;12181;36689;2293;6765;7264;23097;9557;29862
520810;201803;1253;2764;910;2373;153;437;515;1404;668;1841
520815;201803;646;1971;468;1592;132;494;69;255;201;749
520830;201803;1746;4099;1294;3576;78;151;1003;2796;1081;2947
520840;201803;2080;5981;1707;5475;715;2390;435;1508;1150;3898
520850;201803;661;1826;451;1494;130;490;112;366;242;856
520860;201803;6075;17416;4697;15187;1082;3752;1656;5473;2738;9225
520870;201803;87444;218910;61563;179547;17223;54305;15421;43967;32644;98272
520880;201803;5974;17391;4718;15336;1506;5206;1112;3604;2618;8810
520890;201803;3786;9870;2733;8147;597;1995;1119;3234;1716;5229
520910;201803;4025;10578;2643;8164;786;2661;461;1434;1247;4095
520915;201803;634;1818;454;1439;78;280;174;532;252;812
520920;201803;4146;10139;2815;8259;425;1346;1378;4069;1803;5415
520929;201803;675;1741;515;1459;107;263;244;766;351;1029
520940;201803;1118;3017;870;2661;59;198;643;1967;702;2165
520945;201803;535;1237;414;1036;34;79;284;691;318;770
520960;201803;1010;2747;794;2380;130;426;423;1224;553;1650
520970;201803;2404;7184;2002;6448;559;1975;478;1572;1037;3547
520980;201803;748;2007;597;1777;134;439;240;682;374;1121
520990;201803;2905;8973;2595;8472;373;1263;1551;5214;1924;6477
520993;201803;954;2360;657;1865;36;105;468;1321;504;1426
520995;201803;2208;5839;1797;5277;435;1255;788;2377;1223;3632
521000;201803;7718;21736;5718;18022;1522;5030;1439;4531;2961;9561
521010;201803;3849;10301;2884;8628;411;1178;1507;4535;1918;5713
521015;201803;650;1709;546;1542;69;200;376;1047;445;1247
521020;201803;2814;7657;1726;5452;472;1591;181;568;653;2159
521030;201803;590;1413;422;1152;52;115;206;607;258;722
521040;201803;7135;17955;5411;15295;1512;4516;1925;5587;3437;10103
521056;201803;827;2332;648;2043;212;692;171;593;383;1285
521060;201803;1031;2629;784;2241;66;201;433;1268;499;1469
521080;201803;1091;2573;582;1698;78;245;196;487;274;732
521090;201803;3075;8098;2253;6784;676;2173;407;1262;1083;3435
521100;201803;1807;4253;1312;3550;261;688;678;1884;939;2572
521120;201803;4826;11459;3410;9698;443;1219;1556;4992;1999;6211
521130;201803;998;2501;672;1888;39;137;390;1083;429;1220
521140;201803;1166;3164;865;2628;150;479;330;1004;480;1483
521150;201803;10995;25970;7189;20301;1900;5925;2621;7562;4521;13487
521160;201803;702;1577;465;1218;83;233;227;560;310;793
521170;201803;1100;2647;784;2166;81;223;492;1314;573;1537
521180;201803;6265;19059;5244;17133;1111;3883;2010;6477;3121;10360
521190;201803;9972;26616;5868;19169;1442;5047;1021;3496;2463;8543
521200;201803;763;1987;545;1609;67;214;279;808;346;1022
521205;201803;584;1548;442;1315;25;73;320;930;345;1003
521210;201803;759;2037;427;1312;99;331;59;137;158;468
521220;201803;4162;10243;2875;8326;598;1833;988;2783;1586;4616
521225;201803;350;831;278;751;24;46;207;595;231;641
521230;201803;1387;4597;1295;4455;424;1266;706;2740;1130;4006
521250;201803;30696;87818;24789;79225;10097;33191;6857;23638;16954;56829
521260;201803;622;1486;470;1252;77;225;257;673;334;898
521270;201803;1811;4788;1565;4495;127;283;1206;3589;1333;3872
521280;201803;1898;5321;1434;4489;437;1471;440;1399;877;2870
521290;201803;451;1194;338;1039;57;209;189;564;246;773
521295;201803;1161;2605;913;2305;94;215;670;1777;764;1992
521300;201803;1856;4821;1498;4319;245;671;966;2901;1211;3572
521305;201803;726;1906;538;1591;85;248;271;806;356;1054
521308;201803;4327;12348;3235;10186;596;1913;1564;4945;2160;6858
521310;201803;8084;22013;5346;16910;1370;4614;1398;4295;2768;8909
521340;201803;387;944;306;823;22;57;236;632;258;689
521350;201803;2098;5401;1645;4721;211;652;1101;3079;1312;3731
521370;201803;1094;2905;670;2144;181;670;82;257;263;927
521375;201803;1436;3825;1066;3312;258;855;390;1267;648;2122
521377;201803;1309;2998;1036;2654;52;135;890;2290;942;2425
521380;201803;6131;16728;4173;13118;480;1562;1010;3340;1490;4902
521385;201803;595;1489;469;1331;109;310;210;649;319;959
521390;201803;707;1840;521;1558;162;522;166;512;328;1034
521400;201803;2218;5444;1780;4955;206;640;1311;3651;1517;4291
521405;201803;1249;3364;947;2853;211;642;422;1275;633;1917
521410;201803;755;2093;616;1893;131;377;313;1038;444;1415
521440;201803;1400;3813;1034;3143;276;879;242;720;518;1599
521450;201803;3783;11783;2903;9962;748;2644;700;2511;1448;5155
521460;201803;6215;17121;4723;14463;1494;4845;1275;3756;2769;8601
521470;201803;628;1789;378;1213;66;200;90;269;156;469
521480;201803;369;1013;212;688;41;144;56;160;97;304
521483;201803;2475;6258;1793;5118;466;1389;505;1403;971;2792
521486;201803;1670;4044;1290;3525;76;207;980;2650;1056;2857
521487;201803;473;1209;324;983;71;230;127;385;198;615
521490;201803;835;2318;637;1973;37;146;441;1321;478;1467
521500;201803;1644;4334;1151;3506;130;464;680;1978;810;2442
521520;201803;805;1849;559;1488;98;259;234;648;332;907
521523;201803;11201;37891;9884;35595;3615;13897;2416;9098;6031;22995
521525;201803;1001;2433;788;2123;77;208;537;1425;614;1633
521530;201803;2130;5606;1271;3876;284;912;283;909;567;1821
521540;201803;861;2243;559;1719;91;347;244;743;335;1090
521550;201803;1389;3576;831;2451;165;530;276;856;441;1386
521560;201803;3668;10732;2690;9416;635;2532;1277;4652;1912;7184
521565;201803;578;1456;471;1307;66;174;315;860;381;1034
521570;201803;3862;10476;2537;7952;529;1797;347;1121;876;2918
521580;201803;526;1306;294;899;45;146;57;163;102;309
521590;201803;588;1560;462;1337;124;403;179;485;303;888
521600;201803;407;1166;262;833;53;159;57;179;110;338
521630;201803;1522;3566;938;2685;206;646;273;746;479;1392
521640;201803;2087;5032;1511;4217;359;1023;606;1722;965;2745
521645;201803;570;1583;373;1207;81;274;99;318;180;592
521680;201803;1153;3655;927;3174;290;1048;109;399;399;1447
521690;201803;435;1247;393;1173;92;278;200;590;292;868
521710;201803;3013;8185;2109;6599;407;1345;421;1293;828;2638
521720;201803;2024;5347;1512;4459;212;671;813;2313;1025;2984
521730;201803;3648;11126;2940;9781;1003;3665;460;1299;1463;4964
521740;201803;3831;10528;2984;9232;837;2834;1028;3342;1865;6176
521760;201803;13861;42377;11521;38577;3442;12457;3649;12899;7091;25356
521770;201803;2810;7468;2013;6029;642;2052;444;1286;1086;3338
521800;201803;5939;17272;4870;15455;1430;4724;1514;5199;2944;9923
521805;201803;687;1554;468;1260;161;409;174;498;335;907
521810;201803;730;1747;497;1398;89;266;222;650;311;916
521830;201803;5148;15137;4271;13833;461;1675;2822;9024;3283;10699
521839;201803;679;1790;487;1442;97;299;178;510;275;809
521850;201803;5520;14422;3983;11923;1050;3424;624;1763;1674;5187
521860;201803;1826;4754;1305;3905;230;760;433;1264;663;2024
521870;201803;538;1647;424;1446;100;352;131;419;231;771
521878;201803;672;1872;472;1479;80;280;172;496;252;776
521880;201803;18893;47146;12778;37693;3311;10219;3931;12093;7242;22312
521890;201803;3154;8907;2166;6893;536;1821;256;750;792;2571
521900;201803;1554;3814;968;2909;234;692;271;818;505;1510
521910;201803;1181;2718;803;2268;82;246;479;1412;561;1658
521920;201803;388;1165;293;963;61;222;96;336;157;558
521925;201803;631;1834;486;1569;105;326;139;448;244;774
521930;201803;4212;11554;3193;9953;946;2926;942;3140;1888;6066
521935;201803;714;1881;537;1562;108;317;253;712;361;1029
521940;201803;1222;2923;857;2422;214;700;361;971;575;1671
521945;201803;563;1674;461;1487;86;274;207;709;293;983
521950;201803;610;1502;484;1344;31;91;387;1076;418;1167
521960;201803;711;2010;478;1529;71;256;213;651;284;907
521970;201803;2605;6793;2187;6300;137;354;1782;5291;1919;5645
521971;201803;865;2228;584;1757;131;418;136;394;267;812
521973;201803;1049;2968;868;2698;110;388;522;1590;632;1978
521975;201803;12195;32875;10381;30476;1742;5281;6446;19003;8188;24284
521980;201803;2433;6161;1950;5518;209;545;1427;4096;1636;4641
521990;201803;1146;3233;914;2856;126;396;502;1609;628;2005
522000;201803;3812;13016;3184;12206;245;829;2295;9501;2540;10330
522005;201803;301;768;218;638;62;161;83;264;145;425
522010;201803;3598;9452;2727;8042;836;2572;672;1944;1508;4516
522015;201803;945;2592;694;2198;144;477;265;834;409;1311
522020;201803;5172;12885;3551;10247;861;2592;1447;4221;2308;6813
522026;201803;652;1851;514;1643;84;281;255;837;339;1118
522028;201803;516;1409;377;1107;90;262;134;363;224;625
522040;201803;2673;6129;1878;5107;258;714;1267;3457;1525;4171
522045;201803;15952;48495;12242;41193;3016;10891;2457;8093;5473;18984
522050;201803;1093;3013;736;2347;157;519;246;737;403;1256
522060;201803;2458;6993;1987;6267;303;1014;1091;3552;1394;4566
522068;201803;1678;4864;1396;4522;175;519;953;3224;1128;3743
522070;201803;602;1669;505;1518;47;190;345;990;392;1180
522100;201803;547;1519;413;1319;71;241;217;695;288;936
522108;201803;829;2448;681;2198;47;205;533;1661;580;1866
522119;201803;1569;4210;1223;3728;207;649;638;2010;845;2659
522130;201803;382;974;275;830;66;215;137;417;203;632
522140;201803;15459;43018;11527;36008;3545;11700;1758;5515;5303;17215
522145;201803;828;2108;614;1796;141;369;331;1054;472;1423
522150;201803;931;2305;706;1986;211;576;241;717;452;1293
522155;201803;876;2405;713;2143;146;404;345;1093;491;1497
522157;201803;543;1483;465;1374;27;110;344;979;371;1089
522160;201803;6099;16405;4070;12656;1138;3837;345;1202;1483;5039
522170;201803;2398;6664;1734;5501;551;1819;421;1349;972;3168
522180;201803;425;1141;274;874;57;186;43;156;100;342
522185;201803;15585;40945;11933;36171;4557;14628;3465;11452;8022;26080
522190;201803;796;1913;591;1608;114;302;237;683;351;985
522200;201803;1718;5223;1162;3991;229;810;159;544;388;1354
522205;201803;1472;3728;1142;3243;98;309;811;2316;909;2625
522220;201803;1346;3474;1023;3007;160;441;568;1728;728;2169
522230;201803;1212;3256;1006;2955;181;588;567;1663;748;2251
530010;201803;165241;488826;141953;450104;30208;105778;67642;209585;97850;315363
110001;201804;3271;10055;2559;8794;662;2409;1075;3705;1737;6114
110002;201804;10984;30183;8064;25203;2459;8208;2497;7755;4956;15963
110003;201804;682;2035;507;1678;154;548;92;283;246;831
110004;201804;8386;24766;6237;20632;1801;6256;1348;4763;3149;11019
110005;201804;2149;5919;1402;4533;362;1226;456;1559;818;2785
110006;201804;1667;4820;1047;3520;274;982;134;451;408;1433
110007;201804;1150;3379;896;2933;319;1075;288;1052;607;2127
110008;201804;2374;7707;2129;7350;283;908;1613;5769;1896;6677
110009;201804;3837;11297;2676;9287;813;2906;865;3133;1678;6039
110010;201804;5969;20306;4930;18481;1400;5149;2111;8872;3511;14021
110011;201804;6158;18023;4778;15381;1604;5335;1020;3354;2624;8689
110012;201804;12972;35028;9094;28360;2371;7702;1446;4638;3817;12340
110013;201804;5247;16052;4266;14185;1692;5771;739;2712;2431;8483
110014;201804;3677;10116;2704;8394;778;2464;1066;3246;1844;5710
110015;201804;4945;13929;2979;9917;773;2731;420;1372;1193;4103
110018;201804;3428;9209;2213;7128;522;1918;578;1749;1100;3667
110020;201804;65731;170391;46386;143062;10380;33658;17843;58541;28223;92199
110025;201804;4425;11643;3086;9331;551;1760;1643;4866;2194;6626
110026;201804;471;1448;399;1323;121;432;161;510;282;942
110028;201804;5920;16802;4136;13334;1177;4053;554;1775;1731;5828
110029;201804;1319;3337;811;2534;198;631;340;1060;538;1691
110030;201804;11073;28138;7753;23331;1535;5245;2981;9077;4516;14322
110032;201804;3024;9194;2242;7528;761;2584;544;1870;1305;4454
110033;201804;4085;13311;3360;11920;1177;4212;916;3613;2093;7825
110034;201804;3254;8472;2379;7196;773;2464;1012;3104;1785;5568
110037;201804;1645;5365;1346;4769;342;1255;616;2165;958;3420
110040;201804;2879;8635;2217;7389;701;2513;560;1784;1261;4297
110045;201804;4553;14123;3843;13028;1190;4318;1514;5154;2704;9472
110050;201804;1598;4891;1237;4166;513;1790;288;970;801;2760
110060;201804;784;2474;575;2033;207;767;62;239;269;1006
110070;201804;1852;6081;1507;5279;537;1969;350;1166;887;3135
110080;201804;4863;12730;3739;11318;954;2943;1882;5968;2836;8911
110090;201804;632;1759;445;1419;133;438;170;530;303;968
110092;201804;1068;3360;889;3066;151;568;483;1714;634;2282
110094;201804;2897;8763;2293;7749;799;2787;690;2433;1489;5220
110100;201804;1833;5699;1564;5158;345;1232;784;2557;1129;3789
110110;201804;1548;4623;1175;4021;411;1467;259;946;670;2413
110120;201804;1379;4211;1038;3507;299;1058;265;887;564;1945
110130;201804;2511;6691;1588;4978;393;1375;510;1557;903;2932
110140;201804;2113;6769;1601;5687;440;1657;387;1357;827;3014
110143;201804;1312;3672;957;3010;328;1047;260;840;588;1887
110145;201804;975;2749;635;2087;161;557;204;674;365;1231
110146;201804;433;1217;308;1017;54;167;153;538;207;705
110147;201804;624;1731;419;1315;97;320;158;450;255;770
110148;201804;974;2931;586;2016;114;424;52;173;166;597
110149;201804;2711;8002;2058;6965;816;2701;577;2148;1393;4849
110150;201804;2032;5803;1560;5080;666;2384;383;1168;1049;3552
110155;201804;686;2156;550;1843;126;446;202;653;328;1099
110160;201804;1458;4701;1136;4005;414;1448;277;1024;691;2472
110170;201804;2220;6122;1483;4679;291;977;732;2242;1023;3219
110175;201804;1401;4224;1101;3766;190;695;549;1966;739;2661
110180;201804;1148;3351;863;2783;242;763;365;1211;607;1974
120001;201804;3418;12079;3020;11488;487;1663;1985;8165;2472;9828
120005;201804;1747;6912;1578;6626;184;860;1183;5062;1367;5922
120010;201804;5132;16510;4442;15350;682;2289;2943;10527;3625;12816
120013;201804;2023;7934;1909;7768;524;2058;1055;4612;1579;6670
120017;201804;1993;6982;1821;6688;371;1398;1040;4008;1411;5406
120020;201804;13786;59351;13109;58022;1430;6870;9801;44276;11231;51146
120025;201804;2581;8161;2206;7677;444;1584;1376;4899;1820;6483
120030;201804;6349;25351;6123;24975;371;1852;5086;20835;5457;22687
120032;201804;1584;7483;1512;7308;94;597;1199;5757;1293;6354
120033;201804;3837;14867;3620;14491;158;829;3138;12497;3296;13326
120034;201804;2384;9178;2086;8614;134;790;1644;6686;1778;7476
120035;201804;3314;14313;3188;14071;275;1427;2564;11375;2839;12802
120038;201804;2540;8788;2314;8381;592;2221;1206;4449;1798;6670
120039;201804;1867;8532;1787;8374;166;1008;1355;6364;1521;7372
120040;201804;40281;137938;36239;131107;6825;26178;20667;76099;27492;102277
120042;201804;3126;12394;2913;11927;163;851;2333;9512;2496;10363
120043;201804;1212;5421;1145;5271;75;458;971;4459;1046;4917
120045;201804;5218;15725;4747;15199;177;704;4332;13786;4509;14490
120050;201804;8383;32417;7836;31478;674;3194;6035;24557;6709;27751
120060;201804;8263;35150;7888;34484;509;2782;6627;29073;7136;31855
120070;201804;2748;9647;2558;9329;329;1220;1786;6732;2115;7952
120080;201804;3963;14198;3622;13622;614;2445;2417;9206;3031;11651
130002;201804;3109;12762;2871;12428;100;549;2580;11208;2680;11757
130006;201804;2231;8948;1900;8337;157;787;1431;6287;1588;7074
130008;201804;2428;8931;2183;8519;83;457;1816;7081;1899;7538
130010;201804;3736;11001;3265;10467;71;284;3036;9747;3107;10031
130014;201804;2969;9382;2449;8493;422;1507;1547;5467;1969;6974
130020;201804;2702;10652;2491;10286;145;854;1985;8147;2130;9001
130030;201804;9129;31367;8419;30596;154;474;7938;29306;8092;29780
130040;201804;3769;11438;3210;10695;218;723;2564;8670;2782;9393
130050;201804;7105;26739;5994;25307;194;901;5399;23060;5593;23961
130060;201804;6925;29217;6119;28085;518;3047;4794;21920;5312;24967
130063;201804;5311;19416;4792;18813;116;549;4446;17585;4562;18134
130068;201804;3200;12940;2848;12238;204;1109;2155;9235;2359;10344
130070;201804;8155;25951;7066;24725;324;1088;6189;22130;6513;23218
130080;201804;6209;25164;5632;24396;410;2365;4521;19597;4931;21962
130083;201804;2468;8951;2231;8628;181;839;1789;6867;1970;7706
130090;201804;3123;10271;2868;9924;57;241;2583;9074;2640;9315
130100;201804;7010;22907;6255;22088;77;243;5963;21382;6040;21625
130110;201804;7566;22461;6510;21202;536;1576;5490;18341;6026;19917
130115;201804;5264;17248;4724;16563;104;408;4120;14638;4224;15046
130120;201804;14693;54165;13476;52568;1280;5290;10913;43289;12193;48579
130130;201804;4878;16908;4024;15802;472;2136;3028;11843;3500;13979
130140;201804;6461;24643;6236;24381;253;1219;5686;22223;5939;23442
130150;201804;3502;13813;3337;13599;110;657;3021;12306;3131;12963
130160;201804;4726;18181;4234;17528;328;1586;3472;14623;3800;16209
130165;201804;3044;12193;2895;11941;111;628;2546;10474;2657;11102
130170;201804;11028;34646;9115;32306;715;2807;7488;26895;8203;29702
130180;201804;4289;13742;4046;13456;56;256;3867;12841;3923;13097
130185;201804;15784;42251;12955;39231;505;1172;11532;36143;12037;37315
130190;201804;17640;59952;14918;55996;1780;6743;10610;41230;12390;47973
130195;201804;2266;8718;1904;8231;87;429;1677;7297;1764;7726
130200;201804;2235;7041;1913;6596;156;551;1513;5343;1669;5894
130210;201804;1377;5244;1237;5078;107;626;972;3907;1079;4533
130220;201804;2030;7863;1850;7556;115;605;1466;6008;1581;6613
130230;201804;4040;17870;3647;17294;328;1870;2977;14204;3305;16074
130240;201804;10205;34248;8688;32096;228;1335;7653;28243;7881;29578
130250;201804;24225;75971;21507;72874;1509;4950;17957;62591;19466;67541
130255;201804;4086;14474;3679;13761;249;1121;2921;10926;3170;12047
130260;201804;235620;722352;201034;668440;59063;209527;83556;281367;142619;490894
130270;201804;8344;31897;7220;30110;951;4090;5104;22041;6055;26131
130280;201804;3454;14179;3260;13962;78;367;3053;13260;3131;13627
130290;201804;12185;42002;11031;40674;277;672;10341;39140;10618;39812
130300;201804;4574;16904;4252;16414;220;1133;3626;13925;3846;15058
130310;201804;5457;20030;4933;19300;379;1518;4045;16137;4424;17655
130320;201804;3249;11075;2830;10528;280;1012;2139;8192;2419;9204
130330;201804;4145;14137;3544;13384;156;765;3073;11602;3229;12367
130340;201804;20696;72040;18390;69336;1479;5491;15424;59758;16903;65249
130350;201804;3728;14202;3438;13818;177;1039;2966;11765;3143;12804
130353;201804;6023;18240;5128;17086;907;2967;3376;11772;4283;14739
130356;201804;4878;17025;4335;16133;552;2137;3006;11452;3558;13589
130360;201804;3252;9563;2786;9066;80;231;2602;8560;2682;8791
130370;201804;5748;22396;5153;21598;197;1183;4484;18740;4681;19923
130380;201804;7469;31325;7115;30796;495;2725;5979;25648;6474;28373
130390;201804;5606;24284;4989;23174;534;2850;3688;17155;4222;20005
130395;201804;2328;7766;2030;7230;231;859;1440;5149;1671;6008
130400;201804;2502;8401;2191;7960;108;376;1932;7116;2040;7492
130406;201804;10942;40501;9686;38762;1806;7476;6524;26616;8330;34092
130410;201804;4007;14768;3502;13886;1038;4310;1668;6820;2706;11130
130420;201804;12027;46465;10717;44798;1054;4911;8543;36124;9597;41035
130423;201804;3892;13340;3474;12823;170;875;3034;11045;3204;11920
130426;201804;2708;10861;2590;10683;74;360;2402;9993;2476;10353
130430;201804;3908;12350;3540;11839;396;1379;2774;9323;3170;10702
130440;201804;4423;14291;3951;13733;79;309;3699;12960;3778;13269
140002;201804;1899;5890;1688;5602;110;458;1350;4401;1460;4859
140005;201804;3336;9201;3135;8978;129;401;2867;8219;2996;8620
140010;201804;50787;141055;39872;124959;10297;33807;14416;48432;24713;82239
140015;201804;3272;10440;2936;10033;271;946;2397;8362;2668;9308
140017;201804;3527;10979;3131;10451;328;1005;2300;8107;2628;9112
140020;201804;4866;15256;4194;14350;357;1472;3179;10890;3536;12362
140023;201804;2156;6970;1812;6459;226;865;1287;4646;1513;5511
140028;201804;2076;5490;1783;5107;172;573;1353;3763;1525;4336
140030;201804;4108;11985;3670;11432;353;996;2944;9407;3297;10403
140040;201804;1971;8488;1830;8287;99;594;1623;7288;1722;7882
140045;201804;2549;9539;2180;9009;406;1655;1388;6077;1794;7732
140047;201804;5851;17728;5004;16400;941;3149;2963;10031;3904;13180
140050;201804;1392;4243;1193;3947;134;447;833;2783;967;3230
140060;201804;1421;4097;1255;3852;91;272;1036;3224;1127;3496
140070;201804;1768;9574;1710;9421;152;1056;1323;7218;1475;8274
150010;201804;40462;108025;37254;103716;1408;4531;32398;89515;33806;94046
150013;201804;1794;5003;1520;4693;148;392;1137;3702;1285;4094
150020;201804;13128;42168;12444;41251;1237;3264;10322;35487;11559;38751
150030;201804;8623;33394;7898;32488;398;1821;6935;28770;7333;30591
150034;201804;4111;11092;3536;10304;273;821;2842;8354;3115;9175
150040;201804;13377;39106;11594;37060;1029;2490;9638;32524;10667;35014
150050;201804;6537;23726;6078;23057;138;694;5559;21180;5697;21874
150060;201804;19350;56388;16496;52150;3457;10879;9381;30855;12838;41734
150070;201804;6340;24861;5663;24077;174;926;5196;22334;5370;23260
150080;201804;80609;200878;67696;183677;15671;43674;27371;82466;43042;126140
150085;201804;6139;19780;5676;19205;237;747;5198;17797;5435;18544
150090;201804;9987;38020;9448;37110;681;2930;7591;30005;8272;32935
150095;201804;5431;17137;4877;16374;286;891;4023;13879;4309;14770
150100;201804;3122;11071;2772;10451;211;793;2124;8071;2335;8864
150110;201804;3836;17424;3740;17296;218;1057;3347;15627;3565;16684
150120;201804;6969;24043;6767;23746;301;884;5992;21602;6293;22486
150125;201804;747;2089;604;1904;114;403;364;1127;478;1530
150130;201804;22334;66562;19794;62857;2580;7388;14207;46860;16787;54248
150140;201804;191046;491119;167673;459488;25610;68949;106348;300862;131958;369811
150145;201804;4573;13929;3987;13127;690;1999;2849;9873;3539;11872
150150;201804;13604;38123;12248;36378;1095;3443;9379;28143;10474;31586
150157;201804;3116;9054;2636;8411;296;1024;1823;5971;2119;6995
150160;201804;2944;9204;2752;8876;673;2152;1526;5072;2199;7224
150170;201804;23960;80507;20984;75715;3615;12555;13051;50084;16666;62639
150172;201804;3873;11679;3197;10675;313;956;2327;8060;2640;9016
150175;201804;1680;5249;1496;4942;160;583;1076;3608;1236;4191
150178;201804;10075;29108;8462;27197;503;1623;6888;22693;7391;24316
150180;201804;20344;77277;18903;75450;1003;4244;16421;66504;17424;70748
150190;201804;6979;23883;6605;23395;228;1039;5907;20900;6135;21939
150195;201804;5432;17431;5148;16986;96;392;4755;15658;4851;16050
150200;201804;5285;16331;4869;15869;62;198;4623;15186;4685;15384
150210;201804;24785;90292;23471;88559;1940;7107;19045;74315;20985;81422
150215;201804;7149;21902;6232;20511;1873;6173;2692;9387;4565;15560
150220;201804;10918;33314;9736;31492;1703;5424;5708;19084;7411;24508
150230;201804;12355;36432;10699;34213;1486;4583;7273;24383;8759;28966
150240;201804;32223;93501;26643;83548;8830;28149;6801;22172;15631;50321
150250;201804;4111;16808;3908;16515;598;2551;2903;12530;3501;15081
150260;201804;2295;8260;2171;8064;221;806;1617;6088;1838;6894
150270;201804;8153;23813;6043;20783;1898;6763;2258;8196;4156;14959
150275;201804;6204;21294;5773;20632;350;1351;4756;17033;5106;18384
150276;201804;2209;6286;1909;5919;266;788;1392;4521;1658;5309
150277;201804;4920;13876;4142;12942;423;1218;3183;10431;3606;11649
150280;201804;6197;26672;6023;26330;540;2323;4890;21703;5430;24026
150285;201804;3159;11579;2842;11104;322;1372;1969;7839;2291;9211
150290;201804;10669;29186;9845;28289;481;1080;8736;25825;9217;26905
150293;201804;9872;24809;7136;21161;1715;5163;3133;10247;4848;15410
150295;201804;7681;21068;5923;18956;1958;6425;2437;8785;4395;15210
150300;201804;2082;6720;1887;6449;58;299;1622;5482;1680;5781
150304;201804;3912;12505;3402;11660;580;1924;2204;7786;2784;9710
150307;201804;6340;20729;5933;20111;400;1283;4933;16960;5333;18243
150309;201804;5916;19257;5017;17733;1249;4252;2436;9248;3685;13500
150310;201804;6964;27919;6603;27452;266;1392;5757;24188;6023;25580
150320;201804;9316;25197;8501;24125;488;1445;6817;19397;7305;20842
150330;201804;14048;46455;13031;44845;1697;5901;9516;33626;11213;39527
150340;201804;2661;7950;2397;7567;296;898;1713;5505;2009;6403
150345;201804;7434;22907;6738;21999;490;1679;5562;18367;6052;20046
150350;201804;8447;23928;7839;23175;813;1835;6416;19708;7229;21543
150360;201804;22730;65751;18630;60636;2322;6981;12944;44130;15266;51111
150370;201804;9482;32650;8356;31104;831;2993;6210;24027;7041;27020
150375;201804;3183;13506;2900;13068;292;1381;2324;10622;2616;12003
150380;201804;9825;27297;8353;25297;379;1172;7092;21733;7471;22905
150390;201804;7667;32481;7049;31410;1128;4808;4775;22275;5903;27083
150400;201804;6124;22965;5857;22445;350;1370;4854;18752;5204;20122
150405;201804;8885;24637;7882;23411;537;1279;6328;19532;6865;20811
150410;201804;1739;6030;1536;5669;223;815;968;3666;1191;4481
150420;201804;33767;105017;26544;93779;9022;33242;7084;29026;16106;62268
150430;201804;7828;24722;7380;24089;759;2202;5810;19566;6569;21768
150440;201804;5621;18601;5293;18125;405;1281;4329;15051;4734;16332
150442;201804;22990;61779;19610;56983;2676;7621;12417;37353;15093;44974
150445;201804;5710;18825;5179;17978;295;1026;4267;15013;4562;16039
150450;201804;4725;21369;4477;21001;374;1866;3732;17698;4106;19564
150460;201804;7901;26834;7365;26126;234;953;6404;23446;6638;24399
150470;201804;17912;52803;16877;51578;1100;3020;14717;45632;15817;48652
150475;201804;4184;14086;3784;13470;214;803;3119;11301;3333;12104
150480;201804;13800;46655;12397;44464;1956;6829;8639;32265;10595;39094
150490;201804;7753;28152;7330;27611;229;1120;6537;24675;6766;25795
150495;201804;5046;18184;4899;17992;110;479;4550;16780;4660;17259
150497;201804;2626;9006;2195;8205;594;2326;1021;4002;1615;6328
150500;201804;3280;8713;2926;8183;336;868;2249;6345;2585;7213
150503;201804;4024;11713;3071;10346;992;3399;1166;4285;2158;7684
150506;201804;9775;32745;8761;31286;1900;6277;5552;21260;7452;27537
150510;201804;9926;37282;8717;34889;1290;4997;5671;23912;6961;28909
150520;201804;7069;27203;6902;26992;189;896;6444;25264;6633;26160
150530;201804;12227;41989;10772;39728;1361;4308;7904;30515;9265;34823
150540;201804;4787;13768;4144;12820;185;577;3510;10856;3695;11433
150543;201804;6332;18199;5326;16865;852;2748;3627;12006;4479;14754
150548;201804;9668;30607;8843;29560;319;971;8032;27107;8351;28078
150549;201804;1988;6228;1771;5979;59;239;1579;5324;1638;5563
150550;201804;18842;58748;16207;54326;4471;15112;6711;23848;11182;38960
150553;201804;22235;71832;17844;63469;6249;23001;4860;18913;11109;41914
150555;201804;1744;5021;1419;4502;90;294;1018;3213;1108;3507
150560;201804;1817;5818;1622;5428;302;960;900;3112;1202;4072
150563;201804;2427;7901;2175;7455;463;1713;1178;4020;1641;5733
150565;201804;4023;13502;3637;12862;107;542;3068;10855;3175;11397
150570;201804;6011;20900;5782;20516;351;1379;4745;16821;5096;18200
150580;201804;10175;41744;9258;40707;650;3191;7690;34522;8340;37713
150590;201804;6796;25521;6283;24842;197;1046;5738;22630;5935;23676
150600;201804;8540;31030;7988;30312;220;965;7282;27805;7502;28770
150610;201804;2486;8059;2262;7618;158;600;1786;5941;1944;6541
150611;201804;2826;8953;2614;8608;118;464;2220;7256;2338;7720
150613;201804;12524;35889;9618;30975;2097;6987;4215;13984;6312;20971
150616;201804;3123;9039;2332;7681;578;2071;748;2363;1326;4434
150618;201804;6529;20660;5523;18936;977;3371;3214;11482;4191;14853
150619;201804;5575;17337;4757;16068;304;1154;3704;12513;4008;13667
150620;201804;6212;21432;5501;20491;761;2807;3968;15155;4729;17962
150630;201804;6121;17117;5685;16598;339;1029;4916;14464;5255;15493
150635;201804;4042;12388;3552;11527;711;2349;1866;6169;2577;8518
150640;201804;2139;6264;1972;6073;37;121;1843;5751;1880;5872
150650;201804;11309;33338;10080;31169;3043;9078;4235;13980;7278;23058
150655;201804;5498;16621;5070;15930;270;828;4259;13446;4529;14274
150658;201804;4323;12668;3630;11692;707;2423;2176;7285;2883;9708
150660;201804;5754;16958;5176;16151;617;1868;3512;11176;4129;13044
150670;201804;7771;19489;6223;17658;612;1552;4887;14390;5499;15942
150680;201804;64367;201676;50407;179230;12894;45774;21514;85639;34408;131413
150690;201804;2311;6328;2050;5964;120;338;1713;5021;1833;5359
150700;201804;6069;18780;5561;18121;512;1599;4272;14300;4784;15899
150710;201804;3954;13346;3611;12779;281;1086;2741;9746;3022;10832
150715;201804;5015;15704;4358;14673;334;1076;3486;11937;3820;13013
150720;201804;6312;24502;5976;23901;457;2043;4853;19535;5310;21578
150730;201804;10780;35061;9594;33200;1076;3887;7177;25328;8253;29215
150740;201804;3569;10824;3164;10108;484;1478;2044;6663;2528;8141
150745;201804;4831;14683;4142;13724;857;3003;2647;8862;3504;11865
150746;201804;1474;4829;1375;4661;95;312;1105;3796;1200;4108
150747;201804;5120;16347;4525;15481;854;2652;2845;10408;3699;13060
150750;201804;3581;11414;3105;10705;201;788;2429;8522;2630;9310
150760;201804;11562;35187;10595;33972;1288;3938;7880;25874;9168;29812
150770;201804;6031;22579;5780;22225;149;473;5372;21177;5521;21650
150775;201804;942;2791;776;2526;146;554;417;1329;563;1883
150780;201804;4201;12969;3930;12653;85;317;3658;11854;3743;12171
150790;201804;5298;16213;4670;15515;254;712;3856;13823;4110;14535
150795;201804;14010;45483;12673;43261;3078;10016;7046;25530;10124;35546
150796;201804;3358;9227;2935;8721;213;657;2380;7177;2593;7834
150797;201804;3893;12601;3388;11798;123;397;2832;9979;2955;10376
150800;201804;12953;42014;11904;40722;1862;5813;8613;30893;10475;36706
150803;201804;6556;23062;6176;22445;487;1833;5022;18326;5509;20159
150805;201804;2957;9994;2617;9426;286;1013;1988;7277;2274;8290
150808;201804;5794;17858;4404;15338;1600;6070;526;2019;2126;8089
150810;201804;19352;55819;15343;50804;2915;9502;8803;31470;11718;40972
150812;201804;5230;15549;4699;14612;494;1679;3458;10530;3952;12209
150815;201804;8649;27610;7533;26203;762;2626;5825;20714;6587;23340
150820;201804;11562;32600;9994;30740;992;2726;7695;24541;8687;27267
150830;201804;11711;44541;11099;43771;395;2145;9558;38486;9953;40631
150835;201804;2144;7469;1979;7168;438;1599;1027;3823;1465;5422
150840;201804;7208;21556;5776;19012;1228;4269;2705;8975;3933;13244
160005;201804;1119;3237;1027;3090;24;113;959;2840;983;2953
160010;201804;1759;5250;1725;5215;12;43;1687;5098;1699;5141
160015;201804;2167;7271;2002;7043;105;350;1804;6426;1909;6776
160020;201804;1918;6793;1731;6517;237;915;1291;4910;1528;5825
160021;201804;1113;4439;1042;4336;88;477;834;3427;922;3904
160023;201804;1191;4449;1085;4283;85;300;841;3494;926;3794
160025;201804;1633;4751;1598;4708;29;78;1545;4571;1574;4649
160027;201804;8579;23980;7830;23144;672;1761;6460;19757;7132;21518
160030;201804;54436;170805;45995;159318;10872;36209;23976;91204;34848;127413
160040;201804;5047;18072;4592;17449;108;609;4221;15971;4329;16580
160050;201804;3808;12919;3201;12017;1478;5317;998;4520;2476;9837
160053;201804;3255;11341;3071;11107;470;1608;2247;8390;2717;9998
160055;201804;640;2335;630;2323;32;121;573;2127;605;2248
160060;201804;20584;60052;17539;56578;1258;4007;14185;47052;15443;51059
160070;201804;2961;11261;2704;10841;192;852;2164;8831;2356;9683
160080;201804;2720;9774;2565;9584;74;344;2340;8790;2414;9134
170025;201804;594;1691;461;1505;116;362;216;736;332;1098
170030;201804;1156;3708;945;3295;167;606;464;1662;631;2268
170035;201804;1453;3890;1102;3322;118;387;617;1898;735;2285
170040;201804;1791;5409;1497;5019;135;518;836;2952;971;3470
170070;201804;1638;4136;1175;3535;144;465;687;2105;831;2570
170100;201804;2398;7013;1993;6347;186;595;1374;4430;1560;5025
170105;201804;728;2229;520;1779;137;449;181;623;318;1072
170110;201804;885;2858;709;2515;132;482;325;1181;457;1663
170130;201804;1346;4170;995;3481;189;696;480;1744;669;2440
170190;201804;1441;4188;1011;3485;344;1129;222;986;566;2115
170200;201804;1705;4428;1032;3214;271;918;210;626;481;1544
170210;201804;26589;74521;20379;64218;6954;23880;2462;8724;9416;32604
170215;201804;1311;3737;1093;3424;76;300;792;2459;868;2759
170220;201804;5701;18401;4965;17007;1250;4167;2409;8751;3659;12918
170230;201804;1249;3884;966;3305;257;910;248;857;505;1767
170240;201804;2665;7716;2100;6787;182;748;1422;4493;1604;5241
170255;201804;3882;11733;2712;9444;640;2327;1085;3868;1725;6195
170270;201804;1038;2524;676;2023;29;81;448;1323;477;1404
170290;201804;2929;8398;2508;7913;146;374;2075;6842;2221;7216
170300;201804;1901;5534;1555;4987;185;595;991;3249;1176;3844
170305;201804;738;2187;574;1855;83;307;281;888;364;1195
170307;201804;945;3350;773;2993;141;543;389;1566;530;2109
170310;201804;1422;3937;1056;3303;200;695;510;1572;710;2267
170320;201804;1007;2771;749;2351;110;356;404;1290;514;1646
170330;201804;817;2629;737;2505;44;182;573;1906;617;2088
170360;201804;459;1343;350;1156;53;206;208;644;261;850
170370;201804;1313;3609;982;3056;180;571;454;1435;634;2006
170380;201804;1780;5463;1359;4781;156;630;764;2724;920;3354
170382;201804;555;1716;458;1543;74;264;275;920;349;1184
170384;201804;1500;5780;1283;5340;358;1546;516;2159;874;3705
170386;201804;757;2163;482;1611;73;284;114;342;187;626
170388;201804;582;1724;422;1439;58;214;196;663;254;877
170389;201804;1165;4045;1009;3767;50;215;801;3040;851;3255
170390;201804;1498;3827;1134;3368;79;263;892;2686;971;2949
170410;201804;541;1657;403;1414;21;98;263;904;284;1002
170460;201804;391;1084;306;937;35;117;187;573;222;690
170510;201804;842;2656;633;2234;72;303;334;1141;406;1444
170550;201804;6511;17906;4598;14621;1320;4525;770;2593;2090;7118
170555;201804;1333;3792;1054;3344;89;302;568;1854;657;2156
170560;201804;1076;3140;801;2763;103;389;436;1679;539;2068
170600;201804;1371;3850;1109;3455;268;745;599;2005;867;2750
170610;201804;1693;4826;1273;4106;97;386;808;2538;905;2924
170625;201804;418;1180;261;838;35;108;81;244;116;352
170650;201804;1230;3800;942;3276;206;747;376;1387;582;2134
170700;201804;3484;10518;2696;9095;608;2235;1076;3722;1684;5957
170710;201804;1566;4418;1231;3813;233;793;607;1809;840;2602
170720;201804;1871;4860;1545;4380;68;142;1320;3842;1388;3984
170730;201804;1000;2898;764;2511;189;647;331;1123;520;1770
170740;201804;1980;7076;1700;6517;213;840;1115;4308;1328;5148
170755;201804;855;2552;625;2100;74;285;300;1004;374;1289
170765;201804;1242;3297;857;2701;211;686;334;1130;545;1816
170770;201804;1701;5448;1484;5073;199;680;967;3356;1166;4036
170820;201804;3800;13199;3330;12323;460;1665;1983;7761;2443;9426
170825;201804;989;2392;792;2126;69;186;547;1483;616;1669
170830;201804;1387;3904;1137;3503;37;114;926;2876;963;2990
170900;201804;2559;8700;2266;8241;186;746;1798;6587;1984;7333
170930;201804;3672;10492;2947;9227;676;2261;1241;3951;1917;6212
170950;201804;11558;33188;8130;26978;2353;8784;1162;4029;3515;12813
170980;201804;441;1282;357;1136;30;128;222;668;252;796
171050;201804;1551;5030;1382;4726;65;298;1079;3647;1144;3945
171070;201804;1360;4116;1179;3845;255;747;684;2445;939;3192
171090;201804;1074;2727;890;2467;62;149;646;1790;708;1939
171110;201804;568;1638;419;1372;104;381;167;477;271;858
171150;201804;1063;2768;649;2029;73;276;401;1235;474;1511
171180;201804;716;2091;475;1589;87;308;194;670;281;978
171190;201804;1549;5631;1372;5303;235;910;774;3124;1009;4034
171195;201804;841;2845;700;2569;151;580;371;1386;522;1966
171200;201804;550;1644;420;1409;98;365;162;522;260;887
171215;201804;423;1211;319;1015;63;215;148;459;211;674
171240;201804;723;2555;614;2328;51;264;391;1484;442;1748
171245;201804;609;1960;479;1678;74;278;234;792;308;1070
171250;201804;1015;2823;759;2392;226;743;322;1028;548;1771
171270;201804;385;1505;329;1371;89;350;145;672;234;1022
171280;201804;834;2617;659;2299;145;481;292;1125;437;1606
171320;201804;3889;11269;3058;9787;588;1890;1367;4620;1955;6510
171330;201804;2680;7606;2074;6536;458;1460;1003;3259;1461;4719
171360;201804;1429;4432;1216;4131;85;334;947;3235;1032;3569
171370;201804;687;1817;538;1607;53;165;377;1135;430;1300
171380;201804;1349;3995;1087;3563;155;552;636;2092;791;2644
171395;201804;920;2712;652;2169;93;363;317;1021;410;1384
171420;201804;1807;5661;1349;4704;221;857;608;2112;829;2969
171430;201804;1028;3101;841;2734;97;345;559;1756;656;2101
171488;201804;2423;7308;1955;6549;340;1188;1042;3590;1382;4778
171500;201804;917;2493;706;2161;54;167;515;1593;569;1760
171510;201804;785;2734;701;2576;48;222;489;1807;537;2029
171515;201804;482;1348;353;1125;29;108;212;656;241;764
171525;201804;604;1891;505;1712;35;158;317;1011;352;1169
171550;201804;323;998;231;833;42;168;116;403;158;571
171570;201804;1173;3654;997;3322;191;618;591;2054;782;2672
171575;201804;1866;5061;1211;3858;203;692;506;1579;709;2271
171610;201804;5534;16111;4182;13779;1018;3658;1134;3933;2152;7591
171620;201804;2799;7890;2349;7269;136;511;1893;5902;2029;6413
171630;201804;964;2738;790;2493;164;552;468;1508;632;2060
171650;201804;2081;6242;1529;5176;365;1294;501;1776;866;3070
171660;201804;2357;6265;1644;4986;277;834;839;2561;1116;3395
171665;201804;1310;3819;1017;3349;183;664;478;1603;661;2267
171670;201804;1815;4989;1409;4331;221;760;753;2277;974;3037
171700;201804;1168;3519;885;3009;129;428;473;1635;602;2063
171720;201804;764;2136;610;1868;61;223;434;1313;495;1536
171750;201804;1198;3546;863;2917;237;819;174;657;411;1476
171780;201804;1271;3321;920;2815;72;253;622;1883;694;2136
171790;201804;1432;4954;1154;4328;272;1002;507;2004;779;3006
171800;201804;729;2130;569;1880;71;255;328;1089;399;1344
171820;201804;10205;30063;7881;25984;1885;6616;2669;9289;4554;15905
171830;201804;1441;5098;1238;4679;201;839;708;2672;909;3511
171840;201804;691;1890;562;1688;30;100;420;1240;450;1340
171845;201804;625;1684;484;1474;72;255;268;833;340;1088
171850;201804;848;3004;729;2753;71;312;497;1850;568;2162
171855;201804;1075;3352;943;3116;83;267;611;2014;694;2281
171865;201804;389;1297;333;1203;61;239;165;575;226;814
171870;201804;757;2200;554;1806;77;278;293;994;370;1272
171875;201804;1231;3793;986;3386;64;260;725;2457;789;2717
171880;201804;1009;3350;917;3235;52;176;755;2742;807;2918
171884;201804;904;2419;656;2041;123;436;215;751;338;1187
171886;201804;1417;4160;1010;3423;298;1074;184;651;482;1725
171888;201804;762;2214;526;1752;52;185;318;1050;370;1235
171889;201804;461;1443;396;1312;74;277;176;584;250;861
171890;201804;1144;3252;882;2827;159;500;520;1691;679;2191
171900;201804;494;1766;373;1473;91;365;136;572;227;937
172000;201804;582;1819;481;1623;68;271;252;814;320;1085
172010;201804;1045;3720;917;3457;82;398;595;2161;677;2559
172015;201804;325;1247;262;1114;50;204;120;521;170;725
172020;201804;2289;7419;2108;7138;184;749;1575;5319;1759;6068
172025;201804;720;2069;525;1748;55;221;317;1060;372;1281
172030;201804;1224;3704;1058;3435;24;108;868;2812;892;2920
172049;201804;1366;3384;888;2639;315;975;391;1175;706;2150
172065;201804;1422;3682;1146;3348;63;150;1026;3062;1089;3212
172080;201804;2355;7216;1927;6411;135;489;1329;4443;1464;4932
172085;201804;466;1320;306;985;53;150;85;262;138;412
172090;201804;3989;10550;3125;9324;145;510;2479;7349;2624;7859
172093;201804;510;1535;377;1287;53;223;194;632;247;855
172097;201804;621;1730;454;1462;73;245;198;662;271;907
172100;201804;41235;109000;28632;88167;6571;22075;8208;26413;14779;48488
172110;201804;1586;6014;1385;5692;140;597;1041;4437;1181;5034
172120;201804;4911;15161;3880;13465;691;2408;1991;7169;2682;9577
172125;201804;289;847;212;716;26;90;117;401;143;491
172130;201804;707;2098;572;1872;23;79;410;1354;433;1433
172208;201804;2351;6253;1889;5599;284;806;1143;3476;1427;4282
172210;201804;2709;7476;2109;6655;448;1479;1119;3561;1567;5040
210005;201804;19682;59579;16041;53725;4693;16340;6264;22047;10957;38387
210010;201804;1744;5812;1584;5546;54;226;1376;4841;1430;5067
210015;201804;3303;10177;2948;9666;140;371;2513;8431;2653;8802
210020;201804;7434;17021;6646;16129;93;245;6197;15016;6290;15261
210030;201804;4846;16270;4598;15921;226;1079;3966;13583;4192;14662
210040;201804;2116;6050;1908;5813;34;64;1777;5509;1811;5573
210043;201804;6677;17992;5503;16651;693;1965;3932;12571;4625;14536
210047;201804;6361;21859;5705;20922;252;1222;4946;18037;5198;19259
210050;201804;2163;7716;1737;6899;262;1133;1067;4287;1329;5420
210055;201804;1759;5974;1623;5741;68;283;1325;4673;1393;4956
210060;201804;6637;25930;6067;24806;812;3410;4224;17699;5036;21109
210070;201804;7154;20773;6744;20285;41;124;6484;19657;6525;19781
210080;201804;3719;13225;3635;13122;18;82;3540;12824;3558;12906
210083;201804;4996;15894;4384;15227;72;376;4150;14371;4222;14747
210087;201804;2833;8249;2561;7869;154;432;2140;6734;2294;7166
210090;201804;9558;29987;9118;29267;278;1026;8302;26513;8580;27539
210095;201804;5953;20555;5573;20075;261;1104;4879;17675;5140;18779
210100;201804;6833;20664;6311;19919;240;906;5385;17000;5625;17906
210110;201804;2714;8983;2567;8785;34;155;2409;8242;2443;8397
210120;201804;23766;66934;20344;62630;2678;7028;13732;45105;16410;52133
210125;201804;3898;11568;3618;11215;666;1641;2693;8865;3359;10506
210130;201804;4116;11566;3580;10881;162;476;3051;9299;3213;9775
210135;201804;1463;4555;1311;4315;53;221;1089;3582;1142;3803
210140;201804;17011;50604;13938;46405;2990;9988;7601;26246;10591;36234
210150;201804;4480;11131;4020;10525;70;248;3629;9359;3699;9607
210160;201804;16032;49636;14702;47696;1313;4313;11090;36859;12403;41172
210170;201804;14007;47101;13360;46268;602;2203;11989;41694;12591;43897
210173;201804;2426;9232;2297;9027;52;310;2127;8350;2179;8660
210177;201804;3050;9167;2878;8960;62;145;2730;8611;2792;8756
210180;201804;1457;4154;1328;3980;31;113;1184;3532;1215;3645
210190;201804;4711;14490;4292;13715;109;561;3547;11074;3656;11635
210193;201804;1197;3758;1094;3595;43;173;903;2977;946;3150
210197;201804;1964;6588;1815;6396;193;641;1399;5092;1592;5733
210200;201804;7419;24886;6904;24123;639;2280;5536;19655;6175;21935
210203;201804;6909;21308;6385;20608;481;1512;5403;17690;5884;19202
210207;201804;3427;10326;3080;9849;162;438;2505;8248;2667;8686
210210;201804;8148;27316;7719;26723;95;542;7191;24857;7286;25399
210215;201804;1978;6778;1815;6551;61;311;1616;5801;1677;6112
210220;201804;5833;21243;5543;20738;242;1298;4811;17754;5053;19052
210230;201804;4992;15785;4612;15230;216;621;4088;13662;4304;14283
210232;201804;11465;37135;9550;34458;1389;5206;6267;23933;7656;29139
210235;201804;3573;10848;3148;10305;113;482;2776;9101;2889;9583
210237;201804;2386;8738;2221;8535;21;111;2126;8190;2147;8301
210240;201804;2696;8625;2491;8276;92;371;2155;7115;2247;7486
210250;201804;5383;16967;4966;16449;106;564;4443;14662;4549;15226
210255;201804;2604;8148;2286;7570;292;1017;1574;5183;1866;6200
210260;201804;5128;16267;4623;15493;281;1004;3845;12934;4126;13938
210270;201804;4901;14063;4435;13429;93;459;3953;11855;4046;12314
210275;201804;3534;9115;3234;8764;58;116;3058;8403;3116;8519
210280;201804;5504;16418;4594;15037;243;1182;3361;10736;3604;11918
210290;201804;6411;19210;5929;18614;141;515;5346;16809;5487;17324
210300;201804;34769;94989;28859;87508;1895;5862;21651;68497;23546;74359
210310;201804;2995;7953;2719;7584;62;127;2459;6911;2521;7038
210312;201804;2415;6934;2164;6632;57;221;1962;6002;2019;6223
210315;201804;2806;8228;2398;7736;73;197;2127;7059;2200;7256
210317;201804;3917;12611;3651;12303;113;494;3373;11322;3486;11816
210320;201804;18873;60992;17690;59440;527;2436;15945;53440;16472;55876
210325;201804;3475;10442;3081;9874;90;333;2736;8866;2826;9199
210330;201804;27785;77324;22944;71291;5633;16633;11621;41421;17254;58054
210340;201804;10444;31871;9453;30417;1025;3154;6855;22993;7880;26147
210350;201804;9316;27919;8372;26659;265;905;7215;23147;7480;24052
210355;201804;3982;14143;3538;13442;133;710;2951;11315;3084;12025
210360;201804;14573;43841;13139;41813;653;2555;10829;34251;11482;36806
210370;201804;9854;23030;7870;20918;267;573;7039;19168;7306;19741
210375;201804;3051;8813;2407;7932;647;2125;1148;4044;1795;6169
210380;201804;5468;14918;4947;14247;265;700;4265;12426;4530;13126
210390;201804;2658;9817;2491;9526;140;668;2072;7883;2212;8551
210400;201804;4661;14666;4289;14207;117;307;3950;13279;4067;13586
210405;201804;7264;20228;5899;18248;1161;3456;3194;10485;4355;13941
210407;201804;1935;6740;1633;6156;141;643;1249;4621;1390;5264
210408;201804;2348;9165;2228;9000;146;740;1828;7483;1974;8223
210409;201804;3646;12988;3363;12584;110;629;2884;10777;2994;11406
210410;201804;3516;11184;3123;10562;230;771;2413;8305;2643;9076
210420;201804;4022;13091;3651;12433;171;566;3084;10601;3255;11167
210430;201804;2185;6540;2067;6401;118;320;1813;5690;1931;6010
210440;201804;4079;11791;3836;11479;77;243;3614;10843;3691;11086
210450;201804;2510;7983;2256;7563;127;480;1819;6062;1946;6542
210455;201804;3777;10433;3151;9680;720;2151;1961;6246;2681;8397
210460;201804;3326;10483;3028;10052;114;463;2588;8579;2702;9042
210462;201804;1437;4928;1292;4654;57;277;1043;3709;1100;3986
210465;201804;2582;7943;2284;7526;90;290;1982;6604;2072;6894
210467;201804;5906;19644;5448;19093;278;1155;4781;16817;5059;17972
210470;201804;2113;5575;1461;4625;78;193;1108;3616;1186;3809
210480;201804;14942;46515;12827;43821;1514;4997;9243;33424;10757;38421
210490;201804;3717;9814;3083;8909;73;253;2700;7794;2773;8047
210500;201804;6089;24944;5752;24308;401;2032;4625;19413;5026;21445
210510;201804;6015;20872;5592;20361;141;620;5024;18532;5165;19152
210515;201804;3554;10889;3217;10531;126;370;2913;9714;3039;10084
210520;201804;2570;7525;2296;7169;101;347;2026;6353;2127;6700
210530;201804;48875;130334;40425;117454;6758;24468;11713;41267;18471;65735
210535;201804;3094;10686;2955;10491;84;310;2622;9404;2706;9714
210540;201804;13589;42758;11837;40436;1438;4885;8477;30000;9915;34885
210542;201804;5904;15481;5089;14574;246;493;4567;13453;4813;13946
210545;201804;2295;7214;2149;6982;45;209;1915;6142;1960;6351
210547;201804;3539;12796;3234;12218;336;1224;2346;9147;2682;10371
210550;201804;5808;17727;5026;16767;296;1016;4212;14321;4508;15337
210560;201804;3584;11215;3245;10628;107;389;2802;9114;2909;9503
210565;201804;1416;5047;1208;4718;43;227;981;3891;1024;4118
210570;201804;11071;30835;10083;29658;326;808;9198;27389;9524;28197
210580;201804;2898;8269;2567;7857;227;427;2064;6679;2291;7106
210590;201804;4032;12589;3631;12063;131;656;3195;10501;3326;11157
210592;201804;2511;7707;2370;7474;29;165;2099;6533;2128;6698
210594;201804;2726;7516;2140;6601;91;236;1576;5047;1667;5283
210596;201804;2411;8916;2242;8562;169;720;1748;6718;1917;7438
210598;201804;1761;5264;1649;5114;34;141;1530;4732;1564;4873
210600;201804;2935;8304;2484;7693;77;225;2033;6339;2110;6564
210610;201804;2441;7645;2215;7360;83;390;1960;6427;2043;6817
210620;201804;2242;6907;1982;6588;43;129;1823;6174;1866;6303
210630;201804;3109;10846;2827;10431;171;825;2295;8353;2466;9178
210632;201804;4216;14312;3831;13729;344;1409;2983;10659;3327;12068
210635;201804;1828;6437;1721;6254;137;450;1427;5334;1564;5784
210637;201804;2440;8414;2205;8054;139;645;1704;6263;1843;6908
210640;201804;4907;19423;4835;19348;35;138;4744;19049;4779;19187
210650;201804;7041;20739;6672;20249;80;304;6342;19210;6422;19514
210660;201804;8635;25107;7715;23739;329;1183;6640;20284;6969;21467
210663;201804;2519;7747;2400;7611;111;310;2124;6907;2235;7217
210667;201804;1874;6260;1759;6081;64;265;1574;5480;1638;5745
210670;201804;4451;15749;4181;15319;153;724;3658;13352;3811;14076
210675;201804;4998;13914;4442;13178;312;774;3717;11381;4029;12155
210680;201804;4005;10515;3394;9767;137;291;2987;8798;3124;9089
210690;201804;7374;24463;6788;23838;249;1036;6015;21485;6264;22521
210700;201804;2767;7731;2339;7200;165;399;1838;6156;2003;6555
210710;201804;4795;15575;4388;14986;145;674;3854;13080;3999;13754
210720;201804;2730;9344;2570;9136;56;300;2357;8313;2413;8613
210725;201804;1242;4435;1111;4205;43;183;801;3153;844;3336
210730;201804;1205;3369;1030;3123;74;217;810;2477;884;2694
210735;201804;4469;13989;3926;13180;312;1113;3246;11015;3558;12128
210740;201804;5222;14666;4720;14150;147;599;4194;12471;4341;13070
210745;201804;4480;12774;4253;12488;148;369;3849;11408;3997;11777
210750;201804;19742;52034;17129;48972;1525;4337;12995;38018;14520;42355
210760;201804;5555;16076;5068;15548;25;86;4910;15118;4935;15204
210770;201804;5786;15799;5011;14917;58;246;4614;13765;4672;14011
210780;201804;7092;23792;6460;22709;635;2091;4904;17661;5539;19752
210790;201804;4557;14621;4249;14226;130;386;3491;12345;3621;12731
210800;201804;4858;13342;4258;12582;68;282;3887;11376;3955;11658
210805;201804;3802;14637;3671;14434;114;628;3282;12861;3396;13489
210810;201804;5024;15083;4619;14564;215;474;4040;13188;4255;13662
210820;201804;7078;20697;6137;19162;732;2281;4028;12793;4760;15074
210825;201804;6211;20120;5860;19672;274;886;5146;17579;5420;18465
210830;201804;7692;22328;7287;21815;462;1011;6337;19629;6799;20640
210840;201804;3364;9080;3040;8638;82;269;2663;7497;2745;7766
210845;201804;5976;17173;5721;16899;30;66;5654;16748;5684;16814
210850;201804;5689;20068;5098;19114;369;1676;3923;14679;4292;16355
210860;201804;17863;50848;15498;47665;872;2546;12659;39862;13531;42408
210870;201804;6000;18661;5267;17785;308;1063;4467;15243;4775;16306
210880;201804;4231;13568;3924;13202;226;900;3313;11124;3539;12024
210890;201804;4363;13297;3993;12854;255;636;3362;11285;3617;11921
210900;201804;4708;13935;3601;11944;1331;4726;683;2522;2014;7248
210905;201804;1880;5544;1625;5187;49;128;1439;4674;1488;4802
210910;201804;7400;23422;6432;21791;825;2908;4287;14572;5112;17480
210920;201804;3048;10509;2705;10042;98;510;2362;8719;2460;9229
210923;201804;1400;4558;1262;4338;78;323;962;3297;1040;3620
210927;201804;4955;15926;4480;15414;116;441;4103;14279;4219;14720
210930;201804;2409;8578;2222;8260;110;567;1789;6559;1899;7126
210940;201804;3486;11244;3299;10982;120;572;2906;9481;3026;10053
210945;201804;5886;17909;5558;17520;253;713;4936;15748;5189;16461
210950;201804;5032;15064;3996;13487;533;1626;2728;9627;3261;11253
210955;201804;1693;5453;1501;5149;151;502;1061;3720;1212;4222
210960;201804;8712;27306;7861;26070;1587;4873;4804;17058;6391;21931
210970;201804;1293;4285;1095;3929;84;385;810;2797;894;3182
210975;201804;1659;5533;1548;5326;128;479;1162;3977;1290;4456
210980;201804;10528;23808;9429;22688;168;350;8973;21757;9141;22107
210990;201804;15832;47502;13061;43764;1575;5384;8798;30165;10373;35549
211000;201804;14323;44370;12499;42300;629;2634;10347;35737;10976;38371
211003;201804;5054;16977;4415;16194;168;746;3758;14042;3926;14788
211010;201804;6338;23496;5898;22892;78;476;5433;21232;5511;21708
211020;201804;7876;24935;7410;24311;360;1367;6366;20957;6726;22324
211023;201804;2071;6941;1960;6781;113;443;1630;5590;1743;6033
211027;201804;2647;9501;2594;9411;199;805;2209;7981;2408;8786
211030;201804;3741;10971;3421;10594;272;630;2875;9181;3147;9811
211040;201804;4390;16290;4199;16001;137;773;3730;14144;3867;14917
211050;201804;9614;24688;8855;23757;190;494;8233;22119;8423;22613
211060;201804;6021;20304;5649;19758;205;860;5101;17832;5306;18692
211065;201804;2064;6185;1803;5820;55;173;1594;5223;1649;5396
211070;201804;7590;25602;6802;24336;492;1822;5392;19493;5884;21315
211080;201804;1305;3753;1089;3420;45;248;853;2523;898;2771
211085;201804;1948;6131;1755;5848;110;343;1473;4970;1583;5313
211090;201804;3265;9224;2959;8816;49;242;2665;7839;2714;8081
211100;201804;6327;16862;6051;16491;50;165;5677;15466;5727;15631
211102;201804;2849;10612;2648;10328;161;744;2287;8923;2448;9667
211105;201804;2308;7667;1967;7027;225;826;1344;4774;1569;5600
211107;201804;4372;14061;3907;13400;172;633;3223;11335;3395;11968
211110;201804;5879;16900;4629;14999;591;1760;3207;10787;3798;12547
211120;201804;34590;97561;31996;94432;4294;11708;23722;72288;28016;83996
211125;201804;1920;6037;1682;5645;68;287;1437;4819;1505;5106
211130;201804;181263;466148;169087;450662;24488;66605;77792;233095;102280;299700
211140;201804;4945;15577;4532;14985;232;753;3847;12775;4079;13528
211150;201804;9213;26388;8174;25080;278;1034;7049;21642;7327;22676
211153;201804;2565;7874;2190;7401;406;1451;1425;5004;1831;6455
211157;201804;1092;3540;924;3271;46;261;647;2290;693;2551
211160;201804;3902;12261;3241;11155;197;906;2349;7847;2546;8753
211163;201804;1695;5662;1582;5500;13;44;1500;5281;1513;5325
211167;201804;1512;4947;1426;4807;30;144;1337;4483;1367;4627
211170;201804;5955;15503;5670;15161;66;229;5408;14400;5474;14629
211172;201804;2411;6906;2139;6464;78;284;1787;5239;1865;5523
211174;201804;2731;8287;2529;8017;74;363;2277;7137;2351;7500
211176;201804;3986;12398;3321;11449;244;1002;2528;8706;2772;9708
211178;201804;4533;10789;4017;10193;31;127;3797;9524;3828;9651
211180;201804;4024;13811;3773;13433;236;912;3197;11449;3433;12361
211190;201804;2990;9237;2629;8692;49;250;2284;7476;2333;7726
211195;201804;1368;4027;1166;3753;79;208;961;3201;1040;3409
211200;201804;2006;6263;1691;5840;183;656;1145;4059;1328;4715
211210;201804;6505;20069;6031;19411;274;992;5239;16912;5513;17904
211220;201804;33878;92546;29159;86633;3400;10132;20703;63183;24103;73315
211223;201804;4873;14463;4359;13674;488;1424;3180;10215;3668;11639
211227;201804;1648;5821;1532;5640;48;249;1319;4880;1367;5129
211230;201804;7156;22828;6536;21789;529;1793;5125;17133;5654;18926
211240;201804;7950;26619;7572;26135;171;945;6921;23585;7092;24530
211245;201804;5986;16720;5748;16480;50;97;5656;16281;5706;16378
211250;201804;13534;40526;12515;39306;506;1899;10975;34325;11481;36224
211260;201804;7499;24853;6914;24072;213;937;6272;21918;6485;22855
211270;201804;10127;33569;8960;32062;388;1880;7385;26636;7773;28516
211280;201804;13323;38186;11972;36456;808;1959;9790;30984;10598;32943
211285;201804;1640;5939;1453;5594;243;978;727;2909;970;3887
211290;201804;6914;22294;6493;21706;212;856;5614;18773;5826;19629
211300;201804;8213;23790;7510;22867;65;179;7120;21810;7185;21989
211400;201804;11190;34171;9418;31506;1668;5581;5542;19885;7210;25466
220005;201804;1823;5050;1639;4768;37;150;1340;3798;1377;3948
220010;201804;1471;4238;1249;3857;29;126;990;2995;1019;3121
220020;201804;3197;9820;2913;9334;357;1204;2102;6683;2459;7887
220025;201804;2217;5267;1940;4862;33;94;1605;3927;1638;4021
220027;201804;1244;3315;1085;3099;32;103;876;2483;908;2586
220030;201804;3314;9128;3167;8899;108;322;2771;7684;2879;8006
220040;201804;6936;21265;6275;20037;1171;3667;3929;12727;5100;16394
220045;201804;1383;4445;1208;4110;39;193;958;3196;997;3389
220050;201804;4426;12927;3778;11934;136;593;3245;10141;3381;10734
220060;201804;2254;5154;1898;4737;31;75;1743;4339;1774;4414
220070;201804;2456;6661;2159;6208;87;231;1756;5021;1843;5252
220080;201804;658;1975;599;1879;27;112;504;1517;531;1629
220090;201804;1758;4373;1441;3926;14;49;1259;3428;1273;3477
220095;201804;667;1773;631;1724;8;18;587;1602;595;1620
220100;201804;1329;3855;1088;3413;53;206;865;2648;918;2854
220105;201804;2043;6457;1789;5939;134;449;1321;4407;1455;4856
220110;201804;3386;9575;3176;9205;57;242;2795;7973;2852;8215
220115;201804;2611;8254;2441;7983;81;351;2173;6999;2254;7350
220117;201804;1329;3373;1038;2932;19;69;884;2460;903;2529
220120;201804;11364;33549;10481;32430;119;507;9840;30401;9959;30908
220130;201804;996;2958;852;2740;17;115;761;2396;778;2511
220140;201804;1729;4237;1480;3924;159;403;1225;3258;1384;3661
220150;201804;6518;19691;6122;19104;145;761;5305;16212;5450;16973
220155;201804;1087;3244;866;2834;22;87;602;1945;624;2032
220157;201804;1052;2668;889;2395;18;79;725;1887;743;1966
220160;201804;2613;7704;2276;7064;47;252;1873;5675;1920;5927
220170;201804;1368;3871;1164;3547;19;97;1018;3045;1037;3142
220173;201804;1964;5769;1598;5075;38;188;1301;4000;1339;4188
220177;201804;1830;5465;1783;5406;15;54;1729;5251;1744;5305
220180;201804;1149;2964;898;2490;11;43;658;1730;669;1773
220190;201804;5509;15801;4801;14827;421;1356;3630;11309;4051;12665
220191;201804;1381;4507;1289;4336;82;342;927;3038;1009;3380
220192;201804;1816;5065;1454;4418;33;136;1152;3425;1185;3561
220194;201804;1691;5018;1516;4727;67;259;1253;3823;1320;4082
220196;201804;1967;5467;1787;5155;50;202;1512;4279;1562;4481
220198;201804;1212;3567;1008;3284;6;15;955;3161;961;3176
220200;201804;4634;14550;4224;14005;311;1106;3389;11241;3700;12347
220202;201804;2155;6216;1854;5682;31;150;1564;4694;1595;4844
220205;201804;2540;7088;2255;6644;46;190;1956;5666;2002;5856
220207;201804;819;2504;696;2283;57;216;473;1537;530;1753
220208;201804;1703;5390;1397;4760;303;1140;622;2099;925;3239
220209;201804;1608;4692;1379;4289;29;131;1119;3457;1148;3588
220210;201804;1585;4214;1361;3830;27;121;1107;3007;1134;3128
220211;201804;1501;4131;1414;4007;20;80;1249;3546;1269;3626
220213;201804;1708;4725;1503;4324;28;109;1239;3472;1267;3581
220217;201804;1943;6169;1858;6061;42;178;1726;5661;1768;5839
220220;201804;10130;27387;8624;25035;528;1431;6358;18792;6886;20223
220225;201804;1124;3053;928;2795;14;55;809;2403;823;2458
220230;201804;5636;14415;4904;13436;179;499;4253;11675;4432;12174
220240;201804;2872;8665;2643;8237;83;311;2185;6783;2268;7094
220245;201804;1553;4010;1249;3610;12;44;1114;3282;1126;3326
220250;201804;2765;8261;2438;7817;40;179;2170;6945;2210;7124
220253;201804;1652;4635;1385;4162;102;305;1102;3251;1204;3556
220255;201804;1840;4707;1555;4264;24;133;1300;3402;1324;3535
220260;201804;4218;13413;3726;12538;194;712;2943;9901;3137;10613
220265;201804;1223;4144;1115;3976;61;272;855;3003;916;3275
220270;201804;6500;20858;6128;20185;341;1405;5043;16140;5384;17545
220271;201804;1464;3936;1271;3644;47;163;1082;3096;1129;3259
220272;201804;1694;4965;1505;4614;37;135;1176;3534;1213;3669
220273;201804;1170;3415;1002;3093;32;121;784;2397;816;2518
220275;201804;2193;5411;1693;4745;39;138;1461;4071;1500;4209
220277;201804;2079;5565;1809;5140;29;108;1516;4219;1545;4327
220280;201804;1542;3994;1309;3617;47;161;1068;2841;1115;3002
220285;201804;1500;3943;1261;3634;17;71;1127;3216;1144;3287
220290;201804;5812;18157;4807;16716;383;1517;3469;12069;3852;13586
220300;201804;1854;5841;1572;5422;43;262;1297;4379;1340;4641
220310;201804;2688;8060;2242;7545;49;255;1920;6355;1969;6610
220320;201804;2835;8591;2319;7592;134;533;1764;5677;1898;6210
220323;201804;1584;5154;1280;4664;89;385;1006;3627;1095;4012
220325;201804;1230;3740;1040;3381;44;183;834;2683;878;2866
220327;201804;1368;4173;1221;3918;43;209;1020;3180;1063;3389
220330;201804;3906;10281;3321;9496;148;446;2735;7782;2883;8228
220335;201804;1734;5326;1558;5123;31;84;1436;4762;1467;4846
220340;201804;1792;4860;1447;4280;54;193;1024;2922;1078;3115
220342;201804;1131;3525;1024;3359;36;145;827;2711;863;2856
220345;201804;2987;7092;2439;6335;13;34;2312;5997;2325;6031
220350;201804;3468;9164;2820;8113;146;476;2101;5949;2247;6425
220360;201804;1222;3191;998;2847;24;78;794;2236;818;2314
220370;201804;8961;25629;8126;24469;214;879;7210;21484;7424;22363
220375;201804;1409;4419;1311;4278;7;22;1276;4171;1283;4193
220380;201804;1494;3731;1236;3360;37;121;1061;2832;1098;2953
220385;201804;805;1996;632;1692;9;33;536;1400;545;1433
220390;201804;8480;24616;7175;22313;1824;5615;2992;9878;4816;15493
220400;201804;1491;3700;1149;3154;24;86;889;2359;913;2445
220410;201804;1159;3300;963;2975;58;180;768;2336;826;2516
220415;201804;818;2223;711;2046;23;75;538;1513;561;1588
220420;201804;1986;5657;1622;4948;63;210;1231;3685;1294;3895
220430;201804;2430;6651;2363;6561;80;240;2133;5882;2213;6122
220435;201804;1688;4688;1501;4392;57;194;1169;3357;1226;3551
220440;201804;2434;7839;2144;7363;133;517;1750;5909;1883;6426
220450;201804;2189;6242;1816;5732;229;827;1318;4123;1547;4950
220455;201804;1308;4146;1241;4054;28;135;1100;3559;1128;3694
220460;201804;937;2437;847;2333;42;135;734;1978;776;2113
220465;201804;2328;7467;2094;7100;147;556;1614;5471;1761;6027
220470;201804;3513;10144;3149;9549;109;371;2552;7623;2661;7994
220480;201804;2411;6630;1969;5897;153;391;1436;4258;1589;4649
220490;201804;2309;6169;2111;5929;35;144;1888;5241;1923;5385
220500;201804;2694;7298;2421;6844;56;231;1968;5385;2024;5616
220510;201804;2663;7836;2187;6976;83;269;1682;5392;1765;5661
220515;201804;1706;4157;1521;3906;50;114;1348;3460;1398;3574
220520;201804;4956;13196;4524;12583;87;264;4095;11383;4182;11647
220525;201804;1226;3373;1117;3221;16;57;984;2799;1000;2856
220527;201804;1283;3765;1137;3506;31;109;951;2950;982;3059
220530;201804;1202;3384;1083;3204;27;107;997;2895;1024;3002
220535;201804;803;2302;744;2224;50;148;597;1789;647;1937
220540;201804;3319;10600;3144;10305;95;411;2746;8937;2841;9348
220545;201804;1349;4352;1261;4180;83;330;1030;3355;1113;3685
220550;201804;8776;27496;7933;26017;585;2119;5943;19210;6528;21329
220551;201804;1431;4334;1257;4036;51;209;990;3118;1041;3327
220552;201804;1497;4493;1273;4060;32;166;1037;3202;1069;3368
220553;201804;1571;4408;1338;4039;50;150;1042;3227;1092;3377
220554;201804;840;2339;647;2011;39;112;482;1481;521;1593
220555;201804;2009;6599;1873;6358;56;285;1556;5207;1612;5492
220556;201804;1301;3910;1123;3537;46;200;840;2526;886;2726
220557;201804;1539;4787;1321;4339;82;305;952;3063;1034;3368
220558;201804;1248;3493;1012;3154;29;147;837;2543;866;2690
220559;201804;1613;4329;1388;3962;14;56;1150;3288;1164;3344
220560;201804;1671;3990;1355;3555;40;97;1189;3098;1229;3195
220570;201804;7067;22136;6504;21232;551;1858;5020;16474;5571;18332
220580;201804;6498;19084;6176;18561;158;566;5496;16357;5654;16923
220585;201804;1926;6401;1745;6054;68;283;1419;4886;1487;5169
220590;201804;1264;3629;1076;3343;100;318;763;2381;863;2699
220595;201804;2392;6741;2230;6527;15;83;2093;6064;2108;6147
220600;201804;1379;3192;1130;2869;87;138;927;2416;1014;2554
220605;201804;1699;5016;1463;4600;38;165;1155;3546;1193;3711
220610;201804;2840;8964;2680;8733;39;184;2458;8000;2497;8184
220620;201804;7684;24633;7181;23936;190;868;6506;21524;6696;22392
220630;201804;369;1127;293;993;40;145;176;613;216;758
220635;201804;1669;5400;1469;4972;74;303;1086;3621;1160;3924
220640;201804;2648;7361;2262;6778;78;291;1885;5571;1963;5862
220650;201804;2034;5898;1759;5405;68;238;1353;4111;1421;4349
220660;201804;2750;8295;2435;7861;92;411;2044;6411;2136;6822
220665;201804;1275;3996;1114;3729;27;153;945;3111;972;3264
220667;201804;1625;5283;1462;4986;68;258;1170;4007;1238;4265
220669;201804;1695;5380;1626;5252;82;372;1353;4278;1435;4650
220670;201804;2059;5691;1743;5315;37;119;1577;4792;1614;4911
220672;201804;2708;7278;2325;6815;104;302;2062;6051;2166;6353
220675;201804;1221;3443;1119;3253;48;130;885;2553;933;2683
220680;201804;2560;7358;2438;7190;116;336;2161;6368;2277;6704
220690;201804;1572;4332;1381;4017;121;309;1028;3036;1149;3345
220695;201804;925;2628;851;2483;21;68;703;2033;724;2101
220700;201804;8582;22865;7017;20600;348;1133;5383;15639;5731;16772
220710;201804;837;2431;649;2058;54;152;453;1435;507;1587
220720;201804;2004;5031;1820;4750;33;111;1578;4087;1611;4198
220730;201804;1295;3757;1103;3443;23;105;909;2776;932;2881
220735;201804;991;2389;759;2010;23;62;639;1671;662;1733
220740;201804;1400;4016;1126;3656;34;128;952;3102;986;3230
220750;201804;3564;9957;3248;9486;168;487;2808;8188;2976;8675
220755;201804;1140;3037;990;2804;30;116;785;2146;815;2262
220760;201804;2926;8881;2590;8418;109;394;2196;7180;2305;7574
220770;201804;20272;64677;17627;59767;6087;21312;5626;20010;11713;41322
220775;201804;1124;3028;1056;2948;19;62;1017;2838;1036;2900
220777;201804;1551;4128;1230;3594;38;103;934;2712;972;2815
220779;201804;1340;3335;1210;3150;29;106;1047;2677;1076;2783
220780;201804;5471;14435;4727;13219;226;777;3831;10435;4057;11212
220785;201804;1389;3196;1263;3015;21;35;1191;2847;1212;2882
220790;201804;10024;29378;9070;27969;300;1308;7642;23163;7942;24471
220793;201804;831;2282;702;2063;25;78;579;1695;604;1773
220795;201804;1403;3772;1267;3600;25;101;1127;3186;1152;3287
220800;201804;16012;40467;13602;36925;819;2307;9664;25790;10483;28097
220810;201804;2930;8474;2556;7792;53;229;2131;6357;2184;6586
220820;201804;5187;13784;4500;12805;425;1105;3372;9657;3797;10762
220830;201804;6979;19477;6366;18550;290;891;5290;15332;5580;16223
220840;201804;12411;38799;10696;35306;2231;7075;5561;18862;7792;25937
220850;201804;2937;9536;2694;9234;76;413;2403;8151;2479;8564
220855;201804;570;1665;493;1533;15;71;404;1233;419;1304
220860;201804;995;2536;862;2328;18;57;770;2066;788;2123
220865;201804;2523;6849;1990;5932;59;227;1556;4509;1615;4736
220870;201804;2548;7831;2142;7274;32;168;1949;6579;1981;6747
220880;201804;5078;12828;4547;12185;78;269;4203;11195;4281;11464
220885;201804;1278;4322;1100;4001;52;273;850;3088;902;3361
220887;201804;1310;3121;1181;2942;7;30;1111;2736;1118;2766
220890;201804;1570;5135;1327;4658;100;358;981;3477;1081;3835
220900;201804;1967;5036;1666;4614;38;95;1442;3967;1480;4062
220910;201804;1479;4326;1261;3992;31;108;1086;3445;1117;3553
220915;201804;984;2684;795;2315;18;78;627;1760;645;1838
220920;201804;1388;4719;1188;4435;86;391;915;3378;1001;3769
220930;201804;1545;4579;1366;4299;32;128;1219;3777;1251;3905
220935;201804;1041;3023;841;2597;34;136;563;1621;597;1757
220937;201804;1346;3716;1183;3464;27;104;964;2763;991;2867
220940;201804;1344;4043;1133;3623;37;164;851;2631;888;2795
220945;201804;413;1475;368;1388;24;135;262;956;286;1091
220950;201804;1382;3302;919;2554;20;76;709;1905;729;1981
220955;201804;1503;4091;1313;3762;36;104;1109;3185;1145;3289
220960;201804;875;2239;677;1919;16;61;537;1495;553;1556
220965;201804;1725;4879;1548;4613;27;162;1329;3839;1356;4001
220970;201804;1784;4726;1392;4088;55;151;1108;3258;1163;3409
220975;201804;704;2173;620;2063;23;152;550;1737;573;1889
220980;201804;1191;3451;1072;3256;31;131;886;2643;917;2774
220985;201804;1180;3336;1076;3182;45;183;827;2336;872;2519
220987;201804;1471;4471;1279;4134;63;275;1036;3284;1099;3559
220990;201804;1706;4898;1470;4521;34;181;1185;3539;1219;3720
220995;201804;1192;3561;916;3081;61;250;650;2173;711;2423
220997;201804;2380;7019;2240;6816;52;211;2056;6194;2108;6405
221000;201804;4012;11744;3704;11263;119;572;3114;9226;3233;9798
221005;201804;1413;4048;1279;3799;77;245;1008;2896;1085;3141
221010;201804;1206;2972;992;2711;23;65;863;2328;886;2393
221020;201804;1551;4848;1441;4626;35;166;1076;3394;1111;3560
221030;201804;1561;4304;1358;4006;34;150;1133;3288;1167;3438
221035;201804;1330;3709;1210;3549;23;52;1107;3313;1130;3365
221037;201804;586;1743;511;1605;11;56;361;1078;372;1134
221038;201804;524;1500;413;1291;17;57;291;901;308;958
221039;201804;877;2387;775;2222;21;85;656;1826;677;1911
221040;201804;4196;12954;3821;12290;161;563;3023;9750;3184;10313
221050;201804;3565;10045;3252;9641;54;236;2952;8660;3006;8896
221060;201804;8247;23367;6901;21217;276;914;5320;16621;5596;17535
221062;201804;1197;4054;1045;3757;45;237;806;2843;851;3080
221063;201804;1177;3529;1018;3282;68;252;733;2337;801;2589
221065;201804;2641;6950;2334;6425;34;116;2026;5492;2060;5608
221070;201804;3351;10751;2844;9755;219;820;1997;6863;2216;7683
221080;201804;3458;8610;2795;7609;66;259;2262;6079;2328;6338
221090;201804;1362;3689;1138;3297;17;71;985;2776;1002;2847
221093;201804;1412;4150;1309;3937;138;433;851;2481;989;2914
221095;201804;885;2369;751;2154;6;17;624;1749;630;1766
221097;201804;813;2167;637;1836;22;72;468;1295;490;1367
221100;201804;99549;282029;87838;261964;14972;45805;51270;150912;66242;196717
221110;201804;9884;30340;9171;29405;217;1102;8070;25494;8287;26596
221120;201804;4094;12351;3822;11898;261;891;3145;9719;3406;10610
221130;201804;4760;12981;3662;10755;960;2771;1478;4407;2438;7178
221135;201804;1562;4426;1405;4212;40;151;1224;3629;1264;3780
221140;201804;1302;3178;1141;2954;10;38;1025;2607;1035;2645
221150;201804;1108;2798;886;2408;20;86;696;1791;716;1877
221160;201804;801;2009;716;1893;30;62;576;1523;606;1585
221170;201804;1066;3135;963;2967;19;59;788;2418;807;2477
230010;201804;3149;8557;2548;7496;165;547;1918;5549;2083;6096
230015;201804;2886;9760;2653;9307;257;1068;1791;6155;2048;7223
230020;201804;13078;41972;12551;41104;451;1880;10725;34696;11176;36576
230030;201804;12099;32472;10575;30278;224;773;9283;26485;9507;27258
230040;201804;4111;11192;3549;10232;123;478;2866;8122;2989;8600
230050;201804;2714;8770;1999;6939;437;1463;712;2483;1149;3946
230060;201804;2308;6513;1886;5696;44;178;1519;4490;1563;4668
230070;201804;3907;10964;3272;9670;181;617;2216;6575;2397;7192
230075;201804;8937;29637;8304;28479;379;1897;6759;22612;7138;24509
230080;201804;2588;6059;2056;5296;31;138;1800;4566;1831;4704
230090;201804;3997;10684;3466;9819;186;602;2639;7350;2825;7952
230100;201804;17426;48185;15638;45542;1734;5359;10195;29701;11929;35060
230110;201804;11848;36344;10541;33692;1940;6264;5638;18164;7578;24428
230120;201804;7398;20588;6523;19150;599;1617;4721;14144;5320;15761
230125;201804;3016;8341;2477;7424;91;334;1899;5639;1990;5973
230130;201804;5673;18069;4742;16031;452;1662;3072;10172;3524;11834
230140;201804;3444;10627;2932;9649;133;579;2147;6928;2280;7507
230150;201804;1601;4865;1353;4314;225;684;744;2445;969;3129
230160;201804;6293;17301;5472;16041;179;678;4540;13106;4719;13784
230170;201804;5897;17660;5107;16145;246;895;3762;11654;4008;12549
230180;201804;1591;4586;1362;4115;31;143;1062;3083;1093;3226
230185;201804;3985;12275;3471;11364;308;1173;2502;8164;2810;9337
230190;201804;12858;38965;11047;35444;1657;5487;5878;18920;7535;24407
230195;201804;5099;15317;4533;14334;341;1195;3492;10884;3833;12079
230200;201804;4828;13502;4228;12325;181;536;3325;9503;3506;10039
230205;201804;3983;12641;3597;11946;183;793;2675;8706;2858;9499
230210;201804;9426;24776;8068;22776;492;1577;5946;16639;6438;18216
230220;201804;13316;35561;11888;33229;544;1648;9677;26719;10221;28367
230230;201804;6882;21276;6181;19843;512;1663;4422;14142;4934;15805
230240;201804;12856;34731;11370;32314;441;1321;9222;25976;9663;27297
230250;201804;9056;26812;8923;26594;348;1282;6988;20296;7336;21578
230260;201804;14052;44856;12664;42019;1681;5871;7364;24641;9045;30512
230270;201804;7411;20834;5990;18166;601;1861;3907;11915;4508;13776
230280;201804;20133;56412;16984;51000;763;3097;13131;38146;13894;41243
230290;201804;4609;13447;3987;12131;414;1160;2866;8816;3280;9976
230300;201804;4288;12333;4045;11987;114;488;3535;10241;3649;10729
230310;201804;4755;13798;4061;12577;143;581;2902;8775;3045;9356
230320;201804;7444;21954;6527;20254;326;1286;5001;15236;5327;16522
230330;201804;4679;13218;3867;11632;187;577;2855;8476;3042;9053
230340;201804;3516;11308;3022;10274;266;953;2069;6979;2335;7932
230350;201804;18473;52866;16509;49516;1091;3795;10671;32380;11762;36175
230360;201804;2893;8122;2313;7040;138;502;1593;4764;1731;5266
230365;201804;2997;7712;2550;6982;61;279;2153;5787;2214;6066
230370;201804;52422;156378;45412;145169;9581;31332;22104;73251;31685;104583
230380;201804;6395;18213;5174;15891;177;663;3717;11222;3894;11885
230390;201804;3282;10109;2878;9404;132;562;2174;6954;2306;7516
230393;201804;2908;9229;2465;8309;92;494;1886;6100;1978;6594
230395;201804;5631;15705;4951;14501;494;1370;3329;9913;3823;11283
230400;201804;5575;16134;4980;15109;171;762;3969;11702;4140;12464
230410;201804;14513;44192;11880;38935;1357;4598;7272;23943;8629;28541
230420;201804;24943;74449;21413;67663;3018;10169;11697;36656;14715;46825
230423;201804;4571;13924;4002;12766;139;589;3169;9928;3308;10517
230425;201804;5383;17310;4953;16387;501;1678;3426;11364;3927;13042
230426;201804;2536;6930;1949;5772;44;187;1480;4301;1524;4488
230427;201804;1803;5260;1267;4018;60;204;871;2655;931;2859
230428;201804;9458;26696;8432;25073;1237;3884;4860;14316;6097;18200
230430;201804;4405;13314;3803;12211;207;809;2817;8792;3024;9601
230435;201804;5442;15549;4696;14239;602;1883;2855;8656;3457;10539
230440;201804;382915;1021293;323547;926853;51881;154908;172539;493915;224420;648823
230445;201804;4352;11740;3648;10499;199;519;2553;7246;2752;7765
230450;201804;3474;10549;3050;9797;209;848;2192;6918;2401;7766
230460;201804;1972;5915;1729;5487;84;333;1386;4367;1470;4700
230465;201804;3908;11374;3325;10289;105;477;2437;7281;2542;7758
230470;201804;11050;38035;10104;36194;896;3871;7295;25720;8191;29591
230480;201804;1409;4268;1200;3856;108;431;871;2705;979;3136
230490;201804;2275;6719;1991;6160;213;649;1148;3473;1361;4122
230495;201804;5683;17568;5090;16465;436;1740;3328;10582;3764;12322
230500;201804;8298;28721;7785;27713;345;1529;6105;21691;6450;23220
230510;201804;1630;5335;1215;4344;222;843;494;1755;716;2598
230520;201804;4297;12842;3868;12012;300;999;2720;8316;3020;9315
230523;201804;14984;45695;12477;40250;2904;9508;3138;10564;6042;20072
230526;201804;3848;11278;3291;10251;146;630;2539;7689;2685;8319
230530;201804;5215;16434;4524;15202;454;1631;3176;10733;3630;12364
230533;201804;4025;10572;3449;9490;130;372;2776;7576;2906;7948
230535;201804;5474;15518;4646;14030;312;967;3185;9767;3497;10734
230540;201804;16074;45649;14438;43130;339;1416;12321;36288;12660;37704
230550;201804;19661;55000;16507;49352;2019;6393;9519;28269;11538;34662
230560;201804;7405;19678;6147;17413;109;435;5022;14041;5131;14476
230565;201804;3139;8668;2586;7677;80;316;1963;5751;2043;6067
230570;201804;3485;9129;3044;8532;73;214;2557;7127;2630;7341
230580;201804;9646;27438;8624;25921;353;1311;7204;21428;7557;22739
230590;201804;8799;26160;7359;23406;553;1959;5120;15835;5673;17794
230600;201804;3737;9999;2809;8183;96;302;1833;5406;1929;5708
230610;201804;6309;18546;5661;17512;451;1433;4279;13225;4730;14658
230620;201804;2078;5787;1600;4790;141;439;967;2833;1108;3272
230625;201804;7924;24025;6946;22049;2056;6795;1830;6038;3886;12833
230630;201804;10138;31529;9037;29252;2390;7259;3881;13516;6271;20775
230640;201804;26465;82810;24224;79119;1675;6284;18964;61388;20639;67672
230650;201804;4871;14088;4252;12899;264;895;3234;9619;3498;10514
230655;201804;9143;32503;8730;31754;615;2542;6865;25072;7480;27614
230660;201804;6276;18727;5165;16596;178;935;4172;13074;4350;14009
230670;201804;5984;15042;4524;12554;191;588;3512;9474;3703;10062
230680;201804;2515;7277;2166;6587;220;661;1433;4360;1653;5021
230690;201804;6371;19753;5827;18574;540;1921;3590;11201;4130;13122
230700;201804;9323;25195;8134;22949;338;1122;6131;16797;6469;17919
230710;201804;6985;22258;6110;20482;513;1864;4433;14715;4946;16579
230720;201804;1855;5702;1550;5035;134;425;1009;3238;1143;3663
230725;201804;3517;11469;3100;10459;674;2389;1216;4031;1890;6420
230730;201804;54775;156617;45398;141359;10764;36193;15481;50548;26245;86741
230740;201804;5992;17294;5323;16134;149;592;4274;12807;4423;13399
230750;201804;8155;22738;6919;20639;216;801;5378;15649;5594;16450
230760;201804;11141;31153;9979;29162;745;2499;7215;20567;7960;23066
230763;201804;4348;12740;3750;11601;183;720;2885;8611;3068;9331
230765;201804;39130;114444;33586;104587;7304;23896;12545;39487;19849;63383
230770;201804;25433;67267;21823;62156;2887;8735;13455;38339;16342;47074
230780;201804;5825;21209;5500;20534;923;3448;3180;12314;4103;15762
230790;201804;2913;8732;2646;8279;161;603;2022;6253;2183;6856
230800;201804;7623;25431;6885;23865;894;3427;3933;13452;4827;16879
230810;201804;11584;35837;10532;34069;492;1944;8121;25775;8613;27719
230820;201804;3184;10626;2743;9649;276;1134;1680;5740;1956;6874
230830;201804;7366;21388;6346;19498;195;829;5079;15285;5274;16114
230835;201804;4020;9969;3176;8638;110;348;2567;6831;2677;7179
230837;201804;3121;10089;2666;9192;146;687;1977;6623;2123;7310
230840;201804;8761;26900;7715;25118;532;1918;5880;19109;6412;21027
230850;201804;9031;27354;8055;25449;522;1872;5744;17998;6266;19870
230860;201804;4997;13511;4240;12367;148;515;3569;10308;3717;10823
230870;201804;16963;42992;14659;39384;541;1560;11539;30831;12080;32391
230880;201804;1982;6331;1830;6064;76;386;1410;4518;1486;4904
230890;201804;4305;14542;3985;13925;339;1339;2840;9795;3179;11134
230900;201804;2990;9192;2515;8204;272;907;1560;4996;1832;5903
230910;201804;3011;8532;2451;7549;94;445;1925;5807;2019;6252
230920;201804;4504;12823;4038;12140;152;602;3374;10028;3526;10630
230930;201804;6495;19057;5527;17157;427;1415;3653;11230;4080;12645
230940;201804;7665;20949;6794;19538;215;663;5622;16070;5837;16733
230945;201804;6441;18940;5606;17259;424;1398;3820;11818;4244;13216
230950;201804;6304;16336;5759;15668;137;327;5145;14265;5282;14592
230960;201804;13509;40788;12198;38205;1942;6194;6048;19250;7990;25444
230970;201804;13302;37964;11463;34895;2116;6767;5473;16691;7589;23458
230980;201804;2715;8150;2351;7505;519;1603;1270;4229;1789;5832
230990;201804;1690;4887;1404;4313;77;330;960;2817;1037;3147
231000;201804;2450;6644;2083;5896;81;233;1488;4138;1569;4371
231010;201804;3016;7925;2490;7027;147;487;1924;5310;2071;5797
231020;201804;7990;26022;7312;24524;1294;4144;4235;14730;5529;18874
231025;201804;7237;21269;6476;19949;986;3100;4139;12841;5125;15941
231030;201804;6850;21387;5589;18650;975;3266;2938;9819;3913;13085
231040;201804;3108;9243;2698;8469;97;403;2076;6372;2173;6775
231050;201804;11719;31556;9524;27623;655;1835;7003;20072;7658;21907
231060;201804;2507;7624;2277;7236;86;356;1779;5626;1865;5982
231070;201804;8026;24183;6937;22142;1027;3342;3936;12654;4963;15996
231080;201804;3900;11706;3520;11013;124;641;2737;8233;2861;8874
231085;201804;5665;15611;4989;14753;334;978;3746;11275;4080;12253
231090;201804;4205;11415;3230;9445;123;463;2269;6445;2392;6908
231095;201804;2012;6307;1712;5620;157;571;1185;3834;1342;4405
231100;201804;2963;9048;2527;8232;177;614;1847;5997;2024;6611
231110;201804;3340;10544;3259;10405;185;737;2390;7474;2575;8211
231120;201804;1946;6183;1724;5766;131;462;1163;3874;1294;4336
231123;201804;1860;4999;1581;4480;76;223;1187;3305;1263;3528
231126;201804;5743;16250;4621;14045;204;726;3328;9894;3532;10620
231130;201804;19090;54175;16628;50600;1687;5834;11174;34080;12861;39914
231135;201804;4146;11940;3492;10722;176;648;2526;7618;2702;8266
231140;201804;17040;50172;14201;44899;870;3516;9602;29498;10472;33014
231150;201804;5296;15179;4431;13460;738;2181;2142;6673;2880;8854
231160;201804;5741;18348;5287;17442;1132;3520;2796;9623;3928;13143
231170;201804;4253;12955;3533;11458;233;863;2399;7553;2632;8416
231180;201804;13548;39903;11659;35765;2584;8037;4970;15162;7554;23199
231190;201804;3818;11130;3362;10295;155;629;2571;7597;2726;8226
231195;201804;4446;14461;3849;13180;234;1027;2792;9293;3026;10320
231200;201804;7760;25165;6773;23077;262;1282;5125;16927;5387;18209
231210;201804;4676;14474;4066;13398;201;841;3051;9787;3252;10628
231220;201804;11628;31648;9485;27495;558;1683;6825;19291;7383;20974
231230;201804;9000;29046;8085;27545;566;2216;5975;20433;6541;22649
231240;201804;11536;34939;10334;32489;1777;5616;5842;18555;7619;24171
231250;201804;1967;5309;1349;3890;99;293;778;2195;877;2488
231260;201804;3163;9447;2819;8881;320;961;1868;6029;2188;6990
231270;201804;6469;17329;5527;15799;173;711;4240;11835;4413;12546
231280;201804;1649;5271;1542;5059;142;492;1103;3600;1245;4092
231290;201804;35876;111734;31513;102647;5489;18500;14716;47504;20205;66004
231300;201804;3925;11315;3201;9815;265;865;2080;6260;2345;7125
231310;201804;7188;19753;5891;17134;656;1878;3706;10654;4362;12532
231320;201804;7340;21193;5896;18393;145;654;4552;13972;4697;14626
231325;201804;2518;7190;2135;6557;413;1235;1137;3576;1550;4811
231330;201804;10131;31642;8531;28311;1685;5507;4226;14402;5911;19909
231335;201804;5520;14968;4733;13616;103;471;4070;11471;4173;11942
231340;201804;17472;55435;15792;52589;1155;4078;11751;39361;12906;43439
231350;201804;15225;42747;13885;40876;338;1178;12424;36476;12762;37654
231355;201804;4494;13853;4027;13026;225;839;3068;9875;3293;10714
231360;201804;7377;22947;6451;21312;517;1774;4663;15505;5180;17279
231370;201804;2286;6217;1820;5393;44;138;1389;4083;1433;4221
231375;201804;4257;13758;3906;13104;139;633;3203;10593;3342;11226
231380;201804;5721;15952;5331;15462;185;451;4555;13499;4740;13950
231390;201804;3285;9971;2964;9420;182;700;2138;6617;2320;7317
231395;201804;3905;12026;3301;11003;620;2069;1777;6013;2397;8082
231400;201804;8897;26561;7999;24826;372;1480;6183;18817;6555;20297
231410;201804;14870;47123;13264;44459;841;3103;10212;33901;11053;37004
240010;201804;2495;6989;1946;5952;195;696;1197;3556;1392;4252
240020;201804;10885;32526;9540;29977;1034;3604;5968;18545;7002;22149
240030;201804;2579;6919;2461;6744;132;397;2137;5808;2269;6205
240040;201804;846;2430;702;2146;13;64;509;1495;522;1559
240050;201804;3264;8814;2701;7798;64;210;2112;5984;2176;6194
240060;201804;1373;3803;1178;3434;34;122;942;2686;976;2808
240070;201804;2195;6621;2021;6257;220;703;1462;4452;1682;5155
240080;201804;2756;7606;2366;6952;74;285;1815;5267;1889;5552
240090;201804;2195;5689;1816;5026;29;99;1468;3994;1497;4093
240100;201804;8690;22965;7207;20170;410;1260;5393;14661;5803;15921
240110;201804;4349;13151;3821;12143;321;1146;2556;8010;2877;9156
240120;201804;3231;9567;2591;8753;238;938;1688;5785;1926;6723
240130;201804;3206;7336;2762;6676;68;210;2458;5821;2526;6031
240140;201804;2110;6320;1786;5697;198;756;1139;3553;1337;4309
240145;201804;6062;17918;5192;16403;783;2637;3180;10149;3963;12786
240150;201804;864;2655;780;2475;55;204;591;1810;646;2014
240160;201804;1406;4347;1212;3972;76;309;853;2808;929;3117
240165;201804;886;2609;763;2359;82;237;535;1654;617;1891
240170;201804;2291;6642;1970;6056;233;798;1237;3677;1470;4475
240180;201804;2960;8814;2432;7758;451;1429;1348;4417;1799;5846
240185;201804;1262;4167;1141;3966;63;281;931;3214;994;3495
240190;201804;955;2963;849;2779;23;109;703;2268;726;2377
240200;201804;10831;29364;9138;26419;1407;4189;4402;12763;5809;16952
240210;201804;2814;7563;2529;7086;56;233;2132;5787;2188;6020
240220;201804;7154;23180;6504;22170;537;2266;4723;15976;5260;18242
240230;201804;5818;15080;4786;13357;254;685;3791;10589;4045;11274
240240;201804;1926;6259;1234;4482;143;485;427;1721;570;2206
240250;201804;2707;7665;2502;7369;157;418;2025;6004;2182;6422
240260;201804;12167;38750;11131;36934;1577;5257;6955;23748;8532;29005
240270;201804;2231;6775;2034;6467;127;355;1619;5252;1746;5607
240280;201804;1599;4244;1382;3921;48;138;1148;3212;1196;3350
240290;201804;1177;3553;989;3153;39;194;667;1970;706;2164
240300;201804;2209;5881;1621;4719;104;337;964;2711;1068;3048
240310;201804;9081;24770;7627;22284;929;2798;4142;12029;5071;14827
240320;201804;1963;5510;1489;4562;30;147;1132;3304;1162;3451
240325;201804;29035;81944;23160;71577;6185;19951;6497;21134;12682;41085
240330;201804;1493;4358;1230;3822;50;188;847;2531;897;2719
240340;201804;1944;4800;1564;4209;71;189;1211;3189;1282;3378
240350;201804;2024;5484;1877;5307;38;135;1659;4704;1697;4839
240360;201804;7161;21293;6385;20044;1235;3820;3556;11676;4791;15496
240370;201804;2021;5479;1573;4588;118;348;1015;2919;1133;3267
240375;201804;862;2260;754;2049;32;129;581;1491;613;1620
240380;201804;2291;6653;1668;5247;154;497;969;2990;1123;3487
240390;201804;932;2464;694;1969;7;17;486;1298;493;1315
240400;201804;1351;3711;1088;3201;30;108;782;2251;812;2359
240410;201804;523;1668;455;1513;47;187;294;950;341;1137
240420;201804;4582;17066;4189;16157;637;2958;2238;8427;2875;11385
240430;201804;3270;9024;2853;8205;215;737;2095;5812;2310;6549
240440;201804;2495;5882;2112;5349;196;494;1527;3808;1723;4302
240450;201804;4084;11687;3339;10271;371;1273;1985;5923;2356;7196
240460;201804;2980;8715;2760;8391;242;806;2186;6612;2428;7418
240470;201804;3607;11092;2838;9480;378;1267;1612;5410;1990;6677
240480;201804;547;1508;396;1210;36;114;190;577;226;691
240485;201804;2123;6318;1779;5627;187;587;1139;3647;1326;4234
240490;201804;1750;4388;1421;3826;39;83;1186;3205;1225;3288
240500;201804;2185;5960;1912;5575;54;191;1624;4695;1678;4886
240510;201804;1639;4548;1508;4358;106;339;1250;3523;1356;3862
240520;201804;1289;3401;1080;3110;34;141;909;2552;943;2693
240530;201804;1851;5930;1722;5682;109;409;1342;4358;1451;4767
240540;201804;2080;5494;1865;5174;62;189;1613;4445;1675;4634
240550;201804;681;1935;607;1794;33;104;465;1348;498;1452
240560;201804;3282;8882;2837;8289;298;744;2072;6205;2370;6949
240570;201804;2947;7893;2032;5843;273;839;921;2408;1194;3247
240580;201804;7521;22585;6916;21552;533;1791;5513;17111;6046;18902
240590;201804;698;1904;605;1736;18;63;462;1304;480;1367
240600;201804;1694;4709;1266;3822;93;320;795;2309;888;2629
240610;201804;4490;12570;3797;11284;219;713;2697;7876;2916;8589
240615;201804;1024;2948;824;2527;83;296;542;1584;625;1880
240620;201804;1821;5279;1569;4826;111;317;1254;3840;1365;4157
240630;201804;2031;6017;1829;5667;145;385;1258;3997;1403;4382
240640;201804;873;2468;721;2214;45;194;503;1477;548;1671
240650;201804;3901;11147;3485;10460;180;554;2746;8196;2926;8750
240660;201804;2478;7232;2305;6984;71;295;2033;6032;2104;6327
240670;201804;2444;7134;2036;6279;182;630;1283;3824;1465;4454
240680;201804;1575;4382;1265;3823;53;202;928;2708;981;2910
240690;201804;899;2343;716;2017;23;84;573;1558;596;1642
240700;201804;2416;7121;2004;6355;70;304;1561;4817;1631;5121
240710;201804;15509;42282;13511;38717;2572;7198;7301;21338;9873;28536
240720;201804;5232;13923;4569;12846;684;2005;2795;7683;3479;9688
240725;201804;1020;3056;804;2563;34;113;536;1668;570;1781
240730;201804;2104;6059;1778;5414;106;342;1340;4012;1446;4354
240740;201804;1870;5183;1575;4626;59;258;1158;3210;1217;3468
240750;201804;2154;7586;1900;7059;346;1379;990;3713;1336;5092
240760;201804;1452;3693;1036;3034;61;163;787;2324;848;2487
240770;201804;3039;8689;2690;8190;124;474;2233;6669;2357;7143
240780;201804;5619;15339;4476;13442;551;1653;2652;8173;3203;9826
240790;201804;828;2446;696;2176;23;89;539;1669;562;1758
240800;201804;36027;97814;30741;89176;4889;14796;14633;42551;19522;57347
240810;201804;79631;222004;71145;207122;15785;45763;34864;102972;50649;148735
240820;201804;5360;16849;4721;15746;922;3116;2492;8628;3414;11744
240830;201804;8624;25678;7937;24619;326;1377;6518;19846;6844;21223
240840;201804;1133;3002;936;2648;84;241;637;1744;721;1985
240850;201804;1270;3643;924;2858;63;201;518;1584;581;1785
240860;201804;1227;3422;953;2898;23;100;719;2080;742;2180
240870;201804;1145;2979;898;2555;70;212;602;1675;672;1887
240880;201804;1269;4061;1182;3896;76;266;956;3138;1032;3404
240890;201804;4643;12989;3646;11020;618;1972;1705;5037;2323;7009
240895;201804;2622;8781;2402;8422;218;800;1872;6604;2090;7404
240910;201804;3077;8868;2656;8014;61;231;2178;6477;2239;6708
240920;201804;809;2494;690;2254;77;270;374;1215;451;1485
240930;201804;3557;8647;3045;8012;108;195;2434;6555;2542;6750
240933;201804;1812;4468;1508;3992;48;176;1242;3210;1290;3386
240940;201804;6245;15764;4968;13629;318;947;3565;9504;3883;10451
240950;201804;914;2891;819;2695;34;142;634;2044;668;2186
240960;201804;775;2370;674;2167;44;161;489;1536;533;1697
240970;201804;1765;4811;1481;4272;56;215;1202;3340;1258;3555
240980;201804;2893;9236;2634;8753;257;964;1897;6226;2154;7190
240990;201804;2521;7465;2320;7045;294;957;1617;4820;1911;5777
241000;201804;943;2546;777;2229;35;105;546;1550;581;1655
241010;201804;2664;8826;2496;8483;242;993;1801;5946;2043;6939
241020;201804;2035;5537;1514;4471;172;454;897;2639;1069;3093
241025;201804;1720;5065;1426;4509;79;279;954;3002;1033;3281
241030;201804;2419;7788;2032;6972;197;704;1350;4627;1547;5331
241040;201804;2254;7301;2019;6903;121;547;1573;5342;1694;5889
241050;201804;1265;3622;1058;3234;46;155;770;2293;816;2448
241060;201804;740;2113;654;1942;52;159;445;1307;497;1466
241070;201804;653;1824;571;1681;32;122;451;1263;483;1385
241080;201804;1109;3202;859;2700;15;74;636;1958;651;2032
241090;201804;1991;5921;1624;5266;57;281;1272;4059;1329;4340
241100;201804;1101;3231;922;2824;41;137;641;1898;682;2035
241105;201804;1084;3281;906;2951;262;857;326;1085;588;1942
241110;201804;856;2565;671;2144;30;116;446;1369;476;1485
241120;201804;7159;21163;6288;19611;1323;3905;3252;10781;4575;14686
241140;201804;3238;8642;2684;7544;156;443;1980;5424;2136;5867
241142;201804;748;2089;562;1708;39;135;339;994;378;1129
241150;201804;5523;15452;4927;14450;203;789;3891;11123;4094;11912
241160;201804;1558;4756;1373;4451;154;422;994;3306;1148;3728
241170;201804;1242;3315;1106;3077;51;170;899;2405;950;2575
241180;201804;967;2604;712;2090;65;180;402;1171;467;1351
241190;201804;1115;3011;904;2578;28;107;656;1785;684;1892
241200;201804;18205;50177;15770;46445;3320;9958;7622;22922;10942;32880
241210;201804;1395;3855;1067;3194;98;309;640;1889;738;2198
241220;201804;8224;25832;7295;24153;2142;7123;2991;10391;5133;17514
241230;201804;2911;8065;2630;7598;103;386;2189;6150;2292;6536
241240;201804;1174;3424;697;2281;48;190;345;1125;393;1315
241250;201804;5675;17110;4664;15136;206;1002;3417;10619;3623;11621
241255;201804;1863;6448;1656;5978;167;720;1105;3896;1272;4616
241260;201804;4812;12984;3846;11344;96;427;2926;8419;3022;8846
241270;201804;1775;5304;1522;4800;126;473;1087;3362;1213;3835
241280;201804;1921;5241;1719;4879;86;262;1418;3981;1504;4243
241290;201804;3223;8327;2526;7162;89;329;1976;5452;2065;5781
241300;201804;1439;4017;1202;3571;39;131;815;2363;854;2494
241310;201804;1855;5057;1644;4710;49;153;1401;3979;1450;4132
241320;201804;942;3144;809;2855;101;397;494;1721;595;2118
241330;201804;1611;4416;1348;4086;45;178;1161;3501;1206;3679
241335;201804;2926;8480;2646;7969;93;327;2230;6620;2323;6947
241340;201804;1708;5102;1370;4329;282;915;594;1840;876;2755
241350;201804;1880;5705;1684;5335;98;358;1269;3937;1367;4295
241355;201804;1318;3671;1074;3213;34;140;827;2445;861;2585
241360;201804;2077;5440;1653;4616;73;223;1192;3226;1265;3449
241370;201804;1348;3865;1068;3300;77;274;706;2074;783;2348
241380;201804;662;1828;531;1569;60;181;326;940;386;1121
241390;201804;2630;8276;2426;7933;192;661;1867;6110;2059;6771
241400;201804;3578;10136;3209;9597;218;708;2538;7540;2756;8248
241410;201804;2327;7043;2001;6449;405;1359;1062;3430;1467;4789
241415;201804;1604;4809;1362;4356;107;367;992;3119;1099;3486
241420;201804;2064;7088;1830;6640;512;1954;661;2431;1173;4385
241430;201804;511;1487;390;1224;34;116;243;739;277;855
241440;201804;6873;22866;6210;21657;491;2007;4665;16108;5156;18115
241445;201804;1012;2766;938;2677;21;57;856;2487;877;2544
241450;201804;2846;7344;2529;6871;282;698;1840;5044;2122;5742
241460;201804;3508;9884;2988;8772;198;669;2099;5980;2297;6649
241470;201804;1383;3727;1126;3349;46;165;902;2660;948;2825
241475;201804;1212;3562;969;3076;31;172;700;2113;731;2285
241480;201804;2630;8577;2331;7972;852;2902;634;2512;1486;5414
241490;201804;701;1771;557;1547;28;89;360;955;388;1044
241500;201804;792;2390;668;2228;15;64;576;1911;591;1975
250010;201804;2711;8268;2245;7251;78;333;1629;5112;1707;5445
250020;201804;1562;4350;1159;3558;55;162;815;2452;870;2614
250030;201804;6771;19057;6115;18077;342;1142;4916;14253;5258;15395
250040;201804;3848;12471;3483;11733;285;1087;2475;8216;2760;9303
250050;201804;3367;9856;3105;9456;236;820;2406;7210;2642;8030
250053;201804;1196;3524;1083;3349;84;282;786;2424;870;2706
250057;201804;662;2467;637;2434;3;10;607;2356;610;2366
250060;201804;5097;14334;4675;13772;389;1159;3684;10940;4073;12099
250070;201804;3820;11335;3483;10708;61;308;2676;7946;2737;8254
250073;201804;770;2183;643;1974;11;44;497;1470;508;1514
250077;201804;2192;6106;1661;5195;100;335;1190;3688;1290;4023
250080;201804;4282;11702;3909;11156;119;430;3319;9301;3438;9731
250090;201804;2751;7317;2525;6973;110;278;2119;5819;2229;6097
250100;201804;3737;11747;3463;11241;165;682;2841;8984;3006;9666
250110;201804;4713;13673;4359;13142;394;1409;3403;9983;3797;11392
250115;201804;517;1537;456;1434;13;68;335;1020;348;1088
250120;201804;1687;5221;1480;4860;53;239;1170;3811;1223;4050
250130;201804;5331;15689;4609;14523;113;618;3710;11454;3823;12072
250135;201804;1085;3150;995;3002;15;60;862;2586;877;2646
250140;201804;2045;6458;1972;6342;84;389;1686;5339;1770;5728
250150;201804;4692;15465;4300;14697;173;888;3382;11241;3555;12129
250153;201804;1471;3839;1224;3484;33;131;988;2760;1021;2891
250157;201804;1779;5511;1602;5141;163;507;1146;3686;1309;4193
250160;201804;3755;9854;3077;8923;45;159;2801;8103;2846;8262
250170;201804;1672;4587;1490;4312;54;198;1248;3562;1302;3760
250180;201804;16679;45221;15061;42955;952;3147;11364;31685;12316;34832
250190;201804;4009;11297;3555;10542;472;1317;2357;6982;2829;8299
250200;201804;1841;5314;1553;4851;51;189;1299;4028;1350;4217
250205;201804;769;2630;725;2541;22;122;587;2034;609;2156
250210;201804;1506;4686;1375;4466;44;219;1090;3454;1134;3673
250215;201804;1476;4322;1259;3974;63;216;795;2501;858;2717
250220;201804;696;2006;566;1807;26;90;419;1317;445;1407
250230;201804;1617;3871;1208;3223;30;104;960;2469;990;2573
250240;201804;2140;6830;1967;6520;51;209;1654;5406;1705;5615
250250;201804;4417;12847;3921;12128;111;396;3255;10034;3366;10430
250260;201804;1670;4784;1423;4353;40;136;1133;3460;1173;3596
250270;201804;1225;3751;1086;3579;73;241;807;2781;880;3022
250280;201804;3249;9493;2831;8811;126;446;2239;6933;2365;7379
250290;201804;1683;4522;1433;4174;21;57;1194;3474;1215;3531
250300;201804;5237;14878;4925;14489;237;1004;4150;11836;4387;12840
250310;201804;1081;3198;945;2946;31;120;733;2221;764;2341
250320;201804;9292;25100;8447;24006;580;1784;6886;19389;7466;21173
250330;201804;2356;6983;1994;6449;130;437;1551;4964;1681;5401
250340;201804;1079;2983;958;2800;13;50;824;2368;837;2418
250350;201804;4067;11286;3690;10772;150;374;3149;9329;3299;9703
250355;201804;1930;6024;1771;5815;24;131;1612;5270;1636;5401
250360;201804;1784;5122;1654;4907;45;145;1362;4032;1407;4177
250370;201804;11768;32683;10247;30619;460;1666;8468;25008;8928;26674
250375;201804;1046;2992;929;2831;17;64;832;2553;849;2617
250380;201804;1619;4395;1505;4246;49;187;1241;3370;1290;3557
250390;201804;1800;4760;1491;4252;184;504;992;2847;1176;3351
250400;201804;67965;175433;50290;146949;13261;40479;16340;49126;29601;89605
250403;201804;1587;4899;1452;4729;139;600;1030;3241;1169;3841
250407;201804;1199;3188;1022;2923;77;163;746;2153;823;2316
250410;201804;561;1653;493;1530;10;54;407;1223;417;1277
250415;201804;1877;5467;1671;5115;66;228;1322;4033;1388;4261
250420;201804;1214;3520;1102;3362;21;83;1012;3082;1033;3165
250430;201804;6112;15759;5366;14672;179;573;4403;11764;4582;12337
250435;201804;1360;4014;1201;3738;39;160;927;2832;966;2992
250440;201804;4415;12290;3943;11643;93;345;3377;9866;3470;10211
250450;201804;1830;5064;1555;4687;41;158;1282;3806;1323;3964
250460;201804;6719;19176;6196;18485;334;1045;5296;15859;5630;16904
250470;201804;1503;3954;1237;3566;64;218;924;2585;988;2803
250480;201804;3674;10759;3355;10349;42;183;3038;9420;3080;9603
250485;201804;694;1625;502;1352;26;69;384;997;410;1066
250490;201804;4273;11733;3930;11308;250;849;3236;9197;3486;10046
250500;201804;1897;5436;1685;5077;85;269;1357;4074;1442;4343
250510;201804;5178;13594;4523;12711;78;232;4045;11398;4123;11630
250520;201804;1794;5084;1572;4752;174;578;1037;3073;1211;3651
250523;201804;2018;5296;1856;5093;73;314;1609;4280;1682;4594
250527;201804;1603;4366;1483;4218;38;130;1344;3802;1382;3932
250530;201804;594;1722;518;1613;19;71;451;1392;470;1463
250535;201804;1323;4021;1220;3827;39;185;972;2966;1011;3151
250540;201804;2592;6608;2223;6181;56;159;1955;5431;2011;5590
250550;201804;832;2756;755;2624;28;137;602;2036;630;2173
250560;201804;1617;4765;1488;4572;47;181;1222;3652;1269;3833
250570;201804;2512;7752;2200;7176;77;352;1747;5542;1824;5894
250580;201804;1053;2751;946;2601;51;185;781;2106;832;2291
250590;201804;819;2414;731;2277;20;98;608;1835;628;1933
250600;201804;7214;20208;6556;19209;369;985;5432;16010;5801;16995
250610;201804;2949;8509;2707;8145;146;511;2224;6628;2370;7139
250620;201804;695;1972;609;1802;27;107;465;1343;492;1450
250625;201804;2493;7475;2301;7178;54;239;1969;6006;2023;6245
250630;201804;9486;27741;8163;25243;1130;3648;4985;15037;6115;18685
250640;201804;3306;9782;3080;9468;101;458;2595;7794;2696;8252
250650;201804;886;2265;743;2072;33;109;601;1618;634;1727
250660;201804;1655;4253;1481;4017;43;113;1297;3487;1340;3600
250670;201804;2267;7282;2138;7057;49;258;1854;5976;1903;6234
250680;201804;5374;13328;4933;12829;128;422;4496;11523;4624;11945
250690;201804;6369;15351;5792;14615;164;388;5242;13153;5406;13541
250700;201804;4264;12371;3837;11684;360;1137;2867;8636;3227;9773
250710;201804;4464;13157;3887;12374;325;1161;2802;8938;3127;10099
250720;201804;2702;7332;2459;6955;45;200;2208;6170;2253;6370
250730;201804;3779;10470;3380;9938;164;591;2827;8102;2991;8693
250740;201804;1917;5146;1604;4694;130;422;1254;3576;1384;3998
250750;201804;95245;254826;84507;239085;8390;25825;57713;160023;66103;185848
250760;201804;2303;6178;2015;5724;121;363;1577;4385;1698;4748
250770;201804;3747;11974;3429;11554;274;1072;2518;8410;2792;9482
250780;201804;1708;4802;1440;4295;113;381;1019;2966;1132;3347
250790;201804;2330;7258;2109;6906;309;1059;1328;4388;1637;5447
250800;201804;2476;6775;2129;6202;100;235;1733;5067;1833;5302
250810;201804;1262;3545;1053;3231;34;120;862;2645;896;2765
250820;201804;1771;5507;1712;5433;64;265;1534;4820;1598;5085
250830;201804;5248;16423;4704;15309;343;1344;3344;10640;3687;11984
250840;201804;839;2706;725;2462;17;76;509;1740;526;1816
250850;201804;1869;5630;1667;5288;44;246;1373;4218;1417;4464
250855;201804;1015;3002;874;2753;50;201;649;1991;699;2192
250860;201804;3152;9790;2614;8824;464;1669;1341;4560;1805;6229
250870;201804;1058;2960;902;2666;33;119;732;2136;765;2255
250880;201804;1521;4074;1256;3679;148;431;841;2502;989;2933
250890;201804;9290;26450;8694;25621;635;2454;6966;19834;7601;22288
250900;201804;2711;8205;2355;7520;88;313;1917;6011;2005;6324
250905;201804;2156;6398;2040;6238;72;280;1815;5497;1887;5777
250910;201804;5269;14299;4632;13469;119;454;3950;11465;4069;11919
250915;201804;1794;4602;1388;4181;18;38;1291;3968;1309;4006
250920;201804;3115;8620;2886;8245;319;865;2108;5967;2427;6832
250930;201804;2099;5909;1947;5688;88;342;1632;4662;1720;5004
250933;201804;1109;3512;982;3262;37;184;723;2315;760;2499
250937;201804;690;1975;575;1764;31;111;430;1305;461;1416
250939;201804;1667;4640;1461;4324;50;204;1173;3374;1223;3578
250940;201804;3736;10686;3447;10226;54;221;3042;9015;3096;9236
250950;201804;1487;4091;1246;3776;32;142;1089;3273;1121;3415
250960;201804;1045;3210;956;3064;37;162;767;2385;804;2547
250970;201804;8344;22468;7163;20524;441;1432;5365;15105;5806;16537
250980;201804;2506;7006;2273;6578;58;236;1852;5199;1910;5435
250990;201804;1871;6096;1636;5589;89;413;1219;4061;1308;4474
251000;201804;2072;5912;1724;5355;35;157;1431;4400;1466;4557
251010;201804;2573;7502;2323;7104;31;124;2099;6423;2130;6547
251020;201804;1661;4540;1543;4394;44;135;1423;4043;1467;4178
251030;201804;1003;2773;869;2507;40;131;618;1726;658;1857
251040;201804;1785;5339;1553;4941;59;283;1244;3849;1303;4132
251050;201804;1108;3087;908;2702;77;250;648;1850;725;2100
251060;201804;1045;2312;763;1942;11;52;616;1520;627;1572
251065;201804;446;1264;366;1154;19;75;253;740;272;815
251070;201804;732;2099;639;1975;15;58;543;1662;558;1720
251080;201804;18865;50175;15737;45469;2346;7084;9237;26914;11583;33998
251090;201804;2798;8303;2390;7515;80;300;1858;5768;1938;6068
251100;201804;853;2672;757;2503;31;161;542;1704;573;1865
251110;201804;1720;4836;1493;4396;51;144;1145;3340;1196;3484
251120;201804;6621;20507;5916;19493;327;1382;4536;14790;4863;16172
251130;201804;3611;8915;3300;8566;243;650;2914;7555;3157;8205
251140;201804;4240;12275;3874;11742;104;422;3217;9670;3321;10092
251150;201804;2671;8036;2432;7666;131;550;1933;5937;2064;6487
251160;201804;1960;6171;1793;5904;89;297;1529;5059;1618;5356
251170;201804;1500;4309;1367;4157;40;140;1225;3720;1265;3860
251180;201804;2523;7219;2177;6714;199;685;1442;4404;1641;5089
251190;201804;4401;11764;4130;11437;67;279;3758;10195;3825;10474
251200;201804;4034;12597;3747;12233;83;350;3337;10933;3420;11283
251203;201804;945;3118;900;3024;35;157;683;2232;718;2389
251207;201804;1020;3048;832;2697;29;150;575;1803;604;1953
251210;201804;7242;19651;6105;18194;301;900;4871;14636;5172;15536
251220;201804;1119;2872;912;2586;47;122;716;2051;763;2173
251230;201804;4599;12767;4070;12026;161;571;3392;9809;3553;10380
251240;201804;3411;9790;2929;9087;182;611;2190;6657;2372;7268
251250;201804;9758;27578;8832;26184;815;2613;6332;18243;7147;20856
251260;201804;454;1423;413;1344;14;59;317;1017;331;1076
251270;201804;4060;13026;3657;12509;113;518;3146;10770;3259;11288
251272;201804;1302;3633;1211;3502;39;149;1077;3086;1116;3235
251274;201804;894;2626;735;2339;43;176;514;1565;557;1741
251275;201804;1216;3494;1072;3251;44;181;799;2319;843;2500
251276;201804;1221;3417;1119;3283;47;203;922;2627;969;2830
251278;201804;562;1661;502;1545;49;150;352;1093;401;1243
251280;201804;2212;6320;2007;5991;49;222;1628;4704;1677;4926
251290;201804;5480;14399;5163;13996;302;1083;4308;11268;4610;12351
251300;201804;767;2426;718;2346;14;61;603;1960;617;2021
251310;201804;2763;8099;2519;7722;78;367;2030;6067;2108;6434
251315;201804;1607;5223;1495;5029;85;305;1177;3916;1262;4221
251320;201804;1694;4559;1208;3735;48;170;850;2620;898;2790
251330;201804;1876;4704;1544;4295;36;139;1401;3879;1437;4018
251335;201804;1132;3832;1041;3688;41;185;857;2988;898;3173
251340;201804;3438;9245;2872;8492;125;446;2188;6374;2313;6820
251350;201804;1082;3329;999;3190;32;139;818;2534;850;2673
251360;201804;1769;5269;1466;4850;23;110;1258;4181;1281;4291
251365;201804;725;2101;582;1793;14;53;452;1381;466;1434
251370;201804;22165;64575;20855;62747;2124;6841;15100;45088;17224;51929
251380;201804;1215;3643;1071;3399;21;99;908;2780;929;2879
251385;201804;720;1879;566;1608;22;68;417;1121;439;1189
251390;201804;5993;18916;5240;17502;945;3337;2828;9340;3773;12677
251392;201804;971;2785;832;2548;31;135;622;1853;653;1988
251394;201804;616;1958;531;1806;25;105;409;1375;434;1480
251396;201804;715;1989;617;1826;34;91;421;1226;455;1317
251398;201804;892;2412;678;2037;22;92;483;1396;505;1488
251400;201804;1140;3046;941;2772;34;125;706;2007;740;2132
251410;201804;1613;3936;1326;3508;23;89;1109;2848;1132;2937
251420;201804;1858;5132;1559;4784;59;244;1232;3682;1291;3926
251430;201804;1519;4923;1362;4662;42;211;1185;3993;1227;4204
251440;201804;1094;3233;897;2843;18;65;717;2271;735;2336
251445;201804;1495;4417;1400;4286;74;301;1137;3377;1211;3678
251450;201804;4369;13342;3986;12808;75;340;3331;10598;3406;10938
251455;201804;974;3027;879;2840;48;205;653;2066;701;2271
251460;201804;865;2558;776;2414;29;103;639;2009;668;2112
251465;201804;438;1348;368;1193;15;71;278;882;293;953
251470;201804;1153;3262;888;2698;79;240;548;1623;627;1863
251480;201804;916;2506;787;2296;22;99;588;1653;610;1752
251490;201804;1819;5094;1510;4644;98;322;1029;3126;1127;3448
251500;201804;1741;5350;1644;5177;75;306;1402;4344;1477;4650
251510;201804;2403;7790;2150;7245;190;739;1401;4612;1591;5351
251520;201804;943;2557;724;2108;79;222;458;1311;537;1533
251530;201804;12895;33148;11315;31094;157;759;10068;27189;10225;27948
251540;201804;2750;8449;2543;8058;118;438;2035;6325;2153;6763
251550;201804;3519;8811;2844;7933;72;226;2387;6637;2459;6863
251560;201804;594;1819;534;1725;88;302;323;1003;411;1305
251570;201804;892;2608;742;2302;17;73;554;1654;571;1727
251580;201804;1853;4766;1647;4480;116;328;1332;3545;1448;3873
251590;201804;1572;4259;1392;4028;55;183;1123;3184;1178;3367
251593;201804;938;2813;860;2692;99;326;529;1614;628;1940
251597;201804;1978;5840;1875;5706;24;90;1708;5148;1732;5238
251600;201804;6318;17783;5691;16819;200;649;4736;13808;4936;14457
251610;201804;3305;9562;2862;8743;313;904;1936;5979;2249;6883
251615;201804;1142;3072;924;2699;26;104;702;1979;728;2083
251620;201804;17005;41582;14046;38087;238;551;11866;33624;12104;34175
251630;201804;4599;11353;3745;10160;217;616;2840;7639;3057;8255
251640;201804;2063;6102;1883;5752;66;287;1600;4777;1666;5064
251650;201804;4074;11103;3636;10537;171;569;3082;8874;3253;9443
251660;201804;3435;10603;3042;9893;82;401;2521;8004;2603;8405
251670;201804;4209;12110;3743;11473;42;207;3438;10527;3480;10734
251675;201804;654;1983;600;1908;93;325;384;1202;477;1527
251680;201804;2663;7456;2178;6735;50;183;1760;5418;1810;5601
251690;201804;3250;9443;2842;8660;77;272;2087;6217;2164;6489
251700;201804;1851;5839;1723;5665;66;312;1447;4643;1513;4955
251710;201804;831;2189;561;1612;53;187;299;817;352;1004
251720;201804;1361;3988;1139;3573;31;137;872;2642;903;2779
251740;201804;666;1863;519;1601;36;128;357;1058;393;1186
260005;201804;27217;61224;22359;54709;2395;5877;15547;37622;17942;43499
260010;201804;9672;25818;8060;23440;543;1625;4982;14766;5525;16391
260020;201804;6619;16421;5587;14913;138;566;4589;12020;4727;12586
260030;201804;6193;16909;5323;15533;237;810;4198;12203;4435;13013
260040;201804;7926;22015;6684;20109;663;1992;4543;13809;5206;15801
260050;201804;11997;34368;10952;33119;403;1301;9478;29148;9881;30449
260060;201804;3836;10322;3317;9446;239;650;2509;7178;2748;7828
260070;201804;10045;27228;8822;25347;633;2106;6514;18370;7147;20476
260080;201804;6528;15606;5673;14351;185;553;4643;11457;4828;12010
260090;201804;5105;13376;4604;12714;609;1642;3292;9196;3901;10838
260100;201804;3195;8629;2699;7909;101;377;2204;6416;2305;6793
260105;201804;5244;14110;4693;13330;141;561;3928;10905;4069;11466
260110;201804;22209;59682;20145;56937;1064;3242;17065;47905;18129;51147
260120;201804;13541;38130;11676;35104;1717;5263;7046;21669;8763;26932
260130;201804;3047;8274;2773;7847;231;721;2051;5675;2282;6396
260140;201804;12673;30402;10956;28226;582;1587;9063;23293;9645;24880
260150;201804;3353;8474;2897;7915;144;481;2433;6526;2577;7007
260160;201804;6097;17291;5226;16129;131;552;4505;13980;4636;14532
260170;201804;17245;45639;15406;42983;1516;4050;11489;32301;13005;36351
260180;201804;3261;9427;2957;8975;146;513;2492;7477;2638;7990
260190;201804;16969;36934;14882;34448;223;663;13004;29571;13227;30234
260200;201804;11020;27313;9672;25619;381;1093;8438;22262;8819;23355
260210;201804;11911;34547;10208;31770;359;1421;8206;25439;8565;26860
260220;201804;9855;25544;9297;24847;241;823;8381;22110;8622;22933
260230;201804;9978;26496;8786;24811;331;1108;7065;19734;7396;20842
260240;201804;2769;8309;2428;7755;199;674;1830;5839;2029;6513
260250;201804;2163;5935;1875;5515;79;269;1487;4277;1566;4546
260260;201804;12375;33943;10890;31653;498;1812;8509;24300;9007;26112
260270;201804;3597;9958;3261;9475;161;717;2534;7101;2695;7818
260280;201804;12882;40118;11759;38504;534;2037;10037;32779;10571;34816
260290;201804;36646;100362;32348;93619;4306;12957;20349;58305;24655;71262
260300;201804;9077;26087;8008;24520;269;1176;6499;19796;6768;20972
260310;201804;4468;12449;3998;11774;483;1334;2836;8551;3319;9885
260320;201804;7360;22098;6587;20735;273;926;5359;16802;5632;17728
260330;201804;2490;7856;2260;7388;72;263;1806;5782;1878;6045
260340;201804;1968;5458;1734;5112;28;126;1519;4424;1547;4550
260345;201804;23486;66065;20499;61332;4237;13481;9126;26580;13363;40061
260350;201804;4933;12724;4460;12099;132;440;3886;10424;4018;10864
260360;201804;2499;6799;2274;6394;76;332;1557;4289;1633;4621
260370;201804;5409;16134;4744;14966;229;911;3628;11293;3857;12204
260380;201804;4816;14991;4206;13982;210;819;3120;10257;3330;11076
260390;201804;4187;13034;3599;11826;235;855;2453;7910;2688;8765
260392;201804;3388;10987;3058;10548;151;822;2529;8596;2680;9418
260400;201804;15005;38469;13380;36220;958;2886;10091;26678;11049;29564
260410;201804;61178;162622;49907;145972;10842;33579;21419;64059;32261;97638
260415;201804;3821;11123;3308;10136;123;551;2442;7219;2565;7770
260420;201804;12745;27880;10980;25878;203;605;9906;23138;10109;23743
260430;201804;2865;8942;2468;8182;130;502;1743;5713;1873;6215
260440;201804;3532;9890;3073;9064;168;625;2347;6729;2515;7354
260450;201804;5368;14316;4934;13769;196;542;4234;11903;4430;12445
260460;201804;5335;16821;4676;15522;613;2265;2695;8757;3308;11022
260470;201804;4863;13206;4178;12419;155;413;3667;11187;3822;11600
260480;201804;4127;11175;3490;10241;353;1171;2300;6856;2653;8027
260490;201804;5125;12645;4487;11577;103;366;3889;9764;3992;10130
260500;201804;5926;15792;5019;14439;533;1483;3357;9792;3890;11275
260510;201804;9195;23076;7910;21333;204;691;7002;18689;7206;19380
260515;201804;4397;12712;3382;10721;151;549;2228;6930;2379;7479
260520;201804;17260;41818;15530;39482;993;2614;12540;31551;13533;34165
260530;201804;9317;27876;8127;25971;224;1013;6897;21839;7121;22852
260540;201804;6476;15028;5793;14208;505;1039;4849;12157;5354;13196
260545;201804;46;140;23;93;5;19;5;21;10;40
260550;201804;2841;8596;2370;7651;190;789;1454;4593;1644;5382
260560;201804;6041;15778;5229;14633;141;575;4446;12240;4587;12815
260570;201804;7123;21017;6415;19990;532;1760;5011;15579;5543;17339
260580;201804;4094;10504;3664;9873;42;179;3322;8853;3364;9032
260590;201804;6649;15973;5716;14916;261;717;4829;12650;5090;13367
260600;201804;29455;80484;24629;72875;1353;4677;18091;52780;19444;57457
260610;201804;6572;18550;6080;17848;485;1535;4572;13293;5057;14828
260620;201804;14599;41926;13445;40110;1824;5941;8687;25418;10511;31359
260630;201804;2345;6421;1953;5802;47;203;1618;4764;1665;4967
260640;201804;18908;46775;16409;43785;1085;3162;12629;33416;13714;36578
260650;201804;5443;15929;4656;14709;187;811;3866;12082;4053;12893
260660;201804;7372;19863;6418;18632;173;736;5446;15549;5619;16285
260670;201804;2244;5893;1844;5305;90;240;1331;3809;1421;4049
260680;201804;23800;61543;20216;56008;2417;6876;12009;32930;14426;39806
260690;201804;3599;9503;2997;8552;118;388;2400;6786;2518;7174
260700;201804;5781;17286;5559;17029;24;54;5415;16758;5439;16812
260710;201804;1327;3611;1245;3504;60;201;905;2608;965;2809
260720;201804;19950;56798;17855;53577;2930;8990;10625;31716;13555;40706
260730;201804;7034;21578;6295;20496;374;1445;5103;16330;5477;17775
260740;201804;1321;3795;1141;3497;19;72;931;2866;950;2938
260750;201804;6857;19595;5961;18426;140;436;5375;16850;5515;17286
260760;201804;5293;13181;4645;12370;214;638;3760;10084;3974;10722
260765;201804;7542;23828;6785;22680;750;3092;4527;14703;5277;17795
260770;201804;3753;9984;3277;9185;103;339;2591;7186;2694;7525
260775;201804;5000;13985;4554;13326;277;1051;3409;9673;3686;10724
260780;201804;3658;11174;3308;10571;399;1426;2096;6545;2495;7971
260790;201804;110890;263517;95150;241864;16435;41466;55265;140029;71700;181495
260795;201804;3085;8535;2687;7933;146;479;2017;5979;2163;6458
260800;201804;5409;12941;4930;12249;128;415;4395;10573;4523;10988
260805;201804;3592;10642;3039;9675;217;787;2133;6699;2350;7486
260810;201804;6491;18130;5912;17041;574;1663;4266;12107;4840;13770
260820;201804;4265;10893;3788;10202;274;961;2846;7393;3120;8354
260825;201804;2835;8814;2490;8202;147;564;1823;5972;1970;6536
260830;201804;4204;12489;3528;11226;468;1375;2298;7515;2766;8890
260840;201804;4151;11481;3673;10769;189;561;3009;8774;3198;9335
260845;201804;4036;11253;3738;10718;277;806;2772;7903;3049;8709
260850;201804;4896;14705;4247;13365;515;1681;2475;7652;2990;9333
260860;201804;3534;10278;2984;9255;111;422;2363;7197;2474;7619
260870;201804;4378;11048;3798;10314;126;474;3290;8754;3416;9228
260875;201804;6412;17349;5474;15856;762;2177;3490;10244;4252;12421
260880;201804;9716;27898;8558;25931;414;1297;6839;20840;7253;22137
260890;201804;13140;35785;11852;33863;853;2771;8582;24050;9435;26821
260900;201804;5334;16055;4571;14700;310;1194;3071;9700;3381;10894
260910;201804;3097;8896;2750;8326;116;414;2113;6330;2229;6744
260915;201804;4950;15094;4434;14463;74;310;4015;13160;4089;13470
260920;201804;3255;9317;2927;8893;117;373;2468;7584;2585;7957
260930;201804;3580;11724;3189;11033;211;817;2394;8269;2605;9086
260940;201804;14308;35786;12641;33276;987;2852;9232;23815;10219;26667
260950;201804;6426;18789;5243;16475;666;2268;2681;8027;3347;10295
260960;201804;61031;150286;50703;135562;7582;21429;28592;75187;36174;96616
260970;201804;5042;14265;4542;13604;184;544;3557;10787;3741;11331
260980;201804;4233;13059;3873;12597;72;291;3512;11457;3584;11748
260990;201804;17214;50389;15077;47440;941;3348;11615;36429;12556;39777
261000;201804;15196;39181;12958;35999;808;2597;9316;25845;10124;28442
261010;201804;2476;6653;2210;6309;79;200;1971;5645;2050;5845
261020;201804;6388;18189;5521;16553;385;1257;4190;12259;4575;13516
261030;201804;4004;11469;3490;10631;216;625;2721;8285;2937;8910
261040;201804;5056;15732;4232;13989;268;1029;3014;9754;3282;10783
261050;201804;7429;20650;6759;19501;627;1712;4609;13366;5236;15078
261060;201804;12841;34657;11505;32715;706;2192;9046;25497;9752;27689
261070;201804;55173;126966;46466;115051;3807;9200;33413;82030;37220;91230
261080;201804;5815;15659;5468;15166;199;558;4926;13705;5125;14263
261090;201804;16858;43573;15309;41500;481;1587;13071;35130;13552;36717
261100;201804;7958;23787;6994;22216;725;2450;4760;15279;5485;17729
261110;201804;58793;172001;50825;158960;11264;36901;23773;75416;35037;112317
261120;201804;3762;9713;3267;9093;68;233;2924;8153;2992;8386
261130;201804;7509;18423;6659;17364;148;440;5898;15292;6046;15732
261140;201804;3352;8436;3012;7956;238;675;2317;6037;2555;6712
261150;201804;5263;14475;4667;13537;145;534;3977;11397;4122;11931
261153;201804;1949;5858;1674;5404;85;334;1145;3666;1230;4000
261160;201804;201741;498293;171612;455537;42634;117158;68527;185602;111161;302760
261170;201804;5784;15382;5254;14605;323;885;4178;11603;4501;12488
261180;201804;9843;25906;8833;24542;646;1995;6284;17268;6930;19263
261190;201804;4885;14818;4439;14142;351;1411;3218;9974;3569;11385
261200;201804;3331;7991;2935;7490;208;554;2366;5974;2574;6528
261210;201804;1889;4739;1641;4383;57;162;1433;3815;1490;3977
261220;201804;13560;40127;11319;35739;1532;5268;6353;19889;7885;25157
261230;201804;4588;13472;3895;12594;85;357;3278;10713;3363;11070
261240;201804;4941;13404;4373;12506;302;858;3460;9879;3762;10737
261245;201804;3449;10265;2967;9409;117;538;2337;7157;2454;7695
261247;201804;2948;9002;2508;8194;150;588;1797;5825;1947;6413
261250;201804;19259;47647;16836;44702;2625;6661;11165;30721;13790;37382
261255;201804;3963;12063;3478;11142;168;756;2689;8339;2857;9095
261260;201804;12599;34608;10967;32538;382;1507;9253;27348;9635;28855
261270;201804;3943;10946;3535;10309;231;772;2761;7855;2992;8627
261280;201804;2533;7402;2268;6952;95;404;1796;5351;1891;5755
261290;201804;2911;8030;2535;7540;119;462;2010;5996;2129;6458
261300;201804;11443;34056;9836;31166;703;2679;6900;21363;7603;24042
261310;201804;7204;20602;6437;19465;1104;3457;3974;11893;5078;15350
261320;201804;5826;17172;5144;15951;109;433;4256;13010;4365;13443
261330;201804;5702;15081;5272;14511;197;723;4543;12282;4740;13005
261340;201804;4025;12327;3510;11570;214;908;2603;8490;2817;9398
261350;201804;8238;25261;7604;24216;151;746;6269;19611;6420;20357
261360;201804;8201;20714;7084;19142;339;997;5702;15097;6041;16094
261370;201804;19295;53448;17156;50296;3142;9260;9743;28882;12885;38142
261380;201804;3904;12653;3554;11944;504;1873;2220;7329;2724;9202
261390;201804;16073;47326;13960;43765;1487;5056;8729;27291;10216;32347
261400;201804;4632;15324;4071;14122;184;834;2978;10129;3162;10963
261410;201804;9139;24301;7817;22160;568;1640;6159;17421;6727;19061
261420;201804;6977;22579;6500;21941;1051;3983;4126;13851;5177;17834
261430;201804;3440;10126;2912;9291;125;431;2337;7443;2462;7874
261440;201804;1503;4637;1321;4271;43;208;938;2945;981;3153
261450;201804;13878;38954;12840;37443;320;1213;10894;31640;11214;32853
261460;201804;6966;19917;6414;19106;251;857;5513;16362;5764;17219
261470;201804;4163;10851;3736;10283;53;266;3101;8542;3154;8808
261480;201804;4514;14625;3983;13724;230;966;3044;10245;3274;11211
261485;201804;4952;14557;4321;13531;404;1483;2947;9007;3351;10490
261500;201804;5487;14889;4843;14013;458;1251;3387;10100;3845;11351
261510;201804;1765;5560;1542;5144;87;322;1139;3821;1226;4143
261520;201804;2527;7864;2371;7563;87;352;1607;5226;1694;5578
261530;201804;10460;32951;9038;30099;1352;5108;4176;13698;5528;18806
261540;201804;7369;22267;6692;21191;1134;3594;3901;12659;5035;16253
261550;201804;3564;9684;3162;9055;235;757;2309;6511;2544;7268
261560;201804;7407;22979;6555;21753;440;1789;4926;16265;5366;18054
261570;201804;3396;9646;2844;8719;220;794;1931;5784;2151;6578
261580;201804;6401;17511;5821;16656;140;618;5207;14683;5347;15301
261590;201804;2660;7048;2173;6320;94;282;1673;4912;1767;5194
261600;201804;5237;13708;4409;12477;410;1130;2996;8659;3406;9789
261610;201804;2446;6673;2064;6087;78;307;1592;4655;1670;4962
261618;201804;2498;6585;2241;6229;94;288;1839;5051;1933;5339
261620;201804;3908;11846;3645;11421;809;2396;2160;7068;2969;9464
261630;201804;6839;19532;5796;17593;476;1760;3634;10554;4110;12314
261640;201804;36138;84623;31910;79420;1851;4153;25405;64846;27256;68999
261650;201804;4047;10872;3621;10316;142;536;2729;7776;2871;8312
270010;201804;4280;15212;3851;14402;183;997;3047;11181;3230;12178
270020;201804;3937;10223;3504;9652;223;728;2846;7645;3069;8373
270030;201804;34303;97602;30071;90724;4553;13687;18584;56588;23137;70275
270040;201804;11038;30746;9654;29052;493;1804;7912;23715;8405;25519
270050;201804;5132;12379;4432;11594;210;561;3885;10188;4095;10749
270060;201804;2019;5402;1769;5084;177;498;1288;3771;1465;4269
270070;201804;4511;13278;3982;12532;146;678;3338;10259;3484;10937
270080;201804;1364;3980;1144;3572;88;284;840;2554;928;2838
270090;201804;1942;6022;1717;5575;73;342;1334;4171;1407;4513
270100;201804;5483;15506;4841;14528;314;1167;3811;11229;4125;12396
270110;201804;3114;7950;2549;7307;181;528;2000;5864;2181;6392
270120;201804;3040;8311;2668;7851;90;362;2353;6877;2443;7239
270130;201804;5319;14419;4636;13634;264;872;3777;11192;4041;12064
270135;201804;1981;4956;1726;4660;74;208;1545;4169;1619;4377
270140;201804;10153;23462;8297;20976;412;1565;6722;16056;7134;17621
270150;201804;2640;8205;2533;8074;17;49;2481;7924;2498;7973
270160;201804;5168;15858;4561;15099;89;510;4052;13253;4141;13763
270170;201804;3569;10841;3122;10212;288;1266;2227;6996;2515;8262
270180;201804;2250;7123;2063;6861;62;286;1774;5807;1836;6093
270190;201804;1706;5288;1576;5109;77;298;1289;4167;1366;4465
270200;201804;2506;7803;2197;7390;156;653;1621;5308;1777;5961
270210;201804;5415;13844;4758;13054;181;589;4219;11463;4400;12052
270220;201804;1348;3959;1175;3704;223;779;669;2050;892;2829
270230;201804;9631;28844;8228;26549;837;3194;5304;16598;6141;19792
270235;201804;5837;18609;5247;17604;238;1004;4221;14015;4459;15019
270240;201804;10540;29284;8706;26939;1108;3777;6007;18513;7115;22290
270250;201804;2826;7422;2533;7045;280;715;1891;5332;2171;6047
270255;201804;4648;13589;3582;11610;197;816;2543;8052;2740;8868
270260;201804;5581;17062;5227;16505;156;745;4499;13767;4655;14512
270270;201804;1039;2840;950;2721;150;443;625;1765;775;2208
270280;201804;3844;9835;3131;8917;419;805;2198;6622;2617;7427
270290;201804;7745;25311;7031;24137;332;1548;5812;19623;6144;21171
270300;201804;4100;11378;3276;10475;263;906;2351;7602;2614;8508
270310;201804;7128;20783;6219;19352;183;949;5181;15603;5364;16552
270320;201804;5817;17412;5262;16413;655;2161;3596;10996;4251;13157
270330;201804;3790;12851;3469;12387;283;1105;2698;9670;2981;10775
270340;201804;1624;4719;1389;4403;75;291;1124;3497;1199;3788
270350;201804;1906;4760;1622;4409;177;531;1168;3186;1345;3717
270360;201804;2278;6302;2075;6062;87;266;1868;5498;1955;5764
270370;201804;1412;4527;1289;4301;55;243;1014;3354;1069;3597
270375;201804;2990;7529;2537;6962;55;186;2281;6239;2336;6425
270380;201804;5711;16958;4974;15967;466;1586;3569;11645;4035;13231
270390;201804;1216;3231;1019;2952;30;126;816;2313;846;2439
270400;201804;6189;17583;5355;16246;224;856;4064;11934;4288;12790
270410;201804;4481;13740;4007;12918;261;988;3060;9736;3321;10724
270420;201804;5620;17169;5201;16605;191;838;4309;13498;4500;14336
270430;201804;134901;352720;110547;319817;26209;79932;43373;128417;69582;208349
270440;201804;4855;13548;4195;12725;133;566;3445;10405;3578;10971
270450;201804;6498;18588;5895;17851;297;1112;4846;14531;5143;15643
270460;201804;3449;8380;3050;7903;67;244;2775;7057;2842;7301
270470;201804;10699;32066;9517;30311;959;3322;6703;21563;7662;24885
270480;201804;2778;7960;2393;7353;189;715;1822;5403;2011;6118
270490;201804;979;2918;873;2786;54;203;687;2165;741;2368
270500;201804;4827;15324;4427;14799;184;870;3685;12126;3869;12996
270510;201804;5800;16290;5055;15252;531;2001;3544;10169;4075;12170
270520;201804;3844;11466;3148;10255;845;2886;1071;3698;1916;6584
270530;201804;1206;3629;1088;3447;62;197;813;2580;875;2777
270540;201804;2103;6469;1887;6183;82;394;1586;5068;1668;5462
270550;201804;6750;18420;5624;17156;510;1485;4242;13312;4752;14797
270560;201804;3134;8794;2795;8309;159;552;2177;6368;2336;6920
270570;201804;3901;11780;3379;10957;170;712;2686;8553;2856;9265
270580;201804;2179;6433;2035;6225;87;262;1781;5461;1868;5723
270590;201804;1518;4654;1429;4546;6;21;1395;4445;1401;4466
270600;201804;2799;8854;2500;8353;108;546;2094;6808;2202;7354
270610;201804;3531;9787;3030;9145;110;437;2618;7747;2728;8184
270620;201804;1320;4155;1209;3959;49;212;1006;3210;1055;3422
270630;201804;14791;41776;13187;39255;1138;3644;9942;29486;11080;33130
270640;201804;5556;16302;4819;15168;214;867;3871;11878;4085;12745
270642;201804;2351;7885;2158;7599;153;776;1687;5732;1840;6508
270644;201804;3124;8363;2619;7697;234;702;1940;5776;2174;6478
270650;201804;3335;10078;2994;9591;416;1619;2050;6282;2466;7901
270660;201804;2182;5485;1740;4870;75;237;1294;3586;1369;3823
270670;201804;15623;38922;13410;36260;942;2617;10670;28830;11612;31447
270680;201804;4932;12960;4463;12431;101;222;4168;11698;4269;11920
270690;201804;9359;23871;7921;22213;1229;3182;5578;16062;6807;19244
270700;201804;551;1719;477;1582;45;178;321;1050;366;1228
270710;201804;5821;17678;5395;17121;268;1161;4522;14055;4790;15216
270720;201804;3324;10509;2962;9887;94;558;2497;8114;2591;8672
270730;201804;7079;18081;6527;17479;393;1002;5422;15210;5815;16212
270740;201804;2316;6292;2080;5994;94;341;1743;4944;1837;5285
270750;201804;5283;15067;4674;14190;291;1057;3714;11188;4005;12245
270760;201804;3374;9697;2973;9108;79;379;2538;7646;2617;8025
270770;201804;20360;50951;16254;45930;2989;7991;9173;27778;12162;35769
270780;201804;1753;5343;1650;5196;93;334;1374;4329;1467;4663
270790;201804;1556;4609;1375;4348;145;470;926;2940;1071;3410
270800;201804;10781;30816;9771;29393;458;1962;8221;24043;8679;26005
270810;201804;3090;9293;2467;8178;187;776;1695;5496;1882;6272
270820;201804;1721;5314;1460;4868;120;468;1065;3482;1185;3950
270830;201804;5504;13504;4592;12370;255;768;3669;9892;3924;10660
270840;201804;8203;24618;7366;23462;213;1190;6433;19898;6646;21088
270850;201804;8269;22075;7470;21045;528;1932;6029;16292;6557;18224
270860;201804;11314;29467;9463;27198;637;2138;7347;20778;7984;22916
270870;201804;2052;6073;1776;5577;188;653;1252;3908;1440;4561
270880;201804;8112;24782;7344;23661;295;1290;6050;19163;6345;20453
270890;201804;2428;6955;2137;6538;150;538;1553;4641;1703;5179
270895;201804;2875;9734;2693;9482;92;520;2357;8086;2449;8606
270900;201804;1807;4805;1421;4192;58;197;1116;3210;1174;3407
270910;201804;3628;11078;3175;10300;137;578;2412;7684;2549;8262
270915;201804;8839;27736;7564;25416;920;3580;4797;15709;5717;19289
270920;201804;5683;17749;5319;17187;248;1161;4424;13828;4672;14989
270930;201804;16870;41915;13383;37765;2257;5995;8620;25141;10877;31136
270940;201804;5872;17703;5280;16957;304;1395;4036;12638;4340;14033
280010;201804;670;1851;570;1665;26;102;394;1054;420;1156
280020;201804;4685;12697;4043;11648;521;1471;2666;7685;3187;9156
280030;201804;70672;175129;57167;155852;14684;41255;21611;61474;36295;102729
280040;201804;3103;8881;2744;8323;284;918;1904;5711;2188;6629
280050;201804;3770;11228;3348;10540;589;1987;1942;6085;2531;8072
280060;201804;5080;14570;4158;13073;758;2546;2042;6598;2800;9144
280067;201804;6785;18075;5772;16473;523;1551;3942;11154;4465;12705
280070;201804;1906;5962;1825;5827;118;389;1513;4790;1631;5179
280100;201804;3631;10655;3206;9946;353;1213;2225;6845;2578;8058
280110;201804;1308;3871;1186;3659;49;204;982;2920;1031;3124
280120;201804;7505;22748;6808;21567;746;2212;5022;16192;5768;18404
280130;201804;8469;21276;7579;20009;741;1992;5652;15100;6393;17092
280140;201804;5532;14035;4980;13261;304;834;4100;10893;4404;11727
280150;201804;3755;10134;3424;9686;220;622;2797;7883;3017;8505
280160;201804;1244;3667;1026;3286;145;482;627;1971;772;2453
280170;201804;5039;13806;4582;13168;268;754;3759;10885;4027;11639
280190;201804;1211;2883;1011;2595;59;174;800;1988;859;2162
280200;201804;1287;3548;1073;3179;105;377;749;2184;854;2561
280210;201804;14757;39857;12949;37318;2141;6421;7450;21728;9591;28149
280220;201804;1764;4825;1546;4529;45;220;1256;3674;1301;3894
280230;201804;3517;9596;3160;9078;221;723;2407;6773;2628;7496
280240;201804;3373;9203;3056;8718;79;346;2613;7275;2692;7621
280250;201804;834;2155;657;1877;68;221;374;1015;442;1236
280260;201804;2077;5334;1916;5136;45;134;1776;4762;1821;4896
280270;201804;2228;6583;1981;6195;106;384;1666;5134;1772;5518
280280;201804;4047;12992;3659;12391;558;1697;2376;8480;2934;10177
280290;201804;16823;47707;15065;45165;1691;5628;9786;29348;11477;34976
280300;201804;10034;27502;8838;26151;373;1347;6912;21336;7285;22683
280310;201804;1363;3681;1155;3316;37;134;858;2386;895;2520
280320;201804;8532;24599;7564;23116;845;2805;4967;14878;5812;17683
280330;201804;4716;12090;4060;11133;267;837;3115;8390;3382;9227
280340;201804;5075;11303;4392;10534;283;609;3723;9120;4006;9729
280350;201804;22630;58954;19689;54611;1907;5486;13893;38406;15800;43892
280360;201804;5758;16861;5193;15873;876;2721;2872;8905;3748;11626
280370;201804;2036;5191;1686;4614;87;232;1316;3571;1403;3803
280380;201804;991;2881;869;2693;97;336;583;1781;680;2117
280390;201804;3286;8879;2742;7945;139;474;2116;6011;2255;6485
280400;201804;3889;10530;3433;9855;627;1729;1990;5937;2617;7666
280410;201804;2097;6311;1727;5616;183;629;1021;3239;1204;3868
280420;201804;4194;11678;3835;11164;113;389;3417;9909;3530;10298
280430;201804;2057;5269;1817;4938;75;262;1416;3781;1491;4043
280440;201804;4593;12543;4046;11777;251;823;3222;9161;3473;9984
280445;201804;2302;6053;2081;5656;45;142;1574;4109;1619;4251
280450;201804;9952;23527;8922;22202;386;751;7713;19463;8099;20214
280460;201804;6552;16487;5996;15689;539;1395;4797;12548;5336;13943
280470;201804;1774;5148;1577;4796;84;295;1165;3506;1249;3801
280480;201804;34887;92751;31352;87729;3152;9795;21880;60108;25032;69903
280490;201804;3825;11100;3266;10152;102;449;2472;7476;2574;7925
280500;201804;935;2369;816;2200;36;123;681;1819;717;1942
280510;201804;2539;7091;2223;6628;115;454;1609;4769;1724;5223
280520;201804;1689;4412;1501;4156;86;223;1230;3406;1316;3629
280530;201804;2587;6436;2288;6077;136;364;1860;4930;1996;5294
280540;201804;8949;24512;8205;23470;200;930;7244;20223;7444;21153
280550;201804;6575;16309;5473;14604;282;795;4249;11121;4531;11916
280560;201804;7083;20454;6697;19900;193;770;5841;17067;6034;17837
280570;201804;6220;16106;5158;14715;272;922;3769;10657;4041;11579
280580;201804;5339;15518;4599;14258;588;1742;3052;9612;3640;11354
280590;201804;2852;7206;2431;6671;144;597;1761;4591;1905;5188
280600;201804;3357;9619;3027;9147;225;781;2216;6622;2441;7403
280610;201804;2520;6426;2278;6100;186;494;1815;4821;2001;5315
280620;201804;5242;14029;4566;13023;434;1056;3320;9850;3754;10906
280630;201804;3582;11167;3258;10659;209;797;2543;8359;2752;9156
280640;201804;2319;6691;2154;6508;50;134;2010;6137;2060;6271
280650;201804;1210;3289;979;2949;89;312;688;2020;777;2332
280660;201804;2965;7446;2664;7092;130;361;2310;6136;2440;6497
280670;201804;18053;43231;15962;40514;1267;3353;12106;30740;13373;34093
280680;201804;2764;7020;2355;6362;166;375;1742;4685;1908;5060
280690;201804;963;2543;830;2355;48;140;612;1718;660;1858
280700;201804;1068;2869;937;2659;21;71;727;2030;748;2101
280710;201804;14088;33185;12247;31055;570;986;10671;27881;11241;28867
280720;201804;2679;6162;2227;5629;144;376;1487;4018;1631;4394
280730;201804;1083;2771;972;2611;74;231;741;1967;815;2198
280740;201804;13505;34825;11601;31814;1170;3213;7758;21195;8928;24408
280750;201804;3435;10040;3096;9430;195;717;2240;6711;2435;7428
280760;201804;5880;16944;5239;15909;653;1986;3384;10561;4037;12547
290010;201804;3037;6621;2136;5227;13;46;1769;4123;1782;4169
290020;201804;5043;14357;4760;13973;294;634;4121;12322;4415;12956
290030;201804;3788;9983;3305;9414;191;524;2767;7892;2958;8416
290035;201804;5124;11640;4127;10338;282;558;3264;8487;3546;9045
290040;201804;4349;10753;3653;9923;153;454;2857;7935;3010;8389
290050;201804;2193;7124;1870;6491;139;550;1296;4454;1435;5004
290060;201804;1280;3278;989;2810;107;380;661;1795;768;2175
290070;201804;33074;79493;28675;73736;2987;7794;18998;49467;21985;57261
290080;201804;5600;16688;4727;15435;582;1974;3119;10353;3701;12327
290090;201804;2295;4423;1717;3813;43;98;1561;3455;1604;3553
290100;201804;9271;25583;7878;23439;1034;2926;4824;14769;5858;17695
290110;201804;4962;13920;4562;13217;477;1432;3118;8949;3595;10381
290115;201804;4342;12601;3774;11799;221;748;2986;9380;3207;10128
290120;201804;6906;17080;5668;15572;147;535;4856;13123;5003;13658
290130;201804;4571;11567;3671;10441;117;486;2944;8201;3061;8687
290135;201804;4418;10551;3612;9265;241;671;2688;6696;2929;7367
290140;201804;4557;12748;3729;11678;132;493;3242;10147;3374;10640
290150;201804;2241;6504;2107;6283;191;614;1580;4593;1771;5207
290160;201804;3153;7765;2891;7432;364;771;2174;5708;2538;6479
290170;201804;2805;8183;2597;7920;69;275;2345;7106;2414;7381
290180;201804;2906;8132;2420;7351;96;353;1904;5722;2000;6075
290190;201804;3929;12058;3563;11532;171;735;2862;9095;3033;9830
290195;201804;2318;6061;1865;5369;55;254;1508;4298;1563;4552
290200;201804;3957;11528;3384;10610;213;699;2632;8229;2845;8928
290205;201804;3405;8986;3008;8396;121;441;2423;6580;2544;7021
290210;201804;13183;38195;11778;36194;1057;2947;8934;28275;9991;31222
290220;201804;2707;7105;2460;6789;168;511;2010;5463;2178;5974
290225;201804;3461;7460;2830;6789;35;80;2658;6401;2693;6481
290230;201804;2419;6949;2210;6703;68;270;1926;5810;1994;6080
290240;201804;3679;9593;3058;8806;126;453;2481;7034;2607;7487
290250;201804;3993;11869;3606;11366;113;292;3061;10119;3174;10411
290260;201804;5289;13843;4334;12433;231;792;3430;9742;3661;10534
290265;201804;3576;10545;2986;9470;128;536;2263;7066;2391;7602
290270;201804;11765;40716;11130;39631;778;3305;8674;30510;9452;33815
290280;201804;5862;17719;5212;16641;392;1371;3785;11994;4177;13365
290290;201804;9850;29671;8351;26941;790;2690;5747;18470;6537;21160
290300;201804;4428;12230;3211;9915;189;674;2261;6986;2450;7660
290310;201804;1515;4057;1275;3724;106;392;921;2615;1027;3007
290320;201804;24197;66646;20429;61310;5150;15553;9491;29756;14641;45309
290323;201804;3608;9990;3227;9465;75;256;2681;7774;2756;8030
290327;201804;4279;12513;3707;11429;324;984;2631;8141;2955;9125
290330;201804;2008;4531;1693;4186;53;115;1518;3775;1571;3890
290340;201804;5637;15367;4560;13988;718;2306;3034;9380;3752;11686
290350;201804;4650;13746;3948;12537;311;1038;2832;9066;3143;10104
290360;201804;4972;13644;4332;12798;121;391;3723;11036;3844;11427
290370;201804;5182;13046;3986;11476;234;604;3040;8926;3274;9530
290380;201804;5520;15226;4764;14156;128;411;4109;12304;4237;12715
290390;201804;14700;42730;12659;39670;1400;4525;8429;26909;9829;31434
290395;201804;2731;8402;2315;7654;73;352;1803;5914;1876;6266
290400;201804;3596;10125;2920;9034;132;501;2160;6548;2292;7049
290405;201804;4689;14009;3937;12657;268;920;2738;8914;3006;9834
290410;201804;5622;16002;4542;14225;160;725;3455;10424;3615;11149
290420;201804;2959;8496;2481;7727;145;460;1903;5941;2048;6401
290430;201804;3079;9030;2573;8192;337;1116;1622;5175;1959;6291
290440;201804;2806;7208;2119;6178;64;207;1548;4569;1612;4776
290450;201804;3263;9068;2702;8242;141;516;2074;6205;2215;6721
290460;201804;11888;33663;10337;30739;2781;8455;3953;11655;6734;20110
290470;201804;4345;11583;3258;9949;480;1618;1679;5220;2159;6838
290475;201804;6207;18639;5346;17073;116;575;4256;13290;4372;13865
290480;201804;1942;5098;1712;4761;138;429;1122;3091;1260;3520
290485;201804;4512;13713;3961;12871;137;717;3369;10713;3506;11430
290490;201804;8630;21339;7913;20388;550;1434;6258;16202;6808;17636
290500;201804;3847;11748;2971;9906;378;1319;1571;5152;1949;6471
290510;201804;3269;8733;2814;8111;100;360;2394;6816;2494;7176
290515;201804;3726;10029;3127;9258;81;225;2727;8250;2808;8475
290520;201804;11352;33752;8957;29033;402;1658;5921;18768;6323;20426
290530;201804;4969;14425;4319;13368;183;602;3550;10982;3733;11584
290540;201804;3666;10017;3295;9537;83;282;2947;8485;3030;8767
290550;201804;4318;11356;3832;10804;39;112;3557;10131;3596;10243
290560;201804;6680;17816;5346;15829;537;1832;3638;10518;4175;12350
290570;201804;42997;111216;39049;106103;2867;8137;30321;81882;33188;90019
290580;201804;7566;23520;6813;22404;632;2040;5133;17245;5765;19285
290590;201804;6894;21698;5994;20091;159;681;4945;16558;5104;17239
290600;201804;17904;51944;16299;49515;847;2634;13033;40066;13880;42700
290610;201804;2476;8087;1998;7117;101;422;1387;4892;1488;5314
290620;201804;6280;17967;5579;16853;220;712;4721;14154;4941;14866
290630;201804;9015;22263;7272;20022;611;1662;5638;15610;6249;17272
290640;201804;2702;7407;2070;6365;106;337;1579;4811;1685;5148
290650;201804;11488;31499;10555;30298;2788;7747;5755;17449;8543;25196
290660;201804;3598;9626;3084;8866;107;259;2281;6911;2388;7170
290670;201804;6828;19711;5938;18259;483;1482;4442;13812;4925;15294
290680;201804;10280;29655;8905;27615;258;1296;7166;21646;7424;22942
290682;201804;4599;12548;4042;11741;142;401;3387;9829;3529;10230
290685;201804;3603;8253;2377;6533;206;541;1540;4395;1746;4936
290687;201804;6718;19124;5390;16886;810;2524;3143;10182;3953;12706
290689;201804;2896;8354;2402;7512;153;532;1726;5438;1879;5970
290690;201804;5555;14841;4564;13504;511;1509;3068;9035;3579;10544
290700;201804;2592;7333;2343;6990;86;324;2004;5978;2090;6302
290710;201804;8356;24167;7232;22636;246;923;6215;19416;6461;20339
290720;201804;18619;51813;17209;49872;889;2796;14364;41596;15253;44392
290730;201804;7058;18195;6125;17043;274;730;4723;13136;4997;13866
290740;201804;1026;2885;785;2446;41;156;588;1815;629;1971
290750;201804;10401;27805;9073;25440;1043;3118;6005;16372;7048;19490
290755;201804;2214;6235;1719;5324;97;351;1195;3650;1292;4001
290760;201804;3901;11627;3096;10030;374;1097;1837;6229;2211;7326
290770;201804;2490;8436;2310;8201;63;320;1916;6840;1979;7160
290780;201804;8338;21494;7244;19939;415;904;5688;15997;6103;16901
290790;201804;4399;12518;3947;11899;163;482;3376;10235;3539;10717
290800;201804;7181;15132;5369;13065;345;787;4107;10172;4452;10959
290810;201804;5676;15715;4545;13901;113;426;3489;10713;3602;11139
290820;201804;5131;13916;4574;13106;270;872;3406;9758;3676;10630
290830;201804;4585;10926;4107;10284;96;297;3421;8435;3517;8732
290840;201804;16580;46224;14582;43092;1728;4556;9673;29836;11401;34392
290850;201804;6287;16487;5728;15861;499;1188;4512;12900;5011;14088
290860;201804;5634;17400;4932;16565;223;835;4134;14107;4357;14942
290870;201804;4687;13218;3668;11428;141;500;2641;8180;2782;8680
290880;201804;1411;3610;1104;3158;80;198;771;2250;851;2448
290890;201804;7772;17724;6857;16693;185;514;6336;15315;6521;15829
290900;201804;2323;6371;1764;5389;111;359;1133;3407;1244;3766
290910;201804;5011;12930;3987;11371;56;248;3325;9377;3381;9625
290920;201804;5104;12872;4717;12381;75;182;4392;11517;4467;11699
290930;201804;8064;22969;6717;20658;211;960;5397;16116;5608;17076
290940;201804;3768;10983;3211;10183;177;623;2411;7678;2588;8301
290950;201804;1501;3991;1279;3647;78;225;914;2628;992;2853
290960;201804;5277;14671;4804;14047;158;510;4048;11855;4206;12365
290970;201804;3611;10664;3039;9718;172;547;2252;7233;2424;7780
290980;201804;10733;28144;9087;25339;1148;3446;4924;13349;6072;16795
290990;201804;8914;25190;7822;23358;392;1464;6288;18309;6680;19773
291000;201804;3282;9063;2658;8267;250;730;2058;6525;2308;7255
291005;201804;14585;35933;12955;33912;649;1809;10819;28247;11468;30056
291010;201804;3049;9301;2451;8054;142;480;1646;5359;1788;5839
291020;201804;1270;3281;1023;2813;35;122;699;1815;734;1937
291030;201804;2385;6165;1670;4800;97;287;1050;2926;1147;3213
291040;201804;5315;15342;4619;14320;211;881;3666;11186;3877;12067
291050;201804;7370;21742;6481;20360;1106;3779;3975;12273;5081;16052
291060;201804;5889;19871;5180;18857;469;2095;3610;12938;4079;15033
291070;201804;15349;43152;13262;39918;581;2137;10567;31494;11148;33631
291072;201804;23573;64822;17636;53571;3695;11821;6528;20029;10223;31850
291075;201804;4976;13577;4445;12666;187;545;3530;9931;3717;10476
291077;201804;1552;4200;1252;3665;49;136;907;2670;956;2806
291080;201804;79997;230494;68069;210642;25300;79925;10503;34168;35803;114093
291085;201804;5683;14655;4749;13325;194;595;4018;11243;4212;11838
291090;201804;1804;3703;1420;3262;113;165;1159;2738;1272;2903
291100;201804;3015;6845;2106;5771;95;347;1622;4342;1717;4689
291110;201804;5553;17759;4814;16484;521;1996;3386;11285;3907;13281
291120;201804;7724;19625;6736;18266;424;1284;5171;13945;5595;15229
291125;201804;2071;3802;1561;3239;93;173;1222;2600;1315;2773
291130;201804;2956;8856;2360;7720;80;374;1760;5561;1840;5935
291140;201804;4532;12787;3432;10624;467;1285;2181;6874;2648;8159
291150;201804;2198;5176;1897;4821;28;77;1693;4268;1721;4345
291160;201804;4859;14548;4255;13545;414;1436;2846;8941;3260;10377
291165;201804;2287;6340;1776;5382;22;94;1308;3859;1330;3953
291170;201804;20463;53199;17348;48112;1128;3343;11102;30741;12230;34084
291180;201804;6034;15124;4684;13108;409;1164;3391;9477;3800;10641
291185;201804;3179;8906;2772;8170;102;331;2228;6477;2330;6808
291190;201804;7504;19174;6329;17564;403;1219;4938;13661;5341;14880
291200;201804;2862;8243;2158;6909;160;518;1326;4213;1486;4731
291210;201804;6776;15530;5293;13739;176;566;3989;10296;4165;10862
291220;201804;3925;11547;3534;10924;283;980;2578;7859;2861;8839
291230;201804;4353;9915;3395;8842;93;188;3083;8145;3176;8333
291240;201804;4262;11278;3726;10357;67;220;3183;8704;3250;8924
291250;201804;3358;10141;2699;8915;179;586;1820;6069;1999;6655
291260;201804;1261;3146;1097;2924;43;169;922;2415;965;2584
291270;201804;4973;14330;4060;12823;750;2413;2382;7686;3132;10099
291280;201804;2358;6379;1820;5476;204;660;1044;3073;1248;3733
291290;201804;5832;15797;4725;14108;513;1549;3099;9297;3612;10846
291300;201804;3976;11106;3013;9463;127;430;2197;6840;2324;7270
291310;201804;5180;14324;4425;12927;159;526;3576;10298;3735;10824
291320;201804;5978;17772;4713;15226;1105;3391;2180;7378;3285;10769
291330;201804;1751;4672;1487;4242;79;241;1088;3020;1167;3261
291340;201804;4076;10868;3439;9845;77;290;2725;7697;2802;7987
291345;201804;2976;9389;2772;9098;138;468;2248;7439;2386;7907
291350;201804;6524;17183;5066;15187;140;424;4234;12873;4374;13297
291360;201804;33834;84858;27479;76545;4697;13405;14895;42603;19592;56008
291370;201804;7821;21706;7155;20799;442;1458;5518;15921;5960;17379
291380;201804;3357;9881;2988;9273;110;458;2426;7394;2536;7852
291390;201804;12359;29139;10063;26503;479;1448;8026;21036;8505;22484
291400;201804;13732;36784;11719;33743;1777;4733;7180;21846;8957;26579
291410;201804;2909;7768;2228;6608;67;292;1686;4847;1753;5139
291420;201804;1907;4932;1578;4506;44;180;1343;3800;1387;3980
291430;201804;3036;8550;2655;7976;89;428;2159;6279;2248;6707
291440;201804;6418;18811;5578;17377;371;1255;4384;13756;4755;15011
291450;201804;8431;22841;7170;21263;148;355;6208;18911;6356;19266
291460;201804;14154;39955;12599;37635;1018;3278;9071;27137;10089;30415
291465;201804;8676;24118;7129;22249;290;1233;5913;18380;6203;19613
291470;201804;15699;38716;13396;36055;625;1620;10123;28000;10748;29620
291480;201804;38817;89867;29113;76674;3805;10555;15241;40371;19046;50926
291490;201804;4891;13434;4339;12735;262;800;3609;10627;3871;11427
291500;201804;4910;12547;4067;11375;80;338;3603;10014;3683;10352
291510;201804;3765;10567;3082;9552;96;475;2471;7606;2567;8081
291520;201804;4303;10594;3395;9360;220;643;2434;6745;2654;7388
291530;201804;2197;5466;1642;4679;322;823;930;2916;1252;3739
291535;201804;3133;9702;2881;9276;202;640;2191;7150;2393;7790
291540;201804;2226;5053;1600;4354;63;205;1401;3761;1464;3966
291550;201804;5375;13092;4270;11592;520;1324;2607;7225;3127;8549
291560;201804;19983;44920;13604;37315;929;2357;9185;26571;10114;28928
291570;201804;2277;5549;1867;5046;98;216;1557;4317;1655;4533
291580;201804;6031;16640;4911;15120;364;1317;3532;10729;3896;12046
291590;201804;1731;5109;1582;4882;153;513;1247;3844;1400;4357
291600;201804;5165;13392;3882;11328;606;1866;2187;6255;2793;8121
291610;201804;5069;14944;4813;14660;83;297;4522;13800;4605;14097
291620;201804;3126;7074;2253;6113;111;326;1727;4751;1838;5077
291630;201804;3236;7562;2480;6590;155;463;1953;5131;2108;5594
291640;201804;15486;40818;11954;35431;2274;6849;4393;13859;6667;20708
291650;201804;8556;23433;7608;22246;477;1163;6402;19038;6879;20201
291660;201804;2226;5451;1617;4499;123;429;1069;2807;1192;3236
291670;201804;1991;5270;1719;4888;107;268;1352;3898;1459;4166
291680;201804;3905;10433;3308;9442;321;970;2437;6931;2758;7901
291685;201804;4752;11598;3799;10356;305;673;2817;7977;3122;8650
291690;201804;4124;9640;2987;7987;104;255;2408;6375;2512;6630
291700;201804;8620;25771;7644;23997;518;1706;6044;18870;6562;20576
291710;201804;5222;13020;3960;11263;332;1052;2684;7500;3016;8552
291720;201804;4554;14290;3771;12675;346;1299;2521;8252;2867;9551
291730;201804;6295;17099;5448;15965;302;1007;4394;12884;4696;13891
291733;201804;2951;7787;2469;7114;84;270;1864;5541;1948;5811
291735;201804;2972;7931;2500;7231;92;298;2094;6071;2186;6369
291740;201804;3883;10191;3096;8972;131;409;2395;6845;2526;7254
291750;201804;19669;49089;15804;43181;2013;5582;9767;26976;11780;32558
291760;201804;10533;31764;8479;28343;2854;10702;1990;6712;4844;17414
291770;201804;6945;19726;5808;17639;570;1880;4021;11924;4591;13804
291780;201804;4769;13321;4316;12626;110;374;3757;10907;3867;11281
291790;201804;2641;7714;2442;7431;208;589;1871;5752;2079;6341
291800;201804;29370;76709;23267;67664;3155;8985;13360;39852;16515;48837
291810;201804;10683;26670;8855;24381;231;796;7576;20625;7807;21421
291820;201804;3757;10404;3303;9727;133;468;2572;7554;2705;8022
291830;201804;4199;10433;3640;9679;246;680;2913;7753;3159;8433
291835;201804;6259;19089;5036;16724;838;2921;2862;9724;3700;12645
291840;201804;45667;127417;39691;119669;4730;14423;27262;84000;31992;98423
291845;201804;2332;6697;2077;6347;128;394;1707;5267;1835;5661
291850;201804;4102;11896;3355;10609;287;816;2416;7892;2703;8708
291855;201804;1985;4303;1591;3819;75;212;1337;3172;1412;3384
291860;201804;2255;5979;1605;4729;35;119;1099;3117;1134;3236
291870;201804;1364;3536;913;2706;63;195;600;1728;663;1923
291875;201804;2671;8187;2382;7665;93;336;1772;5566;1865;5902
291880;201804;5209;15658;4627;14545;343;1079;3409;10708;3752;11787
291890;201804;1477;3290;1005;2711;178;378;638;1784;816;2162
291900;201804;1204;3089;928;2620;25;100;723;1985;748;2085
291905;201804;2741;7051;2089;5943;87;299;1539;4267;1626;4566
291910;201804;2805;7317;2407;6832;79;259;2073;5872;2152;6131
291915;201804;7012;20723;5849;18691;274;1026;4435;14191;4709;15217
291920;201804;25078;70431;22153;66304;2781;8875;14410;42730;17191;51605
291930;201804;2423;7031;2107;6503;206;711;1439;4351;1645;5062
291940;201804;3534;9562;2431;7603;226;730;1472;4479;1698;5209
291950;201804;8728;27585;7629;25458;820;2841;4688;15836;5508;18677
291955;201804;12909;34814;11739;33304;1629;4466;8244;24107;9873;28573
291960;201804;3086;8583;2509;7719;149;467;1908;5982;2057;6449
291970;201804;4033;11450;3530;10706;200;813;2567;7710;2767;8523
291980;201804;10341;29564;8265;26395;645;2062;5705;18382;6350;20444
291990;201804;2001;5773;1877;5629;23;92;1772;5327;1795;5419
291992;201804;4152;10251;3035;8700;311;848;2312;6724;2623;7572
291995;201804;2165;5988;1755;5373;55;243;1433;4291;1488;4534
292000;201804;2416;6274;2010;5681;168;557;1428;4007;1596;4564
292010;201804;6144;14526;5027;12972;222;662;4163;10598;4385;11260
292020;201804;4484;13541;3841;12382;317;1098;2795;8870;3112;9968
292030;201804;1691;5468;1626;5357;97;371;1011;3226;1108;3597
292040;201804;4266;11331;3523;10298;235;627;2810;8442;3045;9069
292045;201804;3865;10618;3017;9353;80;184;2640;8376;2720;8560
292050;201804;6424;18741;5269;16519;420;1453;3283;10157;3703;11610
292060;201804;12506;29307;11433;27985;701;1664;9649;23351;10350;25015
292070;201804;5542;15164;4879;14363;294;936;4164;12202;4458;13138
292080;201804;3222;8275;2623;7513;134;449;2267;6463;2401;6912
292090;201804;4450;10032;3326;8718;251;671;2585;6908;2836;7579
292100;201804;10263;26728;8742;24669;1631;4654;4703;13550;6334;18204
292105;201804;3063;8727;2759;8239;74;352;2324;6814;2398;7166
292110;201804;6283;16304;4562;13441;1095;3224;2016;6081;3111;9305
292120;201804;6749;18131;5473;15842;534;1571;3765;10822;4299;12393
292130;201804;3116;7990;2636;7379;183;577;2013;5626;2196;6203
292140;201804;4944;12272;4125;11075;231;614;3314;8847;3545;9461
292145;201804;2253;6803;1931;6231;102;346;1412;4576;1514;4922
292150;201804;12980;37113;11736;35247;322;1266;9813;29174;10135;30440
292160;201804;2584;6998;2173;6468;73;206;1894;5708;1967;5914
292170;201804;8214;22817;6823;20442;599;1890;4666;13973;5265;15863
292180;201804;2888;7992;2117;6648;370;1090;1120;3568;1490;4658
292190;201804;2926;8025;2472;7365;225;684;1691;5098;1916;5782
292200;201804;7258;19752;5680;17347;1056;3345;2872;8947;3928;12292
292205;201804;3701;10687;3299;10075;75;353;2880;8640;2955;8993
292210;201804;5992;15100;5015;13795;108;453;4436;12038;4544;12491
292220;201804;2018;5114;1793;4789;127;356;1335;3497;1462;3853
292225;201804;3186;9528;2845;9011;88;367;2350;7356;2438;7723
292230;201804;7788;19662;7123;18754;154;636;6075;15668;6229;16304
292240;201804;4966;14598;4290;13279;364;1130;2855;8802;3219;9932
292250;201804;5243;14821;4790;14092;643;1836;3125;9323;3768;11159
292260;201804;3289;9101;2963;8648;188;512;2481;7357;2669;7869
292265;201804;3232;9397;2766;8610;84;379;2172;6602;2256;6981
292270;201804;3997;9732;3271;8850;213;618;2672;7239;2885;7857
292273;201804;2513;5711;2064;5151;88;161;1610;4178;1698;4339
292275;201804;1804;5017;1459;4524;81;196;1143;3690;1224;3886
292280;201804;2499;6224;2063;5716;96;214;1703;4897;1799;5111
292285;201804;2449;6277;1958;5560;92;287;1535;4370;1627;4657
292290;201804;6786;19420;5684;17813;227;826;4613;14424;4840;15250
292300;201804;9633;25966;7726;23522;1029;3282;4874;15044;5903;18326
292303;201804;2847;8342;2510;7823;58;191;2160;6729;2218;6920
292305;201804;2507;6745;2314;6457;48;212;2053;5626;2101;5838
292310;201804;6483;17413;5638;16326;210;649;4784;13781;4994;14430
292320;201804;6328;17261;5205;15220;292;950;3938;11214;4230;12164
292330;201804;2443;5866;2129;5472;116;277;1695;4442;1811;4719
292335;201804;4825;12663;4331;11947;312;792;3500;9762;3812;10554
292340;201804;6134;16921;5188;15207;259;770;3903;11349;4162;12119
292350;201804;2401;6609;1971;6027;71;270;1647;5063;1718;5333
292360;201804;4851;13142;4160;11871;329;1068;2934;8158;3263;9226
292370;201804;10448;24738;9121;22965;172;539;8299;20521;8471;21060
292380;201804;6793;19549;6152;18440;494;1470;4611;13829;5105;15299
292390;201804;4165;8554;3060;7255;181;308;2605;6295;2786;6603
292400;201804;21150;63195;18928;59409;2010;6682;12961;40604;14971;47286
292405;201804;4440;10969;3647;9870;182;435;2962;8069;3144;8504
292410;201804;2006;5192;1769;4909;64;219;1532;4272;1596;4491
292420;201804;3639;11279;3384;10890;180;793;2813;8922;2993;9715
292430;201804;4836;14695;3766;13002;304;1101;2558;8965;2862;10066
292440;201804;7984;26284;7435;25510;108;543;6866;23656;6974;24199
292450;201804;3742;11229;3074;9925;141;517;2397;7742;2538;8259
292460;201804;4808;13676;3990;12254;381;1142;2828;8693;3209;9835
292465;201804;2453;6776;2035;6150;97;260;1452;4563;1549;4823
292467;201804;1720;5212;1595;5042;215;644;1105;3609;1320;4253
292470;201804;2996;7604;2357;6568;80;206;1857;5191;1937;5397
292480;201804;6486;15789;5220;14233;103;383;4638;12427;4741;12810
292490;201804;2147;5805;1793;5256;106;306;1360;4025;1466;4331
292500;201804;6429;18180;5296;16152;598;1815;3443;10562;4041;12377
292510;201804;12677;35117;10323;31530;634;2325;7542;22944;8176;25269
292520;201804;6573;17150;5696;15840;833;2258;3800;10739;4633;12997
292525;201804;5549;13702;4595;12597;126;347;4019;11046;4145;11393
292530;201804;26478;72781;21812;65469;5778;17425;8281;26025;14059;43450
292540;201804;3498;7808;2846;7082;161;415;2439;6076;2600;6491
292550;201804;7420;21046;5898;19057;434;1551;4386;14495;4820;16046
292560;201804;4199;11089;3616;10240;115;458;2948;8263;3063;8721
292570;201804;4034;10786;3496;9983;64;227;3143;8891;3207;9118
292575;201804;6746;20465;6309;19870;343;1186;5246;16489;5589;17675
292580;201804;7156;19195;6207;17798;199;724;5303;15029;5502;15753
292590;201804;7128;19496;6517;18602;261;895;5602;15634;5863;16529
292593;201804;2811;7072;2373;6343;116;309;1908;5064;2024;5373
292595;201804;5404;14660;4740;13820;182;644;3940;11365;4122;12009
292600;201804;10865;30078;9503;28110;542;1485;7365;21956;7907;23441
292610;201804;4445;11716;3691;10437;210;503;2638;7661;2848;8164
292620;201804;6342;18006;5471;17034;61;155;5210;16403;5271;16558
292630;201804;8744;21991;7175;19423;488;1332;4980;13561;5468;14893
292640;201804;7985;24322;7117;22929;250;990;5305;17110;5555;18100
292650;201804;4432;11295;4033;10765;166;469;3582;9437;3748;9906
292660;201804;10897;30860;9507;28806;542;1804;7433;22523;7975;24327
292665;201804;2183;6681;2001;6445;55;194;1755;5713;1810;5907
292670;201804;3516;9725;2740;8291;142;518;1852;5499;1994;6017
292680;201804;3896;10792;3224;9543;216;641;2308;6684;2524;7325
292690;201804;2609;7018;1849;5761;146;432;1197;3876;1343;4308
292700;201804;9434;26574;8242;24775;869;2476;5615;17434;6484;19910
292710;201804;2311;7526;2133;7300;59;217;1925;6629;1984;6846
292720;201804;9318;22735;7887;21139;305;922;6573;17798;6878;18720
292730;201804;4173;10642;3945;10356;194;413;3409;9016;3603;9429
292740;201804;323952;829046;294115;783457;50542;138155;170311;449331;220853;587486
292750;201804;6324;17076;5422;15736;263;806;4094;11963;4357;12769
292760;201804;3856;11418;3455;10696;269;894;2508;7727;2777;8621
292770;201804;5802;16373;4902;14997;839;2703;2837;8972;3676;11675
292780;201804;1930;4086;1441;3477;45;132;1167;2716;1212;2848
292790;201804;4031;8766;3267;7933;88;249;2963;7182;3051;7431
292800;201804;10519;27366;9197;25308;407;1140;7501;20459;7908;21599
292805;201804;3370;8625;2697;7686;211;566;1999;5724;2210;6290
292810;201804;10152;28220;8059;25016;320;1235;5956;18290;6276;19525
292820;201804;7666;20963;5548;17766;435;1670;3939;12342;4374;14012
292830;201804;2730;6516;2375;6075;63;224;2150;5435;2213;5659
292840;201804;8788;23602;7889;22390;171;688;6969;19302;7140;19990
292850;201804;2663;7244;2204;6506;151;528;1481;4215;1632;4743
292860;201804;15824;38029;14211;35957;975;2384;11266;28608;12241;30992
292870;201804;17214;45679;15107;42479;1092;3516;9863;27234;10955;30750
292880;201804;11502;31772;10066;29714;405;1635;7651;21807;8056;23442
292890;201804;5827;17799;5219;16797;328;1228;4140;13211;4468;14439
292895;201804;2951;6649;2179;5487;97;237;1668;4169;1765;4406
292900;201804;2688;7663;2494;7346;81;368;1998;5657;2079;6025
292905;201804;4292;11892;3330;10410;240;775;2254;7115;2494;7890
292910;201804;4982;14099;4494;13277;354;1173;3213;9375;3567;10548
292920;201804;9830;27433;9241;26630;312;1237;8026;22686;8338;23923
292925;201804;5198;15027;4637;14091;256;817;3550;10656;3806;11473
292930;201804;6183;19171;5549;17909;441;1842;3587;11177;4028;13019
292935;201804;2164;6017;1765;5575;41;198;1548;4964;1589;5162
292937;201804;3087;7586;2678;7089;75;225;2333;6193;2408;6418
292940;201804;3151;8285;2529;7294;178;445;1860;5511;2038;5956
292950;201804;9448;25143;8431;23593;366;1140;6530;17939;6896;19079
292960;201804;5305;12842;4526;11797;107;309;3684;9445;3791;9754
292970;201804;4003;11734;3477;10987;117;532;2867;9050;2984;9582
292975;201804;4398;9790;3907;9220;214;417;3441;8242;3655;8659
292980;201804;3242;8203;2591;7189;133;419;1985;5401;2118;5820
292990;201804;11103;30831;9510;28174;501;1670;7462;22049;7963;23719
293000;201804;2636;6493;2372;6138;30;133;1851;4926;1881;5059
293010;201804;17660;46891;14544;41741;1964;5728;8850;25357;10814;31085
293015;201804;7500;24184;6087;21407;560;2351;4078;14199;4638;16550
293020;201804;9310;28728;8532;27682;152;710;7561;24628;7713;25338
293030;201804;5557;15225;4257;13191;134;453;2844;9104;2978;9557
293040;201804;3903;11424;3501;10866;107;399;3067;9454;3174;9853
293050;201804;21172;54262;18816;50929;1689;4668;12988;35519;14677;40187
293060;201804;3469;9216;2859;8219;185;583;2108;5934;2293;6517
293070;201804;24006;60939;19861;55289;3672;10131;10915;31602;14587;41733
293075;201804;3217;10627;2928;10138;206;903;2301;7898;2507;8801
293076;201804;3561;9324;3180;8806;100;268;2660;7439;2760;7707
293077;201804;5251;15342;4437;14180;505;1672;2936;9607;3441;11279
293080;201804;4716;14354;4190;13471;151;657;3378;10657;3529;11314
293090;201804;3106;9502;2475;8441;243;907;1567;5306;1810;6213
293100;201804;5708;15959;4693;14103;311;945;3569;10751;3880;11696
293105;201804;3732;11976;3261;11040;233;812;2326;7811;2559;8623
293110;201804;2355;5937;1978;5417;64;224;1657;4437;1721;4661
293120;201804;4099;11787;3710;11144;140;421;3113;9305;3253;9726
293130;201804;3756;10753;3370;10265;101;401;2912;8852;3013;9253
293135;201804;29693;72939;22071;62146;4246;13209;9105;25854;13351;39063
293140;201804;2189;5430;1963;5153;84;264;1639;4199;1723;4463
293150;201804;5302;16727;4465;15055;495;1673;2942;10052;3437;11725
293160;201804;3887;9620;3310;8934;260;501;2697;7636;2957;8137
293170;201804;3850;9674;3371;9022;129;423;2691;7153;2820;7576
293180;201804;4725;12955;3838;11485;104;473;3123;9119;3227;9592
293190;201804;13396;38497;12004;36404;312;1387;10283;30859;10595;32246
293200;201804;7924;20235;6589;18317;233;859;5094;14014;5327;14873
293210;201804;5056;13760;4350;12637;221;653;3436;9962;3657;10615
293220;201804;4918;13650;3821;11735;941;2878;1423;4606;2364;7484
293230;201804;3852;10594;2997;9331;323;1103;1953;6157;2276;7260
293240;201804;4353;11865;3505;10439;100;301;2673;8089;2773;8390
293245;201804;4047;11055;3601;10437;159;515;2998;8598;3157;9113
293250;201804;5514;13907;4738;12823;305;809;3687;9961;3992;10770
293260;201804;4434;12645;3671;11460;123;410;2620;8129;2743;8539
293270;201804;6585;15730;5350;14375;556;1098;4108;11704;4664;12802
293280;201804;4917;13340;4198;12331;231;671;3170;9343;3401;10014
293290;201804;12480;40217;11487;38464;2747;9181;5502;19351;8249;28532
293300;201804;6180;14803;5289;13623;336;754;3901;10272;4237;11026
293305;201804;4137;10502;3630;9811;64;204;3177;8557;3241;8761
293310;201804;2164;5638;1765;4953;102;296;1283;3547;1385;3843
293315;201804;4156;10281;3415;9142;161;410;2746;7300;2907;7710
293317;201804;2457;6359;2186;5909;113;293;1687;4550;1800;4843
293320;201804;8835;25569;8275;24906;666;2081;6882;20849;7548;22930
293325;201804;1726;4619;1372;4072;202;618;860;2551;1062;3169
293330;201804;44380;141228;39005;131346;8622;29579;17227;58990;25849;88569
293340;201804;2423;6876;1973;6094;149;512;1296;3965;1445;4477
293345;201804;3200;9192;2707;8511;286;637;1931;6546;2217;7183
293350;201804;6737;19290;6018;18479;77;232;5596;17509;5673;17741
293360;201804;14782;39638;12920;37337;533;1784;11369;32652;11902;34436
310010;201804;841;2089;617;1759;68;221;274;737;342;958
310020;201804;2180;6417;1709;5605;420;1519;250;798;670;2317
310030;201804;2223;6553;1780;5750;258;957;1106;3422;1364;4379
310040;201804;966;2503;789;2233;52;196;593;1603;645;1799
310050;201804;1582;5175;1438;4902;264;1004;706;2326;970;3330
310060;201804;3330;9639;2878;9037;149;670;2359;7286;2508;7956
310070;201804;352;870;254;700;8;21;184;496;192;517
310080;201804;807;2245;560;1739;70;261;226;657;296;918
310090;201804;4370;12394;3717;11307;350;1174;2669;8032;3019;9206
310100;201804;3301;9646;2826;8853;122;525;2252;6893;2374;7418
310110;201804;4917;13377;3951;11655;714;2362;1843;5176;2557;7538
310120;201804;648;1698;434;1332;72;276;194;511;266;787
310130;201804;370;1071;312;969;54;206;173;478;227;684
310140;201804;200;647;150;553;41;182;41;127;82;309
310150;201804;4451;13056;3538;11245;723;2472;1234;3833;1957;6305
310160;201804;6731;19191;5259;16562;1327;4548;1313;4009;2640;8557
310163;201804;1038;3129;851;2793;253;919;232;689;485;1608
310170;201804;8864;23807;7423;21588;772;2307;5117;14904;5889;17211
310180;201804;1655;4451;1352;3979;113;424;919;2594;1032;3018
310190;201804;2987;9348;2525;8451;623;2273;311;1003;934;3276
310200;201804;1703;5349;1342;4601;252;950;503;1671;755;2621
310205;201804;1110;3149;844;2747;106;340;491;1648;597;1988
310210;201804;2752;7388;2283;6673;108;345;1705;4925;1813;5270
310220;201804;1060;2971;880;2682;98;343;629;1853;727;2196
310230;201804;2299;6688;1924;5935;236;889;1129;3244;1365;4133
310240;201804;858;2935;758;2748;72;322;514;1822;586;2144
310250;201804;939;2744;804;2510;75;303;541;1599;616;1902
310260;201804;2677;7847;1793;6168;458;1794;285;744;743;2538
310270;201804;2660;6957;2104;6187;132;528;1675;4799;1807;5327
310280;201804;2292;5655;1818;4943;211;678;1132;2940;1343;3618
310285;201804;1891;6421;1658;6018;188;795;1017;3719;1205;4514
310290;201804;1105;3115;980;2891;210;715;521;1387;731;2102
310300;201804;1476;4735;1352;4521;244;976;683;2124;927;3100
310310;201804;316;813;218;644;31;90;116;347;147;437
310320;201804;490;1310;313;983;27;108;160;473;187;581
310330;201804;505;1223;310;868;32;102;130;321;162;423
310340;201804;7869;22288;6314;19627;1128;3409;3012;9754;4140;13163
310350;201804;12069;30698;8440;24741;2035;6462;2517;7165;4552;13627
310360;201804;460;1187;384;1088;12;39;297;821;309;860
310370;201804;1305;4245;1110;3863;225;840;397;1389;622;2229
310375;201804;1007;2669;667;2109;109;366;257;803;366;1169
310380;201804;372;898;200;595;38;111;69;186;107;297
310390;201804;441;1429;371;1287;95;347;79;227;174;574
310400;201804;9246;24134;6696;20023;1178;3904;2942;8487;4120;12391
310410;201804;727;2218;478;1756;126;498;105;360;231;858
310420;201804;3920;10586;2561;7832;501;1717;582;1560;1083;3277
310430;201804;1332;3914;895;3050;190;697;213;676;403;1373
310440;201804;574;1507;401;1193;30;121;221;638;251;759
310445;201804;1342;4036;1005;3382;62;235;708;2354;770;2589
310450;201804;4650;12231;3527;10461;229;781;2638;7767;2867;8548
310460;201804;1689;4669;1188;3721;240;814;320;985;560;1799
310470;201804;3891;8617;3141;7630;288;871;2475;5845;2763;6716
310480;201804;1159;3173;841;2609;153;511;452;1349;605;1860
310490;201804;2942;8824;2375;7732;418;1611;1038;3152;1456;4763
310500;201804;1464;4327;1074;3568;211;745;466;1516;677;2261
310510;201804;1742;5046;1247;4074;297;1049;293;950;590;1999
310520;201804;1383;3490;1004;2865;122;345;586;1681;708;2026
310530;201804;860;2426;450;1456;67;239;66;174;133;413
310540;201804;3287;9837;2753;8876;712;2393;1034;3204;1746;5597
310550;201804;1216;3225;884;2663;99;382;548;1550;647;1932
310560;201804;13489;38233;10719;33408;2392;8283;3656;10429;6048;18712
310570;201804;1122;3197;925;2870;109;423;605;1797;714;2220
310590;201804;4153;11653;3449;10424;385;1312;1979;5796;2364;7108
310600;201804;1462;4500;1209;3947;182;633;542;1657;724;2290
310610;201804;502;1433;343;1148;56;231;163;498;219;729
310620;201804;150605;414590;115602;350638;25005;84778;41407;111882;66412;196660
310630;201804;4466;12750;3778;11505;318;1127;2600;7725;2918;8852
310640;201804;999;3140;832;2801;203;737;247;781;450;1518
310650;201804;2496;7536;1878;6369;222;816;1031;3411;1253;4227
310660;201804;1258;3579;1080;3361;56;180;857;2630;913;2810
310665;201804;1273;3599;1068;3289;51;185;851;2627;902;2812
310670;201804;45497;127436;38353;114302;6523;21256;20538;58410;27061;79666
310680;201804;674;1728;572;1585;32;94;443;1209;475;1303
310690;201804;1605;4600;1231;3966;146;568;672;2050;818;2618
310700;201804;516;1182;384;1021;45;137;262;680;307;817
310710;201804;5397;16551;3992;14427;885;3744;418;1444;1303;5188
310720;201804;837;2252;702;2064;80;272;490;1407;570;1679
310730;201804;8890;25998;7750;24078;643;2342;5224;15988;5867;18330
310740;201804;5134;15139;3676;12137;702;2485;918;2904;1620;5389
310750;201804;1326;3306;941;2752;154;511;388;1056;542;1567
310760;201804;532;1510;411;1293;48;170;173;549;221;719
310770;201804;1068;3028;722;2500;107;399;341;1144;448;1543
310780;201804;3966;10334;3217;9115;196;579;2260;6317;2456;6896
310790;201804;1902;6037;1685;5625;335;1114;743;2630;1078;3744
310800;201804;2378;7401;1763;6154;457;1881;114;359;571;2240
310810;201804;1130;3000;931;2641;75;257;587;1600;662;1857
310820;201804;1113;3116;744;2415;159;558;199;621;358;1179
310825;201804;2804;9348;2318;8504;97;577;1832;6536;1929;7113
310830;201804;1371;4205;1066;3610;249;943;393;1254;642;2197
310840;201804;2030;5725;1412;4600;316;1128;337;988;653;2116
310850;201804;1474;4172;1281;3913;73;338;993;2899;1066;3237
310855;201804;3167;8782;2535;7812;238;870;1798;5437;2036;6307
310860;201804;6861;20427;5600;17958;524;1804;3469;11132;3993;12936
310870;201804;1038;2572;779;2173;111;323;512;1416;623;1739
310880;201804;997;3041;803;2657;103;364;476;1546;579;1910
310890;201804;2352;6818;1655;5570;397;1486;243;708;640;2194
310900;201804;4494;13031;3382;10873;579;2087;1432;4248;2011;6335
310910;201804;1692;4591;1029;3293;136;495;140;368;276;863
310920;201804;1832;5110;1424;4432;242;794;745;2299;987;3093
310925;201804;963;2888;816;2634;126;449;529;1662;655;2111
310930;201804;5761;15842;4311;13483;759;2522;2255;7233;3014;9755
310940;201804;6158;16217;4958;14410;417;1385;3339;9498;3756;10883
310945;201804;1241;3413;1054;3143;98;344;660;1911;758;2255
310950;201804;1918;5837;1365;4648;291;1128;441;1369;732;2497
310960;201804;749;1916;445;1350;66;223;140;442;206;665
310970;201804;1151;3567;824;2873;203;768;199;650;402;1418
310980;201804;376;877;232;646;23;66;148;389;171;455
310990;201804;1220;3649;945;3071;196;661;362;1139;558;1800
311000;201804;4014;11711;3123;10226;889;3136;1141;3608;2030;6744
311010;201804;749;2405;640;2155;240;866;216;701;456;1567
311020;201804;986;2681;688;2119;91;321;306;878;397;1199
311030;201804;1520;4047;1028;3163;291;1008;309;826;600;1834
311040;201804;342;1108;274;939;66;222;67;205;133;427
311050;201804;2244;6307;1824;5610;436;1482;679;1987;1115;3469
311060;201804;2608;7298;1803;5583;285;1026;677;1860;962;2886
311070;201804;1736;4963;1310;4206;200;756;585;1761;785;2517
311080;201804;904;2394;743;2107;78;281;478;1254;556;1535
311090;201804;1993;6722;1590;5969;420;1742;469;1734;889;3476
311100;201804;1987;6074;1363;4802;349;1391;172;536;521;1927
311110;201804;3150;7211;2061;5637;480;1402;858;2357;1338;3759
311115;201804;1211;3334;1001;3029;71;272;754;2226;825;2498
311120;201804;6678;18257;4960;15048;929;3178;1572;4251;2501;7429
311130;201804;1922;5505;1548;4926;168;668;774;2347;942;3015
311140;201804;1285;3292;947;2819;65;214;604;1849;669;2063
311150;201804;1496;4975;1267;4527;195;764;688;2400;883;3164
311160;201804;3702;11497;2707;9657;824;3229;612;2095;1436;5324
311170;201804;824;2309;642;2003;41;146;391;1237;432;1383
311180;201804;1236;3032;824;2391;190;613;319;902;509;1515
311190;201804;1079;3002;802;2480;133;489;308;859;441;1348
311200;201804;1664;4808;1243;3960;345;1183;238;689;583;1872
311205;201804;914;2910;765;2615;68;293;423;1413;491;1706
311210;201804;965;2981;864;2848;132;413;614;2078;746;2491
311220;201804;738;2220;613;1969;103;363;280;827;383;1190
311230;201804;7816;24480;5917;20456;1185;4319;1852;6620;3037;10939
311240;201804;913;2667;733;2387;150;548;388;1225;538;1773
311250;201804;814;2413;666;2164;153;525;289;904;442;1429
311260;201804;2271;5771;1558;4604;315;997;531;1461;846;2458
311265;201804;1196;3276;929;2838;72;273;618;1833;690;2106
311270;201804;3139;9655;2746;9057;200;935;1952;6135;2152;7070
311280;201804;1186;3254;604;1960;104;372;106;318;210;690
311290;201804;1882;5958;1757;5677;191;622;1189;3834;1380;4456
311300;201804;4490;13424;3802;12286;198;963;2954;9337;3152;10300
311310;201804;639;1947;543;1757;96;331;195;578;291;909
311320;201804;3142;10101;2777;9266;431;1637;1207;3717;1638;5354
311330;201804;4572;12948;3951;11891;484;1596;2164;6613;2648;8209
311340;201804;10604;32242;8667;28491;2472;8591;2026;6757;4498;15348
311350;201804;2158;5782;1620;4781;172;567;830;2251;1002;2818
311360;201804;873;2440;711;2215;312;1066;143;441;455;1507
311370;201804;4167;11234;3217;9585;265;1048;1870;5211;2135;6259
311380;201804;421;1346;336;1166;85;294;108;396;193;690
311390;201804;1706;5652;1424;5248;597;2499;354;1136;951;3635
311400;201804;1417;4202;1035;3412;158;601;406;1200;564;1801
311410;201804;1557;4993;1342;4703;273;1056;646;2269;919;3325
311420;201804;1656;5204;1130;3987;196;735;139;376;335;1111
311430;201804;3359;9558;2291;7339;395;1329;598;1930;993;3259
311440;201804;2391;7286;1718;6000;450;1783;435;1467;885;3250
311450;201804;1796;5748;1352;4862;342;1352;275;862;617;2214
311455;201804;940;2339;664;1890;179;501;212;605;391;1106
311460;201804;550;1803;388;1463;87;420;100;333;187;753
311470;201804;440;1444;331;1184;72;294;53;169;125;463
311480;201804;907;2571;772;2382;76;212;537;1718;613;1930
311490;201804;216;714;185;634;47;176;72;225;119;401
311500;201804;424;1137;315;949;41;139;168;505;209;644
311510;201804;2683;7777;1901;6290;416;1569;501;1585;917;3154
311520;201804;568;1755;523;1662;127;447;261;789;388;1236
311530;201804;9080;22369;6045;17290;1443;4612;1527;4238;2970;8850
311535;201804;749;2100;503;1645;104;405;121;376;225;781
311540;201804;534;1763;485;1672;125;424;231;820;356;1244
311545;201804;2072;5934;1761;5521;101;419;1316;4030;1417;4449
311547;201804;1513;4025;1307;3696;42;143;1006;2858;1048;3001
311550;201804;2699;8019;2154;6948;388;1426;764;2333;1152;3759
311560;201804;251;597;188;519;32;92;98;242;130;334
311570;201804;1893;4618;1414;3948;51;149;1139;3269;1190;3418
311580;201804;2238;4274;1515;3428;211;407;946;2250;1157;2657
311590;201804;501;1446;415;1316;78;291;203;612;281;903
311600;201804;1436;3716;1191;3402;80;255;969;2732;1049;2987
311610;201804;2418;8392;2093;7646;445;1599;922;3424;1367;5023
311615;201804;2976;9066;2445;8198;178;737;1806;5964;1984;6701
311620;201804;394;1138;346;1062;21;86;268;801;289;887
311630;201804;1346;3818;1093;3336;83;273;752;2228;835;2501
311640;201804;563;1753;461;1551;95;365;191;614;286;979
311650;201804;1982;5426;1692;4971;157;570;1118;3146;1275;3716
311660;201804;2850;8521;2088;7050;422;1547;394;1147;816;2694
311670;201804;1537;4137;1206;3610;194;657;540;1656;734;2313
311680;201804;2079;6210;1625;5385;249;882;999;3279;1248;4161
311690;201804;552;1248;441;1115;29;76;333;866;362;942
311700;201804;2253;5601;1742;4901;40;150;1415;3897;1455;4047
311710;201804;1491;4467;1042;3579;277;1020;323;1128;600;2148
311720;201804;401;1267;330;1129;39;163;174;571;213;734
311730;201804;4684;11797;2794;8371;859;2854;361;1026;1220;3880
311740;201804;755;2294;699;2213;41;119;623;1999;664;2118
311750;201804;3923;12171;3268;11075;397;1579;1917;6230;2314;7809
311760;201804;629;1978;541;1795;105;409;175;492;280;901
311770;201804;1923;5901;1512;5100;309;1132;528;1665;837;2797
311780;201804;1211;3855;913;3205;186;746;237;722;423;1468
311783;201804;2066;6259;1735;5658;58;275;1419;4543;1477;4818
311787;201804;707;2140;510;1673;73;271;190;542;263;813
311790;201804;1523;4101;1021;3222;238;832;347;1075;585;1907
311800;201804;5047;16078;4232;14205;825;3026;597;1820;1422;4846
311810;201804;981;3131;799;2772;62;258;467;1611;529;1869
311820;201804;717;1972;570;1700;86;315;339;942;425;1257
311830;201804;8218;24948;5872;19714;1494;5405;568;1838;2062;7243
311840;201804;2904;8189;2505;7592;335;1127;1660;4997;1995;6124
311850;201804;299;875;250;795;25;83;156;486;181;569
311860;201804;51192;137580;40917;120616;6634;20757;22656;65269;29290;86026
311870;201804;1927;5432;1347;4313;252;924;487;1377;739;2301
311880;201804;6084;16898;5291;15764;378;1079;4024;12104;4402;13183
311890;201804;1412;3809;1136;3372;147;483;683;1951;830;2434
311900;201804;694;1897;541;1664;52;191;369;1109;421;1300
311910;201804;4257;11372;3267;10067;668;2122;1542;4818;2210;6940
311920;201804;1941;5760;1594;5177;175;614;924;2979;1099;3593
311930;201804;3134;8250;2481;7257;963;2992;689;1868;1652;4860
311940;201804;13375;37760;10249;31645;1643;5578;4233;12304;5876;17882
311950;201804;2172;6212;1655;5321;105;453;1143;3572;1248;4025
311960;201804;567;1407;472;1258;39;174;320;721;359;895
311970;201804;436;1450;287;1058;51;216;58;191;109;407
311980;201804;465;1311;276;927;37;136;81;263;118;399
311990;201804;510;1296;355;1076;100;351;135;380;235;731
311995;201804;987;2853;542;1800;28;103;52;111;80;214
312000;201804;553;1567;480;1455;34;109;349;1071;383;1180
312010;201804;877;2717;698;2342;76;273;382;1256;458;1529
312015;201804;1298;4031;1163;3784;85;364;861;2690;946;3054
312020;201804;1114;3522;968;3260;212;758;379;1253;591;2011
312030;201804;1976;5166;1739;4891;38;180;1591;4407;1629;4587
312040;201804;744;2457;581;2102;84;337;220;759;304;1096
312050;201804;1221;4080;979;3571;243;1018;240;767;483;1785
312060;201804;794;2166;580;1875;132;441;273;883;405;1324
312070;201804;878;2646;625;2115;80;300;325;1060;405;1360
312080;201804;2705;6957;2017;5902;164;562;1231;3393;1395;3955
312083;201804;909;2466;708;2150;85;285;462;1350;547;1635
312087;201804;2173;6093;1881;5674;85;306;1474;4476;1559;4782
312090;201804;9061;25767;7090;22377;1573;5274;2874;8976;4447;14250
312100;201804;1510;4669;1085;3877;132;580;515;1746;647;2326
312110;201804;995;3300;845;2976;250;977;206;653;456;1630
312120;201804;662;1961;500;1666;136;516;168;487;304;1003
312125;201804;1280;3747;1140;3531;152;478;817;2526;969;3004
312130;201804;847;2232;649;1880;71;223;271;742;342;965
312140;201804;790;2458;654;2146;147;518;244;737;391;1255
312150;201804;466;1355;399;1196;15;63;265;743;280;806
312160;201804;7690;23499;6146;20517;1068;4059;2492;7827;3560;11886
312170;201804;835;2342;676;2059;36;115;462;1367;498;1482
312180;201804;1374;3994;1126;3496;169;588;549;1605;718;2193
312190;201804;528;1646;385;1335;96;365;68;239;164;604
312200;201804;4682;13066;3844;11590;753;2327;2101;6307;2854;8634
312210;201804;1288;3174;947;2683;81;294;637;1729;718;2023
312220;201804;1945;6175;1728;5825;149;523;1167;3955;1316;4478
312230;201804;11107;31460;7729;25056;2251;8048;1033;3012;3284;11060
312235;201804;1581;4472;1345;4137;125;430;945;2863;1070;3293
312240;201804;743;2456;575;2086;129;516;145;507;274;1023
312245;201804;2439;6677;2102;6204;77;292;1731;5080;1808;5372
312247;201804;820;2229;601;1880;151;494;273;876;424;1370
312250;201804;1002;2670;688;2084;124;389;265;782;389;1171
312260;201804;915;2688;734;2395;60;233;511;1612;571;1845
312270;201804;679;1957;538;1679;35;160;282;801;317;961
312280;201804;423;1310;340;1143;111;380;38;121;149;501
312290;201804;739;2362;631;2160;117;438;211;703;328;1141
312300;201804;872;2695;631;2105;156;573;87;229;243;802
312310;201804;770;2657;665;2441;111;478;284;998;395;1476
312320;201804;1904;5170;1433;4320;415;1352;279;795;694;2147
312330;201804;873;2560;736;2347;80;281;518;1616;598;1897
312340;201804;272;725;204;616;33;109;102;298;135;407
312350;201804;258;593;220;555;26;76;160;391;186;467
312352;201804;1615;4861;1400;4491;148;470;903;3059;1051;3529
312360;201804;2627;8152;2029;6847;439;1616;456;1470;895;3086
312370;201804;1707;4907;1443;4432;299;1027;656;1902;955;2929
312380;201804;2118;5176;1816;4784;29;75;1620;4298;1649;4373
312385;201804;1242;3545;1015;3139;159;568;569;1662;728;2230
312390;201804;1957;5923;1503;5063;291;1083;443;1348;734;2431
312400;201804;2937;8952;2328;7765;809;2826;612;2084;1421;4910
312410;201804;11222;33389;9350;30002;1826;6167;4378;13831;6204;19998
312420;201804;3639;10815;3249;10089;580;1935;1743;5324;2323;7259
312430;201804;7940;21967;6537;19477;638;2055;4361;12872;4999;14927
312440;201804;917;2922;700;2420;321;1177;82;254;403;1431
312450;201804;1129;3573;868;3050;255;946;297;1070;552;2016
312460;201804;399;1065;288;905;49;173;161;520;210;693
312470;201804;509;1350;325;1019;58;221;107;296;165;517
312480;201804;1199;3011;817;2499;111;371;470;1404;581;1775
312490;201804;1951;4997;1516;4316;250;746;816;2259;1066;3005
312500;201804;821;2176;662;1947;70;251;417;1189;487;1440
312510;201804;3689;10353;2837;8693;501;1539;1193;3568;1694;5107
312520;201804;178;535;151;495;41;134;65;214;106;348
312530;201804;581;1609;505;1509;29;100;420;1260;449;1360
312540;201804;1420;4237;931;3158;201;730;379;1277;580;2007
312550;201804;746;2163;591;1793;58;186;344;953;402;1139
312560;201804;1956;5195;1629;4734;73;282;1307;3737;1380;4019
312570;201804;2241;6064;1740;5319;515;1646;628;1956;1143;3602
312580;201804;542;1657;425;1393;50;195;181;564;231;759
312590;201804;1645;5104;1372;4553;152;643;726;2256;878;2899
312595;201804;1654;5345;1513;5054;267;860;905;3128;1172;3988
312600;201804;920;2486;576;1957;84;346;223;733;307;1079
312610;201804;6277;16612;4202;12818;782;2606;1059;3078;1841;5684
312620;201804;2389;6337;1750;5444;63;266;1343;4270;1406;4536
312630;201804;249;805;212;736;43;165;83;291;126;456
312640;201804;603;1693;401;1334;53;177;133;448;186;625
312650;201804;2071;5616;1421;4322;114;412;916;2643;1030;3055
312660;201804;1366;3433;1055;2957;106;355;701;1885;807;2240
312670;201804;5064;14058;4125;12691;374;1496;2665;7883;3039;9379
312675;201804;1280;3691;1041;3257;82;348;791;2407;873;2755
312680;201804;1338;3922;1146;3637;81;345;864;2661;945;3006
312690;201804;2243;5608;1777;4982;150;462;1297;3538;1447;4000
312695;201804;925;2842;811;2636;78;240;599;1977;677;2217
312700;201804;1967;5521;1446;4551;148;504;818;2526;966;3030
312705;201804;1273;3465;1049;3088;40;143;805;2323;845;2466
312707;201804;1391;4332;1069;3701;94;435;615;2025;709;2460
312710;201804;6377;14909;3731;10867;1101;3501;804;2429;1905;5930
312720;201804;986;2874;747;2460;89;347;372;1159;461;1506
312730;201804;1587;3923;1233;3464;65;207;827;2294;892;2501
312733;201804;1526;4078;1179;3440;40;130;770;2170;810;2300
312735;201804;695;1912;596;1730;83;294;395;1045;478;1339
312737;201804;760;1897;541;1560;97;316;265;719;362;1035
312738;201804;546;1544;374;1209;66;251;158;479;224;730
312740;201804;359;906;207;665;57;199;43;105;100;304
312750;201804;1248;4136;1065;3777;178;728;517;1737;695;2465
312760;201804;1839;5710;1347;4667;257;930;395;1341;652;2271
312770;201804;39539;101779;26789;79781;6346;20004;7811;22661;14157;42665
312780;201804;2466;8051;2148;7480;243;969;1320;4589;1563;5558
312790;201804;286;746;185;602;21;90;73;209;94;299
312800;201804;4755;14565;3728;12420;799;2946;1411;4561;2210;7507
312810;201804;1815;5192;1211;4073;288;1074;326;975;614;2049
312820;201804;1852;5149;1540;4597;70;272;1062;3053;1132;3325
312825;201804;1270;3215;1108;3010;38;123;919;2498;957;2621
312830;201804;2332;6935;1570;5426;381;1433;322;1094;703;2527
312840;201804;1118;3526;872;2996;155;610;280;866;435;1476
312850;201804;807;2219;590;1855;70;267;276;812;346;1079
312860;201804;1420;3705;927;2894;237;783;234;698;471;1481
312870;201804;5862;17281;3766;12735;598;2271;980;3030;1578;5301
312880;201804;1380;3721;1131;3352;57;178;697;2151;754;2329
312890;201804;2002;5616;1322;4240;202;673;495;1616;697;2289
312900;201804;1148;3234;945;2954;83;283;599;1916;682;2199
312910;201804;1584;3029;883;2103;136;339;420;981;556;1320
312920;201804;912;2676;682;2270;129;497;316;977;445;1474
312930;201804;2084;5688;1704;5094;390;1205;739;2192;1129;3397
312940;201804;864;2662;739;2433;136;464;335;1089;471;1553
312950;201804;2567;6945;1923;5924;603;1948;585;1809;1188;3757
312960;201804;1930;5265;1632;4828;117;340;1211;3653;1328;3993
312965;201804;1734;5291;1459;4762;103;357;940;3052;1043;3409
312970;201804;1039;3179;797;2768;191;746;294;969;485;1715
312980;201804;20663;61700;17707;56263;3212;11381;8804;26602;12016;37983
312990;201804;427;1223;286;988;70;284;116;389;186;673
313000;201804;424;1328;343;1180;53;238;144;451;197;689
313005;201804;2554;7645;2221;7079;173;639;1595;4960;1768;5599
313010;201804;4318;12792;3529;11408;686;2434;1951;6132;2637;8566
313020;201804;915;2940;631;2259;97;405;80;225;177;630
313030;201804;1282;3239;883;2615;116;416;466;1327;582;1743
313040;201804;780;2519;652;2222;65;266;332;1063;397;1329
313050;201804;1775;5223;1277;4451;248;1029;356;1097;604;2126
313055;201804;1690;4957;1532;4716;49;162;1333;4092;1382;4254
313060;201804;943;2587;671;2116;214;740;125;342;339;1082
313065;201804;1800;5658;1547;5257;108;446;1154;3887;1262;4333
313070;201804;842;2363;684;2090;102;340;365;1077;467;1417
313080;201804;385;1115;281;901;69;247;72;185;141;432
313090;201804;4687;13231;3975;12016;993;3215;1962;5864;2955;9079
313100;201804;1426;3803;1100;3313;59;206;843;2543;902;2749
313110;201804;1523;4187;1078;3356;114;432;532;1521;646;1953
313115;201804;2395;7485;2123;6930;342;1208;1050;3218;1392;4426
313120;201804;3659;8957;2845;7904;296;903;1818;5055;2114;5958
313130;201804;26449;74941;21486;65290;3281;11148;10502;30208;13783;41356
313140;201804;519;1269;353;1007;20;72;244;678;264;750
313150;201804;1268;3814;994;3273;280;970;244;769;524;1739
313160;201804;927;2531;720;2175;64;219;450;1310;514;1529
313170;201804;11434;35586;8219;28816;1608;5876;2658;9015;4266;14891
313180;201804;2235;6144;1593;4854;239;799;766;2258;1005;3057
313190;201804;4054;12452;3057;10290;589;2082;898;2838;1487;4920
313200;201804;1094;3240;935;2944;38;145;762;2339;800;2484
313210;201804;3891;11713;3154;10378;474;1709;1734;5541;2208;7250
313220;201804;1664;4650;1164;3663;199;727;437;1220;636;1947
313230;201804;2591;8117;2361;7812;80;239;2055;6858;2135;7097
313240;201804;8429;23232;5683;18327;1093;3921;2193;6586;3286;10507
313250;201804;6190;18982;5090;16918;606;2178;2580;8458;3186;10636
313260;201804;628;1739;429;1330;58;222;182;542;240;764
313270;201804;5450;15563;4349;13696;845;2769;2401;7598;3246;10367
313280;201804;370;1127;266;913;43;163;89;284;132;447
313290;201804;738;2473;587;2242;233;962;127;454;360;1416
313300;201804;1647;4960;1274;4195;344;1218;203;588;547;1806
313310;201804;1010;3238;854;2917;155;605;193;545;348;1150
313320;201804;2168;5963;1524;4928;305;1107;669;2153;974;3260
313330;201804;3921;11276;3189;10077;232;1008;2119;6437;2351;7445
313340;201804;1411;3315;1006;2724;150;413;624;1718;774;2131
313350;201804;2179;6468;1577;5191;238;860;535;1631;773;2491
313360;201804;1265;3391;886;2729;155;579;452;1283;607;1862
313370;201804;1238;3828;1119;3596;150;562;628;1909;778;2471
313375;201804;1822;4874;1210;3836;217;805;316;940;533;1745
313380;201804;5369;14559;3987;12009;824;2735;1627;4452;2451;7187
313390;201804;870;2902;785;2754;61;265;515;1757;576;2022
313400;201804;3500;9326;2892;8530;195;571;2303;6756;2498;7327
313410;201804;1226;3326;994;2956;113;382;708;2063;821;2445
313420;201804;15586;36388;8768;24886;1805;5662;1214;3518;3019;9180
313430;201804;880;2665;667;2232;106;427;265;781;371;1208
313440;201804;5939;13283;3949;10719;326;909;2499;6841;2825;7750
313450;201804;610;1767;454;1457;100;338;134;382;234;720
313460;201804;2079;6435;1690;5797;403;1630;720;2251;1123;3881
313470;201804;3060;7778;2504;7019;220;600;1795;5071;2015;5671
313480;201804;872;2573;536;1822;80;308;147;426;227;734
313490;201804;1437;3484;722;2405;240;949;56;185;296;1134
313500;201804;404;1282;325;1084;39;143;122;369;161;512
313505;201804;9008;25549;8024;24312;328;1162;6917;20964;7245;22126
313507;201804;1445;3778;1230;3480;59;217;964;2701;1023;2918
313510;201804;12790;36562;10768;32950;1398;4711;5453;16235;6851;20946
313520;201804;13203;39640;10937;35578;882;3249;7513;24079;8395;27328
313530;201804;520;1526;430;1375;23;78;204;619;227;697
313535;201804;2443;6887;2146;6341;172;480;1476;4325;1648;4805
313540;201804;848;2649;639;2084;149;507;210;668;359;1175
313545;201804;1170;4065;1009;3739;174;696;555;1978;729;2674
313550;201804;1758;5398;1494;4862;348;1210;718;2252;1066;3462
313560;201804;2476;5183;1840;4421;83;204;1530;3641;1613;3845
313570;201804;940;3000;763;2639;186;705;304;1004;490;1709
313580;201804;5466;15206;4282;13286;668;2196;2226;7161;2894;9357
313590;201804;915;2667;703;2338;270;988;219;734;489;1722
313600;201804;3676;10467;3094;9528;171;666;2424;7367;2595;8033
313610;201804;986;2708;809;2379;118;349;500;1453;618;1802
313620;201804;5561;15775;4584;14045;906;3015;2077;6186;2983;9201
313630;201804;8050;21002;5688;17447;825;2801;2868;8896;3693;11697
313640;201804;1010;2480;636;1948;195;665;209;596;404;1261
313650;201804;1808;5671;1534;5223;105;444;1006;3424;1111;3868
313652;201804;784;2709;731;2596;128;501;435;1477;563;1978
313655;201804;1001;2914;811;2627;56;209;582;1854;638;2063
313657;201804;1309;3622;1004;3126;57;254;732;2139;789;2393
313660;201804;827;2534;698;2269;120;473;349;1050;469;1523
313665;201804;4373;12694;3510;11082;538;1920;1887;5722;2425;7642
313670;201804;41880;113744;28840;89505;5474;18438;10234;30247;15708;48685
313680;201804;997;2798;853;2575;79;267;530;1557;609;1824
313690;201804;802;2741;654;2421;134;509;207;792;341;1301
313695;201804;1555;4595;1232;4039;97;374;861;2800;958;3174
313700;201804;3192;10692;2753;10111;266;992;2159;8014;2425;9006
313710;201804;1419;3640;1031;3041;105;323;635;1869;740;2192
313720;201804;5468;16145;4056;13129;689;2496;1468;4337;2157;6833
313730;201804;1269;3181;968;2760;77;219;621;1721;698;1940
313740;201804;1749;6332;1457;5569;351;1481;162;543;513;2024
313750;201804;1902;5490;1491;4657;349;1212;513;1454;862;2666
313753;201804;2020;5139;1436;4183;179;582;796;2276;975;2858
313760;201804;4945;14375;3667;11800;873;3043;1275;3860;2148;6903
313770;201804;3568;10498;2902;9507;295;1004;1909;6294;2204;7298
313780;201804;3981;10983;3008;9359;388;1365;850;2701;1238;4066
313790;201804;447;1454;415;1394;72;249;227;738;299;987
313800;201804;1311;3228;1061;2869;67;219;795;2157;862;2376
313810;201804;1578;4305;1294;3887;99;342;918;2778;1017;3120
313820;201804;12488;31627;9104;25688;1431;4576;3599;9530;5030;14106
313830;201804;327;984;284;908;59;207;130;422;189;629
313835;201804;885;2757;760;2533;79;312;413;1307;492;1619
313840;201804;6413;17611;4800;14852;1174;3864;1042;3219;2216;7083
313850;201804;981;2554;818;2287;123;420;438;1096;561;1516
313860;201804;2654;7593;1971;6154;370;1237;671;1937;1041;3174
313862;201804;1448;3401;807;2411;68;213;428;1244;496;1457
313865;201804;2175;6356;1937;5996;159;537;1437;4382;1596;4919
313867;201804;1098;3668;931;3315;293;1097;378;1327;671;2424
313868;201804;1675;5451;1422;4924;112;465;1044;3558;1156;4023
313870;201804;796;2248;611;1923;127;432;203;561;330;993
313880;201804;1376;3914;1069;3398;220;760;401;1137;621;1897
313890;201804;1997;4794;1470;4108;162;498;904;2577;1066;3075
313900;201804;3582;11704;2909;10295;828;3193;664;2329;1492;5522
313910;201804;627;1970;485;1690;120;441;87;297;207;738
313920;201804;2993;9750;2505;8781;501;1773;1264;4513;1765;6286
313925;201804;1703;4548;1312;3812;256;708;744;2184;1000;2892
313930;201804;6010;20684;5092;19061;450;1639;3493;13677;3943;15316
313940;201804;8270;25347;6090;21496;1310;5265;1520;5794;2830;11059
313950;201804;4449;11019;3280;9369;629;2263;1766;4771;2395;7034
313960;201804;5323;13648;3654;10873;794;2546;1201;3388;1995;5934
313970;201804;1307;3852;1159;3604;72;291;702;2187;774;2478
313980;201804;1339;3763;883;2966;137;517;303;976;440;1493
313990;201804;1696;5901;1338;4999;387;1582;375;1276;762;2858
314000;201804;8986;25703;7752;23435;590;2233;5170;15369;5760;17602
314010;201804;1266;3253;1030;2934;47;181;797;2214;844;2395
314015;201804;2066;5868;1618;5162;216;813;874;2718;1090;3531
314020;201804;521;1487;318;1054;60;238;61;195;121;433
314030;201804;800;2492;621;2099;80;295;287;956;367;1251
314040;201804;727;2028;594;1766;105;336;267;758;372;1094
314050;201804;1531;4485;1185;3802;186;687;538;1576;724;2263
314053;201804;1676;5100;1412;4656;193;638;920;3177;1113;3815
314055;201804;2245;6322;1945;5876;55;240;1621;4875;1676;5115
314060;201804;1152;3302;891;2855;53;200;614;1922;667;2122
314070;201804;4236;12262;3334;10575;778;2528;1239;3818;2017;6346
314080;201804;1758;5251;1243;4094;220;851;378;1086;598;1937
314085;201804;2033;6417;1692;5873;395;1467;733;2522;1128;3989
314090;201804;3582;10993;3110;10207;271;1088;2062;6682;2333;7770
314100;201804;3157;7621;2588;6843;60;132;2144;5775;2204;5907
314110;201804;4057;12388;3447;11138;579;2109;1692;5074;2271;7183
314120;201804;841;1970;388;1210;91;336;59;171;150;507
314130;201804;764;2141;396;1343;53;198;135;445;188;643
314140;201804;4691;14049;3613;11831;648;2258;1502;4796;2150;7054
314150;201804;1464;3900;1131;3318;113;354;702;1989;815;2343
314160;201804;2421;6477;1778;5362;254;811;799;2483;1053;3294
314170;201804;1004;2931;823;2567;98;338;474;1386;572;1724
314180;201804;5156;15091;4337;13750;623;2106;2401;7690;3024;9796
314190;201804;735;2079;540;1763;103;365;258;846;361;1211
314200;201804;2846;8346;2390;7526;148;597;1713;5186;1861;5783
314210;201804;1929;5263;1630;4769;141;448;985;2824;1126;3272
314220;201804;1241;3660;891;3007;247;931;241;738;488;1669
314225;201804;1216;3498;1060;3275;74;249;779;2421;853;2670
314230;201804;745;2107;641;1975;116;390;365;1130;481;1520
314240;201804;1062;3063;846;2718;205;731;329;1066;534;1797
314250;201804;523;1521;346;1121;59;203;125;368;184;571
314260;201804;961;3081;793;2744;178;711;323;1015;501;1726
314270;201804;3095;9240;2511;8229;122;498;1851;5929;1973;6427
314280;201804;3311;8098;2072;5969;361;1156;779;2091;1140;3247
314290;201804;4459;12035;3764;10866;496;1454;2387;6803;2883;8257
314300;201804;1488;4650;1133;3848;294;1063;323;1062;617;2125
314310;201804;5182;14240;3823;11822;1189;3935;854;2461;2043;6396
314315;201804;862;3179;755;2938;63;304;532;2010;595;2314
314320;201804;2807;7800;1909;6261;436;1536;690;2260;1126;3796
314330;201804;47736;138126;37700;120979;10964;36892;8693;28325;19657;65217
314340;201804;2421;6290;1307;4140;245;909;231;563;476;1472
314345;201804;1334;4164;1138;3816;140;480;724;2388;864;2868
314350;201804;976;2819;680;2254;139;496;154;484;293;980
314360;201804;647;1969;401;1413;63;253;101;328;164;581
314370;201804;639;1863;532;1676;39;139;388;1188;427;1327
314380;201804;1146;3377;794;2680;212;804;112;375;324;1179
314390;201804;11608;31926;7898;24923;1701;5701;1956;5578;3657;11279
314400;201804;4128;12320;3316;10969;935;3208;1156;3968;2091;7176
314410;201804;2663;7767;1919;6302;332;1204;667;2350;999;3554
314420;201804;744;1954;580;1718;18;96;451;1284;469;1380
314430;201804;6353;17392;4877;14775;981;3145;1716;5186;2697;8331
314435;201804;1440;4344;1235;4005;46;206;915;2920;961;3126
314437;201804;921;2448;710;2145;34;129;410;1243;444;1372
314440;201804;534;1591;414;1365;116;433;123;355;239;788
314450;201804;1374;3908;1148;3535;149;565;651;1870;800;2435
314460;201804;3515;11258;2601;9177;636;2380;404;1406;1040;3786
314465;201804;2213;6613;1951;6095;64;271;1529;4658;1593;4929
314467;201804;898;2562;759;2333;23;71;596;1820;619;1891
314470;201804;2178;6596;1814;5842;381;1330;742;2224;1123;3554
314480;201804;5679;17677;4068;13917;743;2742;876;2717;1619;5459
314490;201804;844;2437;643;2013;94;333;371;1093;465;1426
314500;201804;1709;4574;1215;3724;253;805;402;1204;655;2009
314505;201804;1901;5066;1623;4675;118;409;1177;3336;1295;3745
314510;201804;1691;4602;1163;3824;251;895;455;1475;706;2370
314520;201804;3625;11763;2529;9215;459;1920;251;747;710;2667
314530;201804;5470;18502;5038;17673;535;2041;3414;12052;3949;14093
314535;201804;2576;7022;2131;6357;143;495;1624;4757;1767;5252
314537;201804;1099;3263;836;2805;77;297;558;1826;635;2123
314540;201804;392;1069;271;837;35;130;114;334;149;464
314545;201804;1620;4453;1449;4214;61;183;1213;3674;1274;3857
314550;201804;658;1694;479;1439;54;210;224;603;278;813
314560;201804;3981;12896;3196;11149;541;2054;1025;3373;1566;5427
314570;201804;299;857;233;730;37;124;107;335;144;459
314580;201804;480;1562;355;1292;85;330;50;179;135;509
314585;201804;725;2322;545;1917;79;351;232;752;311;1103
314587;201804;1924;5566;1515;4881;236;701;820;2686;1056;3387
314590;201804;2828;8873;2108;7290;384;1451;680;2233;1064;3684
314600;201804;1745;5184;1082;3830;252;997;113;357;365;1354
314610;201804;7819;22597;5943;19381;1202;4496;2349;7380;3551;11876
314620;201804;1836;4885;1493;4393;71;244;1217;3523;1288;3767
314625;201804;1488;4639;1312;4375;103;517;978;3085;1081;3602
314630;201804;4873;13612;4083;12410;153;654;3293;9923;3446;10577
314640;201804;578;1510;422;1240;82;273;189;501;271;774
314650;201804;944;2477;640;1978;62;228;267;744;329;972
314655;201804;1538;4426;1104;3578;236;749;456;1485;692;2234
314660;201804;320;793;206;574;13;30;113;301;126;331
314670;201804;1621;4097;1180;3378;74;272;736;2055;810;2327
314675;201804;1766;4948;1521;4521;118;422;1130;3282;1248;3704
314690;201804;2060;6278;1575;5430;489;1871;338;1127;827;2998
314700;201804;9462;29027;6310;22269;1428;5604;1275;4307;2703;9911
314710;201804;7992;23407;5720;18498;1139;4021;1184;3385;2323;7406
314720;201804;2181;6890;1627;5690;363;1377;398;1374;761;2751
314730;201804;1999;5822;1504;4876;380;1313;419;1263;799;2576
314740;201804;2765;8263;2267;7359;243;908;1231;3907;1474;4815
314750;201804;337;980;260;822;25;89;145;440;170;529
314760;201804;1833;5804;1285;4504;194;774;295;846;489;1620
314770;201804;1033;3130;522;1781;41;149;126;370;167;519
314780;201804;329;823;223;665;47;160;112;313;159;473
314790;201804;10281;29883;7585;24868;2438;8904;1105;3185;3543;12089
314795;201804;1445;4065;1240;3711;61;262;959;2750;1020;3012
314800;201804;11121;29859;6717;21253;1426;4843;981;2794;2407;7637
314810;201804;9381;26907;7010;22654;1871;6178;1866;6504;3737;12682
314820;201804;895;2376;655;1971;91;330;358;1026;449;1356
314830;201804;1511;4825;1293;4405;304;1114;599;2016;903;3130
314840;201804;904;2993;720;2707;78;409;465;1663;543;2072
314850;201804;1942;5088;1541;4438;88;319;1240;3517;1328;3836
314860;201804;3184;10090;2695;9110;418;1535;1554;5120;1972;6655
314870;201804;5849;16420;4690;14794;417;1399;3410;10817;3827;12216
314875;201804;1700;5342;1554;5154;96;285;1329;4443;1425;4728
314880;201804;899;2256;707;1995;35;78;498;1476;533;1554
314890;201804;455;1336;333;1076;54;205;118;337;172;542
314900;201804;660;1804;512;1553;114;369;178;536;292;905
314910;201804;1642;4998;1268;4388;273;1129;602;1956;875;3085
314915;201804;2238;6953;1919;6372;142;579;1290;4150;1432;4729
314920;201804;456;1185;314;991;17;57;188;578;205;635
314930;201804;5250;16070;4099;13756;873;3140;1334;4270;2207;7410
314940;201804;391;1077;337;974;37;105;200;540;237;645
314950;201804;383;1064;259;858;30;112;102;316;132;428
314960;201804;743;2041;563;1687;57;210;341;942;398;1152
314970;201804;627;1953;511;1742;99;376;228;751;327;1127
314980;201804;1286;3717;1009;3294;280;1015;181;566;461;1581
314990;201804;2242;6695;1540;5075;348;1291;299;834;647;2125
314995;201804;1529;4555;1288;4151;112;462;770;2355;882;2817
315000;201804;1043;2906;816;2528;86;305;503;1512;589;1817
315010;201804;399;1206;298;995;61;247;111;326;172;573
315015;201804;2113;6299;1917;6027;217;746;1249;4005;1466;4751
315020;201804;825;2486;600;2034;82;323;291;930;373;1253
315030;201804;569;1659;419;1366;115;406;85;246;200;652
315040;201804;822;2445;738;2279;114;373;451;1379;565;1752
315050;201804;1127;3110;887;2765;84;311;476;1470;560;1781
315053;201804;1122;3161;891;2727;92;339;497;1477;589;1816
315057;201804;1606;5292;1413;4894;196;686;848;2959;1044;3645
315060;201804;616;1954;418;1529;93;351;81;301;174;652
315070;201804;634;1800;460;1464;126;430;126;370;252;800
315080;201804;2600;8193;2058;6981;453;1531;909;3101;1362;4632
315090;201804;794;2599;618;2212;114;428;186;634;300;1062
315100;201804;1147;3691;767;2736;138;578;282;911;420;1489
315110;201804;1391;3778;1086;3252;146;456;516;1562;662;2018
315120;201804;11921;28611;8580;23848;1113;3156;4356;12677;5469;15833
315130;201804;1253;3880;1033;3415;183;702;382;1183;565;1885
315140;201804;2800;8158;2196;7020;428;1554;996;2868;1424;4422
315150;201804;4151;10812;2974;8818;475;1566;1244;3596;1719;5162
315160;201804;1462;3793;972;2989;198;633;381;1145;579;1778
315170;201804;1489;4740;1054;3726;228;840;158;554;386;1394
315180;201804;16953;44775;9054;28609;1384;4932;2003;5552;3387;10484
315190;201804;2018;4846;1613;4271;292;805;1084;2835;1376;3640
315200;201804;3607;11167;2753;9568;821;3086;601;2033;1422;5119
315210;201804;7807;21707;5841;17432;762;2505;2497;6871;3259;9376
315213;201804;1111;3117;963;2903;30;95;765;2290;795;2385
315217;201804;2420;7897;1962;7042;132;660;1294;4471;1426;5131
315220;201804;8638;24386;6990;21507;2045;6619;2143;6526;4188;13145
315230;201804;3027;7645;2652;7203;79;142;2362;6669;2441;6811
315240;201804;2571;7976;2230;7396;579;2059;1085;3514;1664;5573
315250;201804;9834;28438;7485;23990;1359;4741;2970;9240;4329;13981
315260;201804;933;2789;545;1890;91;331;48;133;139;464
315270;201804;753;2327;533;1868;91;394;140;411;231;805
315280;201804;2705;7243;1594;4961;373;1229;244;734;617;1963
315290;201804;1218;3196;750;2431;219;763;183;603;402;1366
315300;201804;699;1768;480;1484;229;765;110;358;339;1123
315310;201804;1296;3832;994;3232;92;326;557;1733;649;2059
315320;201804;672;2002;497;1688;56;273;216;673;272;946
315330;201804;732;2622;410;1696;76;342;103;386;179;728
315340;201804;3151;8315;2411;7222;248;810;1393;4105;1641;4915
315350;201804;1541;4284;1145;3613;105;366;550;1703;655;2069
315360;201804;1645;5174;1221;4228;213;798;429;1409;642;2207
315370;201804;442;1350;363;1180;63;201;162;517;225;718
315380;201804;187;599;144;502;33;133;36;111;69;244
315390;201804;1176;3629;872;2982;167;597;270;876;437;1473
315400;201804;4078;11818;3236;10225;463;1523;1663;5148;2126;6671
315410;201804;2282;5412;1786;4723;392;1155;652;1675;1044;2830
315415;201804;1167;3473;959;3144;265;982;360;1155;625;2137
315420;201804;1132;3427;781;2721;164;582;101;311;265;893
315430;201804;3501;9024;2531;7447;603;2027;879;2422;1482;4449
315440;201804;967;2731;815;2473;101;380;433;1203;534;1583
315445;201804;1989;5151;1497;4384;162;506;981;2839;1143;3345
315450;201804;2220;6635;1919;6143;271;844;1196;3910;1467;4754
315460;201804;29645;90778;25554;82916;7513;25905;8043;24845;15556;50750
315470;201804;455;1334;359;1162;31;110;185;585;216;695
315480;201804;1425;4177;969;3194;207;726;232;758;439;1484
315490;201804;2923;7486;2082;6282;317;1038;727;2113;1044;3151
315500;201804;492;1402;304;972;22;84;142;404;164;488
315510;201804;1257;3568;1081;3292;45;181;892;2666;937;2847
315520;201804;1097;3160;862;2772;57;224;562;1748;619;1972
315530;201804;634;2021;499;1695;164;606;167;532;331;1138
315540;201804;1155;3314;841;2713;121;451;329;1030;450;1481
315550;201804;1744;4823;1289;4094;270;968;443;1345;713;2313
315560;201804;5976;19507;5337;18372;407;1519;3582;12380;3989;13899
315570;201804;1859;5589;1601;5086;118;459;895;2745;1013;3204
315580;201804;2216;5857;1735;5065;401;1337;547;1546;948;2883
315590;201804;899;2482;737;2219;95;334;359;1038;454;1372
315600;201804;2364;7974;1775;6797;273;1044;958;3807;1231;4851
315610;201804;930;2482;725;2094;130;465;302;727;432;1192
315620;201804;310;1027;282;983;59;203;154;580;213;783
315630;201804;843;2516;698;2237;172;585;191;544;363;1129
315640;201804;380;1033;318;933;39;133;172;483;211;616
315645;201804;871;2368;603;1909;180;615;151;441;331;1056
315650;201804;1763;4632;1385;4088;68;284;1058;3042;1126;3326
315660;201804;2482;6252;1886;5248;124;351;1273;3452;1397;3803
315670;201804;12324;36557;10103;32421;2100;7136;4427;13747;6527;20883
315680;201804;2925;9301;2224;7911;483;1907;848;2976;1331;4883
315690;201804;2784;7520;1828;5790;429;1432;444;1511;873;2943
315700;201804;7113;21066;5679;18180;973;3306;2565;7923;3538;11229
315710;201804;1888;5004;1340;4103;78;339;874;2529;952;2868
315720;201804;4093;12295;3538;11282;204;953;2376;7213;2580;8166
315725;201804;1584;4540;1337;4199;180;580;925;2962;1105;3542
315727;201804;566;1593;423;1321;68;237;194;565;262;802
315730;201804;679;2109;604;1944;82;299;291;890;373;1189
315733;201804;1350;3590;972;2916;187;663;336;931;523;1594
315737;201804;1129;3379;895;2930;39;171;630;2030;669;2201
315740;201804;961;2797;763;2385;134;486;358;996;492;1482
315750;201804;1202;3386;1015;3075;89;289;685;2080;774;2369
315760;201804;1149;2886;1070;2791;33;64;976;2558;1009;2622
315765;201804;1799;5031;1509;4656;42;167;1341;4128;1383;4295
315770;201804;1166;3633;992;3372;345;1305;313;1005;658;2310
315780;201804;24874;74055;21528;67785;2433;9009;12268;36680;14701;45689
315790;201804;3589;11396;3087;10447;260;878;2035;7084;2295;7962
315800;201804;1208;4673;910;3804;182;842;189;724;371;1566
315810;201804;1285;3331;1119;3084;69;252;881;2307;950;2559
315820;201804;2368;7264;2036;6705;247;926;1358;4387;1605;5313
315830;201804;1142;3419;842;2873;70;292;365;1177;435;1469
315840;201804;761;1928;470;1365;57;185;187;495;244;680
315850;201804;1029;3338;904;3130;196;744;440;1417;636;2161
315860;201804;507;1590;353;1279;74;307;101;336;175;643
315870;201804;446;1226;368;1109;24;92;241;681;265;773
315880;201804;1123;2990;822;2497;65;243;311;895;376;1138
315890;201804;1470;4747;1276;4400;398;1468;514;1692;912;3160
315895;201804;5737;16610;4600;14237;655;2302;2106;6002;2761;8304
315900;201804;823;2206;723;2064;65;219;563;1539;628;1758
315910;201804;488;1533;427;1430;76;277;265;853;341;1130
315920;201804;1567;4256;820;2613;155;518;213;621;368;1139
315930;201804;1037;2561;718;2043;144;415;286;797;430;1212
315935;201804;804;2573;687;2341;153;571;206;718;359;1289
315940;201804;604;1838;504;1634;67;237;259;829;326;1066
315950;201804;1190;3403;1012;3105;145;445;716;2211;861;2656
315960;201804;3525;10416;2245;7961;720;2980;110;232;830;3212
315970;201804;638;1838;510;1654;52;164;362;1206;414;1370
315980;201804;3653;8575;2133;6016;461;1420;713;1823;1174;3243
315990;201804;3718;9897;2933;8560;327;1060;1670;4781;1997;5841
316000;201804;522;1492;420;1328;72;278;172;495;244;773
316010;201804;676;2117;535;1834;54;233;285;894;339;1127
316020;201804;959;3011;816;2737;80;372;529;1643;609;2015
316030;201804;2959;8449;2158;6996;238;813;1329;4376;1567;5189
316040;201804;3190;10699;2451;9204;328;1251;871;3611;1199;4862
316045;201804;1922;5574;1791;5371;137;348;1439;4436;1576;4784
316050;201804;351;1068;265;903;47;190;137;435;184;625
316060;201804;695;1917;524;1653;54;222;315;908;369;1130
316070;201804;5669;16633;4732;14785;848;2896;2100;6296;2948;9192
316080;201804;712;2376;587;2104;157;623;71;242;228;865
316090;201804;470;1441;329;1135;49;200;125;392;174;592
316095;201804;1348;4245;1160;3878;222;774;592;1956;814;2730
316100;201804;2544;8010;1848;6387;340;1291;540;1750;880;3041
316105;201804;870;2412;652;2051;97;322;383;1203;480;1525
316110;201804;11881;37599;10317;34854;1335;4713;6580;22358;7915;27071
316120;201804;1012;3168;737;2477;152;532;194;553;346;1085
316130;201804;1399;3180;823;2277;98;310;382;1014;480;1324
316140;201804;1068;2923;731;2345;144;488;331;1054;475;1542
316150;201804;1565;3925;1322;3536;243;750;617;1528;860;2278
316160;201804;1081;3107;874;2725;91;323;508;1526;599;1849
316165;201804;891;2285;694;1976;110;380;380;1019;490;1399
316170;201804;1124;3085;849;2657;106;389;465;1378;571;1767
316180;201804;1367;4153;923;3166;191;729;117;316;308;1045
316190;201804;2575;7676;1507;5034;273;916;477;1442;750;2358
316200;201804;3434;10475;2546;8736;549;2135;573;1844;1122;3979
316210;201804;4330;13251;3179;10740;1037;3723;358;1204;1395;4927
316220;201804;617;1927;422;1486;83;315;47;199;130;514
316225;201804;1306;3248;1011;2733;65;244;725;1837;790;2081
316230;201804;415;1125;319;987;36;107;160;514;196;621
316240;201804;5972;17726;5272;16672;571;1869;3843;12138;4414;14007
316245;201804;3050;10421;2760;9936;168;916;2136;7432;2304;8348
316250;201804;9265;24633;6783;20206;1772;5764;1564;4463;3336;10227
316255;201804;2756;7988;2384;7422;303;1017;1622;5077;1925;6094
316257;201804;1246;3198;876;2589;114;371;422;1203;536;1574
316260;201804;1865;4958;1407;4253;45;157;791;2474;836;2631
316265;201804;1281;3476;935;2870;55;185;618;1858;673;2043
316270;201804;3410;11114;2984;10129;606;2177;1270;4142;1876;6319
316280;201804;3079;9502;2717;8806;382;1386;1459;4558;1841;5944
316290;201804;3205;9577;2558;8287;429;1598;891;2861;1320;4459
316292;201804;4401;12507;3630;11233;395;1406;2514;7610;2909;9016
316294;201804;752;2283;557;1938;94;367;100;347;194;714
316295;201804;2461;7235;2102;6580;101;435;1562;4728;1663;5163
316300;201804;966;3086;815;2794;60;239;524;1806;584;2045
316310;201804;957;2370;544;1711;90;309;217;671;307;980
316320;201804;560;1641;436;1423;71;268;168;531;239;799
316330;201804;1058;3035;799;2507;66;243;540;1630;606;1873
316340;201804;1065;3148;792;2603;85;350;412;1272;497;1622
316350;201804;1219;3760;1068;3513;130;462;677;2215;807;2677
316360;201804;684;1806;548;1591;62;196;385;1097;447;1293
316370;201804;4516;13197;3596;11394;835;2973;984;2770;1819;5743
316380;201804;1620;4099;1245;3587;44;136;915;2623;959;2759
316390;201804;856;2337;650;1979;181;610;222;656;403;1266
316400;201804;1279;3783;878;3009;146;520;315;1029;461;1549
316410;201804;1013;3138;868;2905;69;245;697;2307;766;2552
316420;201804;1723;5315;1528;5054;98;412;1192;3869;1290;4281
316430;201804;881;2567;574;1946;123;434;130;425;253;859
316440;201804;679;2177;519;1906;144;614;73;251;217;865
316443;201804;569;1681;448;1445;108;385;119;368;227;753
316447;201804;1744;4876;1531;4558;60;199;1255;3726;1315;3925
316450;201804;2165;6892;1713;5955;201;752;1116;3825;1317;4577
316460;201804;857;2459;749;2274;226;729;355;1046;581;1775
316470;201804;5820;17703;4617;15289;968;3625;1499;4608;2467;8233
316480;201804;194;599;165;538;30;115;69;205;99;320
316490;201804;323;907;238;724;33;110;92;245;125;355
316500;201804;1210;4049;787;2918;151;607;112;380;263;987
316510;201804;633;2297;567;2160;140;586;227;871;367;1457
316520;201804;979;2811;783;2460;134;494;315;921;449;1415
316530;201804;964;2841;731;2392;121;511;314;909;435;1420
316540;201804;721;2197;629;2031;111;427;219;642;330;1069
316550;201804;1255;3994;1127;3744;114;440;785;2549;899;2989
316553;201804;3047;9646;2081;7261;552;2067;349;1109;901;3176
316555;201804;2624;8756;2372;8403;144;570;1836;6633;1980;7203
316556;201804;639;1575;456;1280;32;96;246;617;278;713
316557;201804;882;3031;780;2837;323;1234;229;793;552;2027
316560;201804;268;852;202;758;54;241;52;178;106;419
316570;201804;1121;3543;1001;3306;305;1030;318;1047;623;2077
316580;201804;373;944;236;684;54;172;85;223;139;395
316590;201804;1332;3631;984;2987;179;606;529;1489;708;2095
316600;201804;969;3076;860;2863;144;531;456;1499;600;2030
316610;201804;583;1955;489;1782;69;336;292;1006;361;1342
316620;201804;2062;5966;1771;5525;109;409;1275;3978;1384;4387
316630;201804;1495;4631;1194;4030;353;1174;440;1648;793;2822
316640;201804;142;399;115;350;25;90;55;136;80;226
316650;201804;978;3285;806;3024;63;259;519;2009;582;2268
316660;201804;193;493;82;258;9;41;12;30;21;71
316670;201804;1939;5169;1483;4398;431;1349;420;1180;851;2529
316680;201804;2011;5307;1566;4589;145;480;1104;3122;1249;3602
316690;201804;1074;3407;897;3072;228;876;336;1109;564;1985
316695;201804;1000;3029;870;2794;56;236;595;1862;651;2098
316700;201804;367;976;320;919;17;80;230;609;247;689
316710;201804;2645;9398;2121;8268;623;2490;660;2693;1283;5183
316720;201804;18619;55361;14299;46570;2994;10434;5169;16120;8163;26554
316730;201804;339;1000;285;885;73;257;115;316;188;573
316740;201804;659;2042;597;1953;60;262;423;1364;483;1626
316750;201804;398;1263;308;1079;62;249;106;359;168;608
316760;201804;3606;11535;2975;10413;1295;4826;877;3042;2172;7868
316770;201804;1464;3754;1200;3386;34;122;1022;2912;1056;3034
316780;201804;588;1855;470;1624;143;548;54;157;197;705
316790;201804;710;1985;521;1636;124;416;174;528;298;944
316800;201804;5420;16417;4487;14650;450;1729;2637;8276;3087;10005
316805;201804;934;2158;806;2012;22;33;716;1872;738;1905
316810;201804;538;1550;399;1285;92;331;165;501;257;832
316820;201804;328;817;170;533;24;85;31;101;55;186
316830;201804;623;1919;529;1748;101;382;302;963;403;1345
316840;201804;2599;7560;2226;6860;423;1480;1094;3195;1517;4675
316850;201804;2024;5512;1511;4603;195;694;735;2155;930;2849
316860;201804;17104;49296;13624;43683;2667;9697;5717;17753;8384;27450
316870;201804;6399;19177;4928;16074;1099;3865;1501;4663;2600;8528
316880;201804;836;2356;711;2166;150;536;295;852;445;1388
316890;201804;1208;2826;794;2261;169;584;430;1081;599;1665
316900;201804;2309;6570;1834;5583;410;1396;595;1619;1005;3015
316905;201804;469;1475;385;1292;88;314;162;542;250;856
316910;201804;861;2496;583;1977;149;585;57;179;206;764
316920;201804;1644;4343;1116;3495;206;704;480;1504;686;2208
316930;201804;7782;24663;5810;20643;1066;4118;1189;4038;2255;8156
316935;201804;3957;11467;2799;9195;663;2308;785;2538;1448;4846
316940;201804;6650;20754;5134;17338;1006;3749;1553;4861;2559;8610
316950;201804;1735;4404;1367;3873;65;221;1068;2964;1133;3185
316960;201804;4718;11484;3562;9844;539;1658;2160;5885;2699;7543
316970;201804;3154;9655;2823;8998;700;2327;1006;3029;1706;5356
316980;201804;786;2372;544;1884;147;554;66;226;213;780
316990;201804;9907;29293;7516;24117;2014;6863;754;2218;2768;9081
317000;201804;2642;8418;2453;8143;192;639;1786;6203;1978;6842
317005;201804;2465;7271;2053;6538;369;1214;1042;3271;1411;4485
317010;201804;22713;55319;13731;41440;3346;11094;2947;9491;6293;20585
317020;201804;58946;150602;34293;103849;6571;21694;7841;21584;14412;43278
317030;201804;682;1939;547;1741;35;146;382;1189;417;1335
317040;201804;10038;27051;7339;22314;1789;5710;2728;8345;4517;14055
317043;201804;790;1981;633;1762;119;355;377;1044;496;1399
317047;201804;1179;2917;827;2386;100;276;497;1433;597;1709
317050;201804;1301;4184;929;3302;135;500;326;1061;461;1561
317052;201804;2284;6917;1920;6288;246;850;1242;4022;1488;4872
317057;201804;1652;4255;1191;3463;55;214;793;2237;848;2451
317060;201804;411;1128;228;730;40;139;75;215;115;354
317065;201804;1256;3655;1052;3295;52;233;783;2327;835;2560
317070;201804;8044;23545;5367;17874;1167;4327;899;2791;2066;7118
317075;201804;957;2853;677;2233;142;474;115;353;257;827
317080;201804;5820;14792;4576;12709;1505;4361;1169;2990;2674;7351
317090;201804;4445;14046;4077;13463;394;1346;2962;9798;3356;11144
317100;201804;2618;6600;1791;5260;592;1839;519;1481;1111;3320
317103;201804;1823;6020;1614;5632;197;902;973;3178;1170;4080
317107;201804;1319;3798;1089;3341;63;253;686;1919;749;2172
317110;201804;600;1376;325;984;46;172;116;360;162;532
317115;201804;1121;3325;933;2946;73;227;662;2097;735;2324
317120;201804;11704;34775;9159;30162;1488;5443;4438;14047;5926;19490
317130;201804;8255;21318;5711;17058;1249;4062;1850;5439;3099;9501
317140;201804;575;1762;494;1615;56;179;298;983;354;1162
317150;201804;994;2526;793;2274;45;165;622;1735;667;1900
317160;201804;3590;9026;2514;7409;265;803;1516;4488;1781;5291
317170;201804;1980;5183;1398;4123;225;763;489;1245;714;2008
317180;201804;1618;5376;1267;4542;300;1152;304;1020;604;2172
317190;201804;1304;3638;979;3117;75;255;632;1982;707;2237
317200;201804;4571;12975;3472;10908;860;2958;781;2243;1641;5201
317210;201804;1014;2779;819;2486;56;235;588;1779;644;2014
317220;201804;268;896;241;833;57;214;95;315;152;529
320010;201804;4543;13770;3773;12250;443;1576;2301;7285;2744;8861
320013;201804;1674;5107;1208;4024;201;659;522;1805;723;2464
320016;201804;3062;8141;2492;7320;142;415;1975;5789;2117;6204
320020;201804;3749;10917;2928;9364;753;2558;903;2961;1656;5519
320030;201804;1465;4536;1046;3619;289;1068;281;894;570;1962
320035;201804;1668;4822;1423;4410;420;1424;611;1839;1031;3263
320040;201804;3206;9878;2634;8804;468;1698;1226;4052;1694;5750
320050;201804;1686;4211;1484;3879;310;878;777;1970;1087;2848
320060;201804;9645;28882;7102;23577;1413;5129;2169;6878;3582;12007
320070;201804;1391;4215;1048;3483;213;742;315;1036;528;1778
320080;201804;5363;14733;3956;11978;796;2519;1471;4406;2267;6925
320090;201804;6682;19016;5074;15758;1240;4037;2013;6062;3253;10099
320100;201804;2479;7469;1924;6373;514;1792;714;2299;1228;4091
320110;201804;1274;3502;1014;3021;240;739;331;996;571;1735
320115;201804;1783;6040;1553;5619;741;2787;418;1572;1159;4359
320120;201804;14454;40329;10545;33154;2142;7356;3299;9982;5441;17338
320130;201804;34548;103852;29689;95045;4914;17277;15768;49089;20682;66366
320140;201804;2906;8821;2118;7126;480;1815;610;1996;1090;3811
320150;201804;12895;35554;9209;28176;2742;8948;1219;3466;3961;12414
320160;201804;5130;15446;4042;13249;791;2793;1766;5720;2557;8513
320170;201804;1585;4804;1177;3941;298;993;456;1517;754;2510
320180;201804;697;2309;565;2036;198;762;128;460;326;1222
320190;201804;2978;9907;2261;8251;559;2109;444;1615;1003;3724
320200;201804;982;2893;743;2458;219;819;196;653;415;1472
320210;201804;4522;12100;3564;10381;582;1866;1803;5013;2385;6879
320220;201804;2618;7447;2037;6436;345;1161;1095;3454;1440;4615
320225;201804;1269;4159;909;3246;323;1215;129;461;452;1676
320230;201804;4294;12921;3362;11279;903;3306;1257;4194;2160;7500
320240;201804;12993;35781;10109;30948;2149;7078;4130;12569;6279;19647
320245;201804;2883;9219;2457;8305;964;3383;589;1960;1553;5343
320250;201804;1905;5660;1318;4255;314;1150;273;787;587;1937
320255;201804;1668;5600;1474;5248;553;2020;585;2185;1138;4205
320260;201804;1016;3053;734;2385;216;780;186;511;402;1291
320265;201804;2370;7513;2006;6790;861;3052;527;1752;1388;4804
320270;201804;2272;6703;1758;5657;333;1131;852;2770;1185;3901
320280;201804;5439;16069;4541;14388;1179;4000;1412;4340;2591;8340
320290;201804;1307;4094;894;3071;271;1045;175;542;446;1587
320300;201804;3651;11856;3022;10455;993;3619;600;2046;1593;5665
320305;201804;4466;13556;3603;11721;839;2908;1405;4400;2244;7308
320310;201804;1785;5195;1326;4226;282;917;529;1677;811;2594
320313;201804;2016;5489;1352;4127;307;1050;267;761;574;1811
320316;201804;1488;4347;1177;3724;262;882;533;1674;795;2556
320320;201804;19388;54143;13923;44427;3495;11816;4732;14936;8227;26752
320330;201804;2811;8132;2265;7134;641;1995;905;3007;1546;5002
320332;201804;5230;15918;4379;14369;1006;3545;2188;7028;3194;10573
320334;201804;2006;6105;1376;4711;306;1201;289;877;595;2078
320335;201804;1818;5398;1156;3833;311;1126;207;623;518;1749
320340;201804;4823;12922;4107;11788;733;2204;2099;6169;2832;8373
320350;201804;4927;12821;3488;10155;553;1688;1604;4563;2157;6251
320360;201804;1522;4004;1108;3205;181;513;496;1406;677;1919
320370;201804;2448;8003;1925;6777;542;1959;630;2192;1172;4151
320380;201804;2127;6127;1804;5559;378;1257;907;2707;1285;3964
320390;201804;7038;20076;5364;16570;1231;4049;1944;5789;3175;9838
320400;201804;3290;9850;2734;8698;678;2268;1139;3587;1817;5855
320405;201804;4433;12325;3498;10718;530;1724;1890;5736;2420;7460
320410;201804;4866;13344;3659;11427;624;2024;1753;5672;2377;7696
320420;201804;2628;7551;2055;6528;566;1984;482;1511;1048;3495
320425;201804;1982;4925;1515;4144;128;404;959;2521;1087;2925
320430;201804;2563;6846;2039;5791;343;1035;1144;3061;1487;4096
320435;201804;2273;7340;1799;6358;671;2474;481;1750;1152;4224
320440;201804;1081;3250;850;2766;163;591;375;1186;538;1777
320450;201804;1618;4913;1291;4266;308;1106;571;1798;879;2904
320455;201804;3594;11491;2576;9080;737;2749;680;2348;1417;5097
320460;201804;2212;6937;1578;5465;356;1276;337;1104;693;2380
320465;201804;1255;3743;966;3145;120;436;529;1718;649;2154
320470;201804;3822;10973;2608;8383;689;2376;538;1627;1227;4003
320480;201804;1630;4909;1392;4427;258;900;668;2078;926;2978
320490;201804;15976;45418;12648;39606;2491;8632;5092;15977;7583;24609
320495;201804;1356;3874;890;2890;208;727;248;798;456;1525
320500;201804;43734;124276;36612;111835;6708;21960;18977;56186;25685;78146
320501;201804;4619;13786;3375;11581;942;3647;895;2942;1837;6589
320503;201804;2061;6605;1560;5508;484;1893;448;1444;932;3337
320506;201804;3233;9790;2219;7427;610;2192;114;330;724;2522
320510;201804;8877;25653;7325;22886;1237;4242;3903;11893;5140;16135
320515;201804;1789;5014;1402;4187;407;1279;357;1059;764;2338
320517;201804;1947;6241;1565;5414;577;2139;337;1129;914;3268
320520;201804;31020;88107;24184;76337;4953;17133;9315;28946;14268;46079
320530;201804;27152;76657;21504;66496;2923;10485;12076;35212;14999;45697
330010;201804;19083;55717;16253;50727;3264;10577;8558;26678;11822;37255
330015;201804;1342;3617;1122;3223;190;626;541;1464;731;2090
330020;201804;18644;50130;16434;46815;2515;8096;10940;30225;13455;38321
330022;201804;1821;5121;1465;4548;267;905;858;2601;1125;3506
330023;201804;3166;8794;2455;7709;584;1968;926;2834;1510;4802
330025;201804;4524;11914;3235;9599;1031;3354;956;2777;1987;6131
330030;201804;8808;26652;7212;23694;1082;3975;3868;12092;4950;16067
330040;201804;11126;31803;9662;29206;1460;4826;5887;17150;7347;21976
330045;201804;77677;196016;65905;180108;7473;20119;48034;130222;55507;150341
330050;201804;2262;6376;1781;5571;407;1361;772;2269;1179;3630
330060;201804;5126;14266;4286;12908;969;3194;1805;5163;2774;8357
330070;201804;19015;53388;16196;48990;3195;10201;8199;24808;11394;35009
330080;201804;8512;23566;7532;22055;817;2517;5007;14574;5824;17091
330090;201804;2415;6093;2008;5506;245;710;1239;3294;1484;4004
330093;201804;1961;5485;1563;4842;189;596;1028;3244;1217;3840
330095;201804;1009;3227;838;2864;107;404;407;1298;514;1702
330100;201804;59932;172827;51788;160379;4861;17576;35381;107713;40242;125289
330110;201804;2067;6347;1822;5920;351;1236;773;2439;1124;3675
330115;201804;1756;4793;1432;4304;270;903;813;2372;1083;3275
330120;201804;2919;7232;2347;6473;219;685;1717;4640;1936;5325
330130;201804;3454;10302;2938;9484;561;1936;1602;5187;2163;7123
330140;201804;3244;9257;2754;8508;485;1719;1591;4749;2076;6468
330150;201804;2009;5731;1611;5051;347;1126;629;1958;976;3084
330160;201804;1110;3268;926;2976;219;765;453;1407;672;2172
330170;201804;89434;250413;77460;232972;13138;40697;45785;137704;58923;178401
330180;201804;2041;5570;1648;4916;115;435;1113;3206;1228;3641
330185;201804;8858;24953;7398;22379;966;3270;4818;14094;5784;17364
330187;201804;3507;9690;2935;8789;475;1561;1775;5225;2250;6786
330190;201804;27510;72057;24401;67691;2669;7638;18402;50827;21071;58465
330200;201804;13070;37575;11164;34910;2531;7769;6270;20178;8801;27947
330205;201804;1906;5086;1603;4602;105;355;1114;3096;1219;3451
330210;201804;3170;8524;2382;7016;544;1710;827;2276;1371;3986
330220;201804;9470;26839;7529;23072;1720;5668;2139;6028;3859;11696
330225;201804;3492;10041;2859;8979;271;1084;1893;5688;2164;6772
330227;201804;15955;42623;13957;39883;1397;4304;10522;29799;11919;34103
330230;201804;1208;3327;1018;3031;88;284;670;1960;758;2244
330240;201804;17572;49818;14495;44692;3336;11116;6618;19719;9954;30835
330245;201804;1294;3629;904;2928;212;729;235;745;447;1474
330250;201804;32919;91980;28547;85139;6942;20955;13080;39883;20022;60838
330260;201804;4350;12289;3493;10888;575;1955;1787;5287;2362;7242
330270;201804;22541;47673;14009;35692;2666;7449;5687;14330;8353;21779
330280;201804;2171;6093;1741;5312;252;860;911;2627;1163;3487
330285;201804;18994;49473;15719;44778;1997;6362;10309;28514;12306;34876
330290;201804;3190;8860;2682;8019;408;1312;1478;4270;1886;5582
330300;201804;3182;9817;2741;9001;417;1514;1600;5102;2017;6616
330310;201804;2218;6036;1761;5251;151;429;1114;3335;1265;3764
330320;201804;12742;34619;11234;32486;1558;4577;7970;23142;9528;27719
330330;201804;27667;70217;23240;63707;3103;9429;15352;40805;18455;50234
330340;201804;12859;35691;10072;30846;2106;7019;4123;12020;6229;19039
330350;201804;91083;241991;77941;224131;8237;25367;55690;159048;63927;184415
330360;201804;7003;18270;6073;17176;402;1173;4929;13905;5331;15078
330370;201804;3465;11758;3017;10827;843;3152;1121;3985;1964;7137
330380;201804;4796;14449;3819;12635;881;3157;1370;4350;2251;7507
330385;201804;3751;12107;3264;11280;917;3424;1308;4534;2225;7958
330390;201804;21550;65818;17544;57927;3698;13213;7719;24614;11417;37827
330395;201804;3044;8337;2629;7742;211;704;1756;5108;1967;5812
330400;201804;2746;7941;2438;7383;209;780;1684;4769;1893;5549
330410;201804;2698;7865;2038;6659;396;1410;881;2729;1277;4139
330411;201804;2260;6618;1921;5976;181;677;1325;3936;1506;4613
330412;201804;1377;4365;1136;3890;188;705;580;1868;768;2573
330414;201804;22754;60376;18865;54971;2615;7450;12154;35548;14769;42998
330415;201804;3473;10016;2715;8703;485;1536;1293;4293;1778;5829
330420;201804;9117;24104;6046;18840;1047;3456;1993;5905;3040;9361
330430;201804;7426;20522;6508;18973;856;2846;4159;11641;5015;14487
330440;201804;1563;4855;1339;4478;351;1317;563;1763;914;3080
330450;201804;1285;4036;1061;3612;181;669;513;1698;694;2367
330452;201804;13749;38059;10821;32994;2222;7289;5286;15689;7508;22978
330455;201804;516879;1317248;399805;1136350;69963;211744;221886;618687;291849;830431
330460;201804;1188;3549;934;3137;196;705;438;1421;634;2126
330470;201804;4179;11460;3280;10019;858;2768;1310;3912;2168;6680
330475;201804;8177;23038;6741;20968;1736;5945;3216;9724;4952;15669
330480;201804;5717;15987;4930;14780;679;2272;3056;8846;3735;11118
330490;201804;111197;273327;94648;249759;10172;29072;65667;169634;75839;198706
330500;201804;4947;14275;4546;13669;625;1988;3211;9591;3836;11579
330510;201804;36844;102580;30050;92483;8282;25850;13666;42296;21948;68146
330513;201804;1153;3359;1006;3090;306;988;389;1180;695;2168
330515;201804;2687;7774;2216;6932;688;2249;784;2413;1472;4662
330520;201804;10032;29169;8548;26596;1546;5259;4175;12501;5721;17760
330530;201804;1524;4099;1202;3550;265;858;522;1469;787;2327
330540;201804;2717;7726;2183;6768;634;2034;764;2319;1398;4353
330550;201804;7446;23231;6329;21288;2386;8379;1556;5347;3942;13726
330555;201804;10665;28396;9132;26278;1449;4417;5864;16966;7313;21383
330560;201804;4141;11879;3525;10732;471;1544;2059;6083;2530;7627
330570;201804;2832;8264;2382;7473;472;1568;1316;4073;1788;5641
330575;201804;5231;14199;4558;13017;455;1479;3313;9102;3768;10581
330580;201804;11457;33999;9160;29647;2350;8070;3591;11405;5941;19475
330590;201804;1515;4339;1340;4108;153;475;960;2955;1113;3430
330600;201804;10848;31217;8702;27350;1377;4593;4365;13655;5742;18248
330610;201804;8497;25063;7383;23294;909;3309;4572;14007;5481;17316
330615;201804;1590;5151;1399;4874;426;1621;673;2309;1099;3930
330620;201804;3464;11183;2904;10123;989;3673;703;2342;1692;6015
330630;201804;23122;63342;18474;55338;2095;7312;11659;33383;13754;40695
350010;201804;1837;5183;987;3240;237;803;86;217;323;1020
350020;201804;604;1624;322;1052;33;120;141;413;174;533
350030;201804;3825;11503;2915;9712;778;2754;836;2700;1614;5454
350040;201804;579;1833;376;1355;73;288;103;339;176;627
350050;201804;859;2448;625;1985;140;499;174;456;314;955
350055;201804;698;1913;593;1756;54;179;448;1304;502;1483
350060;201804;112;331;90;294;20;70;38;127;58;197
350070;201804;3855;10636;2356;7611;444;1475;686;1996;1130;3471
350075;201804;590;1901;454;1603;179;665;59;181;238;846
350080;201804;676;1862;419;1320;49;172;179;529;228;701
350090;201804;620;1543;350;1027;80;230;104;298;184;528
350100;201804;2022;5718;1353;4468;185;737;616;1883;801;2620
350110;201804;407;1201;306;990;24;87;188;593;212;680
350115;201804;1262;3803;1046;3328;188;653;500;1450;688;2103
350120;201804;791;2093;478;1443;60;163;258;801;318;964
350130;201804;3149;8958;2591;7851;333;1098;1395;4006;1728;5104
350140;201804;582;1895;471;1669;37;169;259;865;296;1034
350150;201804;507;1606;432;1454;126;442;131;423;257;865
350160;201804;10063;26116;6447;19519;903;3130;3423;9601;4326;12731
350170;201804;1494;4753;1172;4000;258;922;338;1096;596;2018
350180;201804;1131;2958;626;1917;126;430;238;684;364;1114
350190;201804;2828;8450;2103;6928;443;1630;782;2141;1225;3771
350200;201804;364;1055;310;958;22;70;219;654;241;724
350210;201804;5024;12474;3375;9741;686;2029;1650;4659;2336;6688
350220;201804;2281;6840;1797;5774;377;1337;689;1996;1066;3333
350230;201804;865;2593;751;2388;164;541;347;1097;511;1638
350240;201804;652;1950;453;1494;76;261;159;516;235;777
350250;201804;2116;6952;1713;6206;589;2297;375;1417;964;3714
350260;201804;814;2136;529;1595;82;256;271;797;353;1053
350270;201804;4492;13042;3658;11322;644;2171;1730;4998;2374;7169
350275;201804;2053;6159;1702;5522;364;1246;775;2427;1139;3673
350280;201804;19816;46335;12177;33699;2282;6720;3961;10593;6243;17313
350290;201804;2922;8661;2042;6822;386;1411;787;2542;1173;3953
350300;201804;640;1852;454;1433;96;314;149;416;245;730
350310;201804;790;2489;667;2203;83;324;278;847;361;1171
350315;201804;526;1523;373;1216;52;204;133;380;185;584
350320;201804;11234;32092;9089;28189;2436;8031;2127;6623;4563;14654
350330;201804;14504;37502;9894;27939;1315;3864;5277;14065;6592;17929
350335;201804;372;1079;310;969;19;59;222;700;241;759
350340;201804;1015;2785;646;2075;126;444;211;658;337;1102
350350;201804;707;2032;574;1858;103;348;252;786;355;1134
350360;201804;909;2932;768;2608;209;692;288;972;497;1664
350370;201804;562;1582;392;1214;113;349;71;197;184;546
350380;201804;4591;12810;3104;9956;759;2525;862;2693;1621;5218
350390;201804;9236;26824;7635;23850;2100;6753;2792;8479;4892;15232
350395;201804;403;1059;197;647;22;78;65;183;87;261
350400;201804;7320;19767;5368;16320;1380;4551;1539;4419;2919;8970
350410;201804;8812;26482;6564;22003;1588;5890;1808;5561;3396;11451
350420;201804;592;1784;446;1502;84;331;79;238;163;569
350430;201804;685;1988;568;1775;68;255;344;1007;412;1262
350440;201804;1400;4082;1141;3554;212;705;604;1812;816;2517
350450;201804;6343;19107;5093;16654;1145;3990;1699;5291;2844;9281
350460;201804;1480;3862;810;2527;150;536;217;615;367;1151
350470;201804;213;562;178;498;9;34;118;309;127;343
350480;201804;801;2214;528;1659;97;340;84;220;181;560
350490;201804;1673;4911;1303;4210;297;998;413;1245;710;2243
350500;201804;580;1681;484;1509;86;303;251;758;337;1061
350510;201804;1064;3019;784;2460;98;347;403;1186;501;1533
350520;201804;1805;6169;1398;5223;263;1095;479;1687;742;2782
350530;201804;2298;6345;1737;5191;413;1310;660;1851;1073;3161
350535;201804;1370;4036;1219;3816;130;485;851;2596;981;3081
350540;201804;1586;4299;1169;3567;241;804;513;1560;754;2364
350550;201804;8986;22610;6017;17717;780;2656;2831;7774;3611;10430
350560;201804;3457;10585;2867;9333;311;1078;1721;5485;2032;6563
350570;201804;18201;55269;15436;49797;3880;13512;6479;19925;10359;33437
350580;201804;1690;5091;1006;3396;205;698;113;315;318;1013
350590;201804;4058;11779;3050;9612;608;2192;1430;4090;2038;6282
350600;201804;37448;92852;24251;68034;3373;10469;11411;29255;14784;39724
350610;201804;6457;18580;4872;15490;1020;3453;2009;6227;3029;9680
350620;201804;373;1028;268;870;30;117;129;402;159;519
350630;201804;1503;4167;1105;3389;107;374;581;1664;688;2038
350635;201804;6484;17791;5000;15301;1027;3500;2393;6964;3420;10464
350640;201804;802;2378;482;1579;76;287;150;420;226;707
350650;201804;7679;21843;5063;16140;1032;3536;1429;4218;2461;7754
350660;201804;4629;12980;3651;11250;705;2276;1692;5212;2397;7488
350670;201804;1466;4368;1295;4076;258;830;666;2102;924;2932
350680;201804;1027;2923;708;2296;139;492;296;955;435;1447
350690;201804;1010;3015;761;2504;145;518;342;1069;487;1587
350700;201804;4111;11544;2979;9656;641;2324;1305;3955;1946;6279
350710;201804;2607;7707;2229;6991;309;1092;1261;3783;1570;4875
350715;201804;795;2337;685;2114;84;318;371;1032;455;1350
350720;201804;149;411;123;368;23;69;45;132;68;201
350730;201804;439;1440;348;1249;61;245;159;545;220;790
350740;201804;1553;4609;1033;3422;188;668;250;752;438;1420
350745;201804;584;1671;346;1112;44;155;140;385;184;540
350750;201804;8575;24980;6941;21840;1359;4825;2517;7051;3876;11876
350760;201804;12650;34254;9273;28402;2535;8344;2141;5803;4676;14147
350770;201804;658;1818;460;1415;59;193;275;826;334;1019
350775;201804;593;1549;462;1333;51;162;219;634;270;796
350780;201804;1823;5162;1396;4398;331;1147;358;1237;689;2384
350790;201804;1645;4811;1097;3730;221;805;168;511;389;1316
350800;201804;3045;9646;2735;9040;479;1707;1394;4473;1873;6180
350810;201804;2032;5483;1732;5078;336;1018;947;2911;1283;3929
350820;201804;735;1871;425;1271;56;170;177;484;233;654
350830;201804;848;2496;498;1677;77;280;145;422;222;702
350840;201804;2517;8025;1933;6851;565;2182;594;1965;1159;4147
350850;201804;5941;18257;4678;15680;1329;4669;1331;4399;2660;9068
350860;201804;3063;8973;2799;8562;116;472;2150;6456;2266;6928
350870;201804;2705;8076;2055;6978;394;1528;1034;3414;1428;4942
350880;201804;1244;3893;993;3302;225;752;291;947;516;1699
350890;201804;648;1747;402;1232;44;144;124;312;168;456
350900;201804;5771;16976;3927;13068;1211;4419;464;1422;1675;5841
350910;201804;804;2233;691;2009;132;440;413;1162;545;1602
350920;201804;11569;30800;9936;28074;618;2012;7666;20807;8284;22819
350925;201804;4453;13098;3299;10869;745;2527;1113;3323;1858;5850
350930;201804;1359;3758;948;2928;148;476;429;1256;577;1732
350940;201804;1865;5619;1549;5011;221;805;897;2795;1118;3600
350945;201804;894;2665;696;2269;126;444;296;907;422;1351
350950;201804;74650;210192;59375;177986;9433;31016;32386;91599;41819;122615
350960;201804;4855;14539;3899;12690;694;2616;2008;6123;2702;8739
350970;201804;3590;11583;2817;9797;907;3408;402;1207;1309;4615
350980;201804;569;1768;476;1559;179;594;147;486;326;1080
350990;201804;1733;5384;1340;4640;351;1359;426;1355;777;2714
350995;201804;791;2572;714;2404;57;235;446;1433;503;1668
351000;201804;2501;6986;1902;5852;375;1266;590;1689;965;2955
351010;201804;295;796;166;521;20;68;78;234;98;302
351015;201804;669;2197;552;1964;100;397;247;838;347;1235
351020;201804;8538;24721;6918;22099;1282;4352;3985;12553;5267;16905
351030;201804;2377;7551;1942;6560;308;1224;945;2991;1253;4215
351040;201804;4244;11578;3637;10604;249;905;2777;7793;3026;8698
351050;201804;15777;40906;10742;32603;2408;7891;3768;11245;6176;19136
351060;201804;40183;107845;31737;93298;4726;14968;18983;54144;23709;69112
351070;201804;1344;3589;797;2576;231;790;80;252;311;1042
351080;201804;2488;7006;1869;6193;430;1556;842;2615;1272;4171
351090;201804;360;1129;254;921;46;177;55;210;101;387
351100;201804;2466;7082;1612;5116;402;1352;345;1119;747;2471
351110;201804;5267;14165;3533;10930;823;2815;1171;3285;1994;6100
351120;201804;695;1916;481;1496;76;247;194;554;270;801
351130;201804;976;2626;473;1595;90;320;88;274;178;594
351140;201804;1613;5176;1239;4376;334;1275;300;927;634;2202
351150;201804;1621;5093;1028;3655;226;854;146;455;372;1309
351160;201804;1105;3716;919;3292;207;792;293;934;500;1726
351170;201804;1328;4004;1162;3641;139;487;701;2065;840;2552
351190;201804;792;2443;593;1939;101;319;215;668;316;987
351200;201804;1661;4331;1281;3722;88;278;754;2075;842;2353
351210;201804;1365;3503;843;2484;103;352;432;1141;535;1493
351220;201804;2985;9222;2628;8538;399;1371;1509;4821;1908;6192
351230;201804;1756;5143;1343;4389;284;1059;565;1653;849;2712
351240;201804;1667;4641;1107;3412;246;809;474;1342;720;2151
351250;201804;1041;2962;606;1965;83;287;208;658;291;945
351260;201804;871;2500;713;2177;208;627;193;575;401;1202
351270;201804;319;991;271;888;54;213;132;365;186;578
351280;201804;4120;11607;3261;9914;570;1928;1450;4153;2020;6081
351290;201804;947;2600;652;2033;118;377;271;808;389;1185
351300;201804;13606;39965;9684;32166;2178;7787;3165;10451;5343;18238
351310;201804;2862;8099;2230;6970;293;1085;1259;3646;1552;4731
351320;201804;861;2721;673;2244;119;421;238;747;357;1168
351330;201804;1033;3973;969;3864;56;144;824;3414;880;3558
351340;201804;5905;18251;4814;16227;1315;4583;1774;6032;3089;10615
351350;201804;9873;27396;8367;24796;1210;3790;5548;15891;6758;19681
351360;201804;3790;11008;3261;10091;807;2738;1063;3041;1870;5779
351370;201804;2205;6548;1540;5074;377;1293;498;1473;875;2766
351380;201804;39449;105388;31467;90838;5691;17220;15599;43827;21290;61047
351385;201804;272;747;173;544;28;78;56;176;84;254
351390;201804;1314;3456;872;2787;157;606;453;1318;610;1924
351400;201804;927;2821;775;2504;179;589;339;1081;518;1670
351410;201804;2249;6710;1776;5773;299;992;843;2699;1142;3691
351420;201804;294;788;181;560;36;112;63;185;99;297
351430;201804;745;2232;679;2110;81;291;491;1485;572;1776
351440;201804;3140;8856;2180;6783;407;1380;451;1178;858;2558
351450;201804;1521;4195;1110;3440;240;799;254;765;494;1564
351460;201804;685;1950;572;1740;202;601;239;726;441;1327
351470;201804;1046;2944;863;2602;87;319;507;1424;594;1743
351480;201804;2472;7781;2116;7152;293;1189;1096;3521;1389;4710
351490;201804;1778;5533;1552;5057;104;437;1074;3314;1178;3751
351492;201804;337;1009;278;872;19;70;152;444;171;514
351495;201804;178;558;142;458;20;70;67;206;87;276
351500;201804;32873;86386;24227;71097;5179;16032;11105;31169;16284;47201
351510;201804;10536;28995;7938;24134;1355;4525;4341;12661;5696;17186
351512;201804;501;1390;339;1022;54;164;130;360;184;524
351515;201804;2812;7093;1779;5249;347;1171;455;1313;802;2484
351518;201804;2207;6098;1493;4769;228;850;761;2190;989;3040
351519;201804;620;1834;417;1349;91;327;75;168;166;495
351520;201804;1019;2687;398;1301;59;215;134;376;193;591
351530;201804;343;1007;191;630;30;100;60;162;90;262
351535;201804;2019;5150;1548;4386;139;490;969;2581;1108;3071
351540;201804;1804;4966;1272;3966;432;1473;206;534;638;2007
351550;201804;5478;15204;3729;11394;524;1777;1744;4929;2268;6706
351560;201804;397;1256;338;1121;77;294;76;244;153;538
351565;201804;161;543;141;496;29;110;56;186;85;296
351570;201804;15237;43017;12118;36800;1738;5792;7379;21474;9117;27266
351580;201804;287;777;163;529;24;72;53;189;77;261
351590;201804;502;1208;280;775;32;117;154;387;186;504
351600;201804;1642;4451;1257;3732;149;481;695;1924;844;2405
351610;201804;632;1639;439;1296;32;120;245;632;277;752
351620;201804;18803;55295;14236;46497;2620;9635;5113;14856;7733;24491
351630;201804;24360;69651;20558;63046;3727;11955;12104;36256;15831;48211
351640;201804;14249;40089;11480;35120;1568;5383;7180;21162;8748;26545
351650;201804;381;1110;172;589;29;99;31;102;60;201
351660;201804;751;2311;491;1645;82;310;86;252;168;562
351670;201804;4531;13244;3398;10667;645;2090;1616;4787;2261;6877
351680;201804;447;1372;278;912;53;155;72;230;125;385
351685;201804;432;1339;353;1184;94;308;110;363;204;671
351690;201804;961;2692;645;2027;116;393;232;632;348;1025
351700;201804;906;2586;759;2312;157;459;320;961;477;1420
351710;201804;600;1848;450;1532;55;230;196;606;251;836
351720;201804;1380;3903;949;3038;180;613;352;1090;532;1703
351730;201804;870;2511;708;2214;97;357;355;1017;452;1374
351740;201804;3835;10056;2969;8386;552;1644;1239;3230;1791;4874
351750;201804;1233;3730;766;2696;132;509;265;921;397;1430
351760;201804;3186;9537;2337;7688;536;1927;661;1983;1197;3910
351770;201804;1975;6102;1635;5404;441;1524;648;2075;1089;3599
351780;201804;1331;3600;696;2192;117;424;180;531;297;955
351790;201804;1184;3126;959;2788;172;470;558;1653;730;2123
351800;201804;562;1283;281;765;36;110;81;194;117;304
351810;201804;975;2723;800;2407;69;190;572;1673;641;1863
351820;201804;2442;7413;1732;5898;385;1388;299;989;684;2377
351830;201804;4282;12301;3255;10317;434;1591;1741;5240;2175;6831
351840;201804;6570;20435;5368;18128;1075;4036;2239;7068;3314;11104
351850;201804;1974;5245;1289;4006;240;856;403;1128;643;1984
351860;201804;2754;8569;2317;7678;484;1728;1134;3681;1618;5409
351870;201804;23108;63966;18330;55760;5841;18404;6429;19782;12270;38186
351880;201804;110756;318107;86724;273063;25298;85314;23752;70373;49050;155687
351885;201804;693;2230;615;2057;137;474;279;898;416;1372
351890;201804;585;1784;472;1563;100;344;78;211;178;555
351900;201804;1009;2982;794;2613;171;582;292;970;463;1552
351905;201804;390;1132;275;888;33;119;108;304;141;423
351907;201804;20322;56115;16269;48624;1146;4060;11555;33482;12701;37542
351910;201804;1165;3256;844;2574;150;505;364;988;514;1493
351920;201804;918;2469;707;2085;75;255;374;1050;449;1305
351925;201804;962;2776;761;2376;106;345;346;1006;452;1351
351930;201804;2697;8159;2545;7871;267;1045;2020;6030;2287;7075
351940;201804;1026;2807;763;2352;81;289;418;1260;499;1549
351950;201804;1347;3517;1039;3016;58;193;630;1784;688;1977
351960;201804;4721;12983;3501;10717;832;2735;1392;4058;2224;6793
351970;201804;5325;18094;4701;16885;976;3888;2252;7634;3228;11522
351980;201804;886;2450;650;1969;93;340;336;936;429;1276
351990;201804;1387;3574;979;2889;133;491;341;898;474;1389
352000;201804;2220;6955;1954;6403;217;847;1208;3740;1425;4587
352010;201804;1887;5637;1518;4909;369;1281;222;761;591;2042
352020;201804;1515;4370;1192;3798;230;800;523;1574;753;2374
352030;201804;5062;14247;4054;12679;823;2803;2107;6541;2930;9344
352040;201804;2009;5835;1320;4392;247;862;237;681;484;1543
352042;201804;3219;8315;1897;5755;383;1210;751;2275;1134;3485
352044;201804;1931;5594;1133;3958;195;746;239;764;434;1510
352050;201804;11902;33957;7859;25212;1916;6919;1162;3199;3078;10118
352060;201804;743;2185;560;1813;88;328;243;721;331;1049
352070;201804;805;1780;574;1442;90;242;260;636;350;878
352080;201804;444;1210;264;817;41;145;83;218;124;363
352090;201804;1358;4421;1069;3706;185;725;319;982;504;1707
352100;201804;3159;9242;2534;8061;587;2014;1057;3199;1644;5213
352110;201804;545;1760;431;1508;98;374;154;483;252;857
352115;201804;517;1554;433;1404;100;336;213;686;313;1022
352120;201804;817;2584;656;2239;78;312;344;1073;422;1385
352130;201804;1815;5364;1165;3695;238;810;357;1062;595;1872
352140;201804;1430;3916;872;2789;135;455;365;1101;500;1556
352150;201804;789;2252;604;1910;164;524;272;863;436;1387
352160;201804;924;2446;672;2029;118;416;282;786;400;1202
352170;201804;2688;7909;2228;6893;439;1485;1059;3021;1498;4506
352180;201804;2784;7740;2219;6649;512;1635;783;2139;1295;3774
352190;201804;1129;3196;839;2682;139;504;298;863;437;1367
352200;201804;375;1216;256;952;38;153;76;279;114;432
352210;201804;16490;42509;13377;37876;1664;5059;9158;25712;10822;30771
352215;201804;498;1409;445;1342;55;178;297;874;352;1052
352220;201804;14078;39039;10115;31676;2912;9449;2676;8263;5588;17712
352230;201804;11979;38267;9463;33178;2578;9982;2916;9477;5494;19459
352240;201804;11387;31118;8369;25692;1904;6591;3016;8390;4920;14981
352250;201804;20454;61316;17056;55199;4426;15051;7790;24700;12216;39751
352260;201804;5319;15069;3668;11642;600;2072;1873;5728;2473;7800
352265;201804;881;2631;765;2430;62;252;532;1621;594;1873
352270;201804;1430;4703;1140;4043;256;952;333;1114;589;2066
352280;201804;2247;6195;1782;5450;195;725;933;2673;1128;3398
352290;201804;1066;3303;901;2929;167;593;412;1213;579;1806
352300;201804;939;2658;665;2082;98;357;298;817;396;1174
352310;201804;43579;120615;32914;102025;8646;27353;13266;41230;21912;68583
352320;201804;5551;15946;4462;13687;816;2790;1977;5365;2793;8155
352330;201804;1871;5585;1529;5082;373;1381;638;1999;1011;3380
352340;201804;4661;13620;3478;11464;841;2990;1157;3567;1998;6557
352350;201804;1739;5454;1452;4776;244;919;602;1782;846;2701
352360;201804;1035;2964;903;2753;139;515;624;1806;763;2321
352370;201804;942;2980;835;2754;43;194;606;1940;649;2134
352380;201804;842;2489;670;2175;156;550;202;624;358;1174
352390;201804;17481;44166;11456;33512;1806;5834;5778;15909;7584;21743
352400;201804;3355;9503;2721;8359;595;2163;1467;4107;2062;6270
352410;201804;2795;7886;2273;7000;322;1122;1248;3686;1570;4808
352420;201804;916;2320;636;1847;104;320;222;622;326;942
352430;201804;6737;18655;5177;15946;1548;5048;1792;5443;3340;10491
352440;201804;16066;47037;12662;40276;2733;9238;5341;16359;8074;25597
352450;201804;687;1953;371;1243;61;214;100;322;161;536
352460;201804;2565;7652;1865;6225;384;1429;615;1949;999;3378
352470;201804;3734;9773;2704;7993;287;977;1484;4079;1771;5056
352480;201804;3618;9231;2512;7207;445;1408;1122;2939;1567;4347
352490;201804;694;2246;543;1897;110;414;206;696;316;1110
352500;201804;9026;24176;6840;20344;3383;10829;1016;2128;4399;12957
352510;201804;3113;8938;2386;7637;608;2105;787;2390;1395;4495
352520;201804;2213;6721;1785;5872;432;1533;774;2384;1206;3917
352530;201804;8484;25053;5667;18665;1276;4564;834;2114;2110;6678
352540;201804;533;1618;387;1284;79;281;81;254;160;535
352550;201804;901;2765;646;2236;126;469;168;540;294;1009
352560;201804;554;1612;373;1203;65;207;94;268;159;475
352570;201804;1919;5902;1252;4455;317;1237;202;590;519;1827
352580;201804;808;2380;632;2019;123;441;221;653;344;1094
352585;201804;240;736;190;628;16;62;97;305;113;367
352590;201804;13021;36546;9405;29329;2932;9772;3456;9888;6388;19660
352600;201804;1876;5480;1442;4552;277;926;621;1840;898;2766
352610;201804;3114;9205;2415;7948;526;1946;785;2413;1311;4359
352620;201804;5252;14922;4320;13423;1226;3908;1676;5192;2902;9100
352630;201804;775;2047;595;1763;103;371;279;754;382;1125
352640;201804;2659;7297;2047;6273;168;550;1337;4033;1505;4583
352650;201804;620;1850;449;1420;73;243;143;426;216;669
352660;201804;957;3182;804;2857;169;607;320;1112;489;1719
352670;201804;9827;27882;5833;19391;1371;4999;434;1416;1805;6415
352680;201804;3023;9468;2195;7536;403;1564;910;2870;1313;4434
352690;201804;29891;78698;21647;63189;2138;7070;12852;35525;14990;42595
352700;201804;557;1475;416;1266;148;486;111;291;259;777
352710;201804;4818;13406;3517;10877;914;3088;1298;3723;2212;6811
352720;201804;7873;23408;6368;20297;2717;8803;1040;3008;3757;11811
352725;201804;414;1135;209;681;13;47;94;292;107;339
352730;201804;2487;7555;2189;6828;402;1419;1138;3195;1540;4614
352740;201804;2154;5477;1660;4701;218;675;892;2424;1110;3099
352750;201804;439;1151;226;715;41;125;59;160;100;285
352760;201804;1375;4272;1083;3583;183;666;477;1481;660;2147
352770;201804;762;2296;587;1893;118;417;200;603;318;1020
352780;201804;608;1960;460;1600;84;302;144;484;228;786
352790;201804;607;1684;422;1334;60;199;141;406;201;605
352800;201804;1142;3834;860;3096;204;765;183;603;387;1368
352810;201804;1064;2669;654;1882;99;297;300;821;399;1118
352820;201804;556;1435;372;1141;74;230;89;267;163;497
352830;201804;573;1539;270;845;40;135;50;121;90;256
352840;201804;3780;11895;3260;10889;1033;3613;1119;3570;2152;7183
352850;201804;10097;26798;6967;21653;1820;6062;2010;6089;3830;12151
352860;201804;825;2633;721;2398;140;500;292;940;432;1440
352870;201804;842;2218;561;1589;50;163;308;801;358;964
352880;201804;1929;4923;1342;3814;203;609;638;1609;841;2218
352885;201804;258;798;206;700;25;86;129;432;154;518
352890;201804;654;1633;415;1115;61;190;183;410;244;600
352900;201804;17318;48076;12252;37986;2254;7616;5025;14550;7279;22166
352910;201804;413;1153;211;689;26;80;41;117;67;197
352920;201804;2428;6672;1751;5386;207;704;968;2801;1175;3505
352930;201804;5360;15860;4169;13391;812;2784;1620;4925;2432;7709
352940;201804;21500;64011;17087;54790;4924;17408;3610;10493;8534;27901
352950;201804;470;1252;261;827;46;161;21;50;67;211
352960;201804;646;1870;349;1172;51;189;85;262;136;451
352965;201804;311;868;173;566;45;154;29;82;74;236
352970;201804;3041;7490;2394;6484;245;663;1596;4338;1841;5001
352980;201804;1284;3790;1038;3360;220;765;493;1553;713;2318
352990;201804;3949;11748;3306;10665;715;2602;1607;4879;2322;7481
353000;201804;464;1275;233;758;47;173;56;155;103;328
353010;201804;2564;6818;1750;5244;409;1344;555;1521;964;2865
353020;201804;3758;10022;2165;6609;298;974;760;2134;1058;3108
353030;201804;3834;10507;2698;8318;662;2174;533;1590;1195;3764
353040;201804;549;1419;413;1186;84;263;167;433;251;696
353050;201804;4768;14828;3676;12559;927;3420;1414;4575;2341;7995
353060;201804;43737;120252;36702;108633;3347;11831;25766;73104;29113;84935
353070;201804;9383;27683;6629;21902;1471;5197;1960;6212;3431;11409
353080;201804;4444;13190;3072;10339;670;2464;887;2735;1557;5199
353090;201804;523;1730;450;1562;40;153;260;851;300;1004
353100;201804;298;815;114;387;13;52;25;72;38;124
353110;201804;7089;20898;6009;19161;974;3402;3638;11643;4612;15045
353120;201804;548;1526;365;1131;59;206;129;343;188;549
353130;201804;2359;6317;1668;5223;481;1620;513;1531;994;3151
353140;201804;2137;5716;1625;4749;200;652;922;2539;1122;3191
353150;201804;1437;3984;1067;3322;268;828;347;1031;615;1859
353160;201804;635;1725;435;1358;89;302;157;438;246;740
353170;201804;493;1486;408;1365;74;304;200;628;274;932
353180;201804;9322;24397;7436;21393;1031;3235;4902;13815;5933;17050
353190;201804;3392;9677;2712;8245;346;1139;1580;4498;1926;5637
353200;201804;1145;3612;766;2591;162;601;184;573;346;1174
353205;201804;323;1066;279;954;66;252;128;426;194;678
353210;201804;946;2377;614;1774;34;125;367;1020;401;1145
353215;201804;417;1238;345;1076;48;171;134;355;182;526
353220;201804;622;1782;448;1426;111;360;91;274;202;634
353230;201804;767;2324;654;2139;176;628;242;689;418;1317
353240;201804;2021;6036;1699;5419;221;819;1007;3069;1228;3888
353250;201804;1229;2911;741;2059;119;336;332;911;451;1247
353260;201804;963;2482;559;1744;117;379;162;488;279;867
353270;201804;609;1741;493;1498;61;182;249;718;310;900
353280;201804;688;2002;492;1567;86;286;154;473;240;759
353282;201804;1768;5337;1554;4901;217;761;864;2607;1081;3368
353284;201804;401;1015;207;617;32;111;73;193;105;304
353286;201804;123;369;91;307;24;84;22;60;46;144
353290;201804;1155;3318;816;2607;109;420;421;1220;530;1640
353300;201804;1565;4489;1176;3673;190;668;482;1364;672;2032
353310;201804;309;810;221;648;29;105;113;299;142;404
353320;201804;589;1629;492;1444;28;85;361;1050;389;1135
353325;201804;600;1888;424;1477;85;310;122;418;207;728
353330;201804;534;1463;348;1052;44;154;191;536;235;690
353340;201804;2876;7946;1914;6141;496;1709;568;1803;1064;3512
353350;201804;3152;9063;2150;6837;480;1646;382;1043;862;2689
353360;201804;477;1511;406;1364;64;241;203;662;267;903
353370;201804;544;1765;462;1603;43;164;284;963;327;1127
353380;201804;256;832;205;710;34;128;76;247;110;375
353390;201804;5162;13953;3930;11617;696;2177;1671;4677;2367;6854
353400;201804;404;1210;315;1026;68;239;58;143;126;382
353410;201804;556;1584;441;1369;95;325;208;620;303;945
353420;201804;485;1363;284;890;49;146;27;72;76;218
353430;201804;2032;6242;1520;5164;383;1398;428;1371;811;2769
353440;201804;56231;164940;40836;133116;8889;30167;17582;55221;26471;85388
353450;201804;393;1062;270;817;38;138;109;302;147;440
353460;201804;3387;9476;2450;7573;246;861;1080;3326;1326;4187
353470;201804;6694;18964;4853;15373;996;3440;1580;4642;2576;8082
353475;201804;1377;3908;1004;3046;136;449;420;1169;556;1618
353480;201804;1450;4229;1260;3840;84;282;896;2651;980;2933
353490;201804;896;2524;649;1985;132;403;264;769;396;1172
353500;201804;957;2397;767;2099;193;530;394;1109;587;1639
353510;201804;849;2662;615;2052;166;569;99;291;265;860
353520;201804;1129;3041;760;2352;73;249;373;1100;446;1349
353530;201804;2305;6407;1839;5485;243;823;968;2684;1211;3507
353540;201804;1893;5630;1589;5083;321;1075;795;2481;1116;3556
353550;201804;5713;16046;4566;13956;868;2864;2216;6406;3084;9270
353560;201804;2032;6236;1576;5435;512;1915;366;1173;878;3088
353570;201804;509;1468;372;1201;82;264;160;490;242;754
353580;201804;2056;5690;1650;4936;358;1098;786;2272;1144;3370
353590;201804;684;1958;430;1369;99;331;141;458;240;789
353600;201804;1670;4498;1385;3932;169;514;727;1970;896;2484
353610;201804;575;1901;432;1581;90;362;97;325;187;687
353620;201804;2395;7088;1792;5911;412;1459;463;1399;875;2858
353625;201804;514;1370;316;967;33;122;185;538;218;660
353630;201804;1209;4053;935;3382;198;738;205;692;403;1430
353640;201804;1298;3589;1003;3038;120;424;587;1742;707;2166
353650;201804;8565;24411;6429;19824;955;3195;3310;9559;4265;12754
353657;201804;300;887;240;781;38;121;97;295;135;416
353660;201804;1088;2462;747;1936;174;498;337;783;511;1281
353670;201804;3325;10176;2744;8983;690;2449;1185;3602;1875;6051
353680;201804;710;2060;542;1791;114;398;244;779;358;1177
353690;201804;495;1307;210;680;21;69;27;76;48;145
353700;201804;1870;5482;1594;4944;218;728;943;2791;1161;3519
353710;201804;3504;8051;1837;5229;269;754;876;2323;1145;3077
353715;201804;543;1529;367;1171;24;99;98;276;122;375
353720;201804;1857;5333;1501;4794;253;910;847;2586;1100;3496
353730;201804;4066;11723;3067;9598;516;1766;1317;3792;1833;5558
353740;201804;1784;4998;1249;3953;297;1038;322;926;619;1964
353750;201804;861;2757;593;2171;145;556;101;373;246;929
353760;201804;11291;28538;8994;25305;1280;4009;5713;15677;6993;19686
353770;201804;673;2057;339;1183;69;255;35;75;104;330
353780;201804;4286;13424;3417;11627;957;3550;816;2562;1773;6112
353790;201804;2164;7019;1685;6012;517;2122;341;1046;858;3168
353800;201804;15931;46298;12404;39898;2461;8513;5535;17582;7996;26095
353810;201804;1048;3018;706;2317;120;456;248;770;368;1226
353820;201804;1564;4776;1185;3924;217;805;445;1428;662;2233
353830;201804;604;1592;466;1358;59;175;245;675;304;850
353850;201804;1662;4863;1293;4125;355;1106;378;1244;733;2350
353860;201804;2464;7528;1981;6491;507;1748;727;2268;1234;4016
353870;201804;27338;76060;18814;58772;3015;10343;7896;22453;10911;32796
353880;201804;2801;8370;2258;7338;260;960;1227;3862;1487;4822
353890;201804;2287;5434;1606;4389;166;503;1007;2611;1173;3114
353900;201804;706;2079;525;1712;109;397;191;584;300;981
353910;201804;1966;6425;1744;6050;224;822;1205;4253;1429;5075
353920;201804;2253;6429;1533;4944;329;1194;307;836;636;2030
353930;201804;4061;11623;2790;9246;712;2550;547;1665;1259;4215
353940;201804;1081;3408;760;2654;152;558;198;654;350;1212
353950;201804;2960;8880;2425;7768;476;1702;1197;3498;1673;5200
353960;201804;605;1821;415;1402;91;288;126;416;217;704
353970;201804;586;1603;468;1391;46;143;293;845;339;988
353980;201804;12918;35802;10408;31390;1569;4993;6080;17858;7649;22851
353990;201804;768;2018;504;1516;55;179;293;842;348;1021
354000;201804;2251;5926;1370;4204;257;828;269;833;526;1661
354010;201804;352;989;263;816;35;112;162;484;197;596
354020;201804;3653;11060;2955;9495;754;2622;920;2686;1674;5308
354025;201804;772;2161;528;1695;107;366;133;428;240;794
354030;201804;477;1170;270;762;44;124;97;258;141;382
354040;201804;736;1866;468;1364;38;121;282;776;320;897
354050;201804;932;2852;670;2306;158;602;154;502;312;1104
354060;201804;4128;12375;2769;9344;714;2498;663;2061;1377;4559
354070;201804;2989;9045;2185;7370;505;1849;485;1408;990;3257
354075;201804;2067;6808;1656;5977;267;1116;840;2919;1107;4035
354080;201804;1431;4171;931;3117;174;602;245;739;419;1341
354085;201804;398;866;325;776;3;12;226;507;229;519
354090;201804;1424;4144;1266;3821;119;414;883;2622;1002;3036
354100;201804;14704;44469;11041;37864;2641;9713;4382;14825;7023;24538
354105;201804;978;2772;831;2539;148;447;483;1476;631;1923
354110;201804;457;1276;358;1124;92;317;106;308;198;625
354120;201804;1584;4400;1061;3240;185;594;357;975;542;1569
354130;201804;5595;15453;3764;11816;1121;3817;182;395;1303;4212
354140;201804;21103;52596;13574;38990;2784;8540;4588;12153;7372;20693
354150;201804;3290;8430;2427;6892;492;1508;1014;2726;1506;4234
354160;201804;3179;9849;2387;8098;669;2357;674;2244;1343;4601
354165;201804;514;1615;421;1428;93;362;198;613;291;975
354170;201804;1388;4241;1128;3641;107;400;621;1870;728;2270
354180;201804;469;1394;350;1131;58;206;119;341;177;547
354190;201804;1438;4309;1093;3599;149;550;379;1226;528;1776
354200;201804;898;2459;713;2121;86;268;343;943;429;1211
354210;201804;661;1966;526;1714;52;204;316;938;368;1142
354220;201804;2981;8452;2322;7179;410;1351;1115;3304;1525;4655
354230;201804;677;1915;538;1703;62;253;318;938;380;1191
354240;201804;1401;4191;941;3212;170;621;235;710;405;1331
354250;201804;524;1421;344;1120;103;349;89;288;192;637
354260;201804;7710;21951;6074;19060;1499;4940;1984;6254;3483;11194
354270;201804;1111;3484;891;3049;173;612;322;1104;495;1716
354280;201804;717;1966;609;1796;89;330;360;970;449;1300
354290;201804;845;2864;731;2589;148;531;304;1078;452;1609
354300;201804;3684;11375;3279;10601;1063;3583;1058;3249;2121;6832
354310;201804;744;2275;597;1954;106;367;240;731;346;1098
354320;201804;845;2279;546;1702;109;384;196;531;305;915
354323;201804;529;1353;346;995;43;118;138;378;181;496
354325;201804;1197;3784;890;3095;165;598;314;1035;479;1633
354330;201804;6405;17521;4860;14578;815;2873;2633;7230;3448;10103
354340;201804;24073;66277;17268;54420;4250;14427;6474;19587;10724;34014
354350;201804;1107;3089;918;2712;143;469;541;1474;684;1943
354360;201804;521;1526;309;1084;58;204;43;146;101;350
354370;201804;1027;3321;857;2973;133;494;451;1529;584;2023
354380;201804;757;2085;519;1655;108;400;109;279;217;679
354390;201804;12973;34038;8340;25532;1622;5281;2242;6407;3864;11688
354400;201804;1558;5258;1217;4400;211;831;404;1447;615;2278
354410;201804;4891;14403;3936;12558;931;3206;1635;5011;2566;8217
354420;201804;1375;3866;982;3027;145;478;523;1539;668;2017
354425;201804;2116;5738;1639;4856;391;1181;566;1720;957;2901
354430;201804;1470;4297;1179;3813;196;720;572;1733;768;2453
354440;201804;527;1521;350;1133;33;108;165;496;198;604
354450;201804;377;1037;221;724;35;128;51;147;86;275
354460;201804;923;2573;641;1986;111;351;266;805;377;1156
354470;201804;521;1337;361;1017;29;89;179;456;208;545
354480;201804;984;2400;691;1933;66;198;428;1139;494;1337
354490;201804;778;2458;594;2038;124;464;197;626;321;1090
354500;201804;2011;6040;1708;5589;558;1994;411;1336;969;3330
354510;201804;810;2235;664;1930;91;271;348;934;439;1205
354515;201804;276;856;210;723;38;153;88;290;126;443
354520;201804;6965;20931;4222;13790;688;2495;2019;6094;2707;8589
354530;201804;3642;11453;2906;9912;695;2505;1066;3611;1761;6116
354540;201804;1286;3675;951;3030;220;759;285;917;505;1676
354550;201804;538;1450;402;1189;60;187;230;647;290;834
354560;201804;1851;4889;1031;3102;128;416;519;1494;647;1910
354570;201804;1137;3108;488;1511;104;358;65;180;169;538
354580;201804;9715;26568;6349;20044;1055;3642;2689;7987;3744;11629
354600;201804;1667;4947;1324;4287;212;751;691;2146;903;2897
354610;201804;364;998;191;604;44;156;52;147;96;303
354620;201804;446;1334;304;1052;51;208;106;306;157;514
354625;201804;312;920;189;642;24;80;51;145;75;225
354630;201804;1963;6182;1619;5457;657;2377;156;475;813;2852
354640;201804;3090;9617;2255;7734;440;1669;531;1638;971;3307
354650;201804;875;2455;712;2135;87;256;436;1330;523;1586
354660;201804;2480;6505;1694;5207;102;386;1175;3570;1277;3956
354670;201804;1009;2943;716;2279;146;510;235;670;381;1180
354680;201804;4259;12551;3622;11455;931;3069;1777;5625;2708;8694
354690;201804;614;1981;416;1497;96;357;102;345;198;702
354700;201804;1010;2777;701;2120;124;409;293;768;417;1177
354710;201804;512;1468;357;1127;41;145;165;470;206;615
354720;201804;280;730;145;446;47;140;24;73;71;213
354730;201804;9223;26997;6769;22285;1090;3920;3442;10843;4532;14763
354740;201804;338;955;131;471;19;81;24;80;43;161
354750;201804;2411;6782;1640;5315;320;1176;614;1806;934;2982
354760;201804;1763;5241;1293;4286;389;1370;238;786;627;2156
354765;201804;283;793;132;437;19;75;27;79;46;154
354770;201804;2201;5782;1568;4650;369;1165;561;1594;930;2759
354780;201804;53281;141742;41914;118902;6256;19680;22432;59378;28688;79058
354790;201804;859;2614;719;2353;102;351;383;1217;485;1568
354800;201804;2485;6906;1965;6046;407;1333;861;2515;1268;3848
354805;201804;998;2801;738;2265;81;274;308;827;389;1101
354810;201804;572;1757;335;1209;59;236;80;256;139;492
354820;201804;901;2861;694;2425;134;525;163;493;297;1018
354830;201804;462;1172;313;899;94;279;107;287;201;566
354840;201804;749;2157;489;1528;76;223;222;688;298;911
354850;201804;19161;54365;13647;43614;2207;8132;7051;20913;9258;29045
354860;201804;1342;4053;983;3344;193;721;299;904;492;1625
354870;201804;46190;123313;37104;106482;5958;18483;19957;54757;25915;73240
354880;201804;5107;13346;2516;7597;345;1181;841;2063;1186;3244
354890;201804;15103;41074;12218;36059;2013;6438;6395;18190;8408;24628
354900;201804;447;1263;287;931;36;127;77;237;113;364
354910;201804;4897;13955;2904;9918;599;2192;255;817;854;3009
354920;201804;347;972;171;581;24;106;26;71;50;177
354925;201804;268;809;136;487;24;86;31;96;55;182
354930;201804;365;926;219;658;28;92;104;293;132;385
354940;201804;1709;5719;1329;4791;456;1753;150;507;606;2260
354950;201804;1455;4255;1176;3799;91;393;734;2231;825;2624
354960;201804;763;2182;601;1927;133;474;245;761;378;1235
354970;201804;3641;11251;2989;9946;473;1732;1681;5390;2154;7122
354980;201804;27075;68937;18254;52843;2455;8306;9092;24218;11547;32524
354990;201804;56259;152302;41936;125399;5375;17505;22740;64955;28115;82460
354995;201804;2221;5844;1669;5043;321;1063;925;2662;1246;3725
355000;201804;1408;4060;1144;3604;235;837;309;843;544;1680
355010;201804;2976;8957;2078;6825;716;2479;181;610;897;3089
355020;201804;3097;9407;2280;7760;742;2776;573;1867;1315;4643
355030;201804;1212112;3097864;922710;2543692;171232;512664;427293;1096446;598525;1609110
355040;201804;2735;7767;2297;7075;394;1241;1419;4385;1813;5626
355050;201804;977;2696;733;2250;215;649;177;508;392;1157
355060;201804;4799;14169;3662;11899;676;2493;1629;4767;2305;7260
355070;201804;7173;20425;5820;18090;880;3147;3196;9238;4076;12385
355080;201804;803;2552;524;1943;105;436;40;125;145;561
355090;201804;1105;3448;873;2982;198;679;267;934;465;1613
355100;201804;18822;52932;14926;46932;3011;10214;8356;25590;11367;35804
355110;201804;1015;3032;771;2607;272;986;139;469;411;1455
355120;201804;613;1782;453;1476;73;268;152;460;225;728
355130;201804;593;1443;266;747;29;79;112;299;141;378
355140;201804;1298;3698;1170;3490;150;519;826;2411;976;2930
355150;201804;3725;10577;2986;9241;513;1676;1469;4469;1982;6145
355160;201804;1755;5205;1347;4447;355;1309;315;985;670;2294
355170;201804;8080;22253;6445;19494;1878;5996;2657;7953;4535;13949
355180;201804;2677;7899;2011;6656;442;1718;639;1873;1081;3591
355190;201804;1605;4669;1319;4145;360;1218;555;1813;915;3031
355200;201804;786;2616;680;2422;268;1049;169;552;437;1601
355210;201804;2953;8566;2518;7675;279;1024;1552;4436;1831;5460
355220;201804;40548;114473;32263;98156;8883;28509;10910;30326;19793;58835
355230;201804;1225;3212;679;2064;136;403;162;463;298;866
355240;201804;21899;59830;14701;45350;2674;8573;5749;17387;8423;25960
355250;201804;32042;90891;24436;76888;6389;21395;8352;25417;14741;46812
355255;201804;821;2173;436;1374;76;220;140;455;216;675
355260;201804;1190;3238;913;2773;114;440;569;1605;683;2045
355270;201804;1463;4554;1142;3807;279;970;369;1147;648;2117
355280;201804;25857;71277;19225;58233;3434;11053;8237;23632;11671;34685
355290;201804;794;2434;609;1997;154;480;179;544;333;1024
355300;201804;1260;3864;1016;3342;219;770;301;957;520;1727
355310;201804;1010;2909;764;2473;85;323;399;1276;484;1599
355320;201804;526;1475;402;1227;73;267;150;379;223;646
355330;201804;2025;5793;1496;4802;212;761;877;2688;1089;3449
355340;201804;3038;7155;2590;6517;285;721;1804;4498;2089;5219
355350;201804;1297;4054;952;3298;199;742;278;949;477;1691
355360;201804;1224;3493;1049;3127;104;323;741;2236;845;2559
355365;201804;364;1016;192;669;39;119;26;87;65;206
355370;201804;5977;15526;4611;13574;1102;3367;1900;5946;3002;9313
355380;201804;2922;8368;2223;6932;405;1347;645;1727;1050;3074
355385;201804;1211;3607;1052;3316;165;597;535;1550;700;2147
355390;201804;730;2103;553;1722;120;381;212;619;332;1000
355395;201804;1924;5712;1385;4500;219;775;551;1637;770;2412
355400;201804;8548;26965;7066;23772;2057;7578;1902;5826;3959;13404
355410;201804;21439;61857;14673;48600;3631;13155;3045;10024;6676;23179
355420;201804;693;2411;591;2182;160;681;125;460;285;1141
355430;201804;3673;9736;2856;8281;716;2086;1188;3446;1904;5532
355440;201804;810;2328;539;1732;107;360;150;447;257;807
355450;201804;3637;10095;2259;7172;421;1424;753;2201;1174;3625
355460;201804;548;1451;347;1075;55;201;144;381;199;582
355465;201804;351;1057;251;824;44;159;65;204;109;363
355470;201804;1146;3086;627;1976;174;565;169;499;343;1064
355475;201804;263;691;237;645;21;64;182;489;203;553
355480;201804;3407;10513;2920;9649;493;1865;1696;5392;2189;7257
355490;201804;957;2705;519;1700;66;243;176;536;242;779
355495;201804;770;2376;593;2022;99;371;170;557;269;928
355500;201804;6527;18505;4055;13038;638;2244;1025;3028;1663;5272
355510;201804;1382;3708;834;2582;123;420;257;694;380;1114
355520;201804;394;918;190;525;22;67;97;249;119;316
355530;201804;462;1049;161;465;20;73;58;131;78;204
355535;201804;556;1613;432;1397;108;401;145;404;253;805
355540;201804;8490;24126;7204;22101;1340;4429;4169;12432;5509;16861
355550;201804;677;2066;535;1770;72;241;232;770;304;1011
355560;201804;1060;3064;575;1955;116;403;28;98;144;501
355570;201804;240;722;124;436;21;81;20;65;41;146
355580;201804;1218;3186;811;2460;116;422;365;1047;481;1469
355590;201804;190;494;141;416;17;53;85;241;102;294
355600;201804;1471;3890;1013;3019;257;827;368;1030;625;1857
355610;201804;1683;4542;1189;3574;179;567;543;1552;722;2119
355620;201804;4417;12912;3371;10641;464;1699;1680;4816;2144;6515
355630;201804;2143;6258;1510;5014;329;1127;579;1911;908;3038
355635;201804;924;2831;763;2546;112;406;441;1490;553;1896
355640;201804;2587;7902;1813;6336;440;1606;348;1224;788;2830
355645;201804;4070;12454;3302;11131;400;1572;1987;6567;2387;8139
355650;201804;6559;18536;5438;16439;1351;4403;2737;7691;4088;12094
355660;201804;1234;3522;894;2826;111;453;344;1045;455;1498
355670;201804;3241;9671;2241;7210;362;1358;978;2751;1340;4109
355680;201804;2728;7997;1173;4035;341;1253;95;285;436;1538
355690;201804;603;1923;408;1503;115;449;18;48;133;497
355695;201804;229;736;126;455;14;56;17;46;31;102
355700;201804;5997;18423;4987;16150;1202;3967;2086;6533;3288;10500
355710;201804;8150;20004;5089;14381;933;2811;1824;4675;2757;7486
355715;201804;352;1072;215;727;55;204;43;137;98;341
355720;201804;1434;4491;1136;3859;231;827;462;1424;693;2251
355730;201804;934;2857;734;2425;186;603;232;732;418;1335
410010;201804;1245;3607;952;2966;201;693;208;634;409;1327
410020;201804;1041;3334;853;2886;294;988;251;841;545;1829
410030;201804;1327;4092;1125;3677;218;791;507;1637;725;2428
410040;201804;10075;30373;8060;26508;1685;6090;2617;8130;4302;14220
410045;201804;1005;2742;677;2120;102;359;189;551;291;910
410050;201804;2578;6632;1599;4807;374;1215;280;737;654;1952
410060;201804;2083;6217;1669;5332;412;1368;558;1741;970;3109
410070;201804;1639;4490;1241;3709;252;803;422;1201;674;2004
410080;201804;1345;3687;989;3027;164;532;395;1197;559;1729
410090;201804;952;2777;877;2628;112;338;477;1504;589;1842
410100;201804;2089;6369;1510;4930;218;820;254;816;472;1636
410105;201804;366;1111;231;758;48;184;47;140;95;324
410110;201804;3033;8236;2135;6378;301;963;759;2206;1060;3169
410115;201804;502;1302;363;1046;71;225;126;332;197;557
410120;201804;2405;7782;2127;7282;783;2825;530;1765;1313;4590
410130;201804;1089;3149;984;2953;331;1102;320;839;651;1941
410140;201804;14890;37901;9273;27441;1883;6031;1857;5012;3740;11043
410150;201804;15869;39532;7590;22163;1452;4529;1311;3637;2763;8166
410160;201804;2832;8316;2406;7530;503;1736;903;2846;1406;4582
410165;201804;652;1884;539;1623;63;215;320;911;383;1126
410170;201804;2327;6387;1588;4722;408;1314;157;459;565;1773
410180;201804;12707;38282;10267;32767;1793;6065;4901;14736;6694;20801
410185;201804;503;1405;364;1141;62;198;105;305;167;503
410190;201804;1981;5416;1514;4502;332;1043;347;986;679;2029
410200;201804;4312;10974;2602;7787;515;1776;516;1504;1031;3280
410210;201804;2554;7191;1729;5391;284;1004;455;1200;739;2204
410220;201804;610;1619;409;1225;53;186;95;283;148;469
410230;201804;1422;4211;1196;3742;214;784;583;1704;797;2488
410240;201804;4122;11923;3360;10403;983;3420;386;1169;1369;4589
410250;201804;2636;6799;1840;5326;296;964;629;1750;925;2714
410260;201804;1684;4388;1131;3426;214;731;491;1442;705;2173
410270;201804;494;1333;370;1087;32;106;179;510;211;616
410275;201804;714;2150;471;1571;62;213;205;653;267;866
410280;201804;2055;5833;1346;4314;288;1039;389;1114;677;2153
410290;201804;3161;9342;2400;7723;534;1698;862;2799;1396;4497
410300;201804;663;1757;518;1481;81;254;218;568;299;822
410302;201804;345;923;171;567;23;71;95;317;118;388
410304;201804;1127;3341;981;3034;178;593;498;1521;676;2114
410305;201804;1659;4312;1223;3611;288;861;559;1656;847;2517
410310;201804;2306;7009;1922;6290;438;1558;605;1962;1043;3520
410315;201804;706;1839;353;1190;86;301;86;278;172;579
410320;201804;1115;3297;735;2430;105;402;112;361;217;763
410322;201804;512;1462;281;906;29;98;98;304;127;402
410330;201804;1406;3721;1047;3006;220;687;275;778;495;1465
410335;201804;859;2470;699;2144;115;396;301;853;416;1249
410337;201804;750;1927;526;1496;55;163;222;590;277;753
410340;201804;517;1425;351;1024;40;131;148;364;188;495
410345;201804;2079;5637;1163;3640;249;820;263;746;512;1566
410347;201804;693;1788;498;1424;48;169;146;398;194;567
410350;201804;1272;3620;928;2925;128;446;321;922;449;1368
410360;201804;3988;10195;3086;8609;248;818;1915;5125;2163;5943
410370;201804;10860;30275;7561;22888;1097;3692;2680;7134;3777;10826
410380;201804;1375;3832;1095;3247;129;476;434;1191;563;1667
410390;201804;2489;6954;1675;5288;444;1547;329;929;773;2476
410395;201804;882;2715;721;2365;142;512;321;1063;463;1575
410400;201804;4808;13983;3756;11813;696;2334;1409;4242;2105;6576
410405;201804;790;2115;643;1867;139;428;293;829;432;1257
410410;201804;1125;3296;1101;3267;195;727;658;1946;853;2673
410420;201804;7125;21920;5559;18447;1137;4178;1359;4101;2496;8279
410425;201804;2734;8249;2019;6770;357;1298;601;1887;958;3185
410430;201804;12470;32631;8700;25601;1496;4787;2656;7463;4152;12250
410440;201804;2761;9172;2445;8564;397;1452;1321;4801;1718;6253
410442;201804;2298;7420;1982;6721;606;2147;614;2060;1220;4207
410445;201804;2206;6826;1784;5961;403;1488;491;1684;894;3172
410450;201804;1554;4341;1196;3619;227;749;269;709;496;1458
410460;201804;1652;4495;1286;3884;236;772;477;1367;713;2139
410465;201804;2410;7475;1894;6319;457;1522;542;1754;999;3276
410470;201804;1764;5398;1301;4352;320;1164;255;891;575;2055
410480;201804;30269;80689;17373;54872;2659;9269;2024;5484;4683;14753
410490;201804;10716;31448;7690;24863;1561;5369;2429;7358;3990;12727
410500;201804;1591;4692;1180;3785;310;1109;243;671;553;1780
410510;201804;2129;5549;1385;4014;258;751;426;1208;684;1959
410520;201804;2959;9804;2711;9293;733;2586;1200;4135;1933;6721
410530;201804;1501;4107;782;2393;128;385;91;215;219;600
410540;201804;2551;7355;1850;5900;290;966;840;2655;1130;3621
410550;201804;6368;17735;4133;12770;797;2706;769;2091;1566;4797
410560;201804;1319;3667;1038;3119;234;757;406;1113;640;1870
410570;201804;2543;7638;2013;6616;545;2018;246;876;791;2894
410580;201804;22471;62533;17333;52694;3522;11791;6955;19577;10477;31368
410590;201804;1364;4133;904;2937;155;538;196;556;351;1094
410600;201804;1705;4865;1342;4128;305;918;457;1457;762;2375
410610;201804;745;2047;549;1661;69;227;203;576;272;803
410620;201804;1905;6015;1268;4447;301;1142;191;584;492;1726
410630;201804;2224;6433;1448;4679;285;1003;170;442;455;1445
410640;201804;4252;10914;2905;8513;733;2402;428;1180;1161;3582
410645;201804;1079;3499;963;3312;375;1344;284;1003;659;2347
410650;201804;1893;5580;1404;4524;366;1281;362;1040;728;2321
410655;201804;1346;4438;1096;3941;54;182;760;2906;814;3088
410657;201804;657;1768;413;1238;81;267;149;381;230;648
410660;201804;3104;8435;1668;5196;339;1089;255;758;594;1847
410670;201804;959;2470;592;1709;108;297;269;734;377;1031
410680;201804;2829;8846;2065;6956;513;1694;478;1690;991;3384
410685;201804;571;1595;474;1415;91;313;228;638;319;951
410690;201804;116679;311899;77711;234476;13742;46124;23142;61119;36884;107243
410700;201804;2169;5945;1866;5431;366;1143;894;2432;1260;3575
410710;201804;860;2372;564;1774;70;228;263;784;333;1012
410712;201804;674;2018;575;1824;163;560;186;534;349;1094
410715;201804;847;2688;562;1982;103;368;148;513;251;881
410720;201804;2891;8140;2195;6684;331;1182;409;1102;740;2284
410725;201804;1050;2806;672;2065;117;390;108;287;225;677
410730;201804;548;1492;398;1214;95;343;71;194;166;537
410740;201804;937;2706;661;2155;123;435;259;827;382;1262
410750;201804;1685;4632;1371;4010;241;787;503;1377;744;2164
410752;201804;324;840;149;452;22;72;58;156;80;228
410753;201804;228;693;157;526;21;73;25;73;46;146
410754;201804;1128;3062;940;2752;67;161;589;1882;656;2043
410755;201804;676;1716;481;1348;43;129;251;651;294;780
410760;201804;2870;7996;2255;6888;662;2168;595;1797;1257;3965
410765;201804;12421;36820;9656;31300;1544;5558;1252;3861;2796;9419
410770;201804;910;2353;626;1843;99;322;245;705;344;1027
410773;201804;1272;3563;1133;3344;155;522;798;2299;953;2821
410775;201804;1408;3829;1233;3549;180;562;544;1538;724;2100
410780;201804;579;1528;354;1047;70;211;80;259;150;470
410785;201804;737;2177;599;1896;134;433;176;528;310;961
410790;201804;574;1779;475;1554;134;463;39;100;173;563
410800;201804;2895;6845;2319;5992;184;538;1181;2964;1365;3502
410810;201804;347;990;269;837;40;136;113;335;153;471
410820;201804;762;2274;453;1440;90;294;70;207;160;501
410830;201804;27720;74114;20559;61438;5195;17296;6516;18388;11711;35684
410832;201804;1000;2736;846;2435;116;423;456;1208;572;1631
410840;201804;7024;19243;4341;13787;988;3480;571;1481;1559;4961
410845;201804;1123;3216;930;2856;189;623;325;962;514;1585
410850;201804;2387;7161;2094;6615;418;1436;841;2651;1259;4087
410855;201804;584;1570;425;1258;46;155;184;503;230;658
410860;201804;3792;10405;2941;8743;535;1678;964;2756;1499;4434
410865;201804;1366;4412;1228;4110;265;968;649;2230;914;3198
410870;201804;1215;3462;1068;3234;96;307;717;2180;813;2487
410880;201804;3926;11529;2971;9640;542;1972;423;1443;965;3415
410890;201804;899;2784;677;2288;153;553;177;592;330;1145
410895;201804;921;3091;795;2805;313;1184;125;413;438;1597
410900;201804;867;2377;588;1814;104;340;145;369;249;709
410910;201804;364;904;221;616;15;44;113;291;128;335
410920;201804;732;1996;574;1718;117;396;219;636;336;1032
410930;201804;1399;4068;1116;3481;304;1072;249;747;553;1819
410940;201804;20573;61441;15931;52489;4204;14939;3304;11070;7508;26009
410950;201804;1862;5718;1689;5441;78;308;1367;4342;1445;4650
410960;201804;7159;19268;4538;14463;1175;4147;1304;3988;2479;8135
410965;201804;985;2804;749;2317;135;433;346;1037;481;1470
410970;201804;3789;10724;2774;8744;666;2471;426;1193;1092;3664
410975;201804;1288;3570;993;3004;200;666;313;940;513;1606
410980;201804;6397;17345;4245;13143;595;1994;1627;4825;2222;6819
410990;201804;1123;3079;736;2314;238;861;143;358;381;1219
411000;201804;478;1394;345;1116;43;147;84;224;127;371
411005;201804;435;1234;276;884;59;183;42;142;101;325
411007;201804;2192;6648;1875;6036;443;1527;580;1858;1023;3385
411010;201804;4032;12794;3347;11307;897;3210;339;1070;1236;4280
411020;201804;2344;6950;1976;6301;598;2023;551;1705;1149;3728
411030;201804;698;1831;456;1282;74;220;149;367;223;587
411040;201804;750;2039;328;1002;55;182;66;181;121;363
411050;201804;1789;5965;1535;5370;441;1661;232;716;673;2377
411060;201804;1570;4398;1091;3411;209;782;227;622;436;1404
411065;201804;334;950;253;792;36;112;108;338;144;450
411070;201804;6240;17341;4933;14909;1040;3416;1766;5127;2806;8543
411080;201804;2089;5873;1683;5109;452;1476;416;1269;868;2745
411090;201804;808;2172;540;1657;50;180;98;261;148;441
411095;201804;1428;3616;1013;2892;148;480;348;937;496;1417
411100;201804;1134;3172;791;2480;101;370;209;649;310;1019
411110;201804;550;1527;253;831;27;73;17;42;44;115
411120;201804;1343;4001;1038;3341;330;1209;190;495;520;1704
411125;201804;4646;14278;4308;13664;964;3188;2035;6633;2999;9821
411130;201804;652;1855;463;1439;103;323;149;487;252;810
411140;201804;2177;6979;1788;6077;437;1559;693;2403;1130;3962
411150;201804;3532;9729;2562;7692;543;1856;213;500;756;2356
411155;201804;962;2579;603;1875;65;215;259;749;324;964
411160;201804;309;788;220;633;32;92;56;165;88;257
411170;201804;719;2211;545;1796;127;440;173;550;300;990
411180;201804;5289;14947;4151;12814;790;2663;1585;4694;2375;7357
411190;201804;1275;3512;990;2941;213;686;258;673;471;1359
411200;201804;4742;13325;3355;10588;880;3001;830;2489;1710;5490
411210;201804;2155;5458;1572;4485;443;1426;164;412;607;1838
411220;201804;859;2345;650;1922;142;465;217;615;359;1080
411230;201804;977;2674;645;2035;135;446;194;617;329;1063
411240;201804;1350;3389;850;2448;78;246;444;1250;522;1496
411250;201804;1930;5512;1522;4772;352;1255;461;1423;813;2678
411260;201804;347;904;222;661;30;91;84;228;114;319
411270;201804;1769;5203;1433;4507;248;849;639;1957;887;2806
411275;201804;1317;3600;970;2941;179;583;379;1130;558;1713
411280;201804;1423;4011;891;2856;162;566;128;348;290;914
411290;201804;708;1985;497;1570;73;233;214;678;287;911
411295;201804;1060;2746;865;2373;99;309;408;1068;507;1377
411300;201804;1007;2584;650;1865;63;193;241;605;304;798
411310;201804;873;2190;670;1881;44;130;261;718;305;848
411320;201804;5102;14257;3715;11632;874;2830;998;2891;1872;5721
411325;201804;1512;4517;1297;4094;240;763;671;2186;911;2949
411330;201804;3086;9053;2378;7645;614;2147;600;1958;1214;4105
411340;201804;772;2221;489;1551;67;249;201;611;268;860
411342;201804;812;2122;565;1628;99;299;258;707;357;1006
411345;201804;978;2797;793;2446;107;376;489;1494;596;1870
411350;201804;2528;7256;1812;5790;461;1615;170;554;631;2169
411360;201804;611;1535;427;1238;53;179;133;351;186;530
411370;201804;44679;117746;33410;97741;3567;12126;17506;47800;21073;59926
411373;201804;1347;3751;1102;3343;140;466;490;1501;630;1967
411375;201804;1024;2743;771;2277;130;402;264;721;394;1123
411380;201804;1057;2677;721;1952;69;227;369;889;438;1116
411390;201804;1627;4747;1280;3906;215;727;438;1212;653;1939
411400;201804;2048;5494;1645;4697;293;971;677;1833;970;2804
411410;201804;1997;5833;1476;4701;354;1231;287;811;641;2042
411420;201804;3794;9975;2262;6894;334;1175;385;930;719;2105
411430;201804;3162;9007;2557;7962;564;1893;1018;2971;1582;4864
411435;201804;424;1235;284;934;52;162;108;327;160;489
411440;201804;2568;7899;2154;7032;513;1772;619;2086;1132;3858
411450;201804;2574;7178;2004;6198;334;1043;1013;3173;1347;4216
411460;201804;3810;10580;2088;6831;344;1323;295;869;639;2192
411470;201804;684;1972;479;1519;78;266;104;311;182;577
411480;201804;4299;12498;3022;9893;574;2099;683;2074;1257;4173
411490;201804;1460;4131;1125;3506;176;641;359;998;535;1639
411500;201804;1529;4059;1049;3132;156;551;325;924;481;1475
411510;201804;1993;5639;1646;4942;399;1354;353;1045;752;2399
411520;201804;25724;66197;14661;44011;2160;7113;4232;11373;6392;18486
411530;201804;894;2482;587;1885;128;451;146;437;274;888
411535;201804;467;1406;203;724;16;67;24;65;40;132
411540;201804;2798;7397;1981;5705;374;1178;646;1783;1020;2961
411545;201804;954;2919;815;2651;82;280;521;1703;603;1983
411550;201804;652;1770;498;1484;92;307;78;222;170;529
411560;201804;1957;5568;1245;4024;163;602;71;168;234;770
411570;201804;6931;17402;4830;13980;1012;3276;1248;3543;2260;6819
411573;201804;779;2183;678;2018;73;218;410;1216;483;1434
411575;201804;1606;4698;1289;4064;295;979;345;1079;640;2058
411580;201804;4088;10458;2389;7541;257;992;301;855;558;1847
411585;201804;773;2358;351;1198;83;286;53;154;136;440
411590;201804;373;1096;270;856;30;110;132;377;162;487
411600;201804;281;785;187;616;41;148;66;212;107;360
411605;201804;1397;3746;921;2717;140;483;359;969;499;1452
411610;201804;2203;5984;1569;4623;247;780;711;2053;958;2833
411620;201804;2809;8111;2456;7549;416;1417;1399;4218;1815;5635
411630;201804;590;1603;395;1231;84;300;81;216;165;516
411640;201804;495;1415;347;1053;46;140;123;348;169;488
411650;201804;185;543;126;415;19;57;19;73;38;130
411660;201804;876;2329;635;1858;71;212;302;871;373;1083
411670;201804;1080;2900;796;2276;126;361;286;785;412;1146
411680;201804;1526;4338;1236;3794;154;544;638;1940;792;2484
411690;201804;3233;9063;2491;7696;519;1651;710;2279;1229;3930
411695;201804;665;2082;493;1675;71;265;163;568;234;833
411700;201804;1496;4168;1024;3244;234;803;134;373;368;1176
411705;201804;1604;5498;1422;5144;287;1007;807;3071;1094;4078
411710;201804;1779;4859;1322;3987;369;1175;153;469;522;1644
411720;201804;929;2475;682;1970;97;305;223;595;320;900
411721;201804;807;2217;620;1829;124;384;132;377;256;761
411722;201804;658;1878;386;1245;68;267;144;392;212;659
411725;201804;1279;3931;812;2811;184;668;162;565;346;1233
411727;201804;1534;4472;1040;3385;298;1008;136;402;434;1410
411729;201804;649;1680;441;1277;97;297;108;275;205;572
411730;201804;5125;14487;3890;11927;1105;3523;1164;3522;2269;7045
411740;201804;563;1575;294;940;54;185;55;159;109;344
411745;201804;816;2398;580;1835;83;272;126;347;209;619
411750;201804;4724;13375;3567;10970;494;1643;1597;4684;2091;6327
411760;201804;7034;19708;5563;17011;1895;6113;1036;3357;2931;9470
411770;201804;3124;9662;2393;7971;631;2207;298;949;929;3156
411780;201804;2898;8549;2514;7825;661;2164;968;3019;1629;5183
411790;201804;2908;7751;1717;5293;391;1358;227;589;618;1947
411800;201804;1011;2921;673;2135;100;330;115;354;215;684
411810;201804;1682;4586;1293;3837;225;727;564;1545;789;2272
411820;201804;11064;34445;9068;30322;2856;9943;2715;9031;5571;18974
411830;201804;573;1427;394;1122;97;306;60;182;157;488
411840;201804;10497;29017;7103;21905;1331;4434;1746;5149;3077;9583
411845;201804;427;1275;230;773;41;157;19;61;60;218
411850;201804;7385;20459;5524;16936;1616;5384;866;2507;2482;7891
411860;201804;773;2329;588;1919;102;353;154;468;256;821
411870;201804;657;2071;462;1566;89;328;98;295;187;623
411880;201804;2038;5686;1502;4699;367;1262;239;733;606;1995
411885;201804;856;2307;663;1967;113;406;232;668;345;1074
411890;201804;1068;3086;729;2347;112;402;49;133;161;535
411900;201804;838;2527;511;1718;130;445;50;164;180;609
411910;201804;1034;3263;762;2651;218;789;182;606;400;1395
411915;201804;16385;42200;10120;30285;1795;5832;2676;7246;4471;13078
411920;201804;912;2933;776;2613;203;740;182;596;385;1336
411925;201804;573;1552;383;1187;92;302;104;300;196;602
411930;201804;5312;17253;4608;15833;2120;7920;270;1001;2390;8921
411940;201804;3095;9864;2467;8332;603;2079;559;1711;1162;3790
411950;201804;12973;37763;10720;33768;2199;7519;5012;15287;7211;22806
411960;201804;5395;15275;4611;13770;965;3173;1649;4611;2614;7784
411965;201804;453;1292;333;1063;57;216;119;352;176;568
411970;201804;835;2194;681;1962;122;317;387;1239;509;1556
411980;201804;1464;4055;1184;3526;301;927;379;1080;680;2007
411990;201804;34356;99143;23950;77625;5086;18162;7233;22056;12319;40218
411995;201804;2567;6956;2002;6041;569;1918;578;1610;1147;3528
412000;201804;2138;5107;1544;4108;94;308;946;2323;1040;2631
412010;201804;666;2138;465;1647;68;274;96;288;164;562
412015;201804;562;1648;468;1471;72;233;244;766;316;999
412020;201804;438;1269;264;864;44;160;97;296;141;456
412030;201804;697;2071;491;1648;89;325;162;524;251;849
412033;201804;894;2612;634;2030;81;267;224;728;305;995
412035;201804;849;2262;544;1724;76;268;249;754;325;1022
412040;201804;575;1650;386;1248;67;216;63;195;130;411
412050;201804;1646;4496;1204;3641;226;770;284;859;510;1629
412060;201804;7006;22597;6089;20681;1824;6719;1389;4556;3213;11275
412065;201804;651;1890;490;1556;95;317;146;446;241;763
412070;201804;1231;3203;902;2527;132;390;364;1008;496;1398
412080;201804;1677;5013;1055;3590;148;548;73;235;221;783
412085;201804;319;890;100;353;9;35;8;21;17;56
412090;201804;5211;14324;4406;12886;1172;3462;1939;5842;3111;9304
412100;201804;1783;5181;1382;4426;422;1454;255;844;677;2298
412110;201804;844;2401;610;1863;118;390;160;487;278;877
412120;201804;1726;5534;1405;4817;322;1203;383;1088;705;2291
412125;201804;625;1933;497;1634;114;386;158;495;272;881
412130;201804;615;1761;446;1384;71;233;100;326;171;559
412135;201804;581;1627;273;840;45;135;85;243;130;378
412140;201804;1573;4189;1066;3216;225;762;162;432;387;1194
412150;201804;2968;8139;2475;7197;306;1001;1524;4290;1830;5291
412160;201804;1068;3424;651;2304;160;617;78;265;238;882
412170;201804;4132;12212;3463;10952;794;2714;1416;4170;2210;6884
412175;201804;1311;4157;1117;3776;261;866;408;1399;669;2265
412180;201804;1644;4757;1220;3958;189;729;512;1500;701;2229
412190;201804;3273;8713;2445;7171;362;1165;993;2990;1355;4155
412200;201804;1869;5793;1335;4478;344;1228;237;775;581;2003
412210;201804;592;1554;359;1085;70;243;79;194;149;437
412215;201804;3743;10298;3122;9093;848;2490;1262;4052;2110;6542
412217;201804;1031;2846;877;2580;72;247;591;1653;663;1900
412220;201804;5591;16614;4779;15034;1178;3684;1769;5904;2947;9588
412230;201804;2764;8740;2247;7612;402;1560;615;1858;1017;3418
412240;201804;6847;18147;4368;13259;815;2730;1071;3026;1886;5756
412250;201804;1925;5314;1508;4479;385;1194;242;658;627;1852
412260;201804;1209;3427;856;2652;128;400;261;749;389;1149
412265;201804;851;2548;723;2271;176;584;277;860;453;1444
412270;201804;778;2348;518;1719;73;268;191;591;264;859
412280;201804;513;1571;422;1394;105;366;98;307;203;673
412290;201804;986;2600;663;1982;111;370;195;547;306;917
412300;201804;1466;4289;1213;3772;305;1007;262;792;567;1799
412310;201804;799;2335;661;2083;70;312;323;998;393;1310
412320;201804;826;2222;572;1720;84;322;182;532;266;854
412330;201804;1402;3886;974;3011;194;636;343;1053;537;1689
412340;201804;969;2846;623;1998;102;351;123;351;225;702
412350;201804;2613;7290;1707;5388;314;1079;254;759;568;1838
412360;201804;240;688;148;472;16;57;55;168;71;225
412370;201804;797;2395;585;1972;124;464;47;167;171;631
412380;201804;1536;4465;1097;3476;276;914;196;653;472;1567
412382;201804;561;1485;370;1105;59;184;105;274;164;458
412385;201804;2183;6329;1830;5592;637;1968;499;1616;1136;3584
412390;201804;2263;5957;1856;5307;374;1143;799;2289;1173;3432
412395;201804;720;2069;510;1620;55;175;241;727;296;902
412400;201804;890;2587;671;2108;155;498;156;524;311;1022
412402;201804;1725;4674;1324;3982;299;1000;160;454;459;1454
412405;201804;3123;8914;1994;6431;401;1441;65;217;466;1658
412410;201804;5053;14353;3832;12065;878;3138;905;2648;1783;5786
412420;201804;450;1219;253;775;29;94;105;289;134;383
412430;201804;532;1435;353;1072;37;122;140;409;177;531
412440;201804;2809;8186;1952;6483;494;1769;341;1142;835;2911
412450;201804;303;960;227;773;30;96;19;45;49;141
412460;201804;856;2502;716;2230;143;491;260;779;403;1270
412470;201804;1702;5623;1366;4801;354;1296;278;1032;632;2328
412480;201804;959;2757;614;1908;103;344;87;212;190;556
412490;201804;1024;2815;847;2463;143;401;365;1012;508;1413
412500;201804;1790;4858;1383;4060;259;796;294;764;553;1560
412510;201804;1955;6175;1437;4844;354;1268;166;512;520;1780
412520;201804;1301;3626;840;2590;190;580;90;267;280;847
412530;201804;610;1699;454;1379;67;220;114;339;181;559
412535;201804;756;2101;529;1620;113;376;101;289;214;665
412540;201804;1215;3325;857;2545;105;382;257;783;362;1165
412545;201804;690;1862;463;1363;84;258;121;324;205;582
412550;201804;30191;86580;20667;65959;4178;14166;5892;17401;10070;31567
412555;201804;231;653;147;463;19;66;39;100;58;166
412560;201804;5055;15184;3753;12141;803;2851;851;2659;1654;5510
412570;201804;3819;10538;2381;7504;484;1647;318;1081;802;2728
412575;201804;918;2626;750;2249;84;286;376;1045;460;1331
412580;201804;1341;3605;944;2822;155;501;387;1089;542;1590
412590;201804;484;1337;256;849;47;155;24;68;71;223
412600;201804;1367;4001;1014;3206;183;631;378;1159;561;1790
412610;201804;755;2161;484;1488;74;235;202;572;276;807
412620;201804;1235;3554;925;2980;198;737;274;797;472;1534
412625;201804;8043;22835;5401;17390;844;2930;520;1796;1364;4726
412627;201804;936;2771;649;2154;177;653;174;544;351;1197
412630;201804;2960;9015;2178;7209;394;1276;671;2061;1065;3337
412635;201804;356;994;243;747;45;145;47;127;92;272
412640;201804;1010;2863;583;1859;85;285;119;348;204;633
412650;201804;1478;4300;1226;3808;213;770;421;1156;634;1926
412660;201804;2553;7011;1790;5458;321;1070;472;1316;793;2386
412665;201804;561;1424;318;972;58;188;112;322;170;510
412667;201804;1676;4621;1265;3785;198;686;490;1385;688;2071
412670;201804;545;1586;437;1379;92;328;142;431;234;759
412680;201804;1371;3950;871;2912;135;539;297;853;432;1392
412690;201804;818;2370;601;1895;120;385;147;442;267;827
412700;201804;2013;5561;1616;4918;323;1155;675;1962;998;3117
412710;201804;5899;18107;4770;15770;976;3478;1317;4041;2293;7519
412720;201804;1225;3741;918;2983;157;555;193;539;350;1094
412730;201804;2080;6039;1173;3893;241;838;174;541;415;1379
412740;201804;1653;4868;1107;3631;203;748;142;488;345;1236
412750;201804;3870;11188;3392;10388;415;1515;2164;6410;2579;7925
412760;201804;2680;7781;2346;7200;356;1203;1354;4043;1710;5246
412770;201804;10051;26778;5414;16888;748;2417;1043;2887;1791;5304
412780;201804;1243;3637;1035;3228;214;709;392;1201;606;1910
412785;201804;2031;5419;1459;4336;335;1004;625;1828;960;2832
412788;201804;1336;4012;1101;3530;263;910;448;1362;711;2272
412790;201804;1033;3005;665;2188;125;453;180;504;305;957
412795;201804;1127;3123;661;2038;131;430;142;415;273;845
412796;201804;2317;7111;1941;6250;379;1315;642;1889;1021;3204
412800;201804;3180;8443;2217;6483;312;1043;840;2243;1152;3286
412810;201804;10629;28041;6250;18691;877;2950;1802;4537;2679;7487
412820;201804;6637;18931;4844;15341;1046;3493;1453;4580;2499;8073
412830;201804;330;986;238;784;35;111;50;164;85;275
412840;201804;1789;4910;1348;4037;217;694;402;1174;619;1868
412850;201804;2947;8148;2220;6834;376;1255;763;2249;1139;3504
412853;201804;1784;4876;1469;4168;155;482;742;1887;897;2369
412855;201804;1227;3478;863;2640;151;520;210;555;361;1075
412860;201804;921;2682;710;2238;151;503;242;740;393;1243
412862;201804;676;1644;435;1219;68;212;167;457;235;669
412863;201804;1159;3733;1101;3641;105;354;837;2762;942;3116
412865;201804;726;2103;535;1732;91;299;184;608;275;907
412870;201804;897;2522;693;2178;227;788;139;461;366;1249
412880;201804;825;2386;560;1783;99;355;74;216;173;571
420005;201804;439;1317;247;857;38;138;97;330;135;468
420010;201804;3573;9181;2368;7051;226;755;1604;4783;1830;5538
420020;201804;536;1708;315;1131;47;191;46;130;93;321
420030;201804;185;532;98;372;20;91;12;44;32;135
420040;201804;588;1836;329;1233;50;202;14;41;64;243
420050;201804;646;1667;419;1253;61;193;231;664;292;857
420055;201804;149;461;73;273;11;51;22;80;33;131
420060;201804;135;425;92;317;14;59;18;38;32;97
420070;201804;950;3014;709;2437;141;523;239;805;380;1328
420075;201804;101;277;58;179;10;30;13;26;23;56
420080;201804;446;1353;342;1140;100;335;93;298;193;633
420090;201804;369;1271;250;947;50;193;53;210;103;403
420100;201804;1103;3241;975;3055;78;268;748;2323;826;2591
420110;201804;245;826;228;788;57;212;80;252;137;464
420120;201804;337;1043;243;818;54;213;90;269;144;482
420125;201804;308;1032;254;922;61;257;121;421;182;678
420127;201804;277;767;97;336;19;73;17;48;36;121
420130;201804;1907;6002;1427;4991;318;1224;457;1436;775;2660
420140;201804;3252;9356;2361;7684;617;2276;304;932;921;3208
420150;201804;526;1405;333;1081;67;240;129;382;196;622
420160;201804;234;625;112;374;13;47;38;124;51;171
420165;201804;159;486;101;340;27;97;28;82;55;179
420170;201804;233;739;144;524;33;132;22;75;55;207
420180;201804;232;710;125;448;18;63;34;107;52;170
420190;201804;155;513;89;337;29;116;17;60;46;176
420195;201804;1263;3576;964;3058;258;919;125;353;383;1272
420200;201804;2920;8242;1690;5655;301;1215;459;1325;760;2540
420205;201804;1208;3573;895;2966;144;529;486;1622;630;2151
420207;201804;1447;4056;942;3058;227;848;275;835;502;1683
420208;201804;431;1198;247;875;44;194;103;370;147;564
420209;201804;165;553;104;380;31;129;36;120;67;249
420210;201804;2211;6138;1389;4735;306;1150;550;1799;856;2949
420213;201804;758;2560;673;2380;174;673;299;1047;473;1720
420215;201804;271;847;172;615;52;183;16;56;68;239
420220;201804;164;549;116;449;34;143;33;121;67;264
420230;201804;3621;10442;2729;8833;421;1573;1321;4114;1742;5687
420240;201804;10889;29718;6888;21769;897;3390;3371;9511;4268;12901
420243;201804;414;1247;329;1080;63;223;140;431;203;654
420245;201804;1134;3171;790;2531;86;345;421;1246;507;1591
420250;201804;439;1358;387;1252;87;315;172;517;259;832
420253;201804;512;1346;377;1140;31;94;205;613;236;707
420257;201804;207;555;126;402;23;78;62;201;85;279
420260;201804;1016;3086;782;2684;138;529;377;1260;515;1789
420270;201804;489;1357;229;734;22;84;84;258;106;342
420280;201804;1533;4219;944;3139;192;678;235;750;427;1428
420285;201804;101;272;50;177;9;37;7;16;16;53
420287;201804;411;1078;281;872;91;298;90;270;181;568
420290;201804;3951;11970;2994;9777;533;1892;1104;3263;1637;5155
420300;201804;6408;18660;3751;12537;782;2975;823;2365;1605;5340
420310;201804;830;2038;422;1196;71;193;239;652;310;845
420315;201804;838;2646;621;2182;156;578;222;770;378;1348
420320;201804;3858;11650;3096;10231;1014;3660;689;2073;1703;5733
420325;201804;223;717;165;594;44;160;44;158;88;318
420330;201804;828;2646;586;2066;126;485;183;591;309;1076
420340;201804;1107;3305;782;2611;151;510;57;189;208;699
420350;201804;1434;3996;993;3119;135;468;564;1746;699;2214
420360;201804;2453;7254;1396;4859;274;1057;116;389;390;1446
420370;201804;1284;3594;995;3096;137;527;640;1890;777;2417
420380;201804;4978;14081;3208;10442;732;2532;928;2971;1660;5503
420390;201804;1000;2634;652;1930;104;335;237;527;341;862
420395;201804;1016;3049;661;2259;101;361;76;226;177;587
420400;201804;958;2915;632;2184;124;493;140;449;264;942
420410;201804;545;1541;403;1257;33;132;288;872;321;1004
420415;201804;330;1022;252;851;79;287;68;224;147;511
420417;201804;641;2020;514;1725;108;380;194;648;302;1028
420419;201804;215;746;154;591;52;226;7;24;59;250
420420;201804;9818;27880;7113;22834;2471;8576;1482;4369;3953;12945
420425;201804;803;2158;560;1708;52;197;241;691;293;888
420430;201804;3138;9209;1959;6462;440;1531;538;1624;978;3155
420435;201804;271;771;126;450;23;104;41;131;64;235
420440;201804;754;2244;417;1401;128;491;108;313;236;804
420445;201804;318;893;188;603;42;144;55;157;97;301
420450;201804;653;2005;466;1576;93;365;128;393;221;758
420455;201804;1877;5105;1434;4357;200;692;718;2102;918;2794
420460;201804;8080;22707;6085;19142;1104;3927;2592;7702;3696;11629
420470;201804;690;1855;396;1265;76;280;93;249;169;529
420475;201804;37;114;30;97;12;37;5;16;17;53
420480;201804;4620;12431;3083;9711;631;2155;914;2783;1545;4938
420490;201804;540;1444;293;1004;69;262;66;231;135;493
420500;201804;1272;3857;902;3117;197;720;307;1044;504;1764
420510;201804;111;373;72;254;11;39;37;124;48;163
420515;201804;54;153;39;124;5;19;15;43;20;62
420517;201804;759;2171;677;2027;44;124;530;1585;574;1709
420519;201804;358;916;229;704;35;128;76;230;111;358
420520;201804;456;1247;214;751;20;62;20;62;40;124
420530;201804;980;2960;693;2331;147;562;194;570;341;1132
420535;201804;226;648;100;337;26;87;13;50;39;137
420540;201804;23472;60593;15322;44852;2871;9278;4835;11983;7706;21261
420543;201804;229;662;182;567;31;109;90;259;121;368
420545;201804;1226;3830;981;3303;222;774;324;1068;546;1842
420550;201804;3423;10112;2294;7945;496;1927;769;2731;1265;4658
420555;201804;306;942;219;748;45;160;85;278;130;438
420560;201804;428;1182;321;1005;70;214;173;544;243;758
420570;201804;2053;6193;1561;5157;326;1203;568;1744;894;2947
420580;201804;1679;4556;1267;3886;262;927;601;1732;863;2659
420590;201804;2917;8385;1759;5760;338;1244;320;789;658;2033
420600;201804;857;2693;708;2404;111;418;388;1310;499;1728
420610;201804;390;1175;214;752;54;199;39;128;93;327
420620;201804;452;1339;376;1196;102;348;123;380;225;728
420630;201804;796;2433;595;1952;121;435;258;782;379;1217
420640;201804;574;1673;273;982;72;293;22;57;94;350
420650;201804;2590;7312;1567;5134;267;929;515;1497;782;2426
420660;201804;402;1149;269;865;56;201;62;186;118;387
420665;201804;515;1426;333;1095;56;233;138;391;194;624
420670;201804;1500;4236;1010;3258;166;668;341;948;507;1616
420675;201804;149;467;105;366;28;118;19;48;47;166
420680;201804;335;832;195;627;36;124;85;266;121;390
420690;201804;769;2541;525;1886;76;280;99;268;175;548
420700;201804;2832;8101;2198;6883;359;1251;909;2726;1268;3977
420710;201804;612;1924;469;1620;91;394;196;577;287;971
420720;201804;1335;3785;1008;3302;266;885;416;1359;682;2244
420730;201804;2715;7620;2116;6659;384;1323;1074;3265;1458;4588
420740;201804;716;2176;478;1671;130;477;80;280;210;757
420750;201804;1799;5563;1267;4351;209;809;426;1298;635;2107
420757;201804;79;184;23;93;5;24;8;31;13;55
420760;201804;375;1155;165;551;34;115;18;58;52;173
420765;201804;417;1350;219;804;41;163;51;190;92;353
420768;201804;1185;3790;1007;3444;228;805;599;2051;827;2856
420770;201804;498;1366;228;831;47;193;62;217;109;410
420775;201804;471;1381;266;918;57;209;46;138;103;347
420780;201804;1082;3158;643;2178;116;400;145;460;261;860
420785;201804;189;536;139;425;28;82;39;104;67;186
420790;201804;991;3255;769;2804;190;756;329;1127;519;1883
420800;201804;732;1989;340;1140;77;285;92;283;169;568
420810;201804;1554;5267;1276;4633;392;1599;297;925;689;2524
420820;201804;8668;23613;5901;19051;1355;4870;2015;5922;3370;10792
420830;201804;2776;8154;2188;7058;517;1806;755;2364;1272;4170
420840;201804;678;2000;297;1056;69;266;59;184;128;450
420845;201804;1682;4605;1015;3382;228;845;309;1012;537;1857
420850;201804;1073;3604;683;2583;157;653;89;284;246;937
420860;201804;284;794;175;591;45;170;33;97;78;267
420870;201804;874;2460;675;2118;224;790;237;689;461;1479
420880;201804;873;2827;677;2369;156;607;164;507;320;1114
420890;201804;7373;20270;4056;13340;721;2589;1061;3004;1782;5593
420895;201804;167;497;95;304;28;93;31;96;59;189
420900;201804;1442;3851;868;2791;154;596;302;844;456;1440
420910;201804;23079;65262;15336;50045;2568;9424;5234;15476;7802;24900
420915;201804;537;2060;361;1519;62;276;159;637;221;913
420917;201804;343;989;180;548;33;108;72;204;105;312
420920;201804;107;315;42;156;4;16;2;6;6;22
420930;201804;17209;47303;12463;38867;2217;7560;5414;16053;7631;23613
420940;201804;2319;6367;1538;4921;371;1297;134;348;505;1645
420945;201804;149;462;108;354;32;119;33;100;65;219
420950;201804;400;1150;217;745;29;120;70;231;99;351
420960;201804;872;2398;611;1886;121;429;205;560;326;989
420970;201804;2554;7624;1782;6065;471;1677;297;1060;768;2737
420980;201804;352;1086;280;978;123;445;86;328;209;773
420985;201804;312;952;160;579;30;130;55;177;85;307
420990;201804;505;1509;281;1016;56;217;42;110;98;327
421000;201804;465;1603;321;1213;72;292;58;168;130;460
421003;201804;492;1234;170;535;17;49;25;58;42;107
421005;201804;64;225;57;212;16;66;22;87;38;153
421010;201804;3797;10705;2683;8703;579;2065;575;1685;1154;3750
421020;201804;396;1190;306;1032;19;75;206;699;225;774
421030;201804;712;2342;573;2022;182;697;134;447;316;1144
421040;201804;763;1859;461;1385;49;184;270;772;319;956
421050;201804;1268;3601;739;2405;136;477;228;683;364;1160
421055;201804;174;481;87;282;23;85;26;74;49;159
421060;201804;525;1621;366;1222;76;294;131;411;207;705
421070;201804;525;1643;311;1100;71;272;39;124;110;396
421080;201804;651;2673;601;2594;67;221;462;2147;529;2368
421085;201804;433;1242;182;648;25;87;35;120;60;207
421090;201804;384;1035;192;611;24;81;49;148;73;229
421100;201804;911;2330;448;1369;103;347;50;133;153;480
421105;201804;1350;3892;1062;3459;169;557;549;1880;718;2437
421110;201804;915;2840;789;2623;68;235;512;1721;580;1956
421120;201804;1023;3273;693;2509;100;415;185;585;285;1000
421125;201804;292;788;213;664;70;244;68;163;138;407
421130;201804;3307;10353;2821;9421;717;2624;1331;4308;2048;6932
421140;201804;286;837;198;646;38;120;60;176;98;296
421145;201804;461;1328;271;865;54;187;101;292;155;479
421150;201804;488;1406;314;1090;51;204;116;384;167;588
421160;201804;802;2163;425;1387;65;242;196;623;261;865
421165;201804;191;598;140;479;27;91;69;239;96;330
421170;201804;1160;3158;903;2756;143;431;550;1695;693;2126
421175;201804;1079;2960;706;2292;139;540;255;728;394;1268
421180;201804;422;1113;198;642;41;170;39;111;80;281
421185;201804;319;850;210;637;38;117;111;335;149;452
421187;201804;338;1026;227;745;31;99;90;280;121;379
421189;201804;352;1090;266;895;43;153;82;256;125;409
421190;201804;9954;27606;6136;20383;1231;4516;1165;3642;2396;8158
421200;201804;711;2218;588;1982;110;396;248;792;358;1188
421205;201804;197;556;151;477;30;110;69;206;99;316
421210;201804;1044;2966;705;2293;164;545;241;766;405;1311
421220;201804;1372;4515;1154;4019;288;1108;208;633;496;1741
421223;201804;400;1193;271;934;58;212;100;334;158;546
421225;201804;971;3051;832;2761;175;638;426;1428;601;2066
421227;201804;957;2656;608;1967;106;387;309;998;415;1385
421230;201804;565;1562;374;1218;103;359;123;411;226;770
421240;201804;328;1019;146;547;17;87;17;63;34;150
421250;201804;1428;3880;906;2996;190;684;269;870;459;1554
421260;201804;269;778;54;197;11;40;7;26;18;66
421265;201804;695;2081;633;1989;50;181;499;1558;549;1739
421270;201804;455;1255;220;782;40;143;75;260;115;403
421280;201804;1481;4608;1162;4003;255;951;492;1673;747;2624
421290;201804;782;2179;451;1435;81;266;86;250;167;516
421300;201804;214;641;144;485;37;140;40;133;77;273
421310;201804;183;572;142;468;25;91;49;154;74;245
421315;201804;243;737;148;515;26;91;19;72;45;163
421320;201804;631;1904;362;1224;63;226;56;129;119;355
421330;201804;561;1745;419;1457;103;381;107;368;210;749
421335;201804;372;1222;304;1083;66;274;83;283;149;557
421340;201804;1379;3964;1039;3350;202;712;455;1411;657;2123
421350;201804;1053;3185;819;2754;139;571;385;1222;524;1793
421360;201804;2255;6473;1411;4758;326;1308;468;1389;794;2697
421370;201804;445;1497;293;1099;75;299;62;230;137;529
421380;201804;789;2275;678;2072;103;344;368;1080;471;1424
421390;201804;161;431;63;203;10;37;19;47;29;84
421400;201804;259;842;180;677;45;184;74;265;119;449
421410;201804;244;708;115;423;16;67;46;166;62;233
421415;201804;335;1043;155;533;38;139;29;82;67;221
421420;201804;601;1778;483;1558;79;274;252;772;331;1046
421430;201804;137;469;106;387;18;71;31;105;49;176
421440;201804;666;1875;454;1505;80;280;223;742;303;1022
421450;201804;383;1173;228;804;28;113;39;154;67;267
421460;201804;420;1202;256;895;60;230;70;224;130;454
421470;201804;253;819;183;660;37;162;55;181;92;343
421480;201804;2653;7302;1724;5655;487;1834;396;1122;883;2956
421490;201804;147;443;76;277;11;45;18;46;29;91
421500;201804;1999;6389;1438;5180;379;1521;231;757;610;2278
421505;201804;309;969;271;905;46;170;146;477;192;647
421507;201804;384;1160;239;836;61;237;73;242;134;479
421510;201804;233;686;148;485;32;96;62;180;94;276
421520;201804;562;1586;357;1120;52;196;170;491;222;687
421530;201804;323;1015;182;658;34;152;42;131;76;283
421535;201804;439;1288;286;982;37;148;143;455;180;603
421540;201804;218;581;150;465;21;82;64;180;85;262
421545;201804;660;2027;478;1662;101;396;194;651;295;1047
421550;201804;1930;5777;1634;5301;408;1455;747;2337;1155;3792
421555;201804;219;644;72;261;17;73;12;31;29;104
421560;201804;106;340;56;211;12;51;12;43;24;94
421565;201804;765;2090;558;1758;126;452;205;652;331;1104
421567;201804;487;1733;355;1357;172;671;53;213;225;884
421568;201804;416;1274;283;956;44;160;109;344;153;504
421569;201804;191;578;70;256;18;62;17;67;35;129
421570;201804;1102;3133;696;2276;175;626;126;375;301;1001
421575;201804;330;1030;290;918;41;145;160;478;201;623
421580;201804;2702;8278;1970;6724;415;1627;632;1878;1047;3505
421590;201804;148;490;125;427;17;61;68;225;85;286
421600;201804;460;1329;317;1003;74;242;76;223;150;465
421605;201804;765;2117;511;1652;92;316;141;420;233;736
421610;201804;1202;3323;753;2432;146;510;153;452;299;962
421620;201804;3714;10716;2219;7726;592;2235;479;1611;1071;3846
421625;201804;264;723;103;349;22;69;15;43;37;112
421630;201804;2544;7305;1435;4723;246;937;313;912;559;1849
421635;201804;233;692;132;437;17;64;47;132;64;196
421640;201804;822;2344;562;1859;122;435;178;579;300;1014
421650;201804;2048;6164;1359;4706;311;1255;225;608;536;1863
421660;201804;6777;21120;5495;18555;1024;3855;1987;6146;3011;10001
421670;201804;866;2544;597;1936;145;543;210;639;355;1182
421680;201804;929;2930;735;2518;229;837;212;671;441;1508
421690;201804;1175;3747;852;2974;195;771;198;657;393;1428
421700;201804;472;1501;246;909;45;188;59;190;104;378
421710;201804;195;634;87;301;19;77;29;91;48;168
421715;201804;112;319;76;238;15;49;46;134;61;183
421720;201804;1814;5246;1081;3698;264;974;255;774;519;1748
421725;201804;170;452;103;322;24;86;35;88;59;174
421730;201804;367;1140;199;642;33;123;68;191;101;314
421740;201804;626;1912;435;1451;115;423;109;325;224;748
421750;201804;875;2177;461;1410;70;225;174;498;244;723
421755;201804;212;605;106;353;15;63;42;123;57;186
421760;201804;916;2677;498;1718;81;296;115;331;196;627
421770;201804;2314;6579;1699;5485;422;1390;596;2081;1018;3471
421775;201804;247;712;173;559;28;98;78;235;106;333
421780;201804;830;2749;576;2153;128;513;157;557;285;1070
421790;201804;618;1638;373;1250;117;414;138;437;255;851
421795;201804;236;718;143;463;23;85;53;150;76;235
421800;201804;2363;6939;1746;5773;385;1401;722;2264;1107;3665
421810;201804;627;1794;447;1439;73;270;201;604;274;874
421820;201804;821;2370;431;1461;87;316;70;197;157;513
421825;201804;1296;3897;1190;3726;172;593;800;2444;972;3037
421830;201804;2169;7098;1862;6484;450;1710;621;2042;1071;3752
421835;201804;211;576;124;420;24;98;57;170;81;268
421840;201804;224;705;152;555;36;141;43;146;79;287
421850;201804;401;1245;225;797;36;143;49;138;85;281
421860;201804;268;829;177;629;28;121;50;146;78;267
421870;201804;3226;8780;2238;6859;500;1695;748;2133;1248;3828
421875;201804;269;823;122;458;23;92;18;48;41;140
421880;201804;563;1650;415;1360;118;423;62;196;180;619
421885;201804;234;686;181;602;60;213;39;111;99;324
421890;201804;748;2470;607;2188;158;641;231;756;389;1397
421895;201804;334;1006;305;965;46;162;204;639;250;801
421900;201804;887;2375;615;1841;111;372;271;751;382;1123
421910;201804;369;1165;263;929;56;235;48;138;104;373
421915;201804;413;1218;239;794;46;147;34;109;80;256
421917;201804;558;1549;367;1275;124;480;83;285;207;765
421920;201804;521;1530;348;1255;166;617;103;384;269;1001
421930;201804;2268;6163;1132;3892;311;1143;127;390;438;1533
421935;201804;470;1556;371;1344;76;297;176;595;252;892
421940;201804;244;776;125;437;25;108;36;117;61;225
421950;201804;2957;7672;1398;4582;297;1079;224;676;521;1755
421960;201804;149;406;103;334;15;58;28;95;43;153
421970;201804;1987;5359;1075;3474;230;771;255;745;485;1516
421985;201804;330;843;180;550;25;85;52;171;77;256
422000;201804;1599;4575;1309;4047;217;784;715;2157;932;2941
430003;201804;545;1609;387;1323;80;312;136;443;216;755
430005;201804;280;784;181;592;50;163;73;241;123;404
430010;201804;1701;4598;1336;3956;230;741;742;2143;972;2884
430020;201804;597;1446;467;1271;70;220;277;719;347;939
430030;201804;1018;2541;607;1774;171;512;176;511;347;1023
430040;201804;9708;25310;6027;18194;1557;5219;308;1001;1865;6220
430045;201804;565;1523;393;1162;48;153;198;553;246;706
430047;201804;266;621;111;335;22;70;33;99;55;169
430050;201804;934;2519;531;1638;119;379;125;361;244;740
430055;201804;281;728;130;397;14;46;59;161;73;207
430057;201804;106;250;39;120;8;31;6;17;14;48
430060;201804;16022;47238;13022;42330;3396;11797;4995;16367;8391;28164
430063;201804;850;2459;674;2068;146;446;370;1129;516;1575
430064;201804;1018;2988;761;2402;224;758;192;582;416;1340
430066;201804;126;294;89;232;4;15;59;144;63;159
430070;201804;663;1762;118;407;10;34;10;25;20;59
430080;201804;767;2062;449;1391;93;307;172;472;265;779
430085;201804;878;2193;528;1555;84;264;191;570;275;834
430087;201804;599;1841;499;1671;98;362;243;789;341;1151
430090;201804;640;1687;214;701;21;81;57;180;78;261
430100;201804;679;1744;359;1107;68;231;124;336;192;567
430105;201804;997;2745;648;2123;112;433;289;949;401;1382
430107;201804;173;534;123;410;19;64;29;84;48;148
430110;201804;2083;5387;1518;4519;283;882;775;2223;1058;3105
430120;201804;1408;4370;891;3024;204;713;347;1227;551;1940
430130;201804;3823;10309;3064;9162;1006;2757;958;3535;1964;6292
430140;201804;955;2868;608;2071;161;545;197;673;358;1218
430150;201804;580;1507;321;994;69;215;89;267;158;482
430155;201804;284;756;145;465;19;70;36;98;55;168
430160;201804;17319;46184;13934;40863;3329;10250;5008;15303;8337;25553
430163;201804;2284;5990;1644;4954;199;675;969;2881;1168;3556
430165;201804;435;1016;84;272;10;26;7;21;17;47
430170;201804;893;2479;324;1145;56;204;65;204;121;408
430175;201804;697;2224;575;1916;148;472;271;913;419;1385
430180;201804;689;1831;556;1596;92;296;334;904;426;1200
430185;201804;458;1156;287;823;48;144;129;330;177;474
430187;201804;618;1655;445;1371;78;265;189;571;267;836
430190;201804;1435;4161;1208;3704;289;930;503;1515;792;2445
430192;201804;135;413;59;185;9;29;10;27;19;56
430195;201804;372;1126;69;242;10;34;6;19;16;53
430200;201804;1087;3460;921;3127;281;1006;283;945;564;1951
430205;201804;507;1432;395;1197;20;78;308;902;328;980
430210;201804;5195;13480;3549;10118;531;1655;1421;3314;1952;4969
430215;201804;314;867;212;646;40;132;84;248;124;380
430220;201804;651;1642;178;611;34;124;40;122;74;246
430222;201804;197;606;160;521;22;74;69;211;91;285
430223;201804;271;771;225;678;40;128;111;324;151;452
430225;201804;16;42;14;38;2;3;7;12;9;15
430230;201804;1566;4620;1463;4482;211;598;1116;3503;1327;4101
430235;201804;239;748;181;605;27;106;66;210;93;316
430237;201804;546;1372;370;1056;24;82;245;648;269;730
430240;201804;1158;2633;688;1906;67;219;402;1077;469;1296
430245;201804;726;2233;558;1874;184;629;244;838;428;1467
430250;201804;1016;2814;820;2512;235;765;44;128;279;893
430258;201804;115;331;90;287;7;23;48;155;55;178
430260;201804;603;1695;439;1362;81;241;215;685;296;926
430265;201804;198;590;147;495;27;100;41;136;68;236
430270;201804;2780;7316;2271;6524;244;751;1527;4323;1771;5074
430280;201804;4618;11775;3480;9732;804;2312;1426;3996;2230;6308
430290;201804;2179;5563;1935;5227;83;261;1658;4418;1741;4679
430300;201804;8423;23491;6702;20262;1379;4493;3089;9267;4468;13760
430310;201804;7850;21162;5376;16485;886;3088;2374;6829;3260;9917
430320;201804;911;2560;504;1649;91;263;242;851;333;1114
430330;201804;630;1603;428;1204;100;300;185;460;285;760
430340;201804;738;1736;370;1118;67;211;189;559;256;770
430350;201804;5695;16576;4632;14345;1235;3961;1837;5534;3072;9495
430355;201804;363;932;124;405;26;91;14;45;40;136
430360;201804;762;2040;555;1656;108;343;194;551;302;894
430367;201804;337;840;173;521;49;166;49;145;98;311
430370;201804;530;1484;259;848;60;208;59;169;119;377
430380;201804;682;1750;369;1170;108;389;89;288;197;677
430390;201804;3221;8310;1779;5484;299;978;133;329;432;1307
430400;201804;1128;2621;841;2156;120;311;526;1306;646;1617
430410;201804;579;1487;411;1198;53;184;248;702;301;886
430420;201804;2883;8277;2231;6777;684;2170;695;2032;1379;4202
430430;201804;573;1553;323;1019;80;271;66;190;146;461
430435;201804;1629;4345;1187;3561;289;907;392;1190;681;2097
430440;201804;3645;10795;2733;8879;537;1863;1297;4269;1834;6132
430450;201804;6049;16806;5109;15021;982;3164;2443;7063;3425;10227
430460;201804;26452;72696;18972;60200;4260;14980;7338;22338;11598;37318
430461;201804;465;1204;141;447;25;81;30;86;55;167
430462;201804;248;675;156;507;24;86;40;137;64;223
430463;201804;4339;12967;3581;11592;684;2412;1756;5637;2440;8049
430465;201804;487;1328;403;1160;76;236;239;665;315;901
430466;201804;3645;9495;2972;8397;703;2080;1407;3782;2110;5862
430467;201804;497;1324;373;1110;61;209;167;473;228;682
430468;201804;1346;3505;1067;3084;167;525;589;1690;756;2215
430469;201804;568;1621;68;231;8;18;9;20;17;38
430470;201804;6113;16658;4331;13463;1362;4483;863;2725;2225;7208
430471;201804;487;1552;429;1419;91;304;180;578;271;882
430480;201804;923;2461;463;1483;73;264;74;205;147;469
430485;201804;148;415;56;189;7;26;10;29;17;55
430490;201804;383;1041;216;675;35;121;94;290;129;411
430495;201804;379;1093;241;800;26;97;96;282;122;379
430500;201804;1092;2907;802;2417;200;666;308;850;508;1516
430510;201804;22312;61450;16233;49178;3804;12588;5629;15762;9433;28350
430511;201804;336;1012;134;468;23;77;16;46;39;123
430512;201804;906;2245;741;1977;190;523;232;637;422;1160
430513;201804;791;2036;397;1152;91;281;156;420;247;701
430515;201804;385;1120;279;906;46;139;134;444;180;583
430517;201804;959;3036;776;2655;135;464;377;1343;512;1807
430520;201804;1337;3645;725;2305;142;473;122;342;264;815
430530;201804;1103;2884;404;1266;79;240;90;277;169;517
430535;201804;2868;7992;2030;6355;357;1168;888;2742;1245;3910
430537;201804;350;1246;311;1116;42;144;221;799;263;943
430540;201804;585;1377;353;1015;61;179;179;500;240;679
430543;201804;605;1249;397;1007;61;139;259;685;320;824
430544;201804;638;1957;471;1558;101;352;216;680;317;1032
430545;201804;1656;4822;1275;4228;321;1114;551;1892;872;3006
430550;201804;511;1454;278;917;56;189;63;187;119;376
430558;201804;136;346;67;211;13;41;19;55;32;96
430560;201804;406;955;176;533;20;62;42;128;62;190
430570;201804;878;2162;596;1668;83;279;335;852;418;1131
430580;201804;1092;2655;677;1993;119;401;318;893;437;1294
430583;201804;180;467;37;116;2;7;6;18;8;25
430585;201804;233;578;133;377;20;66;65;156;85;222
430587;201804;178;544;140;458;28;95;58;194;86;289
430590;201804;1389;3485;1202;3173;55;183;1039;2686;1094;2869
430593;201804;14;45;13;44;1;3;8;28;9;31
430595;201804;435;1058;86;305;6;29;13;39;19;68
430597;201804;325;939;221;685;25;87;79;199;104;286
430600;201804;1804;4862;860;2656;157;489;222;636;379;1125
430605;201804;1139;3355;874;2792;132;512;331;1029;463;1541
430607;201804;673;1546;485;1255;35;108;325;858;360;966
430610;201804;5927;15386;4295;12795;1241;4025;628;1943;1869;5968
430613;201804;291;682;91;273;7;26;26;62;33;88
430620;201804;571;1562;451;1327;119;390;196;543;315;933
430630;201804;454;1315;130;430;19;65;24;66;43;131
430632;201804;594;1622;278;854;32;100;117;341;149;441
430635;201804;521;1473;392;1196;72;243;236;692;308;935
430637;201804;413;1115;340;1000;54;174;190;528;244;702
430640;201804;1282;3380;691;2128;101;324;194;523;295;847
430642;201804;384;1045;261;785;41;119;128;380;169;499
430645;201804;270;603;96;265;17;49;18;51;35;100
430650;201804;1567;4995;1316;4466;331;1155;631;2172;962;3327
430655;201804;187;456;126;353;29;82;52;128;81;210
430660;201804;4869;13310;3748;11293;817;2689;1631;4842;2448;7531
430670;201804;525;1424;412;1211;43;154;264;763;307;917
430673;201804;608;1442;239;719;50;152;79;237;129;389
430675;201804;230;684;55;194;15;60;12;38;27;98
430676;201804;4149;11185;3193;9533;567;1785;1532;4518;2099;6303
430680;201804;990;2733;594;1919;136;424;126;386;262;810
430690;201804;3280;9325;2670;8170;787;2502;716;2169;1503;4671
430692;201804;211;664;166;594;12;42;116;425;128;467
430693;201804;1043;2752;579;1787;122;435;124;338;246;773
430695;201804;542;1347;327;942;37;112;173;465;210;577
430697;201804;414;1097;299;895;55;166;144;451;199;617
430700;201804;7317;18884;3891;12447;924;3196;295;983;1219;4179
430705;201804;337;901;177;569;24;85;64;201;88;286
430710;201804;1720;4003;1229;3242;219;641;612;1567;831;2208
430720;201804;699;1737;384;1186;84;258;130;391;214;649
430730;201804;1294;3453;830;2606;140;447;399;1274;539;1721
430740;201804;576;1647;308;1056;55;199;77;282;132;481
430745;201804;470;1320;239;768;38;132;54;160;92;292
430750;201804;1358;3654;971;2990;197;666;505;1483;702;2149
430755;201804;481;1207;306;851;20;62;168;425;188;487
430760;201804;2049;5433;1553;4617;366;1143;644;1876;1010;3019
430770;201804;5930;16019;4498;13680;778;2589;2452;7239;3230;9828
430780;201804;2196;5653;1308;4112;258;860;406;1334;664;2194
430781;201804;392;1147;249;817;57;194;51;160;108;354
430783;201804;468;1139;272;808;27;95;134;375;161;470
430786;201804;57;197;37;146;8;29;4;21;12;50
430790;201804;4277;11377;2925;8725;531;1747;1460;4096;1991;5843
430800;201804;800;2127;571;1653;52;179;332;911;384;1090
430805;201804;514;1432;299;923;34;114;154;443;188;557
430807;201804;389;980;250;733;26;86;119;327;145;413
430810;201804;879;2231;276;918;42;135;66;208;108;343
430820;201804;1259;3520;698;2361;161;562;132;443;293;1005
430825;201804;271;713;91;256;23;66;18;41;41;107
430830;201804;1556;4755;1329;4333;120;445;904;2958;1024;3403
430840;201804;883;2532;748;2289;147;447;422;1286;569;1733
430843;201804;113;286;38;119;6;19;12;33;18;52
430845;201804;321;837;222;658;80;251;41;102;121;353
430850;201804;2293;6405;1794;5472;370;1258;831;2503;1201;3761
430860;201804;925;2274;455;1380;83;306;181;486;264;792
430865;201804;528;1412;450;1277;120;356;192;512;312;868
430870;201804;664;1812;296;979;53;190;83;239;136;429
430880;201804;1198;2967;788;2303;202;606;299;877;501;1483
430885;201804;228;550;100;338;8;36;60;197;68;233
430890;201804;1242;3330;827;2516;57;254;119;337;176;591
430900;201804;2886;6956;1979;5534;266;856;1056;2786;1322;3642
430905;201804;860;2336;546;1705;104;352;161;477;265;829
430910;201804;1457;4054;962;3021;175;642;381;1077;556;1719
430912;201804;483;1354;332;1081;40;134;198;660;238;794
430915;201804;516;1614;379;1363;99;359;135;519;234;878
430920;201804;21075;56142;16466;48684;2555;8285;9355;26944;11910;35229
430925;201804;143;319;61;171;11;29;21;62;32;91
430930;201804;9942;24454;6018;18121;1484;4774;1664;5241;3148;10015
430940;201804;1274;3810;687;2290;183;627;96;271;279;898
430950;201804;740;1923;475;1406;76;258;233;621;309;879
430955;201804;187;496;60;197;12;28;8;32;20;60
430957;201804;191;673;175;637;36;135;88;318;124;453
430960;201804;1289;3163;853;2413;192;593;413;1145;605;1738
430965;201804;1563;4047;1241;3519;74;251;945;2599;1019;2850
430970;201804;379;1010;196;620;26;92;100;302;126;394
430975;201804;466;1547;373;1309;87;326;148;515;235;841
430980;201804;390;982;235;703;46;152;87;251;133;403
430990;201804;548;1642;316;1047;54;203;135;437;189;640
430995;201804;582;1591;418;1288;71;220;199;597;270;817
431000;201804;1411;3457;604;1818;105;351;27;68;132;419
431010;201804;2224;6069;1292;4277;186;713;109;301;295;1014
431020;201804;8687;20192;5418;14914;1263;3724;1590;4054;2853;7778
431030;201804;326;922;144;515;34;115;18;71;52;186
431033;201804;2911;7894;2067;6572;553;1859;674;2257;1227;4116
431036;201804;346;759;65;195;9;19;12;35;21;54
431040;201804;903;2440;588;1838;98;362;265;763;363;1125
431041;201804;476;1145;368;977;44;125;221;581;265;706
431043;201804;433;1107;220;716;74;245;65;208;139;453
431046;201804;124;330;58;172;6;18;12;33;18;51
431050;201804;1544;3853;1085;3115;222;666;537;1529;759;2195
431053;201804;513;1527;348;1180;89;321;91;298;180;619
431055;201804;601;1562;528;1446;44;123;396;1069;440;1192
431057;201804;285;834;138;470;27;99;37;112;64;211
431060;201804;4940;14134;3818;12041;1132;3869;728;2443;1860;6312
431065;201804;504;1358;334;1042;72;229;86;264;158;493
431070;201804;505;1511;294;991;78;284;39;106;117;390
431075;201804;211;654;152;531;32;118;49;172;81;290
431080;201804;644;1841;441;1397;81;267;133;409;214;676
431085;201804;686;1910;507;1499;77;214;283;825;360;1039
431087;201804;451;1314;374;1138;22;72;268;826;290;898
431090;201804;440;1049;155;484;28;89;39;123;67;212
431100;201804;3119;7613;2303;6477;425;1302;955;2650;1380;3952
431110;201804;1387;3382;994;2681;257;715;418;1059;675;1774
431112;201804;512;1616;448;1486;83;286;226;732;309;1018
431113;201804;385;1105;315;969;99;318;122;383;221;701
431115;201804;1164;3334;923;2902;151;521;506;1537;657;2058
431120;201804;2465;7202;1737;5689;585;2151;381;1129;966;3280
431123;201804;400;1160;254;848;55;172;118;413;173;585
431125;201804;1158;3514;835;2793;296;966;237;857;533;1823
431127;201804;282;777;68;226;8;24;13;33;21;57
431130;201804;3331;9263;2242;7101;477;1629;795;2487;1272;4116
431140;201804;4865;11917;2667;7751;358;1129;952;2425;1310;3554
431142;201804;485;1370;366;1157;57;183;218;684;275;867
431150;201804;994;2829;711;2251;167;544;281;873;448;1417
431160;201804;666;1923;498;1575;108;339;189;610;297;949
431162;201804;529;1273;226;710;28;104;60;177;88;281
431164;201804;228;552;49;163;11;46;4;13;15;59
431170;201804;578;1574;367;1154;101;325;97;303;198;628
431171;201804;686;1773;568;1595;84;239;335;926;419;1165
431173;201804;420;1180;318;998;119;393;74;239;193;632
431175;201804;922;2459;621;1902;173;534;115;359;288;893
431177;201804;740;2225;547;1866;171;619;207;695;378;1314
431179;201804;349;732;76;220;13;38;16;33;29;71
431180;201804;2155;5709;1320;4084;335;1091;227;692;562;1783
431190;201804;502;1360;270;854;36;112;57;148;93;260
431198;201804;310;989;273;917;94;332;87;317;181;649
431200;201804;391;1049;100;332;9;22;1;3;10;25
431205;201804;214;624;90;331;22;84;35;132;57;216
431210;201804;643;1693;519;1507;135;378;254;776;389;1154
431213;201804;232;703;180;607;18;69;94;317;112;386
431215;201804;344;990;216;700;20;68;90;267;110;335
431217;201804;143;416;97;324;11;36;50;157;61;193
431220;201804;686;1875;392;1264;34;137;177;519;211;656
431225;201804;1387;3630;1063;3048;150;454;602;1736;752;2190
431230;201804;696;2081;523;1641;89;299;267;810;356;1109
431235;201804;133;363;24;74;5;13;2;4;7;17
431237;201804;391;1181;317;1048;54;209;157;497;211;706
431238;201804;27;78;22;64;6;19;5;12;11;31
431240;201804;3848;10391;3045;9052;691;2281;1273;3624;1964;5905
431242;201804;344;990;281;863;59;183;128;396;187;579
431244;201804;334;817;159;457;20;74;53;115;73;189
431245;201804;1184;3011;780;2224;120;380;351;951;471;1331
431247;201804;219;636;113;382;18;60;26;87;44;147
431250;201804;1408;4219;1130;3764;253;838;502;1763;755;2601
431260;201804;241;687;133;463;13;62;42;132;55;194
431261;201804;265;857;215;752;30;114;83;269;113;383
431262;201804;409;1174;174;602;18;63;95;330;113;393
431265;201804;1357;3354;591;1787;98;333;174;431;272;764
431267;201804;282;787;158;473;6;23;104;285;110;308
431270;201804;2671;6421;1437;4281;400;1287;378;1148;778;2435
431275;201804;168;473;82;275;18;64;11;30;29;94
431280;201804;253;698;68;236;8;27;7;17;15;44
431290;201804;304;884;217;710;29;107;78;227;107;334
431295;201804;75;205;27;87;3;13;7;21;10;34
431300;201804;407;1035;57;196;3;12;12;34;15;46
431301;201804;244;732;60;206;7;21;3;4;10;25
431303;201804;586;1555;330;1002;41;147;121;344;162;491
431306;201804;2134;5203;1252;3669;169;566;448;1201;617;1767
431308;201804;25;85;23;78;12;43;6;19;18;62
431310;201804;602;1748;344;1117;57;194;118;391;175;585
431320;201804;638;1766;299;1028;60;209;39;123;99;332
431330;201804;1845;4564;917;2822;220;760;170;454;390;1214
431333;201804;334;904;118;358;16;45;32;92;48;137
431335;201804;35;100;21;70;6;16;3;4;9;20
431337;201804;2568;7198;1741;5681;503;1796;388;1201;891;2997
431339;201804;489;1298;331;989;74;227;155;462;229;689
431340;201804;20075;51921;14221;41735;2978;9530;4521;12564;7499;22094
431342;201804;467;1115;355;941;42;140;268;675;310;815
431344;201804;374;1004;247;756;14;47;160;485;174;532
431346;201804;272;695;101;320;15;44;19;66;34;110
431349;201804;686;1901;377;1163;63;201;134;379;197;580
431350;201804;3864;10741;2888;8973;655;2191;1058;3235;1713;5426
431360;201804;606;1503;356;1054;67;206;151;428;218;634
431365;201804;1728;4678;1427;4200;156;508;973;2867;1129;3375
431370;201804;4217;11285;3151;9423;761;2368;1306;4087;2067;6455
431380;201804;730;2155;635;1991;76;272;390;1213;466;1485
431390;201804;2443;6336;1389;4286;244;854;450;1240;694;2094
431395;201804;1259;3537;923;2983;220;734;358;1190;578;1924
431400;201804;394;1191;196;649;33;111;43;132;76;243
431402;201804;978;2338;644;1757;107;308;368;962;475;1270
431403;201804;162;463;136;417;15;67;89;249;104;316
431405;201804;4199;11486;3420;10295;438;1527;2057;6058;2495;7585
431406;201804;473;1471;384;1306;93;312;194;667;287;979
431407;201804;464;1293;307;964;58;188;124;383;182;571
431410;201804;14361;39444;9334;29581;1915;6904;2998;8905;4913;15809
431413;201804;177;456;49;159;2;7;6;19;8;26
431415;201804;683;1762;419;1318;79;293;138;376;217;669
431417;201804;528;1289;388;1064;66;187;213;562;279;749
431420;201804;1270;3314;1057;2968;215;618;433;1284;648;1902
431430;201804;520;1391;280;880;54;190;64;167;118;357
431440;201804;22103;57377;16591;48189;4032;12448;4838;14251;8870;26699
431442;201804;105;301;57;190;8;27;6;11;14;38
431445;201804;475;1350;162;546;26;78;29;93;55;171
431446;201804;361;1056;241;785;72;243;60;182;132;425
431447;201804;593;1666;397;1251;88;278;170;538;258;816
431449;201804;704;1943;465;1410;53;172;228;678;281;850
431450;201804;2062;4640;1735;4207;139;363;1304;3043;1443;3406
431454;201804;39;119;37;115;5;17;15;55;20;72
431455;201804;626;1554;307;859;47;146;135;324;182;470
431460;201804;2761;7439;2192;6324;589;1756;699;2065;1288;3821
431470;201804;1534;4401;1119;3502;227;728;443;1391;670;2119
431475;201804;234;690;30;117;1;5;0;0;1;5
431477;201804;527;1361;312;913;45;125;144;391;189;516
431478;201804;277;723;70;213;17;55;7;20;24;75
431480;201804;3133;8080;2410;6931;366;1153;1363;3863;1729;5016
431490;201804;96125;246727;79506;221372;7973;25577;55903;151281;63876;176858
431500;201804;488;1313;371;1080;81;224;195;557;276;781
431505;201804;433;1051;269;774;25;69;149;424;174;493
431507;201804;342;812;143;407;28;90;56;138;84;228
431510;201804;1579;4341;1132;3447;233;746;431;1324;664;2070
431513;201804;297;723;146;419;14;35;91;264;105;299
431514;201804;84;234;43;149;8;34;14;42;22;76
431515;201804;560;1485;365;1096;76;246;168;473;244;719
431517;201804;74;222;54;166;8;20;12;34;20;54
431520;201804;440;1084;165;537;35;130;52;148;87;278
431530;201804;3987;8995;2422;6699;671;1909;335;931;1006;2840
431531;201804;199;569;136;439;20;70;52;155;72;225
431532;201804;476;1272;341;997;76;231;136;402;212;633
431535;201804;276;684;105;318;21;68;30;85;51;153
431540;201804;1814;6040;1683;5817;87;360;1297;4482;1384;4842
431545;201804;385;1036;71;220;5;21;19;49;24;70
431550;201804;1946;5446;1595;4760;333;1050;660;1881;993;2931
431555;201804;677;1618;431;1192;40;118;254;692;294;810
431560;201804;19590;53091;13380;42385;2810;9522;3552;12058;6362;21580
431570;201804;5003;12310;3903;10794;642;1929;2255;6085;2897;8014
431575;201804;174;546;135;455;19;67;20;54;39;121
431580;201804;522;1409;270;889;40;166;105;326;145;492
431590;201804;767;2084;541;1611;106;322;186;548;292;870
431595;201804;352;1014;234;745;38;109;108;335;146;444
431600;201804;1520;3969;1101;3281;283;933;309;914;592;1847
431610;201804;1359;3732;963;2933;125;356;468;1477;593;1833
431620;201804;523;1433;231;698;49;145;102;285;151;430
431630;201804;1221;3262;605;1922;178;595;156;435;334;1030
431640;201804;5914;15882;5318;15021;780;2264;3588;10209;4368;12473
431642;201804;502;1304;324;943;31;88;157;438;188;526
431643;201804;347;901;155;457;24;63;41;108;65;171
431645;201804;1658;4388;1330;3841;168;527;877;2519;1045;3046
431647;201804;178;483;102;314;14;54;24;60;38;114
431650;201804;218;653;153;510;26;100;45;135;71;235
431660;201804;897;2451;496;1621;84;299;108;292;192;591
431670;201804;1168;2937;821;2333;145;469;379;1013;524;1482
431673;201804;247;661;91;334;15;44;8;25;23;69
431675;201804;688;1744;138;455;11;47;42;115;53;162
431680;201804;7478;20537;5665;16917;1500;4685;1954;5847;3454;10532
431690;201804;19412;52248;14180;42592;3544;11141;4410;13677;7954;24818
431695;201804;145;393;96;304;19;64;40;99;59;163
431697;201804;461;1169;369;1015;66;173;205;591;271;764
431700;201804;1396;3807;1202;3452;189;532;674;1931;863;2463
431710;201804;11246;30382;8752;26568;2321;7380;3239;10523;5560;17903
431720;201804;6109;16360;4050;12182;986;3146;717;1961;1703;5107
431725;201804;28;81;18;61;3;12;6;19;9;31
431730;201804;3473;9354;2492;7686;666;2244;735;2366;1401;4610
431740;201804;4734;12262;3357;9837;1018;3356;619;1536;1637;4892
431750;201804;7225;20106;6161;18418;1218;3960;3048;9187;4266;13147
431755;201804;344;939;72;257;11;45;12;42;23;87
431760;201804;5393;12896;3466;9708;417;1380;1991;5252;2408;6632
431770;201804;1782;4548;1428;4036;163;507;970;2689;1133;3196
431775;201804;205;552;99;312;18;62;12;29;30;91
431780;201804;1907;5137;1328;3987;246;764;442;1280;688;2044
431790;201804;952;2700;693;2150;141;465;253;737;394;1202
431795;201804;267;711;142;435;30;91;35;101;65;192
431800;201804;7296;20068;5323;16533;1670;5683;628;2034;2298;7717
431805;201804;294;697;91;295;5;20;39;117;44;137
431810;201804;3221;8082;2049;5822;400;1270;834;2230;1234;3500
431820;201804;2161;6347;1819;5740;401;1322;750;2392;1151;3714
431830;201804;9276;21731;7016;18419;1601;4611;2757;7231;4358;11842
431840;201804;2418;6931;1997;6193;402;1282;1047;3259;1449;4541
431842;201804;716;1795;249;769;33;117;71;199;104;316
431843;201804;313;885;242;737;31;102;108;315;139;417
431844;201804;260;696;74;242;22;80;13;32;35;112
431845;201804;485;1326;337;1012;20;59;212;633;232;692
431846;201804;249;736;217;688;13;57;176;544;189;601
431848;201804;193;504;97;307;6;21;14;29;20;50
431849;201804;429;1033;63;180;8;26;6;12;14;38
431850;201804;4027;11518;3222;9804;733;2372;1006;2967;1739;5339
431860;201804;688;1781;442;1292;84;251;216;596;300;847
431861;201804;124;334;53;182;8;30;15;43;23;73
431862;201804;446;1476;366;1323;85;340;167;586;252;926
431870;201804;16825;46958;13536;41108;2500;8555;6171;18038;8671;26593
431880;201804;3600;10159;2846;8738;555;1920;1186;3499;1741;5419
431890;201804;4417;11803;2838;8660;835;2770;402;1270;1237;4040
431900;201804;1029;2767;621;1921;134;471;284;817;418;1288
431910;201804;790;1950;311;922;48;141;85;233;133;374
431912;201804;428;1261;357;1122;75;243;197;618;272;861
431915;201804;955;2643;760;2303;99;331;473;1387;572;1718
431920;201804;1166;3083;993;2802;57;182;814;2270;871;2452
431930;201804;809;2389;580;1970;136;406;293;1066;429;1472
431935;201804;73;219;50;171;15;51;10;30;25;81
431936;201804;301;903;178;606;42;147;45;151;87;298
431937;201804;177;478;110;336;28;92;25;63;53;155
431940;201804;2228;5892;1412;4241;288;961;520;1453;808;2414
431950;201804;1619;4605;1364;4172;303;960;637;1941;940;2901
431960;201804;2625;7120;2116;6114;558;1683;599;1689;1157;3372
431970;201804;391;1059;176;588;36;121;33;98;69;219
431971;201804;76;207;44;146;8;27;8;20;16;47
431973;201804;467;1519;387;1356;31;98;281;1008;312;1106
431975;201804;110;248;25;83;4;15;4;8;8;23
431980;201804;1130;3153;869;2676;188;613;359;1060;547;1673
431990;201804;5705;14783;3735;11669;675;2326;1199;3692;1874;6018
432000;201804;9921;25860;7501;21896;2056;6189;2951;8606;5007;14795
432010;201804;1893;5180;1482;4417;220;717;778;2212;998;2929
432020;201804;1905;4665;1329;3720;329;967;613;1636;942;2603
432023;201804;487;1237;271;810;44;164;125;319;169;483
432026;201804;998;2973;740;2430;166;525;364;1199;530;1724
432030;201804;327;886;201;616;36;110;104;303;140;413
432032;201804;440;1180;296;882;29;97;151;415;180;512
432035;201804;773;2275;678;2118;198;675;236;736;434;1411
432040;201804;959;2355;424;1321;72;255;133;395;205;650
432045;201804;240;664;124;423;30;103;28;103;58;206
432050;201804;518;1405;410;1204;119;366;129;381;248;747
432055;201804;776;2089;494;1547;136;454;163;484;299;938
432057;201804;289;747;212;592;38;84;93;250;131;334
432060;201804;468;1176;145;484;26;105;49;141;75;246
432065;201804;217;614;163;491;39;121;52;154;91;275
432067;201804;771;2306;613;1948;86;280;367;1145;453;1425
432070;201804;2007;5426;1228;3793;260;863;241;674;501;1537
432080;201804;3605;9654;2929;8504;768;2483;1129;3163;1897;5646
432085;201804;381;977;241;755;81;246;84;276;165;522
432090;201804;1285;3562;953;2922;230;759;395;1161;625;1920
432100;201804;1098;3043;477;1597;75;275;34;70;109;345
432110;201804;2257;6430;1543;5012;347;1318;108;341;455;1659
432120;201804;3066;8988;2513;7993;803;2766;522;1615;1325;4381
432130;201804;2542;6947;2151;6397;790;2485;734;2199;1524;4684
432132;201804;263;732;126;425;25;90;43;136;68;226
432135;201804;863;2302;589;1751;73;241;384;1108;457;1349
432140;201804;1553;4903;1181;4155;222;811;576;2099;798;2910
432143;201804;1319;3718;1048;3272;127;453;609;1888;736;2341
432145;201804;1346;3873;816;2658;130;461;154;428;284;889
432146;201804;112;343;80;272;25;89;16;48;41;137
432147;201804;358;1187;292;1042;85;311;61;221;146;532
432149;201804;372;1002;223;665;25;73;100;290;125;363
432150;201804;2967;8226;2194;6729;553;1902;614;1806;1167;3708
432160;201804;4330;12745;3501;11355;1036;3560;997;3213;2033;6773
432162;201804;340;802;46;137;5;12;6;18;11;30
432163;201804;210;572;42;138;3;11;3;11;6;22
432166;201804;534;1601;421;1352;76;266;128;361;204;627
432170;201804;1292;3709;834;2775;184;681;203;640;387;1321
432180;201804;2410;6360;1322;4099;272;920;340;937;612;1857
432183;201804;358;1114;236;813;66;247;50;165;116;412
432185;201804;844;2245;521;1608;37;119;312;930;349;1049
432190;201804;2131;5690;1386;4183;338;1132;491;1360;829;2492
432195;201804;1014;2632;650;1975;188;526;189;613;377;1139
432200;201804;2910;8138;2141;6773;494;1635;899;2923;1393;4558
432210;201804;370;1035;255;818;47;164;101;307;148;471
432215;201804;670;2077;592;1944;78;247;391;1316;469;1563
432218;201804;248;647;134;384;20;57;50;131;70;188
432220;201804;3864;9743;2918;8187;435;1393;1649;4399;2084;5792
432225;201804;106;309;77;250;18;56;29;95;47;151
432230;201804;751;1969;426;1290;66;213;147;402;213;615
432232;201804;454;1171;335;967;60;198;159;455;219;653
432234;201804;287;755;136;417;30;87;23;62;53;149
432235;201804;105;304;39;133;5;19;9;28;14;47
432237;201804;382;1021;335;938;16;47;226;598;242;645
432240;201804;13104;37498;10510;33745;973;3606;6420;21496;7393;25102
432250;201804;4109;13589;3568;12485;1093;3976;1188;4274;2281;8250
432252;201804;436;1129;284;825;52;176;114;305;166;481
432253;201804;1172;3655;649;2260;151;586;31;90;182;676
432254;201804;947;2408;194;648;28;109;18;54;46;163
432255;201804;161;414;76;243;8;27;31;87;39;114
432260;201804;5513;14288;4005;11628;1030;3104;1273;3780;2303;6884
432270;201804;2042;6120;1694;5403;544;1839;245;758;789;2597
432280;201804;1158;3061;609;1908;92;311;212;641;304;952
432285;201804;185;569;17;58;2;5;1;1;3;6
432290;201804;394;1191;225;776;60;196;56;178;116;374
432300;201804;24608;67017;19425;58626;2971;9907;11197;32996;14168;42903
432310;201804;692;2016;529;1710;101;333;290;930;391;1263
432320;201804;229;556;74;220;10;39;17;43;27;82
432330;201804;265;680;87;294;17;53;15;52;32;105
432335;201804;175;496;64;237;15;63;10;31;25;94
432340;201804;319;763;148;449;28;100;43;116;71;216
432345;201804;568;1433;518;1367;41;145;394;997;435;1142
432350;201804;340;924;164;551;30;98;50;153;80;251
432360;201804;211;626;40;133;5;26;8;21;13;47
432370;201804;332;899;224;681;20;69;142;425;162;494
432375;201804;535;1397;411;1174;57;153;234;667;291;820
432377;201804;231;744;32;113;5;21;8;20;13;41
432380;201804;1390;4041;866;2918;183;700;367;1165;550;1865
500020;201804;2090;5827;1604;5026;384;1321;666;2014;1050;3335
500025;201804;1269;2958;779;2122;71;202;459;1221;530;1423
500060;201804;6213;18408;4760;15805;714;2405;2748;9591;3462;11996
500070;201804;4069;11167;2972;9222;632;2034;1203;3913;1835;5947
500080;201804;1084;3186;811;2675;198;725;318;1012;516;1737
500085;201804;2015;5039;1378;4066;252;797;709;2037;961;2834
500090;201804;1954;5468;1341;4350;253;861;513;1733;766;2594
500100;201804;3285;8763;2498;7439;351;1154;1170;3314;1521;4468
500110;201804;7087;19920;4937;16429;1010;3595;1680;6242;2690;9837
500124;201804;1932;6182;1655;5703;370;1242;857;3196;1227;4438
500150;201804;1287;3084;804;2314;174;529;260;676;434;1205
500190;201804;4631;11494;3417;9858;686;2066;1604;4796;2290;6862
500200;201804;2201;5498;1652;4526;229;672;906;2341;1135;3013
500210;201804;4481;12526;3465;10996;863;2832;1484;4792;2347;7624
500215;201804;1262;3758;933;3111;111;404;455;1474;566;1878
500220;201804;2784;8070;2092;6852;343;1220;831;2719;1174;3939
500230;201804;2311;5732;1669;4734;225;669;956;2676;1181;3345
500240;201804;3503;11151;2461;8856;453;1892;627;2355;1080;4247
500260;201804;3087;6927;1880;5183;221;624;958;2577;1179;3201
500270;201804;113740;289307;68831;206783;14491;46534;18371;53409;32862;99943
500280;201804;1289;3330;950;2814;116;386;588;1696;704;2082
500290;201804;3903;8978;2164;6348;336;1080;742;2059;1078;3139
500295;201804;2787;7406;1592;4939;261;887;515;1380;776;2267
500310;201804;904;2102;653;1772;112;264;345;990;457;1254
500315;201804;3259;9826;2639;8797;339;1106;1670;5823;2009;6929
500320;201804;17569;52929;12771;44191;3479;12854;3639;13385;7118;26239
500325;201804;3737;9158;2550;7361;314;972;1443;4166;1757;5138
500330;201804;6778;16463;4369;12478;411;1316;2268;6604;2679;7920
500345;201804;1824;4623;1270;3788;341;1015;431;1282;772;2297
500348;201804;2678;6979;2073;5997;241;746;1237;3619;1478;4365
500350;201804;1230;3513;641;2133;77;279;214;726;291;1005
500370;201804;20619;58153;14453;47303;2622;9677;5743;18840;8365;28517
500375;201804;2437;6832;1735;5320;355;1192;538;1610;893;2802
500380;201804;3468;8853;2452;7206;642;1971;870;2598;1512;4569
500390;201804;509;1107;303;808;42;120;155;400;197;520
500400;201804;1130;3244;796;2509;181;607;217;655;398;1262
500410;201804;2259;6131;1730;5296;270;805;1006;3159;1276;3964
500430;201804;2533;6732;1745;5501;298;1039;665;2226;963;3265
500440;201804;1264;3085;754;2228;115;341;274;850;389;1191
500450;201804;1291;3400;715;2289;136;434;111;317;247;751
500460;201804;3755;10608;2423;7958;506;1827;546;1844;1052;3671
500470;201804;2459;6949;1600;5127;463;1619;319;888;782;2507
500480;201804;2126;6369;1893;6064;142;436;1428;4856;1570;5292
500490;201804;846;2200;540;1708;137;496;165;532;302;1028
500500;201804;4007;11187;2787;9337;942;3628;658;2263;1600;5891
500510;201804;738;1899;457;1376;32;114;260;742;292;856
500515;201804;1932;4872;1581;4376;127;334;1140;3264;1267;3598
500520;201804;3109;10557;2571;9460;611;2452;1117;4106;1728;6558
500525;201804;944;2918;765;2627;116;457;396;1385;512;1842
500540;201804;4809;12758;2784;9099;753;2881;268;826;1021;3707
500560;201804;5121;15453;4315;14291;318;1140;3241;10904;3559;12044
500568;201804;4133;9585;2544;7208;607;1952;715;1970;1322;3922
500570;201804;7105;17656;4078;12185;965;3127;791;2213;1756;5340
500580;201804;3170;8902;2461;7673;419;1368;1371;4232;1790;5600
500600;201804;3302;8504;2150;6583;456;1508;694;2127;1150;3635
500620;201804;7460;20724;5166;16220;951;3176;2096;6539;3047;9715
500625;201804;487;1391;264;886;58;221;95;301;153;522
500627;201804;736;1961;450;1415;83;253;106;348;189;601
500630;201804;5880;14988;3671;11150;858;2765;991;3052;1849;5817
500635;201804;2552;9049;2056;8283;169;696;1468;6338;1637;7034
500640;201804;1697;3938;1134;3119;51;172;781;2078;832;2250
500660;201804;17145;48687;12386;40929;4090;14972;2688;8989;6778;23961
500690;201804;2284;6604;1618;5503;719;2690;123;387;842;3077
500710;201804;3040;8767;2353;7474;638;2153;639;2001;1277;4154
500720;201804;5274;13533;3160;9997;853;2979;614;1892;1467;4871
500730;201804;907;2458;583;1839;96;293;211;688;307;981
500740;201804;4577;11557;3335;9386;309;1013;1800;5114;2109;6127
500750;201804;955;2552;716;2120;102;344;319;879;421;1223
500755;201804;977;2759;605;2025;116;404;81;236;197;640
500769;201804;5144;13279;2629;8107;482;1636;386;908;868;2544
500770;201804;1594;4420;1007;3297;174;598;318;1045;492;1643
500780;201804;1272;3321;845;2531;198;612;200;575;398;1187
500790;201804;8326;22229;6710;19657;1253;3966;3593;10608;4846;14574
500793;201804;1917;5245;1347;4251;451;1460;201;570;652;2030
500795;201804;2369;6562;1964;6012;174;460;1524;4930;1698;5390
500797;201804;729;2005;496;1546;108;355;169;500;277;855
500800;201804;2726;6827;1881;5555;641;2124;313;974;954;3098
500830;201804;17992;46672;12410;36282;1957;6236;5505;15396;7462;21632
500840;201804;1128;3056;732;2269;94;310;293;849;387;1159
510010;201804;1472;3942;1084;3338;230;694;556;1771;786;2465
510020;201804;3470;9261;1905;6019;401;1330;358;997;759;2327
510025;201804;6893;18886;4391;14081;807;2849;1245;3765;2052;6614
510030;201804;2012;4771;1390;3886;335;952;520;1520;855;2472
510035;201804;1115;2953;693;2281;112;363;381;1352;493;1715
510040;201804;2125;5065;1520;4204;132;372;945;2622;1077;2994
510050;201804;1810;4681;1230;3737;298;1028;589;1645;887;2673
510060;201804;1401;3708;1024;3086;155;495;502;1472;657;1967
510080;201804;1139;3300;806;2676;223;812;193;564;416;1376
510100;201804;690;1712;452;1273;61;187;211;562;272;749
510120;201804;285;560;168;417;8;23;118;292;126;315
510125;201804;2407;6079;1815;5143;287;1014;762;1979;1049;2993
510130;201804;1488;3997;1111;3357;276;867;300;906;576;1773
510140;201804;2865;8278;2093;7239;794;3105;642;2030;1436;5135
510160;201804;1310;4082;1110;3803;217;767;707;2441;924;3208
510170;201804;4486;12833;3418;11044;772;2627;1428;4593;2200;7220
510180;201804;12426;30821;7827;23293;2006;6446;2199;7259;4205;13705
510185;201804;1726;4620;1166;3813;390;1264;433;1720;823;2984
510190;201804;2324;6417;1555;5200;452;1674;469;1597;921;3271
510250;201804;13630;38381;11568;35469;2565;8245;6030;19163;8595;27408
510260;201804;2098;8625;1694;7837;268;1256;970;5043;1238;6299
510263;201804;3204;9082;2071;6848;438;1565;289;906;727;2471
510267;201804;4940;14528;3142;10459;687;2408;572;1946;1259;4354
510268;201804;1414;3688;965;2862;138;418;517;1487;655;1905
510269;201804;1097;3181;706;2393;222;830;174;534;396;1364
510270;201804;2790;8725;2107;7414;438;1619;752;2591;1190;4210
510279;201804;1748;5028;1297;4150;261;932;603;1827;864;2759
510285;201804;1123;3147;812;2602;230;799;213;654;443;1453
510300;201804;3511;9358;2719;8278;287;839;1802;5713;2089;6552
510305;201804;1349;4086;945;3281;209;756;279;1037;488;1793
510310;201804;776;2125;569;1769;199;624;172;579;371;1203
510320;201804;3748;10083;2786;8381;647;2117;754;2228;1401;4345
510325;201804;4591;14057;3693;12678;1009;3577;1689;6061;2698;9638
510330;201804;2856;8949;2040;7457;449;1714;693;2848;1142;4562
510335;201804;4753;13922;3613;12345;430;1573;2133;7712;2563;9285
510336;201804;515;1532;381;1297;71;233;178;648;249;881
510337;201804;1722;5317;1215;4383;489;1873;196;724;685;2597
510340;201804;73640;182837;47775;141796;14566;49394;9676;27137;24242;76531
510343;201804;1015;2956;705;2320;139;488;229;720;368;1208
510345;201804;1351;4003;1006;3315;182;601;417;1348;599;1949
510350;201804;2813;7651;1885;6121;453;1535;705;2353;1158;3888
510360;201804;1738;3988;1130;3204;60;210;830;2373;890;2583
510370;201804;1622;5026;1210;4296;211;803;632;2336;843;3139
510380;201804;499;1366;267;899;71;260;33;103;104;363
510385;201804;994;3651;724;3064;81;389;413;1865;494;2254
510390;201804;1063;3348;844;3013;217;764;386;1504;603;2268
510395;201804;740;1740;491;1364;44;133;260;761;304;894
510410;201804;4021;12282;3154;10630;779;2675;1470;5200;2249;7875
510420;201804;2147;5060;1537;4165;173;547;862;2294;1035;2841
510450;201804;581;1499;347;1062;84;271;56;172;140;443
510452;201804;644;1949;442;1525;84;288;204;706;288;994
510454;201804;809;2401;616;2052;73;242;356;1225;429;1467
510455;201804;920;2734;659;2157;108;401;244;736;352;1137
510460;201804;2020;5188;1444;4338;150;544;833;2364;983;2908
510480;201804;4159;10468;2883;8105;469;1409;1295;3452;1764;4861
510490;201804;1495;4499;1203;4088;262;912;597;2046;859;2958
510500;201804;1410;3948;899;2986;152;596;359;1166;511;1762
510510;201804;3075;9875;2415;8548;786;3036;542;2048;1328;5084
510515;201804;5714;15768;3694;11817;834;2912;914;2644;1748;5556
510517;201804;1290;3770;994;3222;277;979;156;454;433;1433
510520;201804;2032;4340;1283;3410;48;138;777;2195;825;2333
510523;201804;949;2595;754;2261;115;348;455;1373;570;1721
510525;201804;5114;15112;3917;12659;722;2558;1456;4261;2178;6819
510530;201804;535;1384;393;1171;25;113;276;778;301;891
510550;201804;2724;8487;1991;7098;498;1843;677;2449;1175;4292
510558;201804;1930;5437;1572;4914;132;449;896;2994;1028;3443
510560;201804;1580;4717;940;3482;212;871;223;872;435;1743
510562;201804;5249;14640;3782;11828;902;3051;1208;3864;2110;6915
510590;201804;3133;7993;2296;6888;446;1294;1305;4127;1751;5421
510600;201804;1522;3721;940;2764;232;676;318;947;550;1623
510610;201804;2510;6681;1849;5753;180;633;1134;3473;1314;4106
510615;201804;1955;5599;1482;4764;325;1058;743;2462;1068;3520
510617;201804;879;2613;687;2307;85;270;487;1726;572;1996
510618;201804;1294;3612;924;2907;183;672;441;1295;624;1967
510619;201804;741;1986;421;1391;75;280;74;236;149;516
510620;201804;1482;3453;712;2213;159;559;91;257;250;816
510621;201804;1201;3489;835;2779;175;621;237;790;412;1411
510622;201804;3823;11391;2770;8989;916;3261;509;1514;1425;4775
510623;201804;2879;7655;2099;6355;427;1546;636;1842;1063;3388
510624;201804;1582;4288;700;2435;104;408;95;273;199;681
510625;201804;2156;5649;1334;4137;314;1111;240;734;554;1845
510626;201804;1514;3797;948;2954;267;920;210;683;477;1603
510627;201804;636;1702;386;1194;93;295;88;285;181;580
510628;201804;1574;3648;1034;2915;179;484;604;1788;783;2272
510629;201804;1588;4951;1232;4195;310;1123;387;1360;697;2483
510630;201804;2994;9100;1882;6856;446;1756;301;1157;747;2913
510631;201804;461;1195;339;1007;17;37;232;708;249;745
510637;201804;2977;7845;2267;6704;658;2163;692;1969;1350;4132
510642;201804;4857;15054;3908;13607;1072;4067;1537;5557;2609;9624
510645;201804;915;2014;539;1512;150;425;154;441;304;866
510650;201804;6426;18972;5471;17872;844;2809;3890;13239;4734;16048
510665;201804;1861;4497;1087;3148;214;672;370;1109;584;1781
510670;201804;391;834;211;579;20;71;116;321;136;392
510675;201804;6039;17676;4418;14586;1258;4509;808;2613;2066;7122
510677;201804;2064;5446;1477;4578;213;693;818;2552;1031;3245
510680;201804;660;1900;442;1472;93;309;60;203;153;512
510682;201804;1714;5478;1270;4634;379;1497;255;937;634;2434
510685;201804;766;2214;582;1854;80;260;270;818;350;1078
510700;201804;3541;9360;2479;7760;510;1668;1296;4158;1806;5826
510704;201804;9845;25125;6588;19247;1316;4149;2121;5943;3437;10092
510706;201804;1837;5530;1246;4578;251;1040;616;2369;867;3409
510710;201804;2596;7039;1787;5425;367;1138;613;1774;980;2912
510715;201804;715;1697;495;1341;65;174;203;559;268;733
510718;201804;2536;5605;1391;4219;555;1734;233;961;788;2695
510719;201804;393;874;245;675;38;117;138;366;176;483
510720;201804;1004;2562;668;2011;186;606;160;450;346;1056
510724;201804;714;2027;499;1634;92;337;220;673;312;1010
510726;201804;866;1780;505;1274;78;201;281;713;359;914
510729;201804;657;1596;311;941;50;171;75;214;125;385
510730;201804;3023;7897;2058;6264;496;1608;694;2111;1190;3719
510735;201804;990;2980;751;2645;90;349;496;1775;586;2124
510740;201804;1233;3231;880;2659;90;251;549;1768;639;2019
510757;201804;622;2024;506;1809;208;787;158;549;366;1336
510760;201804;35195;81907;21229;60729;6035;19410;4479;11721;10514;31131
510770;201804;4070;9778;3063;8590;282;721;2105;6256;2387;6977
510774;201804;359;1013;269;838;49;130;131;434;180;564
510775;201804;607;1765;444;1481;111;425;82;251;193;676
510776;201804;436;1230;323;986;75;243;129;373;204;616
510777;201804;1672;4651;1207;4012;130;482;875;2915;1005;3397
510779;201804;591;1708;468;1505;58;157;283;963;341;1120
510780;201804;3350;9643;2656;8533;686;2229;1032;3668;1718;5897
510785;201804;2039;5460;1194;3877;286;1042;170;546;456;1588
510787;201804;2404;6909;1719;5592;718;2429;158;493;876;2922
510788;201804;698;1710;488;1390;86;247;184;620;270;867
510790;201804;14210;39575;8978;29256;2027;7553;1176;3354;3203;10907
510792;201804;8677;23889;5552;17991;1128;3959;1167;3679;2295;7638
510794;201804;1197;3469;809;2730;245;911;171;511;416;1422
510795;201804;7187;20553;5098;16660;1334;4772;1079;3566;2413;8338
510800;201804;1533;4125;1095;3440;233;756;433;1317;666;2073
510805;201804;1802;4963;1207;3860;233;803;439;1269;672;2072
510810;201804;666;1495;446;1193;114;329;215;544;329;873
510820;201804;826;1676;449;1185;55;176;196;495;251;671
510830;201804;734;1962;530;1665;96;291;280;935;376;1226
510835;201804;575;1542;396;1244;53;179;190;575;243;754
510840;201804;40220;98483;30859;86075;6495;17757;15559;45979;22054;63736
510850;201804;1792;4548;1036;3275;315;1110;144;378;459;1488
510860;201804;2657;7566;1749;5931;563;2170;177;583;740;2753
510880;201804;601;1870;482;1648;129;463;215;749;344;1212
510885;201804;579;1545;408;1296;68;232;137;418;205;650
510890;201804;705;2130;567;1924;123;444;275;954;398;1398
510895;201804;1172;3237;820;2609;207;745;287;828;494;1573
520005;201804;1940;5470;1567;4996;455;1352;690;2512;1145;3864
520010;201804;2191;6749;1559;5417;485;1880;294;899;779;2779
520013;201804;2681;7418;1937;5934;468;1518;513;1656;981;3174
520015;201804;528;1409;398;1226;112;359;110;375;222;734
520017;201804;1094;3053;847;2658;178;602;420;1293;598;1895
520020;201804;382;963;301;850;65;207;167;448;232;655
520025;201804;31317;90750;27637;85898;3340;11027;19474;60534;22814;71561
520030;201804;5029;14194;4011;12557;516;1745;2342;7337;2858;9082
520050;201804;440;1074;268;751;19;44;152;451;171;495
520055;201804;957;2712;766;2330;74;214;455;1382;529;1596
520060;201804;1409;4176;1096;3576;271;968;285;909;556;1877
520080;201804;1870;5037;1455;4461;251;764;685;2297;936;3061
520082;201804;1033;2606;872;2330;106;221;503;1402;609;1623
520085;201804;693;2025;557;1789;117;355;178;554;295;909
520090;201804;858;1869;606;1569;100;226;378;1041;478;1267
520110;201804;38500;108028;27684;90474;9412;34849;1756;5199;11168;40048
520120;201804;198;502;112;347;12;45;39;117;51;162
520130;201804;3599;9539;3033;8615;618;1878;1498;4344;2116;6222
520140;201804;34840;103688;27300;89991;9657;34578;2890;9758;12547;44336
520145;201804;457;1193;319;967;61;195;123;353;184;548
520150;201804;549;1370;424;1211;75;214;232;671;307;885
520160;201804;860;2098;624;1743;102;290;269;754;371;1044
520170;201804;5050;10644;3670;9090;221;569;3031;7566;3252;8135
520180;201804;2014;5748;1662;5190;422;1406;693;2133;1115;3539
520215;201804;1968;4833;1432;3988;294;910;649;1767;943;2677
520235;201804;633;1556;420;1218;54;170;157;435;211;605
520250;201804;1554;4090;1106;3398;285;959;206;661;491;1620
520260;201804;845;2044;511;1447;84;251;194;544;278;795
520280;201804;645;1735;510;1485;152;427;189;608;341;1035
520310;201804;1239;2846;813;2188;205;563;297;855;502;1418
520320;201804;1870;5366;1479;4688;166;568;799;2568;965;3136
520330;201804;3161;9282;2276;7724;473;1835;865;2909;1338;4744
520340;201804;2186;5147;1503;4171;152;376;999;2894;1151;3270
520350;201804;3069;7885;2231;6421;674;2069;694;1909;1368;3978
520355;201804;1732;4905;1333;4175;330;1129;512;1574;842;2703
520357;201804;811;2055;631;1779;33;102;448;1274;481;1376
520360;201804;710;1933;542;1638;163;499;142;453;305;952
520380;201804;1313;3409;784;2375;101;347;369;1027;470;1374
520390;201804;952;2180;549;1652;172;566;127;386;299;952
520393;201804;544;1320;382;1063;45;136;188;485;233;621
520396;201804;793;2281;670;2046;96;293;427;1290;523;1583
520400;201804;1536;4108;1232;3665;223;681;726;2185;949;2866
520410;201804;1622;3644;1045;2829;129;369;623;1675;752;2044
520420;201804;373;956;275;763;23;75;194;505;217;580
520425;201804;1420;3514;957;2733;248;720;390;1121;638;1841
520430;201804;2196;5355;1153;3585;204;733;54;153;258;886
520440;201804;3382;8403;2125;6167;550;1708;514;1442;1064;3150
520450;201804;11412;29398;7633;23079;2339;7677;507;1591;2846;9268
520455;201804;673;1897;501;1619;161;550;121;389;282;939
520460;201804;900;2442;763;2246;94;261;568;1701;662;1962
520465;201804;841;2277;696;2047;114;370;435;1224;549;1594
520470;201804;1885;5563;1606;5178;375;1189;925;3205;1300;4394
520480;201804;824;2399;534;1853;132;483;95;333;227;816
520485;201804;1545;4351;1270;3976;130;452;885;2726;1015;3178
520490;201804;3846;11301;2987;9967;799;2664;1360;4715;2159;7379
520495;201804;1452;3498;1147;3091;80;220;855;2364;935;2584
520500;201804;1397;3778;1000;3065;237;812;368;1109;605;1921
520505;201804;724;1820;523;1543;101;292;270;788;371;1080
520510;201804;6843;18634;4946;15704;1158;4060;1239;4093;2397;8153
520520;201804;1074;2806;802;2395;233;667;225;766;458;1433
520530;201804;1868;5972;1444;5190;536;1946;328;1388;864;3334
520540;201804;2896;7802;1831;5673;421;1341;373;1208;794;2549
520545;201804;985;2730;753;2340;130;423;275;845;405;1268
520547;201804;737;2177;578;1865;162;541;219;688;381;1229
520549;201804;10797;31150;8806;27965;1886;6135;4564;14766;6450;20901
520551;201804;4132;11919;3555;11061;506;1827;2363;7182;2869;9009
520552;201804;761;2158;680;2055;105;294;479;1512;584;1806
520570;201804;637;1590;422;1254;104;322;141;427;245;749
520580;201804;2838;6452;1978;5356;228;662;1260;3415;1488;4077
520590;201804;1308;3675;942;2989;231;741;157;518;388;1259
520620;201804;8154;22662;6598;20461;1737;5577;2856;9014;4593;14591
520630;201804;998;2499;632;1889;102;309;189;538;291;847
520640;201804;2575;6683;1993;5689;486;1405;766;2236;1252;3641
520650;201804;898;2261;620;1783;105;315;328;954;433;1269
520660;201804;434;1062;237;719;56;186;41;139;97;325
520670;201804;970;2779;813;2552;80;271;566;1733;646;2004
520680;201804;747;1922;546;1598;105;298;258;779;363;1077
520690;201804;367;878;239;690;73;210;71;226;144;436
520710;201804;559;1383;358;1021;13;39;221;610;234;649
520725;201804;1623;3941;1145;3156;129;397;735;1968;864;2365
520735;201804;803;2069;547;1606;113;332;169;504;282;836
520740;201804;1891;4634;1500;4145;247;658;919;2629;1166;3287
520750;201804;681;1708;497;1436;95;253;225;682;320;935
520753;201804;1453;3811;1182;3321;183;535;577;1588;760;2123
520760;201804;1156;2593;1023;2424;93;188;823;2045;916;2233
520780;201804;1686;4145;1248;3498;134;399;669;1818;803;2217
520790;201804;3115;7662;2226;6314;190;541;1450;4277;1640;4818
520800;201804;15177;40861;12326;37070;2347;6986;7263;22999;9610;29985
520810;201804;1279;2801;924;2396;156;445;522;1411;678;1856
520815;201804;649;1974;471;1597;130;482;71;258;201;740
520830;201804;1764;4132;1306;3601;74;144;1020;2831;1094;2975
520840;201804;2187;6177;1784;5624;755;2476;447;1525;1202;4001
520850;201804;672;1848;459;1510;138;514;113;368;251;882
520860;201804;6123;17561;4730;15292;1108;3853;1652;5439;2760;9292
520870;201804;88920;222095;62587;181993;17359;54569;15914;45195;33273;99764
520880;201804;6070;17644;4790;15540;1505;5189;1155;3735;2660;8924
520890;201804;3826;9954;2758;8211;594;1989;1132;3265;1726;5254
520910;201804;4066;10688;2663;8237;784;2648;471;1465;1255;4113
520915;201804;638;1824;458;1449;77;281;173;520;250;801
520920;201804;4200;10249;2847;8341;423;1340;1401;4133;1824;5473
520929;201804;679;1749;518;1465;113;278;241;757;354;1035
520940;201804;1124;3028;875;2673;58;194;650;1981;708;2175
520945;201804;536;1244;414;1041;34;79;283;694;317;773
520960;201804;1023;2760;801;2387;130;420;432;1242;562;1662
520970;201804;2436;7264;2034;6527;564;1979;479;1567;1043;3546
520980;201804;754;2015;600;1780;131;432;240;680;371;1112
520990;201804;2911;8965;2595;8457;380;1275;1547;5193;1927;6468
520993;201804;968;2386;662;1879;31;91;474;1334;505;1425
520995;201804;2214;5869;1799;5302;434;1246;779;2373;1213;3619
521000;201804;7794;21928;5769;18157;1518;5004;1475;4633;2993;9637
521010;201804;3896;10401;2924;8719;400;1154;1546;4635;1946;5789
521015;201804;654;1717;547;1545;71;207;375;1044;446;1251
521020;201804;2862;7795;1764;5557;482;1629;183;575;665;2204
521030;201804;598;1429;426;1161;52;115;209;617;261;732
521040;201804;7272;18298;5493;15527;1525;4548;2000;5803;3525;10351
521056;201804;844;2371;658;2070;215;695;171;593;386;1288
521060;201804;1068;2729;810;2322;66;203;429;1253;495;1456
521080;201804;1089;2558;575;1680;80;250;187;465;267;715
521090;201804;3107;8194;2280;6867;675;2189;407;1256;1082;3445
521100;201804;1820;4288;1325;3585;265;692;683;1907;948;2599
521120;201804;4871;11556;3413;9716;418;1138;1580;5091;1998;6229
521130;201804;1002;2505;673;1883;42;143;386;1064;428;1207
521140;201804;1195;3220;888;2675;152;481;343;1025;495;1506
521150;201804;11306;26523;7360;20653;1888;5885;2711;7791;4599;13676
521160;201804;706;1584;467;1221;81;226;230;568;311;794
521170;201804;1115;2692;794;2205;82;231;496;1329;578;1560
521180;201804;6340;19224;5305;17277;1110;3878;2075;6647;3185;10525
521190;201804;10135;26951;5943;19348;1453;5073;1025;3500;2478;8573
521200;201804;767;1991;548;1611;67;213;280;808;347;1021
521205;201804;589;1550;442;1310;26;74;318;922;344;996
521210;201804;760;2048;429;1328;101;340;57;128;158;468
521220;201804;4193;10286;2879;8316;604;1864;971;2703;1575;4567
521225;201804;354;832;280;750;27;56;203;577;230;633
521230;201804;1402;4528;1308;4379;437;1303;704;2619;1141;3922
521250;201804;31003;88556;25042;79874;10125;33290;6986;24019;17111;57309
521260;201804;627;1507;473;1267;77;224;264;700;341;924
521270;201804;1820;4796;1573;4502;119;269;1216;3597;1335;3866
521280;201804;1913;5356;1441;4507;434;1461;442;1405;876;2866
521290;201804;458;1205;339;1036;59;213;189;557;248;770
521295;201804;1170;2617;915;2309;99;222;661;1755;760;1977
521300;201804;1878;4872;1516;4366;249;680;977;2932;1226;3612
521305;201804;735;1924;543;1598;87;252;274;810;361;1062
521308;201804;4467;12667;3325;10404;591;1890;1624;5093;2215;6983
521310;201804;8265;22411;5476;17222;1394;4655;1456;4457;2850;9112
521340;201804;391;955;308;828;22;56;236;631;258;687
521350;201804;2098;5409;1643;4727;204;635;1093;3053;1297;3688
521370;201804;1113;2948;684;2181;180;658;94;297;274;955
521375;201804;1457;3858;1076;3317;259;838;391;1271;650;2109
521377;201804;1333;3041;1051;2688;55;139;899;2311;954;2450
521380;201804;6157;16774;4184;13141;479;1561;1012;3349;1491;4910
521385;201804;605;1517;478;1358;110;310;219;679;329;989
521390;201804;715;1856;526;1569;165;532;167;515;332;1047
521400;201804;2279;5550;1818;5029;209;640;1345;3723;1554;4363
521405;201804;1279;3410;968;2880;217;650;424;1275;641;1925
521410;201804;760;2101;619;1897;130;376;314;1040;444;1416
521440;201804;1403;3812;1036;3142;278;883;241;716;519;1599
521450;201804;3839;11928;2939;10074;742;2612;717;2579;1459;5191
521460;201804;6249;17174;4734;14467;1505;4892;1234;3613;2739;8505
521470;201804;641;1816;383;1223;63;192;96;282;159;474
521480;201804;374;1024;213;689;41;142;55;161;96;303
521483;201804;2489;6280;1798;5120;462;1384;525;1445;987;2829
521486;201804;1693;4105;1309;3579;76;215;990;2675;1066;2890
521487;201804;491;1242;340;1012;68;215;135;407;203;622
521490;201804;839;2329;639;1980;39;159;438;1314;477;1473
521500;201804;1659;4360;1168;3544;120;432;718;2091;838;2523
521520;201804;826;1895;567;1512;95;257;236;656;331;913
521523;201804;11237;37908;9894;35555;3603;13822;2411;9054;6014;22876
521525;201804;1019;2457;795;2135;78;212;539;1424;617;1636
521530;201804;2159;5692;1285;3919;273;874;299;959;572;1833
521540;201804;862;2242;561;1719;95;359;240;730;335;1089
521550;201804;1403;3609;840;2475;168;540;277;854;445;1394
521560;201804;3726;10858;2724;9501;638;2546;1278;4635;1916;7181
521565;201804;587;1489;478;1338;66;175;319;875;385;1050
521570;201804;3970;10718;2599;8117;533;1816;348;1125;881;2941
521580;201804;534;1327;300;914;47;154;57;158;104;312
521590;201804;607;1588;466;1351;125;406;178;484;303;890
521600;201804;411;1178;262;832;54;164;56;175;110;339
521630;201804;1543;3601;935;2677;198;625;277;760;475;1385
521640;201804;2101;5034;1507;4180;349;988;568;1576;917;2564
521645;201804;575;1591;377;1217;80;261;102;325;182;586
521680;201804;1155;3653;927;3164;286;1029;106;392;392;1421
521690;201804;435;1246;393;1172;92;278;200;589;292;867
521710;201804;3025;8204;2120;6614;407;1347;425;1291;832;2638
521720;201804;2044;5388;1525;4489;216;681;815;2315;1031;2996
521730;201804;3704;11248;2969;9840;1002;3639;477;1326;1479;4965
521740;201804;3875;10616;3019;9307;860;2874;1027;3335;1887;6209
521760;201804;13958;42379;11580;38507;3454;12474;3674;12737;7128;25211
521770;201804;2821;7482;2023;6047;650;2073;445;1287;1095;3360
521800;201804;6030;17444;4909;15551;1440;4748;1520;5214;2960;9962
521805;201804;680;1538;461;1244;158;401;170;489;328;890
521810;201804;737;1752;501;1396;85;250;229;658;314;908
521830;201804;5184;15228;4291;13897;460;1689;2831;9045;3291;10734
521839;201804;689;1819;493;1461;99;301;177;508;276;809
521850;201804;5570;14552;3993;11965;1019;3310;589;1658;1608;4968
521860;201804;1842;4812;1316;3947;231;763;434;1274;665;2037
521870;201804;546;1661;429;1456;106;376;135;423;241;799
521878;201804;680;1886;481;1495;83;288;178;505;261;793
521880;201804;19024;47438;12869;37922;3365;10374;3931;12054;7296;22428
521890;201804;3169;8925;2173;6900;539;1829;253;740;792;2569
521900;201804;1597;3894;983;2950;240;710;263;798;503;1508
521910;201804;1193;2746;812;2294;84;248;483;1422;567;1670
521920;201804;395;1181;299;977;65;231;93;321;158;552
521925;201804;644;1871;489;1582;110;346;143;465;253;811
521930;201804;4318;11752;3243;10078;955;2939;970;3236;1925;6175
521935;201804;723;1893;540;1563;103;301;262;729;365;1030
521940;201804;1238;2954;864;2441;216;706;357;956;573;1662
521945;201804;576;1705;469;1509;85;270;210;719;295;989
521950;201804;616;1520;489;1360;31;91;391;1089;422;1180
521960;201804;717;2020;477;1524;74;264;211;641;285;905
521970;201804;2618;6814;2192;6312;137;353;1784;5297;1921;5650
521971;201804;872;2248;592;1781;140;449;134;387;274;836
521973;201804;1064;3010;882;2738;105;373;531;1608;636;1981
521975;201804;12325;33171;10493;30743;1766;5349;6477;19035;8243;24384
521980;201804;2449;6179;1960;5525;209;535;1439;4122;1648;4657
521990;201804;1155;3258;922;2878;127;396;506;1627;633;2023
522000;201804;3779;12696;3152;11890;243;815;2271;9234;2514;10049
522005;201804;316;806;229;670;61;161;89;279;150;440
522010;201804;3685;9629;2777;8155;832;2559;691;1987;1523;4546
522015;201804;963;2633;707;2223;146;482;263;813;409;1295
522020;201804;5276;13110;3598;10359;864;2610;1474;4295;2338;6905
522026;201804;663;1894;519;1670;90;303;254;841;344;1144
522028;201804;516;1406;376;1104;94;272;130;355;224;627
522040;201804;2737;6286;1930;5238;261;727;1313;3575;1574;4302
522045;201804;16073;48781;12355;41424;3042;10939;2566;8390;5608;19329
522050;201804;1106;3049;744;2375;155;516;251;760;406;1276
522060;201804;2486;7045;2008;6306;302;993;1105;3595;1407;4588
522068;201804;1698;4893;1407;4535;180;534;962;3231;1142;3765
522070;201804;610;1683;511;1527;45;184;354;1008;399;1192
522100;201804;563;1559;423;1347;73;248;223;711;296;959
522108;201804;850;2473;691;2207;45;184;543;1685;588;1869
522119;201804;1574;4218;1227;3735;205;644;639;2007;844;2651
522130;201804;386;982;277;836;65;214;138;420;203;634
522140;201804;15693;43599;11678;36404;3565;11755;1808;5630;5373;17385
522145;201804;833;2112;618;1799;141;364;329;1041;470;1405
522150;201804;940;2323;711;1995;216;587;242;718;458;1305
522155;201804;883;2409;716;2139;143;405;350;1091;493;1496
522157;201804;553;1494;474;1384;28;111;352;990;380;1101
522160;201804;6152;16528;4095;12729;1145;3857;341;1189;1486;5046
522170;201804;2435;6760;1769;5600;540;1780;477;1525;1017;3305
522180;201804;427;1143;273;867;61;199;43;151;104;350
522185;201804;15806;41392;12082;36518;4710;15086;3377;11160;8087;26246
522190;201804;798;1922;587;1607;109;293;231;674;340;967
522200;201804;1737;5282;1172;4019;221;792;157;528;378;1320
522205;201804;1493;3757;1154;3262;98;301;818;2321;916;2622
522220;201804;1356;3513;1034;3049;167;466;562;1709;729;2175
522230;201804;1218;3280;1016;2983;180;582;574;1686;754;2268
530010;201804;165964;490359;142506;451295;30208;105639;68088;210609;98296;316248
110001;201805;3367;10249;2589;8855;676;2451;1067;3643;1743;6094
110002;201805;11192;30664;8205;25561;2495;8272;2535;7891;5030;16163
110003;201805;686;2053;509;1690;151;540;98;301;249;841
110004;201805;8678;25467;6410;21093;1824;6305;1408;4939;3232;11244
110005;201805;2233;6140;1447;4668;376;1269;449;1546;825;2815
110006;201805;1683;4855;1057;3543;265;943;138;463;403;1406
110007;201805;1166;3411;904;2949;322;1079;283;1027;605;2106
110008;201805;2396;7737;2148;7374;284;913;1626;5779;1910;6692
110009;201805;3929;11534;2707;9373;816;2906;876;3165;1692;6071
110010;201805;6009;20494;4960;18641;1382;5090;2139;9007;3521;14097
110011;201805;6254;18207;4815;15460;1616;5360;1011;3313;2627;8673
110012;201805;13345;35955;9277;28877;2409;7829;1437;4599;3846;12428
110013;201805;5294;16168;4295;14264;1728;5887;724;2655;2452;8542
110014;201805;3738;10259;2713;8427;769;2429;1072;3276;1841;5705
110015;201805;5028;14101;2995;9941;778;2752;432;1400;1210;4152
110018;201805;3498;9368;2244;7205;526;1928;584;1773;1110;3701
110020;201805;67551;174111;47604;145973;10639;34261;18524;60516;29163;94777
110025;201805;4525;11844;3128;9414;575;1835;1628;4785;2203;6620
110026;201805;479;1452;398;1317;123;439;156;487;279;926
110028;201805;6030;17001;4167;13404;1181;4073;566;1804;1747;5877
110029;201805;1338;3390;825;2574;204;651;345;1072;549;1723
110030;201805;11451;28855;7920;23698;1530;5187;3029;9227;4559;14414
110032;201805;3101;9395;2293;7667;772;2605;561;1924;1333;4529
110033;201805;4082;13292;3357;11903;1176;4204;919;3621;2095;7825
110034;201805;3330;8582;2410;7247;763;2424;1024;3134;1787;5558
110037;201805;1656;5391;1346;4775;340;1253;617;2158;957;3411
110040;201805;2927;8744;2243;7464;695;2501;571;1817;1266;4318
110045;201805;4667;14384;3910;13197;1203;4359;1545;5225;2748;9584
110050;201805;1626;4948;1254;4202;519;1804;289;975;808;2779
110060;201805;793;2499;582;2054;210;787;66;242;276;1029
110070;201805;1869;6122;1512;5296;527;1935;360;1198;887;3133
110080;201805;5118;13110;3903;11612;852;2555;2203;6856;3055;9411
110090;201805;634;1760;446;1418;129;423;171;529;300;952
110092;201805;1112;3461;903;3095;151;553;486;1722;637;2275
110094;201805;2932;8842;2315;7801;807;2807;688;2422;1495;5229
110100;201805;1835;5695;1560;5131;354;1256;766;2494;1120;3750
110110;201805;1577;4687;1190;4052;412;1463;261;942;673;2405
110120;201805;1387;4215;1039;3500;294;1042;268;886;562;1928
110130;201805;2569;6839;1625;5081;384;1341;534;1632;918;2973
110140;201805;2149;6840;1618;5726;443;1646;392;1374;835;3020
110143;201805;1328;3718;963;3031;330;1049;256;828;586;1877
110145;201805;973;2735;634;2075;160;555;201;656;361;1211
110146;201805;438;1219;310;1018;58;175;153;538;211;713
110147;201805;634;1762;427;1338;95;310;166;477;261;787
110148;201805;978;2943;589;2027;115;425;54;187;169;612
110149;201805;2728;8023;2066;6976;825;2720;576;2134;1401;4854
110150;201805;2113;5932;1588;5140;660;2353;395;1217;1055;3570
110155;201805;693;2177;553;1853;128;462;200;646;328;1108
110160;201805;1499;4803;1153;4045;418;1456;273;1003;691;2459
110170;201805;2247;6180;1492;4696;286;961;746;2267;1032;3228
110175;201805;1417;4257;1111;3785;193;698;546;1950;739;2648
110180;201805;1212;3519;903;2893;247;776;376;1234;623;2010
120001;201805;3489;12226;3081;11617;485;1636;2039;8278;2524;9914
120005;201805;1777;7007;1606;6720;186;862;1213;5166;1399;6028
120010;201805;5165;16594;4461;15408;709;2375;2929;10480;3638;12855
120013;201805;2065;8038;1948;7863;534;2090;1074;4660;1608;6750
120017;201805;2017;7047;1844;6755;362;1368;1069;4102;1431;5470
120020;201805;13929;59626;13244;58274;1406;6707;9920;44572;11326;51279
120025;201805;2644;8299;2256;7800;451;1607;1417;5022;1868;6629
120030;201805;6394;25531;6153;25127;368;1857;5121;20983;5489;22840
120032;201805;1597;7501;1523;7320;89;575;1214;5791;1303;6366
120033;201805;3892;15033;3669;14646;150;812;3190;12654;3340;13466
120034;201805;2399;9217;2098;8648;134;791;1660;6728;1794;7519
120035;201805;3352;14399;3213;14126;278;1432;2583;11424;2861;12856
120038;201805;2559;8824;2323;8405;610;2266;1190;4404;1800;6670
120039;201805;1894;8590;1811;8428;174;1049;1366;6368;1540;7417
120040;201805;40656;138704;36493;131621;6830;26088;20783;76323;27613;102411
120042;201805;3147;12408;2924;11925;158;839;2352;9549;2510;10388
120043;201805;1227;5457;1159;5300;79;480;984;4479;1063;4959
120045;201805;5350;15879;4846;15317;175;692;4435;13935;4610;14627
120050;201805;8510;32684;7940;31702;656;3087;6150;24876;6806;27963
120060;201805;8392;35400;8005;34721;489;2691;6763;29406;7252;32097
120070;201805;2763;9690;2570;9370;314;1171;1808;6801;2122;7972
120080;201805;4004;14275;3654;13688;588;2360;2477;9377;3065;11737
130002;201805;3112;12762;2867;12418;101;553;2567;11169;2668;11722
130006;201805;2261;8969;1929;8361;153;775;1455;6299;1608;7074
130008;201805;2446;8972;2193;8552;83;455;1815;7078;1898;7533
130010;201805;3770;11070;3290;10523;71;272;3061;9825;3132;10097
130014;201805;3014;9470;2480;8559;442;1552;1553;5476;1995;7028
130020;201805;2710;10743;2494;10371;149;877;1982;8200;2131;9077
130030;201805;9212;31556;8479;30760;153;480;7992;29455;8145;29935
130040;201805;3787;11480;3223;10733;212;711;2572;8686;2784;9397
130050;201805;7197;26963;6079;25517;190;872;5477;23269;5667;24141
130060;201805;7034;29438;6172;28242;508;2981;4854;22139;5362;25120
130063;201805;5473;19657;4945;19039;106;487;4604;17871;4710;18358
130068;201805;3246;13077;2884;12372;207;1135;2181;9314;2388;10449
130070;201805;8237;26139;7127;24888;318;1067;6244;22294;6562;23361
130080;201805;6316;25444;5727;24665;405;2325;4615;19892;5020;22217
130083;201805;2493;9009;2255;8685;186;849;1805;6903;1991;7752
130090;201805;3147;10317;2886;9958;56;235;2600;9111;2656;9346
130100;201805;7116;23105;6327;22250;81;252;6010;21505;6091;21757
130110;201805;7774;22874;6671;21554;556;1602;5617;18639;6173;20241
130115;201805;5340;17369;4754;16633;99;400;4155;14723;4254;15123
130120;201805;14827;54429;13582;52803;1272;5232;11019;43551;12291;48783
130130;201805;4935;16962;4022;15779;460;2086;3025;11827;3485;13913
130140;201805;6513;24760;6268;24476;253;1208;5709;22295;5962;23503
130150;201805;3565;13923;3397;13707;105;616;3081;12454;3186;13070
130160;201805;4760;18237;4252;17566;321;1541;3494;14696;3815;16237
130165;201805;3088;12291;2939;12039;113;633;2584;10567;2697;11200
130170;201805;11223;34930;9264;32535;719;2817;7625;27116;8344;29933
130180;201805;4321;13853;4078;13567;56;254;3899;12954;3955;13208
130185;201805;16529;43152;13505;39932;523;1128;12040;36827;12563;37955
130190;201805;17884;60557;15091;56477;1779;6717;10760;41671;12539;48388
130195;201805;2280;8749;1914;8259;84;424;1690;7332;1774;7756
130200;201805;2269;7082;1940;6627;157;537;1539;5387;1696;5924
130210;201805;1383;5273;1243;5107;108;632;975;3927;1083;4559
130220;201805;2041;7881;1860;7572;113;594;1474;6022;1587;6616
130230;201805;4097;18004;3698;17417;329;1856;3027;14353;3356;16209
130240;201805;10360;34470;8799;32262;228;1327;7759;28405;7987;29732
130250;201805;24779;77064;21959;73850;1518;4891;18235;63430;19753;68321
130255;201805;4140;14602;3715;13857;240;1069;2944;10976;3184;12045
130260;201805;241873;735511;205520;679003;59793;211192;86344;288710;146137;499902
130270;201805;8426;32169;7267;30318;975;4221;5115;22049;6090;26270
130280;201805;3476;14259;3274;14031;83;387;3062;13310;3145;13697
130290;201805;12347;42413;11151;41028;293;737;10420;39368;10713;40105
130300;201805;4612;16996;4285;16500;216;1121;3656;14004;3872;15125
130310;201805;5527;20188;4991;19443;379;1522;4099;16278;4478;17800
130320;201805;3302;11169;2867;10603;273;973;2179;8300;2452;9273
130330;201805;4165;14166;3560;13410;157;757;3077;11603;3234;12360
130340;201805;20793;72230;18457;69492;1473;5436;15454;59834;16927;65270
130350;201805;3791;14318;3489;13920;176;1013;3015;11887;3191;12900
130353;201805;6222;18597;5255;17362;890;2890;3511;12142;4401;15032
130356;201805;4934;17119;4371;16190;563;2175;3016;11436;3579;13611
130360;201805;3286;9678;2788;9133;74;215;2604;8623;2678;8838
130370;201805;5800;22498;5189;21681;191;1137;4515;18826;4706;19963
130380;201805;7513;31491;7153;30951;498;2734;6005;25762;6503;28496
130390;201805;5760;24678;5092;23493;528;2823;3778;17422;4306;20245
130395;201805;2345;7777;2044;7237;237;882;1444;5127;1681;6009
130400;201805;2557;8502;2241;8055;103;365;1980;7201;2083;7566
130406;201805;11093;40897;9801;39106;1833;7582;6570;26737;8403;34319
130410;201805;4035;14855;3530;13974;1059;4386;1671;6823;2730;11209
130420;201805;12312;46959;10884;45145;1058;4903;8693;36440;9751;41343
130423;201805;3951;13412;3525;12883;164;838;3085;11118;3249;11956
130426;201805;2762;11016;2644;10838;70;348;2459;10167;2529;10515
130430;201805;3938;12359;3555;11818;389;1349;2796;9353;3185;10702
130440;201805;4458;14368;3974;13796;78;312;3725;13023;3803;13335
140002;201805;1942;5959;1718;5659;109;448;1374;4449;1483;4897
140005;201805;3356;9248;3152;9022;129;403;2879;8252;3008;8655
140010;201805;52029;143742;40723;126950;10482;34283;14638;48729;25120;83012
140015;201805;3306;10504;2967;10090;274;938;2427;8430;2701;9368
140017;201805;3572;11051;3161;10503;335;1036;2314;8095;2649;9131
140020;201805;4950;15399;4259;14461;353;1434;3248;11049;3601;12483
140023;201805;2200;7018;1837;6485;229;868;1301;4654;1530;5522
140028;201805;2073;5487;1778;5099;171;568;1335;3718;1506;4286
140030;201805;4179;12087;3738;11530;347;962;3013;9533;3360;10495
140040;201805;2042;8765;1893;8550;108;627;1659;7438;1767;8065
140045;201805;2570;9627;2201;9098;405;1656;1399;6130;1804;7786
140047;201805;5962;17998;5095;16642;939;3140;3056;10281;3995;13421
140050;201805;1394;4236;1193;3938;131;439;836;2785;967;3224
140060;201805;1432;4120;1266;3875;95;278;1039;3230;1134;3508
140070;201805;1790;9682;1729;9511;155;1070;1336;7277;1491;8347
150010;201805;41106;109020;37811;104591;1376;4363;32983;90531;34359;94894
150013;201805;1860;5085;1557;4744;151;382;1161;3744;1312;4126
150020;201805;13357;42590;12646;41635;1243;3222;10513;35892;11756;39114
150030;201805;8731;33620;7998;32699;394;1798;7026;28961;7420;30759
150034;201805;4184;11186;3581;10363;267;773;2896;8486;3163;9259
150040;201805;13700;39454;11862;37349;1047;2442;9877;32861;10924;35303
150050;201805;6576;23877;6112;23203;138;693;5584;21313;5722;22006
150060;201805;19706;57085;16747;52704;3417;10706;9653;31509;13070;42215
150070;201805;6374;24911;5673;24093;172;924;5207;22345;5379;23269
150080;201805;81530;202643;68285;184949;15881;44178;27485;82695;43366;126873
150085;201805;6205;19905;5733;19319;228;696;5257;17946;5485;18642
150090;201805;10048;38217;9501;37286;681;2908;7639;30197;8320;33105
150095;201805;5491;17199;4928;16420;303;910;4057;13915;4360;14825
150100;201805;3127;11084;2774;10453;207;788;2132;8087;2339;8875
150110;201805;3888;17567;3787;17434;216;1057;3395;15764;3611;16821
150120;201805;7072;24204;6862;23898;318;922;6065;21718;6383;22640
150125;201805;756;2118;612;1931;115;407;365;1137;480;1544
150130;201805;22892;67651;20173;63681;2656;7489;14439;47429;17095;54918
150140;201805;195623;500035;171013;466547;26218;70183;107958;304221;134176;374404
150145;201805;4601;13962;4006;13143;710;2042;2836;9835;3546;11877
150150;201805;14225;39291;12727;37362;1079;3344;9803;29074;10882;32418
150157;201805;3168;9168;2666;8492;293;1021;1849;6032;2142;7053
150160;201805;2949;9209;2757;8881;677;2158;1533;5091;2210;7249
150170;201805;24121;80898;21115;76047;3695;12803;13042;49989;16737;62792
150172;201805;3951;11864;3263;10846;307;934;2388;8231;2695;9165
150175;201805;1739;5377;1532;5030;177;644;1066;3573;1243;4217
150178;201805;10148;29196;8508;27260;487;1543;6956;22854;7443;24397
150180;201805;20540;77638;19066;75757;1024;4277;16545;66718;17569;70995
150190;201805;7043;24015;6644;23498;228;1020;5939;21018;6167;22038
150195;201805;5455;17494;5168;17048;98;399;4772;15715;4870;16114
150200;201805;5350;16427;4914;15941;63;194;4656;15234;4719;15428
150210;201805;24887;90469;23542;88693;1978;7235;19017;74140;20995;81375
150215;201805;7248;22177;6314;20757;1844;6066;2796;9735;4640;15801
150220;201805;11042;33581;9832;31718;1692;5361;5802;19359;7494;24720
150230;201805;12432;36504;10757;34255;1453;4446;7335;24493;8788;28939
150240;201805;32587;94282;26953;84245;8908;28366;6961;22507;15869;50873
150250;201805;4179;16986;3972;16689;606;2567;2953;12674;3559;15241
150260;201805;2421;8550;2259;8287;222;803;1690;6291;1912;7094
150270;201805;8256;24092;6102;20965;1929;6879;2239;8123;4168;15002
150275;201805;6313;21480;5861;20786;348;1319;4843;17208;5191;18527
150276;201805;2248;6367;1938;5988;268;780;1402;4564;1670;5344
150277;201805;4975;13947;4164;12981;417;1184;3202;10481;3619;11665
150280;201805;6283;26819;6101;26462;540;2305;4964;21842;5504;24147
150285;201805;3191;11649;2869;11166;326;1381;1983;7874;2309;9255
150290;201805;10866;29495;10010;28565;481;1059;8887;26120;9368;27179
150293;201805;9953;24981;7193;21309;1687;5088;3218;10485;4905;15573
150295;201805;7752;21200;5962;19050;2001;6649;2381;8500;4382;15149
150300;201805;2102;6776;1906;6503;59;294;1636;5541;1695;5835
150304;201805;3970;12638;3438;11752;588;1932;2221;7848;2809;9780
150307;201805;6365;20792;5947;20152;423;1343;4901;16883;5324;18226
150309;201805;5986;19401;5065;17824;1257;4264;2469;9327;3726;13591
150310;201805;7112;28280;6741;27799;266;1403;5900;24558;6166;25961
150320;201805;9383;25346;8553;24252;495;1480;6844;19439;7339;20919
150330;201805;14131;46649;13100;45007;1716;5936;9541;33697;11257;39633
150340;201805;2697;8029;2423;7632;318;967;1706;5483;2024;6450
150345;201805;7594;23228;6876;22283;479;1637;5709;18688;6188;20325
150350;201805;8607;24153;7956;23335;810;1799;6510;19824;7320;21623
150360;201805;23107;66752;18935;61533;2330;6945;13147;44822;15477;51767
150370;201805;9621;32810;8450;31204;852;3001;6268;24108;7120;27109
150375;201805;3207;13529;2923;13092;280;1321;2355;10705;2635;12026
150380;201805;10004;27591;8484;25535;369;1127;7225;22002;7594;23129
150390;201805;7721;32609;7082;31505;1132;4800;4804;22399;5936;27199
150400;201805;6216;23135;5942;22605;349;1366;4940;18923;5289;20289
150405;201805;9050;24822;8030;23573;557;1279;6434;19674;6991;20953
150410;201805;1782;6118;1573;5741;224;792;997;3751;1221;4543
150420;201805;34578;106831;27062;95124;9180;33709;7268;29543;16448;63252
150430;201805;7985;24977;7495;24285;771;2153;5904;19790;6675;21943
150440;201805;5653;18677;5320;18190;423;1322;4329;15063;4752;16385
150442;201805;23545;62655;20029;57701;2647;7433;12786;38122;15433;45555
150445;201805;5821;19032;5269;18161;286;978;4372;15262;4658;16240
150450;201805;4790;21508;4530;21124;377;1843;3782;17847;4159;19690
150460;201805;7984;27025;7439;26309;233;953;6469;23611;6702;24564
150470;201805;18269;53190;17216;51950;1032;2796;15116;46238;16148;49034
150475;201805;4265;14313;3852;13678;212;789;3178;11486;3390;12275
150480;201805;13895;46841;12468;44604;1951;6759;8696;32440;10647;39199
150490;201805;7743;28113;7320;27572;232;1127;6524;24629;6756;25756
150495;201805;5097;18290;4942;18089;112;477;4589;16868;4701;17345
150497;201805;2717;9214;2231;8308;596;2310;1030;4037;1626;6347
150500;201805;3309;8754;2946;8209;340;862;2255;6344;2595;7206
150503;201805;4126;11955;3132;10528;1010;3464;1169;4305;2179;7769
150506;201805;9894;32980;8871;31511;1922;6280;5630;21471;7552;27751
150510;201805;10001;37415;8765;34984;1284;4967;5690;23939;6974;28906
150520;201805;7163;27380;6950;27116;193;913;6472;25329;6665;26242
150530;201805;12274;42164;10795;39867;1433;4503;7833;30389;9266;34892
150540;201805;4792;13775;4142;12812;182;564;3505;10836;3687;11400
150543;201805;6592;18699;5496;17250;869;2765;3721;12299;4590;15064
150548;201805;9742;30842;8884;29749;325;1007;8046;27193;8371;28200
150549;201805;2009;6275;1776;5992;58;230;1578;5318;1636;5548
150550;201805;19029;59202;16320;54651;4417;14909;6850;24282;11267;39191
150553;201805;22670;72984;18187;64420;6371;23370;4957;19226;11328;42596
150555;201805;1771;5083;1435;4543;96;316;1025;3220;1121;3536
150560;201805;1823;5810;1625;5415;303;954;898;3098;1201;4052
150563;201805;2438;7911;2179;7453;470;1750;1169;3961;1639;5711
150565;201805;4067;13598;3651;12907;104;525;3057;10833;3161;11358
150570;201805;6102;21033;5859;20636;349;1355;4827;16992;5176;18347
150580;201805;10239;41933;9319;40893;647;3149;7740;34692;8387;37841
150590;201805;6902;25877;6378;25182;199;1054;5817;22907;6016;23961
150600;201805;8597;31004;8032;30269;217;962;7315;27725;7532;28687
150610;201805;2516;8113;2287;7665;152;570;1818;6021;1970;6591
150611;201805;2866;9009;2645;8652;117;466;2254;7311;2371;7777
150613;201805;12860;36646;9841;31528;2111;6986;4384;14453;6495;21439
150616;201805;3234;9286;2431;7914;586;2076;819;2546;1405;4622
150618;201805;6586;20741;5552;18977;922;3163;3283;11700;4205;14863
150619;201805;5701;17548;4836;16215;298;1110;3767;12645;4065;13755
150620;201805;6322;21709;5577;20695;797;2928;3967;15089;4764;18017
150630;201805;6200;17280;5744;16731;347;1027;4949;14545;5296;15572
150635;201805;4189;12696;3660;11762;707;2316;1952;6388;2659;8704
150640;201805;2172;6325;2005;6133;41;132;1868;5789;1909;5921
150650;201805;11525;33757;10237;31497;3110;9228;4276;14074;7386;23302
150655;201805;5549;16687;5112;15977;255;781;4319;13550;4574;14331
150658;201805;4419;12833;3665;11748;707;2391;2155;7227;2862;9618
150660;201805;5808;17113;5226;16296;591;1813;3584;11379;4175;13192
150670;201805;7882;19669;6290;17784;602;1508;4950;14517;5552;16025
150680;201805;65325;203866;51010;180736;13056;46198;21783;86262;34839;132460
150690;201805;2322;6337;2056;5967;126;341;1715;5024;1841;5365
150700;201805;6229;19051;5666;18336;498;1511;4371;14548;4869;16059
150710;201805;3973;13367;3626;12798;275;1056;2757;9780;3032;10836
150715;201805;5088;15785;4399;14698;348;1119;3504;11887;3852;13006
150720;201805;6337;24557;5990;23930;439;1974;4884;19635;5323;21609
150730;201805;10979;35504;9727;33534;1083;3882;7278;25611;8361;29493
150740;201805;3628;10921;3215;10189;477;1431;2099;6785;2576;8216
150745;201805;4915;14881;4188;13853;874;3067;2654;8845;3528;11912
150746;201805;1487;4861;1387;4692;91;294;1112;3817;1203;4111
150747;201805;5151;16419;4542;15515;865;2667;2843;10392;3708;13059
150750;201805;3625;11502;3134;10772;208;805;2438;8550;2646;9355
150760;201805;11675;35368;10691;34131;1338;4066;7903;25875;9241;29941
150770;201805;6121;22777;5870;22427;160;485;5448;21366;5608;21851
150775;201805;945;2789;774;2519;146;555;418;1335;564;1890
150780;201805;4359;13354;4060;13001;90;312;3775;12185;3865;12497
150790;201805;5379;16390;4737;15677;255;710;3908;13968;4163;14678
150795;201805;14058;45577;12708;43325;3121;10136;7021;25414;10142;35550
150796;201805;3425;9343;2990;8820;207;628;2439;7296;2646;7924
150797;201805;3919;12678;3406;11858;128;420;2840;10001;2968;10421
150800;201805;13112;42378;12048;41064;1864;5803;8749;31257;10613;37060
150803;201805;6628;23203;6233;22562;477;1770;5093;18535;5570;20305
150805;201805;3014;10110;2655;9519;279;982;2023;7367;2302;8349
150808;201805;5843;17942;4443;15410;1629;6145;546;2080;2175;8225
150810;201805;19669;56292;15541;51118;2882;9292;8979;31890;11861;41182
150812;201805;5299;15720;4754;14752;496;1686;3488;10592;3984;12278
150815;201805;8781;27900;7636;26446;763;2630;5925;20961;6688;23591
150820;201805;11698;32725;10049;30772;950;2590;7790;24692;8740;27282
150830;201805;11791;44685;11171;43904;396;2116;9597;38561;9993;40677
150835;201805;2158;7503;1977;7166;425;1561;1022;3791;1447;5352
150840;201805;7503;22288;6024;19660;1268;4353;2874;9435;4142;13788
160005;201805;1150;3297;1055;3148;22;106;991;2912;1013;3018
160010;201805;1799;5315;1760;5275;11;41;1722;5158;1733;5199
160015;201805;2224;7414;2052;7177;103;351;1852;6550;1955;6901
160020;201805;1939;6824;1750;6547;240;907;1299;4927;1539;5834
160021;201805;1114;4447;1038;4333;90;492;827;3406;917;3898
160023;201805;1219;4534;1112;4368;93;330;852;3519;945;3849
160025;201805;1641;4765;1605;4721;26;69;1555;4594;1581;4663
160027;201805;8643;24136;7880;23277;673;1758;6492;19837;7165;21595
160030;201805;55629;173327;46815;161347;10919;36081;24597;93037;35516;129118
160040;201805;5120;18316;4662;17690;106;600;4273;16185;4379;16785
160050;201805;3904;13177;3274;12244;1505;5387;1040;4665;2545;10052
160053;201805;3313;11428;3122;11183;421;1471;2343;8636;2764;10107
160055;201805;649;2338;639;2326;32;121;580;2128;612;2249
160060;201805;20909;60662;17726;57040;1233;3867;14319;47528;15552;51395
160070;201805;2965;11260;2701;10829;188;829;2168;8855;2356;9684
160080;201805;2772;9879;2616;9687;68;311;2389;8910;2457;9221
170025;201805;600;1702;465;1515;115;355;221;752;336;1107
170030;201805;1160;3713;940;3283;177;624;442;1595;619;2219
170035;201805;1460;3904;1107;3328;127;415;608;1861;735;2276
170040;201805;1804;5443;1497;5032;128;479;844;2990;972;3469
170070;201805;1637;4105;1171;3499;141;450;684;2087;825;2537
170100;201805;2429;7098;2014;6417;189;606;1374;4428;1563;5034
170105;201805;735;2226;526;1776;130;408;182;627;312;1035
170110;201805;899;2888;718;2533;129;466;334;1195;463;1661
170130;201805;1369;4230;1007;3507;189;695;490;1764;679;2459
170190;201805;1450;4203;1012;3483;343;1130;219;984;562;2114
170200;201805;1719;4452;1047;3243;271;921;222;656;493;1577
170210;201805;26819;74986;20485;64444;6959;23861;2412;8542;9371;32403
170215;201805;1334;3764;1116;3454;77;301;812;2492;889;2793
170220;201805;5781;18564;5003;17074;1243;4097;2454;8916;3697;13013
170230;201805;1260;3904;975;3322;259;911;240;831;499;1742
170240;201805;2679;7730;2103;6788;188;759;1412;4465;1600;5224
170255;201805;3929;11862;2744;9543;615;2254;1138;4048;1753;6302
170270;201805;1039;2526;676;2020;30;86;446;1311;476;1397
170290;201805;2970;8543;2543;8052;144;361;2104;6962;2248;7323
170300;201805;1921;5565;1574;5017;187;594;999;3259;1186;3853
170305;201805;739;2192;575;1859;81;303;282;893;363;1196
170307;201805;955;3358;776;2985;137;536;395;1556;532;2092
170310;201805;1497;4093;1079;3363;205;702;515;1589;720;2291
170320;201805;1009;2771;753;2353;106;334;416;1327;522;1661
170330;201805;828;2639;746;2512;45;193;582;1912;627;2105
170360;201805;461;1344;350;1152;57;217;207;637;264;854
170370;201805;1331;3634;985;3060;190;597;435;1385;625;1982
170380;201805;1797;5503;1371;4814;153;611;776;2765;929;3376
170382;201805;562;1734;462;1555;72;258;283;947;355;1205
170384;201805;1502;5790;1283;5344;363;1573;516;2157;879;3730
170386;201805;759;2174;480;1608;73;284;115;347;188;631
170388;201805;583;1727;423;1441;57;215;199;671;256;886
170389;201805;1156;3946;1000;3667;45;197;791;2940;836;3137
170390;201805;1525;3844;1143;3369;79;233;885;2678;964;2911
170410;201805;543;1653;401;1400;24;109;259;890;283;999
170460;201805;392;1086;306;938;38;129;186;570;224;699
170510;201805;847;2659;634;2228;63;279;351;1181;414;1460
170550;201805;6570;18037;4637;14706;1340;4553;779;2628;2119;7181
170555;201805;1333;3786;1057;3344;88;297;566;1844;654;2141
170560;201805;1088;3145;801;2748;105;393;437;1673;542;2066
170600;201805;1400;3920;1126;3509;263;720;612;2056;875;2776
170610;201805;1701;4842;1275;4111;93;368;808;2546;901;2914
170625;201805;426;1188;267;843;29;86;85;250;114;336
170650;201805;1240;3827;951;3304;206;734;389;1442;595;2176
170700;201805;3530;10625;2719;9164;605;2223;1098;3788;1703;6011
170710;201805;1600;4465;1246;3828;221;740;636;1889;857;2629
170720;201805;1933;4993;1563;4434;71;143;1324;3870;1395;4013
170730;201805;1010;2920;771;2530;193;658;334;1137;527;1795
170740;201805;1997;7118;1713;6551;208;821;1128;4337;1336;5158
170755;201805;858;2554;621;2088;73;278;303;1009;376;1287
170765;201805;1251;3319;867;2726;215;694;337;1138;552;1832
170770;201805;1723;5480;1505;5101;197;667;986;3393;1183;4060
170820;201805;3811;13241;3327;12329;472;1697;1954;7670;2426;9367
170825;201805;991;2391;794;2123;74;208;541;1454;615;1662
170830;201805;1410;3922;1156;3517;37;118;947;2898;984;3016
170900;201805;2650;8845;2305;8292;194;763;1808;6577;2002;7340
170930;201805;3743;10658;3004;9366;692;2299;1242;3947;1934;6246
170950;201805;11734;33577;8259;27285;2365;8813;1173;4059;3538;12872
170980;201805;446;1296;360;1148;29;126;227;684;256;810
171050;201805;1563;5070;1392;4765;66;309;1087;3674;1153;3983
171070;201805;1373;4121;1187;3839;232;691;709;2493;941;3184
171090;201805;1079;2733;892;2468;61;147;646;1788;707;1935
171110;201805;573;1643;422;1375;100;363;171;496;271;859
171150;201805;1088;2822;660;2060;73;273;410;1262;483;1535
171180;201805;723;2085;482;1585;87;300;195;668;282;968
171190;201805;1568;5663;1388;5322;228;881;798;3185;1026;4066
171195;201805;846;2845;705;2573;139;536;385;1429;524;1965
171200;201805;553;1650;421;1413;97;361;163;521;260;882
171215;201805;429;1224;321;1020;64;215;153;476;217;691
171240;201805;738;2573;617;2328;51;264;387;1458;438;1722
171245;201805;616;1968;480;1674;71;271;235;781;306;1052
171250;201805;1036;2862;772;2422;229;757;331;1045;560;1802
171270;201805;385;1505;329;1371;87;346;146;677;233;1023
171280;201805;834;2618;659;2300;143;479;294;1129;437;1608
171320;201805;3918;11329;3071;9818;591;1893;1366;4597;1957;6490
171330;201805;2696;7616;2086;6538;455;1433;1010;3276;1465;4709
171360;201805;1445;4437;1226;4126;86;336;949;3216;1035;3552
171370;201805;692;1835;539;1618;51;158;376;1137;427;1295
171380;201805;1370;4028;1109;3601;146;525;672;2183;818;2708
171395;201805;924;2738;647;2168;92;363;317;1027;409;1390
171420;201805;1815;5677;1352;4703;213;829;616;2130;829;2959
171430;201805;1037;3128;843;2748;96;348;560;1760;656;2108
171488;201805;2442;7338;1957;6550;322;1120;1047;3606;1369;4726
171500;201805;934;2520;716;2178;52;158;528;1621;580;1779
171510;201805;793;2745;713;2593;47;215;505;1841;552;2056
171515;201805;484;1350;354;1126;30;110;214;664;244;774
171525;201805;614;1903;512;1723;40;188;317;992;357;1180
171550;201805;329;1017;237;855;43;172;121;428;164;600
171570;201805;1175;3649;994;3310;188;610;580;2014;768;2624
171575;201805;1869;5061;1210;3846;198;667;509;1587;707;2254
171610;201805;5613;16305;4227;13920;1015;3645;1162;4039;2177;7684
171620;201805;2817;7942;2363;7315;141;528;1893;5905;2034;6433
171630;201805;981;2772;803;2519;157;532;484;1547;641;2079
171650;201805;2126;6337;1560;5252;379;1324;497;1767;876;3091
171660;201805;2378;6317;1653;5014;277;833;848;2587;1125;3420
171665;201805;1320;3836;1023;3363;197;705;472;1580;669;2285
171670;201805;1838;5038;1423;4369;225;769;749;2272;974;3041
171700;201805;1180;3537;887;3009;135;438;474;1633;609;2071
171720;201805;821;2227;645;1932;57;210;465;1384;522;1594
171750;201805;1213;3565;866;2914;233;804;162;622;395;1426
171780;201805;1283;3349;925;2831;73;255;624;1889;697;2144
171790;201805;1442;4983;1164;4358;262;969;517;2034;779;3003
171800;201805;741;2148;576;1896;80;279;324;1076;404;1355
171820;201805;10463;30625;8015;26329;1915;6654;2692;9385;4607;16039
171830;201805;1447;5097;1239;4665;188;789;714;2676;902;3465
171840;201805;695;1896;565;1693;31;108;422;1236;453;1344
171845;201805;644;1720;490;1495;70;249;263;821;333;1070
171850;201805;862;3028;741;2776;75;330;502;1854;577;2184
171855;201805;1086;3390;950;3145;89;293;610;2008;699;2301
171865;201805;393;1311;335;1212;59;229;166;580;225;809
171870;201805;759;2203;560;1815;75;265;298;1006;373;1271
171875;201805;1240;3803;993;3394;60;242;728;2462;788;2704
171880;201805;1019;3352;922;3229;44;159;760;2722;804;2881
171884;201805;905;2420;657;2040;125;445;215;743;340;1188
171886;201805;1448;4219;1028;3467;303;1087;193;671;496;1758
171888;201805;761;2205;523;1741;48;160;314;1050;362;1210
171889;201805;463;1449;397;1316;77;286;175;580;252;866
171890;201805;1165;3307;889;2852;166;503;517;1694;683;2197
171900;201805;503;1794;376;1478;95;375;137;571;232;946
172000;201805;583;1821;481;1623;70;279;254;820;324;1099
172010;201805;1056;3752;923;3473;81;400;597;2165;678;2565
172015;201805;331;1251;265;1115;51;206;118;512;169;718
172020;201805;2304;7443;2117;7151;183;746;1586;5341;1769;6087
172025;201805;726;2082;528;1758;48;190;330;1107;378;1297
172030;201805;1238;3736;1069;3468;24;110;872;2823;896;2933
172049;201805;1370;3397;890;2649;311;966;392;1186;703;2152
172065;201805;1442;3723;1156;3376;64;157;1031;3080;1095;3237
172080;201805;2357;7207;1924;6394;135;486;1320;4415;1455;4901
172085;201805;470;1328;309;991;50;139;88;272;138;411
172090;201805;4008;10558;3123;9315;147;528;2466;7296;2613;7824
172093;201805;511;1537;379;1292;53;231;194;622;247;853
172097;201805;633;1754;465;1485;71;238;209;687;280;925
172100;201805;42935;113110;29683;91172;6658;22290;8786;28214;15444;50504
172110;201805;1594;6040;1393;5719;140;598;1051;4481;1191;5079
172120;201805;4925;15165;3889;13462;671;2336;2007;7192;2678;9528
172125;201805;293;849;212;710;28;99;117;396;145;495
172130;201805;792;2396;651;2156;23;78;487;1630;510;1708
172208;201805;2390;6316;1914;5641;277;768;1181;3588;1458;4356
172210;201805;2722;7478;2115;6651;438;1436;1126;3581;1564;5017
210005;201805;19734;59608;16048;53678;4696;16315;6224;21887;10920;38202
210010;201805;1763;5838;1600;5568;46;193;1406;4916;1452;5109
210015;201805;3328;10219;2964;9698;137;360;2531;8474;2668;8834
210020;201805;7479;17131;6674;16219;92;236;6224;15105;6316;15341
210030;201805;4896;16385;4635;16021;233;1097;3988;13645;4221;14742
210040;201805;2284;6221;2073;5981;34;65;1942;5679;1976;5744
210043;201805;6708;18085;5524;16730;691;1951;3953;12649;4644;14600
210047;201805;6447;21998;5737;20991;246;1176;4981;18129;5227;19305
210050;201805;2175;7733;1742;6904;256;1106;1078;4316;1334;5422
210055;201805;1780;6001;1639;5764;67;274;1341;4706;1408;4980
210060;201805;6714;26105;6102;24893;814;3428;4231;17696;5045;21124
210070;201805;7272;20939;6846;20434;40;118;6584;19804;6624;19922
210080;201805;3821;13587;3730;13475;19;83;3637;13181;3656;13264
210083;201805;5139;16044;4468;15316;80;425;4231;14433;4311;14858
210087;201805;2882;8305;2590;7903;153;423;2166;6774;2319;7197
210090;201805;9584;30148;9133;29408;270;993;8316;26652;8586;27645
210095;201805;5993;20600;5601;20101;265;1093;4905;17728;5170;18821
210100;201805;6853;20725;6324;19973;241;905;5388;17039;5629;17944
210110;201805;2771;9061;2622;8859;32;148;2463;8318;2495;8466
210120;201805;23959;67221;20472;62818;2696;7055;13793;45187;16489;52242
210125;201805;3947;11645;3651;11269;689;1695;2700;8864;3389;10559
210130;201805;4125;11565;3583;10874;155;455;3066;9335;3221;9790
210135;201805;1462;4550;1310;4310;52;214;1087;3577;1139;3791
210140;201805;17257;50993;14108;46700;3006;9991;7706;26454;10712;36445
210150;201805;4553;11243;4082;10622;81;264;3667;9429;3748;9693
210160;201805;16220;49965;14822;47932;1346;4380;11085;36813;12431;41193
210170;201805;14219;47507;13550;46630;616;2230;12150;42002;12766;44232
210173;201805;2423;9180;2286;8963;52;308;2114;8275;2166;8583
210177;201805;3089;9259;2914;9049;68;157;2748;8663;2816;8820
210180;201805;1470;4183;1328;3988;33;115;1176;3515;1209;3630
210190;201805;4745;14515;4310;13722;108;544;3561;11083;3669;11627
210193;201805;1203;3759;1100;3596;44;170;908;2979;952;3149
210197;201805;2005;6660;1852;6464;187;623;1441;5179;1628;5802
210200;201805;7511;25137;6984;24353;647;2289;5599;19835;6246;22124
210203;201805;6968;21451;6414;20710;523;1610;5375;17652;5898;19262
210207;201805;3453;10382;3105;9905;159;442;2534;8308;2693;8750
210210;201805;8215;27442;7776;26835;91;520;7248;24982;7339;25502
210215;201805;1991;6803;1828;6576;62;313;1625;5817;1687;6130
210220;201805;5918;21350;5609;20816;233;1270;4885;17864;5118;19134
210230;201805;5031;15872;4639;15303;211;609;4123;13757;4334;14366
210232;201805;11488;37138;9545;34408;1408;5271;6246;23854;7654;29125
210235;201805;3596;10896;3166;10347;112;473;2798;9163;2910;9636
210237;201805;2399;8740;2231;8533;21;111;2136;8188;2157;8299
210240;201805;2722;8668;2514;8312;89;365;2179;7147;2268;7512
210250;201805;5462;17125;5035;16596;106;563;4510;14825;4616;15388
210255;201805;2631;8209;2302;7614;288;997;1582;5200;1870;6197
210260;201805;5129;16275;4618;15491;281;1013;3841;12927;4122;13940
210270;201805;4931;14094;4451;13439;91;441;3970;11885;4061;12326
210275;201805;3561;9144;3249;8775;57;108;3068;8409;3125;8517
210280;201805;5556;16550;4622;15121;230;1149;3392;10813;3622;11962
210290;201805;6461;19290;5975;18689;142;513;5389;16883;5531;17396
210300;201805;35090;95617;29125;88052;1907;5872;21781;68725;23688;74597
210310;201805;3020;8001;2741;7626;65;133;2478;6952;2543;7085
210312;201805;2513;7020;2244;6700;59;226;2039;6062;2098;6288
210315;201805;2864;8306;2440;7798;76;200;2161;7115;2237;7315
210317;201805;3987;12778;3703;12450;107;475;3421;11457;3528;11932
210320;201805;19119;61455;17873;59822;518;2384;16117;53817;16635;56201
210325;201805;3505;10499;3099;9912;90;327;2751;8907;2841;9234
210330;201805;27934;77704;23053;71599;5720;16852;11609;41450;17329;58302
210340;201805;10541;32116;9513;30601;1009;3113;6920;23191;7929;26304
210350;201805;9384;28023;8422;26742;256;879;7289;23322;7545;24201
210355;201805;4049;14261;3580;13518;130;690;2998;11423;3128;12113
210360;201805;14623;44060;13162;41975;645;2542;10827;34325;11472;36867
210370;201805;10064;23337;8001;21135;262;549;7176;19421;7438;19970
210375;201805;3095;8886;2433;7988;661;2152;1155;4062;1816;6214
210380;201805;5518;15016;4988;14330;262;677;4306;12516;4568;13193
210390;201805;2667;9812;2498;9518;135;649;2080;7876;2215;8525
210400;201805;4687;14707;4301;14228;119;311;3954;13278;4073;13589
210405;201805;7348;20395;5947;18370;1169;3438;3224;10587;4393;14025
210407;201805;1956;6777;1645;6173;131;588;1273;4695;1404;5283
210408;201805;2375;9241;2252;9069;144;724;1851;7558;1995;8282
210409;201805;3674;13067;3384;12652;111;632;2898;10820;3009;11452
210410;201805;3554;11254;3148;10608;230;763;2423;8338;2653;9101
210420;201805;4071;13178;3679;12486;163;535;3117;10688;3280;11223
210430;201805;2207;6581;2083;6436;114;300;1830;5735;1944;6035
210440;201805;4140;11909;3864;11539;81;249;3636;10893;3717;11142
210450;201805;2529;7981;2263;7542;128;480;1825;6049;1953;6529
210455;201805;3813;10519;3165;9739;747;2241;1909;6105;2656;8346
210460;201805;3365;10533;3052;10082;118;470;2614;8627;2732;9097
210462;201805;1465;4989;1311;4697;52;253;1069;3784;1121;4037
210465;201805;2609;7957;2295;7517;87;280;1982;6550;2069;6830
210467;201805;5945;19721;5476;19153;284;1163;4799;16859;5083;18022
210470;201805;2117;5598;1466;4653;78;191;1112;3637;1190;3828
210480;201805;15244;47124;13006;44245;1498;4900;9385;33845;10883;38745
210490;201805;3741;9857;3099;8941;70;249;2718;7823;2788;8072
210500;201805;6156;25030;5809;24377;399;1997;4681;19495;5080;21492
210510;201805;6053;20927;5610;20394;132;580;5045;18596;5177;19176
210515;201805;3598;10986;3253;10621;127;386;2931;9738;3058;10124
210520;201805;2585;7549;2309;7191;98;338;2039;6375;2137;6713
210530;201805;49344;131546;40705;118343;6890;24863;11802;41560;18692;66423
210535;201805;3117;10752;2972;10543;88;333;2635;9431;2723;9764
210540;201805;13873;43154;11979;40622;1462;4879;8526;30034;9988;34913
210542;201805;6060;15715;5184;14739;271;523;4607;13547;4878;14070
210545;201805;2311;7264;2164;7031;48;218;1925;6178;1973;6396
210547;201805;3562;12840;3254;12255;327;1182;2370;9221;2697;10403
210550;201805;5849;17822;5052;16838;303;1052;4220;14345;4523;15397
210560;201805;3619;11276;3269;10668;109;381;2811;9110;2920;9491
210565;201805;1417;5036;1208;4706;45;237;977;3862;1022;4099
210570;201805;11142;30993;10126;29782;330;826;9231;27484;9561;28310
210580;201805;2954;8349;2593;7909;232;439;2086;6733;2318;7172
210590;201805;4079;12682;3677;12159;127;627;3246;10630;3373;11257
210592;201805;2551;7787;2402;7539;30;167;2134;6619;2164;6786
210594;201805;2739;7562;2151;6640;87;224;1590;5099;1677;5323
210596;201805;2431;8953;2253;8582;170;712;1759;6747;1929;7459
210598;201805;1791;5317;1679;5167;32;131;1556;4772;1588;4903
210600;201805;2999;8431;2520;7765;82;230;2048;6368;2130;6598
210610;201805;2465;7699;2231;7404;86;393;1971;6463;2057;6856
210620;201805;2283;6932;2008;6597;42;119;1848;6194;1890;6313
210630;201805;3168;11074;2878;10644;166;798;2350;8589;2516;9387
210632;201805;4278;14479;3884;13883;345;1400;3025;10779;3370;12179
210635;201805;1830;6426;1722;6242;133;442;1430;5326;1563;5768
210637;201805;2460;8445;2216;8070;143;665;1705;6247;1848;6912
210640;201805;4950;19593;4876;19515;34;130;4787;19228;4821;19358
210650;201805;7093;20831;6714;20325;78;287;6385;19309;6463;19596
210660;201805;8698;25253;7765;23861;335;1191;6673;20389;7008;21580
210663;201805;2541;7791;2416;7647;120;326;2132;6928;2252;7254
210667;201805;1891;6283;1771;6097;65;271;1582;5484;1647;5755
210670;201805;4470;15794;4190;15345;147;695;3668;13390;3815;14085
210675;201805;5057;14014;4481;13253;327;790;3733;11420;4060;12210
210680;201805;4051;10605;3432;9842;145;287;3019;8886;3164;9173
210690;201805;7414;24515;6812;23871;246;999;6034;21520;6280;22519
210700;201805;2793;7765;2356;7224;160;375;1855;6189;2015;6564
210710;201805;4836;15626;4427;15036;143;663;3888;13128;4031;13791
210720;201805;2749;9357;2586;9145;57;307;2371;8318;2428;8625
210725;201805;1252;4454;1121;4225;44;199;803;3124;847;3323
210730;201805;1213;3388;1035;3138;74;213;811;2489;885;2702
210735;201805;4532;14073;3974;13245;319;1116;3276;11059;3595;12175
210740;201805;5269;14735;4752;14203;154;585;4210;12517;4364;13102
210745;201805;4569;13026;4336;12731;153;374;3928;11645;4081;12019
210750;201805;20083;52753;17399;49593;1506;4237;13225;38605;14731;42842
210760;201805;5589;16100;5091;15561;24;79;4938;15151;4962;15230
210770;201805;5917;16008;5120;15101;58;243;4721;13948;4779;14191
210780;201805;7161;23930;6503;22806;636;2080;4933;17740;5569;19820
210790;201805;4583;14673;4269;14270;142;416;3496;12352;3638;12768
210800;201805;4965;13519;4344;12725;69;276;3967;11514;4036;11790
210805;201805;3870;14773;3730;14555;108;598;3348;13019;3456;13617
210810;201805;5068;15169;4657;14642;228;504;4062;13232;4290;13736
210820;201805;7146;20852;6186;19281;743;2311;4044;12852;4787;15163
210825;201805;6314;20296;5950;19831;260;843;5238;17753;5498;18596
210830;201805;7736;22406;7318;21880;461;1004;6368;19706;6829;20710
210840;201805;3374;9088;3048;8640;80;256;2671;7500;2751;7756
210845;201805;6036;17348;5767;17056;33;73;5698;16900;5731;16973
210850;201805;5728;20163;5115;19170;360;1634;3948;14793;4308;16427
210860;201805;18218;51403;15791;48153;846;2459;12924;40404;13770;42863
210870;201805;6192;18808;5446;17913;311;1057;4642;15390;4953;16447
210880;201805;4268;13619;3948;13241;221;874;3337;11179;3558;12053
210890;201805;4370;13327;3986;12868;255;636;3347;11275;3602;11911
210900;201805;4779;14080;3644;12039;1367;4847;673;2462;2040;7309
210905;201805;1899;5570;1639;5200;51;123;1451;4694;1502;4817
210910;201805;7474;23555;6490;21899;823;2901;4336;14680;5159;17581
210920;201805;3082;10569;2729;10088;100;519;2386;8759;2486;9278
210923;201805;1422;4602;1280;4376;78;319;976;3331;1054;3650
210927;201805;4974;16002;4493;15482;115;438;4112;14334;4227;14772
210930;201805;2409;8577;2222;8259;111;566;1778;6526;1889;7092
210940;201805;3556;11320;3361;11048;115;542;2971;9574;3086;10116
210945;201805;5949;18071;5606;17663;252;705;4975;15875;5227;16580
210950;201805;5137;15330;4064;13690;546;1670;2760;9734;3306;11404
210955;201805;1700;5460;1506;5155;146;479;1071;3754;1217;4233
210960;201805;8764;27414;7906;26169;1608;4904;4824;17122;6432;22026
210970;201805;1294;4290;1095;3932;85;393;808;2788;893;3181
210975;201805;1666;5563;1560;5371;124;465;1175;4027;1299;4492
210980;201805;10560;23844;9448;22709;165;342;8991;21780;9156;22122
210990;201805;15968;47747;13143;43951;1521;5178;8929;30570;10450;35748
211000;201805;14456;44622;12588;42501;635;2633;10395;35850;11030;38483
211003;201805;5131;17069;4463;16253;176;752;3795;14101;3971;14853
211010;201805;6366;23513;5918;22898;72;425;5454;21272;5526;21697
211020;201805;7931;25030;7451;24387;348;1318;6412;21063;6760;22381
211023;201805;2094;7021;1984;6864;107;415;1654;5683;1761;6098
211027;201805;2709;9600;2652;9503;200;774;2259;8076;2459;8850
211030;201805;3794;11023;3463;10628;276;637;2899;9172;3175;9809
211040;201805;4437;16386;4229;16070;135;761;3757;14209;3892;14970
211050;201805;9678;24820;8895;23859;190;500;8272;22213;8462;22713
211060;201805;6105;20457;5726;19903;197;816;5184;18024;5381;18840
211065;201805;2103;6230;1828;5848;61;198;1586;5171;1647;5369
211070;201805;7673;25765;6833;24415;503;1865;5382;19414;5885;21279
211080;201805;1314;3770;1093;3427;43;240;856;2526;899;2766
211085;201805;1995;6199;1800;5914;118;336;1504;5028;1622;5364
211090;201805;3295;9277;2981;8861;48;240;2683;7871;2731;8111
211100;201805;6390;16965;6099;16569;45;164;5729;15552;5774;15716
211102;201805;2875;10652;2669;10358;162;741;2307;8962;2469;9703
211105;201805;2335;7703;1980;7039;223;814;1361;4806;1584;5620
211107;201805;4462;14222;3959;13509;166;612;3259;11428;3425;12040
211110;201805;5952;17041;4668;15071;613;1813;3190;10695;3803;12508
211120;201805;35299;99185;32638;95969;4378;11873;24178;73469;28556;85342
211125;201805;1944;6081;1699;5680;62;256;1454;4863;1516;5119
211130;201805;184447;473185;171851;457189;24755;66942;78829;236362;103584;303304
211140;201805;4989;15644;4560;15026;230;742;3872;12816;4102;13558
211150;201805;9294;26578;8208;25196;290;1053;7045;21668;7335;22721
211153;201805;2592;7928;2205;7438;413;1458;1429;5018;1842;6476
211157;201805;1099;3559;927;3278;45;257;648;2290;693;2547
211160;201805;3923;12294;3257;11179;197;896;2364;7884;2561;8780
211163;201805;1728;5726;1601;5537;17;62;1510;5293;1527;5355
211167;201805;1526;4978;1439;4837;30;138;1350;4517;1380;4655
211170;201805;6008;15575;5722;15232;67;228;5456;14466;5523;14694
211172;201805;2456;6983;2162;6510;85;291;1795;5248;1880;5539
211174;201805;2753;8317;2545;8040;67;330;2298;7187;2365;7517
211176;201805;4019;12452;3342;11484;238;971;2555;8765;2793;9736
211178;201805;4579;10860;4052;10254;34;141;3830;9578;3864;9719
211180;201805;4047;13845;3791;13462;233;890;3211;11477;3444;12367
211190;201805;3028;9287;2656;8719;46;234;2314;7518;2360;7752
211195;201805;1372;4027;1163;3742;72;192;959;3186;1031;3378
211200;201805;2031;6299;1708;5865;180;648;1168;4099;1348;4747
211210;201805;6534;20143;6058;19480;275;981;5264;16987;5539;17968
211220;201805;34586;93573;29557;87316;3356;9913;21074;63969;24430;73882
211223;201805;4925;14611;4402;13808;497;1451;3217;10324;3714;11775
211227;201805;1666;5850;1540;5653;50;245;1328;4912;1378;5157
211230;201805;7217;22921;6584;21863;523;1750;5172;17244;5695;18994
211240;201805;8031;26705;7616;26178;165;899;6964;23667;7129;24566
211245;201805;6165;16960;5925;16716;57;110;5824;16503;5881;16613
211250;201805;13635;40748;12568;39462;506;1897;10993;34372;11499;36269
211260;201805;7604;25100;7006;24300;204;875;6365;22186;6569;23061
211270;201805;10214;33695;9018;32129;375;1822;7464;26810;7839;28632
211280;201805;13399;38302;12024;36532;833;2001;9802;30973;10635;32974
211285;201805;1668;5998;1477;5651;253;1001;744;2955;997;3956
211290;201805;6986;22421;6546;21811;218;896;5649;18805;5867;19701
211300;201805;8211;23760;7506;22833;80;223;7096;21720;7176;21943
211400;201805;11294;34330;9481;31599;1676;5570;5579;19952;7255;25522
220005;201805;1833;5067;1649;4785;38;154;1347;3809;1385;3963
220010;201805;1490;4261;1259;3863;30;127;997;3010;1027;3137
220020;201805;3243;9888;2947;9380;339;1128;2152;6800;2491;7928
220025;201805;2226;5275;1937;4852;35;100;1600;3910;1635;4010
220027;201805;1251;3337;1090;3116;31;97;886;2516;917;2613
220030;201805;3346;9141;3195;8908;109;316;2796;7695;2905;8011
220040;201805;6955;21333;6290;20091;1189;3714;3919;12720;5108;16434
220045;201805;1391;4461;1208;4115;40;202;959;3201;999;3403
220050;201805;4463;13036;3803;12027;136;592;3275;10252;3411;10844
220060;201805;2320;5226;1954;4799;29;66;1800;4407;1829;4473
220070;201805;2473;6669;2167;6202;85;221;1767;5027;1852;5248
220080;201805;663;1986;603;1891;26;110;510;1537;536;1647
220090;201805;1781;4417;1458;3965;14;49;1273;3466;1287;3515
220095;201805;669;1773;631;1722;10;22;585;1596;595;1618
220100;201805;1342;3876;1099;3435;54;208;870;2651;924;2859
220105;201805;2058;6492;1800;5963;140;471;1324;4408;1464;4879
220110;201805;3416;9640;3202;9262;53;233;2825;8044;2878;8277
220115;201805;2626;8290;2456;8019;81;350;2189;7041;2270;7391
220117;201805;1338;3380;1045;2939;19;70;885;2451;904;2521
220120;201805;11553;33868;10649;32721;130;535;9988;30646;10118;31181
220130;201805;1033;3006;879;2774;18;123;787;2422;805;2545
220140;201805;1798;4287;1544;3967;149;374;1295;3328;1444;3702
220150;201805;6553;19781;6153;19182;150;770;5323;16254;5473;17024
220155;201805;1097;3259;871;2842;22;96;603;1935;625;2031
220157;201805;1060;2682;893;2398;17;75;728;1893;745;1968
220160;201805;2640;7771;2297;7114;47;251;1894;5729;1941;5980
220170;201805;1388;3910;1182;3586;18;96;1036;3085;1054;3181
220173;201805;1970;5773;1600;5072;38;190;1303;3997;1341;4187
220177;201805;1852;5501;1803;5440;15;56;1749;5284;1764;5340
220180;201805;1160;2978;908;2504;10;43;662;1719;672;1762
220190;201805;5636;16031;4887;15000;416;1330;3695;11432;4111;12762
220191;201805;1391;4522;1297;4345;83;345;935;3053;1018;3398
220192;201805;1832;5091;1460;4425;30;118;1165;3466;1195;3584
220194;201805;1702;5043;1522;4738;72;274;1244;3792;1316;4066
220196;201805;1971;5481;1790;5168;51;208;1510;4275;1561;4483
220198;201805;1218;3569;1010;3280;7;26;949;3126;956;3152
220200;201805;4731;14653;4305;14082;329;1160;3446;11264;3775;12424
220202;201805;2172;6239;1866;5695;31;144;1571;4691;1602;4835
220205;201805;2557;7133;2266;6680;41;171;1967;5703;2008;5874
220207;201805;822;2506;696;2282;56;213;472;1533;528;1746
220208;201805;1708;5406;1398;4767;287;1067;636;2148;923;3215
220209;201805;1617;4711;1389;4312;29;131;1122;3458;1151;3589
220210;201805;1587;4222;1361;3833;27;121;1105;3006;1132;3127
220211;201805;1515;4141;1424;4017;19;79;1253;3540;1272;3619
220213;201805;1713;4743;1507;4341;24;98;1243;3483;1267;3581
220217;201805;1962;6184;1875;6074;41;177;1743;5674;1784;5851
220220;201805;10215;27537;8679;25138;537;1435;6362;18799;6899;20234
220225;201805;1140;3073;927;2797;13;50;805;2390;818;2440
220230;201805;5680;14470;4936;13477;180;491;4280;11709;4460;12200
220240;201805;2893;8694;2661;8262;87;318;2196;6795;2283;7113
220245;201805;1562;4022;1255;3616;12;44;1121;3294;1133;3338
220250;201805;2810;8345;2476;7894;38;171;2207;7018;2245;7189
220253;201805;1666;4650;1398;4175;91;279;1128;3300;1219;3579
220255;201805;1861;4733;1569;4279;24;131;1315;3422;1339;3553
220260;201805;4250;13476;3750;12586;191;695;2971;9965;3162;10660
220265;201805;1231;4148;1122;3978;58;256;866;3029;924;3285
220270;201805;6541;20939;6162;20256;331;1366;5075;16210;5406;17576
220271;201805;1484;3956;1285;3659;45;163;1097;3114;1142;3277
220272;201805;1705;4982;1517;4629;39;143;1173;3498;1212;3641
220273;201805;1179;3440;1009;3116;33;131;789;2402;822;2533
220275;201805;2218;5455;1708;4775;40;144;1476;4098;1516;4242
220277;201805;2122;5621;1842;5180;33;112;1545;4258;1578;4370
220280;201805;1562;4023;1326;3643;47;159;1089;2889;1136;3048
220285;201805;1512;3964;1271;3653;18;71;1138;3245;1156;3316
220290;201805;5920;18345;4884;16861;383;1496;3534;12201;3917;13697
220300;201805;1873;5872;1587;5444;42;258;1315;4416;1357;4674
220310;201805;2742;8138;2277;7603;45;232;1952;6426;1997;6658
220320;201805;2868;8666;2329;7630;134;543;1777;5709;1911;6252
220323;201805;1589;5151;1286;4659;85;365;1011;3633;1096;3998
220325;201805;1239;3776;1045;3408;44;182;838;2713;882;2895
220327;201805;1386;4203;1231;3933;42;209;1029;3189;1071;3398
220330;201805;4020;10436;3396;9604;139;416;2816;7927;2955;8343
220335;201805;1745;5357;1561;5144;29;81;1440;4784;1469;4865
220340;201805;1805;4881;1455;4289;60;208;1028;2926;1088;3134
220342;201805;1145;3546;1036;3376;38;149;834;2725;872;2874
220345;201805;3016;7130;2462;6364;13;34;2334;6026;2347;6060
220350;201805;3483;9205;2822;8131;155;513;2088;5909;2243;6422
220360;201805;1237;3211;1000;2839;22;67;797;2236;819;2303
220370;201805;9004;25712;8155;24522;208;858;7240;21540;7448;22398
220375;201805;1424;4453;1323;4308;6;18;1287;4200;1293;4218
220380;201805;1511;3749;1248;3375;36;118;1073;2845;1109;2963
220385;201805;812;2014;635;1700;9;33;543;1418;552;1451
220390;201805;8597;24841;7247;22471;1850;5678;3026;9962;4876;15640
220400;201805;1491;3687;1138;3119;24;87;879;2318;903;2405
220410;201805;1168;3328;970;2999;57;175;774;2357;831;2532
220415;201805;822;2232;711;2048;24;77;539;1520;563;1597
220420;201805;2000;5681;1630;4960;64;208;1238;3691;1302;3899
220430;201805;2460;6714;2390;6621;75;223;2157;5940;2232;6163
220435;201805;1701;4727;1515;4434;56;199;1183;3387;1239;3586
220440;201805;2448;7887;2152;7401;136;534;1750;5919;1886;6453
220450;201805;2230;6312;1846;5786;232;823;1340;4181;1572;5004
220455;201805;1316;4164;1245;4068;28;132;1106;3586;1134;3718
220460;201805;946;2445;854;2338;45;137;739;1985;784;2122
220465;201805;2345;7486;2106;7116;146;548;1623;5495;1769;6043
220470;201805;3555;10230;3180;9620;106;357;2574;7668;2680;8025
220480;201805;2432;6663;1981;5912;152;393;1440;4250;1592;4643
220490;201805;2327;6211;2122;5963;36;153;1895;5260;1931;5413
220500;201805;2715;7336;2438;6876;59;245;1981;5398;2040;5643
220510;201805;2681;7857;2189;6974;82;255;1687;5408;1769;5663
220515;201805;1710;4167;1522;3912;45;100;1349;3468;1394;3568
220520;201805;5005;13275;4558;12641;89;259;4116;11413;4205;11672
220525;201805;1235;3378;1122;3223;11;45;995;2821;1006;2866
220527;201805;1294;3784;1143;3518;29;102;959;2968;988;3070
220530;201805;1216;3400;1096;3219;27;110;1012;2918;1039;3028
220535;201805;805;2302;743;2220;50;148;596;1782;646;1930
220540;201805;3328;10605;3140;10284;99;422;2740;8916;2839;9338
220545;201805;1357;4360;1268;4186;82;328;1038;3364;1120;3692
220550;201805;8843;27640;7980;26140;589;2122;5968;19279;6557;21401
220551;201805;1438;4348;1260;4041;46;187;997;3138;1043;3325
220552;201805;1516;4537;1285;4085;35;177;1043;3216;1078;3393
220553;201805;1573;4400;1336;4026;51;151;1039;3213;1090;3364
220554;201805;841;2330;642;1992;35;96;477;1465;512;1561
220555;201805;2015;6622;1877;6377;58;296;1548;5180;1606;5476
220556;201805;1303;3906;1123;3528;46;195;839;2520;885;2715
220557;201805;1554;4812;1326;4336;83;309;957;3062;1040;3371
220558;201805;1351;3657;1053;3237;28;140;872;2615;900;2755
220559;201805;1623;4339;1396;3967;11;46;1155;3288;1166;3334
220560;201805;1686;4020;1363;3574;40;97;1194;3113;1234;3210
220570;201805;7143;22287;6574;21382;536;1782;5097;16672;5633;18454
220580;201805;6588;19232;6243;18670;148;539;5560;16463;5708;17002
220585;201805;1932;6415;1749;6063;65;277;1425;4900;1490;5177
220590;201805;1271;3645;1079;3353;101;318;767;2399;868;2717
220595;201805;2411;6762;2245;6544;15;82;2105;6074;2120;6156
220600;201805;1404;3218;1149;2888;132;220;902;2357;1034;2577
220605;201805;1705;5028;1463;4594;36;161;1160;3555;1196;3716
220610;201805;2864;8999;2696;8756;38;177;2476;8035;2514;8212
220620;201805;7778;24766;7263;24049;197;910;6569;21563;6766;22473
220630;201805;371;1134;295;1000;39;136;179;629;218;765
220635;201805;1683;5407;1484;4984;71;286;1080;3573;1151;3859
220640;201805;2692;7434;2298;6844;87;309;1903;5608;1990;5917
220650;201805;2057;5954;1775;5449;67;234;1371;4162;1438;4396
220660;201805;2764;8357;2430;7881;97;440;2027;6371;2124;6811
220665;201805;1291;4020;1128;3747;27;152;957;3123;984;3275
220667;201805;1633;5291;1467;4986;72;273;1173;3995;1245;4268
220669;201805;1712;5401;1641;5271;82;369;1368;4304;1450;4673
220670;201805;2093;5747;1761;5354;37;125;1585;4798;1622;4923
220672;201805;2951;7621;2441;7005;107;315;2159;6193;2266;6508
220675;201805;1234;3464;1130;3271;48;130;896;2573;944;2703
220680;201805;2587;7398;2461;7221;113;319;2184;6413;2297;6732
220690;201805;1578;4330;1387;4018;123;310;1029;3032;1152;3342
220695;201805;940;2650;856;2488;20;66;708;2037;728;2103
220700;201805;8797;23206;7157;20835;353;1122;5468;15768;5821;16890
220710;201805;842;2434;652;2059;47;134;463;1452;510;1586
220720;201805;2028;5074;1840;4786;30;98;1598;4128;1628;4226
220730;201805;1301;3764;1107;3449;23;107;911;2777;934;2884
220735;201805;1004;2407;769;2024;23;63;648;1682;671;1745
220740;201805;1415;4038;1138;3674;34;131;963;3117;997;3248
220750;201805;3565;9945;3249;9474;164;473;2813;8190;2977;8663
220755;201805;1151;3068;999;2831;30;118;795;2172;825;2290
220760;201805;2971;8937;2622;8459;111;376;2216;7233;2327;7609
220770;201805;20553;65295;17843;60285;6120;21374;5746;20322;11866;41696
220775;201805;1139;3042;1067;2955;17;59;1032;2852;1049;2911
220777;201805;1556;4136;1234;3600;39;104;936;2716;975;2820
220779;201805;1356;3356;1214;3155;29;103;1047;2680;1076;2783
220780;201805;5564;14552;4788;13287;227;775;3876;10468;4103;11243
220785;201805;1401;3223;1272;3037;20;31;1202;2875;1222;2906
220790;201805;10118;29580;9137;28132;298;1309;7697;23301;7995;24610
220793;201805;841;2300;702;2059;26;79;581;1704;607;1783
220795;201805;1415;3785;1276;3610;25;97;1136;3199;1161;3296
220800;201805;16275;40848;13813;37240;821;2277;9851;26136;10672;28413
220810;201805;2956;8531;2574;7834;55;232;2145;6400;2200;6632
220820;201805;5225;13826;4527;12835;427;1098;3382;9660;3809;10758
220830;201805;7074;19637;6430;18674;279;867;5344;15426;5623;16293
220840;201805;12501;39035;10761;35482;2260;7148;5553;18856;7813;26004
220850;201805;2976;9600;2728;9289;73;390;2433;8201;2506;8591
220855;201805;579;1664;502;1532;14;69;413;1238;427;1307
220860;201805;1001;2548;865;2334;18;57;774;2071;792;2128
220865;201805;2535;6867;1997;5939;58;225;1563;4514;1621;4739
220870;201805;2583;7913;2168;7342;30;150;1976;6662;2006;6812
220880;201805;5120;12864;4573;12196;78;274;4221;11184;4299;11458
220885;201805;1285;4330;1102;4004;52;269;854;3095;906;3364
220887;201805;1315;3124;1187;2947;7;30;1116;2738;1123;2768
220890;201805;1581;5152;1335;4671;100;354;990;3499;1090;3853
220900;201805;1990;5061;1680;4622;37;91;1458;3978;1495;4069
220910;201805;1496;4360;1268;4013;30;101;1096;3475;1126;3576
220915;201805;984;2680;793;2307;16;67;625;1756;641;1823
220920;201805;1391;4713;1189;4426;87;386;913;3371;1000;3757
220930;201805;1568;4611;1384;4323;31;117;1239;3820;1270;3937
220935;201805;1045;3022;842;2593;35;135;562;1617;597;1752
220937;201805;1356;3735;1184;3466;26;100;962;2753;988;2853
220940;201805;1367;4083;1148;3648;36;160;868;2670;904;2830
220945;201805;424;1490;377;1402;24;137;269;960;293;1097
220950;201805;1389;3306;922;2549;20;73;714;1908;734;1981
220955;201805;1515;4110;1325;3782;36;102;1119;3199;1155;3301
220960;201805;878;2241;681;1924;16;62;540;1497;556;1559
220965;201805;1737;4892;1553;4618;27;162;1335;3851;1362;4013
220970;201805;1795;4734;1399;4090;51;140;1119;3273;1170;3413
220975;201805;708;2184;621;2069;22;146;551;1744;573;1890
220980;201805;1194;3464;1075;3269;32;136;890;2660;922;2796
220985;201805;1184;3339;1079;3184;45;173;830;2347;875;2520
220987;201805;1478;4481;1283;4136;63;284;1042;3288;1105;3572
220990;201805;1720;4930;1482;4551;33;178;1196;3562;1229;3740
220995;201805;1200;3581;922;3098;59;245;653;2177;712;2422
220997;201805;2411;7098;2263;6882;53;209;2065;6221;2118;6430
221000;201805;4073;11855;3762;11367;117;549;3168;9332;3285;9881
221005;201805;1430;4064;1291;3806;69;226;1030;2929;1099;3155
221010;201805;1225;2995;1004;2723;25;64;872;2339;897;2403
221020;201805;1563;4882;1450;4655;38;173;1082;3417;1120;3590
221030;201805;1579;4337;1366;4028;32;139;1144;3329;1176;3468
221035;201805;1353;3745;1226;3575;27;56;1119;3341;1146;3397
221037;201805;585;1746;508;1606;11;56;349;1047;360;1103
221038;201805;524;1500;413;1291;17;57;291;901;308;958
221039;201805;877;2380;776;2217;20;81;653;1810;673;1891
221040;201805;4215;12979;3834;12306;166;580;3025;9732;3191;10312
221050;201805;3615;10101;3293;9684;56;224;2988;8716;3044;8940
221060;201805;8370;23592;6989;21385;280;918;5378;16732;5658;17650
221062;201805;1199;4056;1046;3758;46;236;807;2849;853;3085
221063;201805;1183;3541;1023;3294;70;260;736;2342;806;2602
221065;201805;2662;6988;2346;6446;35;120;2038;5511;2073;5631
221070;201805;3366;10803;2856;9804;225;816;1982;6834;2207;7650
221080;201805;3491;8656;2825;7649;66;259;2297;6130;2363;6389
221090;201805;1378;3721;1148;3315;17;71;995;2795;1012;2866
221093;201805;1424;4169;1320;3955;140;433;865;2518;1005;2951
221095;201805;888;2376;754;2161;6;17;627;1757;633;1774
221097;201805;819;2175;643;1844;25;79;470;1294;495;1373
221100;201805;102617;288006;89704;266020;14932;45595;52670;153833;67602;199428
221110;201805;9984;30545;9256;29588;207;1056;8166;25733;8373;26789
221120;201805;4200;12564;3884;12037;260;890;3209;9862;3469;10752
221130;201805;4816;13092;3702;10832;955;2748;1513;4476;2468;7224
221135;201805;1573;4429;1414;4212;41;151;1233;3634;1274;3785
221140;201805;1316;3198;1152;2970;9;37;1036;2619;1045;2656
221150;201805;1113;2801;878;2384;21;92;693;1778;714;1870
221160;201805;806;2019;718;1900;30;62;578;1531;608;1593
221170;201805;1069;3135;965;2967;19;58;787;2409;806;2467
230010;201805;3176;8623;2569;7544;149;493;1934;5582;2083;6075
230015;201805;2925;9863;2688;9395;264;1094;1817;6225;2081;7319
230020;201805;13157;42134;12614;41235;446;1841;10771;34806;11217;36647
230030;201805;12207;32622;10662;30405;227;775;9362;26598;9589;27373
230040;201805;4160;11257;3584;10278;115;453;2915;8231;3030;8684
230050;201805;2718;8776;2002;6945;433;1442;722;2523;1155;3965
230060;201805;2315;6518;1889;5691;43;175;1530;4515;1573;4690
230070;201805;3951;11059;3299;9730;179;607;2232;6621;2411;7228
230075;201805;9024;29819;8381;28648;381;1903;6822;22751;7203;24654
230080;201805;2680;6171;2131;5387;30;135;1886;4699;1916;4834
230090;201805;4038;10717;3492;9823;175;554;2665;7376;2840;7930
230100;201805;17605;48499;15798;45823;1703;5252;10372;30101;12075;35353
230110;201805;11976;36678;10637;33947;1947;6273;5709;18353;7656;24626
230120;201805;7453;20728;6552;19237;596;1607;4746;14222;5342;15829
230125;201805;3052;8409;2510;7488;91;343;1920;5664;2011;6007
230130;201805;5708;18116;4749;16011;453;1662;3085;10186;3538;11848
230140;201805;3474;10664;2951;9658;132;567;2168;6958;2300;7525
230150;201805;1605;4873;1353;4312;224;676;744;2451;968;3127
230160;201805;6365;17393;5526;16107;175;663;4591;13171;4766;13834
230170;201805;5963;17813;5156;16256;243;880;3804;11764;4047;12644
230180;201805;1606;4615;1372;4139;31;140;1064;3088;1095;3228
230185;201805;4021;12310;3501;11388;306;1142;2530;8208;2836;9350
230190;201805;12993;39263;11160;35701;1677;5530;5943;19093;7620;24623
230195;201805;5135;15384;4565;14390;320;1110;3547;11027;3867;12137
230200;201805;4884;13631;4253;12392;175;522;3350;9562;3525;10084
230205;201805;4016;12706;3620;11988;184;784;2690;8731;2874;9515
230210;201805;9566;24975;8182;22947;486;1556;6042;16777;6528;18333
230220;201805;13448;35749;11998;33386;539;1635;9802;26930;10341;28565
230230;201805;6901;21294;6200;19862;499;1631;4442;14158;4941;15789
230240;201805;12913;34885;11403;32426;431;1298;9252;26062;9683;27360
230250;201805;9135;26969;9001;26750;349;1275;7063;20468;7412;21743
230260;201805;14114;44942;12710;42081;1665;5780;7413;24760;9078;30540
230270;201805;7469;20953;6033;18261;589;1813;3955;12040;4544;13853
230280;201805;20338;56729;17122;51202;767;3068;13236;38314;14003;41382
230290;201805;4635;13483;4009;12165;412;1142;2893;8868;3305;10010
230300;201805;4346;12445;4096;12088;111;477;3583;10344;3694;10821
230310;201805;4780;13863;4078;12633;146;584;2905;8773;3051;9357
230320;201805;7509;22095;6569;20341;318;1258;5040;15328;5358;16586
230330;201805;4727;13306;3901;11688;185;567;2878;8504;3063;9071
230340;201805;3541;11366;3037;10314;281;1011;2057;6918;2338;7929
230350;201805;18586;53064;16618;49697;1083;3751;10751;32528;11834;36279
230360;201805;2906;8143;2325;7059;139;496;1593;4760;1732;5256
230365;201805;3034;7775;2567;7012;63;291;2161;5792;2224;6083
230370;201805;53228;158091;46041;146611;9556;31102;22631;74614;32187;105716
230380;201805;6455;18297;5183;15878;177;666;3697;11123;3874;11789
230390;201805;3300;10144;2891;9434;135;575;2182;6970;2317;7545
230393;201805;2936;9268;2478;8317;94;504;1890;6085;1984;6589
230395;201805;5706;15838;5014;14608;490;1354;3390;10020;3880;11374
230400;201805;5645;16247;5033;15196;167;742;4009;11753;4176;12495
230410;201805;14551;44250;11894;38959;1349;4562;7297;24029;8646;28591
230420;201805;25274;75176;21661;68203;2984;9987;11950;37312;14934;47299
230423;201805;4608;13997;4032;12828;128;545;3206;10027;3334;10572
230425;201805;5451;17451;4999;16477;499;1658;3443;11372;3942;13030
230426;201805;2545;6940;1943;5750;45;190;1483;4308;1528;4498
230427;201805;1812;5280;1267;4023;58;201;873;2663;931;2864
230428;201805;9593;26997;8548;25332;1233;3848;4955;14554;6188;18402
230430;201805;4446;13383;3799;12207;205;799;2804;8754;3009;9553
230435;201805;5495;15623;4727;14278;594;1847;2891;8725;3485;10572
230440;201805;388019;1031250;327582;934950;51032;151872;177321;504990;228353;656862
230445;201805;4368;11761;3673;10547;209;542;2559;7248;2768;7790
230450;201805;3500;10596;3071;9837;209;842;2215;6965;2424;7807
230460;201805;2002;5965;1755;5528;80;311;1418;4444;1498;4755
230465;201805;3932;11406;3338;10308;101;451;2449;7300;2550;7751
230470;201805;11136;38195;10171;36316;888;3832;7342;25782;8230;29614
230480;201805;1421;4281;1210;3867;111;441;879;2709;990;3150
230490;201805;2301;6760;2008;6191;204;625;1177;3546;1381;4171
230495;201805;5720;17636;5118;16512;434;1720;3350;10626;3784;12346
230500;201805;8358;28884;7830;27847;349;1541;6144;21823;6493;23364
230510;201805;1643;5348;1225;4350;226;848;499;1758;725;2606
230520;201805;4327;12912;3890;12068;299;997;2736;8356;3035;9353
230523;201805;15114;45994;12542;40418;2903;9484;3184;10735;6087;20219
230526;201805;3859;11305;3292;10260;147;634;2528;7665;2675;8299
230530;201805;5256;16539;4544;15258;449;1618;3190;10770;3639;12388
230533;201805;4073;10636;3486;9548;127;359;2813;7646;2940;8005
230535;201805;5519;15618;4678;14112;311;959;3212;9843;3523;10802
230540;201805;16161;45801;14480;43195;341;1421;12338;36285;12679;37706
230550;201805;19875;55465;16634;49646;1979;6264;9655;28654;11634;34918
230560;201805;7509;19810;6215;17503;106;420;5105;14187;5211;14607
230565;201805;3155;8716;2597;7713;81;320;1966;5757;2047;6077
230570;201805;3530;9168;3079;8563;73;215;2586;7162;2659;7377
230580;201805;9795;27674;8747;26124;360;1315;7297;21573;7657;22888
230590;201805;8828;26193;7354;23362;557;1963;5108;15777;5665;17740
230600;201805;3720;9972;2796;8155;94;296;1825;5404;1919;5700
230610;201805;6384;18629;5720;17573;463;1444;4319;13282;4782;14726
230620;201805;2091;5818;1606;4809;147;468;965;2812;1112;3280
230625;201805;8001;24188;6997;22161;2083;6845;1847;6102;3930;12947
230630;201805;10184;31642;9069;29341;2376;7198;3922;13660;6298;20858
230640;201805;26666;83294;24402;79556;1673;6298;19127;61789;20800;68087
230650;201805;4915;14159;4297;12974;267;895;3275;9703;3542;10598
230655;201805;9223;32624;8795;31845;630;2553;6909;25145;7539;27698
230660;201805;6299;18775;5177;16622;180;943;4183;13091;4363;14034
230670;201805;6022;15092;4544;12574;186;592;3541;9518;3727;10110
230680;201805;2540;7329;2184;6628;212;636;1448;4398;1660;5034
230690;201805;6424;19888;5855;18649;550;1945;3603;11242;4153;13187
230700;201805;9406;25306;8196;23027;338;1103;6181;16854;6519;17957
230710;201805;7054;22406;6157;20575;517;1873;4458;14748;4975;16621
230720;201805;1880;5752;1561;5059;129;419;1021;3247;1150;3666
230725;201805;3553;11539;3134;10532;661;2350;1269;4179;1930;6529
230730;201805;55325;157739;45764;142178;10830;36208;15728;51256;26558;87464
230740;201805;6038;17365;5351;16177;143;568;4296;12855;4439;13423
230750;201805;8233;22891;6970;20745;214;799;5432;15767;5646;16566
230760;201805;11294;31473;10104;29433;740;2449;7322;20833;8062;23282
230763;201805;4397;12842;3786;11677;177;716;2925;8696;3102;9412
230765;201805;39927;116154;34150;105869;7238;23515;13027;40772;20265;64287
230770;201805;25672;67813;22039;62683;2851;8549;13703;39068;16554;47617
230780;201805;5844;21277;5514;20590;918;3425;3195;12361;4113;15786
230790;201805;2931;8750;2656;8286;158;603;2027;6235;2185;6838
230800;201805;7699;25639;6947;24035;877;3379;3983;13575;4860;16954
230810;201805;11711;36089;10624;34259;486;1888;8192;25930;8678;27818
230820;201805;3199;10640;2753;9657;280;1142;1690;5756;1970;6898
230830;201805;7454;21480;6415;19558;188;798;5151;15383;5339;16181
230835;201805;4043;9999;3172;8615;111;347;2561;6811;2672;7158
230837;201805;3140;10113;2680;9205;145;695;2001;6658;2146;7353
230840;201805;8874;27122;7797;25281;534;1903;5943;19240;6477;21143
230850;201805;9118;27519;8094;25525;519;1851;5763;18037;6282;19888
230860;201805;5047;13580;4279;12419;145;504;3603;10348;3748;10852
230870;201805;17120;43221;14791;39560;539;1548;11656;31002;12195;32550
230880;201805;2022;6411;1865;6135;71;366;1447;4607;1518;4973
230890;201805;4375;14683;4039;14028;339;1313;2881;9883;3220;11196
230900;201805;3022;9236;2539;8238;264;893;1594;5063;1858;5956
230910;201805;3038;8559;2471;7568;91;428;1942;5824;2033;6252
230920;201805;4537;12905;4061;12197;152;600;3387;10079;3539;10679
230930;201805;6555;19197;5550;17218;432;1405;3657;11260;4089;12665
230940;201805;7749;21054;6866;19628;216;661;5673;16117;5889;16778
230945;201805;6506;19062;5646;17326;409;1348;3848;11840;4257;13188
230950;201805;6351;16397;5797;15714;135;320;5177;14296;5312;14616
230960;201805;13636;41078;12298;38455;2002;6376;6065;19274;8067;25650
230970;201805;13445;38225;11580;35098;2134;6755;5556;16893;7690;23648
230980;201805;2739;8202;2364;7534;514;1588;1281;4257;1795;5845
230990;201805;1703;4912;1412;4329;77;325;970;2848;1047;3173
231000;201805;2475;6690;2093;5916;81;232;1494;4148;1575;4380
231010;201805;3047;7926;2506;7005;137;454;1951;5314;2088;5768
231020;201805;8049;26186;7359;24662;1312;4188;4252;14780;5564;18968
231025;201805;7375;21506;6556;20094;983;3055;4209;12993;5192;16048
231030;201805;6918;21496;5615;18674;992;3309;2943;9790;3935;13099
231040;201805;3135;9286;2712;8488;99;415;2082;6361;2181;6776
231050;201805;11799;31642;9544;27596;654;1827;7006;19991;7660;21818
231060;201805;2435;7425;2231;7076;82;336;1800;5673;1882;6009
231070;201805;8154;24428;7019;22311;1009;3291;4010;12804;5019;16095
231080;201805;3932;11763;3540;11043;124;640;2751;8260;2875;8900
231085;201805;5737;15707;5047;14827;334;977;3800;11334;4134;12311
231090;201805;4208;11414;3222;9421;121;455;2246;6386;2367;6841
231095;201805;2033;6366;1719;5644;156;565;1181;3828;1337;4393
231100;201805;2989;9083;2541;8243;162;554;1869;6050;2031;6604
231110;201805;3389;10631;3290;10463;177;692;2420;7545;2597;8237
231120;201805;1995;6236;1747;5788;126;445;1185;3901;1311;4346
231123;201805;1867;5020;1588;4501;75;220;1192;3323;1267;3543
231126;201805;5779;16323;4632;14066;212;741;3328;9880;3540;10621
231130;201805;19347;54525;16849;50920;1656;5681;11412;34526;13068;40207
231135;201805;4195;12047;3526;10796;179;657;2532;7603;2711;8260
231140;201805;17170;50323;14274;44982;851;3440;9687;29639;10538;33079
231150;201805;5356;15326;4442;13487;742;2180;2131;6652;2873;8832
231160;201805;5807;18488;5335;17550;1138;3546;2824;9672;3962;13218
231170;201805;4287;13006;3553;11481;234;862;2415;7575;2649;8437
231180;201805;13705;40292;11755;36022;2617;8129;4930;15057;7547;23186
231190;201805;3850;11185;3381;10324;152;614;2593;7639;2745;8253
231195;201805;4486;14524;3859;13175;214;947;2836;9412;3050;10359
231200;201805;7795;25239;6790;23118;259;1265;5144;16961;5403;18226
231210;201805;4719;14512;4094;13411;207;827;3083;9863;3290;10690
231220;201805;11706;31778;9525;27536;548;1642;6862;19329;7410;20971
231230;201805;9078;29242;8153;27727;575;2212;6006;20522;6581;22734
231240;201805;11592;35032;10380;32548;1772;5584;5883;18634;7655;24218
231250;201805;1976;5321;1343;3875;100;297;772;2175;872;2472
231260;201805;3183;9474;2827;8888;320;966;1877;6034;2197;7000
231270;201805;6503;17373;5551;15823;170;693;4257;11856;4427;12549
231280;201805;1664;5322;1556;5107;142;486;1112;3637;1254;4123
231290;201805;36339;112760;31828;103322;5520;18467;14887;47925;20407;66392
231300;201805;3962;11386;3222;9858;266;868;2093;6291;2359;7159
231310;201805;7291;19961;5951;17262;647;1853;3761;10783;4408;12636
231320;201805;7396;21293;5931;18455;140;619;4576;14016;4716;14635
231325;201805;2532;7212;2142;6571;401;1195;1149;3607;1550;4802
231330;201805;10196;31773;8582;28411;1676;5477;4270;14502;5946;19979
231335;201805;5604;15081;4792;13700;104;467;4127;11575;4231;12042
231340;201805;17627;55719;15917;52830;1118;3939;11884;39689;13002;43628
231350;201805;15343;42948;13975;41031;344;1185;12495;36575;12839;37760
231355;201805;4527;13935;4054;13096;226;849;3079;9884;3305;10733
231360;201805;7463;23116;6522;21455;504;1743;4735;15659;5239;17402
231370;201805;2300;6249;1830;5419;44;143;1400;4107;1444;4250
231375;201805;4273;13772;3917;13108;134;613;3221;10617;3355;11230
231380;201805;5765;16035;5367;15534;193;476;4576;13529;4769;14005
231390;201805;3311;9997;2985;9436;184;697;2154;6631;2338;7328
231395;201805;3919;12051;3312;11022;620;2073;1775;6009;2395;8082
231400;201805;8955;26690;8026;24900;371;1479;6206;18892;6577;20371
231410;201805;14971;47345;13332;44624;837;3102;10248;33949;11085;37051
240010;201805;2516;7013;1959;5955;192;686;1209;3554;1401;4240
240020;201805;11057;32894;9668;30264;1000;3479;6097;18876;7097;22355
240030;201805;2619;6979;2474;6763;127;384;2152;5826;2279;6210
240040;201805;848;2434;700;2142;13;64;511;1504;524;1568
240050;201805;3295;8894;2705;7818;65;212;2113;5991;2178;6203
240060;201805;1395;3844;1189;3455;35;125;952;2705;987;2830
240070;201805;2222;6690;2043;6308;217;694;1482;4501;1699;5195
240080;201805;2791;7694;2393;7024;76;285;1831;5318;1907;5603
240090;201805;2234;5744;1838;5051;28;95;1492;4033;1520;4128
240100;201805;8821;23205;7316;20376;404;1255;5507;14887;5911;16142
240110;201805;4406;13253;3863;12224;311;1106;2607;8129;2918;9235
240120;201805;3566;9945;2677;8880;238;915;1705;5825;1943;6740
240130;201805;3278;7424;2819;6745;65;202;2520;5913;2585;6115
240140;201805;2121;6363;1793;5733;186;713;1156;3625;1342;4338
240145;201805;6128;18027;5240;16486;757;2556;3219;10193;3976;12749
240150;201805;868;2663;784;2483;56;205;597;1827;653;2032
240160;201805;1418;4388;1220;3999;73;295;862;2838;935;3133
240165;201805;902;2632;773;2370;80;229;547;1678;627;1907
240170;201805;2335;6718;1995;6091;231;777;1259;3727;1490;4504
240180;201805;3059;8985;2467;7837;453;1425;1352;4428;1805;5853
240185;201805;1265;4167;1143;3965;63;277;931;3208;994;3485
240190;201805;976;2997;867;2809;22;104;717;2290;739;2394
240200;201805;10931;29555;9201;26532;1373;4084;4510;13030;5883;17114
240210;201805;2837;7606;2549;7120;52;221;2147;5808;2199;6029
240220;201805;7210;23186;6558;22170;519;2159;4796;16093;5315;18252
240230;201805;5846;15112;4791;13354;252;683;3793;10569;4045;11252
240240;201805;1996;6599;1300;4805;140;477;493;2050;633;2527
240250;201805;2739;7724;2517;7406;144;385;2054;6079;2198;6464
240260;201805;12852;40169;11501;37812;1671;5441;7050;24003;8721;29444
240270;201805;2250;6822;2033;6480;121;335;1611;5262;1732;5597
240280;201805;1612;4266;1392;3937;46;133;1151;3211;1197;3344
240290;201805;1193;3579;999;3166;40;198;674;1977;714;2175
240300;201805;2248;5917;1626;4694;96;312;973;2709;1069;3021
240310;201805;9129;24848;7640;22274;924;2791;4131;11973;5055;14764
240320;201805;1967;5512;1485;4550;28;136;1124;3283;1152;3419
240325;201805;30175;84170;23805;72972;6215;19972;6766;21752;12981;41724
240330;201805;1516;4404;1246;3855;51;186;857;2547;908;2733
240340;201805;1968;4839;1580;4235;71;185;1226;3210;1297;3395
240350;201805;2055;5554;1906;5374;36;127;1689;4781;1725;4908
240360;201805;7452;21920;6609;20564;1218;3751;3720;12107;4938;15858
240370;201805;2030;5488;1580;4594;113;340;1031;2944;1144;3284
240375;201805;864;2270;754;2055;33;134;585;1508;618;1642
240380;201805;2307;6686;1671;5246;154;492;971;2993;1125;3485
240390;201805;939;2474;695;1965;8;21;486;1294;494;1315
240400;201805;1361;3724;1098;3217;34;126;788;2247;822;2373
240410;201805;533;1697;461;1531;44;174;298;965;342;1139
240420;201805;4617;17084;4193;16110;634;2923;2237;8409;2871;11332
240430;201805;3297;9073;2872;8239;215;727;2108;5839;2323;6566
240440;201805;2526;5916;2136;5370;182;450;1561;3860;1743;4310
240450;201805;4139;11805;3383;10366;365;1250;2020;6013;2385;7263
240460;201805;3015;8794;2783;8450;239;787;2204;6665;2443;7452
240470;201805;3616;11111;2846;9498;377;1259;1621;5454;1998;6713
240480;201805;550;1515;399;1215;37;117;193;583;230;700
240485;201805;2121;6315;1778;5624;181;571;1128;3614;1309;4185
240490;201805;1762;4419;1423;3830;46;105;1175;3166;1221;3271
240500;201805;2206;6006;1933;5621;57;191;1638;4731;1695;4922
240510;201805;1665;4588;1531;4395;99;312;1275;3577;1374;3889
240520;201805;1296;3409;1082;3109;37;153;902;2524;939;2677
240530;201805;1889;5992;1755;5740;109;397;1373;4438;1482;4835
240540;201805;2114;5528;1890;5191;70;215;1623;4424;1693;4639
240550;201805;688;1952;614;1812;34;108;467;1351;501;1459
240560;201805;3327;8959;2869;8350;305;759;2089;6226;2394;6985
240570;201805;2963;7941;2042;5880;272;838;921;2405;1193;3243
240580;201805;7598;22761;6981;21699;533;1787;5572;17244;6105;19031
240590;201805;698;1901;605;1733;17;60;464;1308;481;1368
240600;201805;1711;4742;1271;3833;89;306;793;2306;882;2612
240610;201805;4514;12603;3811;11296;203;662;2721;7933;2924;8595
240615;201805;1040;2977;835;2546;80;281;549;1593;629;1874
240620;201805;1830;5300;1575;4839;111;308;1256;3856;1367;4164
240630;201805;2051;6055;1840;5684;146;382;1264;4014;1410;4396
240640;201805;897;2512;729;2224;40;172;513;1509;553;1681
240650;201805;3936;11217;3512;10512;192;566;2753;8213;2945;8779
240660;201805;2611;7406;2384;7094;68;267;2113;6169;2181;6436
240670;201805;2464;7154;2039;6262;174;588;1278;3812;1452;4400
240680;201805;1593;4411;1280;3843;57;212;934;2712;991;2924
240690;201805;904;2359;720;2032;21;77;576;1570;597;1647
240700;201805;2452;7183;2032;6404;69;297;1580;4847;1649;5144
240710;201805;15874;42858;13674;38978;2576;7167;7407;21497;9983;28664
240720;201805;5282;14001;4606;12910;660;1938;2864;7847;3524;9785
240725;201805;1032;3068;809;2566;38;133;534;1642;572;1775
240730;201805;2110;6073;1782;5428;103;337;1346;4029;1449;4366
240740;201805;1879;5205;1578;4637;59;258;1161;3223;1220;3481
240750;201805;2281;7851;1953;7156;350;1375;1007;3739;1357;5114
240760;201805;1462;3702;1045;3042;66;161;790;2328;856;2489
240770;201805;3051;8736;2699;8230;130;505;2228;6661;2358;7166
240780;201805;5735;15561;4502;13518;559;1665;2654;8191;3213;9856
240790;201805;833;2454;700;2187;23;84;526;1632;549;1716
240800;201805;36446;98607;31072;89840;4871;14703;14965;43323;19836;58026
240810;201805;81605;225754;72660;210116;15691;45297;36157;105744;51848;151041
240820;201805;5521;17171;4832;15984;911;3075;2576;8815;3487;11890
240830;201805;8675;25794;7976;24709;322;1336;6543;19912;6865;21248
240840;201805;1131;2955;923;2586;77;217;634;1718;711;1935
240850;201805;1283;3685;931;2883;59;191;525;1608;584;1799
240860;201805;1227;3411;949;2889;23;100;708;2050;731;2150
240870;201805;1151;2980;904;2559;78;232;607;1681;685;1913
240880;201805;1278;4086;1188;3918;76;274;958;3139;1034;3413
240890;201805;4678;13040;3665;11048;620;1973;1715;5063;2335;7036
240895;201805;2687;8873;2425;8465;212;773;1906;6685;2118;7458
240910;201805;3110;8934;2682;8069;64;243;2204;6523;2268;6766
240920;201805;817;2516;696;2273;79;276;374;1218;453;1494
240930;201805;3602;8706;3079;8057;123;211;2456;6597;2579;6808
240933;201805;1880;4580;1545;4062;47;171;1277;3272;1324;3443
240940;201805;6294;15828;5000;13664;313;925;3585;9518;3898;10443
240950;201805;923;2898;823;2690;34;148;644;2060;678;2208
240960;201805;779;2383;678;2180;43;160;494;1553;537;1713
240970;201805;1767;4826;1481;4285;58;229;1203;3347;1261;3576
240980;201805;2917;9290;2656;8801;247;930;1927;6300;2174;7230
240990;201805;2536;7492;2329;7060;290;949;1629;4849;1919;5798
241000;201805;951;2565;783;2245;40;111;546;1557;586;1668
241010;201805;2710;8937;2524;8552;240;961;1798;5923;2038;6884
241020;201805;2029;5516;1513;4453;166;456;910;2653;1076;3109
241025;201805;1725;5054;1425;4486;85;288;929;2914;1014;3202
241030;201805;2425;7792;2028;6955;197;701;1352;4628;1549;5329
241040;201805;2264;7325;2028;6926;119;529;1579;5362;1698;5891
241050;201805;1284;3671;1067;3260;46;153;777;2319;823;2472
241060;201805;748;2132;661;1960;50;157;453;1325;503;1482
241070;201805;660;1842;577;1696;27;101;458;1286;485;1387
241080;201805;1116;3220;863;2715;16;76;629;1939;645;2015
241090;201805;2049;6025;1645;5311;60;287;1285;4084;1345;4371
241100;201805;1105;3226;919;2806;43;146;640;1886;683;2032
241105;201805;1106;3350;925;3009;272;896;321;1066;593;1962
241110;201805;864;2568;673;2138;28;115;444;1350;472;1465
241120;201805;7223;21309;6329;19715;1297;3835;3299;10923;4596;14758
241140;201805;3273;8721;2688;7568;159;460;1973;5401;2132;5861
241142;201805;750;2095;564;1716;38;130;340;997;378;1127
241150;201805;5612;15575;4991;14536;205;765;3956;11253;4161;12018
241160;201805;1572;4747;1385;4439;152;422;1002;3281;1154;3703
241170;201805;1252;3331;1113;3087;50;168;906;2413;956;2581
241180;201805;976;2617;716;2095;66;187;403;1163;469;1350
241190;201805;1131;3049;919;2614;27;105;663;1800;690;1905
241200;201805;18938;51500;16265;47419;3388;10045;7897;23478;11285;33523
241210;201805;1405;3879;1072;3205;99;315;640;1885;739;2200
241220;201805;8537;26515;7515;24696;2166;7158;3063;10577;5229;17735
241230;201805;2927;8076;2643;7603;100;372;2199;6159;2299;6531
241240;201805;1182;3445;700;2293;45;183;351;1145;396;1328
241250;201805;5732;17201;4709;15211;207;1002;3457;10701;3664;11703
241255;201805;1890;6495;1680;6020;161;683;1131;3960;1292;4643
241260;201805;4851;13055;3866;11392;93;421;2954;8481;3047;8902
241270;201805;1786;5319;1524;4799;127;466;1087;3365;1214;3831
241280;201805;1966;5300;1758;4929;86;259;1452;4022;1538;4281
241290;201805;3243;8365;2536;7180;89;321;1976;5463;2065;5784
241300;201805;1447;4032;1204;3575;41;142;815;2358;856;2500
241310;201805;1884;5095;1655;4730;43;137;1409;3995;1452;4132
241320;201805;982;3226;823;2889;101;397;499;1736;600;2133
241330;201805;1717;4554;1378;4134;42;174;1183;3525;1225;3699
241335;201805;2949;8524;2662;8000;88;310;2255;6681;2343;6991
241340;201805;1717;5122;1373;4337;281;907;591;1829;872;2736
241350;201805;1903;5749;1703;5369;97;346;1284;3972;1381;4318
241355;201805;1326;3685;1080;3224;32;128;833;2460;865;2588
241360;201805;2078;5450;1648;4612;68;207;1189;3222;1257;3429
241370;201805;1353;3866;1070;3294;79;285;704;2056;783;2341
241380;201805;666;1849;534;1587;59;181;328;953;387;1134
241390;201805;2680;8360;2455;7987;208;685;1874;6127;2082;6812
241400;201805;3627;10211;3252;9664;218;697;2574;7602;2792;8299
241410;201805;2360;7132;2022;6509;401;1353;1077;3462;1478;4815
241415;201805;1624;4856;1370;4386;103;350;991;3123;1094;3473
241420;201805;2174;7362;1895;6831;527;2009;680;2484;1207;4493
241430;201805;516;1504;392;1234;31;107;241;736;272;843
241440;201805;6949;22951;6269;21704;488;1985;4715;16163;5203;18148
241445;201805;1026;2786;949;2695;23;60;863;2499;886;2559
241450;201805;2874;7368;2544;6871;281;686;1852;5050;2133;5736
241460;201805;3531;9927;3002;8792;202;660;2101;5989;2303;6649
241470;201805;1427;3801;1137;3381;45;161;922;2716;967;2877
241475;201805;1218;3568;970;3073;31;174;700;2104;731;2278
241480;201805;2689;8714;2353;8028;850;2892;639;2526;1489;5418
241490;201805;705;1781;558;1553;26;80;362;967;388;1047
241500;201805;813;2424;683;2255;16;75;584;1911;600;1986
250010;201805;2719;8269;2243;7218;79;334;1625;5077;1704;5411
250020;201805;1568;4356;1161;3559;53;156;819;2466;872;2622
250030;201805;6821;19172;6162;18183;348;1149;4948;14333;5296;15482
250040;201805;3869;12516;3501;11778;268;1034;2505;8303;2773;9337
250050;201805;3397;9879;3129;9471;222;787;2456;7305;2678;8092
250053;201805;1206;3527;1089;3347;85;278;787;2423;872;2701
250057;201805;661;2450;635;2415;7;36;599;2304;606;2340
250060;201805;5179;14484;4733;13895;399;1162;3729;11046;4128;12208
250070;201805;3855;11412;3514;10781;55;277;2705;8018;2760;8295
250073;201805;777;2195;645;1976;9;35;501;1482;510;1517
250077;201805;2196;6106;1661;5186;98;329;1192;3686;1290;4015
250080;201805;4321;11772;3934;11205;119;426;3338;9342;3457;9768
250090;201805;2773;7351;2544;7001;99;265;2149;5866;2248;6131
250100;201805;3773;11828;3491;11306;159;651;2864;9032;3023;9683
250110;201805;4734;13697;4370;13151;388;1383;3416;10012;3804;11395
250115;201805;527;1547;464;1441;12;61;342;1024;354;1085
250120;201805;1709;5282;1496;4916;52;233;1189;3874;1241;4107
250130;201805;5377;15733;4636;14532;108;579;3742;11500;3850;12079
250135;201805;1115;3198;1020;3045;14;57;888;2631;902;2688
250140;201805;2068;6501;1994;6387;82;380;1710;5395;1792;5775
250150;201805;4746;15583;4345;14802;176;885;3415;11327;3591;12212
250153;201805;1481;3866;1233;3509;35;143;995;2773;1030;2916
250157;201805;1788;5527;1607;5150;160;499;1156;3712;1316;4211
250160;201805;3783;9872;3088;8920;42;136;2819;8132;2861;8268
250170;201805;1692;4611;1504;4322;53;191;1265;3585;1318;3776
250180;201805;17140;45939;15364;43482;959;3108;11579;32058;12538;35166
250190;201805;4037;11340;3574;10575;459;1266;2378;7022;2837;8288
250200;201805;1854;5333;1565;4869;53;184;1307;4044;1360;4228
250205;201805;774;2638;730;2548;22;121;592;2039;614;2160
250210;201805;1518;4716;1384;4491;45;221;1100;3490;1145;3711
250215;201805;1521;4456;1297;4083;64;212;803;2517;867;2729
250220;201805;702;2023;572;1824;27;96;424;1329;451;1425
250230;201805;1636;3897;1220;3240;29;99;967;2475;996;2574
250240;201805;2155;6860;1979;6542;51;203;1666;5438;1717;5641
250250;201805;4453;12930;3937;12176;111;398;3269;10067;3380;10465
250260;201805;1680;4805;1429;4367;38;135;1137;3472;1175;3607
250270;201805;1231;3775;1090;3600;76;247;807;2785;883;3032
250280;201805;3289;9537;2856;8840;125;427;2255;6947;2380;7374
250290;201805;1691;4529;1439;4176;20;51;1197;3465;1217;3516
250300;201805;5281;14920;4964;14526;235;989;4186;11879;4421;12868
250310;201805;1106;3229;958;2954;32;115;735;2213;767;2328
250320;201805;9630;25645;8719;24475;570;1743;7159;19889;7729;21632
250330;201805;2366;6983;2000;6447;128;423;1560;4984;1688;5407
250340;201805;1094;3006;967;2816;14;52;830;2377;844;2429
250350;201805;4106;11388;3723;10867;148;376;3157;9365;3305;9741
250355;201805;1948;6061;1784;5841;26;146;1617;5260;1643;5406
250360;201805;1797;5155;1664;4933;40;132;1375;4059;1415;4191
250370;201805;11903;32919;10337;30767;458;1653;8552;25157;9010;26810
250375;201805;1056;2994;937;2830;17;64;840;2555;857;2619
250380;201805;1630;4408;1515;4258;49;187;1255;3395;1304;3582
250390;201805;1821;4787;1506;4272;190;514;996;2856;1186;3370
250400;201805;68617;176850;50760;148041;13448;41008;16406;49224;29854;90232
250403;201805;1603;4920;1465;4742;136;588;1049;3277;1185;3865
250407;201805;1222;3204;1039;2925;77;151;763;2183;840;2334
250410;201805;569;1665;501;1542;11;63;416;1237;427;1300
250415;201805;1889;5487;1679;5130;64;219;1329;4047;1393;4266
250420;201805;1223;3551;1108;3390;21;83;1019;3113;1040;3196
250430;201805;6205;15918;5415;14775;178;565;4454;11880;4632;12445
250435;201805;1373;4042;1208;3757;39;161;932;2837;971;2998
250440;201805;4444;12340;3962;11674;89;321;3392;9895;3481;10216
250450;201805;1837;5082;1559;4704;41;156;1279;3804;1320;3960
250460;201805;6936;19521;6339;18721;347;1043;5392;16003;5739;17046
250470;201805;1545;4015;1270;3619;71;233;948;2620;1019;2853
250480;201805;3714;10822;3383;10398;42;181;3066;9474;3108;9655
250485;201805;697;1625;502;1349;26;69;383;991;409;1060
250490;201805;4421;11902;4049;11444;238;784;3365;9406;3603;10190
250500;201805;1923;5484;1698;5103;84;265;1368;4097;1452;4362
250510;201805;5234;13662;4563;12758;72;217;4089;11460;4161;11677
250520;201805;1812;5110;1586;4771;177;574;1044;3090;1221;3664
250523;201805;2053;5338;1884;5126;68;304;1637;4304;1705;4608
250527;201805;1602;4376;1486;4232;37;124;1346;3817;1383;3941
250530;201805;603;1729;526;1620;19;71;458;1398;477;1469
250535;201805;1328;4028;1225;3831;39;185;977;2973;1016;3158
250540;201805;2628;6661;2242;6216;53;156;1966;5443;2019;5599
250550;201805;840;2764;758;2626;26;125;596;2011;622;2136
250560;201805;1641;4802;1507;4603;52;190;1232;3668;1284;3858
250570;201805;2541;7813;2220;7219;78;354;1765;5585;1843;5939
250580;201805;1056;2761;948;2606;53;186;780;2108;833;2294
250590;201805;824;2423;734;2284;21;99;609;1848;630;1947
250600;201805;7261;20287;6594;19277;368;989;5470;16073;5838;17062
250610;201805;2976;8559;2727;8184;147;511;2244;6674;2391;7185
250620;201805;700;1977;613;1805;25;102;470;1348;495;1450
250625;201805;2507;7480;2313;7177;55;242;1978;6005;2033;6247
250630;201805;9595;27954;8245;25398;1107;3567;5084;15296;6191;18863
250640;201805;3315;9791;3087;9475;95;426;2608;7836;2703;8262
250650;201805;899;2279;750;2077;34;110;608;1625;642;1735
250660;201805;1659;4258;1481;4017;45;115;1291;3474;1336;3589
250670;201805;2274;7301;2144;7074;47;254;1862;5998;1909;6252
250680;201805;5491;13472;5036;12957;129;430;4594;11636;4723;12066
250690;201805;6401;15409;5823;14670;157;377;5275;13211;5432;13588
250700;201805;4301;12470;3865;11771;360;1128;2894;8723;3254;9851
250710;201805;4491;13198;3909;12407;325;1159;2815;8951;3140;10110
250720;201805;2719;7352;2472;6972;43;188;2222;6192;2265;6380
250730;201805;3825;10568;3422;10028;161;588;2862;8169;3023;8757
250740;201805;1938;5172;1613;4704;124;405;1263;3595;1387;4000
250750;201805;97439;258929;86187;242439;8452;25815;59049;162720;67501;188535
250760;201805;2334;6209;2041;5749;125;358;1589;4392;1714;4750
250770;201805;3762;12007;3441;11588;274;1072;2523;8420;2797;9492
250780;201805;1719;4825;1447;4315;113;378;1026;2982;1139;3360
250790;201805;2359;7319;2134;6963;297;1021;1358;4469;1655;5490
250800;201805;2502;6804;2147;6224;104;239;1745;5080;1849;5319
250810;201805;1272;3560;1053;3230;34;120;861;2641;895;2761
250820;201805;1799;5567;1736;5489;62;252;1560;4889;1622;5141
250830;201805;5319;16622;4751;15450;352;1373;3365;10701;3717;12074
250840;201805;842;2707;725;2458;16;73;511;1742;527;1815
250850;201805;1876;5662;1670;5312;43;234;1372;4225;1415;4459
250855;201805;1012;2989;871;2740;62;228;630;1940;692;2168
250860;201805;3180;9837;2625;8849;459;1630;1357;4629;1816;6259
250870;201805;1062;2960;906;2666;34;124;736;2137;770;2261
250880;201805;1529;4078;1258;3677;147;426;846;2505;993;2931
250890;201805;9388;26685;8779;25837;615;2374;7056;20065;7671;22439
250900;201805;2728;8204;2363;7508;88;312;1926;6012;2014;6324
250905;201805;2181;6433;2058;6261;69;263;1836;5545;1905;5808
250910;201805;5384;14488;4669;13566;120;445;3973;11540;4093;11985
250915;201805;1817;4639;1402;4209;18;38;1302;3991;1320;4029
250920;201805;3175;8728;2930;8329;307;829;2162;6080;2469;6909
250930;201805;2110;5926;1958;5705;79;311;1652;4708;1731;5019
250933;201805;1115;3522;988;3271;35;174;730;2333;765;2507
250937;201805;695;1981;577;1764;29;104;437;1323;466;1427
250939;201805;1644;4592;1457;4296;51;200;1179;3387;1230;3587
250940;201805;3774;10764;3478;10292;59;248;3050;8992;3109;9240
250950;201805;1505;4114;1258;3791;32;142;1098;3278;1130;3420
250960;201805;1063;3241;974;3099;38;171;785;2417;823;2588
250970;201805;8386;22576;7201;20626;414;1362;5424;15257;5838;16619
250980;201805;2513;7013;2275;6579;57;233;1854;5202;1911;5435
250990;201805;1880;6115;1642;5606;86;400;1223;4079;1309;4479
251000;201805;2083;5939;1731;5374;33;145;1444;4439;1477;4584
251010;201805;2589;7542;2337;7140;31;124;2112;6461;2143;6585
251020;201805;1677;4558;1554;4405;45;136;1422;4017;1467;4153
251030;201805;1006;2780;868;2509;43;136;610;1712;653;1848
251040;201805;1802;5354;1560;4938;58;278;1254;3855;1312;4133
251050;201805;1118;3103;918;2718;72;224;655;1863;727;2087
251060;201805;1067;2347;776;1964;11;52;627;1540;638;1592
251065;201805;449;1269;368;1157;19;74;255;742;274;816
251070;201805;744;2111;644;1980;15;58;551;1675;566;1733
251080;201805;19038;50552;15877;45776;2321;7008;9400;27316;11721;34324
251090;201805;2811;8335;2401;7548;82;304;1866;5792;1948;6096
251100;201805;852;2663;754;2489;31;161;540;1693;571;1854
251110;201805;1724;4842;1494;4400;51;141;1145;3341;1196;3482
251120;201805;6687;20634;5970;19596;299;1273;4606;14967;4905;16240
251130;201805;3657;8965;3337;8606;226;590;2968;7654;3194;8244
251140;201805;4242;12267;3870;11727;107;430;3190;9592;3297;10022
251150;201805;2695;8077;2455;7706;120;505;1965;6012;2085;6517
251160;201805;1977;6204;1805;5930;84;284;1544;5091;1628;5375
251170;201805;1506;4330;1370;4174;39;137;1227;3731;1266;3868
251180;201805;2548;7235;2192;6714;198;675;1454;4411;1652;5086
251190;201805;4416;11767;4143;11440;66;283;3771;10196;3837;10479
251200;201805;4052;12637;3760;12262;83;353;3347;10956;3430;11309
251203;201805;953;3137;908;3043;36;155;689;2250;725;2405
251207;201805;1028;3058;837;2705;26;135;583;1819;609;1954
251210;201805;7299;19745;6136;18251;293;856;4903;14714;5196;15570
251220;201805;1126;2878;917;2590;47;126;720;2049;767;2175
251230;201805;4630;12823;4094;12070;154;554;3413;9847;3567;10401
251240;201805;3431;9836;2947;9127;183;622;2211;6705;2394;7327
251250;201805;9859;27765;8912;26329;836;2667;6364;18235;7200;20902
251260;201805;460;1429;419;1350;14;59;321;1018;335;1077
251270;201805;4101;13116;3692;12588;115;524;3169;10817;3284;11341
251272;201805;1316;3666;1220;3523;39;152;1085;3096;1124;3248
251274;201805;895;2626;734;2335;44;182;511;1547;555;1729
251275;201805;1222;3495;1073;3244;42;168;796;2300;838;2468
251276;201805;1248;3447;1134;3298;47;202;934;2638;981;2840
251278;201805;569;1674;511;1561;48;138;363;1121;411;1259
251280;201805;2244;6380;2020;6026;50;217;1641;4744;1691;4961
251290;201805;5584;14508;5261;14096;297;1058;4411;11398;4708;12456
251300;201805;778;2447;728;2367;16;60;610;1982;626;2042
251310;201805;2782;8136;2536;7756;80;366;2043;6098;2123;6464
251315;201805;1619;5264;1505;5066;83;295;1184;3945;1267;4240
251320;201805;1704;4574;1216;3750;42;149;861;2650;903;2799
251330;201805;1909;4769;1571;4355;36;136;1427;3941;1463;4077
251335;201805;1166;3927;1072;3775;38;169;892;3093;930;3262
251340;201805;3464;9293;2893;8532;125;427;2195;6402;2320;6829
251350;201805;1101;3366;1009;3210;34;154;821;2529;855;2683
251360;201805;1791;5285;1484;4862;23;107;1275;4197;1298;4304
251365;201805;724;2101;581;1793;13;48;447;1370;460;1418
251370;201805;22390;64963;21002;63011;2182;7011;15071;44911;17253;51922
251380;201805;1221;3638;1076;3393;21;100;912;2772;933;2872
251385;201805;725;1894;571;1623;23;69;419;1132;442;1201
251390;201805;6055;19018;5277;17567;915;3220;2897;9548;3812;12768
251392;201805;980;2789;838;2546;30;130;630;1862;660;1992
251394;201805;628;1990;534;1823;24;107;412;1386;436;1493
251396;201805;724;2008;625;1843;33;89;426;1234;459;1323
251398;201805;901;2433;684;2054;23;95;486;1407;509;1502
251400;201805;1153;3064;949;2785;32;117;712;2022;744;2139
251410;201805;1630;3959;1340;3528;22;86;1123;2868;1145;2954
251420;201805;1875;5159;1568;4803;58;243;1241;3705;1299;3948
251430;201805;1545;4957;1379;4685;39;194;1196;4018;1235;4212
251440;201805;1103;3240;902;2844;18;66;726;2283;744;2349
251445;201805;1509;4426;1413;4292;72;292;1156;3401;1228;3693
251450;201805;4407;13409;4017;12863;80;361;3356;10642;3436;11003
251455;201805;979;3037;882;2848;46;199;655;2070;701;2269
251460;201805;878;2591;783;2437;27;97;643;2021;670;2118
251465;201805;439;1352;369;1198;15;71;277;879;292;950
251470;201805;1157;3278;891;2715;72;231;547;1612;619;1843
251480;201805;919;2505;787;2290;21;96;586;1641;607;1737
251490;201805;1855;5147;1524;4664;80;264;1066;3225;1146;3489
251500;201805;1751;5361;1654;5188;73;293;1415;4370;1488;4663
251510;201805;2419;7829;2157;7270;187;731;1412;4643;1599;5374
251520;201805;951;2567;726;2105;76;209;462;1316;538;1525
251530;201805;13073;33459;11457;31366;143;701;10212;27506;10355;28207
251540;201805;2783;8518;2571;8117;118;439;2055;6352;2173;6791
251550;201805;3562;8881;2863;7966;75;237;2402;6662;2477;6899
251560;201805;600;1831;540;1737;90;308;326;1010;416;1318
251570;201805;904;2634;751;2324;18;79;562;1667;580;1746
251580;201805;1877;4779;1670;4490;110;306;1365;3585;1475;3891
251590;201805;1575;4257;1387;4018;58;195;1112;3157;1170;3352
251593;201805;947;2831;867;2706;98;328;535;1623;633;1951
251597;201805;1990;5866;1887;5732;23;87;1720;5176;1743;5263
251600;201805;6365;17838;5723;16851;191;620;4768;13844;4959;14464
251610;201805;3334;9624;2878;8781;306;882;1952;6017;2258;6899
251615;201805;1153;3082;933;2709;25;97;713;2005;738;2102
251620;201805;17227;41922;14200;38348;228;531;12010;33888;12238;34419
251630;201805;4651;11429;3776;10199;211;591;2880;7711;3091;8302
251640;201805;2081;6135;1902;5789;65;286;1625;4831;1690;5117
251650;201805;4094;11105;3647;10528;171;550;3091;8880;3262;9430
251660;201805;3474;10688;3075;9966;78;382;2559;8105;2637;8487
251670;201805;4223;12069;3750;11421;40;193;3443;10473;3483;10666
251675;201805;658;1983;604;1908;91;314;391;1220;482;1534
251680;201805;2675;7468;2185;6741;49;181;1761;5410;1810;5591
251690;201805;3255;9451;2847;8668;77;272;2085;6210;2162;6482
251700;201805;1871;5889;1741;5713;65;308;1466;4691;1531;4999
251710;201805;836;2196;563;1611;54;187;305;833;359;1020
251720;201805;1369;4006;1143;3586;31;136;875;2653;906;2789
251740;201805;668;1861;519;1591;35;121;358;1053;393;1174
260005;201805;27781;62055;22834;55420;2338;5686;16073;38552;18411;44238
260010;201805;9744;25954;8111;23542;522;1553;5022;14870;5544;16423
260020;201805;6694;16507;5654;14993;135;549;4666;12156;4801;12705
260030;201805;6289;17083;5399;15680;225;763;4277;12375;4502;13138
260040;201805;7924;22071;6653;20119;709;2159;4403;13445;5112;15604
260050;201805;12174;34650;11105;33362;390;1267;9649;29461;10039;30728
260060;201805;3876;10388;3343;9485;230;630;2547;7251;2777;7881
260070;201805;10175;27419;8925;25493;613;2033;6630;18591;7243;20624
260080;201805;6590;15696;5723;14423;182;550;4687;11523;4869;12073
260090;201805;5104;13364;4594;12686;635;1715;3249;9064;3884;10779
260100;201805;3215;8664;2712;7926;98;364;2219;6439;2317;6803
260105;201805;5251;14167;4692;13372;150;591;3912;10906;4062;11497
260110;201805;22377;60140;20284;57326;1054;3224;17141;48085;18195;51309
260120;201805;13676;38392;11785;35321;1711;5226;7148;21916;8859;27142
260130;201805;3054;8265;2779;7834;236;739;2041;5611;2277;6350
260140;201805;12903;30688;11138;28450;611;1622;9154;23301;9765;24923
260150;201805;3400;8523;2935;7954;148;501;2469;6562;2617;7063
260160;201805;6195;17379;5305;16191;126;525;4588;14092;4714;14617
260170;201805;17451;45946;15547;43191;1569;4166;11530;32286;13099;36452
260180;201805;3291;9468;2978;8998;140;486;2519;7528;2659;8014
260190;201805;17165;37211;15057;34706;226;675;13175;29816;13401;30491
260200;201805;11117;27465;9750;25748;398;1115;8471;22324;8869;23439
260210;201805;11982;34645;10258;31844;349;1377;8242;25486;8591;26863
260220;201805;9961;25646;9392;24930;234;788;8468;22197;8702;22985
260230;201805;10056;26579;8856;24885;322;1049;7143;19866;7465;20915
260240;201805;2791;8350;2447;7792;200;680;1847;5863;2047;6543
260250;201805;2177;5971;1884;5545;82;284;1489;4277;1571;4561
260260;201805;12494;34112;10988;31781;492;1785;8606;24435;9098;26220
260270;201805;3685;10059;3322;9540;167;721;2597;7197;2764;7918
260280;201805;12985;40287;11826;38628;532;2026;10099;32922;10631;34948
260290;201805;37169;101365;32761;94457;4284;12800;20694;59108;24978;71908
260300;201805;9134;26207;8041;24604;267;1195;6523;19831;6790;21026
260310;201805;4535;12544;4060;11863;469;1286;2917;8700;3386;9986
260320;201805;7381;22175;6598;20795;281;952;5356;16826;5637;17778
260330;201805;2498;7865;2266;7394;70;259;1811;5778;1881;6037
260340;201805;1985;5487;1743;5130;29;133;1526;4434;1555;4567
260345;201805;23845;66814;20766;61950;4244;13507;9300;26990;13544;40497
260350;201805;4989;12790;4494;12143;135;438;3916;10470;4051;10908
260360;201805;2504;6803;2279;6402;71;315;1560;4292;1631;4607
260370;201805;5435;16189;4762;15007;223;881;3646;11341;3869;12222
260380;201805;4865;15107;4239;14062;206;795;3151;10337;3357;11132
260390;201805;4284;13280;3672;12016;239;852;2488;7997;2727;8849
260392;201805;3419;11068;3071;10609;152;824;2528;8607;2680;9431
260400;201805;15263;38955;13596;36655;917;2766;10314;27111;11231;29877
260410;201805;61980;164095;50498;147108;10804;33346;21811;64835;32615;98181
260415;201805;3904;11245;3369;10232;120;548;2507;7336;2627;7884
260420;201805;12829;27973;11036;25935;200;589;9963;23205;10163;23794
260430;201805;2886;9017;2488;8250;128;485;1750;5737;1878;6222
260440;201805;3560;9933;3091;9086;160;590;2378;6802;2538;7392
260450;201805;5445;14415;5002;13860;217;549;4264;11940;4481;12489
260460;201805;5430;17172;4753;15828;599;2214;2775;9068;3374;11282
260470;201805;4919;13281;4211;12464;134;350;3718;11281;3852;11631
260480;201805;4151;11204;3515;10277;352;1173;2321;6880;2673;8053
260490;201805;5172;12696;4519;11612;102;359;3929;9832;4031;10191
260500;201805;5983;15874;5071;14508;527;1456;3409;9859;3936;11315
260510;201805;9293;23299;7982;21511;200;672;7062;18856;7262;19528
260515;201805;4425;12743;3392;10715;152;556;2237;6917;2389;7473
260520;201805;17467;42133;15701;39759;977;2539;12694;31821;13671;34360
260530;201805;9483;28155;8242;26168;225;1003;7010;22059;7235;23062
260540;201805;6611;15179;5913;14344;491;999;4984;12338;5475;13337
260545;201805;46;140;23;93;5;19;5;21;10;40
260550;201805;2876;8671;2397;7714;184;771;1483;4669;1667;5440
260560;201805;6053;15798;5231;14640;137;566;4442;12219;4579;12785
260570;201805;7228;21153;6497;20096;519;1690;5095;15739;5614;17429
260580;201805;4162;10573;3717;9925;42;170;3378;8931;3420;9101
260590;201805;6713;16065;5760;14986;269;742;4855;12675;5124;13417
260600;201805;29775;81132;24824;73283;1406;4740;18152;52876;19558;57616
260610;201805;6651;18672;6151;17960;478;1493;4637;13429;5115;14922
260620;201805;15125;42815;13645;40550;1821;5899;8775;25577;10596;31476
260630;201805;2364;6463;1962;5827;45;197;1617;4754;1662;4951
260640;201805;19112;47057;16552;43996;1068;3095;12781;33692;13849;36787
260650;201805;5523;16067;4697;14809;187;802;3896;12151;4083;12953
260660;201805;7395;19898;6419;18631;176;748;5431;15501;5607;16249
260670;201805;2262;5931;1859;5336;93;249;1330;3793;1423;4042
260680;201805;24162;62214;20526;56615;2367;6730;12343;33677;14710;40407
260690;201805;3626;9556;3015;8592;121;406;2407;6783;2528;7189
260700;201805;5872;17493;5633;17216;24;56;5488;16939;5512;16995
260710;201805;1338;3619;1251;3507;60;205;910;2613;970;2818
260720;201805;20361;57532;18203;54218;2964;9042;10871;32129;13835;41171
260730;201805;7102;21708;6345;20595;376;1449;5144;16394;5520;17843
260740;201805;1338;3815;1155;3516;21;86;937;2858;958;2944
260750;201805;6890;19616;5982;18430;143;423;5386;16850;5529;17273
260760;201805;5359;13316;4696;12484;212;617;3807;10182;4019;10799
260765;201805;7619;23912;6850;22743;716;2950;4611;14886;5327;17836
260770;201805;3792;10042;3283;9190;102;338;2597;7187;2699;7525
260775;201805;5113;14207;4655;13526;270;1039;3507;9854;3777;10893
260780;201805;3681;11232;3331;10629;393;1396;2117;6623;2510;8019
260790;201805;112355;266252;96241;244062;16512;41498;56083;141740;72595;183238
260795;201805;3095;8538;2694;7931;143;468;2024;5989;2167;6457
260800;201805;5417;12915;4928;12209;132;429;4383;10515;4515;10944
260805;201805;3639;10719;3075;9726;210;765;2175;6771;2385;7536
260810;201805;6552;18221;5959;17111;575;1654;4297;12128;4872;13782
260820;201805;4345;10963;3853;10254;262;908;2924;7508;3186;8416
260825;201805;2854;8855;2502;8233;146;559;1842;6034;1988;6593
260830;201805;4235;12563;3553;11286;467;1361;2308;7548;2775;8909
260840;201805;4194;11493;3708;10771;190;558;3035;8759;3225;9317
260845;201805;4070;11316;3764;10769;284;813;2790;7941;3074;8754
260850;201805;4940;14792;4281;13430;511;1666;2509;7729;3020;9395
260860;201805;3575;10351;3021;9324;114;415;2391;7256;2505;7671
260870;201805;4405;11069;3819;10329;128;486;3307;8750;3435;9236
260875;201805;6474;17418;5514;15894;735;2084;3558;10374;4293;12458
260880;201805;9811;28100;8619;26067;423;1296;6887;20957;7310;22253
260890;201805;13266;35972;11956;34018;848;2728;8669;24195;9517;26923
260900;201805;5386;16115;4594;14724;310;1193;3091;9719;3401;10912
260910;201805;3121;8906;2764;8323;114;406;2130;6342;2244;6748
260915;201805;5006;15207;4478;14555;73;308;4061;13267;4134;13575
260920;201805;3298;9327;2957;8888;118;383;2495;7563;2613;7946
260930;201805;3591;11721;3185;10996;207;797;2403;8274;2610;9071
260940;201805;14407;35955;12722;33419;983;2834;9323;24012;10306;26846
260950;201805;6486;18906;5275;16524;661;2241;2718;8103;3379;10344
260960;201805;61948;151900;51419;136886;7610;21371;29167;76343;36777;97714
260970;201805;5093;14270;4580;13596;174;506;3579;10746;3753;11252
260980;201805;4324;13213;3935;12715;74;292;3575;11595;3649;11887
260990;201805;17306;50569;15143;47580;921;3293;11692;36613;12613;39906
261000;201805;15465;39570;13183;36327;758;2480;9626;26402;10384;28882
261010;201805;2497;6679;2223;6326;77;189;1983;5666;2060;5855
261020;201805;6423;18240;5549;16587;378;1223;4220;12302;4598;13525
261030;201805;4064;11588;3544;10741;210;606;2773;8384;2983;8990
261040;201805;5097;15789;4257;14011;256;984;3037;9770;3293;10754
261050;201805;7501;20756;6827;19606;627;1676;4676;13529;5303;15205
261060;201805;13018;34926;11652;32950;679;2112;9218;25815;9897;27927
261070;201805;56225;128933;47261;116661;3796;9120;34038;83219;37834;92339
261080;201805;5867;15708;5515;15206;194;553;4986;13767;5180;14320
261090;201805;17063;43878;15496;41784;470;1547;13248;35423;13718;36970
261100;201805;8030;23889;7048;22292;706;2392;4844;15429;5550;17821
261110;201805;59617;173814;51472;160417;11155;36430;24430;77112;35585;113542
261120;201805;3802;9770;3298;9135;73;235;2940;8163;3013;8398
261130;201805;7571;18552;6709;17472;140;421;5960;15426;6100;15847
261140;201805;3414;8519;3065;8027;239;690;2370;6112;2609;6802
261150;201805;5318;14530;4711;13577;142;525;4014;11416;4156;11941
261153;201805;1954;5858;1678;5404;84;324;1143;3658;1227;3982
261160;201805;204959;504563;173828;460196;43017;117804;69409;187377;112426;305181
261170;201805;5871;15643;5339;14863;336;919;4252;11829;4588;12748
261180;201805;9864;25928;8842;24547;632;1952;6281;17231;6913;19183
261190;201805;4922;14907;4466;14218;347;1398;3221;9956;3568;11354
261200;201805;3370;8025;2964;7510;215;557;2379;5987;2594;6544
261210;201805;1896;4751;1644;4390;55;163;1437;3824;1492;3987
261220;201805;13636;40272;11375;35850;1535;5289;6374;19913;7909;25202
261230;201805;4610;13543;3901;12634;84;353;3279;10738;3363;11091
261240;201805;4981;13445;4402;12524;299;822;3494;9937;3793;10759
261245;201805;3474;10285;2984;9415;118;543;2356;7176;2474;7719
261247;201805;2973;9047;2526;8227;147;565;1816;5881;1963;6446
261250;201805;19668;48327;17211;45347;2519;6291;11682;31880;14201;38171
261255;201805;3981;12099;3475;11128;166;741;2659;8242;2825;8983
261260;201805;12773;34898;11081;32753;369;1444;9377;27595;9746;29039
261270;201805;3979;10985;3556;10327;242;791;2769;7858;3011;8649
261280;201805;2547;7446;2277;6979;92;398;1802;5368;1894;5766
261290;201805;2933;8042;2548;7543;121;456;2022;6004;2143;6460
261300;201805;11524;34151;9879;31190;691;2629;6942;21429;7633;24058
261310;201805;7322;20825;6528;19639;1044;3268;4105;12199;5149;15467
261320;201805;5870;17255;5168;16010;110;440;4282;13077;4392;13517
261330;201805;5795;15199;5352;14608;201;729;4609;12365;4810;13094
261340;201805;4090;12445;3561;11664;207;888;2658;8604;2865;9492
261350;201805;8305;25454;7655;24374;147;720;6311;19736;6458;20456
261360;201805;8276;20849;7122;19219;330;968;5727;15144;6057;16112
261370;201805;19510;53825;17295;50543;3120;9130;9832;29056;12952;38186
261380;201805;3961;12761;3596;12036;505;1873;2256;7422;2761;9295
261390;201805;16171;47583;14022;43964;1455;4947;8802;27522;10257;32469
261400;201805;4663;15371;4094;14155;182;814;3006;10192;3188;11006
261410;201805;9228;24457;7883;22279;553;1575;6236;17583;6789;19158
261420;201805;7101;22849;6607;22189;1045;3925;4220;14104;5265;18029
261430;201805;3453;10105;2914;9256;120;422;2339;7401;2459;7823
261440;201805;1501;4638;1314;4261;45;223;930;2930;975;3153
261450;201805;14057;39301;12984;37734;299;1129;11050;32011;11349;33140
261460;201805;7067;20103;6492;19269;239;822;5581;16513;5820;17335
261470;201805;4197;10911;3759;10333;49;236;3127;8623;3176;8859
261480;201805;4578;14780;4030;13845;237;952;3067;10320;3304;11272
261485;201805;4988;14615;4349;13572;394;1430;2967;9057;3361;10487
261500;201805;5548;14985;4899;14098;472;1269;3413;10134;3885;11403
261510;201805;1792;5588;1545;5128;87;321;1142;3817;1229;4138
261520;201805;2537;7878;2379;7572;84;329;1617;5253;1701;5582
261530;201805;10566;33172;9084;30218;1317;4989;4245;13908;5562;18897
261540;201805;7438;22377;6756;21295;1154;3619;3910;12661;5064;16280
261550;201805;3592;9748;3182;9102;236;778;2330;6544;2566;7322
261560;201805;7471;23133;6605;21875;420;1696;4964;16405;5384;18101
261570;201805;3417;9663;2846;8696;216;782;1932;5765;2148;6547
261580;201805;6429;17581;5843;16718;141;621;5229;14745;5370;15366
261590;201805;2687;7083;2192;6344;96;289;1681;4896;1777;5185
261600;201805;5316;13794;4458;12515;438;1168;3007;8654;3445;9822
261610;201805;2464;6673;2081;6088;84;310;1596;4643;1680;4953
261618;201805;2535;6635;2267;6269;100;307;1845;5051;1945;5358
261620;201805;3946;11918;3679;11487;807;2390;2192;7133;2999;9523
261630;201805;6886;19634;5823;17650;462;1700;3669;10664;4131;12364
261640;201805;36595;85298;32276;79970;1884;4150;25602;65136;27486;69286
261650;201805;4103;10892;3661;10310;152;558;2735;7692;2887;8250
270010;201805;4322;15287;3873;14441;165;928;3069;11228;3234;12156
270020;201805;3994;10330;3550;9742;229;728;2882;7723;3111;8451
270030;201805;34599;98180;30284;91174;4620;13873;18702;56835;23322;70708
270040;201805;11259;31101;9797;29321;482;1753;8048;23996;8530;25749
270050;201805;5395;12702;4630;11846;195;508;4082;10467;4277;10975
270060;201805;2055;5473;1798;5145;177;504;1319;3839;1496;4343
270070;201805;4545;13348;4008;12589;146;683;3371;10335;3517;11018
270080;201805;1389;4013;1160;3597;87;274;848;2549;935;2823
270090;201805;1937;6023;1713;5578;73;333;1328;4175;1401;4508
270100;201805;5547;15599;4882;14585;293;1096;3859;11317;4152;12413
270110;201805;3152;7996;2582;7346;173;508;2027;5911;2200;6419
270120;201805;3070;8357;2686;7885;87;344;2367;6900;2454;7244
270130;201805;5351;14453;4662;13664;250;822;3812;11251;4062;12073
270135;201805;2000;4996;1740;4692;74;202;1559;4207;1633;4409
270140;201805;10253;23664;8353;21101;409;1536;6756;16159;7165;17695
270150;201805;2636;8185;2529;8054;15;46;2479;7907;2494;7953
270160;201805;5266;15989;4645;15215;83;469;4151;13439;4234;13908
270170;201805;3598;10887;3144;10251;282;1238;2259;7083;2541;8321
270180;201805;2261;7158;2073;6895;57;268;1786;5850;1843;6118
270190;201805;1702;5264;1570;5083;76;295;1283;4140;1359;4435
270200;201805;2536;7828;2211;7394;152;627;1627;5305;1779;5932
270210;201805;5533;13979;4873;13186;163;521;4344;11639;4507;12160
270220;201805;1393;4028;1203;3748;224;771;684;2073;908;2844
270230;201805;9690;28961;8271;26642;842;3198;5354;16747;6196;19945
270235;201805;5877;18656;5277;17640;231;967;4256;14082;4487;15049
270240;201805;10643;29467;8771;27070;1082;3661;6094;18746;7176;22407
270250;201805;2879;7528;2552;7085;284;712;1887;5320;2171;6032
270255;201805;4669;13599;3585;11581;194;805;2546;8045;2740;8850
270260;201805;5615;17135;5256;16572;157;751;4533;13858;4690;14609
270270;201805;1046;2858;956;2737;151;444;632;1790;783;2234
270280;201805;3847;9800;3128;8873;425;798;2194;6605;2619;7403
270290;201805;7852;25538;7116;24326;326;1531;5877;19762;6203;21293
270300;201805;4108;11379;3277;10467;261;875;2359;7647;2620;8522
270310;201805;7188;20874;6270;19431;176;923;5234;15687;5410;16610
270320;201805;5814;17396;5250;16376;645;2136;3592;10991;4237;13127
270330;201805;3814;12888;3482;12403;282;1101;2716;9700;2998;10801
270340;201805;1633;4711;1393;4390;75;293;1126;3477;1201;3770
270350;201805;1911;4776;1625;4421;177;525;1169;3192;1346;3717
270360;201805;2308;6348;2102;6103;91;261;1889;5541;1980;5802
270370;201805;1426;4546;1301;4317;51;227;1024;3361;1075;3588
270375;201805;3039;7554;2573;6973;44;139;2334;6315;2378;6454
270380;201805;5704;16943;4960;15937;467;1579;3524;11542;3991;13121
270390;201805;1221;3243;1022;2964;31;133;817;2322;848;2455
270400;201805;6247;17625;5397;16270;227;852;4098;11950;4325;12802
270410;201805;4515;13805;4025;12957;254;970;3094;9821;3348;10791
270420;201805;5699;17328;5274;16755;185;807;4380;13664;4565;14471
270430;201805;138393;358525;112987;324288;26308;79624;45136;132059;71444;211683
270440;201805;4884;13573;4215;12738;130;556;3467;10427;3597;10983
270450;201805;6566;18747;5953;17995;290;1108;4912;14690;5202;15798
270460;201805;3539;8494;3121;7994;65;230;2853;7174;2918;7404
270470;201805;10897;32433;9678;30633;938;3206;6872;21982;7810;25188
270480;201805;2824;8042;2438;7437;183;694;1867;5495;2050;6189
270490;201805;988;2912;878;2777;58;203;681;2140;739;2343
270500;201805;4844;15330;4443;14803;177;838;3701;12147;3878;12985
270510;201805;5820;16325;5074;15289;530;1990;3571;10242;4101;12232
270520;201805;3906;11583;3181;10324;841;2857;1088;3746;1929;6603
270530;201805;1144;3494;1042;3332;59;186;794;2543;853;2729
270540;201805;2131;6543;1908;6250;81;392;1605;5134;1686;5526
270550;201805;6798;18531;5658;17251;509;1473;4272;13409;4781;14882
270560;201805;3159;8812;2817;8326;156;540;2203;6401;2359;6941
270570;201805;3968;11853;3428;10999;179;728;2712;8532;2891;9260
270580;201805;2217;6499;2063;6274;87;255;1810;5521;1897;5776
270590;201805;1526;4671;1436;4563;6;21;1401;4460;1407;4481
270600;201805;2827;8921;2521;8405;101;516;2124;6894;2225;7410
270610;201805;3571;9829;3062;9177;103;394;2660;7836;2763;8230
270620;201805;1324;4161;1212;3964;50;213;1005;3203;1055;3416
270630;201805;15175;42454;13489;39809;1095;3520;10270;30149;11365;33669
270640;201805;5614;16406;4869;15266;214;869;3926;11998;4140;12867
270642;201805;2346;7855;2160;7580;148;751;1701;5758;1849;6509
270644;201805;3270;8563;2708;7821;237;695;2009;5881;2246;6576
270650;201805;3356;10112;3017;9629;416;1596;2071;6343;2487;7939
270660;201805;2192;5503;1746;4883;77;241;1295;3596;1372;3837
270670;201805;15787;39279;13537;36573;919;2553;10803;29171;11722;31724
270680;201805;5024;13074;4536;12525;121;235;4224;11789;4345;12024
270690;201805;9462;24093;8003;22408;1223;3137;5646;16243;6869;19380
270700;201805;547;1701;471;1559;44;178;319;1042;363;1220
270710;201805;5841;17734;5407;17166;267;1163;4527;14076;4794;15239
270720;201805;3360;10559;2995;9932;89;530;2534;8202;2623;8732
270730;201805;7251;18283;6691;17671;377;970;5546;15398;5923;16368
270740;201805;2331;6353;2088;6040;100;358;1745;4970;1845;5328
270750;201805;5372;15210;4748;14315;277;1013;3811;11384;4088;12397
270760;201805;3393;9751;2986;9151;71;350;2552;7701;2623;8051
270770;201805;20763;51811;16524;46589;3030;8078;9280;28012;12310;36090
270780;201805;1777;5372;1674;5225;98;333;1394;4367;1492;4700
270790;201805;1584;4671;1394;4400;139;454;941;2984;1080;3438
270800;201805;10893;31053;9848;29563;452;1896;8291;24232;8743;26128
270810;201805;3213;9785;2589;8671;188;768;1790;5920;1978;6688
270820;201805;1721;5307;1459;4858;113;434;1070;3508;1183;3942
270830;201805;5546;13563;4624;12422;257;770;3690;9918;3947;10688
270840;201805;8243;24747;7379;23545;210;1175;6447;19988;6657;21163
270850;201805;8409;22200;7601;21154;520;1824;6192;16609;6712;18433
270860;201805;11755;30200;9778;27786;625;2054;7640;21386;8265;23440
270870;201805;2089;6160;1807;5656;179;619;1278;3991;1457;4610
270880;201805;8161;24872;7383;23741;277;1218;6103;19301;6380;20519
270890;201805;2473;7043;2170;6606;148;526;1583;4717;1731;5243
270895;201805;2920;9841;2729;9580;92;518;2386;8162;2478;8680
270900;201805;1800;4770;1409;4150;53;186;1109;3190;1162;3376
270910;201805;3669;11177;3204;10381;142;593;2415;7688;2557;8281
270915;201805;8956;27995;7664;25652;911;3561;4886;15936;5797;19497
270920;201805;5682;17751;5314;17178;248;1163;4410;13784;4658;14947
270930;201805;17174;42354;13597;38079;2253;5926;8784;25425;11037;31351
270940;201805;5944;17787;5336;17018;301;1374;4091;12737;4392;14111
280010;201805;677;1870;576;1684;26;104;394;1054;420;1158
280020;201805;4742;12780;4082;11699;528;1466;2683;7741;3211;9207
280030;201805;72733;178814;58445;158472;14830;41340;22225;62928;37055;104268
280040;201805;3110;8897;2749;8335;278;892;1908;5730;2186;6622
280050;201805;3874;11413;3406;10641;586;1960;1984;6182;2570;8142
280060;201805;5205;14769;4238;13218;773;2577;2075;6645;2848;9222
280067;201805;6837;18123;5802;16483;514;1539;3990;11213;4504;12752
280070;201805;1917;5977;1831;5832;117;388;1521;4806;1638;5194
280100;201805;3666;10718;3236;9999;347;1172;2255;6922;2602;8094
280110;201805;1304;3859;1182;3647;48;198;979;2914;1027;3112
280120;201805;7595;22898;6883;21696;730;2164;5103;16358;5833;18522
280130;201805;8615;21478;7709;20190;722;1928;5829;15401;6551;17329
280140;201805;5545;14023;4989;13245;299;822;4113;10892;4412;11714
280150;201805;3785;10203;3449;9738;228;617;2798;7897;3026;8514
280160;201805;1246;3669;1030;3290;140;470;637;1993;777;2463
280170;201805;5115;13944;4649;13296;274;770;3818;10986;4092;11756
280190;201805;1223;2898;1019;2604;59;177;806;1995;865;2172
280200;201805;1323;3595;1082;3188;97;348;763;2208;860;2556
280210;201805;14972;40268;13136;37684;2114;6345;7641;22105;9755;28450
280220;201805;1773;4837;1545;4527;44;214;1258;3672;1302;3886
280230;201805;3599;9737;3227;9202;221;705;2453;6858;2674;7563
280240;201805;3399;9231;3079;8739;77;336;2639;7310;2716;7646
280250;201805;846;2178;670;1904;73;239;379;1016;452;1255
280260;201805;2103;5368;1936;5165;45;132;1794;4789;1839;4921
280270;201805;2246;6607;1993;6208;115;424;1670;5111;1785;5535
280280;201805;4063;12993;3670;12386;543;1622;2393;8532;2936;10154
280290;201805;17165;48293;15298;45595;1697;5590;9923;29619;11620;35209
280300;201805;10157;27667;8935;26287;363;1300;6988;21467;7351;22767
280310;201805;1365;3678;1154;3307;38;133;854;2369;892;2502
280320;201805;8640;24790;7627;23222;856;2807;4993;14925;5849;17732
280330;201805;4773;12179;4105;11198;272;811;3146;8470;3418;9281
280340;201805;5143;11406;4446;10620;282;603;3781;9221;4063;9824
280350;201805;23046;59565;20041;55129;1867;5316;14276;39066;16143;44382
280360;201805;5834;17001;5242;15957;901;2787;2877;8877;3778;11664
280370;201805;2090;5285;1719;4672;86;230;1346;3616;1432;3846
280380;201805;1000;2885;875;2697;94;325;584;1775;678;2100
280390;201805;3446;9159;2823;8101;140;460;2169;6114;2309;6574
280400;201805;3972;10669;3486;9939;624;1694;2026;6002;2650;7696
280410;201805;2125;6353;1749;5648;193;646;1033;3266;1226;3912
280420;201805;4239;11715;3867;11183;109;374;3454;9946;3563;10320
280430;201805;2076;5285;1829;4940;72;242;1433;3807;1505;4049
280440;201805;4599;12565;4048;11790;241;782;3229;9193;3470;9975
280445;201805;2299;6027;2073;5618;47;145;1560;4068;1607;4213
280450;201805;10092;23703;9045;22360;399;764;7808;19594;8207;20358
280460;201805;6612;16548;6039;15727;536;1367;4846;12616;5382;13983
280470;201805;1779;5151;1574;4783;81;279;1169;3520;1250;3799
280480;201805;36076;94960;32243;89502;3248;9915;22456;61250;25704;71165
280490;201805;3858;11125;3291;10164;103;449;2488;7463;2591;7912
280500;201805;945;2389;818;2206;49;172;668;1775;717;1947
280510;201805;2555;7089;2233;6615;113;446;1617;4755;1730;5201
280520;201805;1695;4422;1504;4163;82;218;1232;3402;1314;3620
280530;201805;2660;6535;2320;6129;137;371;1888;4983;2025;5354
280540;201805;9025;24661;8275;23613;210;945;7286;20314;7496;21259
280550;201805;6649;16396;5515;14655;282;810;4291;11173;4573;11983
280560;201805;7122;20522;6731;19959;192;748;5872;17140;6064;17888
280570;201805;6273;16177;5192;14771;270;920;3798;10703;4068;11623
280580;201805;5392;15580;4628;14292;587;1743;3080;9646;3667;11389
280590;201805;2978;7369;2491;6752;148;597;1810;4651;1958;5248
280600;201805;3385;9687;3050;9206;223;770;2238;6683;2461;7453
280610;201805;2556;6486;2300;6134;197;513;1817;4810;2014;5323
280620;201805;5279;14076;4589;13045;431;1053;3335;9868;3766;10921
280630;201805;3625;11235;3293;10715;209;768;2577;8444;2786;9212
280640;201805;2375;6738;2195;6539;48;125;2049;6167;2097;6292
280650;201805;1255;3373;990;2975;87;299;692;2033;779;2332
280660;201805;3065;7547;2726;7149;128;343;2357;6171;2485;6514
280670;201805;18735;44343;16480;41403;1278;3330;12537;31485;13815;34815
280680;201805;2788;7047;2376;6384;171;385;1753;4690;1924;5075
280690;201805;965;2530;829;2335;46;132;614;1708;660;1840
280700;201805;1084;2895;942;2665;19;63;730;2036;749;2099
280710;201805;14323;33518;12441;31345;561;945;10858;28194;11419;29139
280720;201805;2784;6306;2276;5721;144;373;1512;4078;1656;4451
280730;201805;1094;2782;980;2619;70;216;749;1979;819;2195
280740;201805;13715;35161;11740;32029;1165;3198;7892;21377;9057;24575
280750;201805;3462;10064;3113;9432;183;673;2261;6727;2444;7400
280760;201805;5955;17051;5287;15971;653;1971;3423;10630;4076;12601
290010;201805;3053;6647;2137;5230;13;46;1770;4127;1783;4173
290020;201805;5168;14514;4855;14086;316;631;4189;12446;4505;13077
290030;201805;3847;10052;3352;9470;200;527;2791;7927;2991;8454
290035;201805;5166;11695;4156;10376;303;579;3272;8501;3575;9080
290040;201805;4386;10816;3673;9965;144;427;2872;7976;3016;8403
290050;201805;2204;7140;1874;6495;140;550;1294;4446;1434;4996
290060;201805;1287;3276;994;2800;101;347;660;1782;761;2129
290070;201805;33597;80276;29081;74372;2909;7566;19444;50257;22353;57823
290080;201805;5625;16750;4746;15482;568;1915;3140;10424;3708;12339
290090;201805;2295;4435;1714;3820;46;101;1554;3456;1600;3557
290100;201805;9329;25666;7912;23492;1001;2809;4873;14888;5874;17697
290110;201805;5023;14039;4609;13311;483;1438;3157;9044;3640;10482
290115;201805;4372;12691;3775;11822;229;766;2950;9275;3179;10041
290120;201805;6978;17213;5730;15685;152;550;4896;13176;5048;13726
290130;201805;4603;11620;3699;10489;121;493;2959;8217;3080;8710
290135;201805;4455;10610;3630;9286;244;664;2694;6701;2938;7365
290140;201805;4641;12866;3755;11719;131;475;3248;10128;3379;10603
290150;201805;2259;6532;2120;6305;184;591;1597;4636;1781;5227
290160;201805;3176;7806;2906;7463;354;747;2185;5731;2539;6478
290170;201805;2862;8255;2640;7974;78;301;2384;7143;2462;7444
290180;201805;2939;8187;2448;7397;94;343;1933;5772;2027;6115
290190;201805;3953;12069;3582;11534;171;723;2877;9102;3048;9825
290195;201805;2343;6109;1882;5407;52;238;1526;4346;1578;4584
290200;201805;4004;11607;3404;10648;214;691;2644;8250;2858;8941
290205;201805;3429;9029;3025;8437;119;444;2441;6616;2560;7060
290210;201805;13302;38335;11859;36258;1074;2991;8963;28229;10037;31220
290220;201805;2723;7136;2474;6819;165;505;2020;5487;2185;5992
290225;201805;3461;7460;2826;6785;35;92;2654;6380;2689;6472
290230;201805;2452;6989;2242;6741;65;259;1960;5861;2025;6120
290240;201805;3706;9627;3076;8823;129;437;2502;7079;2631;7516
290250;201805;4060;12004;3651;11470;129;346;3055;10066;3184;10412
290260;201805;5332;13892;4366;12469;232;794;3451;9754;3683;10548
290265;201805;3593;10603;2994;9508;128;526;2266;7094;2394;7620
290270;201805;11830;40776;11185;39676;768;3251;8720;30549;9488;33800
290280;201805;5922;17867;5254;16755;388;1362;3792;11991;4180;13353
290290;201805;9894;29780;8366;26984;791;2665;5746;18483;6537;21148
290300;201805;4447;12238;3222;9917;187;656;2269;6984;2456;7640
290310;201805;1526;4080;1284;3742;104;378;929;2637;1033;3015
290320;201805;24536;67267;20598;61646;5177;15619;9557;29867;14734;45486
290323;201805;3634;10047;3240;9500;75;256;2687;7795;2762;8051
290327;201805;4300;12564;3718;11463;325;978;2636;8169;2961;9147
290330;201805;2045;4594;1718;4236;49;101;1539;3820;1588;3921
290340;201805;5708;15508;4625;14117;693;2198;3119;9592;3812;11790
290350;201805;4694;13812;3988;12605;309;1025;2854;9104;3163;10129
290360;201805;5009;13686;4351;12817;123;401;3738;11039;3861;11440
290370;201805;5202;13087;3999;11509;229;594;3050;8946;3279;9540
290380;201805;5546;15284;4779;14202;127;402;4116;12334;4243;12736
290390;201805;14851;43063;12757;39905;1410;4501;8489;27059;9899;31560
290395;201805;2762;8456;2338;7694;72;345;1822;5952;1894;6297
290400;201805;3624;10187;2945;9092;129;489;2178;6590;2307;7079
290405;201805;4710;14007;3948;12636;271;915;2737;8884;3008;9799
290410;201805;5681;16100;4567;14259;157;715;3483;10473;3640;11188
290420;201805;2977;8541;2488;7756;145;459;1907;5958;2052;6417
290430;201805;3118;9080;2598;8219;333;1089;1639;5196;1972;6285
290440;201805;2822;7247;2119;6192;65;213;1547;4582;1612;4795
290450;201805;3284;9101;2707;8251;134;487;2081;6235;2215;6722
290460;201805;12027;33970;10422;30947;2700;8211;4134;12145;6834;20356
290470;201805;4408;11668;3312;10029;423;1443;1790;5477;2213;6920
290475;201805;6269;18783;5388;17183;113;557;4304;13428;4417;13985
290480;201805;1960;5102;1718;4752;130;397;1136;3117;1266;3514
290485;201805;4534;13759;3973;12902;137;728;3382;10744;3519;11472
290490;201805;8749;21525;7994;20528;547;1436;6321;16296;6868;17732
290500;201805;3896;11866;2995;9957;385;1338;1564;5115;1949;6453
290510;201805;3327;8810;2850;8166;97;349;2433;6880;2530;7229
290515;201805;3755;10112;3147;9331;79;218;2738;8293;2817;8511
290520;201805;11428;33893;8988;29089;411;1677;5911;18728;6322;20405
290530;201805;4997;14500;4338;13425;178;596;3564;11028;3742;11624
290540;201805;3738;10129;3352;9631;87;297;2989;8540;3076;8837
290550;201805;4353;11411;3856;10845;39;107;3583;10182;3622;10289
290560;201805;6735;17939;5374;15887;533;1811;3667;10594;4200;12405
290570;201805;43628;112485;39621;107295;2892;8179;30811;82885;33703;91064
290580;201805;7562;23442;6793;22294;618;1992;5150;17271;5768;19263
290590;201805;6925;21759;6017;20135;156;661;4966;16597;5122;17258
290600;201805;17995;52140;16366;49663;835;2631;13086;40134;13921;42765
290610;201805;2489;8107;2003;7125;98;412;1390;4894;1488;5306
290620;201805;6386;18170;5651;17000;218;692;4772;14259;4990;14951
290630;201805;9083;22372;7325;20106;604;1652;5693;15691;6297;17343
290640;201805;2733;7449;2080;6380;100;319;1585;4818;1685;5137
290650;201805;11727;31936;10740;30662;2781;7691;5892;17746;8673;25437
290660;201805;3645;9688;3110;8905;105;250;2307;6961;2412;7211
290670;201805;6885;19834;5978;18347;483;1460;4474;13895;4957;15355
290680;201805;10394;29800;8984;27720;249;1254;7251;21784;7500;23038
290682;201805;4631;12595;4066;11776;142;388;3412;9877;3554;10265
290685;201805;3625;8290;2394;6565;203;532;1549;4419;1752;4951
290687;201805;6841;19360;5503;17103;825;2532;3224;10376;4049;12908
290689;201805;2910;8385;2403;7516;150;526;1728;5444;1878;5970
290690;201805;5663;15094;4641;13700;491;1460;3141;9218;3632;10678
290700;201805;2619;7377;2359;7019;85;319;2014;6007;2099;6326
290710;201805;8479;24374;7321;22798;221;836;6308;19614;6529;20450
290720;201805;18866;52180;17412;50182;912;2808;14520;41872;15432;44680
290730;201805;7120;18242;6174;17075;264;692;4765;13168;5029;13860
290740;201805;1033;2895;789;2456;42;159;586;1816;628;1975
290750;201805;10627;28317;9254;25850;1020;3054;6161;16713;7181;19767
290755;201805;2227;6257;1725;5334;97;343;1190;3631;1287;3974
290760;201805;3917;11671;3106;10068;365;1065;1845;6264;2210;7329
290770;201805;2503;8474;2322;8236;62;314;1927;6890;1989;7204
290780;201805;8369;21464;7267;19896;397;868;5712;15964;6109;16832
290790;201805;4429;12596;3968;11960;159;465;3396;10308;3555;10773
290800;201805;7219;15223;5392;13131;367;842;4104;10176;4471;11018
290810;201805;5728;15786;4580;13953;112;405;3512;10744;3624;11149
290820;201805;5165;13972;4599;13147;258;830;3419;9791;3677;10621
290830;201805;4627;10995;4143;10341;94;285;3461;8515;3555;8800
290840;201805;16730;46471;14695;43270;1732;4516;9755;30007;11487;34523
290850;201805;6338;16546;5773;15915;494;1167;4562;12982;5056;14149
290860;201805;5671;17480;4957;16631;220;798;4159;14201;4379;14999
290870;201805;4730;13312;3695;11492;137;491;2664;8224;2801;8715
290880;201805;1428;3647;1119;3194;80;198;777;2266;857;2464
290890;201805;7923;17886;7000;16844;181;511;6490;15490;6671;16001
290900;201805;2341;6396;1769;5398;107;355;1142;3430;1249;3785
290910;201805;5073;13062;4021;11460;57;238;3351;9444;3408;9682
290920;201805;5180;12986;4765;12468;77;179;4435;11609;4512;11788
290930;201805;8137;23113;6764;20759;204;928;5423;16176;5627;17104
290940;201805;3829;11075;3225;10198;181;626;2427;7721;2608;8347
290950;201805;1524;4014;1291;3659;80;220;922;2644;1002;2864
290960;201805;5322;14730;4840;14090;162;499;4073;11888;4235;12387
290970;201805;3655;10741;3060;9757;175;553;2270;7266;2445;7819
290980;201805;10970;28524;9286;25673;1113;3314;5151;13837;6264;17151
290990;201805;9021;25357;7896;23474;392;1437;6355;18423;6747;19860
291000;201805;3294;9100;2663;8291;249;716;2063;6556;2312;7272
291005;201805;14794;36352;13130;34276;650;1827;10962;28478;11612;30305
291010;201805;3072;9353;2472;8103;143;488;1653;5356;1796;5844
291020;201805;1292;3329;1038;2843;37;122;706;1825;743;1947
291030;201805;2409;6209;1677;4818;95;289;1064;2960;1159;3249
291040;201805;5388;15475;4674;14424;215;889;3702;11240;3917;12129
291050;201805;7461;21943;6557;20536;1121;3795;4011;12370;5132;16165
291060;201805;5915;19878;5195;18841;464;2068;3630;12962;4094;15030
291070;201805;15489;43414;13371;40130;578;2110;10657;31667;11235;33777
291072;201805;23950;65559;17842;53981;3703;11769;6659;20359;10362;32128
291075;201805;5023;13655;4475;12713;184;535;3567;10004;3751;10539
291077;201805;1562;4221;1254;3672;53;143;895;2639;948;2782
291080;201805;81023;232495;68841;212293;25526;80473;10753;34855;36279;115328
291085;201805;5744;14727;4791;13369;190;576;4063;11314;4253;11890
291090;201805;1836;3722;1437;3265;105;156;1183;2751;1288;2907
291100;201805;3056;6899;2133;5813;106;380;1627;4320;1733;4700
291110;201805;5631;17901;4869;16576;484;1895;3473;11473;3957;13368
291120;201805;7770;19660;6774;18286;429;1278;5196;13956;5625;15234
291125;201805;2085;3811;1563;3236;93;175;1221;2589;1314;2764
291130;201805;2972;8890;2358;7710;80;380;1760;5541;1840;5921
291140;201805;4564;12849;3456;10680;485;1337;2187;6882;2672;8219
291150;201805;2228;5226;1928;4872;25;62;1726;4330;1751;4392
291160;201805;4901;14604;4287;13588;404;1406;2890;9028;3294;10434
291165;201805;2305;6370;1779;5379;23;98;1309;3844;1332;3942
291170;201805;20644;53558;17482;48390;1094;3238;11242;31045;12336;34283
291180;201805;6071;15149;4710;13116;418;1174;3407;9472;3825;10646
291185;201805;3181;8911;2772;8172;102;329;2224;6477;2326;6806
291190;201805;7563;19276;6376;17651;398;1201;4986;13760;5384;14961
291200;201805;2871;8242;2162;6899;146;474;1333;4216;1479;4690
291210;201805;6822;15596;5327;13788;170;548;4018;10344;4188;10892
291220;201805;3977;11665;3578;11031;275;960;2627;7990;2902;8950
291230;201805;4368;9927;3400;8842;93;193;3081;8127;3174;8320
291240;201805;4291;11333;3748;10402;66;215;3199;8731;3265;8946
291250;201805;3389;10210;2720;8966;182;583;1818;6069;2000;6652
291260;201805;1287;3186;1128;2973;46;166;940;2454;986;2620
291270;201805;5037;14428;4099;12875;745;2329;2430;7823;3175;10152
291280;201805;2384;6447;1838;5526;198;653;1064;3124;1262;3777
291290;201805;5877;15901;4754;14174;503;1525;3132;9376;3635;10901
291300;201805;3999;11118;3030;9465;132;442;2197;6797;2329;7239
291310;201805;5191;14347;4430;12933;157;515;3583;10313;3740;10828
291320;201805;6054;17908;4753;15293;1114;3389;2210;7424;3324;10813
291330;201805;1773;4698;1505;4262;74;232;1106;3036;1180;3268
291340;201805;4139;10980;3479;9909;83;306;2732;7659;2815;7965
291345;201805;3022;9414;2806;9100;141;483;2277;7432;2418;7915
291350;201805;6556;17230;5097;15237;133;402;4265;12937;4398;13339
291360;201805;34212;85514;27787;77088;4604;13091;15245;43408;19849;56499
291370;201805;7876;21833;7196;20896;438;1440;5541;15972;5979;17412
291380;201805;3399;9948;3028;9337;112;469;2459;7432;2571;7901
291390;201805;12524;29338;10186;26648;455;1363;8172;21284;8627;22647
291400;201805;13868;37165;11823;34083;1776;4709;7215;22054;8991;26763
291410;201805;2932;7802;2242;6629;64;279;1694;4859;1758;5138
291420;201805;1915;4958;1580;4524;43;177;1340;3799;1383;3976
291430;201805;3041;8546;2655;7965;89;419;2154;6261;2243;6680
291440;201805;6467;18953;5600;17467;365;1230;4417;13871;4782;15101
291450;201805;8490;22914;7213;21316;149;352;6243;18956;6392;19308
291460;201805;14413;40437;12814;38040;1004;3217;9263;27510;10267;30727
291465;201805;8876;24691;7304;22800;277;1188;6094;18959;6371;20147
291470;201805;15844;38895;13511;36195;646;1652;10171;28033;10817;29685
291480;201805;39371;90914;29493;77454;3862;10667;15392;40679;19254;51346
291490;201805;4988;13604;4428;12893;261;807;3695;10783;3956;11590
291500;201805;4971;12596;4122;11416;79;331;3664;10081;3743;10412
291510;201805;3792;10638;3090;9590;103;513;2469;7596;2572;8109
291520;201805;4343;10643;3429;9403;231;655;2459;6792;2690;7447
291530;201805;2224;5505;1662;4708;320;802;942;2944;1262;3746
291535;201805;3182;9803;2925;9365;206;628;2227;7243;2433;7871
291540;201805;2240;5053;1600;4332;62;201;1400;3740;1462;3941
291550;201805;5417;13145;4300;11625;497;1235;2658;7333;3155;8568
291560;201805;20144;45247;13695;37558;914;2313;9266;26790;10180;29103
291570;201805;2304;5583;1883;5069;104;222;1560;4323;1664;4545
291580;201805;6102;16764;4938;15168;352;1277;3549;10748;3901;12025
291590;201805;1754;5127;1604;4897;148;485;1275;3888;1423;4373
291600;201805;5216;13479;3912;11388;582;1776;2246;6412;2828;8188
291610;201805;5226;15196;4962;14903;83;289;4668;14049;4751;14338
291620;201805;3167;7142;2288;6169;115;333;1746;4783;1861;5116
291630;201805;3260;7625;2500;6644;152;456;1973;5187;2125;5643
291640;201805;15648;41053;12084;35625;2196;6569;4603;14381;6799;20950
291650;201805;8643;23714;7680;22509;486;1164;6453;19276;6939;20440
291660;201805;2240;5471;1631;4521;122;423;1086;2852;1208;3275
291670;201805;2011;5329;1734;4939;110;277;1363;3934;1473;4211
291680;201805;3956;10509;3352;9514;315;943;2478;7002;2793;7945
291685;201805;4773;11628;3810;10367;316;693;2816;7977;3132;8670
291690;201805;4150;9650;3006;7981;111;256;2423;6380;2534;6636
291700;201805;8685;25863;7698;24072;508;1704;6102;18940;6610;20644
291710;201805;5292;13152;4007;11355;309;984;2754;7673;3063;8657
291720;201805;4569;14320;3774;12667;391;1455;2445;7978;2836;9433
291730;201805;6379;17229;5503;16057;305;1018;4427;12918;4732;13936
291733;201805;2977;7827;2493;7155;78;257;1882;5579;1960;5836
291735;201805;3000;7952;2501;7207;85;272;2095;6039;2180;6311
291740;201805;3912;10245;3088;8927;128;392;2384;6799;2512;7191
291750;201805;19917;49492;15982;43458;1968;5441;9956;27321;11924;32762
291760;201805;10617;31930;8547;28482;2849;10672;2023;6792;4872;17464
291770;201805;7032;19901;5869;17757;557;1826;4093;12118;4650;13944
291780;201805;4846;13469;4386;12764;113;394;3811;10986;3924;11380
291790;201805;2644;7726;2444;7442;218;604;1863;5744;2081;6348
291800;201805;29648;77331;23426;68063;3228;9181;13337;39759;16565;48940
291810;201805;10792;26752;8956;24454;235;800;7666;20704;7901;21504
291820;201805;3788;10454;3327;9769;127;447;2602;7620;2729;8067
291830;201805;4254;10558;3667;9751;243;679;2916;7757;3159;8436
291835;201805;6286;19143;5036;16724;830;2882;2866;9759;3696;12641
291840;201805;46161;128593;40126;120700;4765;14533;27597;84734;32362;99267
291845;201805;2392;6799;2102;6409;125;384;1729;5326;1854;5710
291850;201805;4115;11892;3362;10594;288;814;2412;7861;2700;8675
291855;201805;2021;4339;1618;3847;74;196;1367;3224;1441;3420
291860;201805;2260;5990;1602;4723;32;116;1087;3080;1119;3196
291870;201805;1368;3534;915;2703;59;177;603;1724;662;1901
291875;201805;2683;8224;2390;7693;97;351;1789;5621;1886;5972
291880;201805;5298;15810;4670;14649;337;1052;3450;10814;3787;11866
291890;201805;1493;3293;1012;2702;187;395;629;1743;816;2138
291900;201805;1204;3086;928;2616;24;97;723;1983;747;2080
291905;201805;2768;7079;2110;5966;82;286;1564;4304;1646;4590
291910;201805;2830;7350;2414;6844;78;258;2079;5898;2157;6156
291915;201805;7067;20818;5880;18743;284;1057;4451;14199;4735;15256
291920;201805;25473;71220;22482;66986;2789;8885;14675;43250;17464;52135
291930;201805;2448;7078;2122;6531;204;705;1454;4381;1658;5086
291940;201805;3558;9600;2444;7627;219;707;1481;4494;1700;5201
291950;201805;8804;27722;7687;25559;764;2668;4773;16028;5537;18696
291955;201805;13282;35527;12067;33952;1540;4219;8656;25007;10196;29226
291960;201805;3128;8647;2541;7772;149;454;1932;6031;2081;6485
291970;201805;4077;11500;3566;10749;199;774;2594;7769;2793;8543
291980;201805;10400;29655;8299;26436;695;2203;5660;18224;6355;20427
291990;201805;2025;5817;1892;5664;22;84;1785;5357;1807;5441
291992;201805;4174;10296;3051;8738;305;822;2331;6777;2636;7599
291995;201805;2171;6001;1758;5378;56;245;1432;4289;1488;4534
292000;201805;2439;6298;2027;5701;169;558;1447;4031;1616;4589
292010;201805;6220;14619;5087;13039;248;657;4188;10659;4436;11316
292020;201805;4520;13608;3860;12427;314;1094;2807;8881;3121;9975
292030;201805;1705;5492;1640;5382;97;374;1018;3232;1115;3606
292040;201805;4314;11434;3556;10371;232;604;2833;8509;3065;9113
292045;201805;4002;10833;3030;9387;75;172;2660;8438;2735;8610
292050;201805;6477;18839;5300;16585;404;1385;3317;10244;3721;11629
292060;201805;12659;29453;11576;28117;698;1637;9803;23538;10501;25175
292070;201805;5621;15262;4946;14446;291;902;4222;12290;4513;13192
292080;201805;3224;8249;2624;7485;130;433;2271;6448;2401;6881
292090;201805;4514;10103;3361;8754;258;677;2594;6902;2852;7579
292100;201805;10377;26931;8847;24859;1601;4576;4866;13884;6467;18460
292105;201805;3122;8803;2798;8285;72;335;2353;6836;2425;7171
292110;201805;6326;16287;4583;13381;1100;3248;2029;6010;3129;9258
292120;201805;6822;18245;5529;15927;535;1572;3825;10921;4360;12493
292130;201805;3157;8069;2665;7438;184;576;2031;5655;2215;6231
292140;201805;5031;12370;4189;11139;232;612;3382;8927;3614;9539
292145;201805;2267;6837;1941;6257;98;337;1427;4614;1525;4951
292150;201805;13104;37318;11831;35389;314;1246;9897;29279;10211;30525
292160;201805;2622;7039;2193;6481;72;206;1893;5675;1965;5881
292170;201805;8313;22982;6890;20559;604;1898;4713;14046;5317;15944
292180;201805;2914;8049;2132;6686;351;1039;1154;3651;1505;4690
292190;201805;2950;8067;2490;7401;211;639;1719;5173;1930;5812
292200;201805;7426;20086;5795;17606;1026;3232;2998;9275;4024;12507
292205;201805;3741;10733;3315;10080;68;337;2908;8675;2976;9012
292210;201805;6033;15166;5040;13835;107;446;4458;12073;4565;12519
292220;201805;2032;5140;1803;4811;104;297;1360;3553;1464;3850
292225;201805;3216;9572;2867;9042;89;366;2368;7382;2457;7748
292230;201805;7920;19898;7219;18952;151;617;6155;15827;6306;16444
292240;201805;4978;14591;4285;13243;377;1154;2839;8758;3216;9912
292250;201805;5261;14842;4804;14100;641;1806;3122;9305;3763;11111
292260;201805;3314;9136;2980;8674;181;502;2505;7395;2686;7897
292265;201805;3256;9444;2787;8653;87;385;2186;6631;2273;7016
292270;201805;4061;9815;3321;8918;213;619;2706;7282;2919;7901
292273;201805;2538;5754;2079;5181;89;165;1616;4191;1705;4356
292275;201805;1822;5081;1468;4568;79;205;1150;3706;1229;3911
292280;201805;2517;6242;2081;5734;97;207;1717;4920;1814;5127
292285;201805;2490;6351;1976;5603;99;293;1540;4392;1639;4685
292290;201805;6826;19455;5700;17801;228;820;4623;14404;4851;15224
292300;201805;9804;26286;7849;23758;988;3146;5005;15344;5993;18490
292303;201805;2870;8388;2527;7855;61;194;2176;6767;2237;6961
292305;201805;2515;6759;2320;6469;48;213;2059;5641;2107;5854
292310;201805;6517;17466;5656;16361;205;638;4799;13802;5004;14440
292320;201805;6346;17299;5214;15239;294;955;3949;11241;4243;12196
292330;201805;2459;5888;2145;5495;113;259;1710;4470;1823;4729
292335;201805;4857;12716;4346;11977;310;776;3520;9820;3830;10596
292340;201805;6149;16975;5181;15216;259;779;3885;11302;4144;12081
292350;201805;2440;6679;2007;6094;74;271;1679;5132;1753;5403
292360;201805;4903;13249;4187;11932;327;1061;2946;8175;3273;9236
292370;201805;10657;24987;9316;23192;171;530;8497;20763;8668;21293
292380;201805;6864;19644;6206;18509;487;1431;4658;13894;5145;15325
292390;201805;4178;8534;3064;7226;204;323;2588;6263;2792;6586
292400;201805;21441;63921;19150;60001;1965;6498;13201;41285;15166;47783
292405;201805;4461;11008;3658;9894;183;440;2961;8072;3144;8512
292410;201805;2036;5224;1790;4930;61;210;1555;4297;1616;4507
292420;201805;3661;11325;3401;10927;175;779;2835;8983;3010;9762
292430;201805;4944;15150;3852;13405;303;1106;2627;9298;2930;10404
292440;201805;7999;26357;7440;25569;106;535;6871;23728;6977;24263
292450;201805;3769;11288;3088;9954;137;497;2410;7785;2547;8282
292460;201805;4870;13790;4032;12332;375;1105;2856;8778;3231;9883
292465;201805;2492;6847;2051;6187;98;264;1453;4565;1551;4829
292467;201805;1737;5236;1607;5057;215;641;1117;3629;1332;4270
292470;201805;3020;7663;2376;6619;80;199;1869;5231;1949;5430
292480;201805;6530;15852;5243;14268;104;383;4654;12451;4758;12834
292490;201805;2157;5823;1800;5269;106;306;1364;4030;1470;4336
292500;201805;6493;18294;5337;16225;600;1808;3487;10653;4087;12461
292510;201805;12739;35252;10366;31626;631;2327;7578;23029;8209;25356
292520;201805;6651;17316;5770;15992;807;2199;3891;10946;4698;13145
292525;201805;5628;13796;4653;12664;130;356;4067;11104;4197;11460
292530;201805;26782;73329;21958;65735;5862;17643;8208;25703;14070;43346
292540;201805;3590;7886;2923;7146;158;392;2515;6158;2673;6550
292550;201805;7569;21274;5985;19219;442;1534;4432;14598;4874;16132
292560;201805;4244;11136;3638;10257;112;443;2970;8297;3082;8740
292570;201805;4034;10738;3490;9920;66;227;3127;8801;3193;9028
292575;201805;6794;20550;6344;19934;325;1123;5290;16595;5615;17718
292580;201805;7255;19315;6275;17872;198;677;5340;15064;5538;15741
292590;201805;7188;19575;6557;18640;269;911;5608;15572;5877;16483
292593;201805;2820;7087;2368;6332;96;257;1920;5102;2016;5359
292595;201805;5436;14712;4758;13856;173;612;3964;11424;4137;12036
292600;201805;10978;30319;9577;28302;531;1446;7409;22071;7940;23517
292610;201805;4459;11731;3690;10416;212;502;2629;7613;2841;8115
292620;201805;6399;18142;5503;17141;61;156;5236;16496;5297;16652
292630;201805;8811;22090;7214;19479;500;1354;4980;13498;5480;14852
292640;201805;8083;24492;7176;23038;243;964;5331;17150;5574;18114
292650;201805;4534;11419;4126;10880;170;460;3671;9559;3841;10019
292660;201805;11044;31106;9627;29009;548;1794;7525;22671;8073;24465
292665;201805;2198;6684;2011;6442;57;191;1756;5695;1813;5886
292670;201805;3551;9776;2759;8307;139;504;1869;5527;2008;6031
292680;201805;3927;10841;3235;9558;206;604;2328;6722;2534;7326
292690;201805;2636;7082;1858;5797;155;455;1194;3876;1349;4331
292700;201805;9546;26758;8330;24917;867;2459;5672;17527;6539;19986
292710;201805;2327;7568;2146;7336;57;208;1938;6671;1995;6879
292720;201805;9397;22869;7947;21242;307;897;6589;17829;6896;18726
292730;201805;4201;10668;3959;10361;191;409;3425;9026;3616;9435
292740;201805;329254;839635;298057;791964;50908;138588;172585;454174;223493;592762
292750;201805;6351;17138;5437;15779;270;835;4079;11933;4349;12768
292760;201805;3868;11420;3458;10680;276;934;2486;7614;2762;8548
292770;201805;5853;16500;4936;15095;858;2756;2842;8992;3700;11748
292780;201805;1936;4085;1447;3475;49;136;1165;2707;1214;2843
292790;201805;4067;8815;3291;7969;89;253;2981;7208;3070;7461
292800;201805;10618;27506;9278;25428;406;1129;7573;20577;7979;21706
292805;201805;3390;8658;2715;7719;206;550;2022;5776;2228;6326
292810;201805;10273;28418;8160;25189;302;1161;6053;18470;6355;19631
292820;201805;7710;21093;5564;17819;440;1671;3930;12343;4370;14014
292830;201805;2762;6573;2395;6121;65;225;2153;5455;2218;5680
292840;201805;8836;23658;7905;22403;168;659;6968;19266;7136;19925
292850;201805;2683;7282;2214;6531;151;522;1485;4228;1636;4750
292860;201805;16030;38321;14411;36250;949;2316;11480;28973;12429;31289
292870;201805;17440;46119;15298;42868;1105;3502;9999;27541;11104;31043
292880;201805;11644;32065;10161;29929;406;1633;7729;21972;8135;23605
292890;201805;5967;18095;5340;17056;315;1186;4268;13515;4583;14701
292895;201805;2973;6684;2194;5513;100;244;1679;4191;1779;4435
292900;201805;2715;7715;2517;7387;78;362;2014;5681;2092;6043
292905;201805;4347;11945;3367;10440;221;709;2299;7177;2520;7886
292910;201805;5023;14197;4527;13363;344;1141;3249;9473;3593;10614
292920;201805;9887;27551;9294;26743;307;1192;8089;22852;8396;24044
292925;201805;5242;15130;4668;14169;254;803;3557;10669;3811;11472
292930;201805;6233;19310;5585;18017;449;1855;3605;11247;4054;13102
292935;201805;2190;6064;1785;5615;36;173;1578;5041;1614;5214
292937;201805;3119;7632;2702;7125;74;223;2361;6238;2435;6461
292940;201805;3151;8267;2526;7273;182;448;1850;5477;2032;5925
292950;201805;9557;25327;8521;23760;372;1131;6606;18097;6978;19228
292960;201805;5363;12950;4567;11877;108;321;3715;9493;3823;9814
292970;201805;4011;11740;3473;10973;118;525;2856;9028;2974;9553
292975;201805;4457;9852;3958;9273;205;394;3497;8312;3702;8706
292980;201805;3300;8280;2636;7248;129;405;2024;5451;2153;5856
292990;201805;11245;31172;9606;28418;671;2138;7247;21438;7918;23576
293000;201805;2653;6501;2379;6134;31;136;1860;4931;1891;5067
293010;201805;17859;47250;14665;41984;1973;5726;8940;25559;10913;31285
293015;201805;7462;24055;6076;21295;538;2260;4126;14298;4664;16558
293020;201805;9409;28854;8615;27780;152;717;7644;24718;7796;25435
293030;201805;5593;15304;4283;13263;131;442;2857;9139;2988;9581
293040;201805;3924;11450;3510;10868;104;382;3075;9469;3179;9851
293050;201805;21363;54643;18981;51283;1637;4522;13223;36017;14860;40539
293060;201805;3493;9278;2873;8264;193;615;2115;5957;2308;6572
293070;201805;24465;61779;20273;56046;3577;9923;11470;32722;15047;42645
293075;201805;3259;10717;2953;10210;215;928;2318;7954;2533;8882
293076;201805;3604;9361;3215;8829;98;265;2690;7463;2788;7728
293077;201805;5293;15435;4466;14246;502;1647;2948;9642;3450;11289
293080;201805;4731;14382;4195;13481;149;653;3380;10658;3529;11311
293090;201805;3146;9576;2495;8478;238;871;1586;5355;1824;6226
293100;201805;5740;16001;4711;14128;313;954;3581;10759;3894;11713
293105;201805;3758;12026;3280;11072;232;803;2347;7861;2579;8664
293110;201805;2399;6017;2020;5492;61;205;1699;4525;1760;4730
293120;201805;4135;11855;3736;11192;143;420;3127;9335;3270;9755
293130;201805;3775;10768;3379;10266;98;394;2916;8831;3014;9225
293135;201805;30092;73681;22357;62716;4278;13209;9228;26115;13506;39324
293140;201805;2210;5439;1979;5153;83;245;1655;4215;1738;4460
293150;201805;5349;16833;4499;15133;497;1667;2956;10088;3453;11755
293160;201805;3913;9647;3333;8957;255;489;2721;7663;2976;8152
293170;201805;3954;9759;3467;9100;125;379;2793;7311;2918;7690
293180;201805;4737;13001;3849;11523;103;476;3134;9165;3237;9641
293190;201805;13532;38708;12111;36573;302;1354;10389;31043;10691;32397
293200;201805;7990;20384;6627;18403;238;884;5126;14069;5364;14953
293210;201805;5107;13833;4378;12681;230;666;3448;9979;3678;10645
293220;201805;4957;13700;3831;11714;918;2785;1424;4615;2342;7400
293230;201805;3911;10667;3036;9370;309;1030;1989;6236;2298;7266
293240;201805;4394;11890;3530;10439;102;300;2689;8086;2791;8386
293245;201805;4063;11087;3616;10465;163;518;3007;8616;3170;9134
293250;201805;5589;14028;4787;12905;295;770;3738;10064;4033;10834
293260;201805;4468;12704;3694;11501;124;412;2632;8146;2756;8558
293270;201805;6664;15844;5420;14479;548;1049;4163;11811;4711;12860
293280;201805;4964;13395;4235;12369;245;700;3184;9332;3429;10032
293290;201805;12869;40989;11746;39044;2786;9217;5654;19723;8440;28940
293300;201805;6214;14879;5317;13685;343;771;3922;10309;4265;11080
293305;201805;4155;10531;3640;9833;60;188;3185;8578;3245;8766
293310;201805;2186;5677;1785;4988;90;264;1316;3620;1406;3884
293315;201805;4194;10360;3443;9206;160;406;2766;7346;2926;7752
293317;201805;2488;6398;2209;5939;119;293;1701;4567;1820;4860
293320;201805;9166;26012;8567;25294;640;1964;7198;21364;7838;23328
293325;201805;1744;4636;1386;4082;201;609;870;2558;1071;3167
293330;201805;44828;142027;39260;131807;8654;29598;17188;58629;25842;88227
293340;201805;2439;6919;1980;6119;145;502;1308;4005;1453;4507
293345;201805;3240;9252;2723;8536;280;624;1950;6568;2230;7192
293350;201805;6789;19425;6057;18601;78;232;5632;17640;5710;17872
293360;201805;15022;39924;13112;37560;517;1752;11550;32839;12067;34591
310010;201805;854;2112;620;1766;66;214;274;741;340;955
310020;201805;2208;6473;1731;5648;416;1489;263;832;679;2321
310030;201805;2237;6581;1790;5770;260;963;1115;3439;1375;4402
310040;201805;966;2503;785;2230;53;199;590;1600;643;1799
310050;201805;1586;5194;1439;4915;260;994;710;2340;970;3334
310060;201805;3362;9703;2902;9087;142;634;2379;7332;2521;7966
310070;201805;352;868;254;698;8;21;183;490;191;511
310080;201805;817;2267;566;1749;75;279;227;655;302;934
310090;201805;4428;12502;3766;11405;339;1137;2710;8111;3049;9248
310100;201805;3328;9686;2841;8875;122;503;2265;6917;2387;7420
310110;201805;4971;13494;3984;11738;716;2382;1861;5201;2577;7583
310120;201805;651;1699;435;1330;72;275;194;509;266;784
310130;201805;374;1077;316;975;53;203;177;483;230;686
310140;201805;205;652;151;557;41;182;40;123;81;305
310150;201805;4538;13230;3578;11328;727;2480;1259;3864;1986;6344
310160;201805;7039;19810;5414;16948;1339;4569;1377;4177;2716;8746
310163;201805;1043;3136;854;2794;254;921;233;687;487;1608
310170;201805;8975;24013;7490;21725;759;2257;5197;15085;5956;17342
310180;201805;1677;4488;1363;3993;112;404;926;2610;1038;3014
310190;201805;3001;9390;2524;8451;615;2255;311;985;926;3240
310200;201805;1721;5382;1348;4609;245;929;514;1704;759;2633
310205;201805;1122;3166;849;2755;122;394;454;1516;576;1910
310210;201805;2794;7484;2316;6736;107;334;1731;4992;1838;5326
310220;201805;1085;3040;902;2743;99;335;641;1898;740;2233
310230;201805;2326;6757;1946;5992;237;891;1148;3290;1385;4181
310240;201805;876;2959;768;2761;71;322;521;1823;592;2145
310250;201805;954;2774;817;2535;72;292;553;1632;625;1924
310260;201805;2742;7993;1826;6261;473;1854;301;779;774;2633
310270;201805;2667;6972;2108;6194;128;511;1682;4824;1810;5335
310280;201805;2313;5689;1838;4978;213;677;1147;2966;1360;3643
310285;201805;1911;6449;1667;6023;180;756;1022;3705;1202;4461
310290;201805;1112;3131;983;2898;209;706;524;1399;733;2105
310300;201805;1496;4763;1368;4544;237;945;691;2125;928;3070
310310;201805;319;819;219;647;32;89;115;345;147;434
310320;201805;492;1315;312;980;32;131;159;464;191;595
310330;201805;514;1241;313;874;36;115;132;326;168;441
310340;201805;7916;22362;6344;19670;1107;3357;3055;9845;4162;13202
310350;201805;12285;31265;8596;25205;2074;6535;2604;7392;4678;13927
310360;201805;463;1194;387;1095;13;41;298;824;311;865
310370;201805;1313;4252;1112;3857;226;839;389;1364;615;2203
310375;201805;1012;2675;666;2105;113;384;256;791;369;1175
310380;201805;374;899;201;596;36;104;69;186;105;290
310390;201805;449;1439;373;1286;99;357;75;208;174;565
310400;201805;9544;24717;6819;20329;1168;3864;3031;8742;4199;12606
310410;201805;745;2273;490;1799;127;504;112;380;239;884
310420;201805;3975;10718;2582;7884;492;1689;595;1592;1087;3281
310430;201805;1362;3988;917;3114;191;701;225;714;416;1415
310440;201805;583;1528;406;1203;27;113;228;656;255;769
310445;201805;1355;4061;1012;3392;62;236;713;2358;775;2594
310450;201805;4724;12364;3564;10528;219;734;2677;7859;2896;8593
310460;201805;1717;4736;1204;3761;249;845;330;1007;579;1852
310470;201805;3927;8677;3157;7667;285;860;2490;5889;2775;6749
310480;201805;1169;3179;848;2611;146;488;467;1378;613;1866
310490;201805;2961;8859;2390;7757;412;1591;1061;3209;1473;4800
310500;201805;1484;4381;1089;3611;212;753;481;1560;693;2313
310510;201805;1798;5136;1258;4080;295;1037;300;972;595;2009
310520;201805;1392;3505;1008;2876;126;355;585;1671;711;2026
310530;201805;873;2444;458;1465;68;240;75;191;143;431
310540;201805;3328;9913;2781;8922;721;2419;1060;3265;1781;5684
310550;201805;1232;3255;888;2669;93;361;552;1563;645;1924
310560;201805;13722;38714;10818;33642;2378;8166;3672;10460;6050;18626
310570;201805;1120;3196;924;2870;107;416;602;1792;709;2208
310590;201805;4188;11705;3453;10425;376;1294;1982;5767;2358;7061
310600;201805;1476;4532;1217;3967;176;615;547;1679;723;2294
310610;201805;519;1455;344;1149;56;227;164;504;220;731
310620;201805;153721;421391;117642;355396;25110;84796;42702;114793;67812;199589
310630;201805;4506;12841;3809;11586;308;1082;2633;7814;2941;8896
310640;201805;1050;3281;873;2925;209;762;270;850;479;1612
310650;201805;2513;7566;1880;6367;222;820;1035;3417;1257;4237
310660;201805;1281;3623;1101;3404;55;175;876;2671;931;2846
310665;201805;1283;3612;1071;3288;54;202;850;2611;904;2813
310670;201805;46583;130007;39340;116727;6421;20860;21539;60995;27960;81855
310680;201805;682;1751;581;1610;29;83;448;1221;477;1304
310690;201805;1659;4734;1258;4045;146;566;690;2107;836;2673
310700;201805;526;1205;394;1044;43;128;269;695;312;823
310710;201805;5541;16858;4058;14625;891;3776;430;1483;1321;5259
310720;201805;849;2281;710;2085;77;271;495;1416;572;1687
310730;201805;9040;26302;7860;24326;641;2340;5334;16226;5975;18566
310740;201805;5338;15700;3778;12415;697;2466;957;3001;1654;5467
310750;201805;1328;3309;941;2752;151;503;391;1065;542;1568
310760;201805;546;1546;420;1320;44;152;176;563;220;715
310770;201805;1074;3049;724;2512;106;396;346;1168;452;1564
310780;201805;4003;10394;3237;9149;195;559;2275;6357;2470;6916
310790;201805;1911;6048;1692;5633;336;1114;744;2631;1080;3745
310800;201805;2409;7465;1780;6184;461;1881;114;350;575;2231
310810;201805;1146;3042;940;2666;72;244;594;1618;666;1862
310820;201805;1117;3123;739;2398;156;543;192;604;348;1147
310825;201805;2823;9406;2327;8540;95;562;1845;6586;1940;7148
310830;201805;1406;4288;1078;3639;242;912;401;1273;643;2185
310840;201805;2063;5803;1431;4652;323;1153;345;1003;668;2156
310850;201805;1501;4216;1295;3939;66;321;1009;2934;1075;3255
310855;201805;3224;8896;2577;7899;232;858;1837;5500;2069;6358
310860;201805;6949;20610;5640;18055;536;1830;3474;11134;4010;12964
310870;201805;1051;2583;785;2177;90;259;542;1499;632;1758
310880;201805;1002;3056;806;2663;98;352;482;1560;580;1912
310890;201805;2368;6835;1654;5552;393;1468;238;695;631;2163
310900;201805;4537;13084;3417;10912;572;2054;1463;4290;2035;6344
310910;201805;1705;4616;1039;3315;139;503;142;370;281;873
310920;201805;1848;5153;1436;4467;240;794;745;2294;985;3088
310925;201805;970;2894;818;2633;125;446;533;1667;658;2113
310930;201805;5811;15898;4329;13494;773;2553;2240;7168;3013;9721
310940;201805;6246;16327;5030;14495;385;1275;3439;9685;3824;10960
310945;201805;1244;3411;1053;3135;96;333;658;1902;754;2235
310950;201805;1944;5897;1363;4640;279;1065;447;1395;726;2460
310960;201805;752;1926;445;1350;66;223;145;452;211;675
310970;201805;1170;3627;835;2914;204;770;200;654;404;1424
310980;201805;380;884;237;655;21;58;151;394;172;452
310990;201805;1221;3652;946;3077;205;684;358;1133;563;1817
311000;201805;4066;11877;3148;10331;887;3116;1129;3569;2016;6685
311010;201805;764;2443;645;2168;245;877;212;696;457;1573
311020;201805;992;2687;684;2094;91;323;302;867;393;1190
311030;201805;1547;4109;1054;3227;293;999;327;887;620;1886
311040;201805;343;1112;273;940;67;225;68;211;135;436
311050;201805;2328;6487;1857;5709;446;1517;690;2005;1136;3522
311060;201805;2681;7462;1863;5724;283;1018;720;1967;1003;2985
311070;201805;1779;5048;1327;4251;192;728;598;1801;790;2529
311080;201805;942;2446;772;2143;73;263;513;1315;586;1578
311090;201805;2015;6778;1604;6003;416;1730;465;1710;881;3440
311100;201805;2029;6188;1385;4866;352;1392;176;545;528;1937
311110;201805;3236;7365;2098;5720;485;1407;872;2401;1357;3808
311115;201805;1228;3355;1012;3043;71;271;763;2240;834;2511
311120;201805;6770;18453;5021;15169;922;3149;1624;4360;2546;7509
311130;201805;1957;5568;1569;4972;165;653;790;2381;955;3034
311140;201805;1306;3315;959;2825;64;207;604;1828;668;2035
311150;201805;1524;5031;1285;4564;200;777;698;2413;898;3190
311160;201805;3780;11624;2747;9725;820;3204;658;2229;1478;5433
311170;201805;839;2338;652;2024;42;144;400;1263;442;1407
311180;201805;1282;3121;850;2455;198;626;331;936;529;1562
311190;201805;1093;3039;810;2498;123;457;317;881;440;1338
311200;201805;1691;4883;1259;4008;347;1192;250;724;597;1916
311205;201805;920;2913;768;2613;65;279;427;1414;492;1693
311210;201805;969;2986;864;2849;129;407;616;2084;745;2491
311220;201805;747;2239;620;1983;102;361;287;845;389;1206
311230;201805;7904;24609;5964;20550;1177;4278;1906;6777;3083;11055
311240;201805;922;2690;740;2408;156;568;389;1230;545;1798
311250;201805;835;2466;684;2213;161;543;297;933;458;1476
311260;201805;2288;5818;1554;4611;323;1011;507;1397;830;2408
311265;201805;1218;3310;940;2847;66;255;635;1861;701;2116
311270;201805;3156;9707;2764;9108;204;960;1961;6152;2165;7112
311280;201805;1203;3296;605;1961;104;372;101;299;205;671
311290;201805;1895;5994;1770;5712;190;615;1198;3862;1388;4477
311300;201805;4538;13477;3832;12311;208;988;2970;9327;3178;10315
311310;201805;639;1950;543;1760;94;324;198;591;292;915
311320;201805;3159;10142;2787;9284;425;1613;1231;3781;1656;5394
311330;201805;4654;13135;4005;12024;493;1634;2187;6663;2680;8297
311340;201805;10679;32421;8707;28593;2477;8608;2027;6752;4504;15360
311350;201805;2200;5875;1632;4805;166;556;840;2260;1006;2816
311360;201805;911;2524;732;2271;314;1066;158;483;472;1549
311370;201805;4271;11420;3270;9693;259;1010;1909;5306;2168;6316
311380;201805;427;1355;341;1174;84;291;111;403;195;694
311390;201805;1736;5723;1450;5310;614;2560;360;1145;974;3705
311400;201805;1437;4255;1047;3446;156;595;411;1213;567;1808
311410;201805;1576;5030;1357;4736;274;1053;652;2283;926;3336
311420;201805;1675;5249;1138;4014;197;725;142;389;339;1114
311430;201805;3435;9739;2320;7422;414;1387;594;1910;1008;3297
311440;201805;2416;7333;1731;6035;444;1751;445;1491;889;3242
311450;201805;1818;5814;1368;4918;348;1375;277;870;625;2245
311455;201805;954;2365;676;1916;181;506;223;630;404;1136
311460;201805;550;1798;387;1455;85;409;101;334;186;743
311470;201805;446;1457;336;1195;75;306;52;166;127;472
311480;201805;1170;3723;1050;3562;58;166;880;3109;938;3275
311490;201805;224;732;191;649;47;176;78;240;125;416
311500;201805;435;1162;324;972;42;144;180;535;222;679
311510;201805;2746;7874;1949;6376;410;1536;558;1721;968;3257
311520;201805;571;1756;526;1663;123;430;269;808;392;1238
311530;201805;9193;22602;6103;17420;1467;4673;1519;4233;2986;8906
311535;201805;758;2118;508;1656;106;408;121;370;227;778
311540;201805;534;1762;483;1665;119;404;235;833;354;1237
311545;201805;2089;5968;1778;5556;101;412;1329;4049;1430;4461
311547;201805;1516;4014;1309;3684;37;134;1004;2847;1041;2981
311550;201805;2737;8110;2183;7018;388;1409;777;2368;1165;3777
311560;201805;254;600;191;522;31;82;101;251;132;333
311570;201805;1913;4643;1426;3964;52;151;1146;3274;1198;3425
311580;201805;2250;4308;1525;3458;213;412;955;2278;1168;2690
311590;201805;504;1453;417;1321;75;279;209;630;284;909
311600;201805;1483;3766;1227;3435;82;262;999;2749;1081;3011
311610;201805;2434;8403;2098;7627;429;1544;945;3493;1374;5037
311615;201805;3007;9139;2475;8273;174;716;1830;6019;2004;6735
311620;201805;396;1138;348;1062;20;79;269;802;289;881
311630;201805;1359;3846;1098;3347;83;273;750;2215;833;2488
311640;201805;578;1788;476;1586;95;365;201;631;296;996
311650;201805;1992;5429;1694;4957;158;568;1123;3147;1281;3715
311660;201805;2895;8637;2123;7149;422;1534;401;1164;823;2698
311670;201805;1545;4151;1210;3618;192;654;545;1665;737;2319
311680;201805;2102;6240;1623;5379;253;903;989;3237;1242;4140
311690;201805;561;1271;450;1137;31;78;341;888;372;966
311700;201805;2274;5620;1753;4903;40;149;1424;3899;1464;4048
311710;201805;1507;4507;1049;3593;277;1013;327;1142;604;2155
311720;201805;413;1292;338;1146;37;152;178;577;215;729
311730;201805;4709;11866;2813;8417;860;2863;372;1042;1232;3905
311740;201805;765;2317;702;2227;41;119;626;2013;667;2132
311750;201805;3951;12238;3284;11121;415;1635;1886;6103;2301;7738
311760;201805;657;2018;554;1812;101;397;185;513;286;910
311770;201805;1966;6012;1531;5160;316;1160;526;1656;842;2816
311780;201805;1226;3891;917;3211;190;762;240;725;430;1487
311783;201805;2093;6303;1751;5682;56;264;1440;4589;1496;4853
311787;201805;711;2145;510;1667;73;278;194;534;267;812
311790;201805;1533;4126;1027;3241;243;853;343;1062;586;1915
311800;201805;5115;16258;4277;14322;787;2854;600;1817;1387;4671
311810;201805;984;3130;799;2768;62;255;468;1615;530;1870
311820;201805;728;2002;576;1719;84;308;346;962;430;1270
311830;201805;8439;25525;5972;19966;1519;5458;593;1883;2112;7341
311840;201805;2947;8285;2546;7686;339;1137;1702;5098;2041;6235
311850;201805;304;886;254;805;25;85;160;498;185;583
311860;201805;52279;140096;41690;122548;6744;21031;23060;66205;29804;87236
311870;201805;1936;5437;1348;4298;252;927;489;1369;741;2296
311880;201805;6128;16947;5319;15792;377;1066;4044;12134;4421;13200
311890;201805;1461;3914;1168;3450;147;482;712;2032;859;2514
311900;201805;695;1900;540;1666;53;198;371;1115;424;1313
311910;201805;4293;11467;3294;10149;670;2124;1572;4907;2242;7031
311920;201805;1966;5807;1610;5204;174;602;942;3019;1116;3621
311930;201805;3207;8401;2536;7383;969;2997;715;1943;1684;4940
311940;201805;13673;38453;10407;32057;1622;5486;4367;12676;5989;18162
311950;201805;2176;6219;1654;5317;106;458;1140;3564;1246;4022
311960;201805;570;1423;472;1267;38;178;320;724;358;902
311970;201805;434;1450;287;1064;50;214;60;204;110;418
311980;201805;471;1328;282;947;38;138;82;268;120;406
311990;201805;513;1307;358;1090;99;347;134;378;233;725
311995;201805;998;2886;546;1820;27;97;54;123;81;220
312000;201805;557;1580;481;1464;31;94;348;1076;379;1170
312010;201805;886;2723;704;2338;74;268;392;1271;466;1539
312015;201805;1303;4042;1167;3791;75;320;873;2734;948;3054
312020;201805;1121;3543;972;3276;207;753;388;1273;595;2026
312030;201805;1990;5185;1750;4908;34;162;1605;4438;1639;4600
312040;201805;761;2507;587;2129;78;312;220;767;298;1079
312050;201805;1229;4099;987;3591;245;1025;247;787;492;1812
312060;201805;808;2202;593;1910;135;449;281;902;416;1351
312070;201805;892;2686;635;2145;79;290;331;1078;410;1368
312080;201805;2739;7049;2036;5972;164;563;1244;3443;1408;4006
312083;201805;925;2498;715;2168;84;280;464;1348;548;1628
312087;201805;2192;6143;1895;5721;83;301;1479;4494;1562;4795
312090;201805;9180;26038;7181;22588;1558;5202;2944;9165;4502;14367
312100;201805;1508;4663;1082;3871;139;612;515;1748;654;2360
312110;201805;1010;3320;856;2987;246;963;218;670;464;1633
312120;201805;688;2019;513;1697;143;525;175;509;318;1034
312125;201805;1316;3832;1172;3610;149;478;850;2597;999;3075
312130;201805;853;2240;649;1872;67;212;274;741;341;953
312140;201805;796;2470;658;2150;147;517;249;750;396;1267
312150;201805;466;1352;400;1196;13;55;267;748;280;803
312160;201805;7840;23798;6225;20694;1045;3956;2573;8051;3618;12007
312170;201805;840;2361;673;2059;33;102;454;1355;487;1457
312180;201805;1399;4019;1148;3517;165;570;580;1661;745;2231
312190;201805;543;1685;398;1368;92;346;74;258;166;604
312200;201805;4720;13148;3870;11652;732;2274;2139;6389;2871;8663
312210;201805;1307;3220;960;2718;79;282;644;1755;723;2037
312220;201805;1955;6168;1732;5807;159;537;1150;3894;1309;4431
312230;201805;11382;32149;7913;25584;2271;8072;1072;3120;3343;11192
312235;201805;1605;4528;1361;4172;125;437;957;2879;1082;3316
312240;201805;749;2478;578;2100;123;485;148;514;271;999
312245;201805;2469;6710;2117;6220;77;289;1739;5086;1816;5375
312247;201805;829;2236;605;1881;146;478;281;889;427;1367
312250;201805;1015;2704;691;2101;125;390;261;770;386;1160
312260;201805;920;2693;738;2399;58;225;516;1622;574;1847
312270;201805;687;1982;543;1697;35;155;282;804;317;959
312280;201805;436;1346;348;1171;113;387;38;121;151;508
312290;201805;760;2419;644;2194;116;439;220;727;336;1166
312300;201805;884;2724;645;2140;164;594;94;244;258;838
312310;201805;768;2651;661;2431;107;462;284;1004;391;1466
312320;201805;1926;5218;1447;4353;411;1334;287;808;698;2142
312330;201805;877;2577;739;2361;80;279;518;1616;598;1895
312340;201805;272;729;204;620;31;105;105;310;136;415
312350;201805;264;600;222;558;25;75;158;381;183;456
312352;201805;1635;4901;1419;4532;147;464;916;3094;1063;3558
312360;201805;2655;8234;2047;6907;438;1600;463;1513;901;3113
312370;201805;1740;4982;1471;4500;298;1024;670;1923;968;2947
312380;201805;2130;5185;1824;4786;28;74;1628;4296;1656;4370
312385;201805;1251;3570;1020;3158;159;563;563;1646;722;2209
312390;201805;1943;5890;1489;5025;283;1051;443;1347;726;2398
312400;201805;2978;9052;2347;7815;803;2818;624;2116;1427;4934
312410;201805;11390;33754;9475;30292;1851;6236;4464;14032;6315;20268
312420;201805;3693;10910;3269;10127;587;1967;1743;5285;2330;7252
312430;201805;8022;22117;6572;19547;628;2022;4378;12908;5006;14930
312440;201805;930;2961;702;2432;326;1197;80;248;406;1445
312450;201805;1161;3648;889;3106;258;958;300;1070;558;2028
312460;201805;410;1089;292;914;45;158;168;545;213;703
312470;201805;508;1343;323;1011;57;214;104;287;161;501
312480;201805;1220;3057;829;2529;117;383;466;1387;583;1770
312490;201805;1968;5007;1530;4327;244;722;830;2285;1074;3007
312500;201805;830;2190;668;1954;69;247;423;1200;492;1447
312510;201805;3739;10476;2868;8771;514;1567;1195;3572;1709;5139
312520;201805;183;551;154;503;42;137;66;216;108;353
312530;201805;605;1637;520;1525;28;94;438;1290;466;1384
312540;201805;1431;4252;939;3169;199;718;385;1284;584;2002
312550;201805;760;2190;595;1803;60;194;343;945;403;1139
312560;201805;1969;5222;1637;4757;72;277;1300;3723;1372;4000
312570;201805;2268;6109;1756;5356;508;1632;632;1965;1140;3597
312580;201805;545;1664;427;1399;49;189;182;565;231;754
312590;201805;1664;5131;1377;4558;148;623;738;2292;886;2915
312595;201805;1677;5406;1533;5110;266;856;914;3162;1180;4018
312600;201805;952;2531;586;1975;87;355;222;729;309;1084
312610;201805;6483;17123;4282;13028;767;2551;1110;3206;1877;5757
312620;201805;2398;6369;1758;5474;67;283;1353;4298;1420;4581
312630;201805;245;794;207;722;40;159;81;284;121;443
312640;201805;600;1683;400;1328;55;178;128;433;183;611
312650;201805;2084;5644;1421;4315;110;397;917;2644;1027;3041
312660;201805;1373;3443;1058;2954;103;339;711;1908;814;2247
312670;201805;5109;14122;4162;12743;362;1452;2720;8010;3082;9462
312675;201805;1289;3700;1048;3264;79;326;796;2417;875;2743
312680;201805;1350;3950;1155;3659;80;341;876;2700;956;3041
312690;201805;2290;5681;1810;5032;134;415;1353;3673;1487;4088
312695;201805;933;2862;815;2650;75;227;604;1995;679;2222
312700;201805;2003;5586;1473;4608;152;514;823;2516;975;3030
312705;201805;1285;3473;1060;3097;36;124;824;2366;860;2490
312707;201805;1405;4354;1078;3717;93;432;623;2035;716;2467
312710;201805;6499;15190;3824;11100;1117;3540;848;2543;1965;6083
312720;201805;986;2869;747;2455;90;350;373;1160;463;1510
312730;201805;1625;3999;1256;3508;66;209;835;2289;901;2498
312733;201805;1532;4089;1181;3442;38;131;777;2178;815;2309
312735;201805;701;1917;600;1731;85;295;398;1050;483;1345
312737;201805;775;1913;554;1575;93;300;277;735;370;1035
312738;201805;556;1563;381;1225;68;256;161;482;229;738
312740;201805;365;913;208;667;53;179;45;115;98;294
312750;201805;1260;4166;1073;3802;181;736;518;1737;699;2473
312760;201805;1877;5805;1368;4733;260;948;401;1351;661;2299
312770;201805;40393;103564;27124;80670;6398;20150;7909;22917;14307;43067
312780;201805;2491;8094;2162;7499;241;955;1340;4637;1581;5592
312790;201805;287;746;185;601;21;90;72;207;93;297
312800;201805;4835;14713;3785;12528;784;2871;1482;4742;2266;7613
312810;201805;1847;5255;1236;4126;289;1063;345;1022;634;2085
312820;201805;1870;5177;1547;4605;67;262;1073;3083;1140;3345
312825;201805;1284;3231;1116;3017;37;120;927;2506;964;2626
312830;201805;2366;7029;1580;5461;388;1468;322;1082;710;2550
312840;201805;1130;3545;879;3011;152;604;297;918;449;1522
312850;201805;822;2236;601;1866;69;261;285;819;354;1080
312860;201805;1433;3761;939;2945;229;758;240;725;469;1483
312870;201805;5975;17495;3810;12821;588;2197;981;3055;1569;5252
312880;201805;1397;3754;1148;3388;58;183;709;2174;767;2357
312890;201805;2042;5687;1352;4305;202;664;510;1655;712;2319
312900;201805;1164;3258;954;2968;83;282;603;1928;686;2210
312910;201805;1585;3029;884;2104;132;322;420;985;552;1307
312920;201805;964;2765;702;2308;121;466;344;1056;465;1522
312930;201805;2122;5747;1732;5141;389;1189;744;2197;1133;3386
312940;201805;875;2697;747;2462;135;473;339;1101;474;1574
312950;201805;2623;7055;1956;5997;588;1895;624;1908;1212;3803
312960;201805;1941;5294;1638;4846;116;334;1219;3683;1335;4017
312965;201805;1738;5285;1459;4752;108;369;936;3037;1044;3406
312970;201805;1072;3266;828;2856;192;749;321;1050;513;1799
312980;201805;21046;62680;18030;57126;3190;11300;9107;27452;12297;38752
312990;201805;424;1210;282;974;68;275;114;383;182;658
313000;201805;430;1338;347;1187;52;232;146;454;198;686
313005;201805;2569;7681;2229;7100;171;633;1605;4985;1776;5618
313010;201805;4407;13001;3602;11593;696;2458;2001;6259;2697;8717
313020;201805;935;2983;645;2293;102;413;76;207;178;620
313030;201805;1286;3231;881;2601;114;413;464;1312;578;1725
313040;201805;804;2598;668;2282;68;280;340;1091;408;1371
313050;201805;1792;5273;1283;4488;245;1024;359;1112;604;2136
313055;201805;1698;4976;1538;4731;47;151;1336;4107;1383;4258
313060;201805;961;2620;681;2132;215;736;132;362;347;1098
313065;201805;1806;5668;1550;5258;107;444;1153;3868;1260;4312
313070;201805;852;2377;681;2077;93;309;366;1082;459;1391
313080;201805;386;1112;279;891;71;252;69;177;140;429
313090;201805;4717;13320;4000;12094;959;3124;2018;6014;2977;9138
313100;201805;1440;3843;1114;3355;60;212;850;2560;910;2772
313110;201805;1533;4197;1078;3340;106;404;533;1514;639;1918
313115;201805;2418;7548;2143;6987;344;1215;1062;3252;1406;4467
313120;201805;3681;9009;2848;7924;295;904;1805;5014;2100;5918
313130;201805;26849;75821;21749;65903;3243;11046;10752;30801;13995;41847
313140;201805;521;1276;354;1013;20;72;245;686;265;758
313150;201805;1302;3897;1012;3326;279;973;255;794;534;1767
313160;201805;952;2582;740;2213;68;229;466;1336;534;1565
313170;201805;11610;36027;8335;29128;1591;5752;2727;9215;4318;14967
313180;201805;2299;6292;1615;4909;239;789;786;2320;1025;3109
313190;201805;4149;12705;3131;10501;598;2122;941;2956;1539;5078
313200;201805;1103;3251;943;2954;37;143;772;2353;809;2496
313210;201805;3929;11790;3180;10427;464;1663;1762;5618;2226;7281
313220;201805;1687;4710;1174;3693;196;713;439;1232;635;1945
313230;201805;2622;8171;2381;7852;78;226;2075;6899;2153;7125
313240;201805;8694;23654;5767;18512;1077;3888;2264;6724;3341;10612
313250;201805;6221;19036;5107;16945;618;2198;2589;8477;3207;10675
313260;201805;630;1746;430;1336;59;221;183;546;242;767
313270;201805;5497;15655;4388;13765;817;2666;2471;7777;3288;10443
313280;201805;379;1142;268;913;39;148;97;309;136;457
313290;201805;765;2572;603;2316;231;957;142;525;373;1482
313300;201805;1671;5012;1289;4236;349;1228;208;607;557;1835
313310;201805;1031;3282;870;2952;155;604;192;541;347;1145
313320;201805;2202;6035;1545;4979;309;1132;678;2166;987;3298
313330;201805;4036;11485;3213;10152;221;966;2105;6401;2326;7367
313340;201805;1416;3330;1006;2731;146;406;628;1733;774;2139
313350;201805;2238;6624;1601;5249;243;881;535;1618;778;2499
313360;201805;1285;3425;891;2739;160;589;455;1292;615;1881
313370;201805;1259;3878;1136;3632;147;554;647;1947;794;2501
313375;201805;1829;4891;1201;3817;216;799;303;914;519;1713
313380;201805;5481;14833;4071;12213;820;2713;1685;4590;2505;7303
313390;201805;871;2905;786;2757;61;263;516;1761;577;2024
313400;201805;3528;9361;2898;8533;190;564;2262;6606;2452;7170
313410;201805;1247;3368;991;2950;113;387;699;2032;812;2419
313420;201805;15543;36394;8684;24710;1799;5641;1192;3441;2991;9082
313430;201805;897;2716;680;2276;103;415;275;817;378;1232
313440;201805;6102;13598;4009;10871;343;964;2501;6817;2844;7781
313450;201805;623;1804;464;1488;101;342;138;392;239;734
313460;201805;2111;6512;1720;5872;405;1623;735;2299;1140;3922
313470;201805;3121;7902;2523;7074;215;585;1809;5107;2024;5692
313480;201805;895;2651;540;1852;80;308;144;428;224;736
313490;201805;1461;3529;735;2441;239;943;61;203;300;1146
313500;201805;411;1296;325;1080;36;131;125;377;161;508
313505;201805;9095;25693;8087;24420;318;1117;6962;21021;7280;22138
313507;201805;1477;3841;1240;3507;55;201;976;2734;1031;2935
313510;201805;12910;36837;10843;33150;1402;4698;5493;16331;6895;21029
313520;201805;13383;39990;11064;35847;866;3204;7639;24369;8505;27573
313530;201805;529;1550;436;1394;23;78;208;632;231;710
313535;201805;2455;6896;2154;6343;167;471;1489;4341;1656;4812
313540;201805;853;2666;638;2087;149;507;212;673;361;1180
313545;201805;1178;4082;1013;3747;176;699;549;1957;725;2656
313550;201805;1774;5446;1495;4875;357;1258;704;2195;1061;3453
313560;201805;2502;5232;1862;4465;83;212;1545;3660;1628;3872
313570;201805;946;3010;767;2646;185;711;310;1015;495;1726
313580;201805;5523;15248;4323;13312;653;2131;2270;7227;2923;9358
313590;201805;932;2705;720;2380;265;974;243;813;508;1787
313600;201805;3703;10536;3120;9595;165;646;2449;7437;2614;8083
313610;201805;986;2702;808;2371;119;359;496;1427;615;1786
313620;201805;5666;15951;4652;14155;893;2971;2152;6348;3045;9319
313630;201805;8182;21318;5783;17696;811;2753;2953;9127;3764;11880
313640;201805;1022;2504;635;1952;191;643;213;614;404;1257
313650;201805;1830;5713;1548;5253;107;441;1008;3423;1115;3864
313652;201805;790;2718;733;2595;130;499;435;1477;565;1976
313655;201805;1017;2934;823;2643;55;214;599;1883;654;2097
313657;201805;1308;3608;998;3102;55;240;727;2123;782;2363
313660;201805;842;2568;708;2298;120;466;354;1072;474;1538
313665;201805;4421;12824;3552;11198;545;1943;1906;5748;2451;7691
313670;201805;42670;115373;29290;90589;5485;18408;10568;31105;16053;49513
313680;201805;1006;2821;858;2595;74;250;540;1592;614;1842
313690;201805;828;2798;669;2460;136;513;216;816;352;1329
313695;201805;1599;4699;1262;4117;103;384;882;2857;985;3241
313700;201805;3215;10736;2773;10151;262;967;2173;8047;2435;9014
313710;201805;1436;3714;1039;3100;101;316;643;1921;744;2237
313720;201805;5602;16416;4106;13231;677;2456;1526;4486;2203;6942
313730;201805;1281;3186;974;2761;75;207;625;1724;700;1931
313740;201805;1759;6374;1459;5579;355;1502;168;564;523;2066
313750;201805;1934;5574;1510;4720;351;1218;525;1499;876;2717
313753;201805;2069;5224;1461;4232;176;573;811;2290;987;2863
313760;201805;5001;14473;3708;11861;890;3087;1291;3881;2181;6968
313770;201805;3633;10661;2946;9627;278;949;1964;6450;2242;7399
313780;201805;4027;11106;3025;9425;381;1344;852;2708;1233;4052
313790;201805;449;1453;413;1385;71;250;223;714;294;964
313800;201805;1325;3250;1073;2888;69;219;804;2173;873;2392
313810;201805;1622;4373;1321;3933;99;336;941;2818;1040;3154
313820;201805;12721;32101;9210;25883;1459;4642;3616;9567;5075;14209
313830;201805;331;989;287;912;60;209;133;423;193;632
313835;201805;900;2778;762;2533;79;308;412;1295;491;1603
313840;201805;6510;17825;4857;14988;1175;3877;1051;3224;2226;7101
313850;201805;991;2569;821;2291;122;417;444;1111;566;1528
313860;201805;2686;7664;1991;6206;363;1210;669;1930;1032;3140
313862;201805;1462;3413;809;2404;71;222;424;1225;495;1447
313865;201805;2215;6429;1949;6018;152;491;1446;4413;1598;4904
313867;201805;1114;3714;947;3363;296;1101;390;1373;686;2474
313868;201805;1676;5441;1422;4915;107;455;1045;3542;1152;3997
313870;201805;800;2254;614;1925;126;431;205;569;331;1000
313880;201805;1407;4001;1090;3462;222;766;414;1174;636;1940
313890;201805;2017;4813;1480;4111;149;459;929;2625;1078;3084
313900;201805;3644;11830;2932;10342;827;3166;660;2303;1487;5469
313910;201805;632;1982;482;1683;119;434;88;300;207;734
313920;201805;3010;9767;2514;8784;501;1738;1277;4569;1778;6307
313925;201805;1710;4545;1318;3814;265;732;740;2156;1005;2888
313930;201805;6023;20820;5086;19155;432;1594;3515;13850;3947;15444
313940;201805;8375;25603;6138;21640;1309;5251;1520;5785;2829;11036
313950;201805;4630;11352;3402;9638;592;2143;1863;5018;2455;7161
313960;201805;5463;13939;3729;11053;795;2564;1229;3423;2024;5987
313970;201805;1319;3882;1170;3631;72;289;715;2228;787;2517
313980;201805;1362;3811;898;3001;138;525;315;996;453;1521
313990;201805;1713;5954;1344;5030;392;1605;374;1283;766;2888
314000;201805;9138;25991;7861;23653;582;2187;5262;15595;5844;17782
314010;201805;1276;3254;1033;2926;48;183;798;2200;846;2383
314015;201805;2086;5916;1634;5202;215;807;887;2755;1102;3562
314020;201805;525;1503;318;1061;57;222;61;199;118;421
314030;201805;816;2530;634;2131;77;282;302;1003;379;1285
314040;201805;738;2062;602;1797;107;347;272;775;379;1122
314050;201805;1556;4530;1196;3828;183;674;544;1599;727;2273
314053;201805;1720;5210;1425;4698;207;677;900;3120;1107;3797
314055;201805;2273;6364;1970;5917;56;241;1640;4909;1696;5150
314060;201805;1159;3311;894;2859;48;179;616;1930;664;2109
314070;201805;4312;12465;3379;10708;771;2509;1272;3896;2043;6405
314080;201805;1773;5277;1250;4102;217;842;384;1105;601;1947
314085;201805;2046;6449;1703;5904;387;1436;755;2603;1142;4039
314090;201805;3658;11132;3175;10332;269;1085;2112;6779;2381;7864
314100;201805;3203;7698;2607;6881;68;147;2132;5735;2200;5882
314110;201805;4174;12711;3546;11421;575;2097;1760;5260;2335;7357
314120;201805;848;1986;392;1219;91;332;62;183;153;515
314130;201805;779;2182;411;1387;54;201;145;480;199;681
314140;201805;4749;14128;3626;11833;662;2288;1506;4795;2168;7083
314150;201805;1481;3928;1139;3329;116;368;705;1983;821;2351
314160;201805;2432;6505;1779;5364;258;825;789;2434;1047;3259
314170;201805;1021;2977;836;2601;95;327;485;1412;580;1739
314180;201805;5231;15269;4388;13878;589;1986;2468;7873;3057;9859
314190;201805;738;2102;542;1785;100;355;265;876;365;1231
314200;201805;2888;8460;2410;7589;146;588;1724;5215;1870;5803
314210;201805;1947;5300;1643;4796;138;437;994;2845;1132;3282
314220;201805;1258;3682;895;3011;250;942;240;731;490;1673
314225;201805;1217;3499;1060;3274;71;240;779;2420;850;2660
314230;201805;760;2128;654;1991;111;371;381;1173;492;1544
314240;201805;1094;3123;860;2753;206;724;334;1080;540;1804
314250;201805;523;1518;341;1103;59;202;126;372;185;574
314260;201805;970;3100;800;2761;180;715;326;1023;506;1738
314270;201805;3111;9286;2526;8271;120;485;1861;5958;1981;6443
314280;201805;3349;8199;2095;6037;362;1161;794;2142;1156;3303
314290;201805;4505;12127;3789;10920;495;1446;2403;6850;2898;8296
314300;201805;1516;4703;1135;3851;295;1053;318;1064;613;2117
314310;201805;5214;14316;3831;11852;1171;3886;855;2464;2026;6350
314315;201805;864;3187;756;2944;64;307;529;2003;593;2310
314320;201805;2832;7882;1912;6291;436;1536;692;2273;1128;3809
314330;201805;48388;139771;38143;122183;11061;37156;8802;28640;19863;65796
314340;201805;2456;6370;1321;4180;250;927;242;594;492;1521
314345;201805;1340;4175;1135;3801;145;506;705;2319;850;2825
314350;201805;983;2836;684;2262;138;493;154;485;292;978
314360;201805;649;1973;402;1415;66;263;101;327;167;590
314370;201805;648;1882;536;1692;38;137;393;1204;431;1341
314380;201805;1164;3405;797;2675;207;770;116;393;323;1163
314390;201805;11799;32312;8003;25138;1700;5685;2028;5732;3728;11417
314400;201805;4162;12407;3334;11017;942;3221;1169;4018;2111;7239
314410;201805;2715;7894;1939;6370;336;1224;678;2380;1014;3604
314420;201805;745;1959;580;1723;18;94;448;1279;466;1373
314430;201805;6475;17609;4932;14869;989;3153;1760;5273;2749;8426
314435;201805;1466;4411;1248;4049;46;199;931;2983;977;3182
314437;201805;926;2450;713;2143;34;126;409;1237;443;1363
314440;201805;536;1592;414;1364;116;433;121;346;237;779
314450;201805;1391;3951;1159;3564;149;566;660;1894;809;2460
314460;201805;3563;11384;2625;9243;636;2376;412;1435;1048;3811
314465;201805;2225;6637;1956;6107;62;260;1532;4670;1594;4930
314467;201805;907;2578;757;2320;21;61;591;1799;612;1860
314470;201805;2207;6649;1826;5852;371;1320;754;2242;1125;3562
314480;201805;5809;18016;4130;14077;756;2781;938;2894;1694;5675
314490;201805;853;2460;652;2040;94;336;375;1106;469;1442
314500;201805;1759;4696;1261;3846;253;790;437;1311;690;2101
314505;201805;1937;5139;1644;4724;123;425;1186;3347;1309;3772
314510;201805;1730;4677;1188;3875;246;878;478;1524;724;2402
314520;201805;3741;12111;2601;9454;464;1924;253;752;717;2676
314530;201805;5523;18593;5072;17729;524;2005;3463;12159;3987;14164
314535;201805;2596;7028;2134;6335;140;486;1621;4726;1761;5212
314537;201805;1119;3306;852;2845;73;276;573;1872;646;2148
314540;201805;396;1065;275;834;30;110;125;358;155;468
314545;201805;1656;4488;1485;4249;57;166;1245;3715;1302;3881
314550;201805;671;1719;490;1460;48;184;235;629;283;813
314560;201805;4034;13035;3224;11227;550;2092;1031;3392;1581;5484
314570;201805;306;877;236;742;37;124;110;349;147;473
314580;201805;483;1578;360;1310;87;340;56;205;143;545
314585;201805;742;2370;559;1954;76;340;244;783;320;1123
314587;201805;1940;5603;1521;4896;240;710;822;2701;1062;3411
314590;201805;2945;9134;2173;7450;394;1469;711;2319;1105;3788
314600;201805;1809;5349;1105;3898;248;972;117;365;365;1337
314610;201805;8094;23053;6064;19657;1212;4557;2419;7528;3631;12085
314620;201805;1854;4904;1503;4402;73;246;1226;3538;1299;3784
314625;201805;1497;4632;1318;4364;103;514;989;3110;1092;3624
314630;201805;4932;13698;4132;12484;151;632;3342;10024;3493;10656
314640;201805;586;1538;424;1252;82;274;187;496;269;770
314650;201805;964;2503;645;1981;62;224;270;741;332;965
314655;201805;1545;4431;1111;3588;239;763;456;1478;695;2241
314660;201805;327;803;206;573;13;30;114;299;127;329
314670;201805;1646;4127;1199;3397;69;253;754;2092;823;2345
314675;201805;1780;4963;1528;4518;117;415;1140;3297;1257;3712
314690;201805;2093;6339;1599;5473;495;1855;359;1195;854;3050
314700;201805;9704;29573;6408;22508;1444;5669;1324;4416;2768;10085
314710;201805;8125;23727;5799;18682;1149;4048;1214;3438;2363;7486
314720;201805;2217;6985;1644;5742;363;1383;397;1379;760;2762
314730;201805;2034;5925;1528;4952;386;1320;423;1272;809;2592
314740;201805;2805;8339;2292;7407;250;924;1239;3914;1489;4838
314750;201805;340;987;262;828;26;97;142;420;168;517
314760;201805;1851;5851;1282;4495;185;745;299;858;484;1603
314770;201805;1042;3145;522;1762;38;136;130;381;168;517
314780;201805;328;819;222;661;47;160;113;316;160;476
314790;201805;10489;30327;7646;24986;2387;8701;1187;3428;3574;12129
314795;201805;1449;4065;1241;3706;55;232;964;2766;1019;2998
314800;201805;11227;30085;6774;21375;1426;4817;1023;2909;2449;7726
314810;201805;9613;27540;7194;23186;1903;6286;1998;6892;3901;13178
314820;201805;919;2456;679;2051;89;322;383;1116;472;1438
314830;201805;1526;4860;1300;4420;300;1093;604;2034;904;3127
314840;201805;909;3003;719;2709;80;417;465;1668;545;2085
314850;201805;1970;5135;1567;4482;82;290;1282;3627;1364;3917
314860;201805;3209;10139;2709;9142;422;1545;1563;5137;1985;6682
314870;201805;5927;16564;4720;14858;399;1351;3435;10885;3834;12236
314875;201805;1717;5374;1559;5168;95;275;1324;4429;1419;4704
314880;201805;907;2275;713;2012;34;79;498;1475;532;1554
314890;201805;457;1345;331;1072;50;187;118;344;168;531
314900;201805;669;1832;517;1570;118;386;176;522;294;908
314910;201805;1656;5037;1276;4419;277;1145;609;1980;886;3125
314915;201805;2271;6999;1937;6397;145;578;1293;4147;1438;4725
314920;201805;460;1197;317;1002;17;57;193;596;210;653
314930;201805;5288;16121;4107;13752;878;3169;1327;4223;2205;7392
314940;201805;402;1092;341;979;35;95;202;548;237;643
314950;201805;389;1076;264;862;30;112;109;332;139;444
314960;201805;765;2082;579;1713;54;198;361;987;415;1185
314970;201805;648;2017;528;1798;102;382;236;781;338;1163
314980;201805;1346;3852;1040;3377;291;1045;206;645;497;1690
314990;201805;2274;6791;1566;5156;347;1282;313;884;660;2166
314995;201805;1551;4619;1305;4201;110;447;790;2419;900;2866
315000;201805;1052;2932;811;2514;90;323;493;1476;583;1799
315010;201805;404;1216;300;1002;61;248;114;335;175;583
315015;201805;2138;6359;1934;6070;211;724;1269;4057;1480;4781
315020;201805;831;2493;606;2042;82;318;295;926;377;1244
315030;201805;573;1663;421;1361;114;403;90;257;204;660
315040;201805;828;2481;741;2285;111;368;456;1389;567;1757
315050;201805;1139;3128;896;2778;85;314;485;1487;570;1801
315053;201805;1136;3181;901;2739;95;341;502;1488;597;1829
315057;201805;1619;5314;1421;4906;191;663;855;2984;1046;3647
315060;201805;619;1964;418;1531;94;355;81;301;175;656
315070;201805;646;1825;471;1490;125;421;132;388;257;809
315080;201805;2622;8242;2070;7011;449;1517;920;3123;1369;4640
315090;201805;805;2620;621;2211;119;453;189;630;308;1083
315100;201805;1162;3729;774;2755;140;577;285;922;425;1499
315110;201805;1419;3826;1106;3288;151;468;539;1609;690;2077
315120;201805;12058;28897;8662;24026;1107;3109;4412;12839;5519;15948
315130;201805;1279;3932;1041;3429;183;701;387;1188;570;1889
315140;201805;2860;8300;2237;7124;427;1556;1017;2932;1444;4488
315150;201805;4200;10899;3009;8888;472;1534;1272;3672;1744;5206
315160;201805;1498;3883;995;3056;204;653;391;1176;595;1829
315170;201805;1509;4795;1060;3743;234;859;163;573;397;1432
315180;201805;17199;45303;9157;28824;1389;4927;2070;5697;3459;10624
315190;201805;2056;4894;1637;4303;286;787;1115;2887;1401;3674
315200;201805;3645;11250;2771;9607;830;3101;601;2040;1431;5141
315210;201805;7925;21911;5896;17515;757;2473;2533;6914;3290;9387
315213;201805;1117;3126;967;2909;28;91;765;2281;793;2372
315217;201805;2449;7956;1969;7067;128;646;1304;4505;1432;5151
315220;201805;8699;24482;7016;21531;2008;6507;2209;6702;4217;13209
315230;201805;3075;7681;2694;7237;79;129;2391;6682;2470;6811
315240;201805;2573;7966;2234;7392;577;2046;1084;3501;1661;5547
315250;201805;10055;28992;7634;24419;1391;4851;3034;9389;4425;14240
315260;201805;952;2843;548;1894;92;329;49;142;141;471
315270;201805;754;2327;533;1865;87;372;141;421;228;793
315280;201805;2792;7423;1622;5027;376;1242;248;748;624;1990
315290;201805;1241;3271;764;2492;220;778;184;606;404;1384
315300;201805;698;1763;480;1480;224;752;106;342;330;1094
315310;201805;1309;3854;1000;3245;88;312;559;1737;647;2049
315320;201805;681;2036;505;1720;57;278;222;697;279;975
315330;201805;737;2621;411;1686;77;345;103;381;180;726
315340;201805;3198;8409;2453;7309;234;763;1459;4270;1693;5033
315350;201805;1546;4291;1145;3609;127;449;546;1692;673;2141
315360;201805;1655;5193;1228;4244;217;812;432;1415;649;2227
315370;201805;449;1370;369;1197;66;207;162;516;228;723
315380;201805;187;594;145;499;38;155;32;89;70;244
315390;201805;1224;3778;913;3120;171;613;292;937;463;1550
315400;201805;4130;11938;3281;10328;465;1528;1686;5174;2151;6702
315410;201805;2306;5457;1804;4748;392;1148;651;1665;1043;2813
315415;201805;1188;3520;975;3172;265;979;365;1165;630;2144
315420;201805;1149;3478;793;2757;163;580;102;316;265;896
315430;201805;3553;9125;2555;7506;592;1998;908;2494;1500;4492
315440;201805;981;2760;826;2497;99;368;443;1232;542;1600
315445;201805;2006;5163;1505;4385;161;505;993;2848;1154;3353
315450;201805;2236;6656;1922;6144;271;846;1203;3927;1474;4773
315460;201805;30411;92765;26127;84542;7423;25604;8566;26322;15989;51926
315470;201805;464;1359;364;1177;33;117;188;590;221;707
315480;201805;1437;4231;977;3235;204;720;238;768;442;1488
315490;201805;2948;7518;2100;6306;311;1004;743;2166;1054;3170
315500;201805;500;1416;308;976;21;79;147;412;168;491
315510;201805;1265;3584;1088;3308;44;182;898;2675;942;2857
315520;201805;1098;3158;863;2771;58;226;564;1751;622;1977
315530;201805;639;2038;503;1708;165;612;167;535;332;1147
315540;201805;1170;3354;849;2735;118;438;336;1051;454;1489
315550;201805;1773;4881;1300;4123;278;990;430;1307;708;2297
315560;201805;6052;19635;5393;18463;406;1470;3601;12405;4007;13875
315570;201805;1879;5630;1617;5123;122;474;908;2776;1030;3250
315580;201805;2253;5956;1762;5134;411;1364;544;1540;955;2904
315590;201805;921;2525;741;2232;95;338;360;1031;455;1369
315600;201805;2381;8010;1778;6799;261;993;964;3825;1225;4818
315610;201805;933;2488;727;2099;131;468;302;727;433;1195
315620;201805;310;1021;282;977;57;190;156;587;213;777
315630;201805;866;2565;720;2286;168;571;208;580;376;1151
315640;201805;387;1048;323;946;35;118;181;510;216;628
315645;201805;896;2411;614;1928;180;607;155;453;335;1060
315650;201805;1784;4664;1392;4095;67;276;1072;3062;1139;3338
315660;201805;2489;6270;1888;5248;118;332;1279;3468;1397;3800
315670;201805;12561;37120;10264;32821;2135;7236;4481;13871;6616;21107
315680;201805;2956;9351;2239;7924;460;1805;886;3075;1346;4880
315690;201805;2820;7591;1846;5832;429;1437;458;1545;887;2982
315700;201805;7184;21203;5694;18175;989;3341;2547;7836;3536;11177
315710;201805;1905;5014;1349;4104;73;324;891;2564;964;2888
315720;201805;4128;12345;3565;11315;199;922;2411;7284;2610;8206
315725;201805;1611;4599;1357;4249;178;569;935;3002;1113;3571
315727;201805;569;1599;428;1332;66;233;199;580;265;813
315730;201805;680;2108;604;1941;82;298;288;878;370;1176
315733;201805;1395;3711;997;2994;187;663;347;958;534;1621
315737;201805;1131;3367;897;2919;39;172;634;2029;673;2201
315740;201805;969;2819;765;2391;136;496;361;1007;497;1503
315750;201805;1213;3402;1020;3082;92;300;682;2064;774;2364
315760;201805;1170;2904;1088;2806;29;56;994;2579;1023;2635
315765;201805;1811;5042;1519;4664;42;165;1348;4134;1390;4299
315770;201805;1176;3650;997;3383;351;1313;302;973;653;2286
315780;201805;25543;75692;22073;69181;2347;8707;12875;38352;15222;47059
315790;201805;3639;11503;3110;10507;255;875;2037;7056;2292;7931
315800;201805;1219;4694;912;3796;183;840;181;688;364;1528
315810;201805;1299;3349;1132;3102;66;231;897;2342;963;2573
315820;201805;2401;7337;2061;6769;256;946;1371;4417;1627;5363
315830;201805;1163;3464;859;2912;69;277;370;1196;439;1473
315840;201805;764;1937;467;1366;59;195;186;491;245;686
315850;201805;1047;3375;915;3154;204;774;442;1417;646;2191
315860;201805;514;1602;357;1285;69;281;104;349;173;630
315870;201805;449;1237;369;1116;25;96;242;684;267;780
315880;201805;1129;3000;811;2473;60;230;297;849;357;1079
315890;201805;1477;4748;1277;4396;396;1463;516;1693;912;3156
315895;201805;5844;16861;4669;14416;654;2281;2142;6096;2796;8377
315900;201805;830;2223;730;2081;66;224;567;1546;633;1770
315910;201805;492;1546;431;1443;73;262;271;875;344;1137
315920;201805;1583;4295;832;2645;163;549;215;620;378;1169
315930;201805;1056;2593;727;2057;145;419;294;812;439;1231
315935;201805;817;2619;695;2378;156;583;210;739;366;1322
315940;201805;611;1844;509;1639;65;229;266;839;331;1068
315950;201805;1201;3432;1019;3125;142;437;724;2231;866;2668
315960;201805;3581;10556;2268;8037;729;3010;113;240;842;3250
315970;201805;644;1841;514;1652;55;179;363;1189;418;1368
315980;201805;3713;8664;2170;6076;458;1402;725;1856;1183;3258
315990;201805;3750;9954;2949;8587;327;1055;1674;4776;2001;5831
316000;201805;529;1515;426;1350;69;266;178;518;247;784
316010;201805;692;2143;547;1852;53;227;300;919;353;1146
316020;201805;978;3047;820;2744;82;377;524;1623;606;2000
316030;201805;2962;8453;2156;6992;234;808;1334;4387;1568;5195
316040;201805;3335;11274;2574;9733;314;1193;994;4135;1308;5328
316045;201805;1941;5621;1808;5415;135;342;1454;4484;1589;4826
316050;201805;351;1075;265;910;51;204;134;430;185;634
316060;201805;700;1930;529;1664;53;214;322;933;375;1147
316070;201805;5741;16792;4788;14908;865;2917;2111;6316;2976;9233
316080;201805;730;2418;597;2131;159;624;72;250;231;874
316090;201805;471;1436;331;1136;48;189;128;405;176;594
316095;201805;1356;4255;1160;3868;233;810;569;1868;802;2678
316100;201805;2567;8043;1857;6392;343;1298;539;1716;882;3014
316105;201805;871;2403;652;2041;86;283;392;1227;478;1510
316110;201805;12130;38059;10477;35173;1324;4669;6680;22552;8004;27221
316120;201805;1027;3211;733;2479;148;518;186;532;334;1050
316130;201805;1417;3213;828;2288;91;289;389;1028;480;1317
316140;201805;1078;2947;720;2323;145;491;336;1073;481;1564
316150;201805;1603;3992;1356;3598;254;774;630;1549;884;2323
316160;201805;1092;3131;880;2744;88;318;516;1543;604;1861
316165;201805;894;2283;695;1965;111;374;379;1016;490;1390
316170;201805;1140;3108;858;2671;99;356;477;1413;576;1769
316180;201805;1378;4181;927;3180;189;719;117;326;306;1045
316190;201805;2596;7710;1517;5031;264;899;502;1493;766;2392
316200;201805;3436;10472;2545;8728;552;2145;570;1828;1122;3973
316210;201805;4448;13536;3231;10892;1023;3655;365;1228;1388;4883
316220;201805;630;1962;424;1492;90;343;46;191;136;534
316225;201805;1325;3273;1027;2752;59;222;743;1865;802;2087
316230;201805;423;1145;324;1001;36;108;161;515;197;623
316240;201805;6018;17805;5303;16724;555;1804;3880;12231;4435;14035
316245;201805;3075;10493;2775;9988;167;910;2145;7467;2312;8377
316250;201805;9465;25045;6873;20440;1792;5824;1625;4624;3417;10448
316255;201805;2777;8019;2402;7453;285;958;1655;5157;1940;6115
316257;201805;1265;3229;889;2613;119;378;433;1236;552;1614
316260;201805;1889;5008;1423;4285;45;156;796;2482;841;2638
316265;201805;1285;3475;933;2864;52;188;620;1855;672;2043
316270;201805;3443;11198;3009;10202;603;2182;1288;4188;1891;6370
316280;201805;3091;9519;2714;8794;385;1397;1451;4526;1836;5923
316290;201805;3267;9713;2602;8384;429;1584;906;2895;1335;4479
316292;201805;4427;12537;3655;11263;380;1360;2561;7708;2941;9068
316294;201805;764;2320;567;1972;99;384;98;337;197;721
316295;201805;2522;7399;2145;6710;102;438;1584;4785;1686;5223
316300;201805;975;3103;821;2804;64;254;528;1812;592;2066
316310;201805;964;2399;551;1735;87;298;223;699;310;997
316320;201805;576;1695;441;1451;66;244;169;542;235;786
316330;201805;1066;3036;801;2499;68;248;542;1628;610;1876
316340;201805;1075;3160;799;2607;85;354;421;1282;506;1636
316350;201805;1221;3766;1071;3520;132;471;678;2213;810;2684
316360;201805;683;1797;549;1583;64;202;380;1076;444;1278
316370;201805;4637;13511;3678;11602;807;2876;1053;2968;1860;5844
316380;201805;1632;4117;1255;3603;45;136;919;2629;964;2765
316390;201805;860;2347;653;1989;184;621;219;641;403;1262
316400;201805;1293;3824;885;3025;147;525;320;1038;467;1563
316410;201805;1039;3195;880;2934;65;224;704;2317;769;2541
316420;201805;1725;5315;1529;5055;94;389;1193;3877;1287;4266
316430;201805;887;2575;573;1935;124;432;130;426;254;858
316440;201805;686;2190;526;1919;142;603;73;248;215;851
316443;201805;577;1702;454;1464;109;393;117;364;226;757
316447;201805;1775;4940;1553;4609;60;203;1261;3730;1321;3933
316450;201805;2174;6890;1718;5940;208;775;1110;3783;1318;4558
316460;201805;886;2520;768;2319;223;719;368;1073;591;1792
316470;201805;6004;18146;4689;15483;958;3585;1544;4711;2502;8296
316480;201805;197;603;168;542;32;121;71;207;103;328
316490;201805;324;907;239;724;31;103;94;250;125;353
316500;201805;1226;4080;792;2921;150;598;114;387;264;985
316510;201805;645;2342;577;2197;140;580;231;891;371;1471
316520;201805;1007;2871;803;2509;133;496;330;957;463;1453
316530;201805;977;2860;742;2406;116;492;316;896;432;1388
316540;201805;726;2205;633;2038;109;419;224;657;333;1076
316550;201805;1274;4030;1141;3769;114;440;796;2573;910;3013
316553;201805;3120;9852;2133;7424;547;2053;381;1187;928;3240
316555;201805;2658;8814;2395;8446;145;586;1843;6617;1988;7203
316556;201805;642;1585;453;1274;30;87;246;618;276;705
316557;201805;896;3070;794;2877;322;1231;227;786;549;2017
316560;201805;271;851;204;754;53;232;50;168;103;400
316570;201805;1127;3543;1007;3306;297;991;330;1081;627;2072
316580;201805;377;948;238;685;53;169;88;227;141;396
316590;201805;1376;3699;984;2975;178;580;519;1461;697;2041
316600;201805;1007;3197;879;2929;142;519;465;1532;607;2051
316610;201805;587;1972;493;1800;69;338;295;1015;364;1353
316620;201805;2081;6026;1787;5583;110;407;1283;4020;1393;4427
316630;201805;1511;4673;1209;4069;353;1171;444;1657;797;2828
316640;201805;149;418;119;366;23;79;55;138;78;217
316650;201805;981;3282;807;3017;62;256;519;1999;581;2255
316660;201805;193;490;82;255;9;39;13;33;22;72
316670;201805;1942;5176;1477;4386;427;1342;427;1198;854;2540
316680;201805;2043;5375;1593;4653;137;467;1133;3188;1270;3655
316690;201805;1090;3432;911;3091;224;860;355;1161;579;2021
316695;201805;999;3021;866;2782;54;228;590;1847;644;2075
316700;201805;383;994;324;923;17;77;234;620;251;697
316710;201805;2687;9506;2145;8320;622;2464;679;2734;1301;5198
316720;201805;18986;56281;14552;47253;3013;10471;5317;16515;8330;26986
316730;201805;351;1037;295;915;67;236;123;341;190;577
316740;201805;674;2078;607;1980;62;269;429;1383;491;1652
316750;201805;410;1286;311;1082;64;249;111;370;175;619
316760;201805;3646;11657;2988;10465;1297;4849;864;2980;2161;7829
316770;201805;1484;3769;1206;3381;33;120;1030;2918;1063;3038
316780;201805;601;1894;475;1646;143;557;59;166;202;723
316790;201805;720;2003;526;1641;121;402;176;533;297;935
316800;201805;5483;16563;4532;14764;462;1764;2649;8298;3111;10062
316805;201805;949;2181;818;2031;25;37;723;1885;748;1922
316810;201805;556;1598;402;1309;94;341;163;509;257;850
316820;201805;325;806;167;522;24;85;31;101;55;186
316830;201805;641;1955;543;1780;100;378;317;996;417;1374
316840;201805;2633;7643;2252;6921;414;1452;1130;3285;1544;4737
316850;201805;2056;5579;1532;4647;195;680;747;2198;942;2878
316860;201805;17373;49749;13775;43965;2668;9642;5804;17935;8472;27577
316870;201805;6540;19583;5019;16358;1103;3882;1568;4845;2671;8727
316880;201805;844;2361;713;2155;150;535;299;855;449;1390
316890;201805;1212;2845;794;2275;167;577;423;1073;590;1650
316900;201805;2325;6617;1845;5614;404;1383;607;1651;1011;3034
316905;201805;473;1483;385;1294;88;317;162;542;250;859
316910;201805;875;2532;592;1999;151;592;56;172;207;764
316920;201805;1650;4361;1119;3503;200;686;489;1538;689;2224
316930;201805;7870;24913;5872;20844;1069;4125;1210;4088;2279;8213
316935;201805;4003;11570;2831;9274;660;2282;799;2573;1459;4855
316940;201805;6733;20909;5168;17395;977;3656;1603;4976;2580;8632
316950;201805;1752;4437;1378;3900;64;224;1081;2988;1145;3212
316960;201805;4827;11702;3630;9999;528;1614;2222;6030;2750;7644
316970;201805;3211;9801;2864;9111;720;2368;995;3012;1715;5380
316980;201805;790;2384;548;1895;154;576;64;221;218;797
316990;201805;10106;29773;7611;24364;2025;6891;782;2285;2807;9176
317000;201805;2658;8433;2464;8153;190;635;1793;6209;1983;6844
317005;201805;2500;7339;2072;6575;367;1196;1057;3317;1424;4513
317010;201805;23247;56516;14043;42286;3403;11241;3137;10039;6540;21280
317020;201805;60065;153064;34858;105261;6653;21925;8158;22310;14811;44235
317030;201805;681;1934;544;1730;35;146;381;1182;416;1328
317040;201805;10280;27585;7478;22665;1834;5844;2753;8383;4587;14227
317043;201805;789;1965;629;1742;117;347;377;1041;494;1388
317047;201805;1183;2918;823;2356;102;268;486;1396;588;1664
317050;201805;1321;4243;945;3352;136;502;331;1071;467;1573
317052;201805;2317;6962;1928;6296;250;865;1242;4008;1492;4873
317057;201805;1664;4271;1190;3448;56;216;782;2207;838;2423
317060;201805;412;1127;230;734;40;138;76;217;116;355
317065;201805;1260;3666;1048;3282;50;218;770;2290;820;2508
317070;201805;8275;24088;5502;18224;1165;4307;984;3050;2149;7357
317075;201805;962;2866;682;2254;139;463;126;388;265;851
317080;201805;5898;14969;4625;12818;1524;4428;1185;3010;2709;7438
317090;201805;4485;14148;4111;13553;386;1314;2976;9811;3362;11125
317100;201805;2641;6629;1803;5275;592;1835;531;1512;1123;3347
317103;201805;1841;6036;1620;5633;199;907;975;3170;1174;4077
317107;201805;1325;3812;1091;3342;60;238;685;1915;745;2153
317110;201805;627;1420;331;999;48;183;117;359;165;542
317115;201805;1127;3337;937;2958;74;230;659;2084;733;2314
317120;201805;11860;35176;9285;30505;1477;5386;4544;14347;6021;19733
317130;201805;8553;21838;5836;17336;1239;4011;1902;5569;3141;9580
317140;201805;581;1766;497;1615;56;179;300;982;356;1161
317150;201805;1007;2565;806;2315;43;154;634;1777;677;1931
317160;201805;3620;9069;2535;7441;269;809;1518;4487;1787;5296
317170;201805;1985;5188;1406;4140;224;757;495;1258;719;2015
317180;201805;1640;5426;1280;4575;298;1150;314;1043;612;2193
317190;201805;1305;3647;979;3123;76;257;628;1977;704;2234
317200;201805;4672;13166;3542;11047;867;2960;805;2292;1672;5252
317210;201805;1056;2847;847;2541;55;223;605;1825;660;2048
317220;201805;270;902;242;836;58;216;96;321;154;537
320010;201805;4598;13892;3799;12306;437;1568;2315;7291;2752;8859
320013;201805;1688;5117;1219;4031;202;653;524;1795;726;2448
320016;201805;3091;8202;2507;7355;142;406;1990;5829;2132;6235
320020;201805;3838;11069;2985;9456;757;2560;941;3034;1698;5594
320030;201805;1434;4399;1010;3471;259;964;283;890;542;1854
320035;201805;1673;4823;1426;4412;419;1420;606;1824;1025;3244
320040;201805;3292;10137;2702;9008;469;1704;1271;4167;1740;5871
320050;201805;1718;4239;1504;3893;302;854;802;2009;1104;2863
320060;201805;9948;29615;7326;24188;1412;5092;2369;7483;3781;12575
320070;201805;1408;4270;1052;3513;206;721;322;1055;528;1776
320080;201805;5390;14845;3986;12072;792;2500;1500;4514;2292;7014
320090;201805;6758;19194;5116;15860;1254;4079;2009;6018;3263;10097
320100;201805;2527;7594;1965;6489;519;1821;739;2360;1258;4181
320110;201805;1279;3512;1017;3026;241;742;333;998;574;1740
320115;201805;1794;6045;1560;5620;743;2778;421;1571;1164;4349
320120;201805;15017;41716;10899;34121;2173;7436;3490;10467;5663;17903
320130;201805;35432;106213;30354;96887;4999;17510;16095;49888;21094;67398
320140;201805;2958;8956;2150;7210;481;1819;626;2039;1107;3858
320150;201805;13348;36738;9527;29092;2775;8980;1433;4148;4208;13128
320160;201805;5247;15757;4099;13431;789;2796;1797;5804;2586;8600
320170;201805;1595;4825;1183;3950;299;996;443;1468;742;2464
320180;201805;702;2322;570;2053;202;772;125;445;327;1217
320190;201805;3014;10007;2279;8301;561;2118;459;1657;1020;3775
320200;201805;1011;2962;757;2497;215;796;205;683;420;1479
320210;201805;4592;12290;3609;10517;597;1920;1818;5052;2415;6972
320220;201805;2663;7570;2067;6528;357;1194;1094;3444;1451;4638
320225;201805;1285;4197;922;3279;321;1216;133;465;454;1681
320230;201805;4366;13074;3402;11360;904;3288;1282;4251;2186;7539
320240;201805;13244;36390;10286;31420;2167;7100;4235;12877;6402;19977
320245;201805;2928;9334;2492;8398;984;3447;587;1944;1571;5391
320250;201805;1945;5770;1334;4299;313;1137;284;816;597;1953
320255;201805;1686;5625;1488;5271;557;2024;586;2181;1143;4205
320260;201805;1011;3036;727;2364;205;738;190;521;395;1259
320265;201805;2387;7533;2014;6794;871;3080;513;1702;1384;4782
320270;201805;2280;6719;1750;5642;344;1171;829;2698;1173;3869
320280;201805;5566;16353;4622;14585;1225;4122;1436;4410;2661;8532
320290;201805;1315;4114;897;3079;272;1044;179;557;451;1601
320300;201805;3725;12059;3073;10593;988;3606;614;2066;1602;5672
320305;201805;4578;13806;3668;11864;846;2915;1472;4596;2318;7511
320310;201805;1803;5249;1335;4252;289;949;536;1687;825;2636
320313;201805;2078;5624;1383;4196;311;1051;278;787;589;1838
320316;201805;1503;4401;1186;3763;256;870;568;1787;824;2657
320320;201805;19906;55353;14273;45348;3577;12000;4856;15285;8433;27285
320330;201805;2845;8200;2288;7184;644;1993;922;3053;1566;5046
320332;201805;5323;16135;4439;14513;1028;3591;2196;7043;3224;10634
320334;201805;2019;6114;1377;4702;302;1179;283;850;585;2029
320335;201805;1838;5449;1160;3832;302;1083;215;642;517;1725
320340;201805;4925;13088;4158;11878;720;2155;2156;6289;2876;8444
320350;201805;4996;12984;3523;10244;566;1757;1597;4488;2163;6245
320360;201805;1527;4006;1109;3196;176;495;507;1429;683;1924
320370;201805;2489;8112;1953;6861;552;1982;634;2205;1186;4187
320380;201805;2172;6218;1835;5631;365;1221;947;2809;1312;4030
320390;201805;7144;20362;5424;16756;1234;4052;1992;5938;3226;9990
320400;201805;3321;9902;2744;8708;691;2321;1117;3494;1808;5815
320405;201805;4462;12402;3514;10769;524;1702;1884;5723;2408;7425
320410;201805;4889;13360;3678;11440;616;1980;1779;5736;2395;7716
320420;201805;2688;7669;2098;6621;576;2000;506;1567;1082;3567
320425;201805;2004;4965;1531;4171;129;400;971;2541;1100;2941
320430;201805;2610;6944;2068;5849;342;1036;1166;3102;1508;4138
320435;201805;2312;7448;1826;6445;670;2475;501;1810;1171;4285
320440;201805;1118;3346;869;2824;154;557;380;1208;534;1765
320450;201805;1630;4944;1299;4291;313;1127;567;1779;880;2906
320455;201805;3643;11620;2594;9125;745;2769;680;2353;1425;5122
320460;201805;2230;6974;1586;5480;352;1256;342;1121;694;2377
320465;201805;1267;3765;973;3155;116;418;538;1743;654;2161
320470;201805;3902;11188;2639;8468;688;2356;545;1645;1233;4001
320480;201805;1671;5002;1418;4481;260;904;685;2117;945;3021
320490;201805;16437;46521;12971;40428;2513;8713;5256;16353;7769;25066
320495;201805;1393;3976;923;2985;212;739;277;882;489;1621
320500;201805;44609;126479;37278;113598;6769;22146;19390;57142;26159;79288
320501;201805;4643;13844;3387;11601;938;3618;916;3014;1854;6632
320503;201805;2091;6674;1577;5549;482;1881;460;1484;942;3365
320506;201805;3252;9846;2227;7458;605;2184;126;381;731;2565
320510;201805;9076;26154;7460;23240;1259;4311;3972;12020;5231;16331
320515;201805;1805;5041;1407;4199;405;1266;360;1074;765;2340
320517;201805;1979;6320;1593;5482;572;2117;351;1169;923;3286
320520;201805;31843;90042;24675;77632;5032;17329;9502;29426;14534;46755
320530;201805;28187;79304;22226;68463;2975;10623;12489;36215;15464;46838
330010;201805;19408;56491;16494;51346;3288;10633;8705;27020;11993;37653
330015;201805;1360;3657;1135;3255;188;613;559;1517;747;2130
330020;201805;18949;50749;16697;47362;2510;8061;11195;30789;13705;38850
330022;201805;1849;5202;1481;4594;261;882;874;2649;1135;3531
330023;201805;3247;8963;2506;7842;596;1991;958;2930;1554;4921
330025;201805;4614;12136;3267;9694;1024;3332;977;2826;2001;6158
330030;201805;8957;26994;7303;23921;1066;3937;3980;12371;5046;16308
330040;201805;11359;32383;9849;29695;1465;4838;6029;17483;7494;22321
330045;201805;79083;198720;67025;182400;7443;19894;49192;132798;56635;152692
330050;201805;2302;6457;1809;5633;406;1354;786;2301;1192;3655
330060;201805;5199;14424;4344;13036;970;3193;1840;5234;2810;8427
330070;201805;19486;54460;16576;49897;3261;10374;8402;25241;11663;35615
330080;201805;8619;23786;7623;22249;848;2597;5061;14688;5909;17285
330090;201805;2441;6139;2030;5552;242;703;1264;3348;1506;4051
330093;201805;1990;5545;1577;4874;189;592;1025;3216;1214;3808
330095;201805;1022;3242;850;2881;108;412;416;1309;524;1721
330100;201805;61228;175442;52835;162575;4824;17255;36330;109968;41154;127223
330110;201805;2096;6400;1848;5970;350;1235;805;2511;1155;3746
330115;201805;1788;4856;1455;4354;262;869;840;2449;1102;3318
330120;201805;2959;7293;2377;6524;215;666;1746;4694;1961;5360
330130;201805;3480;10346;2955;9517;559;1934;1627;5237;2186;7171
330140;201805;3263;9286;2767;8532;484;1720;1604;4772;2088;6492
330150;201805;2025;5770;1622;5086;345;1141;639;1978;984;3119
330160;201805;1126;3303;939;3006;222;767;462;1426;684;2193
330170;201805;92020;255946;79607;237809;13321;40845;47453;141804;60774;182649
330180;201805;2057;5586;1661;4927;110;418;1131;3235;1241;3653
330185;201805;9018;25265;7537;22653;949;3198;4961;14408;5910;17606
330187;201805;3553;9814;2976;8902;481;1580;1795;5264;2276;6844
330190;201805;28105;73431;24882;68872;2634;7550;18858;51927;21492;59477
330200;201805;13310;38013;11366;35297;2619;7928;6376;20405;8995;28333
330205;201805;1922;5116;1611;4613;109;366;1108;3063;1217;3429
330210;201805;3182;8557;2385;7026;529;1658;846;2337;1375;3995
330220;201805;9660;27288;7657;23410;1771;5824;2145;6027;3916;11851
330225;201805;3566;10180;2916;9093;262;1039;1950;5829;2212;6868
330227;201805;16146;42919;14114;40134;1361;4182;10727;30203;12088;34385
330230;201805;1243;3431;1045;3113;88;284;680;1981;768;2265
330240;201805;18088;51044;14915;45784;3334;11060;6964;20691;10298;31751
330245;201805;1305;3651;913;2941;213;723;238;753;451;1476
330250;201805;33592;93360;29091;86294;7072;21261;13411;40666;20483;61927
330260;201805;4388;12377;3519;10950;579;1967;1803;5329;2382;7296
330270;201805;23545;49722;14434;36761;2719;7603;5845;14645;8564;22248
330280;201805;2203;6174;1762;5368;251;850;932;2704;1183;3554
330285;201805;19467;50510;16092;45650;2009;6392;10612;29195;12621;35587
330290;201805;3220;8923;2703;8064;410;1313;1495;4309;1905;5622
330300;201805;3280;10012;2825;9170;418;1525;1680;5278;2098;6803
330310;201805;2247;6091;1779;5282;144;401;1133;3386;1277;3787
330320;201805;13007;35147;11449;32943;1621;4733;8079;23326;9700;28059
330330;201805;28839;72548;24064;65516;3160;9541;15928;42018;19088;51559
330340;201805;13052;36145;10214;31202;2088;6955;4246;12309;6334;19264
330350;201805;93536;247064;80081;228759;8299;25378;57665;163495;65964;188873
330360;201805;7113;18478;6169;17368;389;1126;5057;14202;5446;15328
330370;201805;3513;11880;3051;10911;846;3156;1134;4022;1980;7178
330380;201805;4892;14621;3876;12728;879;3141;1432;4495;2311;7636
330385;201805;3829;12250;3307;11383;910;3389;1338;4615;2248;8004
330390;201805;22069;67023;17926;58857;3679;13076;8039;25442;11718;38518
330395;201805;3080;8417;2663;7821;216;731;1778;5144;1994;5875
330400;201805;2789;8052;2475;7485;206;770;1717;4865;1923;5635
330410;201805;2741;7946;2065;6702;405;1447;883;2697;1288;4144
330411;201805;2317;6774;1961;6084;180;674;1360;4020;1540;4694
330412;201805;1398;4407;1158;3937;192;715;590;1874;782;2589
330414;201805;23047;61010;19054;55415;2601;7408;12347;36001;14948;43409
330415;201805;3508;10108;2744;8783;485;1528;1321;4392;1806;5920
330420;201805;9214;24333;6108;19015;1049;3458;2048;6069;3097;9527
330430;201805;7564;20797;6633;19232;804;2692;4363;12157;5167;14849
330440;201805;1589;4910;1360;4528;348;1300;584;1822;932;3122
330450;201805;1308;4087;1082;3659;186;681;526;1726;712;2407
330452;201805;14233;39098;11151;33809;2260;7356;5466;16144;7726;23500
330455;201805;526054;1337150;406973;1152687;70621;212706;227292;631489;297913;844195
330460;201805;1203;3583;946;3167;199;710;443;1438;642;2148
330470;201805;4252;11626;3331;10140;875;2812;1323;3947;2198;6759
330475;201805;8284;23307;6840;21223;1694;5786;3375;10209;5069;15995
330480;201805;5775;16117;4985;14903;673;2248;3108;8961;3781;11209
330490;201805;113017;277167;96113;252975;10177;28973;67086;172886;77263;201859
330500;201805;5061;14533;4650;13915;661;2109;3272;9691;3933;11800
330510;201805;37498;103995;30528;93598;8308;25864;14010;43133;22318;68997
330513;201805;1166;3380;1017;3107;300;972;392;1170;692;2142
330515;201805;2716;7842;2246;6999;686;2242;812;2479;1498;4721
330520;201805;10264;29697;8692;26956;1558;5283;4270;12733;5828;18016
330530;201805;1535;4112;1204;3547;264;848;523;1471;787;2319
330540;201805;2750;7809;2206;6829;643;2038;768;2340;1411;4378
330550;201805;7577;23524;6436;21545;2409;8425;1599;5436;4008;13861
330555;201805;11088;29125;9475;26908;1460;4398;6152;17559;7612;21957
330560;201805;4169;11940;3538;10766;473;1540;2065;6098;2538;7638
330570;201805;2853;8318;2402;7517;473;1567;1324;4088;1797;5655
330575;201805;5302;14356;4622;13167;447;1445;3387;9313;3834;10758
330580;201805;11706;34571;9343;30093;2379;8132;3700;11641;6079;19773
330590;201805;1526;4367;1349;4134;153;471;958;2955;1111;3426
330600;201805;10959;31426;8780;27510;1356;4511;4462;13916;5818;18427
330610;201805;8624;25319;7484;23497;905;3291;4665;14221;5570;17512
330615;201805;1618;5199;1421;4913;409;1551;707;2405;1116;3956
330620;201805;3523;11333;2958;10263;975;3610;762;2514;1737;6124
330630;201805;23535;64209;18782;56036;2091;7275;11937;34054;14028;41329
350010;201805;1904;5344;1011;3311;238;804;91;235;329;1039
350020;201805;624;1677;337;1095;31;113;151;441;182;554
350030;201805;3859;11551;2925;9719;761;2688;866;2777;1627;5465
350040;201805;595;1878;385;1376;75;299;106;341;181;640
350050;201805;886;2515;651;2052;145;522;182;458;327;980
350055;201805;719;1968;606;1801;51;170;463;1356;514;1526
350060;201805;112;332;89;294;19;69;37;124;56;193
350070;201805;3889;10742;2369;7669;437;1455;706;2059;1143;3514
350075;201805;593;1907;453;1594;185;679;56;168;241;847
350080;201805;683;1873;422;1326;49;169;183;541;232;710
350090;201805;629;1562;354;1035;83;240;104;299;187;539
350100;201805;2068;5844;1388;4575;183;722;646;1977;829;2699
350110;201805;424;1236;318;1018;24;86;198;620;222;706
350115;201805;1279;3862;1060;3373;194;675;504;1450;698;2125
350120;201805;798;2108;477;1443;62;172;256;798;318;970
350130;201805;3233;9159;2646;7985;362;1176;1387;3954;1749;5130
350140;201805;584;1902;470;1673;34;160;255;847;289;1007
350150;201805;521;1635;441;1477;130;450;130;420;260;870
350160;201805;10333;26739;6669;20049;901;3100;3611;10065;4512;13165
350170;201805;1543;4890;1203;4091;258;919;350;1130;608;2049
350180;201805;1133;2961;627;1911;127;426;232;668;359;1094
350190;201805;2895;8616;2142;7042;465;1695;787;2141;1252;3836
350200;201805;370;1081;314;979;23;71;220;660;243;731
350210;201805;5147;12753;3436;9912;686;2033;1694;4765;2380;6798
350220;201805;2330;6975;1826;5866;381;1347;702;2033;1083;3380
350230;201805;883;2613;769;2410;163;534;368;1144;531;1678
350240;201805;660;1972;458;1508;76;259;159;509;235;768
350250;201805;2197;7162;1767;6359;605;2346;377;1411;982;3757
350260;201805;817;2124;531;1579;75;222;276;806;351;1028
350270;201805;4527;13120;3673;11339;633;2135;1759;5065;2392;7200
350275;201805;2100;6272;1735;5611;371;1267;801;2494;1172;3761
350280;201805;20074;46835;12265;33901;2284;6723;4022;10705;6306;17428
350290;201805;2974;8767;2057;6853;385;1402;785;2528;1170;3930
350300;201805;651;1885;466;1472;101;330;159;449;260;779
350310;201805;804;2521;678;2232;85;329;289;884;374;1213
350315;201805;535;1538;379;1229;50;191;141;407;191;598
350320;201805;11453;32561;9241;28540;2474;8129;2201;6803;4675;14932
350330;201805;14721;37940;10070;28304;1302;3851;5453;14446;6755;18297
350335;201805;371;1078;309;968;20;61;220;696;240;757
350340;201805;1036;2826;660;2111;126;448;218;674;344;1122
350350;201805;714;2043;579;1868;98;329;260;812;358;1141
350360;201805;929;2968;784;2638;215;706;289;969;504;1675
350370;201805;586;1642;404;1245;113;350;81;223;194;573
350380;201805;4651;12975;3153;10094;765;2544;881;2767;1646;5311
350390;201805;9384;27119;7743;24069;2089;6721;2864;8628;4953;15349
350395;201805;406;1069;199;657;25;87;61;176;86;263
350400;201805;7479;20154;5462;16577;1389;4550;1572;4513;2961;9063
350410;201805;9000;26969;6694;22359;1597;5891;1892;5810;3489;11701
350420;201805;607;1819;457;1527;86;336;82;244;168;580
350430;201805;696;2007;575;1789;69;260;347;1001;416;1261
350440;201805;1432;4152;1169;3621;201;678;646;1934;847;2612
350450;201805;6449;19372;5174;16866;1168;4049;1725;5326;2893;9375
350460;201805;1504;3922;817;2549;142;507;208;579;350;1086
350470;201805;220;580;183;513;9;34;122;319;131;353
350480;201805;810;2258;531;1682;99;347;77;201;176;548
350490;201805;1706;4975;1312;4225;295;983;436;1311;731;2294
350500;201805;590;1698;490;1516;86;299;249;748;335;1047
350510;201805;1088;3085;805;2524;97;339;415;1221;512;1560
350520;201805;1844;6270;1432;5305;266;1091;498;1731;764;2822
350530;201805;2335;6415;1767;5252;400;1263;692;1917;1092;3180
350535;201805;1375;4037;1221;3812;124;466;855;2603;979;3069
350540;201805;1608;4341;1186;3602;243;805;530;1605;773;2410
350550;201805;9138;23017;6133;18045;784;2674;2925;8010;3709;10684
350560;201805;3520;10767;2909;9486;319;1113;1749;5573;2068;6686
350570;201805;18905;57099;15983;51303;3954;13695;6788;20708;10742;34403
350580;201805;1709;5134;1013;3409;209;711;114;317;323;1028
350590;201805;4172;12106;3105;9788;607;2176;1464;4185;2071;6361
350600;201805;38084;94143;24588;68732;3398;10490;11582;29600;14980;40090
350610;201805;6560;18833;4942;15659;1032;3483;2036;6286;3068;9769
350620;201805;377;1039;270;875;33;125;129;399;162;524
350630;201805;1517;4195;1117;3419;98;340;599;1719;697;2059
350635;201805;6644;18139;5112;15566;1045;3535;2460;7100;3505;10635
350640;201805;808;2381;479;1557;71;263;155;431;226;694
350650;201805;7895;22363;5160;16394;1036;3545;1467;4299;2503;7844
350660;201805;4655;13023;3671;11281;708;2276;1706;5251;2414;7527
350670;201805;1545;4632;1371;4336;249;796;749;2395;998;3191
350680;201805;1051;2985;725;2345;140;496;304;968;444;1464
350690;201805;1028;3062;777;2551;144;518;359;1117;503;1635
350700;201805;4166;11736;3032;9804;667;2387;1322;4001;1989;6388
350710;201805;2632;7756;2251;7037;302;1063;1286;3852;1588;4915
350715;201805;799;2340;683;2104;83;318;367;1014;450;1332
350720;201805;152;416;124;371;24;74;46;133;70;207
350730;201805;449;1464;354;1266;61;247;163;549;224;796
350740;201805;1580;4651;1047;3443;183;632;252;762;435;1394
350745;201805;581;1653;344;1098;39;134;140;384;179;518
350750;201805;8775;25441;7106;22237;1389;4930;2620;7261;4009;12191
350760;201805;12915;34826;9475;28872;2557;8361;2275;6131;4832;14492
350770;201805;667;1845;466;1441;61;201;282;854;343;1055
350775;201805;619;1625;477;1387;57;181;215;624;272;805
350780;201805;1862;5227;1415;4418;331;1142;371;1270;702;2412
350790;201805;1654;4836;1099;3729;218;804;172;508;390;1312
350800;201805;3079;9726;2764;9110;467;1660;1420;4554;1887;6214
350810;201805;2072;5594;1764;5178;338;1025;960;2940;1298;3965
350820;201805;746;1894;425;1272;51;155;186;507;237;662
350830;201805;856;2507;501;1679;64;224;147;430;211;654
350840;201805;2585;8232;1982;7022;564;2172;615;2020;1179;4192
350850;201805;6034;18452;4741;15825;1324;4627;1362;4490;2686;9117
350860;201805;3124;9109;2854;8687;126;494;2178;6517;2304;7011
350870;201805;2723;8116;2067;7005;396;1530;1040;3422;1436;4952
350880;201805;1267;3965;1017;3374;231;772;306;999;537;1771
350890;201805;657;1774;405;1246;47;157;127;322;174;479
350900;201805;5880;17212;3985;13187;1246;4506;488;1476;1734;5982
350910;201805;818;2263;705;2040;135;450;425;1184;560;1634
350920;201805;11719;31133;10052;28337;611;2008;7784;21061;8395;23069
350925;201805;4507;13207;3325;10916;729;2460;1155;3427;1884;5887
350930;201805;1390;3838;967;2981;141;457;455;1325;596;1782
350940;201805;1906;5712;1586;5089;225;807;923;2855;1148;3662
350945;201805;902;2683;695;2268;126;443;295;904;421;1347
350950;201805;76506;214490;60579;180970;9533;31280;33062;93068;42595;124348
350960;201805;5029;14940;4032;13026;704;2635;2102;6359;2806;8994
350970;201805;3674;11814;2878;9987;922;3447;397;1179;1319;4626
350980;201805;582;1792;484;1578;175;574;156;505;331;1079
350990;201805;1762;5448;1357;4684;355;1370;428;1364;783;2734
350995;201805;795;2587;717;2415;57;235;446;1433;503;1668
351000;201805;2552;7120;1919;5900;387;1313;576;1641;963;2954
351010;201805;314;847;182;572;22;74;87;260;109;334
351015;201805;692;2249;568;2007;94;371;254;857;348;1228
351020;201805;8644;25006;6981;22286;1296;4384;3968;12494;5264;16878
351030;201805;2451;7755;2000;6729;301;1180;995;3149;1296;4329
351040;201805;4344;11791;3723;10793;262;934;2841;7927;3103;8861
351050;201805;16029;41491;10900;33024;2442;7990;3849;11446;6291;19436
351060;201805;41124;109996;32440;94995;4829;15240;19469;55277;24298;70517
351070;201805;1371;3649;805;2602;234;804;79;247;313;1051
351080;201805;2526;7067;1901;6244;428;1536;876;2702;1304;4238
351090;201805;363;1137;254;922;47;181;56;210;103;391
351100;201805;2479;7104;1618;5131;392;1323;363;1171;755;2494
351110;201805;5402;14520;3615;11185;821;2796;1217;3414;2038;6210
351120;201805;706;1954;487;1525;78;251;192;557;270;808
351130;201805;993;2669;482;1621;93;329;89;276;182;605
351140;201805;1641;5242;1255;4416;334;1268;306;959;640;2227
351150;201805;1711;5364;1081;3822;224;844;185;567;409;1411
351160;201805;1114;3736;918;3284;208;794;296;931;504;1725
351170;201805;1338;4034;1172;3671;141;489;704;2077;845;2566
351190;201805;807;2486;610;1993;108;344;216;664;324;1008
351200;201805;1670;4349;1289;3739;87;274;760;2096;847;2370
351210;201805;1386;3552;855;2515;103;353;441;1159;544;1512
351220;201805;3025;9299;2657;8594;393;1323;1547;4947;1940;6270
351230;201805;1794;5236;1360;4438;285;1063;573;1670;858;2733
351240;201805;1718;4728;1139;3464;239;780;495;1377;734;2157
351250;201805;1054;3002;612;1986;78;274;212;670;290;944
351260;201805;898;2563;724;2217;198;588;205;618;403;1206
351270;201805;327;1015;279;913;58;228;136;377;194;605
351280;201805;4187;11782;3306;10029;591;1970;1488;4269;2079;6239
351290;201805;972;2648;660;2050;118;377;273;813;391;1190
351300;201805;13888;40683;9844;32606;2204;7809;3267;10769;5471;18578
351310;201805;2935;8276;2286;7121;290;1070;1304;3773;1594;4843
351320;201805;880;2784;693;2311;115;408;246;774;361;1182
351330;201805;1036;4005;971;3893;53;139;828;3446;881;3585
351340;201805;6051;18594;4915;16485;1341;4641;1816;6125;3157;10766
351350;201805;10202;28182;8665;25514;1200;3754;5864;16689;7064;20443
351360;201805;3865;11143;3303;10172;797;2702;1093;3091;1890;5793
351370;201805;2219;6594;1545;5096;377;1294;500;1484;877;2778
351380;201805;40928;108292;32046;92102;5701;17173;15938;44491;21639;61664
351385;201805;274;751;174;547;30;82;55;174;85;256
351390;201805;1339;3532;889;2845;153;593;471;1374;624;1967
351400;201805;935;2838;776;2498;177;586;347;1091;524;1677
351410;201805;2276;6768;1792;5813;308;1027;833;2663;1141;3690
351420;201805;311;821;185;571;37;114;64;188;101;302
351430;201805;751;2249;684;2121;80;288;498;1505;578;1793
351440;201805;3187;8969;2205;6846;413;1393;469;1215;882;2608
351450;201805;1551;4262;1131;3488;244;804;254;758;498;1562
351460;201805;705;2006;588;1787;196;586;252;765;448;1351
351470;201805;1075;3013;883;2649;91;330;519;1445;610;1775
351480;201805;2516;7884;2145;7226;288;1152;1100;3532;1388;4684
351490;201805;1803;5597;1575;5120;103;429;1098;3388;1201;3817
351492;201805;337;1003;278;865;18;65;153;442;171;507
351495;201805;181;566;144;463;20;72;69;209;89;281
351500;201805;33553;87960;24699;72279;5189;16030;11466;32073;16655;48103
351510;201805;10734;29415;8080;24448;1356;4503;4474;12993;5830;17496
351512;201805;509;1411;341;1027;56;173;123;339;179;512
351515;201805;2957;7330;1838;5365;358;1176;465;1335;823;2511
351518;201805;2229;6155;1512;4820;230;853;767;2203;997;3056
351519;201805;627;1845;423;1362;87;317;82;185;169;502
351520;201805;1044;2725;409;1321;62;224;138;374;200;598
351530;201805;342;1002;189;623;30;100;61;164;91;264
351535;201805;2068;5248;1551;4388;146;506;963;2552;1109;3058
351540;201805;1849;5061;1301;4040;430;1469;220;560;650;2029
351550;201805;5597;15488;3821;11626;535;1812;1823;5108;2358;6920
351560;201805;400;1266;339;1124;78;296;80;251;158;547
351565;201805;162;547;142;500;31;118;57;188;88;306
351570;201805;15662;44094;12425;37617;1758;5838;7593;22004;9351;27842
351580;201805;290;771;160;509;21;63;52;181;73;244
351590;201805;508;1221;281;779;33;121;152;377;185;498
351600;201805;1650;4474;1262;3749;148;478;696;1924;844;2402
351610;201805;637;1646;445;1308;31;115;248;639;279;754
351620;201805;19224;56374;14529;47299;2659;9737;5279;15250;7938;24987
351630;201805;24811;70726;20897;63907;3777;12069;12289;36717;16066;48786
351640;201805;14405;40527;11614;35423;1526;5235;7356;21589;8882;26824
351650;201805;387;1123;173;591;27;86;34;117;61;203
351660;201805;757;2326;485;1626;81;306;79;224;160;530
351670;201805;4639;13447;3461;10773;653;2100;1662;4886;2315;6986
351680;201805;449;1373;281;917;52;152;73;228;125;380
351685;201805;435;1348;351;1183;97;318;103;343;200;661
351690;201805;982;2741;651;2038;120;398;231;630;351;1028
351700;201805;913;2599;763;2318;154;448;327;979;481;1427
351710;201805;610;1871;456;1544;57;235;195;596;252;831
351720;201805;1446;4068;979;3123;179;614;360;1100;539;1714
351730;201805;909;2579;743;2276;101;355;391;1104;492;1459
351740;201805;3877;10170;2984;8423;554;1641;1245;3247;1799;4888
351750;201805;1263;3808;784;2744;133;505;265;910;398;1415
351760;201805;3225;9648;2366;7776;535;1918;687;2068;1222;3986
351770;201805;1987;6119;1644;5413;426;1453;672;2151;1098;3604
351780;201805;1350;3655;707;2227;113;413;190;560;303;973
351790;201805;1209;3164;981;2817;168;452;576;1684;744;2136
351800;201805;564;1291;282;766;37;113;83;192;120;305
351810;201805;985;2748;810;2431;63;172;588;1717;651;1889
351820;201805;2465;7453;1742;5914;390;1409;302;988;692;2397
351830;201805;4331;12400;3294;10404;435;1577;1771;5319;2206;6896
351840;201805;6732;20785;5460;18342;1068;3984;2301;7221;3369;11205
351850;201805;1973;5246;1274;3974;233;833;384;1073;617;1906
351860;201805;2770;8601;2324;7694;492;1746;1133;3685;1625;5431
351870;201805;23325;64412;18497;56112;5899;18520;6431;19773;12330;38293
351880;201805;112736;322786;88031;276446;25494;85829;24582;72646;50076;158475
351885;201805;703;2256;625;2083;134;459;288;926;422;1385
351890;201805;600;1822;485;1602;99;340;86;234;185;574
351900;201805;1026;3022;802;2636;163;555;308;1019;471;1574
351905;201805;399;1145;279;892;33;119;110;301;143;420
351907;201805;20733;57121;16570;49407;1317;4557;11561;33376;12878;37933
351910;201805;1188;3322;863;2621;150;505;377;1019;527;1524
351920;201805;927;2503;712;2110;76;260;376;1060;452;1320
351925;201805;961;2777;755;2357;106;346;342;1005;448;1351
351930;201805;2745;8288;2585;7981;269;1052;2051;6127;2320;7179
351940;201805;1054;2878;786;2404;90;300;424;1276;514;1576
351950;201805;1375;3555;1060;3052;59;190;646;1819;705;2009
351960;201805;4813;13194;3572;10900;853;2790;1431;4134;2284;6924
351970;201805;5440;18423;4794;17173;979;3875;2330;7905;3309;11780
351980;201805;902;2487;655;1988;88;315;348;984;436;1299
351990;201805;1408;3613;995;2924;133;486;354;929;487;1415
352000;201805;2233;6982;1960;6411;217;842;1204;3717;1421;4559
352010;201805;1928;5733;1557;5006;375;1292;244;820;619;2112
352020;201805;1541;4419;1213;3840;230;792;538;1610;768;2402
352030;201805;5138;14434;4117;12836;834;2827;2132;6597;2966;9424
352040;201805;2082;6034;1358;4510;250;876;257;741;507;1617
352042;201805;3148;8081;1924;5825;392;1236;760;2290;1152;3526
352044;201805;1960;5659;1140;3976;187;715;234;749;421;1464
352050;201805;12174;34666;7990;25608;1947;7004;1170;3206;3117;10210
352060;201805;745;2186;563;1817;88;326;246;726;334;1052
352070;201805;812;1795;580;1456;89;243;265;642;354;885
352080;201805;460;1250;276;846;41;145;95;248;136;393
352090;201805;1374;4453;1081;3731;176;687;338;1044;514;1731
352100;201805;3215;9364;2574;8158;601;2051;1068;3222;1669;5273
352110;201805;556;1799;442;1540;97;376;159;499;256;875
352115;201805;529;1583;442;1430;98;331;221;711;319;1042
352120;201805;827;2598;663;2246;74;296;353;1097;427;1393
352130;201805;1849;5459;1191;3770;236;783;367;1106;603;1889
352140;201805;1451;3974;885;2826;140;472;367;1104;507;1576
352150;201805;819;2350;633;2004;164;521;295;938;459;1459
352160;201805;958;2508;698;2081;118;415;299;821;417;1236
352170;201805;2723;7971;2248;6918;437;1473;1078;3058;1515;4531
352180;201805;2800;7787;2237;6697;513;1660;769;2069;1282;3729
352190;201805;1136;3214;847;2699;140;503;308;908;448;1411
352200;201805;383;1237;256;948;36;146;76;278;112;424
352210;201805;16814;43193;13643;38471;1683;5120;9403;26252;11086;31372
352215;201805;506;1433;451;1359;60;198;298;875;358;1073
352220;201805;14307;39538;10246;31982;2951;9550;2742;8408;5693;17958
352230;201805;12196;38838;9605;33568;2584;9921;2983;9700;5567;19621
352240;201805;11529;31441;8481;25953;1934;6692;3082;8507;5016;15199
352250;201805;20898;62477;17405;56184;4413;14983;8112;25639;12525;40622
352260;201805;5431;15304;3728;11748;604;2075;1936;5868;2540;7943
352265;201805;880;2625;761;2419;58;236;537;1644;595;1880
352270;201805;1459;4762;1144;4044;257;949;337;1107;594;2056
352280;201805;2253;6210;1783;5448;197;731;931;2667;1128;3398
352290;201805;1065;3281;901;2909;166;586;412;1201;578;1787
352300;201805;941;2670;667;2092;102;361;289;796;391;1157
352310;201805;44199;121952;33328;102981;8774;27615;13462;41695;22236;69310
352320;201805;5606;16071;4492;13767;823;2800;2000;5440;2823;8240
352330;201805;1918;5712;1571;5205;390;1421;646;2030;1036;3451
352340;201805;4768;13897;3569;11711;847;2996;1219;3716;2066;6712
352350;201805;1782;5577;1489;4886;239;897;649;1916;888;2813
352360;201805;1056;3000;925;2791;137;512;647;1847;784;2359
352370;201805;959;3012;852;2786;43;191;624;1975;667;2166
352380;201805;860;2523;686;2206;154;535;211;648;365;1183
352390;201805;17642;44548;11549;33754;1811;5811;5810;15987;7621;21798
352400;201805;3425;9689;2788;8542;601;2188;1514;4226;2115;6414
352410;201805;2862;8059;2327;7145;320;1123;1295;3823;1615;4946
352420;201805;928;2348;645;1874;106;325;224;628;330;953
352430;201805;6905;19066;5282;16203;1552;5067;1874;5623;3426;10690
352440;201805;16301;47603;12828;40683;2789;9370;5359;16415;8148;25785
352450;201805;728;2021;379;1263;63;220;106;336;169;556
352460;201805;2597;7740;1888;6290;390;1448;622;1968;1012;3416
352470;201805;3783;9868;2741;8073;292;988;1507;4111;1799;5099
352480;201805;3580;9149;2494;7155;443;1389;1122;2944;1565;4333
352490;201805;701;2262;551;1920;110;414;215;720;325;1134
352500;201805;9180;24559;6937;20600;3454;11061;972;1962;4426;13023
352510;201805;3216;9217;2452;7846;612;2132;822;2471;1434;4603
352520;201805;2260;6793;1822;5920;445;1560;780;2357;1225;3917
352530;201805;8630;25429;5748;18881;1290;4594;855;2159;2145;6753
352540;201805;537;1631;389;1289;77;279;76;229;153;508
352550;201805;906;2777;646;2235;124;463;177;581;301;1044
352560;201805;557;1609;370;1190;68;229;84;230;152;459
352570;201805;1950;5985;1271;4504;314;1226;207;604;521;1830
352580;201805;814;2380;639;2021;118;415;234;683;352;1098
352585;201805;248;762;197;653;22;82;97;304;119;386
352590;201805;13238;37049;9543;29641;2972;9864;3499;9968;6471;19832
352600;201805;1980;5911;1544;4970;266;877;720;2246;986;3123
352610;201805;3141;9263;2429;7987;528;1938;807;2493;1335;4431
352620;201805;5343;15110;4377;13553;1272;4030;1655;5117;2927;9147
352630;201805;791;2074;610;1788;106;381;288;765;394;1146
352640;201805;2738;7490;2082;6362;171;553;1357;4079;1528;4632
352650;201805;625;1849;449;1413;75;247;144;430;219;677
352660;201805;967;3212;813;2883;169;615;330;1134;499;1749
352670;201805;9958;28244;5933;19684;1400;5097;460;1499;1860;6596
352680;201805;3052;9555;2218;7592;407;1570;914;2871;1321;4441
352690;201805;30306;79697;21931;63870;2157;7106;13036;35952;15193;43058
352700;201805;560;1479;417;1264;149;484;109;286;258;770
352710;201805;4904;13585;3576;11010;924;3129;1342;3823;2266;6952
352720;201805;7963;23557;6417;20358;2751;8862;1040;2976;3791;11838
352725;201805;422;1168;214;706;14;50;95;301;109;351
352730;201805;2542;7696;2228;6932;393;1378;1178;3312;1571;4690
352740;201805;2178;5518;1678;4733;220;678;900;2438;1120;3116
352750;201805;440;1155;226;718;43;134;58;160;101;294
352760;201805;1401;4317;1102;3608;178;637;495;1536;673;2173
352770;201805;772;2318;591;1902;115;401;205;623;320;1024
352780;201805;619;1988;465;1614;88;317;146;485;234;802
352790;201805;611;1690;424;1337;57;189;145;413;202;602
352800;201805;1166;3887;876;3131;213;778;178;587;391;1365
352810;201805;1080;2696;663;1894;99;300;311;837;410;1137
352820;201805;562;1456;372;1142;75;238;83;246;158;484
352830;201805;589;1582;276;870;41;139;50;122;91;261
352840;201805;3824;12010;3287;10958;1065;3731;1095;3481;2160;7212
352850;201805;10236;27164;7055;21924;1869;6225;2015;6076;3884;12301
352860;201805;856;2696;737;2433;144;505;296;941;440;1446
352870;201805;852;2241;570;1607;51;169;320;827;371;996
352880;201805;1966;5008;1371;3881;215;640;657;1650;872;2290
352885;201805;261;804;210;707;26;91;132;434;158;525
352890;201805;664;1648;423;1130;58;172;192;439;250;611
352900;201805;17621;48793;12454;38467;2252;7599;5139;14790;7391;22389
352910;201805;411;1149;208;686;26;81;37;111;63;192
352920;201805;2483;6794;1791;5486;208;712;1019;2932;1227;3644
352930;201805;5425;16017;4204;13473;806;2744;1660;5040;2466;7784
352940;201805;21969;65182;17390;55597;4917;17288;3895;11353;8812;28641
352950;201805;474;1255;263;831;52;179;20;51;72;230
352960;201805;653;1883;347;1162;44;169;77;235;121;404
352965;201805;311;868;172;562;41;140;29;83;70;223
352970;201805;3087;7579;2428;6546;250;683;1604;4321;1854;5004
352980;201805;1308;3855;1057;3415;226;782;499;1567;725;2349
352990;201805;3992;11837;3343;10741;715;2571;1641;4969;2356;7540
353000;201805;467;1287;233;762;45;166;55;155;100;321
353010;201805;2611;6926;1770;5295;401;1310;559;1537;960;2847
353020;201805;3796;10102;2185;6661;299;987;777;2179;1076;3166
353030;201805;3902;10686;2753;8466;672;2181;570;1709;1242;3890
353040;201805;571;1481;428;1232;82;259;181;470;263;729
353050;201805;4831;14984;3724;12684;925;3414;1446;4663;2371;8077
353060;201805;44431;121757;37260;109898;3360;11832;26266;74241;29626;86073
353070;201805;9509;28040;6722;22189;1486;5236;1993;6271;3479;11507
353080;201805;4498;13340;3101;10428;661;2441;874;2707;1535;5148
353090;201805;529;1751;452;1569;41;162;258;841;299;1003
353100;201805;307;845;117;396;15;57;27;75;42;132
353110;201805;7164;21028;6062;19250;1001;3487;3616;11524;4617;15011
353120;201805;547;1514;365;1125;60;210;130;340;190;550
353130;201805;2391;6400;1688;5276;484;1631;519;1548;1003;3179
353140;201805;2175;5825;1663;4856;197;641;941;2588;1138;3229
353150;201805;1447;4009;1075;3346;272;842;352;1042;624;1884
353160;201805;642;1739;438;1368;90;309;157;436;247;745
353170;201805;499;1497;412;1373;73;294;201;636;274;930
353180;201805;9462;24694;7553;21666;1037;3254;5006;14052;6043;17306
353190;201805;3438;9807;2743;8332;347;1144;1609;4567;1956;5711
353200;201805;1385;4219;793;2670;153;553;192;586;345;1139
353205;201805;325;1071;280;957;64;246;127;423;191;669
353210;201805;949;2373;616;1769;33;119;372;1029;405;1148
353215;201805;422;1259;350;1097;51;181;134;355;185;536
353220;201805;629;1792;444;1418;110;359;89;267;199;626
353230;201805;774;2336;658;2146;177;630;243;695;420;1325
353240;201805;2046;6097;1719;5466;230;855;1007;3050;1237;3905
353250;201805;1256;2950;755;2081;116;330;353;954;469;1284
353260;201805;988;2537;576;1782;124;399;172;509;296;908
353270;201805;620;1771;501;1522;61;187;258;740;319;927
353280;201805;701;2034;495;1572;87;286;157;482;244;768
353282;201805;1796;5402;1574;4950;209;720;884;2665;1093;3385
353284;201805;400;1008;204;604;32;111;72;189;104;300
353286;201805;123;364;90;299;25;85;22;61;47;146
353290;201805;1171;3365;825;2636;103;390;427;1239;530;1629
353300;201805;1596;4559;1195;3715;195;677;494;1381;689;2058
353310;201805;326;857;228;669;26;97;123;328;149;425
353320;201805;602;1659;502;1467;27;82;367;1063;394;1145
353325;201805;613;1922;431;1495;87;315;127;431;214;746
353330;201805;534;1463;346;1046;44;154;188;528;232;682
353340;201805;2903;8017;1937;6202;507;1725;582;1858;1089;3583
353350;201805;3196;9174;2167;6872;472;1608;386;1057;858;2665
353360;201805;487;1527;410;1367;63;232;206;665;269;897
353370;201805;551;1770;459;1594;44;174;278;938;322;1112
353380;201805;263;842;209;717;35;125;84;274;119;399
353390;201805;5275;14187;4012;11797;695;2180;1748;4861;2443;7041
353400;201805;409;1223;319;1035;65;227;57;137;122;364
353410;201805;559;1586;444;1373;97;327;208;620;305;947
353420;201805;504;1418;295;929;51;152;34;91;85;243
353430;201805;2075;6348;1563;5272;393;1420;455;1436;848;2856
353440;201805;57465;167955;41687;135324;8921;30096;18170;56808;27091;86904
353450;201805;405;1096;279;846;37;135;112;313;149;448
353460;201805;3407;9524;2460;7596;237;808;1076;3309;1313;4117
353470;201805;6848;19314;4955;15622;1016;3497;1636;4769;2652;8266
353475;201805;1404;3967;1020;3078;131;438;433;1189;564;1627
353480;201805;1488;4303;1287;3887;85;287;916;2674;1001;2961
353490;201805;911;2565;657;2013;131;401;270;789;401;1190
353500;201805;974;2438;783;2137;196;532;398;1117;594;1649
353510;201805;855;2690;621;2080;169;584;103;310;272;894
353520;201805;1159;3132;775;2404;81;274;373;1100;454;1374
353530;201805;2339;6483;1857;5527;249;839;976;2708;1225;3547
353540;201805;1919;5683;1610;5131;322;1063;804;2510;1126;3573
353550;201805;5793;16222;4609;14083;890;2929;2205;6371;3095;9300
353560;201805;2042;6254;1579;5442;522;1935;361;1164;883;3099
353570;201805;516;1480;377;1218;84;269;162;496;246;765
353580;201805;2102;5825;1686;5042;370;1129;786;2264;1156;3393
353590;201805;693;1980;436;1383;105;353;139;447;244;800
353600;201805;1702;4551;1402;3952;175;510;739;2006;914;2516
353610;201805;579;1916;433;1587;93;374;96;323;189;697
353620;201805;2462;7236;1826;6000;415;1453;475;1432;890;2885
353625;201805;521;1382;317;969;30;112;186;542;216;654
353630;201805;1229;4103;957;3440;201;746;218;721;419;1467
353640;201805;1335;3679;1038;3123;131;445;610;1803;741;2248
353650;201805;8800;25033;6544;20178;950;3198;3377;9702;4327;12900
353657;201805;303;896;243;790;36;112;102;313;138;425
353660;201805;1105;2507;750;1957;224;622;263;607;487;1229
353670;201805;3388;10321;2796;9112;684;2431;1218;3677;1902;6108
353680;201805;720;2089;554;1824;113;390;255;811;368;1201
353690;201805;498;1315;209;674;20;68;26;71;46;139
353700;201805;1895;5532;1612;4969;213;713;965;2841;1178;3554
353710;201805;3338;7831;1824;5191;271;756;901;2381;1172;3137
353715;201805;550;1547;370;1177;22;89;104;295;126;384
353720;201805;1891;5393;1527;4839;248;880;874;2660;1122;3540
353730;201805;4100;11817;3093;9681;518;1758;1319;3817;1837;5575
353740;201805;1840;5137;1284;4038;299;1058;338;956;637;2014
353750;201805;874;2790;604;2202;152;585;101;366;253;951
353760;201805;11506;28918;9149;25583;1264;3921;5814;15865;7078;19786
353770;201805;673;2065;339;1185;71;260;35;77;106;337
353780;201805;4370;13667;3476;11803;966;3567;840;2630;1806;6197
353790;201805;2189;7071;1705;6053;524;2145;341;1015;865;3160
353800;201805;16198;46813;12608;40290;2455;8409;5703;18043;8158;26452
353810;201805;1078;3085;721;2350;123;470;252;773;375;1243
353820;201805;1598;4857;1204;3975;220;808;438;1411;658;2219
353830;201805;618;1625;474;1379;66;193;243;665;309;858
353850;201805;1684;4916;1306;4152;351;1082;382;1254;733;2336
353860;201805;2487;7566;1989;6507;494;1704;741;2315;1235;4019
353870;201805;27687;76874;19063;59385;3033;10410;8138;23033;11171;33443
353880;201805;2865;8490;2299;7421;256;937;1258;3933;1514;4870
353890;201805;2320;5467;1626;4403;167;509;1029;2626;1196;3135
353900;201805;727;2136;539;1757;114;413;194;595;308;1008
353910;201805;1993;6488;1764;6099;225;820;1221;4283;1446;5103
353920;201805;2271;6450;1538;4939;326;1189;319;858;645;2047
353930;201805;4154;11830;2850;9370;716;2536;603;1814;1319;4350
353940;201805;1094;3433;767;2666;150;544;205;673;355;1217
353950;201805;3006;8982;2454;7837;481;1705;1227;3582;1708;5287
353960;201805;611;1836;418;1414;92;283;127;427;219;710
353970;201805;603;1632;481;1412;47;146;302;860;349;1006
353980;201805;13234;36630;10657;32086;1538;4890;6348;18609;7886;23499
353990;201805;777;2032;508;1518;49;152;290;834;339;986
354000;201805;2283;5968;1367;4169;256;826;271;820;527;1646
354010;201805;356;1001;267;828;35;112;166;493;201;605
354020;201805;3716;11198;3001;9596;779;2683;934;2712;1713;5395
354025;201805;775;2179;522;1679;105;365;123;384;228;749
354030;201805;475;1155;266;745;44;120;95;251;139;371
354040;201805;743;1884;473;1378;37;112;284;781;321;893
354050;201805;946;2896;685;2352;161;597;167;549;328;1146
354060;201805;4216;12623;2819;9503;723;2521;678;2098;1401;4619
354070;201805;3075;9211;2240;7484;506;1852;523;1489;1029;3341
354075;201805;2104;6900;1685;6057;278;1143;866;3001;1144;4144
354080;201805;1448;4225;933;3127;171;594;238;727;409;1321
354085;201805;407;879;330;785;3;14;230;510;233;524
354090;201805;1453;4214;1293;3887;119;407;909;2687;1028;3094
354100;201805;15123;45466;11289;38525;2700;9892;4457;15025;7157;24917
354105;201805;994;2808;844;2573;141;428;505;1536;646;1964
354110;201805;460;1283;360;1130;93;312;105;304;198;616
354120;201805;1604;4444;1066;3253;187;601;360;980;547;1581
354130;201805;5688;15620;3815;11906;1133;3834;188;399;1321;4233
354140;201805;21393;53255;13771;39453;2788;8505;4723;12471;7511;20976
354150;201805;3361;8580;2473;7017;496;1519;1043;2783;1539;4302
354160;201805;3215;9903;2414;8140;680;2368;683;2268;1363;4636
354165;201805;518;1602;420;1404;85;332;201;621;286;953
354170;201805;1431;4315;1152;3684;99;365;652;1951;751;2316
354180;201805;483;1435;353;1144;58;206;117;337;175;543
354190;201805;1456;4352;1105;3627;148;542;391;1260;539;1802
354200;201805;913;2492;721;2145;90;279;343;944;433;1223
354210;201805;671;1993;532;1734;51;200;323;961;374;1161
354220;201805;3029;8593;2353;7280;417;1376;1139;3373;1556;4749
354230;201805;684;1923;544;1712;61;250;329;962;390;1212
354240;201805;1419;4256;955;3251;176;639;233;711;409;1350
354250;201805;529;1437;350;1138;104;348;92;302;196;650
354260;201805;7836;22230;6167;19259;1512;4953;2026;6317;3538;11270
354270;201805;1123;3519;897;3066;174;613;333;1141;507;1754
354280;201805;715;1959;607;1789;88;326;359;967;447;1293
354290;201805;858;2902;741;2619;141;501;316;1124;457;1625
354300;201805;3695;11398;3288;10616;1083;3630;1045;3186;2128;6816
354310;201805;742;2262;598;1948;105;363;239;725;344;1088
354320;201805;852;2305;550;1721;107;379;203;552;310;931
354323;201805;529;1354;347;997;44;119;137;377;181;496
354325;201805;1207;3804;897;3103;161;583;324;1059;485;1642
354330;201805;6584;17967;5003;14942;833;2921;2737;7486;3570;10407
354340;201805;24730;67772;17615;55271;4320;14568;6631;19975;10951;34543
354350;201805;1112;3103;920;2719;138;446;548;1500;686;1946
354360;201805;530;1542;310;1084;57;199;47;159;104;358
354370;201805;1034;3343;860;2986;139;527;449;1519;588;2046
354380;201805;773;2112;525;1671;100;368;113;289;213;657
354390;201805;13172;34451;8473;25829;1652;5347;2339;6664;3991;12011
354400;201805;1590;5366;1246;4500;211;832;423;1514;634;2346
354410;201805;4974;14590;3985;12673;936;3203;1657;5064;2593;8267
354420;201805;1394;3915;993;3066;146;485;537;1592;683;2077
354425;201805;2144;5786;1660;4896;405;1211;561;1706;966;2917
354430;201805;1492;4350;1199;3859;197;716;583;1761;780;2477
354440;201805;529;1518;347;1111;36;119;163;488;199;607
354450;201805;389;1069;225;740;35;128;52;154;87;282
354460;201805;925;2571;639;1975;104;335;271;817;375;1152
354470;201805;525;1344;359;1009;29;89;175;442;204;531
354480;201805;1020;2471;715;1985;62;191;457;1201;519;1392
354490;201805;801;2521;607;2076;124;457;204;652;328;1109
354500;201805;2046;6109;1743;5656;576;2034;410;1331;986;3365
354510;201805;816;2268;665;1949;92;285;339;906;431;1191
354515;201805;279;869;210;728;37;147;88;293;125;440
354520;201805;7103;21276;4329;14062;705;2546;2082;6260;2787;8806
354530;201805;3731;11714;2968;10101;713;2547;1092;3696;1805;6243
354540;201805;1315;3718;969;3057;223;765;296;924;519;1689
354550;201805;545;1469;409;1206;63;193;233;654;296;847
354560;201805;1870;4930;1039;3117;135;437;517;1480;652;1917
354570;201805;1150;3147;492;1521;96;333;68;188;164;521
354580;201805;9822;26812;6407;20186;1066;3688;2725;8060;3791;11748
354600;201805;1688;4988;1340;4317;206;723;706;2187;912;2910
354610;201805;372;1011;193;606;43;151;55;157;98;308
354620;201805;453;1337;308;1051;53;204;104;299;157;503
354625;201805;314;927;191;650;26;85;51;147;77;232
354630;201805;1990;6259;1639;5527;655;2361;176;538;831;2899
354640;201805;3127;9696;2281;7787;433;1648;554;1697;987;3345
354650;201805;888;2490;719;2156;83;252;440;1336;523;1588
354660;201805;2569;6710;1735;5322;104;394;1203;3640;1307;4034
354670;201805;1024;2971;727;2307;139;487;252;720;391;1207
354680;201805;4361;12759;3701;11630;953;3118;1822;5730;2775;8848
354690;201805;623;2019;427;1541;96;363;109;372;205;735
354700;201805;1015;2787;703;2124;119;396;300;786;419;1182
354710;201805;519;1480;351;1106;44;163;155;439;199;602
354720;201805;291;754;144;441;47;139;24;73;71;212
354730;201805;9383;27466;6894;22674;1087;3883;3529;11120;4616;15003
354740;201805;340;965;130;474;20;85;20;68;40;153
354750;201805;2443;6854;1658;5354;315;1164;633;1835;948;2999
354760;201805;1810;5351;1324;4366;383;1342;258;839;641;2181
354765;201805;292;812;135;441;17;67;28;81;45;148
354770;201805;2266;5923;1619;4774;371;1173;592;1667;963;2840
354780;201805;53807;142984;42219;119637;6260;19648;22636;59810;28896;79458
354790;201805;868;2641;726;2373;105;358;388;1232;493;1590
354800;201805;2524;7020;1994;6128;444;1457;844;2436;1288;3893
354805;201805;1010;2824;750;2291;79;265;322;872;401;1137
354810;201805;581;1784;338;1219;56;221;78;261;134;482
354820;201805;918;2895;704;2447;136;532;167;506;303;1038
354830;201805;464;1176;315;903;88;257;111;300;199;557
354840;201805;758;2172;493;1533;77;222;223;687;300;909
354850;201805;19340;54716;13760;43847;2201;8069;7146;21121;9347;29190
354860;201805;1362;4095;990;3358;193;719;309;926;502;1645
354870;201805;47370;126163;38033;108831;6000;18561;20698;56641;26698;75202
354880;201805;5241;13646;2553;7676;346;1170;846;2056;1192;3226
354890;201805;15383;41655;12438;36531;1991;6388;6600;18676;8591;25064
354900;201805;453;1266;285;922;36;127;80;242;116;369
354910;201805;4966;14120;2953;10055;601;2179;272;873;873;3052
354920;201805;418;1137;175;597;25;106;31;92;56;198
354925;201805;269;814;136;491;22;75;31;96;53;171
354930;201805;373;956;227;689;27;92;108;308;135;400
354940;201805;1754;5837;1355;4868;468;1787;153;519;621;2306
354950;201805;1478;4308;1197;3846;85;364;761;2310;846;2674
354960;201805;763;2174;599;1916;130;464;242;752;372;1216
354970;201805;3702;11389;3035;10062;470;1709;1714;5472;2184;7181
354980;201805;27722;70381;18691;53928;2491;8400;9401;24942;11892;33342
354990;201805;57585;155706;42804;127842;5396;17589;23397;66652;28793;84241
354995;201805;2254;5880;1694;5070;313;1037;968;2751;1281;3788
355000;201805;1425;4083;1152;3611;237;842;319;866;556;1708
355010;201805;3048;9127;2099;6895;715;2479;181;612;896;3091
355020;201805;3164;9583;2322;7885;749;2786;579;1893;1328;4679
355030;201805;1237621;3156313;939510;2583659;172695;516024;438971;1122357;611666;1638381
355040;201805;2773;7850;2334;7159;406;1268;1439;4439;1845;5707
355050;201805;990;2714;733;2251;214;647;175;497;389;1144
355060;201805;4922;14464;3749;12133;691;2557;1683;4893;2374;7450
355070;201805;7377;20944;5984;18543;884;3132;3309;9536;4193;12668
355080;201805;826;2603;535;1971;109;447;38;122;147;569
355090;201805;1127;3499;883;3007;199;680;267;924;466;1604
355100;201805;19349;54098;15275;47811;3062;10288;8531;26079;11593;36367
355110;201805;1028;3061;781;2630;267;956;143;484;410;1440
355120;201805;627;1810;462;1499;73;267;158;479;231;746
355130;201805;618;1505;280;783;27;74;127;332;154;406
355140;201805;1331;3752;1191;3525;146;504;854;2473;1000;2977
355150;201805;3828;10861;3069;9484;507;1662;1547;4688;2054;6350
355160;201805;1813;5331;1393;4563;352;1287;320;997;672;2284
355170;201805;8293;22797;6613;19936;1869;5966;2801;8332;4670;14298
355180;201805;2705;7956;2026;6698;441;1716;643;1881;1084;3597
355190;201805;1653;4772;1363;4241;363;1208;590;1904;953;3112
355200;201805;803;2650;695;2451;266;1033;184;585;450;1618
355210;201805;3012;8734;2550;7773;294;1074;1549;4426;1843;5500
355220;201805;41412;116657;32932;99880;8988;28738;11228;31147;20216;59885
355230;201805;1236;3233;684;2073;137;406;168;488;305;894
355240;201805;22166;60471;14883;45799;2633;8418;5939;17830;8572;26248
355250;201805;32838;92777;25011;78286;6522;21707;8645;26115;15167;47822
355255;201805;821;2171;436;1372;78;230;142;461;220;691
355260;201805;1228;3331;936;2838;114;437;581;1632;695;2069
355270;201805;1460;4538;1139;3783;274;948;362;1112;636;2060
355280;201805;26407;72654;19560;59155;3456;11120;8431;24134;11887;35254
355290;201805;807;2476;619;2032;143;443;188;580;331;1023
355300;201805;1281;3922;1032;3393;217;755;306;977;523;1732
355310;201805;1028;2966;781;2529;88;319;410;1332;498;1651
355320;201805;547;1516;411;1243;76;275;154;388;230;663
355330;201805;2087;5939;1543;4915;211;758;909;2755;1120;3513
355340;201805;3102;7283;2645;6633;299;744;1826;4544;2125;5288
355350;201805;1318;4091;968;3326;199;735;280;954;479;1689
355360;201805;1248;3542;1070;3176;102;316;758;2277;860;2593
355365;201805;365;1013;187;645;39;120;27;89;66;209
355370;201805;6027;15660;4652;13688;1118;3397;1905;5968;3023;9365
355380;201805;2971;8488;2242;6978;402;1353;669;1770;1071;3123
355385;201805;1232;3674;1069;3375;157;586;569;1644;726;2230
355390;201805;732;2118;549;1718;120;385;211;616;331;1001
355395;201805;1935;5754;1384;4507;209;751;563;1653;772;2404
355400;201805;8782;27614;7260;24324;2092;7675;1954;5964;4046;13639
355410;201805;21747;62575;14847;49057;3626;13071;3140;10293;6766;23364
355420;201805;694;2402;587;2159;156;664;124;449;280;1113
355430;201805;3720;9835;2889;8362;741;2164;1187;3441;1928;5605
355440;201805;848;2416;547;1746;107;359;158;465;265;824
355450;201805;3676;10179;2278;7209;423;1429;769;2246;1192;3675
355460;201805;553;1463;351;1086;54;189;143;389;197;578
355465;201805;361;1087;261;854;46;165;77;244;123;409
355470;201805;1166;3131;635;1991;179;573;175;520;354;1093
355475;201805;263;690;237;644;21;64;182;488;203;552
355480;201805;3462;10599;2963;9715;493;1851;1736;5484;2229;7335
355490;201805;970;2753;523;1720;63;230;187;582;250;812
355495;201805;776;2391;596;2031;97;365;175;572;272;937
355500;201805;6629;18719;4082;13093;631;2224;1063;3151;1694;5375
355510;201805;1415;3805;857;2658;126;432;264;714;390;1146
355520;201805;400;942;190;531;30;93;74;180;104;273
355530;201805;472;1080;163;475;21;76;58;134;79;210
355535;201805;562;1627;437;1410;109;407;152;426;261;833
355540;201805;8715;24671;7381;22563;1378;4521;4264;12692;5642;17213
355550;201805;684;2092;541;1795;73;246;239;794;312;1040
355560;201805;1064;3063;575;1943;117;401;29;99;146;500
355570;201805;240;718;124;432;23;88;20;64;43;152
355580;201805;1221;3194;813;2467;111;401;365;1052;476;1453
355590;201805;188;483;139;405;17;53;83;230;100;283
355600;201805;1505;3955;1027;3055;266;843;367;1035;633;1878
355610;201805;1696;4582;1194;3599;176;566;542;1542;718;2108
355620;201805;4488;13099;3424;10779;475;1743;1713;4891;2188;6634
355630;201805;2175;6330;1520;5040;320;1091;604;1983;924;3074
355635;201805;935;2853;768;2555;120;439;434;1454;554;1893
355640;201805;2631;8008;1837;6396;439;1588;354;1246;793;2834
355645;201805;4180;12767;3374;11356;413;1586;2008;6624;2421;8210
355650;201805;6693;18879;5546;16726;1409;4545;2721;7623;4130;12168
355660;201805;1253;3567;908;2864;111;460;342;1034;453;1494
355670;201805;3324;9899;2294;7350;361;1344;1014;2842;1375;4186
355680;201805;2947;8604;1210;4137;358;1304;108;327;466;1631
355690;201805;620;1989;414;1535;114;445;19;55;133;500
355695;201805;231;741;129;462;12;47;14;36;26;83
355700;201805;6141;18831;5092;16465;1209;3962;2143;6730;3352;10692
355710;201805;8343;20442;5177;14610;939;2823;1859;4742;2798;7565
355715;201805;358;1090;220;745;58;219;42;129;100;348
355720;201805;1460;4557;1147;3895;228;830;474;1457;702;2287
355730;201805;953;2918;748;2470;193;630;235;739;428;1369
410010;201805;1254;3626;958;2985;198;679;211;645;409;1324
410020;201805;1044;3339;850;2875;298;1005;246;823;544;1828
410030;201805;1333;4085;1131;3671;206;746;527;1686;733;2432
410040;201805;10268;30887;8184;26876;1718;6193;2653;8217;4371;14410
410045;201805;1002;2732;671;2098;106;366;188;551;294;917
410050;201805;2612;6720;1614;4844;370;1205;292;756;662;1961
410060;201805;2102;6299;1682;5397;412;1390;539;1689;951;3079
410070;201805;1657;4523;1246;3705;247;770;427;1228;674;1998
410080;201805;1364;3736;1001;3061;164;525;407;1237;571;1762
410090;201805;966;2802;885;2639;109;323;483;1521;592;1844
410100;201805;2119;6432;1523;4950;224;844;256;809;480;1653
410105;201805;416;1195;238;773;45;175;51;146;96;321
410110;201805;3067;8309;2149;6404;298;949;765;2220;1063;3169
410115;201805;517;1355;373;1086;76;247;124;326;200;573
410120;201805;2433;7821;2148;7306;766;2771;574;1873;1340;4644
410130;201805;1099;3178;990;2972;332;1100;321;843;653;1943
410140;201805;15080;38332;9374;27676;1907;6094;1880;5059;3787;11153
410150;201805;16287;40447;7764;22584;1473;4582;1354;3748;2827;8330
410160;201805;2844;8327;2411;7521;507;1743;896;2811;1403;4554
410165;201805;658;1898;544;1634;63;213;320;904;383;1117
410170;201805;2392;6560;1613;4809;416;1336;155;447;571;1783
410180;201805;13038;39242;10519;33548;1816;6174;5069;15208;6885;21382
410185;201805;507;1405;364;1131;60;185;106;308;166;493
410190;201805;2063;5570;1539;4559;339;1051;364;1032;703;2083
410200;201805;4432;11211;2607;7803;507;1752;528;1527;1035;3279
410210;201805;2582;7269;1753;5470;290;1035;472;1230;762;2265
410220;201805;609;1622;407;1223;57;201;89;267;146;468
410230;201805;1443;4267;1216;3798;210;774;600;1738;810;2512
410240;201805;4180;12072;3378;10447;989;3440;367;1100;1356;4540
410250;201805;2651;6807;1851;5330;278;913;661;1805;939;2718
410260;201805;1731;4476;1161;3480;232;761;487;1419;719;2180
410270;201805;494;1323;367;1070;31;102;179;504;210;606
410275;201805;719;2160;474;1575;66;228;204;640;270;868
410280;201805;2093;5932;1364;4363;274;977;422;1225;696;2202
410290;201805;3177;9366;2398;7702;531;1681;862;2798;1393;4479
410300;201805;671;1776;522;1489;80;246;221;573;301;819
410302;201805;352;935;172;567;28;95;85;273;113;368
410304;201805;1140;3364;988;3045;175;575;494;1500;669;2075
410305;201805;1677;4340;1229;3627;266;798;580;1712;846;2510
410310;201805;2341;7081;1934;6310;430;1531;618;1993;1048;3524
410315;201805;711;1844;352;1181;88;308;86;273;174;581
410320;201805;1129;3316;734;2421;110;419;112;357;222;776
410322;201805;515;1472;285;920;27;94;102;316;129;410
410330;201805;1429;3765;1054;3012;214;662;275;781;489;1443
410335;201805;866;2501;697;2152;118;400;300;863;418;1263
410337;201805;764;1955;539;1522;49;152;235;614;284;766
410340;201805;518;1426;349;1006;39;129;151;365;190;494
410345;201805;2157;5847;1178;3698;247;806;263;767;510;1573
410347;201805;704;1813;506;1444;52;185;142;381;194;566
410350;201805;1285;3649;946;2972;125;430;343;992;468;1422
410360;201805;4049;10298;3134;8690;244;806;1960;5206;2204;6012
410370;201805;11045;30771;7649;23150;1085;3642;2758;7370;3843;11012
410380;201805;1389;3868;1102;3263;127;468;449;1236;576;1704
410390;201805;2536;7053;1695;5336;447;1544;336;965;783;2509
410395;201805;885;2722;720;2361;140;513;322;1065;462;1578
410400;201805;4915;14216;3826;11982;710;2347;1452;4345;2162;6692
410405;201805;797;2119;644;1860;139;425;295;827;434;1252
410410;201805;1155;3372;1128;3339;191;706;686;2036;877;2742
410420;201805;7282;22383;5681;18815;1152;4208;1441;4346;2593;8554
410425;201805;2787;8384;2059;6880;356;1285;628;1967;984;3252
410430;201805;12626;33011;8782;25812;1472;4684;2735;7703;4207;12387
410440;201805;2784;9274;2456;8639;387;1406;1337;4902;1724;6308
410442;201805;2303;7433;1982;6722;605;2141;613;2060;1218;4201
410445;201805;2220;6862;1795;5986;403;1498;492;1693;895;3191
410450;201805;1568;4366;1197;3625;221;740;272;713;493;1453
410460;201805;1680;4568;1308;3959;234;782;504;1432;738;2214
410465;201805;2486;7684;1933;6454;447;1498;547;1757;994;3255
410470;201805;1792;5468;1313;4383;320;1167;260;913;580;2080
410480;201805;31153;82537;17806;55981;2740;9513;2243;6015;4983;15528
410490;201805;10857;31784;7765;25069;1567;5395;2448;7390;4015;12785
410500;201805;1617;4764;1191;3828;303;1084;255;726;558;1810
410510;201805;2139;5571;1398;4042;256;744;424;1198;680;1942
410520;201805;2987;9867;2729;9332;735;2584;1199;4120;1934;6704
410530;201805;1520;4145;792;2415;135;414;96;226;231;640
410540;201805;2580;7420;1870;5949;293;989;854;2683;1147;3672
410550;201805;6498;18112;4207;13009;823;2770;809;2210;1632;4980
410560;201805;1357;3759;1068;3198;239;762;420;1160;659;1922
410570;201805;2572;7703;2028;6646;543;2028;235;820;778;2848
410580;201805;22923;63565;17617;53387;3542;11835;7122;19938;10664;31773
410590;201805;1367;4158;907;2946;154;529;205;596;359;1125
410600;201805;1737;4941;1364;4177;309;919;467;1485;776;2404
410610;201805;752;2052;551;1657;71;236;207;584;278;820
410620;201805;1911;6034;1265;4438;300;1137;187;578;487;1715
410630;201805;2280;6554;1488;4764;292;1017;182;475;474;1492
410640;201805;4355;11106;2966;8647;754;2453;435;1201;1189;3654
410645;201805;1077;3492;962;3308;375;1335;286;1015;661;2350
410650;201805;1924;5656;1418;4561;354;1221;377;1085;731;2306
410655;201805;1348;4435;1098;3942;52;184;767;2909;819;3093
410657;201805;663;1781;413;1243;82;273;148;379;230;652
410660;201805;3158;8562;1689;5239;336;1078;277;811;613;1889
410670;201805;962;2469;591;1697;108;292;265;717;373;1009
410680;201805;2833;8855;2055;6917;519;1712;474;1678;993;3390
410685;201805;587;1622;485;1436;96;326;230;638;326;964
410690;201805;118995;317196;79048;237818;13957;46710;23761;62497;37718;109207
410700;201805;2200;5999;1892;5476;371;1148;901;2443;1272;3591
410710;201805;866;2387;563;1779;64;215;267;801;331;1016
410712;201805;683;2038;580;1836;165;574;188;531;353;1105
410715;201805;859;2703;558;1957;107;373;147;511;254;884
410720;201805;2947;8236;2211;6700;324;1155;425;1135;749;2290
410725;201805;1065;2831;681;2079;118;384;113;302;231;686
410730;201805;555;1521;404;1238;97;350;72;196;169;546
410740;201805;945;2731;667;2179;122;435;260;836;382;1271
410750;201805;1712;4709;1395;4086;233;758;512;1419;745;2177
410752;201805;336;879;151;464;21;76;58;159;79;235
410753;201805;233;703;161;537;21;74;26;73;47;147
410754;201805;1160;3119;963;2798;70;166;606;1919;676;2085
410755;201805;683;1749;483;1367;45;140;252;656;297;796
410760;201805;2955;8213;2298;7023;678;2227;574;1739;1252;3966
410765;201805;12677;37533;9843;31843;1565;5589;1293;3949;2858;9538
410770;201805;927;2382;642;1875;100;315;251;721;351;1036
410773;201805;1288;3591;1149;3374;152;506;807;2308;959;2814
410775;201805;1410;3829;1228;3536;179;560;541;1531;720;2091
410780;201805;594;1551;355;1041;73;210;76;254;149;464
410785;201805;752;2220;602;1914;129;417;179;545;308;962
410790;201805;581;1791;475;1556;128;457;39;89;167;546
410800;201805;2969;7002;2355;6074;177;515;1240;3109;1417;3624
410810;201805;345;988;265;830;40;137;110;326;150;463
410820;201805;776;2306;454;1444;93;307;74;215;167;522
410830;201805;28324;75394;20861;62197;5247;17414;6610;18604;11857;36018
410832;201805;1001;2732;844;2425;111;400;458;1219;569;1619
410840;201805;7162;19482;4377;13823;984;3427;606;1589;1590;5016
410845;201805;1153;3275;946;2888;190;624;325;963;515;1587
410850;201805;2403;7210;2110;6661;414;1412;849;2689;1263;4101
410855;201805;599;1597;437;1280;47;155;188;508;235;663
410860;201805;3829;10462;2965;8773;549;1731;974;2737;1523;4468
410865;201805;1378;4426;1238;4122;271;977;642;2198;913;3175
410870;201805;1223;3477;1077;3251;88;280;737;2233;825;2513
410880;201805;3965;11629;2991;9695;536;1950;429;1462;965;3412
410890;201805;921;2826;684;2292;157;562;185;618;342;1180
410895;201805;925;3097;793;2795;314;1184;125;417;439;1601
410900;201805;874;2402;588;1822;100;329;146;378;246;707
410910;201805;367;913;219;615;13;38;114;295;127;333
410920;201805;742;2018;575;1720;115;391;222;642;337;1033
410930;201805;1428;4138;1131;3518;310;1087;255;768;565;1855
410940;201805;20941;62268;16094;52861;4130;14608;3449;11473;7579;26081
410950;201805;1884;5777;1709;5499;78;308;1378;4372;1456;4680
410960;201805;7254;19502;4598;14632;1184;4152;1351;4135;2535;8287
410965;201805;987;2796;749;2303;131;414;350;1044;481;1458
410970;201805;3844;10852;2795;8794;671;2490;424;1162;1095;3652
410975;201805;1309;3609;1001;3017;196;645;303;907;499;1552
410980;201805;6458;17489;4275;13215;582;1956;1637;4849;2219;6805
410990;201805;1142;3104;746;2339;238;843;138;349;376;1192
411000;201805;487;1405;349;1118;41;144;89;234;130;378
411005;201805;439;1236;276;876;52;166;44;142;96;308
411007;201805;2229;6720;1901;6087;440;1500;591;1886;1031;3386
411010;201805;4081;12924;3349;11312;871;3127;331;1054;1202;4181
411020;201805;2359;6983;1982;6309;605;2045;544;1662;1149;3707
411030;201805;700;1824;453;1269;71;204;155;384;226;588
411040;201805;754;2046;333;1014;51;161;72;197;123;358
411050;201805;1800;5990;1538;5373;439;1651;235;723;674;2374
411060;201805;1603;4476;1109;3452;198;755;231;625;429;1380
411065;201805;339;961;254;795;34;104;107;336;141;440
411070;201805;6332;17518;5008;15054;1021;3328;1848;5346;2869;8674
411080;201805;2105;5911;1700;5147;463;1520;417;1250;880;2770
411090;201805;815;2170;531;1618;52;186;101;274;153;460
411095;201805;1461;3699;1032;2950;151;497;345;919;496;1416
411100;201805;1151;3208;799;2499;104;384;211;658;315;1042
411110;201805;561;1558;257;844;26;69;16;44;42;113
411120;201805;1352;4020;1047;3364;334;1210;192;504;526;1714
411125;201805;4687;14385;4339;13753;961;3189;2062;6706;3023;9895
411130;201805;664;1882;468;1453;101;312;158;520;259;832
411140;201805;2199;7035;1797;6105;441;1593;686;2362;1127;3955
411150;201805;3585;9848;2582;7722;532;1814;213;498;745;2312
411155;201805;976;2617;610;1884;67;223;260;739;327;962
411160;201805;319;798;225;642;30;89;56;163;86;252
411170;201805;720;2222;545;1799;125;438;174;556;299;994
411180;201805;5360;15078;4197;12882;788;2649;1629;4765;2417;7414
411190;201805;1311;3616;1018;3026;215;688;274;718;489;1406
411200;201805;4854;13624;3381;10692;898;3079;789;2353;1687;5432
411210;201805;2223;5609;1616;4581;454;1454;175;437;629;1891
411220;201805;873;2375;655;1929;138;453;213;602;351;1055
411230;201805;980;2677;646;2033;135;438;197;631;332;1069
411240;201805;1394;3491;877;2512;82;261;455;1263;537;1524
411250;201805;1959;5556;1531;4772;349;1241;467;1433;816;2674
411260;201805;348;916;220;665;29;86;84;236;113;322
411270;201805;1779;5228;1434;4508;241;828;649;1980;890;2808
411275;201805;1325;3613;973;2943;175;573;386;1145;561;1718
411280;201805;1450;4078;899;2891;161;559;128;347;289;906
411290;201805;714;2006;501;1585;73;230;217;695;290;925
411295;201805;1083;2812;878;2421;90;279;419;1101;509;1380
411300;201805;1018;2597;647;1853;64;197;236;576;300;773
411310;201805;881;2199;679;1891;43;127;269;729;312;856
411320;201805;5193;14444;3754;11703;871;2827;1055;3019;1926;5846
411325;201805;1561;4610;1316;4140;243;763;677;2203;920;2966
411330;201805;3135;9167;2414;7739;624;2168;609;1985;1233;4153
411340;201805;782;2254;493;1572;64;229;200;606;264;835
411342;201805;830;2152;570;1640;85;255;264;727;349;982
411345;201805;997;2837;797;2456;104;359;492;1508;596;1867
411350;201805;2564;7356;1821;5827;465;1639;173;561;638;2200
411360;201805;610;1532;421;1224;53;176;137;369;190;545
411370;201805;45828;120234;34010;99261;3561;12098;17894;48709;21455;60807
411373;201805;1359;3771;1108;3357;138;455;497;1522;635;1977
411375;201805;1042;2781;774;2283;127;395;269;731;396;1126
411380;201805;1077;2702;730;1962;68;223;387;916;455;1139
411390;201805;1652;4816;1297;3952;217;734;444;1223;661;1957
411400;201805;2072;5541;1658;4727;289;969;690;1875;979;2844
411410;201805;2039;5952;1503;4782;356;1242;290;808;646;2050
411420;201805;3895;10235;2304;7024;336;1180;402;971;738;2151
411430;201805;3223;9157;2603;8076;566;1908;1036;2982;1602;4890
411435;201805;423;1234;279;922;51;162;107;322;158;484
411440;201805;2611;7993;2170;7060;504;1738;638;2140;1142;3878
411450;201805;2591;7213;2008;6205;328;1018;1012;3168;1340;4186
411460;201805;3871;10740;2123;6932;356;1360;302;895;658;2255
411470;201805;689;1991;485;1545;80;274;105;315;185;589
411480;201805;4345;12619;3055;9990;572;2089;711;2175;1283;4264
411490;201805;1485;4178;1147;3546;181;655;377;1029;558;1684
411500;201805;1536;4084;1040;3108;156;548;315;888;471;1436
411510;201805;2027;5710;1669;4996;381;1282;364;1085;745;2367
411520;201805;26384;67703;14998;44853;2173;7165;4459;11895;6632;19060
411530;201805;890;2452;583;1858;134;472;124;359;258;831
411535;201805;471;1411;209;741;21;86;22;58;43;144
411540;201805;2835;7476;2009;5758;361;1146;681;1874;1042;3020
411545;201805;958;2936;816;2662;77;263;524;1716;601;1979
411550;201805;662;1793;499;1486;91;297;80;230;171;527
411560;201805;1980;5616;1252;4031;172;641;75;172;247;813
411570;201805;7113;17782;4943;14251;1034;3319;1298;3666;2332;6985
411573;201805;787;2201;682;2024;80;242;403;1186;483;1428
411575;201805;1635;4769;1299;4094;288;956;347;1085;635;2041
411580;201805;4172;10600;2406;7568;260;1006;300;852;560;1858
411585;201805;779;2375;353;1204;84;290;55;158;139;448
411590;201805;373;1095;268;852;28;106;135;386;163;492
411600;201805;284;789;182;595;42;155;62;196;104;351
411605;201805;1434;3836;941;2772;149;514;372;1006;521;1520
411610;201805;2241;6050;1593;4661;224;695;753;2157;977;2852
411620;201805;2852;8180;2492;7600;421;1419;1424;4248;1845;5667
411630;201805;614;1654;404;1248;84;300;90;241;174;541
411640;201805;501;1429;347;1046;43;138;128;347;171;485
411650;201805;188;558;129;428;19;57;23;87;42;144
411660;201805;889;2358;639;1863;63;187;322;925;385;1112
411670;201805;1102;2937;810;2297;118;340;304;821;422;1161
411680;201805;1549;4386;1251;3823;150;525;650;1974;800;2499
411690;201805;3294;9218;2546;7844;531;1654;745;2402;1276;4056
411695;201805;669;2088;496;1683;70;257;164;571;234;828
411700;201805;1520;4200;1032;3247;236;802;136;380;372;1182
411705;201805;1625;5555;1439;5193;291;1028;813;3087;1104;4115
411710;201805;1804;4907;1335;4009;366;1171;153;447;519;1618
411720;201805;940;2505;678;1958;93;293;223;595;316;888
411721;201805;820;2267;630;1873;125;386;134;393;259;779
411722;201805;677;1943;402;1300;66;260;145;393;211;653
411725;201805;1291;3920;812;2783;183;642;154;535;337;1177
411727;201805;1539;4481;1046;3387;298;1003;138;408;436;1411
411729;201805;661;1701;453;1304;87;267;119;305;206;572
411730;201805;5185;14618;3900;11937;1111;3536;1152;3488;2263;7024
411740;201805;565;1584;294;950;51;173;52;160;103;333
411745;201805;811;2398;560;1777;73;240;111;304;184;544
411750;201805;4827;13614;3610;11086;507;1678;1625;4751;2132;6429
411760;201805;7151;19969;5634;17175;1917;6125;1052;3397;2969;9522
411770;201805;3143;9691;2395;7956;630;2198;300;947;930;3145
411780;201805;2934;8604;2540;7859;664;2180;963;2981;1627;5161
411790;201805;2963;7854;1734;5321;399;1371;220;560;619;1931
411800;201805;1028;2966;682;2160;99;323;118;361;217;684
411810;201805;1695;4596;1298;3833;222;717;567;1547;789;2264
411820;201805;11226;34896;9181;30654;2859;9929;2776;9218;5635;19147
411830;201805;578;1449;398;1141;95;303;66;202;161;505
411840;201805;10760;29610;7199;22123;1345;4496;1772;5134;3117;9630
411845;201805;432;1293;233;781;43;164;21;65;64;229
411850;201805;7518;20770;5588;17096;1619;5407;845;2407;2464;7814
411860;201805;773;2324;585;1909;97;340;152;455;249;795
411870;201805;657;2079;462;1569;86;318;98;302;184;620
411880;201805;2041;5675;1503;4686;361;1237;239;726;600;1963
411885;201805;876;2362;674;2001;116;424;233;660;349;1084
411890;201805;1099;3170;744;2391;116;425;48;123;164;548
411900;201805;832;2510;501;1690;127;443;48;159;175;602
411910;201805;1049;3308;771;2665;223;802;183;602;406;1404
411915;201805;16578;42695;10239;30626;1807;5887;2740;7375;4547;13262
411920;201805;938;3000;801;2683;210;759;188;611;398;1370
411925;201805;575;1558;379;1179;92;305;103;299;195;604
411930;201805;5344;17335;4618;15861;2064;7673;309;1185;2373;8858
411940;201805;3140;9979;2490;8386;617;2112;575;1750;1192;3862
411950;201805;13073;37967;10799;33916;2179;7417;5120;15564;7299;22981
411960;201805;5440;15419;4639;13860;966;3191;1647;4589;2613;7780
411965;201805;458;1293;333;1054;56;211;124;362;180;573
411970;201805;839;2196;680;1958;125;326;387;1234;512;1560
411980;201805;1491;4107;1184;3525;295;911;390;1108;685;2019
411990;201805;34969;100658;24305;78613;5144;18377;7424;22514;12568;40891
411995;201805;2629;7084;2049;6148;593;1985;577;1592;1170;3577
412000;201805;2169;5152;1565;4133;92;308;973;2374;1065;2682
412010;201805;668;2143;466;1649;68;270;99;297;167;567
412015;201805;571;1670;475;1487;74;240;248;776;322;1016
412020;201805;447;1296;267;879;44;161;93;287;137;448
412030;201805;705;2096;497;1665;91;327;159;512;250;839
412033;201805;895;2617;628;2017;84;280;218;717;302;997
412035;201805;858;2292;549;1742;75;268;252;757;327;1025
412040;201805;574;1645;385;1248;64;208;64;198;128;406
412050;201805;1648;4491;1202;3631;224;759;285;859;509;1618
412060;201805;7065;22744;6141;20815;1830;6745;1406;4587;3236;11332
412065;201805;660;1907;495;1563;96;321;146;440;242;761
412070;201805;1250;3256;922;2581;139;410;366;1008;505;1418
412080;201805;1699;5085;1070;3641;148;545;77;252;225;797
412085;201805;324;914;103;369;10;42;8;21;18;63
412090;201805;5327;14616;4481;13094;1202;3558;1942;5816;3144;9374
412100;201805;1810;5225;1399;4454;430;1462;263;875;693;2337
412110;201805;857;2433;623;1895;120;394;172;518;292;912
412120;201805;1749;5587;1416;4841;325;1207;384;1097;709;2304
412125;201805;641;1974;504;1653;117;386;160;503;277;889
412130;201805;626;1790;450;1396;72;247;102;328;174;575
412135;201805;589;1646;274;842;45;137;85;238;130;375
412140;201805;1602;4256;1071;3235;221;758;166;441;387;1199
412150;201805;2986;8161;2489;7214;301;976;1537;4312;1838;5288
412160;201805;1087;3474;654;2311;159;611;82;277;241;888
412170;201805;4179;12324;3501;11041;811;2769;1422;4163;2233;6932
412175;201805;1329;4205;1134;3823;279;917;395;1358;674;2275
412180;201805;1672;4819;1240;4008;191;728;523;1539;714;2267
412190;201805;3300;8767;2458;7198;359;1166;1007;3016;1366;4182
412200;201805;1888;5837;1336;4468;344;1222;229;743;573;1965
412210;201805;605;1578;371;1114;70;242;93;225;163;467
412215;201805;3806;10449;3142;9147;853;2490;1256;4053;2109;6543
412217;201805;1048;2882;885;2594;73;243;596;1658;669;1901
412220;201805;5691;16849;4825;15166;1214;3786;1720;5729;2934;9515
412230;201805;2785;8812;2260;7659;404;1561;620;1883;1024;3444
412240;201805;6908;18296;4388;13330;815;2736;1085;3052;1900;5788
412250;201805;1942;5334;1522;4498;385;1181;245;671;630;1852
412260;201805;1227;3465;870;2682;136;438;256;718;392;1156
412265;201805;857;2559;725;2275;170;565;277;853;447;1418
412270;201805;799;2410;531;1760;73;267;197;610;270;877
412280;201805;519;1584;426;1402;96;328;105;328;201;656
412290;201805;997;2622;672;2005;109;353;196;549;305;902
412300;201805;1480;4329;1223;3797;307;1010;265;803;572;1813
412310;201805;808;2340;666;2080;67;287;331;1016;398;1303
412320;201805;827;2227;569;1710;82;321;186;541;268;862
412330;201805;1426;3951;983;3045;193;628;351;1099;544;1727
412340;201805;975;2876;629;2019;100;346;124;353;224;699
412350;201805;2654;7370;1733;5433;320;1079;272;817;592;1896
412360;201805;240;688;148;473;16;57;54;164;70;221
412370;201805;815;2452;599;2016;120;446;49;175;169;621
412380;201805;1560;4538;1113;3531;279;915;193;647;472;1562
412382;201805;565;1500;373;1119;59;186;107;284;166;470
412385;201805;2208;6383;1847;5631;633;1942;514;1663;1147;3605
412390;201805;2275;5980;1850;5284;367;1114;793;2271;1160;3385
412395;201805;720;2067;506;1613;52;164;236;720;288;884
412400;201805;899;2601;676;2120;153;488;158;533;311;1021
412402;201805;1751;4744;1343;4042;301;994;166;485;467;1479
412405;201805;3150;8973;2016;6477;417;1487;72;250;489;1737
412410;201805;5146;14574;3890;12207;862;3074;931;2715;1793;5789
412420;201805;455;1224;259;787;31;99;104;278;135;377
412430;201805;540;1450;352;1062;34;114;147;425;181;539
412440;201805;2838;8271;1964;6519;500;1800;341;1141;841;2941
412450;201805;325;1033;233;803;33;106;21;52;54;158
412460;201805;867;2522;724;2242;137;465;279;840;416;1305
412470;201805;1693;5589;1360;4778;346;1262;286;1066;632;2328
412480;201805;982;2822;631;1952;110;359;89;215;199;574
412490;201805;1056;2879;866;2491;130;374;400;1081;530;1455
412500;201805;1813;4919;1399;4103;275;829;270;703;545;1532
412510;201805;1966;6219;1436;4852;344;1236;151;457;495;1693
412520;201805;1395;3818;816;2507;188;574;86;243;274;817
412530;201805;619;1724;458;1386;65;217;120;352;185;569
412535;201805;768;2131;534;1639;118;392;103;295;221;687
412540;201805;1220;3329;856;2532;104;367;257;784;361;1151
412545;201805;696;1872;466;1365;86;265;126;334;212;599
412550;201805;30745;87970;20987;66783;4182;14177;6140;18064;10322;32241
412555;201805;238;663;154;475;21;69;43;106;64;175
412560;201805;5155;15427;3767;12181;794;2798;870;2732;1664;5530
412570;201805;3882;10666;2402;7561;492;1671;314;1073;806;2744
412575;201805;937;2687;768;2310;81;275;400;1121;481;1396
412580;201805;1342;3604;942;2816;157;509;393;1115;550;1624
412590;201805;490;1352;260;856;46;149;26;74;72;223
412600;201805;1373;4006;1010;3183;179;626;376;1142;555;1768
412610;201805;776;2209;495;1507;72;228;209;577;281;805
412620;201805;1251;3591;934;3002;195;723;284;819;479;1542
412625;201805;8221;23305;5475;17612;850;2923;525;1794;1375;4717
412627;201805;956;2828;660;2193;175;652;178;560;353;1212
412630;201805;2996;9074;2200;7237;408;1326;676;2046;1084;3372
412635;201805;359;1004;247;755;43;136;49;128;92;264
412640;201805;1016;2879;579;1852;82;283;117;337;199;620
412650;201805;1508;4376;1247;3866;224;807;425;1156;649;1963
412660;201805;2567;7044;1809;5501;327;1081;486;1361;813;2442
412665;201805;563;1419;316;956;58;181;110;310;168;491
412667;201805;1703;4669;1272;3794;203;702;482;1360;685;2062
412670;201805;571;1641;456;1423;90;327;151;453;241;780
412680;201805;1393;4002;880;2933;132;522;307;880;439;1402
412690;201805;834;2409;609;1917;119;381;151;453;270;834
412700;201805;2039;5611;1625;4928;316;1143;695;2004;1011;3147
412710;201805;5971;18306;4805;15867;1002;3566;1314;4019;2316;7585
412720;201805;1243;3792;929;3013;163;581;185;501;348;1082
412730;201805;2116;6123;1193;3934;249;855;175;546;424;1401
412740;201805;1689;4960;1133;3699;212;768;152;519;364;1287
412750;201805;3908;11230;3402;10388;415;1518;2173;6388;2588;7906
412760;201805;2711;7846;2371;7255;343;1151;1382;4123;1725;5274
412770;201805;10203;27103;5487;17078;758;2450;1063;2934;1821;5384
412780;201805;1262;3670;1034;3217;214;709;383;1170;597;1879
412785;201805;2057;5472;1474;4370;323;965;649;1888;972;2853
412788;201805;1347;4033;1102;3521;266;907;447;1357;713;2264
412790;201805;1036;2994;661;2163;125;457;181;510;306;967
412795;201805;1133;3146;665;2055;132;437;142;420;274;857
412796;201805;2317;7131;1944;6274;394;1360;621;1831;1015;3191
412800;201805;3261;8621;2254;6578;307;1016;866;2308;1173;3324
412810;201805;10820;28563;6362;19027;883;2958;1871;4777;2754;7735
412820;201805;6725;19138;4893;15470;1047;3480;1496;4702;2543;8182
412830;201805;344;1031;247;811;36;114;52;162;88;276
412840;201805;1803;4932;1356;4047;212;677;404;1174;616;1851
412850;201805;2980;8248;2242;6890;371;1227;779;2313;1150;3540
412853;201805;1800;4923;1485;4209;168;523;745;1896;913;2419
412855;201805;1237;3494;863;2630;160;543;206;542;366;1085
412860;201805;932;2695;714;2245;143;472;249;757;392;1229
412862;201805;684;1666;441;1237;67;216;174;479;241;695
412863;201805;1179;3773;1109;3661;109;363;834;2747;943;3110
412865;201805;732;2120;539;1743;96;316;181;602;277;918
412870;201805;907;2544;697;2190;222;781;138;452;360;1233
412880;201805;829;2379;554;1758;99;347;72;214;171;561
420005;201805;446;1340;252;874;39;143;98;333;137;476
420010;201805;3619;9250;2392;7087;225;745;1626;4826;1851;5571
420020;201805;540;1701;315;1114;49;196;45;124;94;320
420030;201805;186;534;99;374;22;97;12;44;34;141
420040;201805;595;1859;328;1234;51;206;14;41;65;247
420050;201805;650;1669;420;1251;61;192;235;673;296;865
420055;201805;154;479;78;291;11;53;26;93;37;146
420060;201805;134;420;89;310;14;57;16;34;30;91
420070;201805;959;3030;714;2448;138;508;245;821;383;1329
420075;201805;102;278;58;178;10;30;14;28;24;58
420080;201805;446;1351;342;1138;100;335;94;299;194;634
420090;201805;372;1277;250;945;49;189;53;210;102;399
420100;201805;1127;3280;991;3082;74;249;764;2356;838;2605
420110;201805;247;828;228;787;52;199;86;268;138;467
420120;201805;347;1069;251;843;56;217;94;283;150;500
420125;201805;321;1072;261;952;63;267;124;434;187;701
420127;201805;303;858;109;381;22;86;20;56;42;142
420130;201805;1946;6089;1446;5035;316;1225;472;1462;788;2687
420140;201805;3337;9577;2423;7862;638;2334;311;960;949;3294
420150;201805;533;1417;337;1091;68;239;131;391;199;630
420160;201805;230;610;108;359;13;47;35;114;48;161
420165;201805;162;492;101;342;26;92;29;90;55;182
420170;201805;234;737;145;522;32;125;25;85;57;210
420180;201805;231;707;127;453;18;63;32;98;50;161
420190;201805;138;467;85;320;30;116;16;57;46;173
420195;201805;1296;3669;990;3135;268;959;127;351;395;1310
420200;201805;3031;8496;1764;5833;317;1272;501;1426;818;2698
420205;201805;1234;3628;914;3009;152;552;498;1653;650;2205
420207;201805;1499;4158;962;3096;230;840;289;875;519;1715
420208;201805;439;1209;250;876;40;175;106;373;146;548
420209;201805;168;559;106;381;30;120;37;124;67;244
420210;201805;2273;6309;1436;4888;313;1175;571;1861;884;3036
420213;201805;769;2588;681;2401;175;678;304;1057;479;1735
420215;201805;272;851;173;619;52;187;20;69;72;256
420220;201805;165;545;117;445;33;134;33;119;66;253
420230;201805;3722;10714;2820;9076;439;1621;1387;4300;1826;5921
420240;201805;11086;30366;6979;22155;901;3400;3404;9677;4305;13077
420243;201805;416;1253;331;1086;62;221;142;436;204;657
420245;201805;1175;3267;811;2584;85;331;431;1281;516;1612
420250;201805;442;1361;389;1254;88;318;173;518;261;836
420253;201805;516;1354;380;1145;29;86;205;612;234;698
420257;201805;209;559;128;406;23;76;63;203;86;279
420260;201805;1041;3153;799;2741;137;523;396;1330;533;1853
420270;201805;504;1395;228;730;22;83;80;246;102;329
420280;201805;1511;4161;938;3106;192;678;234;746;426;1424
420285;201805;98;264;50;173;9;37;7;16;16;53
420287;201805;414;1080;281;870;91;299;91;267;182;566
420290;201805;4022;12158;3054;9926;541;1927;1141;3346;1682;5273
420300;201805;6528;18936;3808;12674;779;2952;857;2441;1636;5393
420310;201805;859;2093;429;1209;74;197;235;635;309;832
420315;201805;839;2644;619;2177;151;559;220;770;371;1329
420320;201805;3948;11877;3152;10392;1019;3676;714;2148;1733;5824
420325;201805;231;732;170;604;49;175;44;153;93;328
420330;201805;829;2649;584;2061;123;476;185;600;308;1076
420340;201805;1116;3326;790;2633;158;535;60;199;218;734
420350;201805;1440;3999;999;3123;138;480;568;1747;706;2227
420360;201805;2494;7370;1409;4899;273;1044;115;387;388;1431
420370;201805;1295;3605;999;3101;136;516;643;1900;779;2416
420380;201805;5024;14187;3238;10519;732;2532;944;2983;1676;5515
420390;201805;1040;2718;683;1999;111;342;247;545;358;887
420395;201805;1025;3077;666;2280;101;365;78;232;179;597
420400;201805;976;2964;645;2224;128;502;150;491;278;993
420410;201805;545;1537;403;1257;33;133;286;863;319;996
420415;201805;332;1032;254;864;79;283;69;237;148;520
420417;201805;654;2055;523;1750;116;405;195;649;311;1054
420419;201805;216;750;155;595;54;234;6;18;60;252
420420;201805;9991;28283;7233;23124;2501;8650;1524;4481;4025;13131
420425;201805;828;2221;562;1725;53;200;241;705;294;905
420430;201805;3177;9278;1981;6489;440;1528;544;1615;984;3143
420435;201805;281;783;128;450;23;102;44;141;67;243
420440;201805;769;2273;414;1395;125;477;105;306;230;783
420445;201805;322;902;190;609;42;142;55;158;97;300
420450;201805;663;2033;471;1595;94;368;129;391;223;759
420455;201805;1931;5225;1461;4425;210;721;726;2111;936;2832
420460;201805;8314;23312;6268;19642;1132;3984;2701;8009;3833;11993
420470;201805;679;1838;389;1252;76;285;91;245;167;530
420475;201805;38;115;30;96;12;37;5;16;17;53
420480;201805;4749;12745;3166;9931;648;2212;945;2866;1593;5078
420490;201805;556;1488;301;1023;71;270;66;225;137;495
420500;201805;1292;3893;919;3148;194;700;320;1076;514;1776
420510;201805;110;370;70;249;14;48;33;111;47;159
420515;201805;58;163;42;132;6;20;15;43;21;63
420517;201805;764;2174;680;2028;46;129;527;1571;573;1700
420519;201805;358;916;229;704;36;132;77;232;113;364
420520;201805;455;1244;212;745;20;62;19;59;39;121
420530;201805;965;2922;682;2293;138;529;190;558;328;1087
420535;201805;224;642;101;340;25;85;14;51;39;136
420540;201805;24166;62277;15765;46074;2930;9409;5064;12590;7994;21999
420543;201805;237;688;186;583;28;93;96;287;124;380
420545;201805;1243;3870;991;3325;220;762;332;1093;552;1855
420550;201805;3518;10327;2352;8085;493;1903;831;2931;1324;4834
420555;201805;311;958;219;751;46;165;85;279;131;444
420560;201805;429;1187;322;1008;72;221;167;522;239;743
420570;201805;2113;6355;1607;5287;335;1218;575;1770;910;2988
420580;201805;1702;4606;1285;3930;271;950;597;1706;868;2656
420590;201805;2982;8514;1803;5825;340;1247;346;819;686;2066
420600;201805;896;2783;733;2464;114;421;390;1306;504;1727
420610;201805;392;1186;214;758;53;199;40;135;93;334
420620;201805;471;1382;387;1227;107;362;126;392;233;754
420630;201805;820;2510;611;2005;124;443;272;825;396;1268
420640;201805;583;1692;275;979;68;270;25;65;93;335
420650;201805;2650;7472;1595;5206;266;918;531;1530;797;2448
420660;201805;407;1164;272;875;58;203;63;192;121;395
420665;201805;519;1433;335;1100;59;236;131;373;190;609
420670;201805;1528;4313;1026;3303;172;689;352;971;524;1660
420675;201805;156;477;103;358;26;108;18;47;44;155
420680;201805;338;839;195;630;34;121;87;269;121;390
420690;201805;802;2616;548;1946;78;283;113;310;191;593
420700;201805;2883;8204;2232;6961;361;1252;940;2806;1301;4058
420710;201805;625;1967;479;1657;92;400;204;611;296;1011
420720;201805;1353;3826;1019;3331;259;855;429;1403;688;2258
420730;201805;2782;7780;2165;6789;375;1283;1123;3388;1498;4671
420740;201805;719;2190;476;1664;129;475;79;277;208;752
420750;201805;1836;5667;1282;4400;213;830;435;1325;648;2155
420757;201805;78;179;22;88;4;19;8;31;12;50
420760;201805;384;1189;170;572;36;126;20;64;56;190
420765;201805;416;1350;219;807;38;151;52;195;90;346
420768;201805;1202;3823;1018;3467;227;798;610;2075;837;2873
420770;201805;503;1389;227;831;45;189;64;222;109;411
420775;201805;471;1383;266;920;60;225;45;136;105;361
420780;201805;1094;3191;650;2201;117;410;148;465;265;875
420785;201805;196;555;143;436;28;83;40;107;68;190
420790;201805;1003;3296;782;2846;190;760;329;1130;519;1890
420800;201805;738;2009;339;1138;78;287;88;270;166;557
420810;201805;1562;5305;1287;4675;394;1601;299;926;693;2527
420820;201805;9010;24432;6129;19630;1369;4889;2136;6209;3505;11098
420830;201805;2842;8322;2235;7187;527;1832;774;2416;1301;4248
420840;201805;673;1989;291;1042;68;261;59;189;127;450
420845;201805;1707;4675;1033;3445;236;867;316;1035;552;1902
420850;201805;1098;3677;693;2616;155;649;93;296;248;945
420860;201805;286;793;175;587;46;171;32;94;78;265
420870;201805;882;2454;678;2105;215;754;248;720;463;1474
420880;201805;905;2924;706;2458;164;632;176;535;340;1167
420890;201805;7493;20622;4114;13520;738;2664;1098;3085;1836;5749
420895;201805;167;496;94;300;30;99;29;88;59;187
420900;201805;1467;3883;874;2788;143;545;311;865;454;1410
420910;201805;23492;66389;15554;50698;2597;9501;5311;15651;7908;25152
420915;201805;554;2114;370;1555;64;285;158;637;222;922
420917;201805;344;980;173;523;31;101;66;184;97;285
420920;201805;107;315;42;156;4;16;2;6;6;22
420930;201805;17466;47819;12642;39245;2248;7621;5536;16296;7784;23917
420940;201805;2371;6451;1565;4968;378;1311;143;355;521;1666
420945;201805;149;462;108;354;35;127;31;95;66;222
420950;201805;404;1160;218;745;30;127;64;205;94;332
420960;201805;903;2470;627;1932;125;447;215;593;340;1040
420970;201805;2582;7720;1794;6122;476;1691;298;1074;774;2765
420980;201805;354;1095;282;986;124;451;87;329;211;780
420985;201805;320;978;167;603;34;147;56;178;90;325
420990;201805;516;1537;282;1017;57;219;42;110;99;329
421000;201805;476;1626;324;1209;80;324;60;172;140;496
421003;201805;508;1263;175;546;17;49;24;55;41;104
421005;201805;64;225;57;212;16;66;22;87;38;153
421010;201805;3869;10852;2705;8754;578;2036;581;1712;1159;3748
421020;201805;400;1200;310;1043;20;80;205;695;225;775
421030;201805;718;2342;569;1997;179;686;140;459;319;1145
421040;201805;777;1892;471;1407;52;194;275;785;327;979
421050;201805;1290;3679;748;2444;136;476;232;693;368;1169
421055;201805;174;479;85;274;21;79;22;63;43;142
421060;201805;528;1629;365;1220;75;294;132;409;207;703
421070;201805;540;1703;319;1139;73;274;42;147;115;421
421080;201805;660;2687;611;2611;68;223;469;2159;537;2382
421085;201805;435;1254;180;643;25;93;29;92;54;185
421090;201805;391;1058;196;626;24;81;54;163;78;244
421100;201805;922;2354;451;1384;104;349;48;127;152;476
421105;201805;1394;3997;1089;3538;167;547;576;1958;743;2505
421110;201805;934;2884;804;2657;64;217;529;1777;593;1994
421120;201805;1042;3333;706;2551;102;425;187;587;289;1012
421125;201805;292;787;213;663;69;239;69;164;138;403
421130;201805;3457;10770;2953;9792;725;2639;1434;4625;2159;7264
421140;201805;288;839;197;643;40;128;61;179;101;307
421145;201805;463;1340;274;880;56;198;104;305;160;503
421150;201805;501;1435;320;1108;54;225;119;393;173;618
421160;201805;809;2179;429;1396;66;241;198;625;264;866
421165;201805;200;625;143;486;31;103;66;225;97;328
421170;201805;1168;3162;909;2755;145;432;552;1689;697;2121
421175;201805;1094;2988;714;2313;142;545;260;741;402;1286
421180;201805;429;1135;201;651;40;166;42;120;82;286
421185;201805;324;854;212;635;38;119;112;328;150;447
421187;201805;336;1012;223;729;31;99;88;272;119;371
421189;201805;354;1105;269;913;43;153;82;261;125;414
421190;201805;10145;28124;6272;20770;1248;4548;1216;3788;2464;8336
421200;201805;720;2253;590;2001;102;356;251;817;353;1173
421205;201805;198;566;152;487;30;110;69;211;99;321
421210;201805;1055;2998;711;2315;167;554;238;758;405;1312
421220;201805;1391;4570;1171;4070;290;1122;215;639;505;1761
421223;201805;405;1212;273;945;57;205;104;355;161;560
421225;201805;984;3100;845;2810;175;634;439;1476;614;2110
421227;201805;960;2653;606;1953;104;377;309;996;413;1373
421230;201805;574;1573;376;1218;101;351;124;406;225;757
421240;201805;331;1034;147;554;14;68;16;62;30;130
421250;201805;1457;3967;930;3062;192;694;279;895;471;1589
421260;201805;272;785;54;197;11;40;7;26;18;66
421265;201805;712;2137;650;2045;50;181;516;1614;566;1795
421270;201805;471;1303;225;812;42;151;77;275;119;426
421280;201805;1504;4656;1176;4036;258;951;484;1645;742;2596
421290;201805;794;2217;453;1444;80;266;86;249;166;515
421300;201805;220;651;146;486;37;142;41;129;78;271
421310;201805;183;576;142;472;25;91;49;158;74;249
421315;201805;250;754;154;529;37;133;18;66;55;199
421320;201805;637;1918;361;1214;61;215;54;126;115;341
421330;201805;580;1782;432;1485;106;394;113;376;219;770
421335;201805;382;1257;311;1112;61;254;93;321;154;575
421340;201805;1392;4012;1053;3403;207;732;460;1435;667;2167
421350;201805;1089;3263;839;2797;144;578;393;1241;537;1819
421360;201805;2247;6434;1403;4719;325;1295;462;1366;787;2661
421370;201805;451;1518;294;1102;71;279;66;253;137;532
421380;201805;805;2313;686;2090;105;352;375;1094;480;1446
421390;201805;160;428;62;200;8;31;19;47;27;78
421400;201805;269;893;179;681;42;179;77;274;119;453
421410;201805;263;741;119;430;16;63;48;171;64;234
421415;201805;330;1014;149;504;35;119;28;84;63;203
421420;201805;606;1791;486;1564;79;270;255;782;334;1052
421430;201805;137;471;105;387;18;69;29;102;47;171
421440;201805;682;1913;461;1525;83;291;226;751;309;1042
421450;201805;398;1200;243;838;33;133;40;160;73;293
421460;201805;429;1216;261;903;60;227;74;230;134;457
421470;201805;252;813;180;648;37;162;52;172;89;334
421480;201805;2727;7545;1763;5793;481;1808;423;1218;904;3026
421490;201805;146;439;75;273;11;45;18;50;29;95
421500;201805;2041;6491;1458;5232;384;1538;248;804;632;2342
421505;201805;311;972;271;901;46;170;147;476;193;646
421507;201805;388;1170;239;840;62;245;75;247;137;492
421510;201805;231;678;146;477;34;104;59;171;93;275
421520;201805;562;1566;357;1102;51;182;173;494;224;676
421530;201805;320;1008;179;648;34;156;41;123;75;279
421535;201805;427;1245;280;947;35;138;142;449;177;587
421540;201805;226;596;151;471;20;76;64;182;84;258
421545;201805;676;2061;488;1680;103;403;205;673;308;1076
421550;201805;1958;5844;1655;5357;409;1446;761;2384;1170;3830
421555;201805;209;628;70;255;15;65;11;27;26;92
421560;201805;106;337;57;210;11;47;14;48;25;95
421565;201805;793;2172;578;1825;132;466;211;683;343;1149
421567;201805;496;1761;351;1344;165;650;48;181;213;831
421568;201805;405;1247;282;949;43;158;111;351;154;509
421569;201805;195;588;72;263;19;64;18;72;37;136
421570;201805;1112;3146;701;2275;177;624;125;365;302;989
421575;201805;326;1011;286;899;43;152;152;443;195;595
421580;201805;2771;8459;2006;6833;412;1625;650;1938;1062;3563
421590;201805;147;491;123;423;20;72;58;191;78;263
421600;201805;461;1322;316;992;75;242;76;220;151;462
421605;201805;766;2105;508;1635;91;316;138;409;229;725
421610;201805;1216;3351;752;2425;146;517;159;468;305;985
421620;201805;3783;10895;2253;7837;593;2244;493;1662;1086;3906
421625;201805;268;735;106;359;24;77;14;39;38;116
421630;201805;2579;7390;1447;4755;243;908;315;923;558;1831
421635;201805;235;696;134;441;15;55;50;143;65;198
421640;201805;821;2321;550;1814;116;401;150;482;266;883
421650;201805;2086;6259;1376;4752;307;1231;236;641;543;1872
421660;201805;6901;21483;5578;18826;1022;3862;2039;6307;3061;10169
421670;201805;885;2606;608;1974;145;545;217;664;362;1209
421680;201805;947;2971;746;2539;225;819;219;684;444;1503
421690;201805;1192;3796;862;3007;201;797;200;664;401;1461
421700;201805;469;1489;243;892;47;191;56;182;103;373
421710;201805;200;642;88;301;21;84;28;86;49;170
421715;201805;113;323;77;242;16;51;46;136;62;187
421720;201805;1840;5306;1085;3702;267;975;259;795;526;1770
421725;201805;173;463;105;329;26;91;34;84;60;175
421730;201805;370;1138;203;648;31;117;71;192;102;309
421740;201805;629;1913;433;1441;114;416;107;317;221;733
421750;201805;885;2191;462;1407;73;236;175;498;248;734
421755;201805;212;605;106;353;15;63;42;123;57;186
421760;201805;931;2715;515;1767;83;309;120;345;203;654
421770;201805;2342;6657;1720;5546;417;1370;607;2117;1024;3487
421775;201805;252;724;173;558;28;97;74;223;102;320
421780;201805;838;2760;581;2160;122;481;160;570;282;1051
421790;201805;634;1667;378;1258;110;390;148;464;258;854
421795;201805;240;720;147;465;24;88;54;149;78;237
421800;201805;2405;7052;1774;5858;382;1398;754;2365;1136;3763
421810;201805;642;1826;449;1444;70;257;205;620;275;877
421820;201805;844;2443;449;1529;89;324;69;210;158;534
421825;201805;1321;3944;1207;3758;167;583;825;2491;992;3074
421830;201805;2182;7129;1867;6496;451;1705;609;1994;1060;3699
421835;201805;217;596;124;423;20;85;59;179;79;264
421840;201805;224;707;152;556;35;138;43;147;78;285
421850;201805;409;1272;231;820;39;156;49;133;88;289
421860;201805;274;849;178;635;29;125;44;125;73;250
421870;201805;3320;8993;2299;7002;516;1741;779;2188;1295;3929
421875;201805;267;810;122;452;22;89;21;58;43;147
421880;201805;566;1650;418;1360;117;417;66;208;183;625
421885;201805;240;698;185;612;58;203;40;112;98;315
421890;201805;760;2498;617;2213;156;625;238;777;394;1402
421895;201805;346;1033;317;992;47;165;212;658;259;823
421900;201805;919;2457;639;1907;109;376;291;796;400;1172
421910;201805;369;1159;264;925;54;221;48;136;102;357
421915;201805;408;1196;236;780;49;156;32;98;81;254
421917;201805;572;1569;374;1287;122;472;84;287;206;759
421920;201805;522;1530;348;1253;167;619;100;375;267;994
421930;201805;2306;6292;1147;3958;313;1155;127;396;440;1551
421935;201805;480;1580;380;1364;76;293;181;604;257;897
421940;201805;253;805;126;440;27;116;35;113;62;229
421950;201805;3037;7862;1458;4733;311;1108;251;748;562;1856
421960;201805;154;419;106;344;19;75;25;81;44;156
421970;201805;2013;5407;1092;3504;228;760;268;764;496;1524
421985;201805;330;843;180;550;25;85;52;171;77;256
422000;201805;1633;4665;1338;4128;216;774;736;2221;952;2995
430003;201805;549;1622;387;1323;80;308;137;449;217;757
430005;201805;279;779;180;587;50;165;70;228;120;393
430010;201805;1729;4658;1359;4007;218;700;778;2243;996;2943
430020;201805;602;1449;469;1268;71;222;279;720;350;942
430030;201805;1022;2549;609;1783;179;542;167;478;346;1020
430040;201805;9831;25604;6069;18318;1580;5290;336;1078;1916;6368
430045;201805;572;1540;393;1166;46;147;197;548;243;695
430047;201805;270;632;112;340;22;71;33;99;55;170
430050;201805;959;2568;539;1662;118;377;128;368;246;745
430055;201805;284;732;129;394;15;50;60;164;75;214
430057;201805;106;251;38;119;8;32;7;20;15;52
430060;201805;16348;48063;13266;43004;3435;11922;5123;16689;8558;28611
430063;201805;872;2506;693;2109;145;433;382;1159;527;1592
430064;201805;1035;3034;773;2432;224;757;206;625;430;1382
430066;201805;126;293;89;231;4;15;59;143;63;158
430070;201805;671;1774;118;406;9;30;12;27;21;57
430080;201805;771;2060;450;1385;96;310;171;468;267;778
430085;201805;894;2220;534;1565;88;268;193;572;281;840
430087;201805;607;1854;505;1682;100;364;248;800;348;1164
430090;201805;640;1693;215;706;20;78;59;188;79;266
430100;201805;684;1756;364;1122;71;235;122;337;193;572
430105;201805;1015;2802;661;2172;110;421;293;972;403;1393
430107;201805;175;540;124;413;19;64;30;88;49;152
430110;201805;2091;5388;1527;4523;283;881;783;2242;1066;3123
430120;201805;1420;4399;893;3034;199;697;354;1251;553;1948
430130;201805;3868;10360;3082;9179;1017;2773;956;3511;1973;6284
430140;201805;967;2894;617;2083;160;539;204;685;364;1224
430150;201805;591;1542;326;1014;71;226;95;287;166;513
430155;201805;289;763;147;469;20;72;35;96;55;168
430160;201805;17558;46554;14118;41135;3278;10011;5286;15985;8564;25996
430163;201805;2321;6094;1678;5054;192;660;1004;2985;1196;3645
430165;201805;439;1026;85;271;10;26;7;19;17;45
430170;201805;896;2493;321;1140;58;212;64;200;122;412
430175;201805;705;2230;580;1923;144;457;277;927;421;1384
430180;201805;693;1846;553;1595;91;296;334;910;425;1206
430185;201805;473;1183;296;841;48;140;131;335;179;475
430187;201805;631;1674;451;1379;73;241;202;610;275;851
430190;201805;1466;4232;1215;3738;293;951;504;1523;797;2474
430192;201805;136;414;59;185;9;29;10;27;19;56
430195;201805;377;1138;66;231;10;34;6;19;16;53
430200;201805;1097;3491;928;3150;286;1032;275;918;561;1950
430205;201805;513;1437;401;1200;20;78;316;914;336;992
430210;201805;5265;13622;3592;10218;545;1691;1425;3299;1970;4990
430215;201805;324;888;210;639;42;137;77;228;119;365
430220;201805;653;1639;174;593;31;116;38;111;69;227
430222;201805;196;605;159;520;22;74;68;210;90;284
430223;201805;272;774;226;680;39;124;113;330;152;454
430225;201805;16;42;14;38;2;3;7;12;9;15
430230;201805;1593;4687;1489;4547;208;591;1137;3560;1345;4151
430235;201805;242;755;181;603;29;112;61;190;90;302
430237;201805;552;1386;372;1062;21;68;246;652;267;720
430240;201805;1178;2681;706;1949;67;217;415;1113;482;1330
430245;201805;742;2264;562;1883;187;635;245;838;432;1473
430250;201805;1027;2826;827;2518;239;772;45;131;284;903
430258;201805;114;327;88;279;7;23;45;146;52;169
430260;201805;610;1693;443;1356;84;252;213;661;297;913
430265;201805;193;577;140;479;26;103;39;130;65;233
430270;201805;2809;7370;2289;6558;244;754;1546;4350;1790;5104
430280;201805;4752;12052;3517;9812;797;2292;1440;4025;2237;6317
430290;201805;2189;5554;1946;5222;77;236;1674;4438;1751;4674
430300;201805;8591;23898;6821;20585;1388;4509;3158;9442;4546;13951
430310;201805;8213;22079;5604;17089;913;3167;2466;7029;3379;10196
430320;201805;920;2572;508;1650;89;249;246;860;335;1109
430330;201805;633;1611;432;1213;94;282;191;474;285;756
430340;201805;750;1759;376;1137;71;221;195;576;266;797
430350;201805;5762;16719;4673;14442;1236;3950;1868;5610;3104;9560
430355;201805;366;945;126;413;26;91;13;42;39;133
430360;201805;773;2050;562;1658;110;356;197;538;307;894
430367;201805;336;838;172;519;49;166;49;145;98;311
430370;201805;531;1488;260;852;59;207;59;168;118;375
430380;201805;691;1768;372;1178;108;386;89;286;197;672
430390;201805;3268;8387;1796;5518;299;980;138;337;437;1317
430400;201805;1137;2642;845;2171;112;297;543;1349;655;1646
430410;201805;589;1522;417;1221;55;188;251;719;306;907
430420;201805;2902;8314;2237;6783;690;2171;704;2051;1394;4222
430430;201805;680;1788;331;1046;78;259;66;195;144;454
430435;201805;1672;4417;1222;3622;286;899;425;1256;711;2155
430440;201805;3737;11036;2796;9051;541;1861;1340;4394;1881;6255
430450;201805;6182;17044;5197;15173;929;2990;2583;7372;3512;10362
430460;201805;26999;73922;19391;61149;4345;15150;7570;22859;11915;38009
430461;201805;465;1204;138;439;23;73;28;82;51;155
430462;201805;251;689;157;515;22;78;42;145;64;223
430463;201805;4434;13212;3649;11787;705;2475;1791;5731;2496;8206
430465;201805;488;1330;403;1161;75;233;241;671;316;904
430466;201805;3749;9747;3040;8578;732;2161;1415;3803;2147;5964
430467;201805;500;1330;369;1098;62;212;166;474;228;686
430468;201805;1360;3527;1078;3101;165;515;608;1742;773;2257
430469;201805;585;1674;71;241;11;30;10;27;21;57
430470;201805;6174;16785;4348;13509;1378;4532;871;2738;2249;7270
430471;201805;490;1561;431;1425;83;272;186;603;269;875
430480;201805;929;2466;465;1475;71;251;74;195;145;446
430485;201805;152;426;57;193;8;29;10;29;18;58
430490;201805;403;1095;222;686;36;126;99;299;135;425
430495;201805;384;1094;239;791;28;102;97;282;125;384
430500;201805;1099;2917;801;2410;207;689;293;802;500;1491
430510;201805;22726;62372;16503;49784;3798;12522;5805;16136;9603;28658
430511;201805;336;1000;123;431;19;62;14;42;33;104
430512;201805;913;2247;742;1970;191;525;230;628;421;1153
430513;201805;795;2044;392;1129;87;266;158;421;245;687
430515;201805;390;1133;281;912;47;140;130;434;177;574
430517;201805;969;3068;785;2686;135;466;388;1377;523;1843
430520;201805;1356;3688;731;2321;140;466;125;361;265;827
430530;201805;1109;2881;402;1251;76;227;87;261;163;488
430535;201805;2928;8099;2061;6412;363;1185;907;2778;1270;3963
430537;201805;353;1263;313;1130;39;132;226;822;265;954
430540;201805;585;1376;349;1008;60;169;174;496;234;665
430543;201805;617;1265;403;1015;62;138;258;683;320;821
430544;201805;647;1985;475;1571;102;358;217;679;319;1037
430545;201805;1706;4932;1310;4313;308;1072;589;1998;897;3070
430550;201805;515;1459;282;921;53;179;70;203;123;382
430558;201805;136;346;67;211;13;41;19;55;32;96
430560;201805;407;955;174;529;19;61;39;117;58;178
430570;201805;890;2174;604;1674;85;281;344;867;429;1148
430580;201805;1096;2665;679;2000;129;452;308;848;437;1300
430583;201805;181;463;36;113;2;7;5;15;7;22
430585;201805;234;582;134;381;20;65;65;159;85;224
430587;201805;182;557;142;466;29;98;60;203;89;301
430590;201805;1423;3549;1229;3227;52;166;1071;2758;1123;2924
430593;201805;14;45;13;44;1;3;8;28;9;31
430595;201805;437;1075;91;327;7;32;14;44;21;76
430597;201805;334;972;229;718;26;90;80;199;106;289
430600;201805;1824;4905;863;2657;156;486;221;634;377;1120
430605;201805;1163;3414;881;2816;136;529;332;1026;468;1555
430607;201805;675;1545;487;1256;35;104;326;860;361;964
430610;201805;6000;15543;4348;12925;1236;3994;656;2036;1892;6030
430613;201805;293;688;91;273;8;29;25;60;33;89
430620;201805;581;1586;458;1339;119;382;200;554;319;936
430630;201805;465;1345;131;430;19;65;25;67;44;132
430632;201805;593;1621;271;829;33;103;113;328;146;431
430635;201805;533;1488;400;1208;70;225;246;716;316;941
430637;201805;424;1139;344;1006;53;170;195;542;248;712
430640;201805;1295;3409;695;2144;105;334;193;528;298;862
430642;201805;388;1054;264;792;43;123;129;383;172;506
430645;201805;270;596;92;248;15;43;17;46;32;89
430650;201805;1590;5017;1330;4489;338;1173;629;2161;967;3334
430655;201805;201;481;129;362;27;75;57;148;84;223
430660;201805;4896;13367;3764;11333;820;2689;1637;4873;2457;7562
430670;201805;561;1481;430;1242;45;156;266;773;311;929
430673;201805;615;1466;240;732;52;165;78;235;130;400
430675;201805;228;679;56;199;16;67;11;34;27;101
430676;201805;4211;11312;3243;9644;584;1839;1548;4550;2132;6389
430680;201805;1013;2805;611;1971;146;455;134;407;280;862
430690;201805;3301;9353;2683;8189;792;2499;720;2187;1512;4686
430692;201805;209;655;164;585;13;45;112;410;125;455
430693;201805;1056;2778;585;1796;121;433;125;336;246;769
430695;201805;539;1340;324;935;37;112;170;458;207;570
430697;201805;414;1086;299;884;55;158;145;452;200;610
430700;201805;7400;19070;3937;12562;936;3220;311;1031;1247;4251
430705;201805;345;921;181;582;26;91;68;214;94;305
430710;201805;1738;4009;1238;3242;217;642;622;1564;839;2206
430720;201805;704;1745;385;1186;81;249;134;401;215;650
430730;201805;1300;3442;831;2582;144;454;388;1219;532;1673
430740;201805;594;1698;311;1075;51;177;80;299;131;476
430745;201805;468;1314;239;764;38;136;51;147;89;283
430750;201805;1370;3668;978;2997;196;660;507;1477;703;2137
430755;201805;486;1223;308;857;20;62;170;433;190;495
430760;201805;2077;5495;1573;4664;370;1152;660;1921;1030;3073
430770;201805;6000;16174;4551;13800;795;2618;2477;7305;3272;9923
430780;201805;2210;5692;1321;4146;264;866;405;1341;669;2207
430781;201805;397;1159;251;825;58;195;54;169;112;364
430783;201805;470;1142;273;807;28;96;135;374;163;470
430786;201805;61;210;37;146;8;29;4;21;12;50
430790;201805;4364;11600;2985;8907;529;1734;1513;4260;2042;5994
430800;201805;813;2143;579;1661;53;189;339;916;392;1105
430805;201805;515;1439;300;930;33;112;156;449;189;561
430807;201805;389;973;252;731;25;84;122;329;147;413
430810;201805;889;2270;278;931;43;145;70;219;113;364
430820;201805;1291;3589;712;2403;160;556;140;462;300;1018
430825;201805;276;722;89;247;21;58;17;39;38;97
430830;201805;1566;4769;1337;4343;106;392;919;2992;1025;3384
430840;201805;891;2539;751;2289;146;442;425;1293;571;1735
430843;201805;116;292;40;125;5;15;14;40;19;55
430845;201805;326;846;224;662;77;243;46;114;123;357
430850;201805;2341;6488;1810;5494;364;1239;828;2467;1192;3706
430860;201805;944;2321;472;1424;85;309;191;509;276;818
430865;201805;532;1416;451;1276;117;352;197;519;314;871
430870;201805;671;1820;297;976;51;183;86;247;137;430
430880;201805;1223;3012;799;2325;199;601;314;909;513;1510
430885;201805;226;546;101;338;6;28;61;199;67;227
430890;201805;1231;3294;819;2490;59;265;119;338;178;603
430900;201805;2936;7035;2009;5589;258;820;1100;2888;1358;3708
430905;201805;868;2354;551;1713;105;356;167;493;272;849
430910;201805;1486;4126;988;3083;172;627;395;1105;567;1732
430912;201805;489;1372;337;1095;37;115;203;677;240;792
430915;201805;519;1620;383;1372;102;373;132;498;234;871
430920;201805;21433;56971;16735;49353;2564;8308;9555;27444;12119;35752
430925;201805;140;311;52;147;10;28;20;60;30;88
430930;201805;10052;24705;6110;18335;1492;4785;1743;5449;3235;10234
430940;201805;1298;3855;697;2305;188;636;92;258;280;894
430950;201805;761;1935;476;1395;80;276;232;603;312;879
430955;201805;188;492;61;193;12;28;7;24;19;52
430957;201805;189;662;173;626;36;134;86;308;122;442
430960;201805;1310;3209;866;2442;187;582;421;1163;608;1745
430965;201805;1652;4195;1276;3590;72;242;972;2672;1044;2914
430970;201805;383;1018;195;620;27;96;97;295;124;391
430975;201805;470;1550;375;1305;93;339;144;500;237;839
430980;201805;417;1034;233;701;45;147;87;255;132;402
430990;201805;557;1662;325;1065;49;178;144;459;193;637
430995;201805;600;1631;430;1322;70;213;210;632;280;845
431000;201805;1436;3513;612;1845;104;343;27;73;131;416
431010;201805;2244;6111;1308;4314;185;699;119;333;304;1032
431020;201805;8780;20357;5444;14971;1258;3723;1606;4062;2864;7785
431030;201805;327;927;145;519;33;115;21;82;54;197
431033;201805;2943;8002;2088;6661;563;1859;681;2331;1244;4190
431036;201805;349;767;66;198;9;19;12;35;21;54
431040;201805;917;2476;595;1854;98;356;268;775;366;1131
431041;201805;483;1159;376;993;44;122;228;595;272;717
431043;201805;437;1118;223;726;74;245;68;217;142;462
431046;201805;124;331;57;170;6;18;12;33;18;51
431050;201805;1548;3863;1088;3124;218;655;547;1557;765;2212
431053;201805;516;1536;349;1185;88;318;92;301;180;619
431055;201805;603;1559;526;1438;47;127;392;1054;439;1181
431057;201805;288;837;132;446;22;80;35;104;57;184
431060;201805;4994;14212;3850;12076;1133;3860;755;2491;1888;6351
431065;201805;511;1375;333;1045;75;239;84;262;159;501
431070;201805;507;1513;296;994;77;282;39;106;116;388
431075;201805;213;657;153;532;32;117;50;175;82;292
431080;201805;653;1877;446;1424;83;272;136;426;219;698
431085;201805;687;1915;504;1491;78;219;273;796;351;1015
431087;201805;451;1317;372;1133;23;77;265;819;288;896
431090;201805;445;1069;158;498;29;95;38;118;67;213
431100;201805;3185;7723;2349;6557;424;1288;1003;2764;1427;4052
431110;201805;1396;3388;996;2677;255;706;420;1060;675;1766
431112;201805;519;1640;453;1504;88;302;225;731;313;1033
431113;201805;394;1127;322;986;100;324;129;399;229;723
431115;201805;1177;3367;930;2917;152;528;503;1524;655;2052
431120;201805;2480;7221;1745;5695;584;2141;379;1111;963;3252
431123;201805;403;1170;256;853;53;166;123;431;176;597
431125;201805;1168;3534;842;2801;307;993;234;845;541;1838
431127;201805;283;777;68;223;8;24;12;28;20;52
431130;201805;3372;9337;2276;7174;487;1660;815;2520;1302;4180
431140;201805;4970;12134;2713;7821;378;1203;971;2439;1349;3642
431142;201805;492;1384;373;1170;52;159;227;715;279;874
431150;201805;999;2844;711;2256;158;511;285;894;443;1405
431160;201805;671;1933;503;1585;111;346;188;603;299;949
431162;201805;531;1280;226;712;30;113;59;175;89;288
431164;201805;229;556;49;162;11;46;4;14;15;60
431170;201805;586;1582;373;1158;103;323;96;295;199;618
431171;201805;687;1783;569;1604;86;253;333;917;419;1170
431173;201805;426;1198;320;1008;120;405;78;244;198;649
431175;201805;972;2535;622;1896;173;532;115;353;288;885
431177;201805;751;2261;556;1901;168;612;219;741;387;1353
431179;201805;357;753;74;219;14;44;16;33;30;77
431180;201805;2209;5847;1360;4189;349;1132;239;717;588;1849
431190;201805;509;1382;271;858;37;118;57;149;94;267
431198;201805;308;975;270;901;94;332;84;301;178;633
431200;201805;394;1054;105;341;13;31;1;3;14;34
431205;201805;213;622;89;329;22;84;33;126;55;210
431210;201805;649;1711;522;1518;132;373;256;782;388;1155
431213;201805;235;701;181;603;16;60;97;324;113;384
431215;201805;353;1023;222;720;21;74;94;279;115;353
431217;201805;144;419;98;327;13;43;49;153;62;196
431220;201805;692;1889;398;1280;35;139;181;534;216;673
431225;201805;1412;3679;1084;3097;144;440;621;1781;765;2221
431230;201805;704;2101;529;1657;88;292;274;823;362;1115
431235;201805;141;382;27;83;6;16;3;8;9;24
431237;201805;391;1183;317;1051;57;218;155;494;212;712
431238;201805;28;79;23;65;6;19;6;13;12;32
431240;201805;3888;10458;3076;9114;695;2288;1277;3615;1972;5903
431242;201805;343;989;280;862;57;178;130;403;187;581
431244;201805;343;841;163;470;21;77;53;114;74;191
431245;201805;1313;3274;835;2352;126;395;380;1017;506;1412
431247;201805;222;639;113;378;19;67;25;73;44;140
431250;201805;1429;4232;1150;3779;255;820;513;1797;768;2617
431260;201805;258;748;144;510;16;78;46;150;62;228
431261;201805;265;853;214;747;28;102;83;270;111;372
431262;201805;414;1193;178;614;19;68;99;339;118;407
431265;201805;1365;3372;584;1752;94;320;168;411;262;731
431267;201805;282;788;158;474;6;23;104;286;110;309
431270;201805;2692;6448;1446;4281;389;1259;400;1188;789;2447
431275;201805;168;473;82;275;18;64;11;30;29;94
431280;201805;257;712;75;261;9;31;8;20;17;51
431290;201805;303;874;212;692;26;90;75;217;101;307
431295;201805;75;204;26;85;3;13;7;21;10;34
431300;201805;411;1047;58;200;4;16;11;32;15;48
431301;201805;242;728;57;202;6;15;3;8;9;23
431303;201805;594;1581;336;1023;44;157;123;350;167;507
431306;201805;2184;5318;1282;3756;177;588;466;1238;643;1826
431308;201805;26;89;24;82;13;47;6;19;19;66
431310;201805;608;1759;349;1126;58;197;119;387;177;584
431320;201805;646;1781;303;1034;57;199;42;139;99;338
431330;201805;1870;4623;923;2846;219;756;179;485;398;1241
431333;201805;345;937;124;382;14;36;36;110;50;146
431335;201805;35;100;21;70;6;16;3;4;9;20
431337;201805;2610;7300;1777;5769;510;1825;430;1307;940;3132
431339;201805;491;1299;335;993;76;233;155;457;231;690
431340;201805;20415;52631;14373;42102;2968;9483;4626;12834;7594;22317
431342;201805;478;1138;361;957;40;131;277;700;317;831
431344;201805;376;999;248;749;18;56;158;473;176;529
431346;201805;274;693;100;313;13;33;18;59;31;92
431349;201805;693;1920;382;1178;65;208;135;384;200;592
431350;201805;3935;10915;2955;9132;639;2126;1133;3451;1772;5577
431360;201805;611;1516;359;1062;71;218;148;416;219;634
431365;201805;1759;4735;1458;4259;157;506;1006;2940;1163;3446
431370;201805;4268;11374;3185;9476;787;2448;1287;3989;2074;6437
431380;201805;730;2153;633;1986;69;247;385;1200;454;1447
431390;201805;2434;6332;1403;4312;248;867;464;1260;712;2127
431395;201805;1284;3584;937;3011;225;747;356;1181;581;1928
431400;201805;395;1194;196;651;32;104;42;133;74;237
431402;201805;984;2344;648;1766;107;315;370;963;477;1278
431403;201805;163;460;135;412;15;63;85;234;100;297
431405;201805;4261;11634;3457;10401;439;1541;2068;6079;2507;7620
431406;201805;476;1469;383;1289;90;294;194;664;284;958
431407;201805;481;1350;317;1004;62;199;126;389;188;588
431410;201805;14689;40216;9534;30089;1908;6789;3173;9434;5081;16223
431413;201805;179;459;49;160;2;7;6;19;8;26
431415;201805;701;1812;428;1353;79;299;145;398;224;697
431417;201805;540;1317;393;1077;68;195;213;564;281;759
431420;201805;1287;3347;1066;2985;217;625;434;1282;651;1907
431430;201805;529;1417;286;900;58;205;60;152;118;357
431440;201805;22924;59149;17165;49553;4078;12546;5157;14950;9235;27496
431442;201805;107;305;59;194;9;32;6;11;15;43
431445;201805;475;1347;157;526;28;86;23;71;51;157
431446;201805;362;1054;241;784;69;232;64;196;133;428
431447;201805;598;1674;402;1260;90;284;171;538;261;822
431449;201805;711;1959;460;1390;58;192;212;626;270;818
431450;201805;2084;4666;1743;4216;140;365;1300;3033;1440;3398
431454;201805;40;121;38;117;5;17;15;55;20;72
431455;201805;625;1553;306;858;46;145;135;324;181;469
431460;201805;2880;7665;2221;6377;604;1797;689;2029;1293;3826
431470;201805;1544;4430;1130;3535;226;717;438;1384;664;2101
431475;201805;246;723;33;129;1;5;2;9;3;14
431477;201805;528;1369;311;910;46;128;144;388;190;516
431478;201805;280;728;70;211;17;55;6;16;23;71
431480;201805;3178;8214;2445;7049;380;1187;1364;3883;1744;5070
431490;201805;98292;251328;81166;225061;8019;25667;57255;154172;65274;179839
431500;201805;490;1319;370;1078;83;228;191;551;274;779
431505;201805;433;1051;269;774;25;69;149;424;174;493
431507;201805;348;829;146;417;33;109;53;127;86;236
431510;201805;1589;4345;1141;3451;233;738;438;1338;671;2076
431513;201805;300;724;149;425;14;36;93;264;107;300
431514;201805;87;247;46;162;9;39;16;49;25;88
431515;201805;567;1503;372;1113;76;249;173;483;249;732
431517;201805;77;229;57;173;9;23;13;36;22;59
431520;201805;441;1090;167;545;35;130;51;144;86;274
431530;201805;4024;9090;2454;6783;690;1957;352;997;1042;2954
431531;201805;199;559;136;429;17;54;54;159;71;213
431532;201805;480;1273;340;992;76;233;134;391;210;624
431535;201805;284;714;105;329;22;74;25;70;47;144
431540;201805;1837;6095;1703;5866;90;369;1313;4521;1403;4890
431545;201805;387;1038;72;222;5;21;20;51;25;72
431550;201805;1968;5475;1611;4780;327;1021;674;1903;1001;2924
431555;201805;683;1625;432;1187;43;125;250;672;293;797
431560;201805;19949;53865;13591;42908;2873;9677;3592;12138;6465;21815
431570;201805;5041;12416;3934;10890;647;1952;2286;6160;2933;8112
431575;201805;176;546;136;454;19;67;19;49;38;116
431580;201805;538;1437;280;907;41;162;109;327;150;489
431590;201805;774;2104;549;1633;105;315;197;584;302;899
431595;201805;362;1038;239;757;37;109;110;336;147;445
431600;201805;1540;3999;1117;3309;290;937;319;940;609;1877
431610;201805;1366;3749;963;2932;125;355;465;1472;590;1827
431620;201805;534;1458;233;700;50;147;101;281;151;428
431630;201805;1230;3287;602;1921;174;586;151;429;325;1015
431640;201805;5992;16014;5377;15120;776;2252;3628;10270;4404;12522
431642;201805;500;1300;323;938;34;99;155;427;189;526
431643;201805;350;905;156;455;23;61;42;112;65;173
431645;201805;1682;4406;1346;3845;160;494;895;2544;1055;3038
431647;201805;185;498;106;325;14;54;26;67;40;121
431650;201805;221;657;156;516;26;97;45;138;71;235
431660;201805;907;2481;503;1646;80;286;111;305;191;591
431670;201805;1190;2981;831;2349;143;459;391;1035;534;1494
431673;201805;248;667;93;343;16;47;11;34;27;81
431675;201805;696;1766;136;445;9;35;40;110;49;145
431680;201805;7656;20855;5733;17077;1508;4688;1987;5912;3495;10600
431690;201805;19754;53027;14359;43000;3578;11245;4497;13883;8075;25128
431695;201805;157;422;101;317;19;64;42;103;61;167
431697;201805;465;1176;370;1012;59;157;212;600;271;757
431700;201805;1420;3844;1212;3466;188;532;678;1929;866;2461
431710;201805;11390;30625;8850;26742;2336;7379;3273;10561;5609;17940
431720;201805;6164;16464;4072;12204;990;3131;712;1943;1702;5074
431725;201805;28;81;18;61;3;12;6;19;9;31
431730;201805;3514;9426;2508;7719;670;2251;733;2356;1403;4607
431740;201805;4800;12435;3387;9935;1024;3378;626;1565;1650;4943
431750;201805;7297;20254;6213;18526;1177;3791;3151;9499;4328;13290
431755;201805;343;935;70;249;11;45;11;39;22;84
431760;201805;5483;13081;3535;9855;415;1368;2065;5421;2480;6789
431770;201805;1809;4582;1446;4056;160;497;1000;2750;1160;3247
431775;201805;209;565;101;320;20;71;13;35;33;106
431780;201805;1922;5169;1336;4006;251;784;446;1299;697;2083
431790;201805;960;2718;698;2163;140;463;258;751;398;1214
431795;201805;268;707;142;432;30;91;35;101;65;192
431800;201805;7402;20280;5375;16656;1683;5718;630;2028;2313;7746
431805;201805;298;702;93;298;6;23;40;117;46;140
431810;201805;3241;8110;2048;5825;383;1213;835;2227;1218;3440
431820;201805;2208;6445;1843;5782;438;1420;728;2309;1166;3729
431830;201805;9384;21925;7100;18566;1640;4732;2736;7131;4376;11863
431840;201805;2428;6942;2007;6201;405;1293;1056;3269;1461;4562
431842;201805;718;1800;251;777;33;114;67;187;100;301
431843;201805;322;910;252;763;33;109;111;321;144;430
431844;201805;259;694;73;240;21;78;13;31;34;109
431845;201805;492;1340;341;1019;19;57;215;639;234;696
431846;201805;250;730;218;682;13;51;179;549;192;600
431848;201805;195;507;100;313;6;21;15;30;21;51
431849;201805;433;1039;62;183;8;26;5;11;13;37
431850;201805;4061;11586;3241;9845;731;2372;1005;2957;1736;5329
431860;201805;698;1805;443;1292;86;254;213;589;299;843
431861;201805;122;329;53;181;9;32;15;42;24;74
431862;201805;445;1462;364;1308;85;329;162;569;247;898
431870;201805;17222;47771;13865;41830;2489;8470;6479;18747;8968;27217
431880;201805;3649;10278;2882;8831;560;1919;1201;3529;1761;5448
431890;201805;4456;11871;2860;8706;844;2791;399;1267;1243;4058
431900;201805;1051;2814;631;1951;132;463;291;841;423;1304
431910;201805;798;1966;303;900;44;126;84;228;128;354
431912;201805;432;1273;359;1131;79;254;195;615;274;869
431915;201805;967;2670;772;2329;95;313;487;1426;582;1739
431920;201805;1186;3112;1006;2821;57;172;829;2307;886;2479
431930;201805;812;2393;583;1974;138;415;292;1056;430;1471
431935;201805;77;231;52;177;16;54;10;30;26;84
431936;201805;301;912;178;614;40;142;45;155;85;297
431937;201805;180;483;113;341;27;89;26;63;53;152
431940;201805;2264;5969;1421;4260;285;946;540;1521;825;2467
431950;201805;1690;4774;1413;4304;322;1004;649;1975;971;2979
431960;201805;2661;7200;2146;6183;565;1696;604;1694;1169;3390
431970;201805;393;1061;175;578;36;118;34;98;70;216
431971;201805;77;210;45;149;8;25;8;22;16;47
431973;201805;471;1527;387;1353;31;102;282;1007;313;1109
431975;201805;110;248;25;83;4;15;4;8;8;23
431980;201805;1135;3156;872;2669;189;609;360;1058;549;1667
431990;201805;5750;14850;3758;11693;680;2333;1243;3797;1923;6130
432000;201805;10175;26442;7657;22319;2082;6272;3035;8824;5117;15096
432010;201805;1944;5280;1505;4469;222;717;795;2252;1017;2969
432020;201805;1930;4732;1334;3740;327;980;608;1606;935;2586
432023;201805;512;1297;274;808;47;168;129;329;176;497
432026;201805;1002;2969;742;2423;174;552;352;1158;526;1710
432030;201805;336;921;207;638;37;117;104;309;141;426
432032;201805;442;1184;296;885;28;93;149;408;177;501
432035;201805;785;2309;687;2145;206;690;236;736;442;1426
432040;201805;1033;2473;428;1323;72;255;129;385;201;640
432045;201805;240;664;124;423;30;103;28;103;58;206
432050;201805;526;1418;411;1200;116;342;125;370;241;712
432055;201805;782;2088;497;1537;139;467;160;461;299;928
432057;201805;290;747;211;587;38;83;92;246;130;329
432060;201805;473;1186;146;487;26;104;52;147;78;251
432065;201805;219;619;163;491;38;116;55;163;93;279
432067;201805;783;2325;622;1962;87;284;376;1155;463;1439
432070;201805;2013;5427;1231;3787;266;878;243;676;509;1554
432080;201805;3662;9780;2966;8593;775;2515;1136;3147;1911;5662
432085;201805;387;995;246;771;81;238;86;291;167;529
432090;201805;1310;3616;962;2939;228;746;398;1171;626;1917
432100;201805;1107;3059;485;1616;79;291;36;78;115;369
432110;201805;2272;6461;1555;5046;359;1357;100;312;459;1669
432120;201805;3081;9005;2527;8013;795;2718;538;1664;1333;4382
432130;201805;2562;6979;2170;6427;794;2491;742;2215;1536;4706
432132;201805;264;734;127;427;25;90;44;138;69;228
432135;201805;896;2367;603;1783;70;231;396;1137;466;1368
432140;201805;1582;4969;1190;4173;220;799;584;2114;804;2913
432143;201805;1346;3779;1071;3330;126;444;627;1940;753;2384
432145;201805;1364;3915;817;2651;132;468;159;439;291;907
432146;201805;111;340;79;269;25;89;16;48;41;137
432147;201805;374;1230;303;1078;84;309;62;221;146;530
432149;201805;375;1007;224;662;26;79;100;280;126;359
432150;201805;3000;8315;2214;6794;551;1916;622;1838;1173;3754
432160;201805;4420;12953;3563;11517;1043;3583;1026;3279;2069;6862
432162;201805;339;798;45;133;5;12;6;18;11;30
432163;201805;209;566;41;132;3;11;2;5;5;16
432166;201805;547;1648;432;1393;74;261;135;386;209;647
432170;201805;1318;3772;851;2828;189;697;207;645;396;1342
432180;201805;2451;6454;1344;4159;277;936;357;992;634;1928
432183;201805;377;1150;243;824;67;249;52;168;119;417
432185;201805;857;2283;516;1603;35;118;294;871;329;989
432190;201805;2166;5764;1397;4223;342;1153;490;1354;832;2507
432195;201805;1033;2673;662;2004;199;558;191;617;390;1175
432200;201805;2996;8362;2189;6914;489;1617;942;3047;1431;4664
432210;201805;381;1055;258;823;48;166;101;306;149;472
432215;201805;674;2070;593;1930;77;243;390;1296;467;1539
432218;201805;250;648;133;378;18;52;51;132;69;184
432220;201805;3911;9803;2937;8202;432;1385;1665;4411;2097;5796
432225;201805;108;315;78;254;18;57;31;101;49;158
432230;201805;756;1980;427;1290;65;212;154;420;219;632
432232;201805;457;1181;337;974;62;203;158;453;220;656
432234;201805;309;826;140;430;32;92;23;61;55;153
432235;201805;107;307;39;133;5;19;9;28;14;47
432237;201805;384;1024;337;941;16;45;229;608;245;653
432240;201805;13442;38071;10636;33971;984;3575;6429;21447;7413;25022
432250;201805;4176;13762;3620;12640;1116;4033;1199;4323;2315;8356
432252;201805;447;1163;282;822;51;171;115;309;166;480
432253;201805;1179;3678;647;2257;149;575;32;100;181;675
432254;201805;964;2452;199;664;31;121;18;53;49;174
432255;201805;163;421;77;248;8;27;32;92;40;119
432260;201805;5546;14377;4010;11632;1058;3186;1204;3553;2262;6739
432270;201805;2061;6152;1697;5404;546;1849;244;755;790;2604
432280;201805;1175;3103;616;1935;91;310;214;641;305;951
432285;201805;184;576;15;56;1;4;1;1;2;5
432290;201805;397;1201;224;773;59;198;52;160;111;358
432300;201805;25038;67919;19726;59286;3018;9993;11379;33364;14397;43357
432310;201805;698;2022;527;1703;95;323;297;943;392;1266
432320;201805;232;566;77;230;10;39;20;53;30;92
432330;201805;268;687;90;302;21;66;15;51;36;117
432335;201805;176;501;64;239;15;63;9;29;24;92
432340;201805;329;793;152;460;26;92;48;131;74;223
432345;201805;574;1449;524;1383;37;132;402;1021;439;1153
432350;201805;341;925;168;560;31;101;51;156;82;257
432360;201805;212;633;40;137;5;26;8;25;13;51
432370;201805;336;901;226;680;21;72;139;408;160;480
432375;201805;539;1403;414;1176;58;158;234;660;292;818
432377;201805;238;765;37;129;5;16;8;20;13;36
432380;201805;1436;4174;895;3018;190;719;382;1213;572;1932
500020;201805;2123;5901;1630;5090;390;1337;679;2040;1069;3377
500025;201805;1283;2990;786;2142;71;193;463;1241;534;1434
500060;201805;6294;18550;4795;15862;714;2392;2768;9622;3482;12014
500070;201805;4112;11272;3007;9322;637;2036;1229;4001;1866;6037
500080;201805;1127;3240;828;2690;202;725;325;1014;527;1739
500085;201805;2037;5097;1383;4095;252;806;713;2045;965;2851
500090;201805;1962;5480;1344;4349;246;830;510;1721;756;2551
500100;201805;3350;8929;2560;7594;362;1185;1221;3444;1583;4629
500110;201805;7254;20262;5007;16594;1040;3689;1654;6168;2694;9857
500124;201805;1942;6197;1662;5713;370;1241;857;3173;1227;4414
500150;201805;1287;3082;806;2315;177;540;259;670;436;1210
500190;201805;4705;11645;3454;9964;685;2079;1594;4763;2279;6842
500200;201805;2218;5490;1658;4505;223;653;928;2374;1151;3027
500210;201805;4522;12575;3494;11028;887;2869;1489;4800;2376;7669
500215;201805;1269;3780;940;3136;108;401;465;1503;573;1904
500220;201805;2818;8135;2093;6842;351;1239;815;2654;1166;3893
500230;201805;2336;5785;1687;4776;227;668;975;2722;1202;3390
500240;201805;3530;11209;2480;8908;450;1869;641;2398;1091;4267
500260;201805;3114;6971;1901;5211;228;623;969;2599;1197;3222
500270;201805;118651;299325;71302;212813;14791;47283;19722;56646;34513;103929
500280;201805;1303;3363;951;2824;111;365;587;1702;698;2067
500290;201805;3931;9039;2180;6381;342;1090;751;2077;1093;3167
500295;201805;2856;7540;1627;5019;262;887;542;1451;804;2338
500310;201805;917;2141;661;1799;116;279;348;1000;464;1279
500315;201805;3311;9939;2686;8903;345;1124;1706;5905;2051;7029
500320;201805;17850;53430;12937;44524;3480;12816;3714;13547;7194;26363
500325;201805;3811;9335;2607;7509;328;1006;1472;4246;1800;5252
500330;201805;6839;16551;4399;12518;406;1290;2292;6647;2698;7937
500345;201805;1882;4746;1295;3859;343;1034;439;1295;782;2329
500348;201805;2697;7013;2093;6032;245;745;1249;3642;1494;4387
500350;201805;1238;3520;643;2136;80;291;218;743;298;1034
500370;201805;21170;59441;14757;48085;2630;9692;5961;19390;8591;29082
500375;201805;2457;6867;1740;5322;364;1221;541;1605;905;2826
500380;201805;3515;8950;2483;7277;653;1999;875;2609;1528;4608
500390;201805;512;1118;308;823;42;123;155;400;197;523
500400;201805;1140;3263;799;2508;181;603;219;656;400;1259
500410;201805;2280;6178;1740;5320;266;793;1004;3157;1270;3950
500430;201805;2573;6815;1758;5531;308;1081;663;2212;971;3293
500440;201805;1269;3095;760;2237;116;343;275;854;391;1197
500450;201805;1311;3453;726;2322;140;452;116;329;256;781
500460;201805;3804;10726;2433;7982;493;1784;549;1845;1042;3629
500470;201805;2510;7071;1609;5138;469;1628;302;824;771;2452
500480;201805;2153;6408;1908;6085;139;428;1431;4850;1570;5278
500490;201805;874;2257;549;1728;139;500;167;528;306;1028
500500;201805;4053;11275;2808;9378;947;3621;655;2257;1602;5878
500510;201805;744;1904;460;1376;31;110;266;750;297;860
500515;201805;1963;4938;1603;4428;130;345;1146;3262;1276;3607
500520;201805;3136;10648;2590;9527;659;2636;1069;3904;1728;6540
500525;201805;952;2950;770;2653;113;447;401;1412;514;1859
500540;201805;4845;12832;2803;9130;744;2846;270;840;1014;3686
500560;201805;5169;15521;4336;14322;322;1148;3260;10942;3582;12090
500568;201805;4205;9700;2580;7272;605;1943;729;2009;1334;3952
500570;201805;7196;17874;4119;12296;962;3105;818;2281;1780;5386
500580;201805;3189;8923;2475;7692;428;1393;1366;4209;1794;5602
500600;201805;3323;8531;2165;6598;454;1498;721;2188;1175;3686
500620;201805;7558;20943;5187;16271;984;3250;2059;6448;3043;9698
500625;201805;493;1406;270;900;58;218;93;295;151;513
500627;201805;743;1973;456;1429;84;259;111;353;195;612
500630;201805;5973;15184;3726;11288;855;2754;1035;3192;1890;5946
500635;201805;2573;9079;2072;8305;169;696;1476;6329;1645;7025
500640;201805;1714;3989;1139;3145;50;168;788;2102;838;2270
500660;201805;17338;49107;12498;41225;4125;15058;2722;9141;6847;24199
500690;201805;2319;6655;1641;5533;708;2660;122;363;830;3023
500710;201805;3072;8829;2365;7495;638;2137;634;1968;1272;4105
500720;201805;5336;13656;3191;10060;849;2945;637;1972;1486;4917
500730;201805;912;2469;584;1839;98;297;211;684;309;981
500740;201805;4660;11743;3401;9537;316;1013;1848;5235;2164;6248
500750;201805;964;2576;720;2138;103;345;318;879;421;1224
500755;201805;990;2800;611;2047;120;424;82;237;202;661
500769;201805;5202;13401;2655;8176;478;1629;388;896;866;2525
500770;201805;1601;4431;1002;3277;175;608;311;1017;486;1625
500780;201805;1282;3341;849;2544;197;609;203;580;400;1189
500790;201805;8385;22346;6747;19727;1253;3935;3623;10699;4876;14634
500793;201805;1928;5269;1352;4257;451;1464;214;597;665;2061
500795;201805;2409;6633;1992;6072;164;443;1564;5012;1728;5455
500797;201805;737;2010;502;1551;113;362;166;493;279;855
500800;201805;2815;7012;1934;5683;651;2153;318;987;969;3140
500830;201805;18304;47395;12569;36720;1951;6197;5653;15818;7604;22015
500840;201805;1139;3086;743;2301;92;303;299;863;391;1166
510010;201805;1546;4029;1102;3363;212;622;595;1877;807;2499
510020;201805;3697;9769;1956;6153;416;1370;357;990;773;2360
510025;201805;6974;19099;4443;14237;801;2831;1283;3867;2084;6698
510030;201805;2058;4865;1403;3927;338;943;507;1500;845;2443
510035;201805;1123;2967;693;2275;109;352;386;1360;495;1712
510040;201805;2150;5114;1542;4247;134;373;949;2624;1083;2997
510050;201805;1870;4785;1270;3809;285;965;631;1749;916;2714
510060;201805;1420;3758;1039;3124;154;493;502;1464;656;1957
510080;201805;1146;3315;805;2678;223;808;195;579;418;1387
510100;201805;690;1707;451;1268;62;187;209;558;271;745
510120;201805;287;557;169;414;8;23;119;289;127;312
510125;201805;2420;6126;1825;5190;280;1004;768;2003;1048;3007
510130;201805;1496;4003;1118;3363;273;863;305;919;578;1782
510140;201805;2902;8349;2110;7278;788;3075;642;2029;1430;5104
510160;201805;1332;4109;1124;3817;213;743;725;2484;938;3227
510170;201805;4589;13036;3472;11165;798;2699;1440;4600;2238;7299
510180;201805;12750;31482;7972;23648;2022;6481;2251;7437;4273;13918
510185;201805;1763;4702;1190;3871;407;1329;430;1685;837;3014
510190;201805;2344;6453;1562;5215;472;1750;456;1559;928;3309
510250;201805;13971;39026;11726;35841;2551;8153;6169;19551;8720;27704
510260;201805;2109;8669;1701;7873;264;1243;987;5116;1251;6359
510263;201805;3248;9209;2088;6918;438;1560;280;883;718;2443
510267;201805;5030;14809;3197;10675;695;2443;579;1958;1274;4401
510268;201805;1410;3677;957;2842;136;411;512;1474;648;1885
510269;201805;1102;3186;706;2386;200;739;199;631;399;1370
510270;201805;2815;8775;2114;7433;435;1599;749;2599;1184;4198
510279;201805;1775;5072;1308;4169;253;882;623;1905;876;2787
510285;201805;1127;3153;816;2614;233;810;208;627;441;1437
510300;201805;3539;9411;2732;8308;300;877;1792;5681;2092;6558
510305;201805;1347;4063;940;3253;205;741;276;1023;481;1764
510310;201805;798;2165;584;1797;197;614;182;598;379;1212
510320;201805;3772;10124;2797;8394;649;2121;757;2249;1406;4370
510325;201805;4662;14247;3737;12793;1021;3624;1679;5995;2700;9619
510330;201805;2897;9019;2058;7486;447;1710;706;2866;1153;4576
510335;201805;4792;13989;3627;12380;433;1579;2106;7614;2539;9193
510336;201805;530;1554;385;1301;69;223;176;637;245;860
510337;201805;1739;5359;1227;4416;481;1848;201;742;682;2590
510340;201805;77001;189041;49427;145508;14953;50476;10224;28254;25177;78730
510343;201805;1024;2967;707;2320;139;484;228;717;367;1201
510345;201805;1353;4015;1011;3334;181;599;413;1339;594;1938
510350;201805;2859;7738;1902;6155;456;1548;713;2363;1169;3911
510360;201805;1768;4038;1145;3240;60;212;843;2409;903;2621
510370;201805;1659;5165;1241;4417;209;802;664;2447;873;3249
510380;201805;503;1373;269;904;73;270;32;100;105;370
510385;201805;1005;3680;732;3083;83;390;419;1880;502;2270
510390;201805;1079;3370;857;3035;227;792;390;1513;617;2305
510395;201805;742;1739;494;1366;44;124;262;773;306;897
510410;201805;4102;12478;3191;10748;781;2684;1495;5287;2276;7971
510420;201805;2170;5098;1552;4201;175;552;865;2311;1040;2863
510450;201805;580;1492;345;1053;81;258;57;178;138;436
510452;201805;671;2008;462;1572;85;287;215;735;300;1022
510454;201805;824;2425;623;2061;69;226;360;1245;429;1471
510455;201805;926;2747;665;2166;108;407;250;738;358;1145
510460;201805;2041;5242;1459;4379;154;540;836;2380;990;2920
510480;201805;4282;10759;2937;8259;488;1464;1260;3378;1748;4842
510490;201805;1545;4615;1229;4168;265;911;612;2104;877;3015
510500;201805;1422;3975;905;3002;155;601;357;1162;512;1763
510510;201805;3136;10032;2444;8635;794;3072;551;2078;1345;5150
510515;201805;5772;15971;3736;11961;837;2918;922;2694;1759;5612
510517;201805;1304;3811;1012;3271;277;982;164;469;441;1451
510520;201805;2068;4405;1298;3446;50;140;776;2187;826;2327
510523;201805;959;2620;758;2273;112;326;462;1404;574;1730
510525;201805;5322;15696;4083;13152;742;2609;1577;4638;2319;7247
510530;201805;541;1399;399;1192;24;109;276;782;300;891
510550;201805;2770;8589;2023;7178;499;1822;704;2548;1203;4370
510558;201805;1959;5495;1582;4945;141;481;879;2948;1020;3429
510560;201805;1619;4823;955;3533;217;878;226;883;443;1761
510562;201805;5327;14767;3838;11926;897;3001;1269;4037;2166;7038
510590;201805;3153;8048;2298;6917;427;1231;1337;4242;1764;5473
510600;201805;1538;3744;944;2767;225;652;323;966;548;1618
510610;201805;2572;6768;1890;5814;179;634;1173;3538;1352;4172
510615;201805;2000;5712;1514;4855;305;994;797;2623;1102;3617
510617;201805;907;2657;700;2327;91;277;482;1711;573;1988
510618;201805;1320;3680;938;2950;186;684;444;1311;630;1995
510619;201805;751;2009;422;1398;73;269;75;237;148;506
510620;201805;1486;3453;707;2194;151;531;91;251;242;782
510621;201805;1231;3563;844;2813;183;648;237;787;420;1435
510622;201805;3917;11660;2823;9156;951;3390;497;1461;1448;4851
510623;201805;2907;7752;2114;6423;434;1561;627;1829;1061;3390
510624;201805;1595;4314;711;2460;102;402;97;275;199;677
510625;201805;2229;5798;1347;4173;314;1107;247;761;561;1868
510626;201805;1596;3937;969;2989;276;950;207;666;483;1616
510627;201805;646;1721;386;1198;93;296;88;287;181;583
510628;201805;1601;3690;1043;2933;173;466;620;1826;793;2292
510629;201805;1609;4996;1245;4231;305;1100;396;1389;701;2489
510630;201805;3072;9260;1898;6891;443;1758;298;1151;741;2909
510631;201805;469;1212;342;1014;16;39;237;715;253;754
510637;201805;3141;8229;2350;6934;682;2232;673;1919;1355;4151
510642;201805;4966;15312;3988;13820;1112;4156;1533;5526;2645;9682
510645;201805;923;2027;537;1507;154;431;154;437;308;868
510650;201805;6523;19101;5538;17966;829;2706;3962;13423;4791;16129
510665;201805;1876;4509;1091;3137;209;651;379;1124;588;1775
510670;201805;393;844;215;591;25;88;111;308;136;396
510675;201805;6112;17819;4461;14700;1266;4559;795;2556;2061;7115
510677;201805;2105;5574;1501;4669;223;737;786;2435;1009;3172
510680;201805;666;1902;444;1466;93;307;60;198;153;505
510682;201805;1721;5491;1275;4648;382;1504;256;945;638;2449
510685;201805;767;2210;581;1845;81;259;270;820;351;1079
510700;201805;3588;9475;2507;7835;503;1659;1335;4269;1838;5928
510704;201805;10014;25402;6668;19373;1308;4091;2144;5996;3452;10087
510706;201805;1872;5632;1281;4684;251;1032;624;2405;875;3437
510710;201805;2644;7140;1814;5490;365;1137;619;1779;984;2916
510715;201805;731;1743;501;1371;61;165;205;565;266;730
510718;201805;2581;5693;1410;4283;573;1787;234;973;807;2760
510719;201805;391;868;241;664;40;124;133;351;173;475
510720;201805;1006;2566;674;2019;186;602;164;464;350;1066
510724;201805;716;2030;501;1641;92;341;222;677;314;1018
510726;201805;882;1789;510;1272;74;188;285;711;359;899
510729;201805;661;1607;313;948;50;173;69;202;119;375
510730;201805;3054;7954;2088;6320;480;1542;733;2214;1213;3756
510735;201805;1011;3042;764;2692;85;331;510;1826;595;2157
510740;201805;1247;3364;887;2767;99;277;544;1837;643;2114
510757;201805;627;2048;509;1828;208;787;155;542;363;1329
510760;201805;35995;83642;21590;61628;6086;19580;4611;12029;10697;31609
510770;201805;4109;9819;3062;8576;281;712;2091;6191;2372;6903
510774;201805;367;1024;273;836;49;130;133;437;182;567
510775;201805;615;2134;445;1841;83;329;116;722;199;1051
510776;201805;441;1244;325;994;76;248;128;374;204;622
510777;201805;1688;4649;1206;3985;126;469;872;2881;998;3350
510779;201805;593;1704;469;1500;59;160;283;956;342;1116
510780;201805;3466;9861;2721;8665;689;2223;1061;3718;1750;5941
510785;201805;2059;5515;1203;3917;292;1061;171;567;463;1628
510787;201805;2436;7015;1730;5648;711;2414;152;475;863;2889
510788;201805;694;1687;480;1358;87;244;175;591;262;835
510790;201805;14560;40380;9170;29744;2059;7619;1238;3486;3297;11105
510792;201805;8798;24190;5615;18169;1129;3968;1205;3786;2334;7754
510794;201805;1230;3547;826;2779;252;931;173;519;425;1450
510795;201805;7280;20818;5161;16867;1338;4797;1114;3662;2452;8459
510800;201805;1567;4205;1116;3497;253;823;408;1228;661;2051
510805;201805;1808;4976;1207;3856;237;815;445;1288;682;2103
510810;201805;670;1497;448;1190;115;327;213;539;328;866
510820;201805;831;1673;453;1183;54;174;196;489;250;663
510830;201805;740;1965;536;1669;94;284;292;960;386;1244
510835;201805;582;1558;401;1258;55;185;191;577;246;762
510840;201805;41683;100885;31693;87760;6581;17819;16053;47209;22634;65028
510850;201805;1809;4579;1045;3294;319;1128;143;371;462;1499
510860;201805;2681;7625;1757;5961;561;2158;174;571;735;2729
510880;201805;615;1904;489;1664;129;467;212;737;341;1204
510885;201805;592;1574;413;1310;70;244;138;420;208;664
510890;201805;708;2138;568;1929;127;463;267;923;394;1386
510895;201805;1194;3279;831;2629;212;754;292;846;504;1600
520005;201805;1984;5596;1605;5108;456;1336;721;2622;1177;3958
520010;201805;2205;6785;1563;5426;467;1805;303;916;770;2721
520013;201805;2704;7475;1949;5968;464;1498;510;1643;974;3141
520015;201805;535;1419;400;1229;114;366;105;361;219;727
520017;201805;1114;3092;858;2681;177;597;432;1324;609;1921
520020;201805;383;965;302;852;66;211;162;434;228;645
520025;201805;31882;92146;28125;87160;3400;11153;19793;61335;23193;72488
520030;201805;5052;14222;4026;12576;507;1717;2372;7408;2879;9125
520050;201805;449;1096;273;763;20;47;153;454;173;501
520055;201805;1015;2845;789;2400;71;220;466;1405;537;1625
520060;201805;1438;4237;1119;3626;268;946;301;954;569;1900
520080;201805;1889;5067;1465;4479;250;755;686;2299;936;3054
520082;201805;1043;2625;874;2336;106;225;496;1388;602;1613
520085;201805;699;2037;562;1801;120;363;173;542;293;905
520090;201805;868;1878;615;1577;98;221;393;1069;491;1290
520110;201805;39021;109332;27998;91324;9446;34895;1816;5357;11262;40252
520120;201805;199;505;110;342;12;46;38;114;50;160
520130;201805;3652;9633;3059;8661;604;1812;1485;4299;2089;6111
520140;201805;35588;105458;27779;91266;9883;35223;2968;9973;12851;45196
520145;201805;476;1228;334;1000;66;210;129;365;195;575
520150;201805;564;1416;437;1253;77;216;235;685;312;901
520160;201805;867;2121;628;1756;102;288;278;783;380;1071
520170;201805;5148;10823;3733;9221;220;565;3071;7642;3291;8207
520180;201805;2040;5830;1681;5257;424;1424;701;2155;1125;3579
520215;201805;2009;4931;1455;4041;304;928;639;1729;943;2657
520235;201805;639;1561;421;1217;51;161;160;437;211;598
520250;201805;1578;4143;1122;3435;295;989;215;684;510;1673
520260;201805;850;2065;514;1468;84;255;197;555;281;810
520280;201805;649;1743;514;1493;150;422;194;621;344;1043
520310;201805;1263;2906;832;2246;211;583;304;878;515;1461
520320;201805;1893;5408;1492;4719;162;539;804;2590;966;3129
520330;201805;3268;9554;2358;7956;473;1811;915;3065;1388;4876
520340;201805;2221;5218;1522;4223;154;381;1006;2918;1160;3299
520350;201805;3072;7876;2229;6407;678;2086;686;1884;1364;3970
520355;201805;1756;4967;1354;4229;330;1135;520;1575;850;2710
520357;201805;828;2093;646;1812;32;98;464;1311;496;1409
520360;201805;720;1951;550;1651;164;499;141;449;305;948
520380;201805;1333;3459;798;2408;98;337;382;1064;480;1401
520390;201805;952;2185;552;1659;173;562;132;405;305;967
520393;201805;557;1347;390;1082;47;142;187;485;234;627
520396;201805;801;2295;673;2055;92;287;433;1302;525;1589
520400;201805;1608;4261;1284;3792;221;674;775;2308;996;2982
520410;201805;1652;3708;1057;2859;134;374;618;1659;752;2033
520420;201805;381;971;282;774;24;76;199;513;223;589
520425;201805;1433;3533;956;2725;249;723;372;1071;621;1794
520430;201805;2206;5371;1156;3589;206;738;53;149;259;887
520440;201805;3409;8466;2141;6198;553;1708;517;1448;1070;3156
520450;201805;11511;29587;7701;23215;2358;7713;552;1715;2910;9428
520455;201805;682;1930;506;1646;159;542;124;398;283;940
520460;201805;924;2482;783;2281;104;283;580;1722;684;2005
520465;201805;847;2282;698;2047;111;356;434;1218;545;1574
520470;201805;1910;5607;1629;5222;384;1210;934;3213;1318;4423
520480;201805;841;2434;545;1882;141;515;96;333;237;848
520485;201805;1556;4390;1279;4013;130;450;890;2749;1020;3199
520490;201805;3870;11299;2992;9926;831;2759;1329;4586;2160;7345
520495;201805;1464;3510;1153;3097;79;219;864;2379;943;2598
520500;201805;1410;3831;1011;3109;240;831;372;1122;612;1953
520505;201805;727;1816;524;1534;98;280;271;784;369;1064
520510;201805;6976;18875;5012;15849;1164;4062;1263;4149;2427;8211
520520;201805;1086;2865;809;2442;237;692;216;749;453;1441
520530;201805;1998;6204;1495;5286;531;1907;348;1448;879;3355
520540;201805;2948;7939;1845;5719;427;1365;362;1156;789;2521
520545;201805;1002;2768;763;2367;130;416;271;836;401;1252
520547;201805;750;2217;586;1893;163;541;229;724;392;1265
520549;201805;11070;31824;9015;28518;1957;6324;4672;15061;6629;21385
520551;201805;4202;12067;3612;11191;510;1826;2408;7296;2918;9122
520552;201805;772;2189;692;2088;104;286;493;1557;597;1843
520570;201805;646;1611;431;1271;112;342;141;424;253;766
520580;201805;2848;6471;1985;5371;214;615;1275;3469;1489;4084
520590;201805;1317;3693;947;3000;239;778;159;523;398;1301
520620;201805;8218;22792;6646;20563;1735;5545;2889;9102;4624;14647
520630;201805;996;2510;620;1871;104;315;164;479;268;794
520640;201805;2595;6696;2007;5688;495;1414;756;2211;1251;3625
520650;201805;919;2291;633;1804;111;318;333;964;444;1282
520660;201805;438;1073;240;727;55;181;43;145;98;326
520670;201805;968;2772;811;2545;80;271;564;1726;644;1997
520680;201805;753;1931;549;1604;102;286;261;787;363;1073
520690;201805;376;893;246;701;72;207;75;230;147;437
520710;201805;562;1389;360;1026;14;42;220;605;234;647
520725;201805;1644;4006;1159;3203;131;404;741;1985;872;2389
520735;201805;820;2125;560;1653;110;324;178;539;288;863
520740;201805;1928;4705;1524;4194;246;656;936;2655;1182;3311
520750;201805;682;1704;500;1434;93;247;226;682;319;929
520753;201805;1474;3872;1192;3358;199;577;557;1535;756;2112
520760;201805;1204;2676;1066;2501;92;187;865;2122;957;2309
520780;201805;1693;4167;1255;3523;133;394;665;1816;798;2210
520790;201805;3329;8039;2348;6548;210;574;1480;4364;1690;4938
520800;201805;15445;41498;12522;37577;2420;7225;7302;23065;9722;30290
520810;201805;1293;2825;932;2414;160;450;527;1421;687;1871
520815;201805;650;1975;472;1599;130;474;71;266;201;740
520830;201805;1781;4145;1313;3599;72;141;1031;2840;1103;2981
520840;201805;2229;6287;1819;5726;766;2517;478;1611;1244;4128
520850;201805;680;1869;466;1527;157;579;96;311;253;890
520860;201805;6212;17813;4799;15500;1147;3990;1647;5406;2794;9396
520870;201805;90817;226102;63840;184841;17575;55040;16574;46791;34149;101831
520880;201805;6217;18059;4906;15897;1516;5230;1241;4001;2757;9231
520890;201805;3923;10154;2810;8323;610;2016;1142;3284;1752;5300
520910;201805;4131;10872;2706;8375;787;2669;481;1502;1268;4171
520915;201805;641;1842;457;1460;73;265;171;523;244;788
520920;201805;4235;10302;2857;8356;428;1360;1417;4170;1845;5530
520929;201805;684;1761;518;1467;114;275;237;751;351;1026
520940;201805;1130;3049;880;2694;59;200;657;2008;716;2208
520945;201805;540;1248;415;1041;28;58;286;706;314;764
520960;201805;1035;2787;812;2411;125;406;443;1265;568;1671
520970;201805;2467;7339;2060;6591;572;2002;490;1607;1062;3609
520980;201805;775;2067;612;1812;134;443;242;680;376;1123
520990;201805;2929;8945;2590;8398;374;1237;1545;5161;1919;6398
520993;201805;993;2430;675;1902;31;90;489;1364;520;1454
520995;201805;2226;5880;1802;5298;441;1261;764;2311;1205;3572
521000;201805;7895;22175;5828;18319;1513;4990;1519;4745;3032;9735
521010;201805;3938;10498;2949;8779;381;1099;1560;4662;1941;5761
521015;201805;666;1745;557;1569;70;203;382;1060;452;1263
521020;201805;2912;7908;1792;5640;492;1656;181;570;673;2226
521030;201805;598;1423;423;1152;50;110;208;613;258;723
521040;201805;7403;18578;5597;15771;1509;4470;2104;6100;3613;10570
521056;201805;854;2388;665;2084;214;692;176;606;390;1298
521060;201805;1093;2796;815;2346;65;202;424;1237;489;1439
521080;201805;1104;2587;583;1702;84;259;179;439;263;698
521090;201805;3122;8241;2286;6878;660;2158;387;1187;1047;3345
521100;201805;1828;4294;1331;3590;268;699;687;1913;955;2612
521120;201805;4937;11647;3440;9757;390;1065;1599;5154;1989;6219
521130;201805;1006;2511;677;1889;42;146;387;1069;429;1215
521140;201805;1205;3246;891;2692;152;487;347;1037;499;1524
521150;201805;11754;27311;7611;21190;1855;5770;2861;8150;4716;13920
521160;201805;710;1596;469;1223;80;221;234;579;314;800
521170;201805;1128;2717;800;2212;82;228;502;1336;584;1564
521180;201805;6462;19471;5403;17492;1120;3894;2156;6823;3276;10717
521190;201805;10267;27266;5985;19463;1461;5111;1035;3523;2496;8634
521200;201805;769;1984;546;1595;68;208;279;805;347;1013
521205;201805;600;1578;454;1340;27;74;325;947;352;1021
521210;201805;764;2050;430;1330;97;332;57;125;154;457
521220;201805;4226;10365;2894;8357;599;1854;968;2688;1567;4542
521225;201805;356;837;281;752;28;58;199;563;227;621
521230;201805;1410;4369;1314;4218;438;1298;705;2452;1143;3750
521250;201805;31403;89472;25369;80668;10168;33431;7162;24500;17330;57931
521260;201805;630;1505;471;1261;76;218;264;698;340;916
521270;201805;1843;4821;1590;4519;113;262;1228;3592;1341;3854
521280;201805;1928;5396;1452;4540;424;1426;453;1435;877;2861
521290;201805;471;1240;352;1071;61;216;198;581;259;797
521295;201805;1197;2678;942;2369;98;224;687;1815;785;2039
521300;201805;1937;5002;1558;4476;266;710;994;2993;1260;3703
521305;201805;738;1930;545;1601;82;235;285;840;367;1075
521308;201805;4581;12930;3388;10555;587;1855;1683;5243;2270;7098
521310;201805;8419;22786;5559;17479;1393;4643;1517;4653;2910;9296
521340;201805;396;969;309;835;22;56;236;636;258;692
521350;201805;2101;5473;1632;4754;198;641;1070;3025;1268;3666
521370;201805;1138;3017;705;2237;181;656;110;348;291;1004
521375;201805;1477;3893;1082;3326;260;840;402;1295;662;2135
521377;201805;1336;3045;1052;2690;54;136;900;2316;954;2452
521380;201805;6209;16914;4207;13214;474;1541;1026;3400;1500;4941
521385;201805;620;1543;487;1374;110;309;226;694;336;1003
521390;201805;724;1882;534;1594;167;539;170;530;337;1069
521400;201805;2378;5718;1879;5143;219;660;1364;3766;1583;4426
521405;201805;1327;3507;999;2943;217;642;440;1322;657;1964
521410;201805;765;2103;621;1894;127;369;315;1037;442;1406
521440;201805;1412;3816;1049;3160;286;914;253;742;539;1656
521450;201805;3894;12054;2974;10152;739;2566;742;2651;1481;5217
521460;201805;6311;17314;4764;14528;1555;5041;1195;3493;2750;8534
521470;201805;655;1853;391;1250;63;195;102;298;165;493
521480;201805;380;1037;217;705;44;151;51;151;95;302
521483;201805;2524;6331;1804;5123;462;1377;537;1480;999;2857
521486;201805;1698;4105;1308;3570;79;223;982;2652;1061;2875
521487;201805;488;1233;337;1004;66;206;134;406;200;612
521490;201805;843;2337;645;1994;38;153;447;1342;485;1495
521500;201805;1677;4404;1182;3587;111;401;749;2193;860;2594
521520;201805;835;1915;568;1516;94;255;234;647;328;902
521523;201805;11405;38310;10031;35881;3602;13763;2437;9054;6039;22817
521525;201805;1063;2546;820;2194;84;219;549;1455;633;1674
521530;201805;2196;5767;1297;3939;272;872;311;994;583;1866
521540;201805;864;2248;563;1725;98;370;238;720;336;1090
521550;201805;1414;3627;845;2483;165;525;277;857;442;1382
521560;201805;3808;11080;2785;9683;648;2598;1296;4693;1944;7291
521565;201805;603;1533;490;1376;75;204;316;866;391;1070
521570;201805;4094;10993;2658;8258;546;1862;345;1104;891;2966
521580;201805;540;1338;303;917;48;157;59;156;107;313
521590;201805;613;1610;471;1372;130;420;178;488;308;908
521600;201805;417;1190;262;833;54;162;55;178;109;340
521630;201805;1562;3637;945;2694;198;617;285;783;483;1400
521640;201805;2129;5108;1528;4237;349;982;577;1607;926;2589
521645;201805;575;1596;376;1218;78;258;102;331;180;589
521680;201805;1175;3706;943;3216;292;1046;107;401;399;1447
521690;201805;442;1253;398;1178;88;267;208;603;296;870
521710;201805;3080;8336;2148;6682;406;1349;432;1304;838;2653
521720;201805;2069;5445;1549;4548;217;675;831;2363;1048;3038
521730;201805;3769;11409;3005;9951;1010;3683;489;1353;1499;5036
521740;201805;3927;10746;3055;9409;876;2921;1008;3272;1884;6193
521760;201805;14089;42522;11681;38596;3426;12359;3760;12885;7186;25244
521770;201805;2848;7525;2035;6068;647;2068;452;1308;1099;3376
521800;201805;6150;17711;4979;15751;1438;4727;1559;5339;2997;10066
521805;201805;686;1554;465;1257;158;398;174;504;332;902
521810;201805;743;1759;507;1405;88;258;232;658;320;916
521830;201805;5241;15355;4334;14003;457;1676;2853;9078;3310;10754
521839;201805;705;1854;503;1482;99;298;184;527;283;825
521850;201805;5632;14669;4007;11996;991;3212;563;1568;1554;4780
521860;201805;1862;4879;1322;3980;222;731;438;1296;660;2027
521870;201805;651;1914;464;1567;109;380;131;416;240;796
521878;201805;716;1964;502;1549;86;297;195;547;281;844
521880;201805;19260;48009;13025;38344;3438;10576;3966;12132;7404;22708
521890;201805;3196;8969;2184;6919;538;1832;260;744;798;2576
521900;201805;1643;3995;1002;3012;241;701;266;827;507;1528
521910;201805;1204;2780;822;2328;80;244;490;1444;570;1688
521920;201805;402;1199;304;987;64;226;94;326;158;552
521925;201805;675;1940;507;1631;120;381;151;484;271;865
521930;201805;4398;11914;3297;10203;958;2927;1022;3397;1980;6324
521935;201805;756;1983;567;1637;96;279;291;807;387;1086
521940;201805;1279;3030;883;2490;218;703;355;958;573;1661
521945;201805;588;1729;480;1527;84;270;219;737;303;1007
521950;201805;620;1528;489;1363;30;90;391;1091;421;1181
521960;201805;717;2007;475;1507;71;247;216;653;287;900
521970;201805;2630;6832;2200;6327;128;326;1795;5327;1923;5653
521971;201805;879;2278;599;1810;144;465;131;376;275;841
521973;201805;1079;3053;890;2768;100;360;546;1661;646;2021
521975;201805;12447;33484;10587;30998;1783;5395;6530;19169;8313;24564
521980;201805;2497;6300;2000;5641;209;529;1466;4197;1675;4726
521990;201805;1169;3283;936;2906;124;384;513;1645;637;2029
522000;201805;3765;12490;3131;11668;247;819;2252;9033;2499;9852
522005;201805;329;831;243;705;62;168;95;292;157;460
522010;201805;3777;9818;2828;8273;830;2571;718;2021;1548;4592
522015;201805;969;2647;710;2231;148;488;265;827;413;1315
522020;201805;5355;13282;3649;10481;859;2578;1512;4405;2371;6983
522026;201805;671;1913;522;1672;91;305;238;782;329;1087
522028;201805;519;1408;373;1095;85;245;139;385;224;630
522040;201805;2822;6463;1997;5388;266;746;1355;3679;1621;4425
522045;201805;16444;49604;12601;42015;3100;11062;2671;8639;5771;19701
522050;201805;1127;3090;762;2417;165;547;250;752;415;1299
522060;201805;2546;7148;2035;6364;299;970;1131;3672;1430;4642
522068;201805;1720;4901;1420;4529;172;515;995;3286;1167;3801
522070;201805;614;1692;513;1534;45;184;357;1018;402;1202
522100;201805;585;1601;429;1361;70;239;228;726;298;965
522108;201805;898;2535;701;2216;42;170;551;1697;593;1867
522119;201805;1589;4250;1233;3757;204;644;640;2013;844;2657
522130;201805;390;989;280;841;64;210;139;424;203;634
522140;201805;16097;44634;11950;37196;3592;11811;1930;5960;5522;17771
522145;201805;849;2152;629;1831;146;380;321;1024;467;1404
522150;201805;951;2347;718;2007;219;594;238;699;457;1293
522155;201805;940;2528;740;2191;157;442;345;1068;502;1510
522157;201805;563;1517;480;1401;27;109;358;1008;385;1117
522160;201805;6233;16710;4158;12871;1147;3853;344;1183;1491;5036
522170;201805;2503;6888;1821;5721;546;1786;562;1764;1108;3550
522180;201805;435;1152;281;874;63;203;41;143;104;346
522185;201805;16130;42194;12326;37187;4862;15625;3317;10957;8179;26582
522190;201805;797;1919;588;1609;103;274;233;679;336;953
522200;201805;1770;5378;1188;4069;224;801;152;511;376;1312
522205;201805;1526;3820;1175;3306;101;305;833;2355;934;2660
522220;201805;1359;3531;1037;3067;168;464;558;1707;726;2171
522230;201805;1235;3314;1027;3007;182;584;580;1701;762;2285
530010;201805;166637;491823;142976;452361;30223;105533;68437;211443;98660;316976
110001;201806;3444;10426;2622;8946;692;2512;1063;3609;1755;6121
110002;201806;11350;30966;8287;25733;2524;8317;2542;7886;5066;16203
110003;201806;685;2049;509;1687;150;536;98;303;248;839
110004;201806;8903;25990;6538;21417;1828;6283;1471;5131;3299;11414
110005;201806;2267;6221;1461;4700;386;1306;446;1533;832;2839
110006;201806;1700;4917;1071;3596;263;936;143;485;406;1421
110007;201806;1168;3413;898;2931;321;1075;279;1013;600;2088
110008;201806;2419;7782;2150;7376;288;926;1617;5753;1905;6679
110009;201806;3986;11655;2726;9427;816;2904;881;3177;1697;6081
110010;201806;6121;20790;5042;18880;1375;5023;2191;9215;3566;14238
110011;201806;6317;18312;4837;15506;1618;5358;985;3220;2603;8578
110012;201806;13647;36709;9426;29301;2453;7930;1423;4566;3876;12496
110013;201806;5334;16275;4307;14300;1737;5938;691;2543;2428;8481
110014;201806;3788;10388;2740;8499;786;2493;1067;3255;1853;5748
110015;201806;5087;14202;3016;9985;781;2776;443;1414;1224;4190
110018;201806;3527;9437;2260;7248;534;1950;584;1761;1118;3711
110020;201806;68674;176061;48276;147348;10750;34416;18872;61342;29622;95758
110025;201806;4576;11937;3156;9466;598;1902;1583;4611;2181;6513
110026;201806;486;1474;405;1339;121;429;160;504;281;933
110028;201806;6128;17189;4206;13484;1174;4031;577;1825;1751;5856
110029;201806;1347;3401;828;2576;207;651;348;1088;555;1739
110030;201806;11659;29247;8006;23892;1553;5252;3009;9176;4562;14428
110032;201806;3122;9441;2301;7681;772;2597;561;1916;1333;4513
110033;201806;4096;13331;3368;11939;1182;4241;914;3591;2096;7832
110034;201806;3353;8598;2414;7240;757;2413;1028;3129;1785;5542
110037;201806;1671;5416;1347;4771;344;1263;607;2126;951;3389
110040;201806;2945;8788;2253;7490;690;2474;570;1823;1260;4297
110045;201806;4712;14477;3926;13231;1197;4335;1551;5233;2748;9568
110050;201806;1636;4970;1260;4211;515;1784;287;969;802;2753
110060;201806;793;2492;581;2046;209;782;66;242;275;1024
110070;201806;1888;6168;1524;5324;533;1953;358;1179;891;3132
110080;201806;5335;13499;4041;11916;763;2256;2441;7496;3204;9752
110090;201806;630;1753;442;1411;128;419;169;528;297;947
110092;201806;1129;3499;904;3096;153;559;485;1710;638;2269
110094;201806;2934;8844;2317;7803;811;2825;681;2401;1492;5226
110100;201806;1838;5695;1557;5117;364;1287;748;2435;1112;3722
110110;201806;1590;4700;1197;4052;407;1439;266;950;673;2389
110120;201806;1401;4243;1050;3526;299;1059;270;884;569;1943
110130;201806;2581;6858;1632;5088;383;1336;540;1641;923;2977
110140;201806;2158;6858;1625;5746;452;1683;388;1351;840;3034
110143;201806;1341;3760;969;3049;335;1068;252;812;587;1880
110145;201806;981;2747;640;2084;160;557;205;659;365;1216
110146;201806;444;1234;317;1037;61;188;158;546;219;734
110147;201806;644;1784;434;1353;95;311;168;479;263;790
110148;201806;984;2960;590;2034;118;439;54;187;172;626
110149;201806;2772;8144;2095;7066;832;2750;580;2135;1412;4885
110150;201806;2202;6066;1620;5208;645;2294;417;1282;1062;3576
110155;201806;697;2189;555;1858;130;466;199;644;329;1110
110160;201806;1528;4863;1168;4076;412;1437;286;1035;698;2472
110170;201806;2263;6195;1489;4670;285;960;745;2246;1030;3206
110175;201806;1441;4305;1120;3805;198;702;542;1940;740;2642
110180;201806;1228;3568;909;2912;241;759;378;1236;619;1995
120001;201806;3564;12423;3144;11799;484;1628;2100;8452;2584;10080
120005;201806;1802;7072;1622;6764;177;803;1231;5249;1408;6052
120010;201806;5198;16603;4483;15403;682;2261;2973;10596;3655;12857
120013;201806;2102;8108;1976;7924;531;2051;1094;4716;1625;6767
120017;201806;2048;7128;1870;6828;357;1342;1086;4157;1443;5499
120020;201806;14028;59778;13325;58395;1410;6687;9967;44619;11377;51306
120025;201806;2688;8405;2288;7890;454;1603;1439;5100;1893;6703
120030;201806;6427;25659;6177;25239;385;1945;5106;20919;5491;22864
120032;201806;1616;7545;1540;7357;85;546;1233;5844;1318;6390
120033;201806;3907;15054;3683;14661;154;822;3188;12608;3342;13430
120034;201806;2435;9309;2134;8743;127;761;1702;6861;1829;7622
120035;201806;3363;14413;3221;14134;279;1454;2588;11411;2867;12865
120038;201806;2574;8854;2330;8418;605;2257;1195;4402;1800;6659
120039;201806;1917;8650;1832;8486;179;1067;1384;6422;1563;7489
120040;201806;40976;139502;36677;132187;6825;26026;20842;76498;27667;102524
120042;201806;3166;12458;2942;11973;162;854;2347;9522;2509;10376
120043;201806;1230;5446;1162;5289;80;485;985;4462;1065;4947
120045;201806;5473;16061;4939;15462;174;700;4522;14049;4696;14749
120050;201806;8598;32852;8019;31858;649;3040;6229;25052;6878;28092
120060;201806;8489;35559;8093;34877;490;2699;6844;29546;7334;32245
120070;201806;2813;9782;2600;9438;310;1153;1824;6838;2134;7991
120080;201806;4070;14374;3712;13772;587;2343;2518;9422;3105;11765
130002;201806;3136;12814;2875;12452;107;590;2568;11162;2675;11752
130006;201806;2265;8969;1930;8353;153;774;1456;6295;1609;7069
130008;201806;2490;9042;2233;8615;81;445;1843;7098;1924;7543
130010;201806;3808;11131;3318;10573;68;246;3089;9888;3157;10134
130014;201806;3045;9544;2502;8618;454;1579;1554;5480;2008;7059
130020;201806;2708;10746;2493;10377;148;875;1982;8207;2130;9082
130030;201806;9383;31862;8637;31055;155;487;8126;29684;8281;30171
130040;201806;3841;11639;3264;10869;205;698;2597;8759;2802;9457
130050;201806;7259;27114;6132;25657;232;1070;5469;23134;5701;24204
130060;201806;7102;29610;6222;28388;524;3040;4867;22145;5391;25185
130063;201806;5545;19819;5012;19191;111;502;4666;18006;4777;18508
130068;201806;3261;13094;2886;12365;210;1153;2163;9218;2373;10371
130070;201806;8295;26092;7171;24827;323;1069;6254;22143;6577;23212
130080;201806;6403;25610;5793;24804;400;2286;4671;20009;5071;22295
130083;201806;2523;9048;2284;8730;195;868;1821;6928;2016;7796
130090;201806;3151;10323;2891;9966;57;241;2601;9100;2658;9341
130100;201806;7173;23153;6367;22281;91;281;6033;21486;6124;21767
130110;201806;7851;23063;6725;21707;590;1666;5616;18659;6206;20325
130115;201806;5379;17441;4775;16684;95;392;4170;14760;4265;15152
130120;201806;14901;54505;13613;52824;1272;5215;11048;43587;12320;48802
130130;201806;4954;16980;4019;15764;459;2094;3015;11772;3474;13866
130140;201806;6582;24876;6317;24567;264;1251;5717;22245;5981;23496
130150;201806;3580;13917;3405;13692;104;614;3090;12429;3194;13043
130160;201806;4757;18236;4250;17566;321;1550;3491;14683;3812;16233
130165;201806;3093;12289;2940;12033;114;636;2585;10560;2699;11196
130170;201806;11363;35137;9370;32700;726;2830;7710;27231;8436;30061
130180;201806;4358;13962;4113;13674;54;252;3937;13066;3991;13318
130185;201806;16900;43640;13749;40280;549;1151;12223;37069;12772;38220
130190;201806;18001;60784;15148;56601;1806;6818;10750;41566;12556;48384
130195;201806;2292;8781;1923;8287;83;430;1700;7358;1783;7788
130200;201806;2302;7117;1962;6647;156;540;1542;5346;1698;5886
130210;201806;1381;5257;1240;5090;108;634;971;3907;1079;4541
130220;201806;2045;7894;1862;7584;112;585;1477;6041;1589;6626
130230;201806;4138;18111;3734;17518;334;1898;3047;14369;3381;16267
130240;201806;10485;34656;8878;32386;236;1361;7790;28374;8026;29735
130250;201806;25084;77691;22181;74378;1541;4945;18354;63730;19895;68675
130255;201806;4162;14643;3737;13900;236;1059;2955;10982;3191;12041
130260;201806;246508;745305;209034;687204;60244;211888;88522;294357;148766;506245
130270;201806;8504;32372;7332;30497;992;4282;5139;22074;6131;26356
130280;201806;3485;14265;3279;14035;87;407;3060;13286;3147;13693
130290;201806;12466;42924;11206;41441;319;925;10356;39262;10675;40187
130300;201806;4651;17064;4314;16551;226;1170;3666;13989;3892;15159
130310;201806;5568;20319;5022;19550;383;1544;4122;16353;4505;17897
130320;201806;3339;11237;2897;10660;270;948;2216;8397;2486;9345
130330;201806;4240;14288;3622;13516;172;800;3115;11640;3287;12440
130340;201806;20974;72388;18590;69592;1496;5479;15515;59747;17011;65226
130350;201806;3819;14389;3511;13986;176;1003;3033;11958;3209;12961
130353;201806;6273;18692;5293;17444;893;2880;3531;12191;4424;15071
130356;201806;4978;17191;4404;16236;580;2198;3010;11399;3590;13597
130360;201806;3291;9676;2790;9127;74;215;2606;8616;2680;8831
130370;201806;5839;22558;5218;21725;190;1134;4540;18853;4730;19987
130380;201806;7648;31861;7235;31240;498;2722;6055;25932;6553;28654
130390;201806;5807;24803;5130;23597;539;2898;3748;17229;4287;20127
130395;201806;2359;7804;2054;7254;240;900;1446;5107;1686;6007
130400;201806;2585;8567;2260;8108;110;389;1982;7191;2092;7580
130406;201806;11169;41105;9836;39266;1840;7640;6576;26764;8416;34404
130410;201806;4034;14857;3530;13977;1052;4355;1676;6853;2728;11208
130420;201806;12466;47252;10998;45394;1071;5015;8742;36412;9813;41427
130423;201806;4019;13485;3585;12950;177;880;3126;11129;3303;12009
130426;201806;2783;11044;2664;10865;68;336;2477;10187;2545;10523
130430;201806;3981;12423;3590;11869;386;1337;2821;9375;3207;10712
130440;201806;4520;14507;4015;13913;79;329;3767;13126;3846;13455
140002;201806;1978;6041;1742;5723;105;432;1398;4508;1503;4940
140005;201806;3389;9326;3176;9083;130;411;2889;8279;3019;8690
140010;201806;53057;145839;41451;128617;10591;34573;15056;49580;25647;84153
140015;201806;3305;10485;2964;10069;274;943;2426;8409;2700;9352
140017;201806;3660;11218;3229;10639;340;1046;2357;8171;2697;9217
140020;201806;5031;15565;4319;14593;357;1465;3278;11086;3635;12551
140023;201806;2216;7022;1840;6476;237;903;1291;4595;1528;5498
140028;201806;2083;5525;1780;5127;168;556;1337;3750;1505;4306
140030;201806;4265;12221;3809;11650;340;938;3088;9673;3428;10611
140040;201806;2051;8799;1901;8582;111;638;1660;7441;1771;8079
140045;201806;2576;9654;2206;9120;402;1639;1406;6167;1808;7806
140047;201806;6026;18119;5145;16740;917;3057;3135;10479;4052;13536
140050;201806;1407;4270;1202;3967;130;439;841;2807;971;3246
140060;201806;1450;4164;1270;3893;97;284;1035;3217;1132;3501
140070;201806;1822;9794;1754;9601;154;1067;1356;7348;1510;8415
150010;201806;41626;109829;38251;105286;1367;4278;33387;91210;34754;95488
150013;201806;1880;5101;1570;4751;149;372;1172;3755;1321;4127
150020;201806;13467;42778;12739;41802;1220;3151;10621;36115;11841;39266
150030;201806;8843;33888;8102;32956;395;1780;7114;29188;7509;30968
150034;201806;4217;11239;3604;10401;259;752;2929;8557;3188;9309
150040;201806;13901;39662;12044;37535;1055;2407;10037;33064;11092;35471
150050;201806;6598;23976;6122;23285;137;683;5585;21355;5722;22038
150060;201806;19969;57645;16941;53162;3382;10590;9816;31897;13198;42487
150070;201806;6399;24959;5689;24128;176;941;5210;22342;5386;23283
150080;201806;82344;204743;68853;186667;16003;44532;27750;83623;43753;128155
150085;201806;6276;20057;5792;19457;227;710;5307;18039;5534;18749
150090;201806;10071;38206;9514;37249;687;2913;7638;30128;8325;33041
150095;201806;5529;17245;4960;16454;307;897;4069;13921;4376;14818
150100;201806;3134;11077;2779;10446;208;794;2130;8065;2338;8859
150110;201806;3934;17656;3832;17522;216;1047;3436;15848;3652;16895
150120;201806;7127;24305;6915;23996;322;913;6111;21823;6433;22736
150125;201806;760;2122;612;1930;118;417;366;1138;484;1555
150130;201806;23144;68211;20345;64111;2662;7490;14531;47601;17193;55091
150140;201806;198808;506193;173258;471225;26708;71214;108831;305704;135539;376918
150145;201806;4617;13974;4010;13142;724;2083;2806;9736;3530;11819
150150;201806;14521;39802;12976;37816;1072;3295;10033;29531;11105;32826
150157;201806;3198;9240;2680;8541;297;1037;1858;6077;2155;7114
150160;201806;2979;9298;2786;8971;681;2170;1541;5115;2222;7285
150170;201806;24243;81135;21203;76237;3782;13047;12974;49676;16756;62723
150172;201806;4035;12025;3342;11002;299;905;2454;8383;2753;9288
150175;201806;1734;5340;1520;4979;185;657;1043;3494;1228;4151
150178;201806;10211;29292;8550;27335;477;1507;7002;22947;7479;24454
150180;201806;20694;77906;19191;75977;1057;4389;16565;66595;17622;70984
150190;201806;7080;24115;6668;23581;231;1021;5934;20995;6165;22016
150195;201806;5492;17575;5201;17122;102;419;4795;15757;4897;16176
150200;201806;5382;16460;4934;15960;64;199;4668;15229;4732;15428
150210;201806;25020;90825;23639;88973;1997;7348;19049;74176;21046;81524
150215;201806;7305;22269;6355;20830;1819;5921;2849;9912;4668;15833
150220;201806;11141;33763;9905;31863;1695;5355;5862;19504;7557;24859
150230;201806;12519;36633;10839;34374;1454;4419;7390;24552;8844;28971
150240;201806;32861;94866;27165;84720;8953;28452;7090;22826;16043;51278
150250;201806;4209;17042;3999;16742;601;2539;2982;12743;3583;15282
150260;201806;2468;8648;2294;8364;228;813;1707;6320;1935;7133
150270;201806;8322;24246;6137;21062;1948;6971;2227;8041;4175;15012
150275;201806;6409;21664;5948;20960;346;1308;4927;17394;5273;18702
150276;201806;2258;6382;1950;6005;269;775;1402;4554;1671;5329
150277;201806;5008;13978;4181;12995;452;1328;3186;10359;3638;11687
150280;201806;6316;26880;6131;26516;533;2257;4984;21888;5517;24145
150285;201806;3211;11666;2882;11174;345;1452;1965;7763;2310;9215
150290;201806;10984;29623;10113;28675;483;1059;8966;26178;9449;27237
150293;201806;10004;25055;7241;21379;1661;4987;3275;10610;4936;15597
150295;201806;7840;21330;6005;19114;2040;6819;2332;8263;4372;15082
150300;201806;2117;6791;1914;6505;55;279;1646;5554;1701;5833
150304;201806;3993;12652;3453;11753;606;1985;2208;7773;2814;9758
150307;201806;6357;20762;5934;20114;429;1356;4868;16788;5297;18144
150309;201806;6055;19531;5102;17900;1239;4218;2489;9360;3728;13578
150310;201806;7164;28425;6793;27946;266;1409;5944;24677;6210;26086
150320;201806;9454;25505;8611;24381;496;1476;6864;19456;7360;20932
150330;201806;14154;46672;13113;45015;1735;5986;9530;33635;11265;39621
150340;201806;2715;8067;2435;7658;324;1009;1707;5456;2031;6465
150345;201806;7655;23287;6934;22339;483;1624;5762;18766;6245;20390
150350;201806;8717;24265;8034;23405;827;1800;6559;19851;7386;21651
150360;201806;23366;67373;19117;62010;2375;7092;13189;44881;15564;51973
150370;201806;9732;32930;8516;31255;882;3086;6254;23973;7136;27059
150375;201806;3224;13568;2937;13126;288;1348;2356;10692;2644;12040
150380;201806;10145;27865;8580;25745;372;1150;7284;22084;7656;23234
150390;201806;7764;32689;7118;31565;1139;4800;4811;22380;5950;27180
150400;201806;6250;23190;5973;22661;345;1360;4959;18932;5304;20292
150405;201806;9179;24973;8138;23697;583;1308;6490;19736;7073;21044
150410;201806;1825;6183;1603;5787;227;801;1017;3774;1244;4575
150420;201806;35168;108124;27457;96081;9270;33914;7425;30005;16695;63919
150430;201806;8050;25023;7545;24308;776;2137;5936;19796;6712;21933
150440;201806;5692;18764;5351;18262;434;1368;4332;15032;4766;16400
150442;201806;23825;63077;20224;58015;2626;7359;12978;38510;15604;45869
150445;201806;5868;19099;5300;18213;277;962;4397;15282;4674;16244
150450;201806;4815;21550;4549;21155;375;1829;3802;17897;4177;19726
150460;201806;8030;27144;7471;26406;244;1003;6491;23649;6735;24652
150470;201806;18587;53509;17495;52226;1001;2686;15416;46625;16417;49311
150475;201806;4316;14477;3897;13834;206;775;3225;11643;3431;12418
150480;201806;13919;46849;12486;44597;1959;6767;8685;32377;10644;39144
150490;201806;7737;28089;7313;27545;232;1127;6519;24608;6751;25735
150495;201806;5166;18450;5007;18245;109;471;4652;17010;4761;17481
150497;201806;2792;9359;2275;8403;601;2310;1045;4074;1646;6384
150500;201806;3317;8750;2954;8205;331;838;2263;6341;2594;7179
150503;201806;4192;12097;3177;10645;1037;3560;1161;4243;2198;7803
150506;201806;9976;33107;8939;31620;1946;6308;5659;21520;7605;27828
150510;201806;10046;37507;8793;35039;1277;4946;5710;23970;6987;28916
150520;201806;7239;27521;6991;27213;208;1028;6448;25142;6656;26170
150530;201806;12418;42640;10917;40301;1479;4627;7899;30660;9378;35287
150540;201806;4815;13795;4157;12817;184;574;3512;10818;3696;11392
150543;201806;6707;18926;5572;17424;874;2764;3764;12414;4638;15178
150548;201806;9796;30958;8912;29803;315;972;8053;27171;8368;28143
150549;201806;2026;6289;1785;5997;58;231;1584;5320;1642;5551
150550;201806;19251;59710;16474;55040;4427;14929;6931;24475;11358;39404
150553;201806;22958;73554;18372;64799;6421;23457;4980;19265;11401;42722
150555;201806;1781;5104;1438;4549;105;344;1011;3176;1116;3520
150560;201806;1829;5818;1626;5412;304;961;894;3073;1198;4034
150563;201806;2457;7936;2184;7452;469;1728;1163;3940;1632;5668
150565;201806;4126;13731;3682;12986;109;544;3063;10834;3172;11378
150570;201806;6152;21093;5896;20677;341;1319;4872;17067;5213;18386
150580;201806;10264;41986;9339;40939;656;3195;7746;34668;8402;37863
150590;201806;6995;26109;6456;25398;212;1102;5860;23003;6072;24105
150600;201806;8639;30986;8066;30241;227;1019;7311;27551;7538;28570
150610;201806;2537;8154;2299;7691;150;560;1819;6009;1969;6569
150611;201806;2873;8986;2650;8624;116;460;2253;7270;2369;7730
150613;201806;13005;36990;9961;31831;2101;6951;4469;14660;6570;21611
150616;201806;3278;9392;2460;7997;588;2082;838;2598;1426;4680
150618;201806;6620;20770;5571;18983;883;3020;3321;11784;4204;14804
150619;201806;5772;17650;4879;16279;300;1106;3794;12683;4094;13789
150620;201806;6445;22067;5677;20993;831;3033;3988;15104;4819;18137
150630;201806;6259;17401;5779;16824;373;1087;4938;14508;5311;15595
150635;201806;4279;12875;3727;11903;698;2276;2026;6557;2724;8833
150640;201806;2177;6327;2007;6130;40;121;1867;5791;1907;5912
150650;201806;11654;33986;10328;31647;3153;9316;4311;14151;7464;23467
150655;201806;5612;16807;5166;16085;253;776;4363;13623;4616;14399
150658;201806;4471;12941;3685;11805;712;2410;2167;7261;2879;9671
150660;201806;5828;17155;5243;16335;582;1787;3597;11406;4179;13193
150670;201806;8008;19840;6339;17875;602;1495;4980;14569;5582;16064
150680;201806;66137;205649;51549;182017;13232;46663;21905;86453;35137;133116
150690;201806;2345;6343;2067;5959;123;318;1722;5023;1845;5341
150700;201806;6305;19184;5728;18453;491;1468;4421;14654;4912;16122
150710;201806;3976;13352;3623;12776;279;1073;2743;9717;3022;10790
150715;201806;5172;15901;4439;14743;358;1139;3518;11863;3876;13002
150720;201806;6388;24657;6035;24021;458;2059;4898;19603;5356;21662
150730;201806;11119;35831;9836;33812;1095;3922;7343;25751;8438;29673
150740;201806;3656;10956;3238;10213;474;1411;2125;6840;2599;8251
150745;201806;4967;14993;4212;13916;868;3036;2674;8915;3542;11951
150746;201806;1498;4861;1399;4693;90;286;1120;3809;1210;4095
150747;201806;5158;16424;4538;15490;856;2637;2842;10372;3698;13009
150750;201806;3677;11627;3168;10861;224;850;2445;8568;2669;9418
150760;201806;11782;35538;10779;34273;1347;4067;7964;25972;9311;30039
150770;201806;6148;22817;5886;22455;161;489;5463;21384;5624;21873
150775;201806;958;2817;780;2537;143;542;421;1343;564;1885
150780;201806;4422;13510;4107;13130;89;300;3817;12320;3906;12620
150790;201806;5435;16455;4780;15729;253;707;3922;13969;4175;14676
150795;201806;14125;45665;12759;43391;3169;10298;7012;25304;10181;35602
150796;201806;3469;9396;3023;8862;210;633;2458;7309;2668;7942
150797;201806;3957;12773;3426;11918;141;464;2833;9961;2974;10425
150800;201806;13276;42743;12198;41414;1854;5755;8879;31567;10733;37322
150803;201806;6669;23224;6262;22566;474;1751;5117;18550;5591;20301
150805;201806;3075;10260;2697;9638;289;1000;2051;7457;2340;8457
150808;201806;5882;18001;4457;15422;1619;6110;549;2073;2168;8183
150810;201806;19879;56747;15663;51413;2853;9211;9024;31956;11877;41167
150812;201806;5336;15748;4776;14757;501;1702;3488;10531;3989;12233
150815;201806;8855;28012;7687;26515;784;2704;5953;20949;6737;23653
150820;201806;11836;32921;10128;30909;930;2525;7870;24844;8800;27369
150830;201806;11844;44825;11213;44023;404;2161;9622;38597;10026;40758
150835;201806;2159;7505;1974;7155;424;1551;1015;3780;1439;5331
150840;201806;7583;22460;6075;19775;1282;4412;2903;9499;4185;13911
160005;201806;1163;3314;1065;3163;22;106;1002;2931;1024;3037
160010;201806;1855;5409;1813;5366;10;38;1773;5243;1783;5281
160015;201806;2260;7441;2083;7198;99;346;1888;6580;1987;6926
160020;201806;1967;6869;1771;6582;238;884;1314;4963;1552;5847
160021;201806;1119;4450;1039;4330;88;483;827;3396;915;3879
160023;201806;1214;4503;1107;4337;93;329;847;3489;940;3818
160025;201806;1698;4891;1657;4842;22;64;1612;4723;1634;4787
160027;201806;8638;24117;7868;23248;674;1767;6469;19759;7143;21526
160030;201806;56426;175041;47388;162752;11027;36234;24921;93987;35948;130221
160040;201806;5176;18461;4717;17831;106;605;4320;16295;4426;16900
160050;201806;3975;13349;3341;12416;1521;5396;1075;4804;2596;10200
160053;201806;3358;11510;3160;11252;418;1442;2377;8717;2795;10159
160055;201806;674;2383;664;2371;29;109;611;2193;640;2302
160060;201806;21235;61333;17991;57641;1230;3847;14527;48045;15757;51892
160070;201806;2973;11290;2707;10853;187;832;2169;8866;2356;9698
160080;201806;2824;9966;2661;9768;63;276;2438;9023;2501;9299
170025;201806;604;1712;468;1525;111;337;226;775;337;1112
170030;201806;1161;3708;942;3281;182;644;441;1585;623;2229
170035;201806;1471;3901;1110;3316;126;410;609;1841;735;2251
170040;201806;1819;5464;1501;5031;126;460;836;2971;962;3431
170070;201806;1641;4112;1177;3509;138;442;686;2091;824;2533
170100;201806;2448;7121;2027;6430;192;605;1373;4402;1565;5007
170105;201806;733;2224;524;1773;133;415;172;594;305;1009
170110;201806;897;2880;716;2525;129;466;332;1187;461;1653
170130;201806;1370;4232;1005;3504;189;696;487;1752;676;2448
170190;201806;1449;4195;1013;3482;355;1181;209;935;564;2116
170200;201806;1740;4485;1056;3260;274;923;228;684;502;1607
170210;201806;27004;75352;20585;64642;6956;23792;2379;8395;9335;32187
170215;201806;1341;3781;1123;3473;76;301;812;2487;888;2788
170220;201806;5848;18688;5050;17170;1229;4015;2482;8992;3711;13007
170230;201806;1268;3915;981;3332;256;914;238;809;494;1723
170240;201806;2693;7731;2111;6778;185;739;1410;4432;1595;5171
170255;201806;3966;11919;2763;9564;595;2175;1173;4149;1768;6324
170270;201806;1038;2527;677;2024;32;93;441;1298;473;1391
170290;201806;3018;8646;2578;8142;139;342;2130;7035;2269;7377
170300;201806;1934;5586;1587;5039;189;608;1006;3258;1195;3866
170305;201806;743;2193;577;1858;84;315;282;882;366;1197
170307;201806;960;3369;777;2990;139;545;394;1554;533;2099
170310;201806;1553;4191;1100;3401;202;697;510;1572;712;2269
170320;201806;1019;2802;760;2377;102;323;422;1349;524;1672
170330;201806;838;2661;755;2531;44;190;590;1931;634;2121
170360;201806;469;1355;353;1155;58;224;208;630;266;854
170370;201806;1338;3654;989;3074;190;604;436;1388;626;1992
170380;201806;1813;5516;1380;4817;154;611;771;2737;925;3348
170382;201806;567;1745;466;1565;72;262;284;945;356;1207
170384;201806;1505;5792;1286;5347;357;1545;522;2177;879;3722
170386;201806;773;2211;491;1639;71;278;122;373;193;651
170388;201806;588;1739;425;1444;58;223;200;668;258;891
170389;201806;1159;3949;1002;3669;46;203;793;2940;839;3143
170390;201806;1610;3929;1188;3411;99;303;879;2573;978;2876
170410;201806;545;1648;401;1392;23;102;256;874;279;976
170460;201806;398;1096;310;944;38;115;188;583;226;698
170510;201806;852;2667;641;2244;60;278;360;1198;420;1476
170550;201806;6628;18182;4670;14798;1348;4563;797;2708;2145;7271
170555;201806;1342;3800;1063;3354;84;276;575;1870;659;2146
170560;201806;1031;3056;784;2700;99;376;434;1665;533;2041
170600;201806;1403;3917;1127;3504;265;731;609;2036;874;2767
170610;201806;1707;4841;1274;4098;91;359;809;2545;900;2904
170625;201806;430;1198;269;849;28;84;86;250;114;334
170650;201806;1246;3848;957;3326;203;721;391;1448;594;2169
170700;201806;3553;10672;2737;9204;602;2193;1109;3825;1711;6018
170710;201806;1619;4504;1253;3847;224;742;645;1924;869;2666
170720;201806;1940;5002;1560;4430;75;150;1303;3822;1378;3972
170730;201806;1016;2927;774;2534;189;641;335;1141;524;1782
170740;201806;2023;7165;1734;6590;215;843;1137;4347;1352;5190
170755;201806;873;2573;626;2086;72;263;299;991;371;1254
170765;201806;1259;3333;869;2729;218;707;334;1123;552;1830
170770;201806;1749;5522;1513;5121;194;648;994;3425;1188;4073
170820;201806;3849;13331;3341;12358;482;1746;1939;7589;2421;9335
170825;201806;993;2397;795;2128;78;224;533;1427;611;1651
170830;201806;1423;3948;1164;3536;35;110;956;2922;991;3032
170900;201806;2673;8878;2321;8314;191;754;1818;6576;2009;7330
170930;201806;3782;10745;3028;9418;708;2356;1230;3885;1938;6241
170950;201806;11805;33750;8309;27419;2369;8842;1170;4023;3539;12865
170980;201806;444;1289;358;1141;27;119;226;681;253;800
171050;201806;1574;5091;1398;4776;67;320;1094;3677;1161;3997
171070;201806;1365;4085;1180;3804;231;688;701;2459;932;3147
171090;201806;1082;2738;892;2468;63;158;642;1773;705;1931
171110;201806;577;1647;425;1378;101;363;168;490;269;853
171150;201806;1097;2841;668;2079;77;286;410;1257;487;1543
171180;201806;725;2084;484;1584;88;302;187;634;275;936
171190;201806;1583;5704;1398;5352;219;848;819;3259;1038;4107
171195;201806;849;2848;710;2581;136;523;389;1442;525;1965
171200;201806;555;1654;421;1412;94;353;161;510;255;863
171215;201806;430;1225;322;1022;62;210;156;483;218;693
171240;201806;741;2575;619;2330;52;268;386;1445;438;1713
171245;201806;617;1969;481;1674;75;287;233;769;308;1056
171250;201806;1032;2852;768;2412;228;753;329;1040;557;1793
171270;201806;385;1506;329;1372;85;336;145;674;230;1010
171280;201806;836;2616;659;2296;138;462;301;1152;439;1614
171320;201806;3951;11396;3099;9878;590;1887;1367;4579;1957;6466
171330;201806;2710;7629;2095;6547;457;1430;1011;3274;1468;4704
171360;201806;1443;4430;1223;4118;86;332;946;3212;1032;3544
171370;201806;695;1843;541;1623;54;163;374;1137;428;1300
171380;201806;1386;4054;1125;3628;141;503;695;2245;836;2748
171395;201806;927;2758;650;2191;91;362;320;1039;411;1401
171420;201806;1825;5699;1354;4717;212;826;613;2138;825;2964
171430;201806;1036;3128;843;2749;95;346;560;1759;655;2105
171488;201806;2455;7383;1964;6584;324;1116;1028;3549;1352;4665
171500;201806;935;2511;717;2169;53;159;528;1611;581;1770
171510;201806;795;2753;714;2600;42;194;509;1856;551;2050
171515;201806;481;1337;351;1113;30;110;210;651;240;761
171525;201806;624;1939;525;1768;41;191;324;1012;365;1203
171550;201806;329;1018;238;858;42;174;117;410;159;584
171570;201806;1171;3627;986;3279;180;579;576;1993;756;2572
171575;201806;1879;5087;1209;3848;200;668;504;1579;704;2247
171610;201806;5671;16456;4274;14059;1011;3634;1182;4106;2193;7740
171620;201806;2830;7958;2374;7329;149;543;1878;5852;2027;6395
171630;201806;987;2776;807;2522;163;544;482;1533;645;2077
171650;201806;2136;6370;1570;5275;379;1324;494;1754;873;3078
171660;201806;2410;6380;1675;5068;275;816;853;2612;1128;3428
171665;201806;1323;3834;1022;3356;194;701;468;1559;662;2260
171670;201806;1847;5070;1428;4389;221;755;757;2294;978;3049
171700;201806;1191;3544;893;3008;132;422;479;1639;611;2061
171720;201806;818;2219;641;1924;57;210;456;1360;513;1570
171750;201806;1231;3598;876;2934;229;794;154;588;383;1382
171780;201806;1289;3354;924;2828;76;269;622;1882;698;2151
171790;201806;1442;4958;1163;4334;262;967;518;2020;780;2987
171800;201806;744;2153;579;1901;83;291;317;1052;400;1343
171820;201806;10647;31060;8118;26619;1930;6695;2706;9418;4636;16113
171830;201806;1455;5110;1244;4669;173;732;732;2729;905;3461
171840;201806;697;1901;567;1698;31;108;422;1235;453;1343
171845;201806;651;1734;493;1507;69;243;261;812;330;1055
171850;201806;864;3026;736;2758;72;316;501;1849;573;2165
171855;201806;1094;3407;955;3158;89;294;614;2015;703;2309
171865;201806;397;1316;336;1213;56;216;164;575;220;791
171870;201806;763;2198;555;1797;71;249;288;978;359;1227
171875;201806;1246;3816;998;3403;60;246;729;2451;789;2697
171880;201806;1031;3363;933;3239;47;171;757;2690;804;2861
171884;201806;910;2424;660;2041;128;452;214;734;342;1186
171886;201806;1461;4248;1037;3488;311;1114;196;681;507;1795
171888;201806;767;2208;529;1745;46;148;318;1057;364;1205
171889;201806;466;1456;399;1322;80;293;175;580;255;873
171890;201806;1166;3315;889;2859;167;506;514;1689;681;2195
171900;201806;504;1794;376;1475;96;378;135;560;231;938
172000;201806;591;1846;489;1648;72;285;259;833;331;1118
172010;201806;1076;3803;932;3494;83;403;593;2135;676;2538
172015;201806;333;1257;264;1113;53;218;114;493;167;711
172020;201806;2362;7504;2161;7196;194;769;1600;5333;1794;6102
172025;201806;733;2094;533;1765;48;183;334;1110;382;1293
172030;201806;1256;3787;1085;3519;26;123;880;2844;906;2967
172049;201806;1377;3418;896;2673;302;947;396;1190;698;2137
172065;201806;1459;3753;1170;3402;67;166;1037;3089;1104;3255
172080;201806;2361;7219;1926;6402;134;490;1308;4365;1442;4855
172085;201806;475;1339;313;1001;51;142;88;273;139;415
172090;201806;4068;10628;3138;9330;139;502;2454;7248;2593;7750
172093;201806;511;1543;379;1300;54;237;192;619;246;856
172097;201806;636;1758;467;1488;71;238;211;691;282;929
172100;201806;44732;116815;30642;93536;6768;22477;9058;28865;15826;51342
172110;201806;1595;6043;1393;5721;138;593;1052;4485;1190;5078
172120;201806;4939;15203;3895;13479;673;2334;1998;7171;2671;9505
172125;201806;294;854;213;715;27;97;117;399;144;496
172130;201806;855;2623;714;2383;22;74;550;1857;572;1931
172208;201806;2416;6344;1933;5662;281;758;1195;3614;1476;4372
172210;201806;2745;7520;2134;6689;437;1432;1130;3576;1567;5008
210005;201806;19868;59717;16076;53605;4661;16137;6201;21657;10862;37794
210010;201806;1787;5884;1621;5611;49;210;1424;4941;1473;5151
210015;201806;3358;10273;2984;9741;144;383;2539;8476;2683;8859
210020;201806;7529;17207;6702;16261;99;259;6230;15091;6329;15350
210030;201806;4922;16441;4657;16072;228;1065;4014;13731;4242;14796
210040;201806;2205;6124;1994;5884;34;65;1863;5582;1897;5647
210043;201806;6702;17972;5508;16599;694;1978;3930;12467;4624;14445
210047;201806;6502;22020;5770;20991;243;1160;5001;18093;5244;19253
210050;201806;2198;7746;1751;6896;251;1080;1086;4308;1337;5388
210055;201806;1794;6040;1649;5794;65;266;1354;4741;1419;5007
210060;201806;6783;26305;6140;25034;821;3459;4233;17723;5054;21182
210070;201806;7305;21024;6881;20521;38;114;6611;19873;6649;19987
210080;201806;3903;13949;3809;13834;24;117;3707;13497;3731;13614
210083;201806;5237;16135;4533;15369;83;458;4279;14409;4362;14867
210087;201806;2911;8339;2610;7924;151;417;2180;6786;2331;7203
210090;201806;9592;30174;9130;29421;276;1009;8288;26587;8564;27596
210095;201806;6015;20611;5617;20104;261;1067;4913;17720;5174;18787
210100;201806;6884;20782;6347;20018;243;913;5386;17007;5629;17920
210110;201806;2791;9108;2640;8903;34;159;2475;8344;2509;8503
210120;201806;24178;67714;20646;63254;2743;7203;13864;45340;16607;52543
210125;201806;3979;11662;3674;11271;732;1798;2676;8757;3408;10555
210130;201806;4135;11567;3588;10869;157;457;3067;9324;3224;9781
210135;201806;1463;4547;1310;4305;53;220;1084;3560;1137;3780
210140;201806;17428;51317;14232;46955;3003;9942;7782;26612;10785;36554
210150;201806;4593;11321;4117;10690;86;280;3686;9458;3772;9738
210160;201806;16383;50351;14943;48246;1371;4481;11104;36848;12475;41329
210170;201806;14337;47671;13651;46769;634;2258;12204;42019;12838;44277
210173;201806;2419;9114;2278;8890;56;331;2103;8182;2159;8513
210177;201806;3135;9356;2949;9132;70;159;2770;8717;2840;8876
210180;201806;1477;4187;1331;3984;35;121;1173;3492;1208;3613
210190;201806;4764;14527;4329;13737;105;526;3581;11108;3686;11634
210193;201806;1209;3754;1100;3583;49;177;892;2922;941;3099
210197;201806;2024;6703;1869;6504;189;629;1457;5219;1646;5848
210200;201806;7540;25130;6992;24316;651;2305;5590;19743;6241;22048
210203;201806;6985;21448;6415;20683;536;1620;5338;17537;5874;19157
210207;201806;3502;10336;3143;9845;161;435;2564;8248;2725;8683
210210;201806;8261;27529;7806;26902;94;534;7270;25014;7364;25548
210215;201806;2030;6893;1858;6654;64;330;1635;5815;1699;6145
210220;201806;6000;21392;5685;20851;238;1308;4951;17838;5189;19146
210230;201806;5091;16019;4680;15418;225;637;4141;13804;4366;14441
210232;201806;11632;37461;9617;34617;1459;5484;6235;23766;7694;29250
210235;201806;3616;10903;3181;10348;119;502;2798;9123;2917;9625
210237;201806;2417;8748;2248;8540;24;131;2147;8171;2171;8302
210240;201806;2739;8692;2517;8313;89;362;2178;7141;2267;7503
210250;201806;5489;17187;5059;16652;108;572;4531;14865;4639;15437
210255;201806;2640;8215;2302;7600;289;999;1570;5145;1859;6144
210260;201806;5136;16258;4609;15449;277;990;3817;12842;4094;13832
210270;201806;4948;14088;4463;13427;91;438;3967;11839;4058;12277
210275;201806;3605;9191;3276;8800;62;116;3081;8402;3143;8518
210280;201806;5586;16601;4635;15135;241;1194;3383;10752;3624;11946
210290;201806;6478;19321;5982;18709;143;515;5378;16839;5521;17354
210300;201806;35371;96171;29328;88476;1947;5968;21846;68825;23793;74793
210310;201806;3039;8037;2754;7653;73;140;2476;6949;2549;7089
210312;201806;2508;6997;2239;6677;60;234;2033;6031;2093;6265
210315;201806;2896;8369;2471;7861;75;193;2190;7182;2265;7375
210317;201806;4054;12911;3756;12569;111;481;3460;11546;3571;12027
210320;201806;19244;61629;17979;59965;513;2373;16210;53915;16723;56288
210325;201806;3518;10542;3104;9943;92;328;2757;8946;2849;9274
210330;201806;28038;77891;23122;71730;5786;17059;11543;41181;17329;58240
210340;201806;10572;32159;9531;30626;1002;3092;6943;23213;7945;26305
210350;201806;9427;28057;8433;26739;255;876;7272;23235;7527;24111
210355;201806;4076;14268;3598;13514;131;679;3004;11386;3135;12065
210360;201806;14697;44253;13222;42146;646;2560;10849;34354;11495;36914
210370;201806;10138;23416;8036;21174;269;551;7198;19436;7467;19987
210375;201806;3106;8896;2443;7996;668;2168;1147;4025;1815;6193
210380;201806;5613;15120;5036;14379;267;676;4320;12497;4587;13173
210390;201806;2672;9803;2499;9503;139;666;2069;7814;2208;8480
210400;201806;4697;14739;4302;14247;128;338;3945;13257;4073;13595
210405;201806;7394;20450;5961;18372;1165;3421;3221;10563;4386;13984
210407;201806;1964;6789;1649;6175;130;593;1276;4686;1406;5279
210408;201806;2383;9257;2259;9083;140;720;1857;7556;1997;8276
210409;201806;3691;13110;3395;12688;115;631;2880;10767;2995;11398
210410;201806;3576;11282;3159;10618;238;816;2413;8262;2651;9078
210420;201806;4096;13244;3697;12538;166;537;3120;10701;3286;11238
210430;201806;2214;6594;2085;6442;115;303;1829;5732;1944;6035
210440;201806;4170;11950;3889;11573;79;259;3659;10908;3738;11167
210450;201806;2545;7998;2274;7553;131;484;1827;6044;1958;6528
210455;201806;3833;10621;3174;9816;761;2302;1875;6012;2636;8314
210460;201806;3395;10589;3076;10128;116;454;2628;8654;2744;9108
210462;201806;1477;4995;1320;4697;55;263;1071;3762;1126;4025
210465;201806;2620;7976;2302;7530;88;286;1982;6529;2070;6815
210467;201806;5958;19746;5485;19172;288;1186;4800;16836;5088;18022
210470;201806;2120;5595;1467;4647;80;195;1115;3643;1195;3838
210480;201806;15362;47372;13082;44444;1458;4776;9458;34069;10916;38845
210490;201806;3767;9861;3119;8939;71;246;2728;7796;2799;8042
210500;201806;6194;25120;5823;24419;395;1969;4684;19527;5079;21496
210510;201806;6079;20961;5624;20416;133;587;5051;18591;5184;19178
210515;201806;3627;11037;3267;10654;122;383;2943;9749;3065;10132
210520;201806;2599;7573;2318;7210;98;333;2047;6397;2145;6730
210530;201806;49592;132014;40828;118579;6949;24976;11825;41569;18774;66545
210535;201806;3196;10905;3008;10620;95;356;2629;9393;2724;9749
210540;201806;14146;43534;12083;40764;1469;4871;8554;29995;10023;34866
210542;201806;6110;15794;5212;14794;277;526;4576;13539;4853;14065
210545;201806;2313;7258;2166;7025;51;230;1920;6144;1971;6374
210547;201806;3584;12899;3269;12297;324;1172;2377;9237;2701;10409
210550;201806;5885;17890;5063;16862;308;1071;4210;14306;4518;15377
210560;201806;3625;11275;3268;10655;107;375;2804;9078;2911;9453
210565;201806;1426;5035;1214;4701;51;264;975;3822;1026;4086
210570;201806;11222;31131;10178;29886;339;853;9269;27554;9608;28407
210580;201806;2990;8387;2616;7926;237;447;2101;6750;2338;7197
210590;201806;4122;12758;3712;12225;126;607;3276;10693;3402;11300
210592;201806;2568;7818;2416;7565;30;168;2148;6645;2178;6813
210594;201806;2743;7553;2151;6627;86;219;1582;5061;1668;5280
210596;201806;2456;8984;2273;8604;176;713;1775;6771;1951;7484
210598;201806;1805;5342;1692;5191;37;153;1559;4756;1596;4909
210600;201806;3046;8510;2536;7793;89;248;2052;6367;2141;6615
210610;201806;2486;7717;2245;7414;84;381;1981;6466;2065;6847
210620;201806;2325;6991;2045;6647;41;110;1885;6254;1926;6364
210630;201806;3215;11218;2919;10782;163;783;2384;8703;2547;9486
210632;201806;4284;14482;3882;13872;354;1453;3011;10707;3365;12160
210635;201806;1838;6438;1728;6250;128;420;1440;5357;1568;5777
210637;201806;2472;8444;2222;8058;144;658;1697;6192;1841;6850
210640;201806;5032;19632;4958;19554;35;132;4869;19268;4904;19400
210650;201806;7118;20848;6721;20320;82;309;6389;19286;6471;19595
210660;201806;8730;25276;7772;23831;335;1169;6669;20333;7004;21502
210663;201806;2550;7788;2420;7640;123;331;2132;6917;2255;7248
210667;201806;1898;6286;1777;6098;66;272;1584;5476;1650;5748
210670;201806;4478;15778;4186;15313;148;705;3660;13339;3808;14044
210675;201806;5096;14083;4497;13290;329;787;3722;11391;4051;12178
210680;201806;4074;10621;3445;9846;147;294;3026;8872;3173;9166
210690;201806;7470;24574;6834;23873;254;1018;6045;21492;6299;22510
210700;201806;2802;7776;2363;7234;161;383;1861;6190;2022;6573
210710;201806;4877;15685;4452;15072;137;639;3909;13152;4046;13791
210720;201806;2757;9381;2592;9166;56;299;2374;8329;2430;8628
210725;201806;1261;4468;1122;4224;43;197;805;3124;848;3321
210730;201806;1219;3390;1039;3137;77;216;810;2477;887;2693
210735;201806;4560;14093;3992;13253;321;1115;3287;11060;3608;12175
210740;201806;5278;14704;4754;14166;156;590;4201;12440;4357;13030
210745;201806;4592;13007;4345;12696;157;392;3922;11561;4079;11953
210750;201806;20374;53320;17636;50092;1531;4287;13369;38917;14900;43204
210760;201806;5633;16152;5126;15602;24;84;4964;15155;4988;15239
210770;201806;5997;16117;5176;15184;63;268;4764;13982;4827;14250
210780;201806;7214;24046;6529;22874;629;2064;4956;17782;5585;19846
210790;201806;4599;14698;4280;14288;161;463;3476;12285;3637;12748
210800;201806;4995;13545;4365;12736;67;264;3985;11518;4052;11782
210805;201806;3896;14819;3749;14591;109;614;3361;13026;3470;13640
210810;201806;5082;15175;4662;14633;230;504;4064;13216;4294;13720
210820;201806;7204;20972;6232;19379;748;2337;4051;12837;4799;15174
210825;201806;6370;20354;5994;19878;262;845;5266;17752;5528;18597
210830;201806;7793;22495;7368;21961;461;998;6409;19792;6870;20790
210840;201806;3374;9081;3047;8632;80;256;2670;7493;2750;7749
210845;201806;6065;17403;5792;17106;35;87;5721;16937;5756;17024
210850;201806;5785;20374;5154;19360;360;1660;3957;14842;4317;16502
210860;201806;18400;51646;15927;48349;845;2449;13030;40555;13875;43004
210870;201806;6370;18919;5617;18017;305;1002;4811;15557;5116;16559
210880;201806;4285;13614;3957;13228;223;862;3332;11138;3555;12000
210890;201806;4367;13270;3978;12805;264;693;3323;11131;3587;11824
210900;201806;4817;14165;3666;12099;1382;4895;668;2443;2050;7338
210905;201806;1920;5605;1656;5231;49;114;1470;4736;1519;4850
210910;201806;7515;23639;6517;21955;844;2978;4332;14641;5176;17619
210920;201806;3116;10635;2761;10152;102;520;2417;8827;2519;9347
210923;201806;1435;4622;1292;4396;77;316;984;3337;1061;3653
210927;201806;5013;16059;4507;15511;123;461;4102;14279;4225;14740
210930;201806;2419;8579;2231;8260;112;565;1779;6508;1891;7073
210940;201806;3649;11379;3438;11088;118;546;3044;9614;3162;10160
210945;201806;5952;18056;5605;17643;249;694;4976;15863;5225;16557
210950;201806;5181;15415;4095;13758;571;1723;2748;9685;3319;11408
210955;201806;1704;5462;1508;5154;150;480;1067;3746;1217;4226
210960;201806;8798;27492;7930;26228;1605;4890;4829;17093;6434;21983
210970;201806;1302;4310;1103;3954;89;408;809;2782;898;3190
210975;201806;1672;5575;1565;5381;123;460;1181;4047;1304;4507
210980;201806;10579;23890;9462;22749;163;348;9008;21815;9171;22163
210990;201806;16130;48106;13271;44271;1487;5075;9060;30927;10547;36002
211000;201806;14512;44637;12602;42470;627;2600;10389;35781;11016;38381
211003;201806;5200;17096;4518;16263;183;745;3832;14092;4015;14837
211010;201806;6381;23471;5921;22837;73;446;5441;21147;5514;21593
211020;201806;7993;25222;7498;24558;345;1324;6447;21182;6792;22506
211023;201806;2103;7028;1991;6865;106;416;1660;5676;1766;6092
211027;201806;2726;9623;2669;9526;203;758;2272;8108;2475;8866
211030;201806;3796;11030;3463;10634;278;650;2891;9145;3169;9795
211040;201806;4475;16477;4258;16140;135;765;3781;14253;3916;15018
211050;201806;9712;24854;8910;23871;188;494;8287;22224;8475;22718
211060;201806;6378;21254;5979;20671;186;762;5448;18861;5634;19623
211065;201806;2117;6250;1831;5849;65;212;1586;5161;1651;5373
211070;201806;7717;25866;6860;24483;506;1853;5385;19416;5891;21269
211080;201806;1316;3773;1089;3423;43;240;847;2506;890;2746
211085;201806;1998;6203;1799;5914;121;348;1500;5013;1621;5361
211090;201806;3307;9280;2981;8849;49;238;2683;7859;2732;8097
211100;201806;6426;17015;6123;16604;44;160;5751;15579;5795;15739
211102;201806;2887;10648;2677;10348;155;725;2312;8938;2467;9663
211105;201806;2351;7717;1992;7046;222;804;1372;4819;1594;5623
211107;201806;4498;14312;3973;13575;165;610;3271;11487;3436;12097
211110;201806;6010;17166;4699;15147;596;1779;3210;10728;3806;12507
211120;201806;35688;100006;32962;96712;4430;11967;24328;73834;28758;85801
211125;201806;1952;6085;1705;5681;62;256;1459;4861;1521;5117
211130;201806;186833;480109;174017;463818;25080;67504;79487;239831;104567;307335
211140;201806;5004;15623;4568;14997;228;711;3878;12797;4106;13508
211150;201806;9349;26693;8228;25265;295;1058;7050;21701;7345;22759
211153;201806;2605;7926;2210;7427;402;1418;1432;5023;1834;6441
211157;201806;1107;3580;932;3288;44;252;652;2300;696;2552
211160;201806;3938;12307;3268;11185;196;896;2364;7849;2560;8745
211163;201806;1741;5748;1607;5550;19;75;1510;5285;1529;5360
211167;201806;1531;4992;1441;4847;30;137;1348;4516;1378;4653
211170;201806;6032;15606;5745;15262;68;234;5476;14486;5544;14720
211172;201806;2483;7017;2162;6493;90;300;1791;5220;1881;5520
211174;201806;2765;8337;2555;8059;64;312;2309;7213;2373;7525
211176;201806;4030;12475;3347;11494;236;965;2561;8777;2797;9742
211178;201806;4613;10898;4076;10284;32;133;3848;9590;3880;9723
211180;201806;4059;13851;3798;13461;232;880;3214;11469;3446;12349
211190;201806;3048;9298;2673;8729;49;246;2325;7512;2374;7758
211195;201806;1388;4048;1176;3754;74;189;966;3189;1040;3378
211200;201806;2049;6325;1720;5881;180;640;1176;4114;1356;4754
211210;201806;6572;20277;6089;19609;283;1005;5273;17041;5556;18046
211220;201806;35117;94347;29870;87826;3364;9859;21338;64459;24702;74318
211223;201806;4952;14620;4423;13808;507;1471;3217;10280;3724;11751
211227;201806;1673;5851;1538;5637;51;255;1327;4898;1378;5153
211230;201806;7266;22998;6622;21924;525;1733;5193;17290;5718;19023
211240;201806;8117;26797;7689;26249;159;863;7027;23720;7186;24583
211245;201806;6270;17060;6025;16811;60;113;5922;16597;5982;16710
211250;201806;13734;41043;12618;39693;514;1912;10992;34419;11506;36331
211260;201806;7656;25234;7051;24421;216;942;6391;22236;6607;23178
211270;201806;10325;33869;9100;32251;380;1833;7544;26916;7924;28749
211280;201806;13445;38365;12051;36565;860;2098;9772;30850;10632;32948
211285;201806;1683;6059;1492;5711;255;1012;755;3003;1010;4015
211290;201806;7056;22545;6601;21910;221;902;5678;18834;5899;19736
211300;201806;8200;23668;7488;22732;96;284;7045;21494;7141;21778
211400;201806;11370;34443;9525;31667;1661;5515;5621;20039;7282;25554
220005;201806;1847;5082;1664;4801;38;149;1354;3806;1392;3955
220010;201806;1502;4291;1264;3879;32;136;994;3000;1026;3136
220020;201806;3291;9960;2976;9426;327;1088;2189;6876;2516;7964
220025;201806;2236;5289;1940;4853;33;96;1593;3882;1626;3978
220027;201806;1255;3342;1093;3116;33;104;881;2489;914;2593
220030;201806;3363;9095;3205;8854;109;316;2805;7639;2914;7955
220040;201806;7017;21505;6342;20242;1202;3743;3932;12766;5134;16509
220045;201806;1421;4532;1220;4158;39;197;969;3232;1008;3429
220050;201806;4512;13107;3836;12080;131;562;3307;10306;3438;10868
220060;201806;2342;5228;1975;4800;28;62;1822;4410;1850;4472
220070;201806;2499;6682;2186;6211;86;221;1779;5027;1865;5248
220080;201806;668;1996;605;1898;27;114;515;1555;542;1669
220090;201806;1790;4433;1467;3982;15;56;1275;3471;1290;3527
220095;201806;670;1772;632;1721;10;22;586;1595;596;1617
220100;201806;1348;3894;1104;3452;53;216;872;2648;925;2864
220105;201806;2061;6495;1796;5953;145;489;1310;4361;1455;4850
220110;201806;3441;9671;3222;9282;53;243;2839;8046;2892;8289
220115;201806;2643;8308;2472;8036;82;351;2202;7047;2284;7398
220117;201806;1344;3389;1051;2948;20;72;889;2453;909;2525
220120;201806;11671;34030;10731;32835;136;557;10047;30676;10183;31233
220130;201806;1035;3005;881;2773;18;123;789;2422;807;2545
220140;201806;1848;4319;1592;3998;145;368;1349;3373;1494;3741
220150;201806;6582;19819;6172;19201;148;747;5305;16168;5453;16915
220155;201806;1103;3270;870;2838;23;102;602;1927;625;2029
220157;201806;1062;2686;893;2401;17;74;719;1876;736;1950
220160;201806;2667;7855;2317;7185;50;266;1899;5754;1949;6020
220170;201806;1385;3889;1178;3564;18;96;1035;3080;1053;3176
220173;201806;1975;5782;1601;5074;37;184;1298;3978;1335;4162
220177;201806;1880;5558;1827;5493;15;53;1769;5330;1784;5383
220180;201806;1168;3003;910;2514;9;41;662;1720;671;1761
220190;201806;5736;16209;4947;15115;423;1324;3719;11455;4142;12779
220191;201806;1400;4536;1303;4355;84;349;939;3065;1023;3414
220192;201806;1840;5101;1463;4428;29;109;1160;3445;1189;3554
220194;201806;1709;5043;1524;4730;69;274;1237;3751;1306;4025
220196;201806;1977;5495;1792;5173;48;204;1505;4249;1553;4453
220198;201806;1238;3586;1024;3290;7;23;959;3130;966;3153
220200;201806;4776;14702;4328;14104;339;1195;3449;11231;3788;12426
220202;201806;2184;6263;1874;5711;31;141;1574;4694;1605;4835
220205;201806;2576;7192;2284;6738;44;182;1967;5702;2011;5884
220207;201806;826;2510;699;2286;58;219;473;1533;531;1752
220208;201806;1722;5440;1408;4793;276;1021;658;2222;934;3243
220209;201806;1623;4730;1392;4325;25;113;1119;3454;1144;3567
220210;201806;1607;4233;1377;3837;26;115;1122;3020;1148;3135
220211;201806;1525;4146;1429;4009;18;74;1253;3524;1271;3598
220213;201806;1715;4739;1502;4324;25;104;1229;3431;1254;3535
220217;201806;1970;6200;1881;6087;38;157;1749;5702;1787;5859
220220;201806;10279;27652;8713;25200;554;1470;6324;18686;6878;20156
220225;201806;1151;3086;936;2808;13;52;809;2386;822;2438
220230;201806;5742;14525;4984;13515;190;516;4303;11685;4493;12201
220240;201806;2920;8718;2677;8262;86;315;2194;6744;2280;7059
220245;201806;1575;4026;1261;3612;12;44;1127;3287;1139;3331
220250;201806;2823;8362;2488;7913;35;159;2216;7036;2251;7195
220253;201806;1677;4651;1405;4170;83;256;1144;3324;1227;3580
220255;201806;1867;4737;1568;4270;28;150;1305;3376;1333;3526
220260;201806;4278;13542;3768;12638;197;711;2980;9974;3177;10685
220265;201806;1240;4155;1128;3980;55;246;871;3028;926;3274
220270;201806;6591;21020;6200;20313;333;1390;5088;16158;5421;17548
220271;201806;1488;3951;1286;3651;48;165;1094;3098;1142;3263
220272;201806;1706;4976;1524;4631;39;139;1183;3506;1222;3645
220273;201806;1187;3470;1011;3133;32;129;783;2381;815;2510
220275;201806;2231;5479;1717;4791;42;156;1474;4075;1516;4231
220277;201806;2141;5637;1848;5175;34;109;1542;4233;1576;4342
220280;201806;1580;4033;1337;3645;43;148;1104;2901;1147;3049
220285;201806;1528;3975;1281;3655;20;82;1145;3232;1165;3314
220290;201806;5996;18478;4938;16969;381;1479;3579;12311;3960;13790
220300;201806;1879;5871;1587;5437;48;298;1309;4370;1357;4668
220310;201806;2778;8194;2303;7646;41;211;1969;6458;2010;6669
220320;201806;2911;8748;2356;7689;139;572;1795;5730;1934;6302
220323;201806;1603;5158;1296;4660;84;353;1014;3612;1098;3965
220325;201806;1255;3808;1059;3440;41;174;848;2728;889;2902
220327;201806;1393;4211;1236;3940;43;213;1032;3195;1075;3408
220330;201806;4064;10471;3423;9615;134;402;2856;7978;2990;8380
220335;201806;1771;5411;1577;5185;32;90;1444;4789;1476;4879
220340;201806;1829;4922;1464;4310;59;212;1027;2899;1086;3111
220342;201806;1146;3547;1031;3369;39;160;834;2721;873;2881
220345;201806;3041;7146;2475;6362;16;48;2345;6013;2361;6061
220350;201806;3485;9230;2825;8155;153;513;2075;5882;2228;6395
220360;201806;1244;3212;1003;2833;22;67;799;2231;821;2298
220370;201806;9028;25739;8173;24540;216;892;7241;21493;7457;22385
220375;201806;1453;4478;1350;4330;9;34;1306;4191;1315;4225
220380;201806;1521;3749;1253;3366;36;114;1077;2838;1113;2952
220385;201806;813;2006;637;1695;9;33;544;1410;553;1443
220390;201806;8693;25033;7310;22604;1867;5712;3032;9964;4899;15676
220400;201806;1509;3700;1141;3110;24;81;872;2292;896;2373
220410;201806;1176;3333;976;3001;57;176;777;2348;834;2524
220415;201806;824;2222;707;2026;23;68;530;1488;553;1556
220420;201806;2015;5720;1640;4992;59;189;1250;3729;1309;3918
220430;201806;2481;6734;2409;6640;74;220;2171;5944;2245;6164
220435;201806;1716;4743;1525;4442;55;194;1185;3378;1240;3572
220440;201806;2456;7916;2154;7412;129;499;1752;5929;1881;6428
220450;201806;2254;6366;1863;5831;221;787;1356;4221;1577;5008
220455;201806;1320;4162;1247;4062;26;122;1106;3577;1132;3699
220460;201806;947;2437;853;2328;44;135;741;1981;785;2116
220465;201806;2358;7521;2115;7147;144;532;1628;5521;1772;6053
220470;201806;3571;10251;3194;9635;101;341;2580;7659;2681;8000
220480;201806;2444;6684;1986;5925;147;375;1444;4258;1591;4633
220490;201806;2351;6223;2142;5968;35;149;1910;5246;1945;5395
220500;201806;2725;7356;2439;6882;57;238;1966;5341;2023;5579
220510;201806;2697;7893;2192;6986;89;283;1673;5355;1762;5638
220515;201806;1710;4162;1521;3905;44;98;1344;3446;1388;3544
220520;201806;5043;13312;4579;12653;99;291;4084;11279;4183;11570
220525;201806;1242;3392;1127;3234;11;45;1002;2833;1013;2878
220527;201806;1296;3770;1142;3502;30;102;956;2947;986;3049
220530;201806;1218;3402;1098;3221;27;110;1014;2921;1041;3031
220535;201806;803;2296;741;2214;51;151;592;1768;643;1919
220540;201806;3345;10622;3152;10292;103;431;2742;8896;2845;9327
220545;201806;1365;4371;1276;4198;84;333;1042;3363;1126;3696
220550;201806;8877;27688;8006;26167;604;2179;5952;19174;6556;21353
220551;201806;1440;4344;1258;4032;47;193;987;3101;1034;3294
220552;201806;1515;4524;1283;4070;35;177;1034;3184;1069;3361
220553;201806;1579;4410;1342;4036;55;152;1042;3229;1097;3381
220554;201806;842;2329;639;1984;33;91;467;1428;500;1519
220555;201806;2021;6654;1882;6409;58;298;1544;5189;1602;5487
220556;201806;1306;3922;1124;3537;46;197;832;2503;878;2700
220557;201806;1551;4803;1324;4328;84;314;951;3037;1035;3351
220558;201806;1365;3681;1063;3255;25;123;886;2654;911;2777
220559;201806;1630;4339;1401;3964;10;45;1160;3282;1170;3327
220560;201806;1724;4068;1384;3601;42;106;1211;3130;1253;3236
220570;201806;7207;22406;6620;21476;532;1773;5126;16708;5658;18481
220580;201806;6641;19321;6282;18739;143;512;5592;16508;5735;17020
220585;201806;1928;6398;1739;6038;69;284;1408;4865;1477;5149
220590;201806;1278;3659;1083;3361;98;301;775;2431;873;2732
220595;201806;2415;6755;2246;6534;16;89;2101;6044;2117;6133
220600;201806;1433;3231;1172;2898;148;235;909;2347;1057;2582
220605;201806;1707;5013;1460;4570;36;164;1137;3460;1173;3624
220610;201806;2863;8970;2692;8724;38;169;2460;7964;2498;8133
220620;201806;7828;24801;7301;24068;210;964;6580;21487;6790;22451
220630;201806;372;1130;295;995;39;136;179;622;218;758
220635;201806;1687;5410;1485;4980;69;280;1077;3558;1146;3838
220640;201806;2701;7435;2300;6835;91;321;1899;5579;1990;5900
220650;201806;2064;5963;1774;5441;65;226;1368;4147;1433;4373
220660;201806;2743;8389;2390;7858;97;461;1982;6312;2079;6773
220665;201806;1299;4029;1128;3741;27;153;949;3095;976;3248
220667;201806;1637;5296;1472;4996;80;313;1161;3935;1241;4248
220669;201806;1719;5418;1647;5287;85;372;1366;4300;1451;4672
220670;201806;2136;5808;1779;5388;40;140;1597;4808;1637;4948
220672;201806;3007;7688;2470;7039;111;325;2175;6195;2286;6520
220675;201806;1242;3472;1135;3271;52;136;890;2543;942;2679
220680;201806;2616;7430;2485;7245;114;316;2205;6432;2319;6748
220690;201806;1580;4324;1385;4005;123;312;1018;2989;1141;3301
220695;201806;942;2659;856;2495;19;64;708;2043;727;2107
220700;201806;8866;23294;7190;20866;368;1155;5466;15721;5834;16876
220710;201806;848;2443;653;2061;46;134;466;1456;512;1590
220720;201806;2042;5099;1846;4798;30;104;1593;4096;1623;4200
220730;201806;1315;3775;1113;3447;20;92;919;2787;939;2879
220735;201806;1004;2412;764;2011;24;68;638;1646;662;1714
220740;201806;1427;4040;1145;3671;35;132;967;3112;1002;3244
220750;201806;3609;10013;3286;9530;179;505;2831;8202;3010;8707
220755;201806;1155;3079;1001;2838;31;120;791;2164;822;2284
220760;201806;2994;8960;2639;8476;116;378;2221;7234;2337;7612
220770;201806;20858;66008;18039;60806;6170;21504;5813;20475;11983;41979
220775;201806;1133;3021;1061;2934;16;57;1026;2830;1042;2887
220777;201806;1567;4157;1239;3611;40;108;931;2697;971;2805
220779;201806;1371;3375;1221;3163;29;98;1055;2696;1084;2794
220780;201806;5594;14592;4808;13308;232;787;3888;10472;4120;11259
220785;201806;1418;3240;1286;3050;16;25;1218;2889;1234;2914
220790;201806;10171;29598;9179;28125;299;1325;7698;23163;7997;24488
220793;201806;850;2310;704;2055;28;80;575;1686;603;1766
220795;201806;1426;3803;1285;3624;29;117;1142;3194;1171;3311
220800;201806;16588;41330;14019;37561;846;2295;9972;26332;10818;28627
220810;201806;2955;8522;2569;7817;56;231;2129;6348;2185;6579
220820;201806;5241;13849;4530;12840;427;1104;3370;9607;3797;10711
220830;201806;7148;19746;6482;18749;283;880;5362;15404;5645;16284
220840;201806;12554;39140;10786;35534;2287;7246;5492;18627;7779;25873
220850;201806;2995;9638;2743;9321;73;394;2447;8225;2520;8619
220855;201806;596;1693;519;1561;12;58;429;1266;441;1324
220860;201806;1007;2553;871;2339;16;52;780;2077;796;2129
220865;201806;2541;6869;1997;5927;59;224;1548;4459;1607;4683
220870;201806;2630;7986;2201;7396;28;143;2004;6701;2032;6844
220880;201806;5172;12910;4615;12228;74;253;4251;11187;4325;11440
220885;201806;1286;4318;1103;3992;52;269;852;3072;904;3341
220887;201806;1319;3128;1189;2948;7;30;1118;2738;1125;2768
220890;201806;1587;5148;1338;4664;100;353;991;3487;1091;3840
220900;201806;1996;5043;1681;4595;41;104;1452;3921;1493;4025
220910;201806;1511;4373;1274;4013;32;106;1090;3438;1122;3544
220915;201806;983;2675;794;2307;16;67;625;1753;641;1820
220920;201806;1407;4739;1203;4449;84;384;921;3369;1005;3753
220930;201806;1575;4620;1386;4327;30;114;1239;3818;1269;3932
220935;201806;1031;2981;815;2523;33;130;542;1551;575;1681
220937;201806;1360;3736;1186;3466;24;95;965;2752;989;2847
220940;201806;1375;4094;1152;3654;38;169;854;2620;892;2789
220945;201806;424;1490;377;1402;25;137;266;952;291;1089
220950;201806;1394;3320;918;2544;20;73;710;1898;730;1971
220955;201806;1558;4136;1361;3797;34;92;1159;3230;1193;3322
220960;201806;881;2241;679;1916;13;47;525;1448;538;1495
220965;201806;1746;4906;1561;4631;28;164;1341;3861;1369;4025
220970;201806;1792;4722;1396;4078;52;142;1116;3264;1168;3406
220975;201806;713;2189;625;2073;21;140;555;1749;576;1889
220980;201806;1199;3469;1078;3272;35;149;885;2638;920;2787
220985;201806;1191;3352;1082;3190;43;166;831;2341;874;2507
220987;201806;1483;4470;1284;4121;63;295;1042;3254;1105;3549
220990;201806;1737;4943;1499;4564;32;174;1210;3574;1242;3748
220995;201806;1202;3579;925;3100;57;231;654;2175;711;2406
220997;201806;2425;7132;2271;6906;59;240;2056;6170;2115;6410
221000;201806;4094;11882;3773;11383;114;535;3170;9334;3284;9869
221005;201806;1435;4070;1296;3812;70;229;1032;2924;1102;3153
221010;201806;1231;2996;1007;2718;25;64;877;2340;902;2404
221020;201806;1563;4877;1442;4635;36;166;1067;3371;1103;3537
221030;201806;1590;4350;1371;4034;36;152;1142;3311;1178;3463
221035;201806;1370;3763;1235;3583;26;53;1118;3324;1144;3377
221037;201806;585;1745;507;1604;11;56;349;1047;360;1103
221038;201806;523;1495;412;1286;17;57;290;896;307;953
221039;201806;886;2404;782;2237;19;84;656;1810;675;1894
221040;201806;4240;13026;3841;12321;171;600;3021;9702;3192;10302
221050;201806;3645;10122;3316;9698;60;236;3002;8705;3062;8941
221060;201806;8485;23799;7060;21514;282;901;5439;16870;5721;17771
221062;201806;1204;4053;1049;3753;47;242;812;2848;859;3090
221063;201806;1198;3553;1026;3284;72;270;737;2312;809;2582
221065;201806;2664;6975;2342;6422;35;120;2034;5487;2069;5607
221070;201806;3381;10811;2855;9777;238;834;1952;6730;2190;7564
221080;201806;3520;8688;2847;7672;63;244;2321;6158;2384;6402
221090;201806;1383;3725;1148;3309;17;71;992;2783;1009;2854
221093;201806;1428;4176;1323;3960;138;431;864;2511;1002;2942
221095;201806;890;2377;754;2159;5;15;628;1758;633;1773
221097;201806;822;2185;642;1848;25;81;465;1283;490;1364
221100;201806;104316;292031;90830;269103;14827;45227;53603;156434;68430;201661
221110;201806;10053;30647;9307;29659;214;1089;8178;25663;8392;26752
221120;201806;4248;12662;3913;12110;254;876;3233;9918;3487;10794
221130;201806;4858;13171;3731;10891;935;2679;1544;4553;2479;7232
221135;201806;1586;4434;1425;4214;42;150;1240;3629;1282;3779
221140;201806;1316;3197;1151;2968;9;34;1031;2609;1040;2643
221150;201806;1114;2801;875;2378;21;92;686;1758;707;1850
221160;201806;808;2025;717;1900;30;62;574;1520;604;1582
221170;201806;1071;3147;968;2980;19;58;788;2415;807;2473
230010;201806;3199;8660;2584;7569;148;491;1943;5594;2091;6085
230015;201806;2936;9870;2697;9393;257;1060;1825;6230;2082;7290
230020;201806;13219;42263;12660;41344;449;1844;10790;34818;11239;36662
230030;201806;12298;32764;10716;30499;225;765;9410;26674;9635;27439
230040;201806;4241;11356;3609;10299;117;457;2937;8263;3054;8720
230050;201806;2728;8783;2011;6957;421;1404;723;2514;1144;3918
230060;201806;2329;6531;1898;5696;47;191;1532;4496;1579;4687
230070;201806;3971;11093;3312;9751;179;604;2244;6645;2423;7249
230075;201806;9088;29938;8420;28723;388;1938;6844;22754;7232;24692
230080;201806;2727;6204;2159;5400;28;124;1916;4722;1944;4846
230090;201806;4066;10749;3507;9837;183;571;2665;7352;2848;7923
230100;201806;17709;48654;15886;45959;1679;5177;10466;30269;12145;35446
230110;201806;12177;37155;10764;34264;1939;6229;5785;18530;7724;24759
230120;201806;7501;20819;6583;19304;587;1572;4766;14244;5353;15816
230125;201806;3069;8436;2519;7504;90;336;1923;5672;2013;6008
230130;201806;5700;18077;4732;15949;446;1646;3071;10117;3517;11763
230140;201806;3497;10715;2966;9690;134;568;2170;6950;2304;7518
230150;201806;1609;4877;1357;4316;225;671;745;2454;970;3125
230160;201806;6399;17443;5554;16146;176;668;4612;13190;4788;13858
230170;201806;5989;17839;5164;16239;255;907;3781;11670;4036;12577
230180;201806;1624;4645;1381;4148;31;140;1074;3102;1105;3242
230185;201806;4036;12326;3506;11381;316;1163;2519;8160;2835;9323
230190;201806;13061;39383;11205;35782;1697;5587;5948;19069;7645;24656
230195;201806;5174;15489;4600;14492;306;1048;3582;11139;3888;12187
230200;201806;4892;13651;4257;12409;181;536;3330;9500;3511;10036
230205;201806;4050;12755;3646;12025;179;752;2719;8796;2898;9548
230210;201806;9680;25128;8262;23059;489;1556;6101;16868;6590;18424
230220;201806;13522;35842;12053;33458;533;1627;9850;26982;10383;28609
230230;201806;6924;21341;6217;19883;479;1576;4462;14185;4941;15761
230240;201806;12925;34842;11406;32372;415;1269;9253;25983;9668;27252
230250;201806;9163;27010;9029;26792;348;1269;7084;20502;7432;21771
230260;201806;14231;45120;12802;42223;1665;5707;7500;24961;9165;30668
230270;201806;7488;20974;6037;18249;573;1764;3971;12057;4544;13821
230280;201806;20466;56894;17188;51255;767;3050;13254;38242;14021;41292
230290;201806;4664;13525;4027;12193;409;1132;2899;8854;3308;9986
230300;201806;4362;12443;4112;12085;111;479;3596;10333;3707;10812
230310;201806;4788;13868;4077;12617;141;570;2904;8751;3045;9321
230320;201806;7557;22166;6592;20367;322;1273;5042;15286;5364;16559
230330;201806;4745;13319;3909;11687;184;555;2885;8502;3069;9057
230340;201806;3529;11332;3028;10289;286;1038;2048;6880;2334;7918
230350;201806;18660;53148;16666;49746;1079;3724;10769;32503;11848;36227
230360;201806;2918;8153;2327;7054;146;527;1591;4729;1737;5256
230365;201806;3054;7800;2575;7023;61;281;2154;5761;2215;6042
230370;201806;53900;159564;46591;147865;9519;30836;23083;75785;32602;106621
230380;201806;6498;18367;5196;15894;174;656;3718;11168;3892;11824
230390;201806;3322;10156;2901;9420;133;558;2182;6947;2315;7505
230393;201806;2960;9303;2499;8340;101;529;1902;6088;2003;6617
230395;201806;5728;15852;5019;14600;477;1328;3391;9992;3868;11320
230400;201806;5687;16261;5048;15169;168;766;3999;11634;4167;12400
230410;201806;14623;44413;11941;39077;1335;4479;7384;24296;8719;28775
230420;201806;25580;75738;21855;68551;2976;9910;12098;37601;15074;47511
230423;201806;4642;14018;4058;12835;127;547;3229;10026;3356;10573
230425;201806;5498;17534;5030;16527;504;1679;3459;11371;3963;13050
230426;201806;2551;6936;1942;5732;43;181;1485;4306;1528;4487
230427;201806;1825;5292;1273;4022;60;203;875;2654;935;2857
230428;201806;9678;27186;8617;25502;1250;3847;4987;14674;6237;18521
230430;201806;4530;13538;3850;12303;203;791;2851;8859;3054;9650
230435;201806;5546;15656;4755;14280;585;1802;2922;8776;3507;10578
230440;201806;392115;1038579;330761;940873;50729;150492;180151;510863;230880;661355
230445;201806;4372;11764;3675;10546;209;541;2552;7212;2761;7753
230450;201806;3529;10660;3096;9894;213;864;2221;6952;2434;7816
230460;201806;2043;6003;1779;5540;77;306;1438;4450;1515;4756
230465;201806;3951;11431;3349;10317;101;464;2452;7278;2553;7742
230470;201806;11222;38315;10240;36400;888;3809;7387;25837;8275;29646
230480;201806;1430;4308;1215;3889;112;444;875;2705;987;3149
230490;201806;2329;6821;2027;6240;201;626;1183;3534;1384;4160
230495;201806;5762;17705;5136;16538;436;1726;3348;10595;3784;12321
230500;201806;8502;29200;7952;28123;373;1605;6210;21920;6583;23525
230510;201806;1644;5336;1221;4325;222;834;501;1761;723;2595
230520;201806;4348;12922;3903;12060;297;973;2740;8343;3037;9316
230523;201806;15220;46239;12595;40536;2911;9498;3192;10743;6103;20241
230526;201806;3873;11331;3301;10278;147;631;2525;7652;2672;8283
230530;201806;5280;16577;4554;15266;444;1603;3188;10728;3632;12331
230533;201806;4102;10674;3510;9583;128;357;2836;7687;2964;8044
230535;201806;5537;15652;4689;14135;307;935;3213;9840;3520;10775
230540;201806;16229;45854;14502;43196;341;1409;12330;36190;12671;37599
230550;201806;20016;55756;16740;49878;1974;6236;9731;28817;11705;35053
230560;201806;7577;19877;6262;17548;105;412;5157;14246;5262;14658
230565;201806;3160;8720;2599;7714;82;325;1966;5750;2048;6075
230570;201806;3576;9222;3099;8586;74;218;2591;7135;2665;7353
230580;201806;9900;27820;8816;26221;357;1299;7356;21660;7713;22959
230590;201806;8875;26242;7375;23366;558;1958;5118;15754;5676;17712
230600;201806;3695;9910;2781;8110;91;297;1825;5396;1916;5693
230610;201806;6422;18665;5751;17602;474;1444;4324;13271;4798;14715
230620;201806;2090;5805;1603;4794;139;441;963;2798;1102;3239
230625;201806;8055;24292;7040;22241;2088;6850;1858;6107;3946;12957
230630;201806;10190;31652;9064;29328;2370;7178;3923;13666;6293;20844
230640;201806;26872;83713;24545;79855;1711;6460;19130;61627;20841;68087
230650;201806;4976;14229;4336;13023;268;896;3284;9669;3552;10565
230655;201806;9290;32712;8850;31910;650;2584;6912;25088;7562;27672
230660;201806;6316;18814;5180;16640;180;945;4168;13058;4348;14003
230670;201806;6075;15135;4552;12552;192;596;3538;9505;3730;10101
230680;201806;2551;7340;2186;6625;210;635;1455;4408;1665;5043
230690;201806;6435;19929;5858;18677;551;1955;3585;11192;4136;13147
230700;201806;9483;25413;8252;23109;346;1125;6200;16824;6546;17949
230710;201806;7091;22450;6178;20593;517;1841;4449;14691;4966;16532
230720;201806;1897;5761;1571;5057;128;416;1029;3249;1157;3665
230725;201806;3601;11653;3177;10658;636;2264;1339;4399;1975;6663
230730;201806;55822;158696;46115;142911;10896;36365;15782;51283;26678;87648
230740;201806;6043;17359;5340;16143;151;614;4264;12739;4415;13353
230750;201806;8323;23002;7018;20808;212;795;5459;15756;5671;16551
230760;201806;11383;31645;10174;29576;736;2430;7373;20920;8109;23350
230763;201806;4436;12905;3804;11710;172;701;2945;8729;3117;9430
230765;201806;40290;116927;34418;106473;7165;23226;13319;41558;20484;64784
230770;201806;25799;67951;22143;62797;2864;8532;13724;39017;16588;47549
230780;201806;5903;21392;5563;20686;911;3389;3236;12447;4147;15836
230790;201806;2955;8795;2658;8295;162;618;2013;6192;2175;6810
230800;201806;7754;25788;6982;24140;878;3371;3989;13588;4867;16959
230810;201806;11792;36193;10675;34312;492;1930;8198;25826;8690;27756
230820;201806;3204;10642;2752;9649;285;1170;1668;5649;1953;6819
230830;201806;7485;21492;6439;19564;180;776;5167;15360;5347;16136
230835;201806;4067;10020;3180;8610;114;368;2573;6812;2687;7180
230837;201806;3160;10165;2699;9256;147;708;2012;6673;2159;7381
230840;201806;8952;27235;7854;25354;541;1898;5976;19266;6517;21164
230850;201806;9163;27612;8108;25544;512;1832;5751;17960;6263;19792
230860;201806;5112;13665;4325;12477;147;511;3641;10375;3788;10886
230870;201806;17218;43338;14857;39614;549;1566;11668;30932;12217;32498
230880;201806;2032;6422;1873;6146;69;358;1450;4600;1519;4958
230890;201806;4430;14779;4090;14119;352;1329;2905;9918;3257;11247
230900;201806;3040;9273;2558;8277;261;894;1609;5081;1870;5975
230910;201806;3060;8593;2486;7588;92;427;1946;5810;2038;6237
230920;201806;4548;12929;4057;12201;156;613;3353;9977;3509;10590
230930;201806;6578;19209;5544;17163;420;1368;3663;11250;4083;12618
230940;201806;7806;21090;6907;19639;222;670;5692;16091;5914;16761
230945;201806;6536;19087;5671;17341;407;1341;3858;11822;4265;13163
230950;201806;6381;16401;5810;15698;142;328;5171;14239;5313;14567
230960;201806;13705;41224;12355;38585;2032;6447;6046;19201;8078;25648
230970;201806;13517;38342;11632;35196;2138;6730;5589;16970;7727;23700
230980;201806;2756;8234;2373;7550;506;1545;1292;4295;1798;5840
230990;201806;1717;4944;1421;4343;77;323;975;2853;1052;3176
231000;201806;2501;6749;2093;5910;80;223;1489;4128;1569;4351
231010;201806;3094;7956;2543;7026;132;446;2002;5366;2134;5812
231020;201806;8054;26201;7353;24655;1311;4178;4236;14737;5547;18915
231025;201806;7452;21644;6610;20200;960;2972;4274;13168;5234;16140
231030;201806;6980;21612;5665;18774;990;3292;2967;9828;3957;13120
231040;201806;3171;9350;2731;8524;104;431;2085;6353;2189;6784
231050;201806;11854;31717;9557;27594;660;1845;6996;19909;7656;21754
231060;201806;2453;7450;2245;7092;86;342;1806;5670;1892;6012
231070;201806;8215;24530;7051;22367;1005;3279;4022;12786;5027;16065
231080;201806;3946;11798;3545;11060;130;658;2729;8194;2859;8852
231085;201806;5784;15775;5087;14885;333;959;3822;11365;4155;12324
231090;201806;4210;11422;3212;9397;119;453;2232;6342;2351;6795
231095;201806;2046;6397;1727;5663;157;576;1186;3832;1343;4408
231100;201806;3003;9046;2540;8179;146;495;1878;6029;2024;6524
231110;201806;3410;10665;3301;10474;168;655;2425;7539;2593;8194
231120;201806;2012;6278;1754;5802;124;458;1182;3869;1306;4327
231123;201806;1887;5044;1602;4516;77;224;1206;3347;1283;3571
231126;201806;5786;16315;4632;14046;221;773;3321;9837;3542;10610
231130;201806;19451;54739;16919;51094;1641;5647;11474;34631;13115;40278
231135;201806;4221;12068;3539;10795;169;613;2533;7578;2702;8191
231140;201806;17236;50359;14296;44950;866;3504;9662;29438;10528;32942
231150;201806;5399;15411;4468;13532;740;2194;2111;6549;2851;8743
231160;201806;5870;18629;5378;17653;1126;3505;2860;9754;3986;13259
231170;201806;4301;13039;3555;11493;239;883;2410;7553;2649;8436
231180;201806;13875;40741;11859;36315;2678;8290;4889;14931;7567;23221
231190;201806;3867;11192;3378;10287;150;610;2585;7576;2735;8186
231195;201806;4542;14610;3902;13235;211;927;2879;9485;3090;10412
231200;201806;7833;25293;6814;23141;266;1303;5152;16932;5418;18235
231210;201806;4721;14466;4094;13359;209;836;3068;9772;3277;10608
231220;201806;11782;31908;9532;27524;549;1648;6854;19245;7403;20893
231230;201806;9150;29403;8204;27845;568;2193;6036;20571;6604;22764
231240;201806;11664;35184;10440;32667;1782;5582;5890;18619;7672;24201
231250;201806;1981;5318;1345;3864;100;294;772;2167;872;2461
231260;201806;3210;9520;2837;8899;328;1010;1863;5964;2191;6974
231270;201806;6539;17426;5569;15845;169;686;4255;11824;4424;12510
231280;201806;1667;5323;1559;5107;145;489;1116;3650;1261;4139
231290;201806;36485;113010;31874;103324;5586;18602;14807;47640;20393;66242
231300;201806;3992;11429;3232;9870;262;852;2089;6258;2351;7110
231310;201806;7326;19980;5970;17255;653;1855;3767;10756;4420;12611
231320;201806;7433;21294;5950;18425;133;585;4572;13947;4705;14532
231325;201806;2538;7205;2137;6537;388;1156;1156;3606;1544;4762
231330;201806;10261;31904;8617;28484;1687;5523;4283;14502;5970;20025
231335;201806;5655;15162;4799;13706;110;499;4115;11504;4225;12003
231340;201806;17736;55891;15997;52949;1107;3892;11934;39733;13041;43625
231350;201806;15468;43150;14063;41177;355;1227;12519;36499;12874;37726
231355;201806;4529;13910;4049;13059;226;841;3066;9824;3292;10665
231360;201806;7529;23268;6577;21592;499;1744;4760;15681;5259;17425
231370;201806;2301;6242;1830;5410;44;136;1397;4090;1441;4226
231375;201806;4313;13838;3948;13156;135;618;3241;10639;3376;11257
231380;201806;5798;16078;5384;15556;198;490;4550;13435;4748;13925
231390;201806;3335;10028;3003;9454;191;711;2158;6617;2349;7328
231395;201806;3947;12081;3327;11028;616;2045;1786;6017;2402;8062
231400;201806;8992;26759;8040;24928;371;1469;6208;18882;6579;20351
231410;201806;15060;47456;13399;44701;837;3096;10304;34011;11141;37107
240010;201806;2520;7014;1958;5946;194;700;1212;3548;1406;4248
240020;201806;11151;33096;9739;30426;977;3416;6138;18934;7115;22350
240030;201806;2665;7061;2504;6820;139;396;2162;5843;2301;6239
240040;201806;849;2432;697;2132;13;68;511;1499;524;1567
240050;201806;3319;8933;2720;7840;63;201;2121;5997;2184;6198
240060;201806;1402;3853;1191;3455;37;127;948;2694;985;2821
240070;201806;2228;6709;2046;6325;212;681;1487;4522;1699;5203
240080;201806;2822;7731;2417;7053;81;305;1845;5317;1926;5622
240090;201806;2251;5752;1841;5035;31;100;1496;4029;1527;4129
240100;201806;8947;23449;7409;20535;401;1239;5592;15033;5993;16272
240110;201806;4456;13349;3895;12277;304;1094;2651;8212;2955;9306
240120;201806;3627;10021;2698;8909;233;900;1717;5837;1950;6737
240130;201806;3341;7486;2860;6782;62;183;2567;5972;2629;6155
240140;201806;2130;6382;1798;5745;185;695;1151;3610;1336;4305
240145;201806;6192;18179;5278;16586;771;2580;3237;10257;4008;12837
240150;201806;872;2665;788;2485;58;212;594;1804;652;2016
240160;201806;1428;4406;1227;4007;72;297;868;2844;940;3141
240165;201806;912;2637;780;2372;83;235;552;1679;635;1914
240170;201806;2363;6762;2016;6132;226;753;1277;3775;1503;4528
240180;201806;3091;9039;2478;7857;458;1442;1338;4377;1796;5819
240185;201806;1266;4162;1144;3962;65;278;926;3187;991;3465
240190;201806;989;3008;875;2814;24;116;721;2272;745;2388
240200;201806;11022;29670;9249;26578;1359;4034;4550;13081;5909;17115
240210;201806;2850;7621;2557;7130;55;226;2132;5744;2187;5970
240220;201806;7251;23198;6591;22172;517;2140;4830;16097;5347;18237
240230;201806;5881;15169;4814;13393;250;678;3807;10591;4057;11269
240240;201806;2135;7189;1441;5390;142;474;638;2664;780;3138
240250;201806;2773;7761;2535;7417;142;381;2063;6065;2205;6446
240260;201806;13181;40842;11698;38261;1726;5570;7104;24126;8830;29696
240270;201806;2255;6818;2034;6472;119;329;1608;5236;1727;5565
240280;201806;1626;4290;1402;3955;45;130;1154;3207;1199;3337
240290;201806;1201;3607;1002;3177;35;173;683;2020;718;2193
240300;201806;2253;5914;1627;4689;93;295;978;2717;1071;3012
240310;201806;9179;24922;7660;22278;927;2797;4111;11888;5038;14685
240320;201806;1978;5526;1491;4555;26;124;1131;3294;1157;3418
240325;201806;30783;85505;24185;73940;6253;20047;6912;22116;13165;42163
240330;201806;1519;4410;1245;3852;50;181;860;2556;910;2737
240340;201806;1976;4856;1585;4246;67;167;1238;3244;1305;3411
240350;201806;2067;5567;1918;5387;32;113;1697;4781;1729;4894
240360;201806;7593;22257;6738;20883;1219;3716;3821;12399;5040;16115
240370;201806;2050;5524;1594;4620;103;310;1052;2999;1155;3309
240375;201806;882;2306;758;2066;33;136;585;1500;618;1636
240380;201806;2319;6709;1678;5257;155;502;970;2981;1125;3483
240390;201806;939;2474;696;1969;10;32;484;1291;494;1323
240400;201806;1371;3729;1105;3219;35;128;791;2234;826;2362
240410;201806;534;1701;461;1531;50;199;285;914;335;1113
240420;201806;4646;17134;4208;16128;624;2856;2242;8402;2866;11258
240430;201806;3320;9133;2885;8279;223;752;2094;5799;2317;6551
240440;201806;2576;6024;2172;5450;179;446;1591;3929;1770;4375
240450;201806;4161;11815;3408;10415;366;1258;2006;5957;2372;7215
240460;201806;3037;8825;2800;8470;239;786;2217;6677;2456;7463
240470;201806;3612;11084;2843;9477;381;1283;1601;5369;1982;6652
240480;201806;551;1513;399;1210;35;113;190;569;225;682
240485;201806;2129;6327;1781;5629;191;608;1110;3538;1301;4146
240490;201806;1768;4429;1427;3836;47;106;1171;3155;1218;3261
240500;201806;2206;5990;1931;5601;56;188;1635;4711;1691;4899
240510;201806;1680;4601;1539;4393;91;283;1279;3580;1370;3863
240520;201806;1300;3419;1081;3112;38;160;893;2491;931;2651
240530;201806;1898;5996;1761;5741;107;394;1379;4436;1486;4830
240540;201806;2132;5556;1903;5212;81;241;1626;4428;1707;4669
240550;201806;690;1951;614;1808;35;113;462;1330;497;1443
240560;201806;3339;8999;2879;8387;301;754;2097;6244;2398;6998
240570;201806;2976;7964;2046;5887;273;839;918;2398;1191;3237
240580;201806;7628;22837;7001;21758;533;1791;5588;17284;6121;19075
240590;201806;696;1888;604;1721;17;60;462;1296;479;1356
240600;201806;1725;4773;1282;3855;86;298;817;2365;903;2663
240610;201806;4542;12629;3832;11313;198;655;2734;7924;2932;8579
240615;201806;1046;2978;839;2543;77;268;550;1586;627;1854
240620;201806;1849;5344;1591;4877;118;324;1258;3857;1376;4181
240630;201806;2066;6093;1850;5712;147;384;1260;4007;1407;4391
240640;201806;905;2530;734;2239;38;165;518;1523;556;1688
240650;201806;3942;11228;3512;10511;201;600;2735;8146;2936;8746
240660;201806;2686;7515;2421;7162;71;264;2149;6262;2220;6526
240670;201806;2478;7196;2051;6303;171;582;1286;3833;1457;4415
240680;201806;1598;4438;1282;3864;57;211;931;2720;988;2931
240690;201806;905;2363;721;2036;21;77;576;1571;597;1648
240700;201806;2468;7207;2042;6420;69;291;1579;4839;1648;5130
240710;201806;16097;43166;13772;39055;2568;7124;7457;21519;10025;28643
240720;201806;5338;14074;4647;12960;653;1921;2909;7913;3562;9834
240725;201806;1046;3095;821;2590;38;133;550;1678;588;1811
240730;201806;2118;6089;1788;5443;101;337;1352;4035;1453;4372
240740;201806;1890;5221;1582;4640;57;245;1156;3194;1213;3439
240750;201806;2306;7861;1962;7134;342;1338;1015;3725;1357;5063
240760;201806;1470;3709;1049;3043;63;153;795;2341;858;2494
240770;201806;3058;8745;2698;8227;130;502;2215;6624;2345;7126
240780;201806;5772;15633;4526;13570;572;1691;2646;8165;3218;9856
240790;201806;837;2450;702;2183;22;88;522;1598;544;1686
240800;201806;36841;99254;31370;90350;4889;14768;15161;43570;20050;58338
240810;201806;82705;227823;73478;211732;15636;45069;36954;107448;52590;152517
240820;201806;5609;17332;4902;16104;919;3076;2627;8910;3546;11986
240830;201806;8731;25889;8020;24778;313;1302;6576;19959;6889;21261
240840;201806;1131;2953;922;2582;72;209;635;1713;707;1922
240850;201806;1292;3719;938;2904;58;192;528;1614;586;1806
240860;201806;1236;3424;953;2887;25;108;717;2079;742;2187
240870;201806;1163;2985;915;2565;79;231;618;1693;697;1924
240880;201806;1284;4101;1192;3928;81;298;949;3101;1030;3399
240890;201806;4701;13101;3679;11093;622;1988;1721;5071;2343;7059
240895;201806;2711;8875;2433;8451;209;758;1916;6685;2125;7443
240910;201806;3132;8962;2693;8081;66;252;2213;6528;2279;6780
240920;201806;823;2529;700;2281;82;280;374;1221;456;1501
240930;201806;3633;8731;3098;8068;131;214;2458;6586;2589;6800
240933;201806;1905;4610;1560;4074;48;176;1289;3276;1337;3452
240940;201806;6346;15880;5031;13680;303;895;3588;9459;3891;10354
240950;201806;935;2931;831;2714;36;161;647;2060;683;2221
240960;201806;778;2379;676;2173;45;167;487;1530;532;1697
240970;201806;1777;4832;1487;4285;63;256;1208;3341;1271;3597
240980;201806;2969;9396;2700;8888;230;860;1968;6382;2198;7242
240990;201806;2544;7513;2334;7074;289;938;1630;4848;1919;5786
241000;201806;954;2575;785;2253;40;111;546;1558;586;1669
241010;201806;2734;8982;2542;8584;232;933;1809;5944;2041;6877
241020;201806;2028;5512;1519;4464;161;446;932;2712;1093;3158
241025;201806;1725;5045;1418;4457;86;292;918;2872;1004;3164
241030;201806;2431;7809;2029;6960;202;721;1346;4607;1548;5328
241040;201806;2272;7339;2033;6937;114;509;1581;5369;1695;5878
241050;201806;1292;3681;1065;3245;42;138;779;2326;821;2464
241060;201806;749;2130;661;1956;47;146;452;1320;499;1466
241070;201806;665;1858;582;1712;28;104;461;1290;489;1394
241080;201806;1125;3242;869;2734;16;74;636;1959;652;2033
241090;201806;2065;6043;1653;5320;60;284;1288;4080;1348;4364
241100;201806;1111;3235;921;2804;45;144;639;1882;684;2026
241105;201806;1112;3368;932;3024;269;890;315;1048;584;1938
241110;201806;869;2577;677;2144;28;110;447;1361;475;1471
241120;201806;7271;21395;6358;19758;1290;3818;3326;10946;4616;14764
241140;201806;3283;8753;2693;7593;155;450;1976;5414;2131;5864
241142;201806;750;2089;563;1708;36;122;335;975;371;1097
241150;201806;5657;15605;5017;14526;200;748;3985;11276;4185;12024
241160;201806;1576;4748;1385;4434;150;425;1000;3258;1150;3683
241170;201806;1268;3342;1118;3083;50;166;913;2418;963;2584
241180;201806;980;2629;720;2107;65;186;408;1170;473;1356
241190;201806;1140;3073;926;2635;26;104;666;1808;692;1912
241200;201806;19322;52230;16534;47973;3409;10061;8068;23842;11477;33903
241210;201806;1415;3912;1080;3230;100;314;644;1898;744;2212
241220;201806;8713;26874;7658;24996;2180;7176;3112;10688;5292;17864
241230;201806;2925;8064;2640;7591;104;385;2191;6130;2295;6515
241240;201806;1184;3449;702;2295;44;178;347;1128;391;1306
241250;201806;5748;17215;4715;15206;208;1017;3464;10693;3672;11710
241255;201806;1915;6551;1700;6067;152;644;1151;4014;1303;4658
241260;201806;4892;13122;3888;11426;96;436;2970;8494;3066;8930
241270;201806;1801;5344;1530;4803;132;480;1085;3349;1217;3829
241280;201806;2001;5341;1785;4957;79;230;1483;4076;1562;4306
241290;201806;3278;8404;2558;7194;97;362;1974;5391;2071;5753
241300;201806;1450;4029;1206;3571;44;153;811;2340;855;2493
241310;201806;1897;5126;1660;4753;34;118;1405;4005;1439;4123
241320;201806;996;3261;832;2915;105;408;501;1750;606;2158
241330;201806;1738;4580;1383;4141;39;167;1183;3516;1222;3683
241335;201806;2983;8606;2694;8081;90;309;2275;6735;2365;7044
241340;201806;1729;5149;1380;4354;289;931;585;1807;874;2738
241350;201806;1917;5779;1716;5396;105;371;1283;3952;1388;4323
241355;201806;1335;3700;1090;3238;32;126;842;2472;874;2598
241360;201806;2084;5474;1642;4602;65;197;1182;3204;1247;3401
241370;201806;1359;3863;1075;3287;83;286;693;2018;776;2304
241380;201806;672;1875;540;1613;64;196;332;973;396;1169
241390;201806;2711;8407;2484;8033;224;716;1877;6109;2101;6825
241400;201806;3651;10263;3270;9708;212;678;2593;7645;2805;8323
241410;201806;2343;7111;2007;6477;398;1345;1069;3442;1467;4787
241415;201806;1628;4867;1371;4387;101;343;985;3100;1086;3443
241420;201806;2232;7491;1932;6919;529;2027;699;2520;1228;4547
241430;201806;521;1515;394;1237;31;107;244;742;275;849
241440;201806;7026;23099;6337;21835;487;1963;4770;16249;5257;18212
241445;201806;1033;2809;955;2716;21;48;867;2525;888;2573
241450;201806;2877;7372;2545;6869;277;679;1855;5053;2132;5732
241460;201806;3548;9959;3013;8810;197;645;2104;5977;2301;6622
241470;201806;1436;3825;1141;3395;45;162;929;2736;974;2898
241475;201806;1219;3560;965;3054;29;164;702;2109;731;2273
241480;201806;2740;8813;2386;8094;853;2889;648;2545;1501;5434
241490;201806;703;1773;555;1543;27;89;358;949;385;1038
241500;201806;823;2433;691;2262;19;86;587;1904;606;1990
250010;201806;2737;8296;2255;7246;80;328;1622;5055;1702;5383
250020;201806;1574;4360;1162;3554;55;158;818;2460;873;2618
250030;201806;6856;19237;6191;18237;359;1162;4935;14279;5294;15441
250040;201806;3907;12593;3535;11849;273;1042;2519;8310;2792;9352
250050;201806;3418;9887;3141;9466;210;746;2472;7326;2682;8072
250053;201806;1206;3527;1089;3347;86;281;786;2422;872;2703
250057;201806;660;2441;633;2404;8;43;594;2278;602;2321
250060;201806;5253;14613;4792;14006;419;1195;3758;11111;4177;12306
250070;201806;3863;11412;3515;10769;54;271;2704;8006;2758;8277
250073;201806;778;2199;646;1980;9;35;498;1469;507;1504
250077;201806;2204;6123;1660;5191;97;325;1193;3706;1290;4031
250080;201806;4340;11801;3948;11227;114;415;3347;9349;3461;9764
250090;201806;2801;7398;2562;7038;99;263;2166;5905;2265;6168
250100;201806;3792;11861;3505;11326;156;626;2858;8988;3014;9614
250110;201806;4757;13707;4388;13153;391;1383;3417;9964;3808;11347
250115;201806;532;1554;466;1442;11;56;345;1030;356;1086
250120;201806;1714;5303;1498;4933;56;258;1179;3839;1235;4097
250130;201806;5403;15771;4649;14548;111;592;3738;11468;3849;12060
250135;201806;1119;3204;1023;3050;14;59;893;2643;907;2702
250140;201806;2085;6526;2007;6408;83;390;1722;5408;1805;5798
250150;201806;4764;15649;4358;14858;176;881;3422;11364;3598;12245
250153;201806;1494;3875;1242;3510;34;137;1007;2786;1041;2923
250157;201806;1788;5516;1603;5124;157;496;1155;3695;1312;4191
250160;201806;3788;9846;3088;8887;37;118;2818;8102;2855;8220
250170;201806;1709;4629;1519;4337;49;175;1277;3598;1326;3773
250180;201806;17445;46467;15596;43915;980;3133;11765;32423;12745;35556
250190;201806;4058;11360;3585;10589;454;1236;2385;7038;2839;8274
250200;201806;1859;5332;1567;4860;53;183;1308;4031;1361;4214
250205;201806;777;2631;728;2533;22;120;593;2033;615;2153
250210;201806;1532;4727;1396;4500;45;218;1108;3494;1153;3712
250215;201806;1523;4461;1298;4085;66;217;801;2512;867;2729
250220;201806;703;2023;573;1824;27;95;423;1322;450;1417
250230;201806;1639;3891;1219;3229;30;96;962;2457;992;2553
250240;201806;2174;6872;1992;6546;50;197;1682;5461;1732;5658
250250;201806;4482;12962;3960;12202;109;387;3291;10101;3400;10488
250260;201806;1692;4817;1434;4362;46;147;1132;3447;1178;3594
250270;201806;1234;3782;1093;3607;80;262;803;2769;883;3031
250280;201806;3301;9547;2863;8841;124;413;2257;6943;2381;7356
250290;201806;1698;4534;1442;4173;19;48;1194;3448;1213;3496
250300;201806;5343;14988;5017;14586;233;986;4224;11900;4457;12886
250310;201806;1153;3296;991;2996;41;130;745;2212;786;2342
250320;201806;9816;25893;8848;24652;565;1730;7295;20088;7860;21818
250330;201806;2377;6985;2009;6445;130;419;1565;4979;1695;5398
250340;201806;1096;3005;968;2814;13;45;832;2384;845;2429
250350;201806;4101;11357;3711;10824;146;378;3132;9286;3278;9664
250355;201806;1955;6092;1790;5870;25;141;1622;5288;1647;5429
250360;201806;1813;5165;1667;4929;40;130;1374;4046;1414;4176
250370;201806;12021;33158;10424;30958;448;1627;8607;25248;9055;26875
250375;201806;1066;3014;947;2850;18;72;847;2559;865;2631
250380;201806;1635;4410;1520;4259;47;181;1257;3383;1304;3564
250390;201806;1832;4801;1514;4284;188;505;1009;2889;1197;3394
250400;201806;68984;177718;51030;148725;13595;41458;16333;48980;29928;90438
250403;201806;1610;4929;1472;4751;129;571;1060;3293;1189;3864
250407;201806;1232;3212;1046;2929;77;150;768;2184;845;2334
250410;201806;571;1667;502;1542;10;59;417;1239;427;1298
250415;201806;1895;5492;1683;5133;64;227;1325;4017;1389;4244
250420;201806;1237;3580;1117;3414;20;77;1031;3150;1051;3227
250430;201806;6273;16043;5452;14857;179;560;4486;11958;4665;12518
250435;201806;1383;4061;1214;3768;37;152;935;2840;972;2992
250440;201806;4487;12383;3992;11700;90;314;3406;9887;3496;10201
250450;201806;1842;5089;1564;4713;40;157;1279;3796;1319;3953
250460;201806;7035;19695;6400;18845;365;1086;5383;15926;5748;17012
250470;201806;1559;4038;1279;3634;73;234;958;2649;1031;2883
250480;201806;3743;10857;3408;10429;40;171;3090;9503;3130;9674
250485;201806;697;1627;503;1351;28;73;378;976;406;1049
250490;201806;4475;11967;4087;11486;246;806;3387;9407;3633;10213
250500;201806;1937;5499;1708;5114;83;263;1377;4103;1460;4366
250510;201806;5270;13693;4590;12773;74;227;4113;11460;4187;11687
250520;201806;1820;5132;1590;4787;175;563;1049;3110;1224;3673
250523;201806;2069;5375;1895;5157;70;312;1645;4329;1715;4641
250527;201806;1627;4406;1507;4258;37;120;1361;3833;1398;3953
250530;201806;602;1719;525;1610;17;67;458;1390;475;1457
250535;201806;1335;4031;1229;3823;37;173;979;2962;1016;3135
250540;201806;2663;6718;2271;6267;56;162;1988;5480;2044;5642
250550;201806;841;2766;757;2624;28;135;592;1994;620;2129
250560;201806;1656;4809;1519;4609;57;201;1237;3661;1294;3862
250570;201806;2557;7833;2234;7235;80;365;1772;5579;1852;5944
250580;201806;1059;2765;951;2610;51;179;785;2115;836;2294
250590;201806;827;2431;736;2290;21;99;611;1855;632;1954
250600;201806;7305;20390;6631;19370;362;985;5499;16126;5861;17111
250610;201806;2995;8569;2744;8191;149;519;2248;6639;2397;7158
250620;201806;706;1988;614;1809;24;97;469;1342;493;1439
250625;201806;2516;7494;2321;7189;55;247;1972;5968;2027;6215
250630;201806;9664;28102;8302;25524;1084;3507;5149;15450;6233;18957
250640;201806;3325;9800;3094;9481;96;437;2604;7795;2700;8232
250650;201806;906;2289;759;2091;37;113;612;1632;649;1745
250660;201806;1660;4254;1473;3999;46;116;1278;3433;1324;3549
250670;201806;2277;7290;2143;7056;46;249;1859;5973;1905;6222
250680;201806;5573;13577;5101;13041;128;434;4642;11659;4770;12093
250690;201806;6444;15460;5859;14713;156;372;5305;13238;5461;13610
250700;201806;4326;12525;3883;11814;373;1172;2887;8683;3260;9855
250710;201806;4507;13234;3915;12427;330;1184;2822;8977;3152;10161
250720;201806;2728;7368;2478;6983;43;185;2221;6191;2264;6376
250730;201806;3882;10679;3455;10111;157;575;2879;8201;3036;8776
250740;201806;1954;5186;1620;4706;123;392;1269;3604;1392;3996
250750;201806;98903;261632;87293;244642;8529;25921;59762;164024;68291;189945
250760;201806;2349;6233;2048;5764;126;374;1586;4360;1712;4734
250770;201806;3767;12029;3446;11611;264;1051;2533;8439;2797;9490
250780;201806;1721;4834;1447;4318;111;375;1026;2984;1137;3359
250790;201806;2371;7350;2142;6987;287;977;1355;4459;1642;5436
250800;201806;2515;6813;2156;6230;108;241;1751;5088;1859;5329
250810;201806;1278;3565;1056;3231;35;118;864;2646;899;2764
250820;201806;1818;5592;1750;5502;63;254;1572;4897;1635;5151
250830;201806;5349;16683;4766;15478;353;1384;3361;10640;3714;12024
250840;201806;842;2703;723;2450;16;73;505;1720;521;1793
250850;201806;1878;5668;1670;5313;41;223;1370;4222;1411;4445
250855;201806;1013;2977;871;2726;70;253;619;1893;689;2146
250860;201806;3212;9908;2648;8900;463;1633;1376;4684;1839;6317
250870;201806;1061;2952;903;2655;40;148;726;2100;766;2248
250880;201806;1545;4115;1260;3692;148;434;844;2499;992;2933
250890;201806;9448;26800;8829;25940;606;2332;7090;20132;7696;22464
250900;201806;2732;8199;2364;7498;89;317;1921;5986;2010;6303
250905;201806;2190;6454;2065;6280;69;267;1838;5543;1907;5810
250910;201806;5439;14560;4687;13599;121;433;3985;11573;4106;12006
250915;201806;1838;4680;1424;4252;22;57;1310;3992;1332;4049
250920;201806;3185;8736;2941;8340;307;812;2170;6087;2477;6899
250930;201806;2112;5921;1959;5699;79;302;1646;4686;1725;4988
250933;201806;1130;3547;1002;3293;33;160;740;2358;773;2518
250937;201806;698;1986;578;1767;28;98;439;1334;467;1432
250939;201806;1657;4618;1467;4318;49;196;1189;3408;1238;3604
250940;201806;3789;10781;3480;10293;59;242;3044;8970;3103;9212
250950;201806;1512;4110;1263;3785;29;125;1100;3267;1129;3392
250960;201806;1062;3230;971;3082;38;171;780;2393;818;2564
250970;201806;8418;22639;7224;20675;422;1353;5442;15318;5864;16671
250980;201806;2524;7005;2280;6561;56;226;1858;5184;1914;5410
250990;201806;1887;6131;1649;5624;88;407;1221;4073;1309;4480
251000;201806;2100;5972;1741;5398;33;145;1453;4463;1486;4608
251010;201806;2610;7554;2355;7145;32;128;2124;6453;2156;6581
251020;201806;1690;4567;1556;4402;42;126;1425;4016;1467;4142
251030;201806;1008;2781;867;2504;44;138;607;1701;651;1839
251040;201806;1815;5372;1571;4954;58;284;1263;3858;1321;4142
251050;201806;1117;3097;918;2715;72;226;653;1851;725;2077
251060;201806;1075;2360;783;1975;11;52;635;1552;646;1604
251065;201806;450;1272;369;1160;19;71;256;745;275;816
251070;201806;748;2095;646;1961;14;53;555;1665;569;1718
251080;201806;19169;50787;15984;45974;2333;6998;9482;27494;11815;34492
251090;201806;2838;8378;2418;7572;82;316;1877;5792;1959;6108
251100;201806;856;2669;757;2494;33;165;537;1678;570;1843
251110;201806;1726;4846;1493;4398;52;142;1141;3327;1193;3469
251120;201806;6744;20765;6005;19690;302;1276;4639;15061;4941;16337
251130;201806;3686;9003;3354;8630;210;554;2996;7699;3206;8253
251140;201806;4238;12227;3860;11679;108;440;3162;9475;3270;9915
251150;201806;2690;8062;2450;7691;119;498;1961;6001;2080;6499
251160;201806;1986;6215;1811;5937;87;304;1539;5048;1626;5352
251170;201806;1514;4326;1371;4161;42;148;1220;3697;1262;3845
251180;201806;2558;7252;2198;6724;198;682;1457;4400;1655;5082
251190;201806;4438;11811;4159;11478;67;287;3787;10233;3854;10520
251200;201806;4067;12653;3767;12266;86;362;3337;10907;3423;11269
251203;201806;953;3129;907;3033;37;162;688;2232;725;2394
251207;201806;1033;3062;840;2705;25;130;582;1804;607;1934
251210;201806;7333;19811;6155;18291;295;857;4906;14721;5201;15578
251220;201806;1132;2881;921;2591;44;114;726;2060;770;2174
251230;201806;4650;12832;4108;12070;164;590;3402;9776;3566;10366
251240;201806;3444;9862;2959;9150;185;621;2219;6725;2404;7346
251250;201806;9954;27937;8985;26456;823;2618;6452;18416;7275;21034
251260;201806;463;1431;418;1346;15;63;321;1014;336;1077
251270;201806;4142;13192;3724;12653;112;502;3190;10851;3302;11353
251272;201806;1318;3661;1219;3514;39;148;1079;3078;1118;3226
251274;201806;895;2616;734;2326;43;178;509;1530;552;1708
251275;201806;1233;3516;1080;3261;42;169;794;2289;836;2458
251276;201806;1259;3464;1143;3313;46;197;942;2650;988;2847
251278;201806;571;1675;513;1562;45;121;367;1136;412;1257
251280;201806;2264;6426;2033;6059;50;217;1645;4749;1695;4966
251290;201806;5644;14574;5305;14139;295;1049;4444;11408;4739;12457
251300;201806;779;2450;729;2370;15;58;612;1987;627;2045
251310;201806;2786;8139;2538;7757;81;370;2039;6082;2120;6452
251315;201806;1629;5283;1513;5082;82;299;1180;3908;1262;4207
251320;201806;1707;4588;1215;3748;41;146;860;2644;901;2790
251330;201806;1936;4793;1591;4372;37;139;1446;3955;1483;4094
251335;201806;1170;3937;1075;3784;36;162;897;3109;933;3271
251340;201806;3498;9343;2922;8575;124;415;2218;6441;2342;6856
251350;201806;1099;3351;1003;3187;33;150;817;2513;850;2663
251360;201806;1805;5304;1498;4880;24;114;1284;4199;1308;4313
251365;201806;730;2111;584;1796;13;47;448;1368;461;1415
251370;201806;22516;65142;21062;63103;2223;7103;15011;44749;17234;51852
251380;201806;1228;3648;1081;3401;23;109;910;2761;933;2870
251385;201806;728;1900;572;1626;23;69;421;1138;444;1207
251390;201806;6105;19109;5321;17651;900;3172;2950;9671;3850;12843
251392;201806;982;2786;837;2538;29;127;632;1864;661;1991
251394;201806;634;1998;538;1829;21;82;414;1396;435;1478
251396;201806;726;2013;628;1850;33;92;424;1227;457;1319
251398;201806;904;2435;685;2053;23;95;488;1410;511;1505
251400;201806;1161;3084;956;2805;33;121;715;2030;748;2151
251410;201806;1632;3954;1339;3516;22;86;1120;2852;1142;2938
251420;201806;1893;5176;1574;4806;55;227;1237;3685;1292;3912
251430;201806;1552;4958;1380;4679;43;213;1185;3969;1228;4182
251440;201806;1105;3234;903;2837;20;73;724;2263;744;2336
251445;201806;1517;4431;1416;4288;75;300;1158;3392;1233;3692
251450;201806;4427;13433;4035;12884;88;385;3358;10624;3446;11009
251455;201806;977;3027;880;2838;47;200;650;2053;697;2253
251460;201806;882;2596;787;2442;30;105;638;2000;668;2105
251465;201806;443;1358;372;1202;15;70;278;878;293;948
251470;201806;1159;3273;888;2701;75;239;538;1578;613;1817
251480;201806;912;2490;781;2276;21;96;580;1627;601;1723
251490;201806;1857;5146;1523;4658;75;253;1071;3241;1146;3494
251500;201806;1761;5387;1664;5214;74;290;1426;4407;1500;4697
251510;201806;2431;7866;2166;7301;184;726;1418;4659;1602;5385
251520;201806;952;2566;725;2097;73;197;459;1314;532;1511
251530;201806;13179;33572;11527;31436;140;678;10275;27582;10415;28260
251540;201806;2793;8534;2574;8124;120;452;2046;6317;2166;6769
251550;201806;3597;8936;2893;8014;74;234;2424;6689;2498;6923
251560;201806;601;1834;539;1734;89;307;328;1014;417;1321
251570;201806;907;2649;753;2336;18;80;563;1675;581;1755
251580;201806;1892;4792;1680;4493;104;288;1376;3590;1480;3878
251590;201806;1581;4267;1392;4027;60;201;1114;3156;1174;3357
251593;201806;955;2850;874;2723;102;345;534;1613;636;1958
251597;201806;2005;5899;1900;5763;24;96;1729;5188;1753;5284
251600;201806;6386;17871;5743;16884;193;620;4776;13845;4969;14465
251610;201806;3345;9656;2882;8798;304;874;1956;6031;2260;6905
251615;201806;1170;3102;949;2727;23;88;727;2020;750;2108
251620;201806;17356;42088;14280;38462;228;545;12076;33962;12304;34507
251630;201806;4692;11509;3803;10261;216;607;2899;7742;3115;8349
251640;201806;2095;6132;1914;5784;67;287;1631;4815;1698;5102
251650;201806;4118;11141;3658;10549;167;543;3094;8870;3261;9413
251660;201806;3492;10692;3090;9961;85;410;2551;8022;2636;8432
251670;201806;4268;12081;3787;11423;42;197;3469;10439;3511;10636
251675;201806;656;1972;601;1896;92;319;386;1200;478;1519
251680;201806;2690;7485;2190;6746;52;194;1756;5377;1808;5571
251690;201806;3262;9453;2848;8660;79;279;2080;6189;2159;6468
251700;201806;1888;5925;1751;5739;64;302;1471;4706;1535;5008
251710;201806;839;2205;565;1619;54;187;306;838;360;1025
251720;201806;1373;4014;1146;3592;33;143;875;2649;908;2792
251740;201806;675;1874;525;1603;35;120;361;1060;396;1180
260005;201806;28211;62681;23189;55943;2318;5581;16422;39112;18740;44693
260010;201806;9783;26032;8130;23585;511;1518;5026;14862;5537;16380
260020;201806;6741;16558;5692;15034;138;557;4690;12172;4828;12729
260030;201806;6333;17163;5425;15738;224;755;4290;12405;4514;13160
260040;201806;8017;22249;6714;20255;716;2191;4412;13445;5128;15636
260050;201806;12285;34823;11204;33519;383;1207;9738;29632;10121;30839
260060;201806;3880;10377;3343;9466;225;613;2550;7235;2775;7848
260070;201806;10238;27495;8969;25541;604;2011;6681;18662;7285;20673
260080;201806;6618;15692;5748;14417;181;543;4704;11512;4885;12055
260090;201806;5139;13396;4616;12700;663;1790;3215;8950;3878;10740
260100;201806;3224;8670;2713;7915;97;359;2218;6429;2315;6788
260105;201806;5246;14171;4679;13362;150;594;3875;10811;4025;11405
260110;201806;22489;60399;20343;57507;1070;3275;17103;47958;18173;51233
260120;201806;13797;38692;11874;35555;1720;5228;7212;22093;8932;27321
260130;201806;3068;8263;2786;7824;235;737;2048;5611;2283;6348
260140;201806;13075;30861;11290;28592;606;1604;9285;23359;9891;24963
260150;201806;3424;8551;2950;7965;148;496;2472;6545;2620;7041
260160;201806;6293;17477;5392;16275;127;510;4661;14167;4788;14677
260170;201806;17539;46042;15606;43244;1595;4237;11529;32148;13124;36385
260180;201806;3299;9471;2981;8995;140;480;2514;7504;2654;7984
260190;201806;17276;37316;15128;34763;223;666;13236;29858;13459;30524
260200;201806;11131;27488;9746;25744;416;1168;8424;22212;8840;23380
260210;201806;12020;34702;10281;31869;349;1370;8235;25424;8584;26794
260220;201806;10059;25715;9450;24952;233;781;8459;22057;8692;22838
260230;201806;10144;26730;8921;24995;320;1024;7198;19962;7518;20986
260240;201806;2817;8389;2454;7803;196;669;1851;5860;2047;6529
260250;201806;2182;5977;1889;5551;87;292;1482;4250;1569;4542
260260;201806;12574;34210;11052;31862;479;1731;8650;24479;9129;26210
260270;201806;3722;10100;3357;9580;167;718;2630;7237;2797;7955
260280;201806;13010;40308;11842;38636;541;2090;10082;32779;10623;34869
260290;201806;37458;101922;32990;94929;4292;12773;20827;59351;25119;72124
260300;201806;9188;26269;8070;24630;273;1216;6528;19771;6801;20987
260310;201806;4560;12578;4085;11898;470;1269;2940;8746;3410;10015
260320;201806;7411;22203;6610;20794;290;968;5350;16804;5640;17772
260330;201806;2524;7897;2288;7418;73;267;1833;5808;1906;6075
260340;201806;2000;5508;1751;5138;29;135;1527;4414;1556;4549
260345;201806;24031;67193;20888;62218;4213;13410;9396;27208;13609;40618
260350;201806;5025;12804;4518;12146;133;423;3931;10464;4064;10887
260360;201806;2502;6796;2277;6395;71;315;1558;4285;1629;4600
260370;201806;5444;16205;4766;15016;222;876;3637;11301;3859;12177
260380;201806;4894;15127;4265;14080;205;782;3171;10349;3376;11131
260390;201806;4310;13343;3690;12061;250;882;2479;7957;2729;8839
260392;201806;3430;11085;3060;10598;152;832;2478;8455;2630;9287
260400;201806;15414;39162;13716;36814;904;2712;10415;27220;11319;29932
260410;201806;62554;165152;50923;147923;10805;33253;22100;65484;32905;98737
260415;201806;4049;11630;3489;10577;115;525;2633;7718;2748;8243
260420;201806;12857;27974;11048;25920;212;607;9947;23152;10159;23759
260430;201806;2903;9055;2502;8282;132;495;1751;5727;1883;6222
260440;201806;3576;9939;3103;9086;151;549;2390;6820;2541;7369
260450;201806;5474;14446;5024;13884;238;590;4251;11892;4489;12482
260460;201806;5451;17167;4760;15792;591;2191;2786;9060;3377;11251
260470;201806;4950;13280;4226;12441;132;346;3735;11269;3867;11615
260480;201806;4162;11202;3522;10273;348;1151;2332;6901;2680;8052
260490;201806;5213;12728;4552;11635;102;363;3954;9836;4056;10199
260500;201806;6013;15909;5095;14538;512;1413;3449;9941;3961;11354
260510;201806;9367;23425;8037;21603;201;680;7074;18820;7275;19500
260515;201806;4439;12742;3401;10711;158;583;2226;6847;2384;7430
260520;201806;17557;42273;15760;39854;1005;2612;12709;31790;13714;34402
260530;201806;9538;28213;8272;26188;227;1004;7033;22053;7260;23057
260540;201806;6729;15301;6004;14435;491;998;5050;12365;5541;13363
260545;201806;46;140;23;93;5;19;5;21;10;40
260550;201806;2894;8700;2411;7736;185;781;1485;4652;1670;5433
260560;201806;6095;15877;5248;14682;146;605;4404;12077;4550;12682
260570;201806;7285;21253;6539;20177;528;1738;5112;15734;5640;17472
260580;201806;4187;10580;3731;9923;46;186;3385;8910;3431;9096
260590;201806;6752;16088;5789;14999;289;786;4838;12580;5127;13366
260600;201806;29962;81477;24956;73539;1463;4868;18164;52834;19627;57702
260610;201806;6718;18793;6198;18055;477;1488;4663;13468;5140;14956
260620;201806;15361;43266;13805;40881;1835;5940;8871;25766;10706;31706
260630;201806;2373;6476;1967;5834;47;203;1613;4732;1660;4935
260640;201806;19211;47134;16618;44031;1063;3068;12822;33674;13885;36742
260650;201806;5575;16120;4724;14833;197;819;3895;12097;4092;12916
260660;201806;7408;19879;6420;18596;172;721;5405;15379;5577;16100
260670;201806;2272;5942;1868;5343;96;253;1333;3791;1429;4044
260680;201806;24420;62630;20727;56934;2340;6639;12545;34021;14885;40660
260690;201806;3652;9580;3020;8589;124;422;2398;6728;2522;7150
260700;201806;5876;17474;5631;17191;24;56;5486;16914;5510;16970
260710;201806;1340;3613;1250;3497;59;199;908;2602;967;2801
260720;201806;20642;58005;18427;54602;2966;9009;11018;32379;13984;41388
260730;201806;7157;21831;6391;20704;370;1430;5185;16487;5555;17917
260740;201806;1333;3795;1144;3488;26;125;911;2758;937;2883
260750;201806;6905;19642;5992;18447;147;438;5377;16806;5524;17244
260760;201806;5415;13394;4743;12546;216;624;3849;10243;4065;10867
260765;201806;7644;23888;6870;22716;684;2845;4641;14906;5325;17751
260770;201806;3817;10077;3288;9191;107;354;2598;7168;2705;7522
260775;201806;5143;14250;4680;13565;271;1040;3524;9860;3795;10900
260780;201806;3689;11258;3338;10655;392;1393;2112;6610;2504;8003
260790;201806;113381;268172;97068;245698;16536;41438;56639;142821;73175;184259
260795;201806;3102;8535;2694;7921;144;470;2016;5962;2160;6432
260800;201806;5425;12905;4920;12180;138;442;4365;10460;4503;10902
260805;201806;3664;10752;3094;9747;213;775;2174;6734;2387;7509
260810;201806;6614;18332;5989;17163;558;1607;4318;12147;4876;13754
260820;201806;4390;11002;3889;10284;263;908;2955;7528;3218;8436
260825;201806;2880;8883;2521;8250;145;549;1856;6044;2001;6593
260830;201806;4253;12609;3565;11319;471;1378;2310;7557;2781;8935
260840;201806;4232;11503;3731;10761;194;558;3056;8762;3250;9320
260845;201806;4101;11367;3783;10802;288;824;2786;7913;3074;8737
260850;201806;4962;14848;4294;13459;501;1634;2519;7743;3020;9377
260860;201806;3584;10365;3028;9336;109;397;2399;7269;2508;7666
260870;201806;4426;11066;3839;10325;125;474;3319;8731;3444;9205
260875;201806;6502;17466;5526;15902;735;2073;3564;10368;4299;12441
260880;201806;9865;28212;8660;26151;431;1307;6907;20994;7338;22301
260890;201806;13340;36094;12008;34099;852;2730;8679;24155;9531;26885
260900;201806;5407;16157;4605;14749;307;1166;3088;9716;3395;10882
260910;201806;3144;8916;2785;8325;116;410;2145;6336;2261;6746
260915;201806;5041;15272;4505;14608;82;324;4078;13302;4160;13626
260920;201806;3300;9277;2949;8827;124;425;2452;7384;2576;7809
260930;201806;3607;11732;3190;10982;199;776;2423;8309;2622;9085
260940;201806;14499;36089;12786;33514;979;2825;9384;24118;10363;26943
260950;201806;6547;19012;5310;16582;655;2228;2751;8169;3406;10397
260960;201806;62622;153034;51930;137788;7610;21334;29532;76982;37142;98316
260970;201806;5135;14306;4606;13611;170;496;3598;10739;3768;11235
260980;201806;4370;13257;3958;12728;76;296;3598;11617;3674;11913
260990;201806;17421;50774;15222;47727;924;3265;11746;36736;12670;40001
261000;201806;15681;39864;13352;36563;727;2394;9826;26725;10553;29119
261010;201806;2504;6668;2227;6311;82;213;1978;5620;2060;5833
261020;201806;6447;18289;5566;16622;362;1189;4249;12349;4611;13538
261030;201806;4091;11634;3568;10788;211;612;2790;8403;3001;9015
261040;201806;5111;15791;4259;13978;253;973;3035;9749;3288;10722
261050;201806;7567;20886;6880;19715;634;1668;4706;13594;5340;15262
261060;201806;13144;35055;11758;33057;652;2035;9352;26002;10004;28037
261070;201806;56987;130393;47828;117848;3827;9156;34486;84131;38313;93287
261080;201806;5898;15751;5543;15245;192;540;5011;13797;5203;14337
261090;201806;17233;44029;15632;41895;465;1517;13354;35499;13819;37016
261100;201806;8081;23938;7093;22334;686;2298;4898;15532;5584;17830
261110;201806;60143;175001;51881;161364;11062;36089;24815;78090;35877;114179
261120;201806;3809;9741;3298;9097;74;231;2932;8108;3006;8339
261130;201806;7624;18593;6750;17497;141;427;5983;15402;6124;15829
261140;201806;3432;8537;3083;8046;237;686;2389;6119;2626;6805
261150;201806;5325;14523;4711;13559;133;501;4014;11400;4147;11901
261153;201806;1961;5869;1684;5410;82;321;1148;3661;1230;3982
261160;201806;206163;506488;174725;461667;43310;118380;69585;187377;112895;305757
261170;201806;5931;15801;5392;15007;347;941;4281;11915;4628;12856
261180;201806;9870;25891;8838;24499;628;1935;6275;17175;6903;19110
261190;201806;4944;14954;4480;14254;342;1383;3223;9947;3565;11330
261200;201806;3380;8031;2972;7513;221;577;2380;5971;2601;6548
261210;201806;1906;4762;1643;4386;55;159;1424;3780;1479;3939
261220;201806;13703;40401;11417;35933;1539;5289;6348;19786;7887;25075
261230;201806;4616;13552;3901;12633;86;359;3259;10677;3345;11036
261240;201806;5014;13492;4426;12555;298;802;3512;9953;3810;10755
261245;201806;3493;10304;2999;9430;115;537;2353;7118;2468;7655
261247;201806;2990;9085;2540;8257;151;580;1809;5838;1960;6418
261250;201806;19839;48587;17364;45589;2479;6173;11896;32289;14375;38462
261255;201806;4013;12140;3473;11108;165;739;2624;8101;2789;8840
261260;201806;12879;35044;11155;32851;409;1557;9387;27519;9796;29076
261270;201806;4002;11015;3569;10342;246;799;2778;7867;3024;8666
261280;201806;2560;7475;2276;6979;92;401;1791;5336;1883;5737
261290;201806;2956;8070;2565;7562;125;468;2030;6005;2155;6473
261300;201806;11603;34261;9926;31256;690;2641;6966;21422;7656;24063
261310;201806;7407;20935;6604;19733;1030;3233;4201;12349;5231;15582
261320;201806;5908;17292;5200;16036;110;436;4285;13007;4395;13443
261330;201806;5841;15224;5388;14615;209;754;4631;12344;4840;13098
261340;201806;4139;12506;3601;11713;209;887;2698;8664;2907;9551
261350;201806;8361;25558;7701;24462;154;773;6319;19671;6473;20444
261360;201806;8318;20894;7135;19216;324;957;5734;15111;6058;16068
261370;201806;19841;54454;17531;51039;3129;9103;10002;29407;13131;38510
261380;201806;4007;12834;3630;12095;512;1899;2278;7452;2790;9351
261390;201806;16249;47762;14060;44072;1445;4875;8816;27571;10261;32446
261400;201806;4684;15400;4107;14170;185;838;3002;10147;3187;10985
261410;201806;9276;24517;7908;22306;554;1577;6236;17531;6790;19108
261420;201806;7159;22942;6656;22268;1035;3878;4253;14156;5288;18034
261430;201806;3471;10099;2924;9236;118;419;2348;7394;2466;7813
261440;201806;1497;4606;1309;4228;47;227;920;2881;967;3108
261450;201806;14177;39490;13076;37893;289;1096;11117;32112;11406;33208
261460;201806;7102;20189;6514;19333;237;823;5591;16528;5828;17351
261470;201806;4221;10942;3781;10362;50;236;3140;8629;3190;8865
261480;201806;4629;14918;4065;13959;244;986;3085;10364;3329;11350
261485;201806;5024;14694;4374;13627;388;1411;2985;9093;3373;10504
261500;201806;5588;15054;4928;14152;472;1264;3433;10177;3905;11441
261510;201806;1811;5624;1559;5151;84;313;1152;3839;1236;4152
261520;201806;2541;7863;2378;7546;87;343;1595;5151;1682;5494
261530;201806;10601;33222;9102;30233;1305;4959;4242;13831;5547;18790
261540;201806;7532;22607;6842;21514;1186;3697;3937;12740;5123;16437
261550;201806;3610;9787;3197;9136;236;787;2318;6480;2554;7267
261560;201806;7512;23207;6630;21925;423;1702;4954;16349;5377;18051
261570;201806;3438;9679;2854;8692;217;783;1925;5721;2142;6504
261580;201806;6451;17594;5848;16714;139;615;5230;14730;5369;15345
261590;201806;2710;7116;2201;6353;97;297;1656;4777;1753;5074
261600;201806;5344;13817;4471;12519;455;1196;2985;8579;3440;9775
261610;201806;2458;6659;2072;6068;85;317;1578;4596;1663;4913
261618;201806;2557;6668;2283;6295;100;304;1840;5015;1940;5319
261620;201806;3978;11975;3706;11534;813;2391;2207;7159;3020;9550
261630;201806;6922;19707;5843;17693;475;1740;3666;10635;4141;12375
261640;201806;36860;85714;32455;80268;1944;4268;25581;64975;27525;69243
261650;201806;4138;10892;3689;10299;159;580;2752;7666;2911;8246
270010;201806;4339;15294;3875;14424;174;969;3032;11049;3206;12018
270020;201806;4011;10355;3558;9750;236;755;2872;7674;3108;8429
270030;201806;34965;98966;30584;91853;4694;14031;18817;57044;23511;71075
270040;201806;11368;31283;9880;29474;477;1717;8110;24105;8587;25822
270050;201806;5505;12835;4709;11946;207;532;4134;10517;4341;11049
270060;201806;2070;5519;1811;5187;173;493;1334;3882;1507;4375
270070;201806;4574;13389;4029;12620;145;682;3383;10339;3528;11021
270080;201806;1408;4047;1173;3619;80;260;856;2556;936;2816
270090;201806;1947;6037;1720;5586;72;331;1330;4167;1402;4498
270100;201806;5580;15649;4915;14635;286;1087;3882;11336;4168;12423
270110;201806;3173;8020;2601;7367;175;513;2034;5910;2209;6423
270120;201806;3076;8351;2689;7874;84;333;2364;6876;2448;7209
270130;201806;5361;14476;4667;13681;242;803;3822;11278;4064;12081
270135;201806;2007;4991;1744;4686;75;201;1560;4194;1635;4395
270140;201806;10297;23771;8380;21179;412;1545;6760;16152;7172;17697
270150;201806;2637;8172;2530;8041;17;52;2476;7876;2493;7928
270160;201806;5331;16082;4704;15302;84;471;4211;13547;4295;14018
270170;201806;3581;10792;3121;10150;275;1218;2236;6988;2511;8206
270180;201806;2267;7172;2074;6899;58;272;1779;5820;1837;6092
270190;201806;1710;5266;1575;5079;80;306;1284;4129;1364;4435
270200;201806;2543;7820;2211;7377;153;633;1608;5221;1761;5854
270210;201806;5578;14005;4906;13201;158;511;4377;11654;4535;12165
270220;201806;1416;4071;1213;3772;225;767;669;2034;894;2801
270230;201806;9735;29009;8297;26667;849;3197;5357;16736;6206;19933
270235;201806;5901;18696;5294;17662;231;967;4254;14039;4485;15006
270240;201806;10707;29587;8815;27159;1092;3692;6114;18766;7206;22458
270250;201806;2905;7586;2576;7140;277;691;1911;5383;2188;6074
270255;201806;4688;13620;3594;11578;192;802;2561;8066;2753;8868
270260;201806;5633;17170;5263;16586;160;762;4528;13831;4688;14593
270270;201806;1052;2873;962;2752;149;434;635;1801;784;2235
270280;201806;3867;9808;3139;8871;426;783;2197;6603;2623;7386
270290;201806;7888;25598;7145;24374;327;1523;5913;19845;6240;21368
270300;201806;4114;11361;3281;10447;252;849;2371;7649;2623;8498
270310;201806;7194;20847;6272;19398;171;885;5237;15679;5408;16564
270320;201806;5842;17474;5256;16408;639;2101;3599;11014;4238;13115
270330;201806;3797;12837;3465;12350;289;1129;2701;9660;2990;10789
270340;201806;1646;4725;1404;4402;70;262;1136;3506;1206;3768
270350;201806;1917;4781;1623;4415;182;520;1140;3141;1322;3661
270360;201806;2337;6393;2127;6143;92;254;1917;5603;2009;5857
270370;201806;1430;4540;1302;4304;54;237;1016;3321;1070;3558
270375;201806;3094;7567;2616;6976;37;121;2386;6348;2423;6469
270380;201806;5722;16946;4970;15928;464;1559;3508;11474;3972;13033
270390;201806;1231;3246;1027;2960;32;140;823;2322;855;2462
270400;201806;6270;17581;5403;16202;222;828;4093;11872;4315;12700
270410;201806;4542;13845;4039;12976;246;941;3112;9846;3358;10787
270420;201806;5755;17432;5310;16820;187;818;4395;13660;4582;14478
270430;201806;141021;362932;114880;327773;26348;79261;46471;134874;72819;214135
270440;201806;4904;13610;4229;12767;129;558;3480;10436;3609;10994
270450;201806;6616;18838;5983;18059;286;1110;4927;14699;5213;15809
270460;201806;3587;8548;3162;8039;64;244;2900;7223;2964;7467
270470;201806;11022;32709;9773;30867;955;3192;6930;22177;7885;25369
270480;201806;2856;8047;2461;7427;184;707;1887;5475;2071;6182
270490;201806;994;2923;882;2785;58;203;681;2137;739;2340
270500;201806;4873;15398;4468;14863;177;836;3720;12188;3897;13024
270510;201806;5836;16342;5085;15298;518;1951;3579;10275;4097;12226
270520;201806;3945;11684;3191;10356;822;2818;1091;3744;1913;6562
270530;201806;1113;3399;1009;3231;57;175;783;2518;840;2693
270540;201806;2134;6534;1902;6230;82;400;1600;5115;1682;5515
270550;201806;6842;18609;5688;17314;508;1454;4286;13444;4794;14898
270560;201806;3170;8802;2827;8315;160;554;2201;6363;2361;6917
270570;201806;4008;11909;3456;11041;186;740;2740;8587;2926;9327
270580;201806;2218;6493;2061;6264;92;275;1803;5488;1895;5763
270590;201806;1545;4696;1450;4583;7;27;1414;4474;1421;4501
270600;201806;2847;8962;2539;8444;99;505;2139;6935;2238;7440
270610;201806;3588;9850;3068;9181;107;422;2657;7807;2764;8229
270620;201806;1327;4152;1212;3948;54;224;999;3167;1053;3391
270630;201806;15473;42879;13719;40138;1086;3479;10504;30514;11590;33993
270640;201806;5629;16423;4880;15275;207;849;3902;11881;4109;12730
270642;201806;2353;7875;2165;7596;151;758;1697;5752;1848;6510
270644;201806;3370;8745;2768;7957;235;676;2047;5976;2282;6652
270650;201806;3362;10121;3021;9633;423;1621;2067;6324;2490;7945
270660;201806;2201;5515;1749;4886;81;254;1291;3575;1372;3829
270670;201806;15916;39502;13633;36758;884;2477;10927;29404;11811;31881
270680;201806;5095;13178;4601;12621;148;260;4256;11854;4404;12114
270690;201806;9540;24236;8051;22504;1214;3112;5667;16240;6881;19352
270700;201806;555;1721;478;1578;38;157;332;1082;370;1239
270710;201806;5855;17763;5413;17168;271;1166;4505;13996;4776;15162
270720;201806;3394;10606;3025;9973;91;547;2560;8227;2651;8774
270730;201806;7400;18457;6831;17836;384;981;5596;15471;5980;16452
270740;201806;2343;6377;2099;6062;102;356;1746;4967;1848;5323
270750;201806;5412;15257;4776;14348;264;955;3841;11449;4105;12404
270760;201806;3405;9788;2994;9179;71;345;2555;7715;2626;8060
270770;201806;21039;52346;16710;47008;3073;8180;9327;28103;12400;36283
270780;201806;1787;5396;1685;5250;102;354;1391;4329;1493;4683
270790;201806;1588;4681;1394;4404;135;432;944;3001;1079;3433
270800;201806;10970;31148;9899;29616;456;1915;8332;24250;8788;26165
270810;201806;3221;9794;2586;8660;189;768;1781;5892;1970;6660
270820;201806;1727;5308;1464;4858;112;437;1069;3487;1181;3924
270830;201806;5568;13602;4628;12441;262;795;3670;9868;3932;10663
270840;201806;8277;24820;7402;23600;212;1179;6442;19971;6654;21150
270850;201806;8510;22275;7697;21223;512;1756;6295;16765;6807;18521
270860;201806;12037;30644;9977;28129;620;2017;7813;21713;8433;23730
270870;201806;2101;6163;1817;5657;192;656;1275;3962;1467;4618
270880;201806;8201;24951;7403;23790;270;1179;6098;19301;6368;20480
270890;201806;2509;7123;2199;6678;151;532;1599;4763;1750;5295
270895;201806;2928;9853;2734;9588;90;511;2394;8177;2484;8688
270900;201806;1801;4751;1403;4123;51;172;1098;3162;1149;3334
270910;201806;3701;11245;3227;10438;142;590;2426;7709;2568;8299
270915;201806;9047;28130;7716;25724;909;3522;4907;15939;5816;19461
270920;201806;5672;17709;5299;17129;244;1147;4386;13702;4630;14849
270930;201806;17310;42516;13690;38188;2253;5907;8862;25540;11115;31447
270940;201806;5991;17815;5359;17016;296;1349;4114;12748;4410;14097
280010;201806;679;1865;576;1675;23;94;392;1043;415;1137
280020;201806;4785;12850;4110;11743;554;1516;2680;7720;3234;9236
280030;201806;73830;180770;59142;159845;14836;41195;22622;63741;37458;104936
280040;201806;3118;8910;2747;8331;280;909;1895;5681;2175;6590
280050;201806;3899;11445;3429;10669;588;1953;2002;6215;2590;8168
280060;201806;5277;14916;4299;13345;776;2561;2104;6716;2880;9277
280067;201806;6870;18133;5827;16480;509;1523;4003;11164;4512;12687
280070;201806;1919;5967;1830;5817;117;403;1519;4772;1636;5175
280100;201806;3683;10756;3248;10029;356;1196;2257;6923;2613;8119
280110;201806;1302;3854;1180;3642;47;199;984;2932;1031;3131
280120;201806;7642;22961;6922;21743;730;2159;5136;16403;5866;18562
280130;201806;8687;21558;7769;20261;703;1885;5897;15454;6600;17339
280140;201806;5563;14035;5001;13251;293;793;4121;10897;4414;11690
280150;201806;3794;10178;3455;9710;235;637;2778;7795;3013;8432
280160;201806;1252;3678;1034;3296;142;468;639;1998;781;2466
280170;201806;5146;13971;4672;13311;270;756;3838;10997;4108;11753
280190;201806;1228;2895;1020;2592;60;180;809;1992;869;2172
280200;201806;1332;3606;1084;3191;96;347;764;2203;860;2550
280210;201806;15097;40488;13242;37873;2098;6299;7707;22201;9805;28500
280220;201806;1784;4986;1550;4666;41;200;1267;3821;1308;4021
280230;201806;3628;9785;3254;9246;232;726;2461;6862;2693;7588
280240;201806;3412;9255;3083;8749;81;360;2629;7266;2710;7626
280250;201806;849;2189;673;1915;68;223;382;1026;450;1249
280260;201806;2118;5378;1950;5172;46;133;1805;4787;1851;4920
280270;201806;2260;6607;2002;6199;122;450;1666;5062;1788;5512
280280;201806;4081;13033;3686;12422;541;1616;2399;8535;2940;10151
280290;201806;17304;48534;15389;45781;1705;5603;9991;29784;11696;35387
280300;201806;10270;27760;9015;26344;358;1270;7050;21552;7408;22822
280310;201806;1369;3683;1153;3298;39;135;856;2373;895;2508
280320;201806;8695;24882;7665;23282;857;2799;4997;14896;5854;17695
280330;201806;4839;12306;4141;11273;278;820;3150;8461;3428;9281
280340;201806;5234;11460;4528;10664;279;600;3862;9266;4141;9866
280350;201806;23300;59919;20255;55421;1852;5267;14494;39388;16346;44655
280360;201806;5892;17128;5280;16047;913;2798;2889;8914;3802;11712
280370;201806;2124;5343;1740;4700;86;231;1366;3641;1452;3872
280380;201806;1011;2901;881;2707;93;329;581;1753;674;2082
280390;201806;3470;9176;2847;8120;140;457;2196;6143;2336;6600
280400;201806;4002;10684;3506;9940;610;1647;2047;6014;2657;7661
280410;201806;2134;6365;1749;5642;193;644;1038;3274;1231;3918
280420;201806;4253;11729;3875;11190;112;389;3456;9924;3568;10313
280430;201806;2082;5299;1833;4949;75;260;1437;3803;1512;4063
280440;201806;4603;12552;4045;11767;238;781;3223;9156;3461;9937
280445;201806;2314;6051;2082;5628;50;151;1538;3991;1588;4142
280450;201806;10162;23804;9100;22443;397;762;7854;19660;8251;20422
280460;201806;6665;16628;6079;15790;533;1344;4874;12659;5407;14003
280470;201806;1789;5154;1579;4776;80;281;1169;3501;1249;3782
280480;201806;36732;96300;32760;90628;3282;9957;22793;61923;26075;71880
280490;201806;3864;11128;3289;10154;105;452;2484;7450;2589;7902
280500;201806;955;2408;825;2221;50;177;668;1774;718;1951
280510;201806;2567;7103;2241;6618;115;447;1620;4742;1735;5189
280520;201806;1693;4406;1500;4140;86;231;1222;3367;1308;3598
280530;201806;2669;6543;2321;6129;138;374;1882;4966;2020;5340
280540;201806;9048;24673;8287;23610;218;966;7278;20265;7496;21231
280550;201806;6689;16446;5549;14698;290;837;4308;11155;4598;11992
280560;201806;7144;20569;6747;19998;194;755;5879;17152;6073;17907
280570;201806;6307;16204;5206;14774;267;919;3804;10678;4071;11597
280580;201806;5416;15605;4636;14287;601;1796;3060;9553;3661;11349
280590;201806;3023;7437;2522;6800;154;605;1828;4667;1982;5272
280600;201806;3400;9721;3063;9233;218;751;2238;6671;2456;7422
280610;201806;2570;6515;2307;6152;198;515;1816;4812;2014;5327
280620;201806;5325;14138;4619;13084;438;1091;3337;9811;3775;10902
280630;201806;3649;11237;3308;10708;210;759;2589;8447;2799;9206
280640;201806;2401;6751;2211;6542;50;135;2053;6138;2103;6273
280650;201806;1268;3387;1000;2989;85;293;704;2048;789;2341
280660;201806;3100;7586;2758;7185;128;342;2390;6209;2518;6551
280670;201806;19037;44788;16718;41774;1259;3284;12749;31822;14008;35106
280680;201806;2806;7051;2389;6382;176;390;1754;4665;1930;5055
280690;201806;975;2537;832;2331;46;121;613;1697;659;1818
280700;201806;1096;2910;951;2676;20;67;739;2044;759;2111
280710;201806;14517;33767;12555;31506;552;920;10953;28324;11505;29244
280720;201806;2784;6275;2268;5675;142;364;1503;4039;1645;4403
280730;201806;1099;2798;983;2629;69;216;748;1972;817;2188
280740;201806;13794;35296;11788;32114;1147;3143;7938;21440;9085;24583
280750;201806;3489;10100;3131;9462;176;652;2273;6733;2449;7385
280760;201806;6006;17122;5321;16025;648;1941;3453;10682;4101;12623
290010;201806;3065;6648;2129;5198;14;50;1762;4103;1776;4153
290020;201806;5204;14560;4882;14122;328;656;4202;12459;4530;13115
290030;201806;3892;10104;3387;9510;206;525;2811;7946;3017;8471
290035;201806;5178;11723;4159;10393;303;582;3275;8505;3578;9087
290040;201806;4407;10853;3679;9980;145;433;2862;7957;3007;8390
290050;201806;2207;7124;1868;6460;141;544;1281;4385;1422;4929
290060;201806;1297;3297;1002;2819;100;344;665;1791;765;2135
290070;201806;33987;80778;29373;74722;2867;7456;19729;50585;22596;58041
290080;201806;5646;16813;4756;15526;573;1936;3140;10436;3713;12372
290090;201806;2297;4436;1712;3809;46;101;1552;3443;1598;3544
290100;201806;9379;25713;7955;23533;992;2790;4886;14878;5878;17668
290110;201806;5048;14086;4627;13349;478;1426;3161;9024;3639;10450
290115;201806;4383;12701;3770;11799;227;759;2938;9221;3165;9980
290120;201806;7002;17242;5739;15687;156;562;4888;13133;5044;13695
290130;201806;4616;11634;3707;10495;125;509;2959;8205;3084;8714
290135;201806;4475;10666;3638;9319;243;662;2699;6723;2942;7385
290140;201806;4688;12896;3761;11700;137;486;3239;10067;3376;10553
290150;201806;2275;6574;2133;6344;177;568;1606;4669;1783;5237
290160;201806;3186;7817;2908;7462;351;763;2163;5651;2514;6414
290170;201806;2914;8312;2658;7993;80;300;2395;7163;2475;7463
290180;201806;2966;8255;2469;7457;99;353;1944;5805;2043;6158
290190;201806;3983;12085;3606;11544;170;717;2895;9101;3065;9818
290195;201806;2360;6119;1892;5409;51;232;1533;4351;1584;4583
290200;201806;4019;11618;3403;10628;225;730;2627;8184;2852;8914
290205;201806;3453;9066;3048;8476;116;438;2458;6634;2574;7072
290210;201806;13374;38390;11900;36261;1109;3088;8949;28090;10058;31178
290220;201806;2738;7179;2487;6857;171;510;2019;5491;2190;6001
290225;201806;3499;7505;2861;6829;36;93;2688;6423;2724;6516
290230;201806;2480;7029;2267;6778;65;257;1981;5890;2046;6147
290240;201806;3714;9609;3081;8801;126;425;2510;7076;2636;7501
290250;201806;4103;12079;3666;11502;139;390;3023;9911;3162;10301
290260;201806;5387;13968;4399;12518;243;824;3465;9748;3708;10572
290265;201806;3617;10633;2999;9500;134;539;2260;7061;2394;7600
290270;201806;11873;40781;11224;39672;772;3259;8715;30392;9487;33651
290280;201806;5945;17909;5263;16769;388;1365;3784;11960;4172;13325
290290;201806;9927;29839;8382;27004;804;2722;5712;18335;6516;21057
290300;201806;4470;12275;3228;9929;188;661;2269;6986;2457;7647
290310;201806;1532;4079;1291;3744;102;373;934;2634;1036;3007
290320;201806;24746;67678;20691;61838;5163;15555;9604;29988;14767;45543
290323;201806;3648;10058;3247;9498;73;251;2684;7769;2757;8020
290327;201806;4315;12579;3724;11460;325;985;2623;8103;2948;9088
290330;201806;2049;4594;1717;4229;50;107;1533;3795;1583;3902
290340;201806;5737;15536;4649;14141;695;2182;3140;9634;3835;11816
290350;201806;4739;13881;4021;12653;315;1041;2864;9096;3179;10137
290360;201806;5029;13711;4358;12820;126;406;3730;10988;3856;11394
290370;201806;5218;13086;4007;11499;229;591;3055;8928;3284;9519
290380;201806;5594;15346;4805;14233;123;399;4144;12362;4267;12761
290390;201806;14952;43269;12820;40057;1422;4527;8501;27046;9923;31573
290395;201806;2781;8491;2350;7719;70;334;1831;5964;1901;6298
290400;201806;3638;10209;2954;9106;129;504;2187;6591;2316;7095
290405;201806;4716;14028;3948;12647;263;890;2735;8889;2998;9779
290410;201806;5708;16126;4577;14259;154;697;3462;10381;3616;11078
290420;201806;2984;8550;2492;7758;145;452;1910;5959;2055;6411
290430;201806;3131;9100;2606;8233;330;1076;1648;5208;1978;6284
290440;201806;2834;7259;2118;6172;63;200;1541;4560;1604;4760
290450;201806;3301;9100;2713;8237;147;528;2064;6160;2211;6688
290460;201806;12158;34230;10513;31143;2659;8069;4256;12489;6915;20558
290470;201806;4426;11696;3325;10055;416;1419;1811;5519;2227;6938
290475;201806;6308;18849;5408;17225;120;595;4292;13362;4412;13957
290480;201806;1968;5116;1720;4751;128;393;1129;3088;1257;3481
290485;201806;4564;13805;3992;12933;139;735;3381;10699;3520;11434
290490;201806;8856;21655;8077;20631;547;1426;6360;16325;6907;17751
290500;201806;3922;11940;3006;9999;403;1414;1542;5026;1945;6440
290510;201806;3346;8818;2861;8167;93;338;2442;6876;2535;7214
290515;201806;3771;10138;3161;9350;83;228;2740;8281;2823;8509
290520;201806;11484;33961;9013;29084;413;1670;5886;18616;6299;20286
290530;201806;5014;14512;4339;13411;176;587;3549;10968;3725;11555
290540;201806;3753;10140;3367;9642;85;283;3005;8562;3090;8845
290550;201806;4399;11461;3876;10864;39;107;3592;10175;3631;10282
290560;201806;6790;18032;5402;15940;530;1786;3668;10583;4198;12369
290570;201806;43838;112845;39800;107612;2890;8168;30961;83105;33851;91273
290580;201806;7605;23479;6810;22286;621;2007;5136;17186;5757;19193
290590;201806;6971;21833;6036;20168;166;700;4946;16511;5112;17211
290600;201806;18128;52307;16459;49782;862;2722;13117;40060;13979;42782
290610;201806;2498;8126;2010;7139;101;425;1387;4871;1488;5296
290620;201806;6425;18237;5664;17018;221;706;4759;14182;4980;14888
290630;201806;9124;22465;7356;20187;610;1674;5704;15708;6314;17382
290640;201806;2752;7476;2086;6388;100;320;1589;4821;1689;5141
290650;201806;11884;32205;10865;30893;2807;7724;5976;17935;8783;25659
290660;201806;3671;9711;3130;8924;103;249;2314;6937;2417;7186
290670;201806;6915;19875;6000;18372;471;1406;4492;13924;4963;15330
290680;201806;10450;29885;9022;27773;250;1239;7267;21791;7517;23030
290682;201806;4640;12599;4070;11774;138;373;3415;9883;3553;10256
290685;201806;3632;8305;2389;6559;198;519;1540;4401;1738;4920
290687;201806;6876;19394;5519;17100;818;2486;3237;10385;4055;12871
290689;201806;2922;8414;2411;7541;146;514;1739;5485;1885;5999
290690;201806;5686;15126;4657;13725;473;1406;3164;9270;3637;10676
290700;201806;2627;7380;2360;7013;88;332;1991;5928;2079;6260
290710;201806;8548;24443;7362;22828;213;805;6336;19607;6549;20412
290720;201806;19018;52286;17527;50236;945;2850;14518;41612;15463;44462
290730;201806;7166;18277;6198;17079;270;706;4763;13118;5033;13824
290740;201806;1036;2904;791;2464;44;169;583;1808;627;1977
290750;201806;10750;28551;9347;26029;1010;3023;6220;16806;7230;19829
290755;201806;2238;6283;1733;5359;95;343;1210;3683;1305;4026
290760;201806;3931;11689;3114;10078;364;1060;1853;6289;2217;7349
290770;201806;2508;8455;2322;8212;61;312;1926;6867;1987;7179
290780;201806;8442;21558;7298;19938;398;867;5720;15963;6118;16830
290790;201806;4462;12683;3993;12035;161;471;3407;10342;3568;10813
290800;201806;7242;15277;5407;13168;379;881;4101;10159;4480;11040
290810;201806;5757;15807;4593;13954;115;406;3473;10584;3588;10990
290820;201806;5186;14001;4609;13160;265;847;3396;9715;3661;10562
290830;201806;4645;10991;4154;10330;96;289;3466;8498;3562;8787
290840;201806;16845;46661;14764;43383;1733;4497;9774;30026;11507;34523
290850;201806;6393;16617;5817;15975;488;1144;4608;13066;5096;14210
290860;201806;5695;17506;4975;16649;221;788;4171;14210;4392;14998
290870;201806;4761;13356;3722;11531;134;479;2677;8214;2811;8693
290880;201806;1433;3650;1120;3192;80;199;773;2248;853;2447
290890;201806;8024;18010;7081;16947;187;515;6548;15551;6735;16066
290900;201806;2360;6434;1781;5424;111;363;1142;3422;1253;3785
290910;201806;5106;13081;4030;11448;53;226;3359;9424;3412;9650
290920;201806;5205;13024;4784;12500;77;184;4448;11626;4525;11810
290930;201806;8164;23133;6761;20722;209;947;5367;15979;5576;16926
290940;201806;3863;11125;3239;10213;177;617;2440;7749;2617;8366
290950;201806;1531;4011;1288;3646;79;215;916;2620;995;2835
290960;201806;5340;14741;4849;14089;160;496;4084;11879;4244;12375
290970;201806;3670;10757;3063;9751;176;554;2268;7247;2444;7801
290980;201806;11103;28758;9392;25875;1067;3177;5266;14102;6333;17279
290990;201806;9034;25384;7897;23471;377;1401;6345;18361;6722;19762
291000;201806;3307;9109;2664;8285;238;683;2069;6570;2307;7253
291005;201806;14971;36708;13262;34572;671;1893;11029;28592;11700;30485
291010;201806;3085;9383;2481;8127;139;475;1638;5300;1777;5775
291020;201806;1301;3334;1041;2847;37;125;705;1819;742;1944
291030;201806;2416;6215;1678;4821;93;277;1061;2954;1154;3231
291040;201806;5416;15520;4695;14457;219;895;3705;11217;3924;12112
291050;201806;7528;22043;6608;20606;1127;3794;4039;12404;5166;16198
291060;201806;5950;19919;5220;18862;460;2041;3648;12985;4108;15026
291070;201806;15574;43557;13426;40219;582;2122;10661;31618;11243;33740
291072;201806;24320;66277;18078;54437;3737;11777;6764;20635;10501;32412
291075;201806;5088;13726;4524;12759;187;543;3605;10023;3792;10566
291077;201806;1562;4215;1252;3663;54;149;885;2601;939;2750
291080;201806;82004;234490;69627;214000;25798;81069;10969;35527;36767;116596
291085;201806;5786;14796;4825;13425;192;583;4083;11336;4275;11919
291090;201806;1871;3765;1464;3298;101;156;1202;2756;1303;2912
291100;201806;3078;6932;2145;5833;106;372;1634;4335;1740;4707
291110;201806;5660;17942;4893;16606;487;1902;3468;11404;3955;13306
291120;201806;7800;19707;6792;18320;424;1243;5182;13922;5606;15165
291125;201806;2096;3808;1548;3200;94;173;1203;2554;1297;2727
291130;201806;2983;8910;2354;7704;88;413;1722;5412;1810;5825
291140;201806;4582;12877;3466;10694;483;1330;2196;6898;2679;8228
291150;201806;2235;5223;1932;4866;25;59;1734;4345;1759;4404
291160;201806;4930;14641;4304;13609;411;1418;2894;9037;3305;10455
291165;201806;2306;6364;1770;5347;25;106;1299;3806;1324;3912
291170;201806;20823;53855;17601;48591;1099;3233;11261;30976;12360;34209
291180;201806;6086;15145;4718;13102;436;1232;3387;9374;3823;10606
291185;201806;3185;8920;2770;8171;103;337;2211;6436;2314;6773
291190;201806;7617;19360;6413;17711;405;1218;5008;13784;5413;15002
291200;201806;2879;8246;2166;6890;141;455;1320;4165;1461;4620
291210;201806;6850;15599;5347;13783;173;539;4009;10296;4182;10835
291220;201806;4027;11804;3619;11154;285;1000;2666;8110;2951;9110
291230;201806;4380;9937;3408;8847;88;181;3090;8138;3178;8319
291240;201806;4298;11326;3749;10383;64;210;3200;8717;3264;8927
291250;201806;3411;10238;2729;8971;183;582;1818;6050;2001;6632
291260;201806;1293;3191;1137;2981;47;162;944;2458;991;2620
291270;201806;5085;14453;4129;12872;761;2375;2429;7747;3190;10122
291280;201806;2410;6506;1853;5567;202;662;1059;3109;1261;3771
291290;201806;5912;15971;4780;14225;513;1562;3139;9370;3652;10932
291300;201806;4015;11106;3038;9437;141;462;2193;6740;2334;7202
291310;201806;5219;14391;4446;12961;158;513;3588;10315;3746;10828
291320;201806;6115;18014;4785;15340;1138;3444;2197;7372;3335;10816
291330;201806;1795;4719;1519;4268;74;222;1112;3035;1186;3257
291340;201806;4161;11003;3490;9917;83;311;2723;7609;2806;7920
291345;201806;3061;9482;2829;9147;146;507;2295;7465;2441;7972
291350;201806;6610;17298;5136;15289;133;397;4307;13007;4440;13404
291360;201806;34623;86215;28111;77658;4530;12796;15508;44007;20038;56803
291370;201806;7916;21913;7229;20968;445;1443;5546;15985;5991;17428
291380;201806;3402;9942;3028;9325;118;493;2453;7395;2571;7888
291390;201806;12644;29537;10262;26801;462;1383;8215;21343;8677;22726
291400;201806;13942;37336;11873;34217;1780;4680;7199;22035;8979;26715
291410;201806;2942;7810;2246;6627;61;263;1692;4847;1753;5110
291420;201806;1925;4951;1586;4515;45;184;1337;3772;1382;3956
291430;201806;3046;8552;2656;7960;95;440;2134;6191;2229;6631
291440;201806;6506;19024;5622;17502;363;1228;4430;13875;4793;15103
291450;201806;8534;22930;7236;21312;152;358;6249;18928;6401;19286
291460;201806;14570;40670;12927;38209;999;3211;9338;27593;10337;30804
291465;201806;8955;24637;7362;22719;277;1184;6139;18855;6416;20039
291470;201806;15965;39008;13618;36286;668;1694;10172;27907;10840;29601
291480;201806;39801;91673;29799;78016;3904;10707;15416;40589;19320;51296
291490;201806;5065;13714;4493;12989;245;759;3778;10945;4023;11704
291500;201806;5050;12664;4188;11473;74;308;3733;10163;3807;10471
291510;201806;3817;10692;3102;9624;102;512;2473;7596;2575;8108
291520;201806;4381;10672;3453;9425;216;606;2494;6843;2710;7449
291530;201806;2245;5526;1674;4718;328;806;943;2934;1271;3740
291535;201806;3210;9840;2952;9400;204;616;2249;7273;2453;7889
291540;201806;2252;5049;1602;4315;63;214;1399;3703;1462;3917
291550;201806;5439;13152;4314;11619;482;1196;2690;7380;3172;8576
291560;201806;20220;45422;13762;37706;921;2351;9295;26822;10216;29173
291570;201806;2316;5608;1890;5088;106;224;1563;4332;1669;4556
291580;201806;6145;16852;4962;15223;357;1293;3549;10725;3906;12018
291590;201806;1776;5139;1623;4907;148;472;1288;3895;1436;4367
291600;201806;5264;13542;3933;11410;572;1733;2267;6442;2839;8175
291610;201806;5328;15317;5048;15000;88;300;4737;14105;4825;14405
291620;201806;3181;7157;2295;6174;113;327;1753;4789;1866;5116
291630;201806;3264;7629;2498;6637;146;436;1969;5171;2115;5607
291640;201806;15765;41264;12180;35802;2151;6423;4699;14602;6850;21025
291650;201806;8702;23860;7727;22642;483;1151;6503;19432;6986;20583
291660;201806;2247;5481;1627;4514;124;438;1082;2833;1206;3271
291670;201806;2024;5357;1739;4956;109;273;1366;3945;1475;4218
291680;201806;3954;10497;3351;9502;310;923;2480;6998;2790;7921
291685;201806;4803;11670;3824;10386;309;678;2828;7992;3137;8670
291690;201806;4165;9664;3015;7990;110;253;2427;6376;2537;6629
291700;201806;8742;25952;7742;24145;502;1670;6134;18978;6636;20648
291710;201806;5310;13212;4014;11392;299;968;2759;7693;3058;8661
291720;201806;4584;14349;3773;12663;418;1534;2402;7850;2820;9384
291730;201806;6434;17300;5540;16110;296;1000;4462;12953;4758;13953
291733;201806;2984;7827;2493;7146;77;250;1874;5553;1951;5803
291735;201806;3021;7981;2507;7209;81;258;2087;6000;2168;6258
291740;201806;3929;10252;3083;8890;123;376;2377;6763;2500;7139
291750;201806;20116;49770;16126;43659;1968;5414;10063;27480;12031;32894
291760;201806;10652;31989;8567;28506;2845;10667;2027;6782;4872;17449
291770;201806;7095;20007;5916;17828;567;1833;4114;12136;4681;13969
291780;201806;4885;13536;4413;12816;115;391;3835;11035;3950;11426
291790;201806;2648;7725;2448;7441;219;603;1863;5734;2082;6337
291800;201806;29871;77806;23559;68385;3319;9415;13219;39410;16538;48825
291810;201806;10828;26782;8965;24451;232;784;7669;20714;7901;21498
291820;201806;3821;10515;3349;9804;132;460;2601;7601;2733;8061
291830;201806;4302;10657;3688;9802;248;694;2921;7760;3169;8454
291835;201806;6310;19190;5050;16748;826;2875;2859;9717;3685;12592
291840;201806;46544;129323;40414;121229;4836;14764;27696;84694;32532;99458
291845;201806;2443;6883;2125;6454;134;407;1735;5329;1869;5736
291850;201806;4129;11911;3370;10604;294;835;2409;7835;2703;8670
291855;201806;2053;4377;1636;3870;72;183;1387;3266;1459;3449
291860;201806;2267;6003;1600;4719;33;119;1086;3082;1119;3201
291870;201806;1377;3549;914;2699;59;179;602;1717;661;1896
291875;201806;2690;8237;2394;7703;97;365;1789;5606;1886;5971
291880;201806;5314;15832;4678;14663;338;1053;3446;10793;3784;11846
291890;201806;1509;3324;1024;2725;192;404;637;1765;829;2169
291900;201806;1201;3083;926;2614;24;97;723;1986;747;2083
291905;201806;2771;7066;2110;5953;83;288;1559;4278;1642;4566
291910;201806;2850;7400;2428;6888;80;261;2089;5935;2169;6196
291915;201806;7119;20886;5915;18794;286;1060;4455;14141;4741;15201
291920;201806;25754;71737;22690;67384;2838;9013;14720;43212;17558;52225
291930;201806;2454;7078;2125;6523;209;723;1443;4330;1652;5053
291940;201806;3586;9666;2456;7669;222;712;1478;4494;1700;5206
291950;201806;8851;27801;7721;25616;714;2524;4831;16151;5545;18675
291955;201806;13507;35950;12256;34323;1501;4128;8866;25397;10367;29525
291960;201806;3141;8646;2542;7756;164;502;1910;5958;2074;6460
291970;201806;4090;11494;3575;10740;190;738;2594;7743;2784;8481
291980;201806;10453;29744;8310;26453;712;2251;5638;18145;6350;20396
291990;201806;2055;5847;1920;5689;21;80;1808;5372;1829;5452
291992;201806;4215;10378;3083;8808;302;809;2359;6839;2661;7648
291995;201806;2175;6009;1761;5383;55;240;1433;4285;1488;4525
292000;201806;2466;6325;2048;5724;166;546;1470;4065;1636;4611
292010;201806;6239;14628;5095;13035;255;681;4185;10620;4440;11301
292020;201806;4545;13614;3861;12383;307;1070;2796;8795;3103;9865
292030;201806;1709;5492;1643;5379;94;363;1026;3251;1120;3614
292040;201806;4322;11429;3561;10359;232;601;2828;8479;3060;9080
292045;201806;4026;10876;3042;9405;73;160;2667;8445;2740;8605
292050;201806;6489;18850;5293;16555;385;1329;3318;10250;3703;11579
292060;201806;12799;29568;11700;28207;701;1631;9914;23619;10615;25250
292070;201806;5663;15314;4980;14490;305;924;4233;12294;4538;13218
292080;201806;3231;8257;2628;7488;123;385;2283;6505;2406;6890
292090;201806;4546;10117;3367;8735;257;668;2599;6882;2856;7550
292100;201806;10459;27072;8909;24964;1582;4543;4943;14022;6525;18565
292105;201806;3163;8828;2819;8284;73;328;2357;6799;2430;7127
292110;201806;6338;16234;4588;13318;1092;3201;2027;5946;3119;9147
292120;201806;6894;18372;5591;16040;522;1536;3895;11058;4417;12594
292130;201806;3182;8093;2678;7449;176;549;2037;5645;2213;6194
292140;201806;5071;12402;4222;11158;228;588;3410;8943;3638;9531
292145;201806;2268;6831;1939;6248;99;335;1420;4590;1519;4925
292150;201806;13146;37427;11863;35471;310;1240;9914;29305;10224;30545
292160;201806;2647;7064;2203;6488;76;219;1882;5623;1958;5842
292170;201806;8380;23089;6931;20629;599;1889;4746;14090;5345;15979
292180;201806;2932;8073;2145;6700;343;1006;1169;3671;1512;4677
292190;201806;2975;8111;2511;7440;210;641;1744;5232;1954;5873
292200;201806;7518;20255;5849;17712;1005;3143;3050;9403;4055;12546
292205;201806;3768;10767;3319;10072;67;340;2914;8668;2981;9008
292210;201806;6085;15211;5076;13860;114;474;4477;12042;4591;12516
292220;201806;2034;5149;1802;4815;98;275;1361;3565;1459;3840
292225;201806;3242;9614;2886;9071;92;385;2375;7365;2467;7750
292230;201806;8013;20016;7267;19019;172;666;6148;15748;6320;16414
292240;201806;5008;14613;4311;13270;392;1176;2829;8702;3221;9878
292250;201806;5304;14908;4839;14158;650;1828;3129;9297;3779;11125
292260;201806;3323;9129;2980;8658;180;497;2502;7372;2682;7869
292265;201806;3279;9461;2790;8639;87;380;2174;6568;2261;6948
292270;201806;4088;9845;3343;8939;208;606;2733;7320;2941;7926
292273;201806;2550;5768;2087;5195;84;159;1622;4203;1706;4362
292275;201806;1823;5057;1461;4530;76;192;1145;3681;1221;3873
292280;201806;2521;6233;2085;5727;98;213;1712;4887;1810;5100
292285;201806;2514;6359;1988;5602;99;287;1539;4375;1638;4662
292290;201806;6857;19482;5717;17809;225;808;4629;14399;4854;15207
292300;201806;9885;26397;7904;23833;1009;3232;5008;15269;6017;18501
292303;201806;2887;8423;2540;7883;63;201;2178;6765;2241;6966
292305;201806;2521;6776;2324;6483;48;212;2060;5646;2108;5858
292310;201806;6549;17490;5665;16358;200;637;4800;13754;5000;14391
292320;201806;6368;17333;5213;15238;304;1004;3930;11168;4234;12172
292330;201806;2465;5898;2149;5502;107;251;1712;4464;1819;4715
292335;201806;4864;12732;4345;11981;311;792;3510;9784;3821;10576
292340;201806;6166;16995;5184;15208;258;770;3866;11220;4124;11990
292350;201806;2454;6718;2021;6133;74;267;1686;5160;1760;5427
292360;201806;4927;13313;4197;11967;322;1045;2938;8142;3260;9187
292370;201806;10794;25124;9424;23286;168;516;8621;20911;8789;21427
292380;201806;6916;19722;6244;18562;488;1433;4685;13895;5173;15328
292390;201806;4205;8540;3058;7197;207;320;2569;6211;2776;6531
292400;201806;21598;64212;19263;60206;1985;6546;13252;41359;15237;47905
292405;201806;4476;11019;3663;9890;178;422;2952;8011;3130;8433
292410;201806;2069;5265;1817;4964;59;193;1576;4323;1635;4516
292420;201806;3679;11328;3414;10923;181;788;2836;8953;3017;9741
292430;201806;4962;15183;3853;13411;309;1115;2613;9270;2922;10385
292440;201806;8012;26330;7444;25527;108;542;6866;23647;6974;24189
292450;201806;3787;11303;3094;9949;135;489;2402;7732;2537;8221
292460;201806;4882;13816;4037;12352;363;1077;2874;8830;3237;9907
292465;201806;2513;6872;2066;6206;99;280;1455;4546;1554;4826
292467;201806;1730;5215;1598;5032;216;641;1107;3602;1323;4243
292470;201806;3031;7692;2381;6639;77;189;1873;5246;1950;5435
292480;201806;6559;15854;5246;14229;100;365;4647;12389;4747;12754
292490;201806;2171;5838;1804;5273;105;312;1366;4020;1471;4332
292500;201806;6521;18343;5346;16236;601;1813;3486;10632;4087;12445
292510;201806;12812;35367;10414;31714;634;2326;7589;23020;8223;25346
292520;201806;6710;17450;5815;16094;810;2215;3920;10985;4730;13200
292525;201806;5699;13875;4700;12721;123;342;4099;11118;4222;11460
292530;201806;27039;73919;22111;66135;5953;17923;8158;25519;14111;43442
292540;201806;3664;7943;2979;7182;167;404;2556;6172;2723;6576
292550;201806;7679;21504;6044;19387;435;1496;4451;14690;4886;16186
292560;201806;4284;11203;3663;10306;115;455;2984;8315;3099;8770
292570;201806;4040;10700;3491;9875;74;260;3122;8728;3196;8988
292575;201806;6868;20692;6404;20061;329;1143;5341;16695;5670;17838
292580;201806;7284;19308;6293;17855;201;670;5328;14981;5529;15651
292590;201806;7207;19571;6560;18613;296;998;5565;15407;5861;16405
292593;201806;2827;7088;2370;6322;93;250;1926;5105;2019;5355
292595;201806;5456;14740;4771;13874;175;617;3969;11416;4144;12033
292600;201806;11072;30513;9636;28431;536;1481;7425;22051;7961;23532
292610;201806;4476;11761;3693;10420;212;502;2622;7589;2834;8091
292620;201806;6456;18216;5524;17166;67;171;5237;16466;5304;16637
292630;201806;8859;22192;7250;19566;515;1389;4986;13513;5501;14902
292640;201806;8128;24549;7200;23051;244;982;5328;17075;5572;18057
292650;201806;4577;11466;4163;10918;159;430;3722;9637;3881;10067
292660;201806;11133;31227;9686;29076;552;1804;7559;22669;8111;24473
292665;201806;2217;6700;2023;6447;65;213;1756;5670;1821;5883
292670;201806;3578;9824;2779;8347;139;500;1875;5530;2014;6030
292680;201806;3942;10860;3241;9558;195;571;2344;6760;2539;7331
292690;201806;2636;7073;1854;5780;156;456;1190;3855;1346;4311
292700;201806;9621;26913;8377;25038;867;2460;5686;17533;6553;19993
292710;201806;2342;7599;2160;7362;59;213;1945;6679;2004;6892
292720;201806;9441;22909;7960;21249;309;908;6559;17705;6868;18613
292730;201806;4238;10699;3988;10382;186;394;3451;9033;3637;9427
292740;201806;332012;845157;300109;796366;51140;138912;173694;456343;224834;595255
292750;201806;6374;17167;5453;15797;277;849;4082;11916;4359;12765
292760;201806;3882;11426;3460;10670;279;948;2470;7545;2749;8493
292770;201806;5891;16570;4963;15150;863;2754;2848;9002;3711;11756
292780;201806;1952;4095;1458;3481;49;131;1173;2707;1222;2838
292790;201806;4098;8868;3302;7997;101;283;2978;7194;3079;7477
292800;201806;10706;27644;9354;25549;407;1108;7623;20643;8030;21751
292805;201806;3398;8636;2706;7675;206;550;2008;5712;2214;6262
292810;201806;10353;28530;8200;25233;304;1167;6072;18442;6376;19609
292820;201806;7738;21113;5575;17807;457;1722;3895;12184;4352;13906
292830;201806;2778;6598;2403;6137;74;256;2136;5403;2210;5659
292840;201806;8895;23737;7916;22407;171;663;6956;19207;7127;19870
292850;201806;2683;7277;2214;6526;151;515;1481;4215;1632;4730
292860;201806;16163;38502;14527;36410;925;2280;11598;29093;12523;31373
292870;201806;17585;46367;15402;43066;1113;3519;10033;27602;11146;31121
292880;201806;11748;32277;10203;30026;403;1629;7733;21940;8136;23569
292890;201806;6065;18241;5424;17180;299;1125;4366;13702;4665;14827
292895;201806;2989;6705;2198;5518;96;236;1685;4199;1781;4435
292900;201806;2736;7747;2535;7416;76;356;2026;5693;2102;6049
292905;201806;4377;11982;3393;10474;214;711;2325;7191;2539;7902
292910;201806;5040;14231;4539;13391;345;1145;3251;9467;3596;10612
292920;201806;9927;27601;9322;26776;301;1169;8105;22834;8406;24003
292925;201806;5264;15187;4678;14200;263;827;3525;10576;3788;11403
292930;201806;6242;19347;5578;18028;460;1886;3555;11105;4015;12991
292935;201806;2215;6080;1802;5623;36;173;1596;5052;1632;5225
292937;201806;3129;7636;2709;7126;75;228;2367;6233;2442;6461
292940;201806;3161;8269;2533;7271;185;457;1843;5434;2028;5891
292950;201806;9651;25491;8593;23885;388;1172;6635;18090;7023;19262
292960;201806;5394;13012;4583;11925;106;313;3720;9512;3826;9825
292970;201806;4023;11763;3476;10982;120;522;2845;9004;2965;9526
292975;201806;4490;9896;3987;9312;207;401;3527;8353;3734;8754
292980;201806;3309;8295;2639;7254;124;386;2027;5454;2151;5840
292990;201806;11355;31445;9668;28603;697;2222;7236;21397;7933;23619
293000;201806;2662;6517;2381;6140;32;134;1857;4921;1889;5055
293010;201806;17942;47380;14709;42056;1970;5730;8940;25496;10910;31226
293015;201806;7587;24385;6162;21514;539;2276;4145;14307;4684;16583
293020;201806;9506;28963;8684;27834;157;736;7682;24704;7839;25440
293030;201806;5608;15325;4292;13275;126;433;2855;9114;2981;9547
293040;201806;3970;11497;3530;10877;102;370;3076;9426;3178;9796
293050;201806;21524;54970;19111;51559;1589;4400;13371;36313;14960;40713
293060;201806;3503;9306;2875;8276;189;611;2111;5940;2300;6551
293070;201806;24789;62395;20570;56608;3472;9634;11887;33583;15359;43217
293075;201806;3300;10772;2984;10249;228;986;2333;7938;2561;8924
293076;201806;3625;9392;3235;8860;99;267;2709;7494;2808;7761
293077;201806;5367;15627;4521;14400;497;1607;2965;9708;3462;11315
293080;201806;4756;14425;4214;13514;151;665;3375;10607;3526;11272
293090;201806;3175;9614;2508;8490;252;910;1579;5329;1831;6239
293100;201806;5761;16012;4723;14127;314;963;3581;10719;3895;11682
293105;201806;3779;12082;3300;11125;242;849;2332;7776;2574;8625
293110;201806;2413;6034;2030;5504;65;231;1699;4499;1764;4730
293120;201806;4183;11915;3770;11229;147;430;3141;9336;3288;9766
293130;201806;3802;10786;3395;10267;101;396;2917;8791;3018;9187
293135;201806;30380;74232;22535;63090;4285;13199;9319;26321;13604;39520
293140;201806;2224;5444;1988;5150;86;246;1654;4196;1740;4442
293150;201806;5360;16835;4502;15128;493;1648;2949;10058;3442;11706
293160;201806;3927;9675;3345;8983;267;524;2719;7652;2986;8176
293170;201806;4023;9801;3512;9113;119;345;2857;7385;2976;7730
293180;201806;4758;13032;3858;11529;105;489;3121;9077;3226;9566
293190;201806;13642;38848;12184;36661;302;1329;10450;31140;10752;32469
293200;201806;8051;20498;6654;18454;243;902;5124;14018;5367;14920
293210;201806;5147;13890;4397;12703;240;692;3450;9960;3690;10652
293220;201806;5021;13857;3860;11781;911;2770;1440;4632;2351;7402
293230;201806;3924;10651;3043;9349;297;984;2007;6262;2304;7246
293240;201806;4412;11910;3530;10433;103;302;2687;8083;2790;8385
293245;201806;4085;11101;3633;10472;172;560;3002;8549;3174;9109
293250;201806;5634;14083;4817;12937;290;757;3770;10101;4060;10858
293260;201806;4489;12729;3707;11513;123;408;2623;8090;2746;8498
293270;201806;6718;15908;5460;14521;537;1024;4198;11853;4735;12877
293280;201806;4978;13401;4245;12370;249;703;3185;9313;3434;10016
293290;201806;13112;41443;11919;39402;2783;9123;5788;20061;8571;29184
293300;201806;6229;14912;5323;13702;340;769;3915;10285;4255;11054
293305;201806;4173;10547;3649;9839;60;186;3193;8580;3253;8766
293310;201806;2200;5697;1794;4999;80;237;1334;3660;1414;3897
293315;201806;4218;10406;3460;9240;162;417;2777;7356;2939;7773
293317;201806;2499;6407;2219;5946;125;299;1702;4566;1827;4865
293320;201806;9341;26269;8735;25545;623;1899;7350;21574;7973;23473
293325;201806;1753;4649;1392;4092;201;614;879;2576;1080;3190
293330;201806;45118;142640;39451;132234;8712;29717;17231;58696;25943;88413
293340;201806;2457;6951;1991;6139;140;490;1318;4018;1458;4508
293345;201806;3271;9299;2732;8548;287;647;1947;6546;2234;7193
293350;201806;6818;19453;6074;18613;73;216;5636;17634;5709;17850
293360;201806;15130;40048;13185;37624;520;1774;11586;32779;12106;34553
310010;201806;855;2112;621;1766;66;214;274;738;340;952
310020;201806;2218;6491;1734;5656;404;1443;271;849;675;2292
310030;201806;2238;6560;1789;5748;265;974;1109;3403;1374;4377
310040;201806;965;2510;784;2237;54;203;585;1596;639;1799
310050;201806;1589;5197;1442;4919;260;994;712;2342;972;3336
310060;201806;3366;9693;2897;9067;143;633;2366;7289;2509;7922
310070;201806;349;855;251;685;8;21;180;477;188;498
310080;201806;819;2269;564;1744;75;279;227;654;302;933
310090;201806;4486;12606;3785;11439;344;1158;2714;8095;3058;9253
310100;201806;3347;9693;2845;8866;120;510;2253;6838;2373;7348
310110;201806;5018;13604;4012;11805;736;2445;1840;5118;2576;7563
310120;201806;652;1699;436;1330;72;275;195;510;267;785
310130;201806;375;1079;317;977;52;200;179;488;231;688
310140;201806;210;662;155;567;40;178;41;121;81;299
310150;201806;4618;13382;3630;11441;733;2484;1280;3895;2013;6379
310160;201806;7154;20045;5477;17097;1332;4539;1429;4322;2761;8861
310163;201806;1045;3136;856;2793;254;923;234;681;488;1604
310170;201806;9071;24150;7531;21786;766;2276;5212;15095;5978;17371
310180;201806;1693;4520;1369;4007;114;413;926;2599;1040;3012
310190;201806;3014;9423;2528;8465;605;2214;320;1007;925;3221
310200;201806;1735;5430;1357;4646;249;939;510;1697;759;2636
310205;201806;1131;3170;854;2753;188;633;378;1229;566;1862
310210;201806;2812;7542;2325;6778;109;342;1737;5027;1846;5369
310220;201806;1088;3041;905;2743;101;334;635;1878;736;2212
310230;201806;2343;6791;1961;6018;234;878;1158;3314;1392;4192
310240;201806;891;2978;775;2762;67;297;525;1822;592;2119
310250;201806;986;2831;832;2565;71;282;564;1664;635;1946
310260;201806;2828;8185;1854;6338;476;1852;301;778;777;2630
310270;201806;2685;6998;2120;6214;129;516;1689;4829;1818;5345
310280;201806;2338;5743;1857;5026;223;698;1144;2949;1367;3647
310285;201806;1918;6459;1673;6032;180;758;1021;3681;1201;4439
310290;201806;1125;3161;993;2923;213;718;531;1415;744;2133
310300;201806;1501;4777;1369;4549;236;934;681;2097;917;3031
310310;201806;320;818;220;646;34;93;115;344;149;437
310320;201806;497;1326;318;992;30;123;163;471;193;594
310330;201806;520;1248;316;878;36;113;132;326;168;439
310340;201806;7971;22448;6368;19711;1123;3400;3045;9804;4168;13204
310350;201806;12367;31465;8659;25368;2069;6501;2633;7484;4702;13985
310360;201806;467;1198;389;1097;12;38;298;822;310;860
310370;201806;1317;4261;1115;3865;226;838;386;1357;612;2195
310375;201806;1017;2686;668;2108;114;384;253;784;367;1168
310380;201806;376;899;200;588;37;105;69;185;106;290
310390;201806;454;1456;378;1303;100;368;78;214;178;582
310400;201806;9737;25057;6902;20497;1158;3812;3101;8920;4259;12732
310410;201806;775;2337;497;1817;128;509;111;371;239;880
310420;201806;4025;10830;2593;7910;483;1661;612;1634;1095;3295
310430;201806;1372;4012;923;3128;190;696;232;742;422;1438
310440;201806;586;1535;408;1210;26;110;229;657;255;767
310445;201806;1360;4068;1017;3399;59;228;720;2369;779;2597
310450;201806;4755;12399;3571;10529;218;737;2679;7832;2897;8569
310460;201806;1734;4778;1211;3780;245;827;329;998;574;1825
310470;201806;3947;8711;3163;7683;287;852;2486;5889;2773;6741
310480;201806;1170;3175;848;2607;143;476;473;1395;616;1871
310490;201806;2987;8886;2409;7777;408;1576;1079;3231;1487;4807
310500;201806;1486;4394;1089;3619;212;757;482;1568;694;2325
310510;201806;1834;5214;1269;4107;293;1015;309;1007;602;2022
310520;201806;1391;3508;1004;2873;129;368;576;1647;705;2015
310530;201806;876;2447;458;1464;67;233;78;197;145;430
310540;201806;3341;9938;2789;8940;711;2393;1066;3272;1777;5665
310550;201806;1242;3273;891;2674;95;366;548;1548;643;1914
310560;201806;13916;39101;10898;33828;2372;8141;3658;10371;6030;18512
310570;201806;1120;3188;923;2861;109;420;595;1772;704;2192
310590;201806;4230;11791;3464;10438;377;1303;1953;5648;2330;6951
310600;201806;1479;4541;1218;3969;180;635;540;1651;720;2286
310610;201806;523;1460;345;1150;58;230;163;499;221;729
310620;201806;155954;426328;118996;358691;25164;84846;43395;116356;68559;201202
310630;201806;4526;12912;3818;11624;305;1077;2612;7748;2917;8825
310640;201806;1052;3284;875;2928;211;768;269;846;480;1614
310650;201806;2536;7618;1884;6366;224;831;1026;3360;1250;4191
310660;201806;1284;3620;1104;3403;55;175;877;2663;932;2838
310665;201806;1286;3585;1070;3257;55;205;847;2571;902;2776
310670;201806;47288;131447;39896;117907;6367;20655;22002;61947;28369;82602
310680;201806;685;1753;584;1612;27;76;450;1221;477;1297
310690;201806;1677;4759;1273;4064;148;570;697;2101;845;2671
310700;201806;529;1214;397;1053;43;130;272;702;315;832
310710;201806;5585;16960;4080;14691;899;3800;433;1502;1332;5302
310720;201806;861;2299;718;2098;72;249;505;1439;577;1688
310730;201806;9196;26582;7950;24519;624;2307;5403;16341;6027;18648
310740;201806;5392;15814;3811;12486;697;2461;986;3063;1683;5524
310750;201806;1329;3299;939;2739;148;492;392;1066;540;1558
310760;201806;547;1549;422;1327;42;146;179;572;221;718
310770;201806;1079;3061;728;2525;108;406;349;1176;457;1582
310780;201806;4030;10423;3246;9150;194;556;2264;6294;2458;6850
310790;201806;1916;6068;1697;5654;340;1128;741;2627;1081;3755
310800;201806;2421;7494;1786;6196;459;1872;112;339;571;2211
310810;201806;1150;3057;940;2669;71;240;592;1613;663;1853
310820;201806;1125;3146;737;2397;154;540;190;596;344;1136
310825;201806;2829;9391;2327;8516;94;551;1836;6533;1930;7084
310830;201806;1431;4333;1087;3651;243;914;400;1264;643;2178
310840;201806;2079;5852;1443;4699;328;1180;352;1019;680;2199
310850;201806;1502;4214;1295;3940;66;321;1007;2927;1073;3248
310855;201806;3234;8914;2574;7891;233;858;1834;5500;2067;6358
310860;201806;7013;20744;5666;18091;547;1853;3453;11035;4000;12888
310870;201806;1061;2601;792;2191;92;265;550;1519;642;1784
310880;201806;1012;3077;807;2662;101;356;477;1544;578;1900
310890;201806;2393;6895;1659;5568;383;1431;233;681;616;2112
310900;201806;4564;13141;3432;10939;574;2060;1465;4264;2039;6324
310910;201806;1720;4644;1048;3339;143;510;145;385;288;895
310920;201806;1862;5168;1449;4483;243;789;736;2261;979;3050
310925;201806;972;2892;817;2627;123;440;534;1667;657;2107
310930;201806;5844;15963;4338;13529;788;2605;2193;7008;2981;9613
310940;201806;6281;16376;5061;14536;373;1232;3459;9703;3832;10935
310945;201806;1255;3436;1055;3146;92;322;662;1920;754;2242
310950;201806;1949;5912;1361;4633;276;1058;444;1385;720;2443
310960;201806;755;1933;447;1356;65;217;146;455;211;672
310970;201806;1174;3630;834;2904;209;788;194;624;403;1412
310980;201806;383;890;240;661;22;60;153;398;175;458
310990;201806;1245;3706;957;3109;207;690;361;1146;568;1836
311000;201806;4104;11977;3163;10383;889;3137;1122;3537;2011;6674
311010;201806;773;2457;650;2178;245;878;206;671;451;1549
311020;201806;999;2697;682;2087;90;319;295;847;385;1166
311030;201806;1545;4093;1052;3209;289;987;328;884;617;1871
311040;201806;345;1118;274;944;66;225;68;209;134;434
311050;201806;2373;6556;1873;5739;440;1496;704;2049;1144;3545
311060;201806;2715;7519;1873;5733;285;1019;719;1957;1004;2976
311070;201806;1814;5126;1352;4312;196;753;607;1807;803;2560
311080;201806;958;2470;785;2166;72;263;522;1329;594;1592
311090;201806;2022;6786;1606;6002;406;1684;463;1699;869;3383
311100;201806;2033;6182;1379;4848;351;1381;180;559;531;1940
311110;201806;3305;7473;2119;5760;478;1387;870;2396;1348;3783
311115;201806;1251;3378;1028;3052;76;281;770;2225;846;2506
311120;201806;6831;18581;5048;15238;909;3103;1625;4340;2534;7443
311130;201806;1953;5546;1566;4952;165;653;783;2351;948;3004
311140;201806;1328;3361;983;2876;69;226;622;1862;691;2088
311150;201806;1539;5073;1298;4601;205;797;699;2412;904;3209
311160;201806;3816;11701;2769;9776;803;3132;689;2335;1492;5467
311170;201806;845;2349;659;2037;42;144;404;1271;446;1415
311180;201806;1296;3146;859;2470;204;636;329;930;533;1566
311190;201806;1096;3048;809;2492;123;453;320;888;443;1341
311200;201806;1727;4946;1268;4034;350;1199;250;722;600;1921
311205;201806;925;2908;768;2599;66;283;427;1400;493;1683
311210;201806;974;3001;871;2868;129;409;620;2095;749;2504
311220;201806;757;2265;627;2004;101;360;291;852;392;1212
311230;201806;7963;24758;6003;20639;1157;4175;1928;6849;3085;11024
311240;201806;933;2718;748;2431;159;581;390;1231;549;1812
311250;201806;840;2476;689;2223;162;545;301;943;463;1488
311260;201806;2310;5858;1559;4622;321;1004;502;1390;823;2394
311265;201806;1226;3317;940;2842;65;250;638;1866;703;2116
311270;201806;3176;9749;2772;9130;210;984;1955;6113;2165;7097
311280;201806;1214;3334;608;1982;105;375;99;299;204;674
311290;201806;1895;5984;1767;5703;190;617;1186;3816;1376;4433
311300;201806;4542;13460;3828;12280;211;994;2953;9262;3164;10256
311310;201806;638;1947;542;1757;93;321;198;591;291;912
311320;201806;3167;10167;2790;9297;430;1634;1231;3775;1661;5409
311330;201806;4716;13253;4032;12084;500;1642;2193;6679;2693;8321
311340;201806;10751;32602;8758;28732;2480;8600;2041;6797;4521;15397
311350;201806;2221;5903;1628;4787;166;556;834;2224;1000;2780
311360;201806;925;2551;734;2281;308;1050;166;513;474;1563
311370;201806;4322;11478;3291;9705;241;916;1929;5379;2170;6295
311380;201806;426;1353;341;1174;84;291;112;405;196;696
311390;201806;1738;5715;1452;5302;614;2555;358;1135;972;3690
311400;201806;1440;4266;1049;3457;158;605;405;1192;563;1797
311410;201806;1587;5064;1366;4767;270;1045;661;2312;931;3357
311420;201806;1694;5281;1144;4014;198;732;145;384;343;1116
311430;201806;3482;9832;2346;7468;422;1409;600;1911;1022;3320
311440;201806;2427;7341;1739;6043;439;1726;449;1499;888;3225
311450;201806;1830;5845;1376;4935;348;1378;278;870;626;2248
311455;201806;966;2392;683;1936;184;508;227;651;411;1159
311460;201806;555;1813;387;1457;84;404;102;333;186;737
311470;201806;444;1443;334;1181;75;304;52;162;127;466
311480;201806;1488;5181;1366;5018;55;153;1200;4586;1255;4739
311490;201806;225;730;191;646;47;176;77;234;124;410
311500;201806;439;1169;326;973;38;131;183;539;221;670
311510;201806;2784;7963;1973;6431;404;1507;581;1780;985;3287
311520;201806;573;1761;528;1668;122;430;270;808;392;1238
311530;201806;9346;22981;6225;17752;1475;4687;1603;4475;3078;9162
311535;201806;769;2146;515;1678;107;414;122;367;229;781
311540;201806;533;1754;482;1657;118;394;235;829;353;1223
311545;201806;2092;5970;1781;5560;104;423;1324;4034;1428;4457
311547;201806;1518;4015;1311;3683;37;133;988;2804;1025;2937
311550;201806;2769;8160;2200;7043;380;1370;783;2375;1163;3745
311560;201806;255;602;193;525;32;85;101;247;133;332
311570;201806;1914;4629;1428;3960;56;161;1143;3258;1199;3419
311580;201806;2264;4336;1539;3486;211;405;964;2293;1175;2698
311590;201806;506;1455;418;1322;72;268;212;638;284;906
311600;201806;1513;3806;1249;3465;73;226;1026;2804;1099;3030
311610;201806;2448;8420;2100;7621;415;1499;953;3502;1368;5001
311615;201806;3019;9168;2482;8292;173;709;1839;6042;2012;6751
311620;201806;396;1141;348;1065;19;73;271;812;290;885
311630;201806;1369;3858;1099;3342;84;280;749;2204;833;2484
311640;201806;579;1793;477;1591;95;364;202;636;297;1000
311650;201806;1996;5405;1695;4929;158;570;1117;3103;1275;3673
311660;201806;2934;8735;2135;7189;420;1527;398;1144;818;2671
311670;201806;1568;4203;1221;3643;198;667;542;1652;740;2319
311680;201806;2104;6240;1621;5373;259;927;978;3195;1237;4122
311690;201806;567;1290;456;1156;31;80;347;907;378;987
311700;201806;2283;5625;1759;4907;39;146;1426;3892;1465;4038
311710;201806;1521;4548;1055;3620;276;1006;322;1128;598;2134
311720;201806;412;1288;338;1144;37;151;178;576;215;727
311730;201806;4743;11969;2833;8482;867;2878;377;1065;1244;3943
311740;201806;770;2328;705;2236;40;118;626;2011;666;2129
311750;201806;3963;12309;3284;11170;432;1681;1842;5974;2274;7655
311760;201806;662;2017;554;1804;102;404;186;497;288;901
311770;201806;1977;6049;1538;5187;316;1158;528;1659;844;2817
311780;201806;1233;3912;920;3227;189;752;239;728;428;1480
311783;201806;2126;6319;1773;5689;57;266;1452;4575;1509;4841
311787;201806;701;2118;505;1654;69;260;188;527;257;787
311790;201806;1551;4166;1031;3259;252;883;336;1049;588;1932
311800;201806;5147;16321;4298;14358;789;2889;618;1856;1407;4745
311810;201806;984;3127;798;2762;62;257;466;1608;528;1865
311820;201806;734;2011;582;1727;84;306;353;973;437;1279
311830;201806;8577;25892;6061;20218;1535;5476;623;1968;2158;7444
311840;201806;3000;8382;2599;7791;342;1136;1739;5175;2081;6311
311850;201806;304;886;255;806;26;87;160;496;186;583
311860;201806;53027;141733;42125;123611;6856;21358;23085;66130;29941;87488
311870;201806;1939;5443;1351;4310;254;935;482;1346;736;2281
311880;201806;6144;16941;5324;15767;388;1097;4024;12032;4412;13129
311890;201806;1476;3926;1175;3454;141;456;724;2061;865;2517
311900;201806;693;1890;535;1652;54;200;365;1099;419;1299
311910;201806;4312;11504;3309;10181;674;2131;1586;4943;2260;7074
311920;201806;1975;5824;1616;5213;168;575;942;3020;1110;3595
311930;201806;3235;8440;2546;7398;965;2973;719;1945;1684;4918
311940;201806;13897;38925;10528;32305;1614;5440;4425;12781;6039;18221
311950;201806;2186;6242;1652;5315;109;476;1120;3504;1229;3980
311960;201806;573;1424;473;1263;38;177;317;707;355;884
311970;201806;438;1460;291;1075;52;222;60;202;112;424
311980;201806;447;1273;267;904;36;127;82;268;118;395
311990;201806;522;1326;365;1103;96;336;140;392;236;728
311995;201806;1004;2900;551;1829;24;87;54;122;78;209
312000;201806;565;1589;487;1471;34;106;349;1066;383;1172
312010;201806;894;2742;706;2341;78;279;388;1251;466;1530
312015;201806;1307;4041;1172;3792;75;320;876;2731;951;3051
312020;201806;1130;3567;978;3292;215;779;382;1254;597;2033
312030;201806;1998;5187;1754;4906;34;158;1608;4436;1642;4594
312040;201806;771;2525;592;2136;72;295;229;794;301;1089
312050;201806;1229;4094;984;3579;240;1004;242;771;482;1775
312060;201806;813;2209;596;1914;137;455;278;889;415;1344
312070;201806;894;2692;635;2146;77;283;333;1086;410;1369
312080;201806;2756;7088;2050;5999;165;559;1243;3426;1408;3985
312083;201806;925;2487;713;2155;83;275;461;1334;544;1609
312087;201806;2209;6180;1896;5736;91;336;1470;4457;1561;4793
312090;201806;9332;26351;7286;22828;1566;5196;2982;9234;4548;14430
312100;201806;1512;4672;1084;3878;144;635;513;1740;657;2375
312110;201806;1021;3343;865;3007;243;951;222;675;465;1626
312120;201806;704;2057;523;1721;142;523;181;524;323;1047
312125;201806;1329;3844;1181;3619;148;473;857;2606;1005;3079
312130;201806;867;2280;663;1909;69;222;275;748;344;970
312140;201806;796;2467;658;2148;146;514;253;762;399;1276
312150;201806;465;1346;399;1190;13;55;269;751;282;806
312160;201806;7902;23915;6260;20749;1043;3941;2579;8043;3622;11984
312170;201806;841;2359;672;2055;32;97;452;1348;484;1445
312180;201806;1410;4028;1160;3528;163;559;589;1673;752;2232
312190;201806;552;1700;400;1369;90;336;75;260;165;596
312200;201806;4752;13225;3890;11699;729;2265;2157;6427;2886;8692
312210;201806;1321;3232;964;2716;78;277;647;1759;725;2036
312220;201806;1962;6160;1733;5786;161;545;1142;3833;1303;4378
312230;201806;11579;32651;8043;25954;2286;8126;1097;3181;3383;11307
312235;201806;1627;4577;1376;4208;121;427;973;2918;1094;3345
312240;201806;749;2472;577;2091;122;484;149;510;271;994
312245;201806;2485;6729;2118;6220;83;317;1727;5028;1810;5345
312247;201806;832;2244;605;1884;143;466;279;881;422;1347
312250;201806;1023;2726;696;2120;128;396;258;765;386;1161
312260;201806;918;2679;736;2385;58;225;514;1608;572;1833
312270;201806;694;2003;550;1719;33;149;288;824;321;973
312280;201806;442;1363;353;1186;113;387;41;131;154;518
312290;201806;770;2444;650;2214;121;459;223;735;344;1194
312300;201806;894;2754;653;2165;168;609;96;249;264;858
312310;201806;775;2656;668;2436;104;449;297;1037;401;1486
312320;201806;1933;5235;1458;4377;406;1311;279;785;685;2096
312330;201806;878;2579;739;2361;86;307;511;1593;597;1900
312340;201806;271;726;203;617;31;105;105;310;136;415
312350;201806;266;607;224;565;25;75;160;388;185;463
312352;201806;1648;4932;1424;4551;146;458;916;3098;1062;3556
312360;201806;2678;8284;2057;6929;433;1576;464;1519;897;3095
312370;201806;1755;5020;1479;4528;305;1035;662;1909;967;2944
312380;201806;2151;5202;1833;4789;27;66;1636;4292;1663;4358
312385;201806;1254;3574;1023;3162;159;565;562;1638;721;2203
312390;201806;1935;5871;1485;5013;268;1007;453;1368;721;2375
312400;201806;2998;9093;2359;7838;807;2826;625;2123;1432;4949
312410;201806;11465;33881;9516;30345;1879;6297;4449;13948;6328;20245
312420;201806;3747;10974;3286;10128;592;1979;1736;5218;2328;7197
312430;201806;8082;22202;6584;19557;641;2051;4341;12775;4982;14826
312440;201806;936;2982;705;2448;329;1208;78;245;407;1453
312450;201806;1180;3684;898;3126;258;959;297;1052;555;2011
312460;201806;410;1084;290;905;44;152;168;547;212;699
312470;201806;513;1351;328;1019;58;214;106;291;164;505
312480;201806;1212;3035;823;2510;117;383;459;1365;576;1748
312490;201806;1990;5037;1541;4338;246;722;830;2278;1076;3000
312500;201806;831;2193;665;1947;63;228;426;1206;489;1434
312510;201806;3781;10575;2887;8834;532;1613;1154;3456;1686;5069
312520;201806;186;559;155;506;42;137;66;216;108;353
312530;201806;610;1641;526;1531;29;96;442;1291;471;1387
312540;201806;1433;4260;936;3161;203;731;383;1271;586;2002
312550;201806;765;2195;599;1807;61;199;344;936;405;1135
312560;201806;1986;5253;1649;4781;77;290;1298;3712;1375;4002
312570;201806;2277;6119;1759;5359;521;1668;621;1940;1142;3608
312580;201806;554;1687;433;1416;53;206;181;562;234;768
312590;201806;1675;5141;1383;4555;147;619;749;2312;896;2931
312595;201806;1675;5405;1529;5105;264;850;911;3160;1175;4010
312600;201806;975;2564;594;1987;84;341;224;730;308;1071
312610;201806;6604;17407;4349;13217;760;2524;1141;3267;1901;5791
312620;201806;2404;6368;1759;5471;65;283;1351;4274;1416;4557
312630;201806;244;790;205;717;40;159;80;281;120;440
312640;201806;601;1683;400;1326;54;174;129;438;183;612
312650;201806;2094;5657;1429;4327;109;394;920;2648;1029;3042
312660;201806;1376;3440;1056;2946;107;352;706;1895;813;2247
312670;201806;5144;14157;4179;12756;355;1421;2736;8021;3091;9442
312675;201806;1297;3708;1051;3265;77;317;797;2418;874;2735
312680;201806;1370;3970;1157;3652;74;313;881;2714;955;3027
312690;201806;2322;5744;1840;5090;128;394;1388;3748;1516;4142
312695;201806;945;2887;819;2658;71;217;607;1995;678;2212
312700;201806;2034;5648;1488;4632;162;556;807;2426;969;2982
312705;201806;1290;3488;1063;3110;30;105;835;2404;865;2509
312707;201806;1413;4364;1080;3711;90;432;631;2050;721;2482
312710;201806;6599;15407;3877;11234;1128;3568;881;2622;2009;6190
312720;201806;995;2891;754;2471;93;356;384;1198;477;1554
312730;201806;1642;4025;1258;3503;64;200;828;2258;892;2458
312733;201806;1539;4103;1180;3442;39;136;774;2166;813;2302
312735;201806;709;1941;605;1746;91;319;395;1034;486;1353
312737;201806;784;1924;558;1576;90;291;286;749;376;1040
312738;201806;567;1586;391;1250;71;268;165;492;236;760
312740;201806;371;922;209;669;52;178;45;116;97;294
312750;201806;1265;4172;1068;3780;172;687;507;1698;679;2385
312760;201806;1888;5839;1377;4762;262;961;397;1332;659;2293
312770;201806;40895;104606;27351;81217;6416;20173;7973;23072;14389;43245
312780;201806;2509;8116;2173;7508;245;970;1340;4606;1585;5576
312790;201806;289;745;185;595;18;80;74;205;92;285
312800;201806;4911;14903;3838;12667;760;2785;1538;4896;2298;7681
312810;201806;1853;5267;1238;4129;290;1068;347;1025;637;2093
312820;201806;1881;5203;1548;4610;65;256;1071;3076;1136;3332
312825;201806;1290;3231;1119;3014;38;120;928;2498;966;2618
312830;201806;2384;7092;1586;5496;394;1507;319;1061;713;2568
312840;201806;1140;3562;883;3024;150;598;306;946;456;1544
312850;201806;824;2236;599;1857;69;261;285;817;354;1078
312860;201806;1436;3766;942;2949;230;759;238;718;468;1477
312870;201806;6044;17598;3835;12853;585;2167;969;3020;1554;5187
312880;201806;1404;3735;1150;3364;56;176;709;2152;765;2328
312890;201806;2064;5718;1369;4332;201;659;523;1686;724;2345
312900;201806;1189;3287;961;2978;87;295;595;1893;682;2188
312910;201806;1585;3018;881;2090;133;324;417;973;550;1297
312920;201806;982;2799;705;2319;121;456;342;1056;463;1512
312930;201806;2134;5755;1737;5135;382;1151;742;2196;1124;3347
312940;201806;890;2739;762;2503;132;460;351;1139;483;1599
312950;201806;2646;7087;1976;6023;581;1879;645;1941;1226;3820
312960;201806;1946;5310;1641;4858;117;336;1215;3673;1332;4009
312965;201806;1744;5278;1463;4742;115;394;928;2985;1043;3379
312970;201806;1084;3291;839;2880;193;749;326;1063;519;1812
312980;201806;21331;63327;18208;57557;3159;11116;9203;27660;12362;38776
312990;201806;425;1208;283;972;67;271;116;383;183;654
313000;201806;436;1355;352;1202;51;224;150;470;201;694
313005;201806;2581;7699;2235;7112;175;648;1606;4976;1781;5624
313010;201806;4457;13121;3641;11700;706;2486;2026;6324;2732;8810
313020;201806;947;3015;655;2326;102;410;86;230;188;640
313030;201806;1286;3231;881;2601;115;415;461;1304;576;1719
313040;201806;808;2600;672;2284;71;286;335;1072;406;1358
313050;201806;1806;5292;1285;4492;244;1017;355;1098;599;2115
313055;201806;1707;4982;1545;4735;49;157;1338;4101;1387;4258
313060;201806;982;2662;696;2166;221;753;139;379;360;1132
313065;201806;1818;5683;1555;5255;105;437;1149;3824;1254;4261
313070;201806;866;2414;692;2106;91;306;380;1116;471;1422
313080;201806;386;1111;279;890;73;257;66;168;139;425
313090;201806;4753;13402;4018;12131;934;3037;2045;6082;2979;9119
313100;201806;1440;3838;1114;3350;62;224;843;2528;905;2752
313110;201806;1543;4207;1080;3335;109;411;532;1508;641;1919
313115;201806;2446;7604;2166;7037;351;1241;1063;3238;1414;4479
313120;201806;3699;9051;2844;7925;294;902;1786;4955;2080;5857
313130;201806;27154;76425;21916;66230;3230;11003;10855;30971;14085;41974
313140;201806;522;1276;351;1005;20;71;244;683;264;754
313150;201806;1308;3911;1017;3338;282;983;250;775;532;1758
313160;201806;971;2627;756;2250;65;221;484;1379;549;1600
313170;201806;11712;36222;8400;29262;1585;5698;2756;9274;4341;14972
313180;201806;2319;6318;1617;4907;240;790;783;2316;1023;3106
313190;201806;4205;12820;3159;10567;607;2139;948;2970;1555;5109
313200;201806;1103;3248;941;2947;37;147;769;2338;806;2485
313210;201806;3954;11855;3204;10493;468;1708;1787;5669;2255;7377
313220;201806;1753;4831;1196;3736;201;717;441;1233;642;1950
313230;201806;2643;8169;2388;7832;74;211;2079;6873;2153;7084
313240;201806;8844;23922;5820;18635;1077;3881;2273;6710;3350;10591
313250;201806;6254;19098;5123;16977;631;2233;2569;8392;3200;10625
313260;201806;631;1743;429;1330;61;227;180;533;241;760
313270;201806;5524;15650;4403;13743;811;2653;2475;7744;3286;10397
313280;201806;381;1147;269;917;42;159;97;308;139;467
313290;201806;779;2605;612;2339;233;965;149;540;382;1505
313300;201806;1680;5027;1293;4245;351;1233;207;600;558;1833
313310;201806;1036;3290;870;2946;154;603;194;545;348;1148
313320;201806;2232;6089;1567;5022;306;1123;691;2194;997;3317
313330;201806;4086;11575;3215;10172;220;962;2085;6353;2305;7315
313340;201806;1435;3363;1017;2756;141;395;639;1746;780;2141
313350;201806;2267;6688;1607;5258;246;895;539;1612;785;2507
313360;201806;1300;3445;900;2752;163;602;457;1282;620;1884
313370;201806;1277;3910;1153;3665;150;565;661;1975;811;2540
313375;201806;1843;4920;1209;3834;217;806;295;883;512;1689
313380;201806;5542;14962;4113;12306;826;2730;1702;4609;2528;7339
313390;201806;872;2917;784;2765;65;280;503;1724;568;2004
313400;201806;3557;9391;2909;8536;185;560;2268;6585;2453;7145
313410;201806;1253;3387;992;2954;106;367;702;2044;808;2411
313420;201806;15558;36480;8616;24543;1793;5617;1158;3355;2951;8972
313430;201806;907;2732;684;2284;107;434;273;807;380;1241
313440;201806;6188;13779;4043;10974;359;1009;2475;6753;2834;7762
313450;201806;630;1816;464;1482;103;349;138;390;241;739
313460;201806;2130;6564;1734;5915;397;1595;745;2330;1142;3925
313470;201806;3131;7889;2528;7051;209;562;1817;5111;2026;5673
313480;201806;907;2688;543;1853;78;298;146;435;224;733
313490;201806;1504;3621;759;2506;254;986;60;201;314;1187
313500;201806;416;1301;328;1083;35;132;125;370;160;502
313505;201806;9268;25884;8169;24511;315;1083;6994;21004;7309;22087
313507;201806;1487;3854;1243;3511;54;201;977;2727;1031;2928
313510;201806;13021;37056;10893;33254;1407;4681;5481;16269;6888;20950
313520;201806;13552;40300;11153;36014;865;3201;7682;24423;8547;27624
313530;201806;532;1562;438;1403;24;85;207;625;231;710
313535;201806;2459;6901;2153;6340;164;472;1484;4316;1648;4788
313540;201806;859;2688;643;2105;145;494;214;679;359;1173
313545;201806;1181;4079;1014;3739;177;710;545;1923;722;2633
313550;201806;1782;5479;1497;4889;358;1263;701;2191;1059;3454
313560;201806;2525;5251;1881;4479;84;210;1561;3675;1645;3885
313570;201806;946;3009;767;2645;183;703;308;1012;491;1715
313580;201806;5547;15289;4339;13326;650;2105;2261;7182;2911;9287
313590;201806;941;2739;726;2406;266;981;244;817;510;1798
313600;201806;3713;10527;3126;9582;172;679;2450;7399;2622;8078
313610;201806;998;2729;819;2394;122;369;496;1419;618;1788
313620;201806;5726;16058;4696;14236;883;2926;2191;6427;3074;9353
313630;201806;8333;21521;5822;17744;805;2754;2986;9164;3791;11918
313640;201806;1026;2507;634;1946;191;644;210;605;401;1249
313650;201806;1838;5734;1545;5247;106;448;1003;3400;1109;3848
313652;201806;798;2743;737;2608;130;500;433;1467;563;1967
313655;201806;1027;2948;831;2655;60;229;603;1889;663;2118
313657;201806;1308;3594;998;3088;53;223;718;2091;771;2314
313660;201806;848;2576;703;2279;117;449;355;1075;472;1524
313665;201806;4455;12875;3571;11229;548;1959;1897;5690;2445;7649
313670;201806;43102;116187;29473;90976;5450;18265;10664;31290;16114;49555
313680;201806;1012;2822;859;2585;76;256;543;1592;619;1848
313690;201806;837;2824;673;2477;136;516;220;826;356;1342
313695;201806;1606;4716;1263;4116;103;382;877;2842;980;3224
313700;201806;3227;10735;2783;10149;261;965;2177;8021;2438;8986
313710;201806;1438;3675;1035;3053;104;321;625;1843;729;2164
313720;201806;5665;16580;4140;13341;669;2397;1559;4616;2228;7013
313730;201806;1294;3194;987;2768;76;205;632;1726;708;1931
313740;201806;1766;6391;1461;5583;353;1495;170;560;523;2055
313750;201806;1957;5616;1531;4759;354;1220;538;1522;892;2742
313753;201806;2093;5265;1466;4244;183;595;803;2263;986;2858
313760;201806;5008;14487;3734;11936;896;3107;1298;3890;2194;6997
313770;201806;3687;10783;2973;9694;279;962;1975;6466;2254;7428
313780;201806;4047;11174;3037;9472;370;1305;846;2689;1216;3994
313790;201806;452;1458;413;1384;69;241;223;717;292;958
313800;201806;1323;3244;1069;2879;70;221;798;2160;868;2381
313810;201806;1623;4372;1317;3926;100;338;938;2813;1038;3151
313820;201806;12830;32306;9252;25958;1478;4659;3604;9542;5082;14201
313830;201806;339;1018;295;941;68;243;134;425;202;668
313835;201806;909;2803;767;2552;92;351;394;1236;486;1587
313840;201806;6607;18067;4896;15118;1173;3865;1054;3240;2227;7105
313850;201806;994;2570;818;2284;121;412;441;1107;562;1519
313860;201806;2716;7760;2005;6269;355;1187;682;1985;1037;3172
313862;201806;1473;3441;810;2414;74;231;419;1215;493;1446
313865;201806;2248;6464;1962;6019;148;484;1448;4369;1596;4853
313867;201806;1111;3706;943;3352;295;1098;389;1371;684;2469
313868;201806;1683;5466;1428;4937;113;491;1041;3517;1154;4008
313870;201806;806;2263;615;1925;119;401;208;576;327;977
313880;201806;1412;4012;1089;3463;223;770;413;1174;636;1944
313890;201806;2029;4818;1487;4110;149;459;940;2631;1089;3090
313900;201806;3695;11953;2956;10414;822;3144;659;2294;1481;5438
313910;201806;634;1994;483;1692;120;435;87;296;207;731
313920;201806;3016;9773;2513;8765;519;1807;1244;4431;1763;6238
313925;201806;1713;4542;1320;3811;268;742;735;2128;1003;2870
313930;201806;6024;20790;5080;19114;422;1540;3498;13784;3920;15324
313940;201806;8462;25803;6184;21760;1298;5207;1530;5829;2828;11036
313950;201806;4675;11409;3431;9682;571;2055;1895;5104;2466;7159
313960;201806;5508;14039;3758;11126;812;2625;1226;3394;2038;6019
313970;201806;1326;3893;1177;3640;70;283;717;2221;787;2504
313980;201806;1370;3832;905;3018;137;521;315;989;452;1510
313990;201806;1749;6056;1359;5081;387;1582;387;1336;774;2918
314000;201806;9242;26151;7924;23739;589;2230;5264;15482;5853;17712
314010;201806;1281;3267;1034;2934;44;171;799;2208;843;2379
314015;201806;2085;5905;1633;5192;217;814;881;2731;1098;3545
314020;201806;526;1507;320;1068;58;228;59;192;117;420
314030;201806;813;2509;632;2114;77;277;300;990;377;1267
314040;201806;740;2065;600;1792;107;349;271;770;378;1119
314050;201806;1570;4551;1194;3812;182;669;539;1576;721;2245
314053;201806;1732;5238;1433;4716;220;717;885;3052;1105;3769
314055;201806;2285;6369;1977;5916;57;242;1638;4891;1695;5133
314060;201806;1168;3315;898;2856;46;171;622;1937;668;2108
314070;201806;4364;12578;3415;10790;763;2461;1298;3990;2061;6451
314080;201806;1776;5278;1253;4110;215;835;393;1116;608;1951
314085;201806;2053;6441;1706;5892;373;1359;765;2631;1138;3990
314090;201806;3681;11177;3193;10371;264;1074;2111;6766;2375;7840
314100;201806;3231;7759;2612;6906;71;151;2112;5679;2183;5830
314110;201806;4198;12753;3556;11441;558;2031;1758;5247;2316;7278
314120;201806;848;1982;390;1213;91;331;62;183;153;514
314130;201806;784;2189;411;1380;54;203;146;477;200;680
314140;201806;4787;14202;3648;11871;658;2285;1530;4849;2188;7134
314150;201806;1483;3928;1140;3326;115;360;703;1979;818;2339
314160;201806;2436;6522;1773;5364;262;843;770;2377;1032;3220
314170;201806;1027;3009;838;2618;96;336;488;1426;584;1762
314180;201806;5281;15368;4420;13957;551;1867;2519;8007;3070;9874
314190;201806;743;2113;546;1796;99;354;267;876;366;1230
314200;201806;2912;8509;2422;7616;152;609;1702;5132;1854;5741
314210;201806;1965;5341;1650;4813;145;455;980;2798;1125;3253
314220;201806;1277;3741;906;3057;248;939;243;740;491;1679
314225;201806;1212;3480;1054;3252;69;223;773;2402;842;2625
314230;201806;769;2141;660;1998;109;368;385;1179;494;1547
314240;201806;1104;3140;866;2766;207;728;331;1071;538;1799
314250;201806;523;1517;341;1102;57;194;127;375;184;569
314260;201806;982;3128;808;2784;181;720;333;1045;514;1765
314270;201806;3128;9311;2535;8285;119;480;1859;5951;1978;6431
314280;201806;3379;8263;2112;6083;366;1175;805;2160;1171;3335
314290;201806;4537;12184;3802;10932;489;1429;2392;6794;2881;8223
314300;201806;1539;4739;1135;3844;290;1041;308;1021;598;2062
314310;201806;5228;14361;3828;11861;1173;3906;840;2419;2013;6325
314315;201806;874;3206;765;2959;66;308;529;1991;595;2299
314320;201806;2850;7900;1919;6284;434;1503;690;2268;1124;3771
314330;201806;48783;140639;38365;122712;11093;37199;8813;28644;19906;65843
314340;201806;2478;6424;1335;4215;251;932;253;623;504;1555
314345;201806;1347;4194;1140;3813;145;497;694;2288;839;2785
314350;201806;985;2836;686;2263;137;487;158;493;295;980
314360;201806;653;1984;405;1423;67;268;101;325;168;593
314370;201806;650;1894;537;1701;34;124;398;1224;432;1348
314380;201806;1176;3436;804;2695;208;773;118;395;326;1168
314390;201806;11877;32481;8031;25196;1715;5718;2031;5735;3746;11453
314400;201806;4172;12427;3336;11020;945;3244;1147;3914;2092;7158
314410;201806;2746;7984;1958;6434;337;1226;677;2379;1014;3605
314420;201806;742;1951;577;1715;19;98;444;1267;463;1365
314430;201806;6531;17715;4967;14951;1006;3197;1772;5297;2778;8494
314435;201806;1466;4415;1247;4052;47;200;926;2977;973;3177
314437;201806;926;2446;711;2134;35;129;405;1225;440;1354
314440;201806;538;1597;414;1364;115;430;121;346;236;776
314450;201806;1396;3953;1162;3560;147;556;661;1889;808;2445
314460;201806;3586;11434;2634;9263;639;2379;415;1447;1054;3826
314465;201806;2235;6654;1962;6117;60;248;1534;4668;1594;4916
314467;201806;927;2621;776;2355;23;64;609;1837;632;1901
314470;201806;2215;6679;1826;5858;367;1305;755;2254;1122;3559
314480;201806;5887;18217;4169;14189;758;2790;971;2995;1729;5785
314490;201806;870;2484;663;2054;94;324;383;1122;477;1446
314500;201806;1770;4717;1270;3867;254;796;440;1309;694;2105
314505;201806;1953;5164;1649;4734;124;421;1181;3337;1305;3758
314510;201806;1760;4737;1202;3919;252;899;482;1543;734;2442
314520;201806;3808;12327;2659;9647;473;1938;260;790;733;2728
314530;201806;5551;18636;5075;17718;521;2023;3433;11993;3954;14016
314535;201806;2623;7029;2133;6313;137;490;1591;4609;1728;5099
314537;201806;1121;3304;851;2839;72;271;571;1864;643;2135
314540;201806;397;1064;276;835;30;115;126;354;156;469
314545;201806;1672;4504;1499;4263;57;168;1254;3716;1311;3884
314550;201806;676;1727;495;1468;45;174;241;639;286;813
314560;201806;4075;13163;3248;11306;557;2101;1030;3390;1587;5491
314570;201806;306;876;236;741;37;127;110;343;147;470
314580;201806;487;1588;365;1323;90;344;56;205;146;549
314585;201806;748;2396;563;1975;77;343;248;804;325;1147
314587;201806;1948;5620;1523;4900;238;702;823;2704;1061;3406
314590;201806;3038;9318;2215;7539;399;1475;716;2317;1115;3792
314600;201806;1822;5379;1105;3900;246;963;113;348;359;1311
314610;201806;8261;23302;6133;19785;1221;4569;2426;7522;3647;12091
314620;201806;1860;4898;1501;4387;75;257;1217;3496;1292;3753
314625;201806;1503;4621;1322;4351;97;477;996;3133;1093;3610
314630;201806;4965;13749;4155;12519;148;613;3367;10078;3515;10691
314640;201806;596;1563;427;1266;86;288;187;502;273;790
314650;201806;967;2511;646;1985;63;229;270;738;333;967
314655;201806;1555;4454;1119;3612;233;747;461;1490;694;2237
314660;201806;330;803;207;566;13;30;115;296;128;326
314670;201806;1655;4134;1206;3404;67;249;756;2080;823;2329
314675;201806;1794;4982;1533;4522;111;394;1151;3316;1262;3710
314690;201806;2114;6397;1616;5523;502;1876;365;1229;867;3105
314700;201806;9912;30069;6494;22769;1446;5667;1363;4549;2809;10216
314710;201806;8213;23985;5850;18879;1169;4103;1205;3422;2374;7525
314720;201806;2248;7054;1666;5795;365;1385;397;1376;762;2761
314730;201806;2056;5975;1534;4958;393;1330;418;1258;811;2588
314740;201806;2845;8402;2310;7430;258;939;1234;3888;1492;4827
314750;201806;340;986;262;827;28;108;139;405;167;513
314760;201806;1851;5855;1282;4501;182;731;298;864;480;1595
314770;201806;1050;3164;522;1762;39;140;130;380;169;520
314780;201806;330;828;225;672;46;157;115;323;161;480
314790;201806;10685;30715;7707;25129;2327;8487;1258;3650;3585;12137
314795;201806;1460;4081;1246;3716;54;234;963;2749;1017;2983
314800;201806;11331;30287;6820;21480;1422;4832;1050;2945;2472;7777
314810;201806;9664;27587;7210;23170;1932;6375;1972;6744;3904;13119
314820;201806;932;2504;691;2102;88;321;388;1141;476;1462
314830;201806;1531;4865;1297;4408;297;1082;599;2014;896;3096
314840;201806;912;3015;721;2720;81;421;463;1663;544;2084
314850;201806;1980;5138;1573;4482;78;272;1294;3654;1372;3926
314860;201806;3228;10172;2712;9156;423;1553;1554;5106;1977;6659
314870;201806;5972;16606;4742;14877;388;1325;3446;10866;3834;12191
314875;201806;1726;5392;1560;5176;96;277;1317;4413;1413;4690
314880;201806;909;2273;715;2010;33;78;498;1468;531;1546
314890;201806;464;1362;333;1071;47;176;122;351;169;527
314900;201806;672;1852;519;1581;118;392;177;525;295;917
314910;201806;1661;5043;1278;4419;276;1141;609;1975;885;3116
314915;201806;2291;7046;1944;6425;149;602;1296;4151;1445;4753
314920;201806;460;1198;318;1004;16;56;196;601;212;657
314930;201806;5351;16279;4143;13852;895;3223;1337;4249;2232;7472
314940;201806;404;1085;342;972;30;79;209;560;239;639
314950;201806;394;1089;269;874;31;115;111;335;142;450
314960;201806;767;2082;579;1707;52;191;362;988;414;1179
314970;201806;665;2046;541;1820;98;367;236;766;334;1133
314980;201806;1375;3918;1063;3431;292;1047;224;693;516;1740
314990;201806;2287;6826;1577;5184;348;1284;316;885;664;2169
314995;201806;1554;4619;1306;4195;109;446;790;2416;899;2862
315000;201806;1056;2940;807;2509;87;313;495;1483;582;1796
315010;201806;408;1220;304;1006;62;245;116;340;178;585
315015;201806;2145;6365;1938;6068;212;721;1273;4053;1485;4774
315020;201806;836;2494;604;2029;83;317;290;910;373;1227
315030;201806;578;1682;427;1384;114;406;90;256;204;662
315040;201806;827;2479;740;2283;111;368;453;1382;564;1750
315050;201806;1153;3151;904;2794;88;324;481;1459;569;1783
315053;201806;1144;3194;906;2748;101;356;498;1466;599;1822
315057;201806;1622;5322;1423;4908;194;669;855;2992;1049;3661
315060;201806;618;1957;418;1529;92;348;81;301;173;649
315070;201806;646;1824;471;1489;126;423;132;386;258;809
315080;201806;2640;8267;2078;7021;449;1501;926;3142;1375;4643
315090;201806;808;2631;624;2223;119;459;193;636;312;1095
315100;201806;1161;3721;766;2734;137;563;279;909;416;1472
315110;201806;1435;3862;1118;3320;148;458;547;1629;695;2087
315120;201806;12139;29050;8698;24102;1119;3118;4423;12841;5542;15959
315130;201806;1284;3943;1040;3427;180;695;385;1185;565;1880
315140;201806;2881;8364;2249;7173;427;1564;1015;2928;1442;4492
315150;201806;4229;10950;3024;8918;481;1566;1273;3657;1754;5223
315160;201806;1523;3939;1008;3096;210;669;389;1163;599;1832
315170;201806;1519;4816;1066;3755;234;852;168;593;402;1445
315180;201806;17384;45703;9240;29019;1396;4955;2107;5783;3503;10738
315190;201806;2062;4904;1641;4310;287;792;1118;2892;1405;3684
315200;201806;3673;11299;2785;9627;832;3108;602;2026;1434;5134
315210;201806;8016;22105;5949;17639;757;2498;2556;6934;3313;9432
315213;201806;1122;3134;970;2911;28;93;771;2290;799;2383
315217;201806;2468;7989;1982;7086;124;635;1309;4495;1433;5130
315220;201806;8747;24584;7038;21594;1991;6445;2238;6800;4229;13245
315230;201806;3103;7697;2703;7227;79;131;2377;6604;2456;6735
315240;201806;2587;7967;2242;7380;573;2025;1084;3485;1657;5510
315250;201806;10212;29384;7740;24718;1411;4928;3046;9399;4457;14327
315260;201806;964;2875;550;1899;91;320;48;135;139;455
315270;201806;759;2348;538;1886;89;382;144;426;233;808
315280;201806;2877;7613;1658;5138;377;1238;253;760;630;1998
315290;201806;1248;3289;771;2508;222;787;183;595;405;1382
315300;201806;702;1771;478;1469;210;706;111;352;321;1058
315310;201806;1311;3856;1002;3247;90;321;554;1709;644;2030
315320;201806;686;2048;508;1730;58;283;218;680;276;963
315330;201806;742;2637;411;1681;79;349;106;388;185;737
315340;201806;3218;8441;2466;7333;232;755;1475;4308;1707;5063
315350;201806;1569;4337;1149;3618;126;436;541;1675;667;2111
315360;201806;1664;5222;1237;4269;215;802;435;1424;650;2226
315370;201806;456;1372;372;1195;70;223;163;508;233;731
315380;201806;191;607;147;503;39;156;27;70;66;226
315390;201806;1241;3823;932;3172;176;626;300;964;476;1590
315400;201806;4169;12012;3307;10378;479;1583;1688;5153;2167;6736
315410;201806;2325;5503;1816;4781;420;1217;603;1546;1023;2763
315415;201806;1192;3519;975;3167;261;959;368;1174;629;2133
315420;201806;1151;3497;794;2774;161;573;100;317;261;890
315430;201806;3567;9149;2560;7516;584;1974;911;2507;1495;4481
315440;201806;987;2773;825;2496;104;388;437;1213;541;1601
315445;201806;2026;5192;1515;4403;163;504;996;2856;1159;3360
315450;201806;2246;6672;1919;6136;280;864;1181;3855;1461;4719
315460;201806;30982;94145;26522;85589;7369;25417;8904;27176;16273;52593
315470;201806;477;1405;376;1220;34;123;192;599;226;722
315480;201806;1447;4259;988;3271;203;719;243;785;446;1504
315490;201806;2986;7600;2110;6339;299;967;750;2204;1049;3171
315500;201806;500;1417;308;979;21;85;148;412;169;497
315510;201806;1265;3574;1086;3296;43;180;899;2669;942;2849
315520;201806;1100;3163;865;2776;60;229;565;1753;625;1982
315530;201806;649;2064;513;1734;171;630;174;549;345;1179
315540;201806;1179;3375;850;2740;117;436;336;1056;453;1492
315550;201806;1810;4963;1310;4157;280;1005;418;1260;698;2265
315560;201806;6100;19713;5416;18490;403;1458;3578;12287;3981;13745
315570;201806;1880;5620;1618;5111;125;490;907;2751;1032;3241
315580;201806;2261;5973;1767;5144;410;1360;548;1553;958;2913
315590;201806;929;2550;745;2252;95;338;361;1046;456;1384
315600;201806;2394;8035;1780;6803;263;1002;959;3792;1222;4794
315610;201806;941;2494;729;2093;130;468;309;740;439;1208
315620;201806;309;1018;282;975;56;190;155;580;211;770
315630;201806;879;2603;732;2323;169;580;214;594;383;1174
315640;201806;386;1042;322;940;35;118;180;504;215;622
315645;201806;906;2434;619;1939;180;610;156;453;336;1063
315650;201806;1796;4680;1400;4106;67;275;1076;3063;1143;3338
315660;201806;2497;6287;1890;5253;118;337;1276;3451;1394;3788
315670;201806;12714;37475;10359;33053;2160;7312;4503;13888;6663;21200
315680;201806;2983;9419;2256;7961;449;1739;910;3157;1359;4896
315690;201806;2871;7698;1869;5894;434;1446;456;1530;890;2976
315700;201806;7225;21269;5714;18196;998;3373;2544;7792;3542;11165
315710;201806;1912;5012;1338;4075;73;319;887;2547;960;2866
315720;201806;4156;12406;3578;11332;200;921;2418;7292;2618;8213
315725;201806;1613;4605;1359;4254;173;559;937;3002;1110;3561
315727;201806;571;1608;428;1337;64;225;198;580;262;805
315730;201806;681;2110;605;1943;83;304;284;862;367;1166
315733;201806;1403;3733;1004;3016;186;663;351;971;537;1634
315737;201806;1130;3362;897;2917;40;176;633;2023;673;2199
315740;201806;983;2850;772;2407;137;499;368;1026;505;1525
315750;201806;1212;3398;1019;3076;89;290;671;2027;760;2317
315760;201806;1189;2922;1102;2819;40;86;995;2564;1035;2650
315765;201806;1821;5071;1524;4687;42;162;1345;4136;1387;4298
315770;201806;1186;3677;1005;3408;355;1325;296;952;651;2277
315780;201806;25929;76472;22377;69824;2311;8559;13098;38815;15409;47374
315790;201806;3650;11529;3117;10527;249;858;2035;7050;2284;7908
315800;201806;1230;4731;917;3816;185;841;190;727;375;1568
315810;201806;1304;3348;1135;3098;60;211;897;2329;957;2540
315820;201806;2429;7379;2087;6808;257;943;1380;4406;1637;5349
315830;201806;1168;3474;860;2905;66;264;371;1191;437;1455
315840;201806;767;1942;469;1368;62;203;183;480;245;683
315850;201806;1056;3385;917;3155;207;788;444;1417;651;2205
315860;201806;522;1627;360;1294;70;279;101;336;171;615
315870;201806;448;1230;367;1108;27;106;236;655;263;761
315880;201806;1133;2997;806;2450;62;232;282;801;344;1033
315890;201806;1478;4748;1275;4392;395;1459;514;1689;909;3148
315895;201806;5906;16962;4696;14449;641;2234;2153;6101;2794;8335
315900;201806;829;2213;728;2070;65;218;565;1539;630;1757
315910;201806;488;1526;426;1420;74;264;267;855;341;1119
315920;201806;1582;4294;832;2645;163;549;215;620;378;1169
315930;201806;1067;2617;735;2078;144;413;299;821;443;1234
315935;201806;838;2676;704;2409;156;584;211;742;367;1326
315940;201806;612;1845;510;1640;65;229;266;839;331;1068
315950;201806;1205;3440;1023;3133;141;436;728;2240;869;2676
315960;201806;3612;10610;2282;8067;731;3026;117;244;848;3270
315970;201806;645;1838;515;1649;56;184;360;1175;416;1359
315980;201806;3734;8725;2185;6116;464;1418;728;1862;1192;3280
315990;201806;3769;9976;2964;8598;332;1066;1676;4752;2008;5818
316000;201806;532;1516;425;1344;70;270;176;508;246;778
316010;201806;698;2144;549;1846;51;215;305;929;356;1144
316020;201806;982;3045;816;2726;79;355;510;1578;589;1933
316030;201806;2977;8467;2163;6992;236;810;1332;4366;1568;5176
316040;201806;3321;11136;2546;9566;313;1179;969;3993;1282;5172
316045;201806;1943;5613;1809;5406;135;340;1456;4481;1591;4821
316050;201806;350;1073;264;908;51;204;134;430;185;634
316060;201806;703;1927;531;1660;53;206;324;939;377;1145
316070;201806;5798;16932;4836;15030;873;2956;2124;6310;2997;9266
316080;201806;733;2424;602;2143;161;627;73;254;234;881
316090;201806;466;1426;324;1122;50;204;123;390;173;594
316095;201806;1360;4256;1157;3855;237;820;548;1799;785;2619
316100;201806;2573;8039;1865;6404;343;1285;546;1732;889;3017
316105;201806;873;2401;654;2039;83;265;397;1243;480;1508
316110;201806;12278;38309;10539;35263;1294;4538;6724;22639;8018;27177
316120;201806;1036;3233;733;2476;138;488;184;528;322;1016
316130;201806;1422;3216;832;2289;91;296;394;1024;485;1320
316140;201806;1083;2956;725;2333;139;471;341;1086;480;1557
316150;201806;1618;4008;1371;3613;258;786;629;1525;887;2311
316160;201806;1092;3122;879;2733;89;321;512;1522;601;1843
316165;201806;895;2283;692;1961;112;378;376;1014;488;1392
316170;201806;1145;3110;859;2670;98;352;479;1420;577;1772
316180;201806;1388;4184;932;3173;189;721;122;335;311;1056
316190;201806;2621;7783;1529;5050;253;848;517;1523;770;2371
316200;201806;3480;10569;2569;8777;556;2144;571;1825;1127;3969
316210;201806;4494;13628;3262;10949;1018;3625;350;1177;1368;4802
316220;201806;633;1974;427;1504;90;346;47;193;137;539
316225;201806;1344;3299;1036;2766;59;228;750;1862;809;2090
316230;201806;424;1148;325;1004;35;104;162;520;197;624
316240;201806;6049;17823;5322;16719;553;1803;3889;12171;4442;13974
316245;201806;3086;10512;2783;10004;168;918;2143;7439;2311;8357
316250;201806;9589;25303;6946;20616;1798;5838;1661;4704;3459;10542
316255;201806;2798;8072;2419;7503;266;888;1681;5240;1947;6128
316257;201806;1276;3241;894;2616;122;384;437;1238;559;1622
316260;201806;1887;5000;1421;4276;45;155;794;2471;839;2626
316265;201806;1284;3462;929;2848;52;194;616;1834;668;2028
316270;201806;3473;11275;3029;10254;590;2142;1307;4238;1897;6380
316280;201806;3112;9543;2726;8807;380;1368;1452;4509;1832;5877
316290;201806;3298;9792;2629;8457;425;1573;906;2899;1331;4472
316292;201806;4456;12581;3673;11290;385;1367;2554;7676;2939;9043
316294;201806;778;2356;572;1989;101;388;100;344;201;732
316295;201806;2551;7459;2163;6747;103;444;1578;4737;1681;5181
316300;201806;977;3109;822;2809;64;254;527;1809;591;2063
316310;201806;966;2403;554;1740;90;312;210;641;300;953
316320;201806;578;1701;440;1453;65;240;169;546;234;786
316330;201806;1069;3035;802;2494;71;256;539;1614;610;1870
316340;201806;1076;3160;798;2603;84;348;421;1285;505;1633
316350;201806;1226;3768;1074;3519;134;476;680;2209;814;2685
316360;201806;686;1803;548;1581;63;201;379;1070;442;1271
316370;201806;4681;13608;3698;11652;805;2874;1057;2985;1862;5859
316380;201806;1643;4133;1259;3612;45;137;908;2596;953;2733
316390;201806;871;2371;656;1998;187;633;214;623;401;1256
316400;201806;1294;3817;882;3005;142;509;318;1018;460;1527
316410;201806;1056;3228;887;2950;67;228;702;2303;769;2531
316420;201806;1730;5307;1535;5046;95;395;1195;3858;1290;4253
316430;201806;890;2575;573;1927;123;428;128;413;251;841
316440;201806;695;2214;531;1935;142;601;71;240;213;841
316443;201806;576;1696;451;1451;106;378;113;356;219;734
316447;201806;1785;4957;1562;4624;61;206;1262;3725;1323;3931
316450;201806;2185;6909;1714;5926;217;809;1082;3683;1299;4492
316460;201806;909;2549;774;2333;220;706;368;1069;588;1775
316470;201806;6112;18413;4732;15613;937;3489;1538;4680;2475;8169
316480;201806;197;601;168;540;31;117;71;205;102;322
316490;201806;325;913;240;730;32;107;96;257;128;364
316500;201806;1232;4090;795;2931;145;570;118;405;263;975
316510;201806;648;2351;580;2206;139;576;233;897;372;1473
316520;201806;1015;2885;808;2516;128;478;335;973;463;1451
316530;201806;986;2882;750;2430;120;507;314;882;434;1389
316540;201806;730;2209;633;2036;111;426;222;646;333;1072
316550;201806;1289;4058;1151;3786;113;433;802;2584;915;3017
316553;201806;3166;9970;2167;7520;546;2035;406;1271;952;3306
316555;201806;2660;8805;2392;8429;144;575;1828;6574;1972;7149
316556;201806;644;1586;454;1276;31;93;244;612;275;705
316557;201806;905;3092;799;2894;323;1235;232;802;555;2037
316560;201806;273;856;206;759;53;232;51;171;104;403
316570;201806;1132;3559;1010;3315;293;978;338;1107;631;2085
316580;201806;377;947;238;684;53;169;88;226;141;395
316590;201806;1387;3720;983;2971;179;578;512;1440;691;2018
316600;201806;1011;3201;879;2929;145;521;461;1526;606;2047
316610;201806;592;1987;498;1815;69;337;298;1024;367;1361
316620;201806;2085;6023;1790;5579;111;411;1285;4016;1396;4427
316630;201806;1512;4680;1209;4075;353;1174;443;1656;796;2830
316640;201806;152;426;122;374;25;84;55;137;80;221
316650;201806;985;3282;807;3006;65;268;515;1973;580;2241
316660;201806;193;491;85;261;10;42;13;33;23;75
316670;201806;1948;5187;1478;4384;424;1338;429;1200;853;2538
316680;201806;2069;5433;1613;4700;138;468;1142;3213;1280;3681
316690;201806;1090;3433;912;3094;221;850;356;1167;577;2017
316695;201806;1000;3018;864;2777;52;216;581;1818;633;2034
316700;201806;388;997;327;926;18;79;237;624;255;703
316710;201806;2717;9600;2162;8386;623;2469;687;2757;1310;5226
316720;201806;19222;56792;14724;47644;3042;10530;5395;16671;8437;27201
316730;201806;356;1054;300;932;63;219;128;355;191;574
316740;201806;678;2091;611;1993;65;283;427;1373;492;1656
316750;201806;413;1299;313;1091;66;251;110;368;176;619
316760;201806;3675;11754;2976;10444;1300;4878;827;2840;2127;7718
316770;201806;1486;3762;1207;3373;31;112;1033;2918;1064;3030
316780;201806;606;1899;478;1651;141;551;63;177;204;728
316790;201806;723;2007;529;1647;121;403;175;529;296;932
316800;201806;5557;16691;4557;14822;451;1725;2633;8248;3084;9973
316805;201806;962;2199;830;2049;23;34;737;1901;760;1935
316810;201806;561;1614;406;1322;93;338;169;532;262;870
316820;201806;330;823;170;532;26;93;36;116;62;209
316830;201806;655;1972;549;1789;98;373;324;1005;422;1378
316840;201806;2638;7649;2253;6920;405;1427;1134;3292;1539;4719
316850;201806;2067;5609;1524;4634;202;698;734;2174;936;2872
316860;201806;17558;50031;13869;44122;2672;9619;5839;17972;8511;27591
316870;201806;6649;19835;5084;16534;1098;3871;1609;4953;2707;8824
316880;201806;854;2390;721;2183;148;525;309;893;457;1418
316890;201806;1214;2847;793;2274;168;580;417;1056;585;1636
316900;201806;2339;6649;1855;5634;412;1392;608;1659;1020;3051
316905;201806;476;1489;387;1298;89;319;161;539;250;858
316910;201806;876;2533;593;2000;152;594;56;172;208;766
316920;201806;1651;4367;1119;3507;197;674;486;1529;683;2203
316930;201806;7920;25041;5910;20941;1068;4115;1234;4164;2302;8279
316935;201806;4060;11699;2863;9366;660;2270;807;2596;1467;4866
316940;201806;6764;20977;5189;17446;975;3650;1614;4960;2589;8610
316950;201806;1763;4463;1385;3921;64;223;1083;2996;1147;3219
316960;201806;4892;11789;3657;10043;531;1599;2247;6089;2778;7688
316970;201806;3244;9884;2893;9188;723;2371;996;3007;1719;5378
316980;201806;792;2390;551;1905;157;585;64;218;221;803
316990;201806;10238;30060;7669;24491;2045;6935;798;2334;2843;9269
317000;201806;2668;8431;2466;8140;189;640;1791;6171;1980;6811
317005;201806;2523;7390;2083;6606;371;1213;1058;3313;1429;4526
317010;201806;23658;57384;14244;42823;3452;11376;3241;10293;6693;21669
317020;201806;60818;154819;35270;106391;6711;22005;8298;22724;15009;44729
317030;201806;681;1927;544;1724;35;146;380;1173;415;1319
317040;201806;10494;28062;7591;22947;1871;5928;2750;8367;4621;14295
317043;201806;783;1944;623;1721;116;344;372;1023;488;1367
317047;201806;1168;2884;808;2310;107;277;466;1354;573;1631
317050;201806;1325;4235;946;3337;134;499;331;1057;465;1556
317052;201806;2344;7009;1945;6324;244;857;1260;4033;1504;4890
317057;201806;1663;4267;1183;3430;57;215;771;2177;828;2392
317060;201806;416;1140;234;747;39;134;81;233;120;367
317065;201806;1261;3673;1036;3257;53;234;737;2185;790;2419
317070;201806;8394;24370;5573;18408;1164;4312;1028;3165;2192;7477
317075;201806;963;2864;681;2251;134;448;132;410;266;858
317080;201806;5941;15057;4652;12873;1517;4384;1192;3045;2709;7429
317090;201806;4515;14204;4122;13572;380;1286;2975;9790;3355;11076
317100;201806;2680;6707;1827;5333;585;1806;530;1494;1115;3300
317103;201806;1848;6023;1621;5604;195;890;967;3122;1162;4012
317107;201806;1325;3806;1087;3326;59;241;669;1851;728;2092
317110;201806;654;1457;332;999;47;177;119;352;166;529
317115;201806;1126;3339;937;2961;74;231;656;2075;730;2306
317120;201806;11946;35345;9354;30647;1480;5395;4589;14444;6069;19839
317130;201806;8693;22075;5874;17399;1241;4010;1860;5428;3101;9438
317140;201806;583;1769;498;1616;56;179;300;982;356;1161
317150;201806;1019;2591;815;2332;40;146;646;1805;686;1951
317160;201806;3643;9098;2542;7446;268;811;1513;4453;1781;5264
317170;201806;1990;5186;1408;4134;225;760;495;1253;720;2013
317180;201806;1652;5453;1288;4597;301;1160;312;1023;613;2183
317190;201806;1314;3665;983;3135;77;257;632;1988;709;2245
317200;201806;4783;13358;3604;11179;874;2962;815;2318;1689;5280
317210;201806;1076;2865;854;2543;53;213;612;1835;665;2048
317220;201806;268;887;239;819;61;226;92;303;153;529
320010;201806;4625;13933;3810;12322;434;1553;2320;7285;2754;8838
320013;201806;1691;5119;1221;4033;198;635;527;1800;725;2435
320016;201806;3095;8201;2504;7339;142;407;1979;5789;2121;6196
320020;201806;3884;11153;3015;9523;758;2548;949;3070;1707;5618
320030;201806;1441;4399;1009;3449;257;947;287;914;544;1861
320035;201806;1688;4848;1431;4424;423;1431;603;1805;1026;3236
320040;201806;3352;10293;2751;9144;470;1692;1291;4235;1761;5927
320050;201806;1730;4253;1513;3903;302;852;811;2021;1113;2873
320060;201806;10230;30446;7572;24947;1415;5088;2566;8099;3981;13187
320070;201806;1423;4288;1056;3511;208;722;313;1015;521;1737
320080;201806;5432;14922;4004;12091;798;2517;1504;4513;2302;7030
320090;201806;6842;19389;5146;15926;1248;4060;2018;6022;3266;10082
320100;201806;2549;7656;1984;6541;513;1801;759;2425;1272;4226
320110;201806;1310;3581;1032;3066;229;706;358;1067;587;1773
320115;201806;1806;6074;1571;5646;747;2791;428;1588;1175;4379
320120;201806;15399;42655;11145;34789;2200;7513;3623;10793;5823;18306
320130;201806;36116;108041;30873;98364;5063;17720;16340;50455;21403;68175
320140;201806;3032;9128;2207;7349;475;1797;674;2180;1149;3977
320150;201806;13674;37830;9805;30086;2778;8974;1668;5022;4446;13996
320160;201806;5316;15928;4144;13557;791;2802;1817;5852;2608;8654
320170;201806;1600;4824;1183;3939;298;993;433;1431;731;2424
320180;201806;701;2318;571;2053;202;771;123;438;325;1209
320190;201806;3030;10054;2290;8331;566;2145;453;1617;1019;3762
320200;201806;1025;2998;764;2520;215;798;209;695;424;1493
320210;201806;4613;12325;3626;10547;598;1913;1824;5061;2422;6974
320220;201806;2674;7573;2064;6502;370;1234;1061;3324;1431;4558
320225;201806;1295;4228;930;3303;333;1256;132;459;465;1715
320230;201806;4413;13140;3430;11402;894;3238;1300;4280;2194;7518
320240;201806;13530;37193;10514;32127;2208;7209;4361;13312;6569;20521
320245;201806;2949;9389;2507;8437;993;3459;580;1928;1573;5387
320250;201806;1973;5828;1340;4312;312;1125;287;829;599;1954
320255;201806;1698;5648;1497;5288;557;2009;592;2205;1149;4214
320260;201806;1015;3045;729;2363;207;740;186;504;393;1244
320265;201806;2394;7554;2016;6807;884;3127;495;1652;1379;4779
320270;201806;2299;6777;1755;5664;349;1189;806;2628;1155;3817
320280;201806;5659;16575;4685;14745;1239;4158;1466;4499;2705;8657
320290;201806;1320;4116;900;3080;273;1037;175;544;448;1581
320300;201806;3771;12160;3093;10628;979;3583;619;2060;1598;5643
320305;201806;4647;13973;3720;12009;851;2905;1512;4710;2363;7615
320310;201806;1815;5284;1338;4268;292;961;527;1649;819;2610
320313;201806;2119;5722;1403;4252;321;1081;279;789;600;1870
320316;201806;1505;4411;1187;3771;254;866;571;1799;825;2665
320320;201806;20207;55983;14484;45847;3635;12144;4953;15547;8588;27691
320330;201806;2870;8271;2304;7232;649;2013;931;3075;1580;5088
320332;201806;5395;16322;4496;14675;1056;3672;2207;7080;3263;10752
320334;201806;2037;6162;1390;4736;297;1164;289;855;586;2019
320335;201806;1841;5448;1160;3827;304;1088;215;637;519;1725
320340;201806;4949;13129;4167;11897;717;2144;2172;6322;2889;8466
320350;201806;5027;13027;3532;10254;575;1778;1582;4414;2157;6192
320360;201806;1548;4070;1125;3244;170;472;518;1451;688;1923
320370;201806;2519;8207;1974;6938;570;2051;639;2215;1209;4266
320380;201806;2205;6288;1856;5682;353;1177;973;2875;1326;4052
320390;201806;7248;20586;5481;16881;1231;4023;2037;6042;3268;10065
320400;201806;3338;9929;2746;8701;704;2367;1088;3383;1792;5750
320405;201806;4490;12447;3520;10780;525;1704;1865;5656;2390;7360
320410;201806;4932;13461;3708;11519;617;1975;1804;5815;2421;7790
320420;201806;2690;7677;2104;6631;585;2021;501;1552;1086;3573
320425;201806;2014;4988;1536;4186;129;397;977;2567;1106;2964
320430;201806;2646;7015;2087;5877;336;1030;1187;3136;1523;4166
320435;201806;2327;7491;1840;6486;669;2469;508;1831;1177;4300
320440;201806;1148;3429;882;2875;157;569;383;1218;540;1787
320450;201806;1651;4991;1308;4320;313;1130;570;1789;883;2919
320455;201806;3726;11850;2641;9248;759;2793;679;2341;1438;5134
320460;201806;2271;7077;1606;5534;364;1297;349;1134;713;2431
320465;201806;1280;3798;977;3157;119;428;535;1721;654;2149
320470;201806;3948;11281;2673;8549;697;2368;540;1620;1237;3988
320480;201806;1694;5054;1439;4528;263;916;692;2116;955;3032
320490;201806;16621;46939;13079;40695;2506;8648;5312;16523;7818;25171
320495;201806;1405;4015;934;3022;210;729;284;904;494;1633
320500;201806;45381;128400;37849;115107;6801;22204;19764;58113;26565;80317
320501;201806;4660;13889;3393;11613;931;3592;927;3053;1858;6645
320503;201806;2097;6681;1582;5559;484;1888;464;1498;948;3386
320506;201806;3260;9839;2226;7434;590;2122;133;400;723;2522
320510;201806;9232;26525;7571;23518;1242;4250;4056;12230;5298;16480
320515;201806;1820;5073;1413;4218;408;1274;359;1075;767;2349
320517;201806;2037;6458;1644;5609;575;2107;368;1225;943;3332
320520;201806;32699;92012;25200;78996;5074;17375;9697;29862;14771;47237
320530;201806;28779;80872;22631;69617;3006;10775;12726;36784;15732;47559
330010;201806;19705;57210;16713;51916;3310;10688;8810;27251;12120;37939
330015;201806;1379;3700;1148;3288;189;612;571;1553;760;2165
330020;201806;19158;51126;16865;47679;2511;8040;11342;31090;13853;39130
330022;201806;1862;5240;1489;4618;258;877;880;2670;1138;3547
330023;201806;3310;9103;2553;7957;589;1959;995;3032;1584;4991
330025;201806;4677;12274;3302;9775;1012;3272;1011;2914;2023;6186
330030;201806;9060;27166;7370;24018;1067;3922;4019;12436;5086;16358
330040;201806;11583;32975;10028;30189;1466;4849;6190;17907;7656;22756
330045;201806;80116;200794;67775;184066;7401;19723;49879;134298;57280;154021
330050;201806;2355;6596;1835;5705;416;1381;791;2311;1207;3692
330060;201806;5243;14492;4375;13081;970;3173;1848;5224;2818;8397
330070;201806;19904;55416;16893;50682;3304;10498;8575;25622;11879;36120
330080;201806;8731;24009;7709;22440;895;2716;5063;14665;5958;17381
330090;201806;2464;6184;2045;5581;237;688;1278;3374;1515;4062
330093;201806;2099;5784;1625;5006;197;625;1039;3243;1236;3868
330095;201806;1030;3260;857;2900;108;414;420;1317;528;1731
330100;201806;62070;176319;53408;163031;4853;17160;36705;110196;41558;127356
330110;201806;2101;6417;1854;5987;348;1242;820;2553;1168;3795
330115;201806;1804;4894;1468;4386;261;872;855;2490;1116;3362
330120;201806;2990;7357;2400;6576;219;672;1758;4714;1977;5386
330130;201806;3519;10418;2983;9573;558;1936;1650;5280;2208;7216
330140;201806;3284;9325;2780;8555;478;1705;1620;4804;2098;6509
330150;201806;2042;5816;1630;5117;339;1140;653;2002;992;3142
330160;201806;1145;3355;958;3062;223;778;463;1419;686;2197
330170;201806;93508;258858;80803;240275;13375;40759;48414;143967;61789;184726
330180;201806;2088;5633;1687;4968;115;434;1144;3239;1259;3673
330185;201806;9096;25396;7592;22757;951;3221;5007;14482;5958;17703
330187;201806;3590;9867;3001;8938;480;1563;1804;5270;2284;6833
330190;201806;28571;74395;25261;69703;2649;7623;19119;52370;21768;59993
330200;201806;13548;38490;11563;35719;2655;7963;6487;20654;9142;28617
330205;201806;1925;5124;1606;4603;111;370;1098;3038;1209;3408
330210;201806;3185;8556;2363;6988;511;1608;833;2315;1344;3923
330220;201806;9849;27720;7757;23664;1784;5830;2145;6010;3929;11840
330225;201806;3602;10263;2932;9146;264;1047;1951;5835;2215;6882
330227;201806;16248;43052;14195;40241;1341;4117;10834;30397;12175;34514
330230;201806;1244;3426;1043;3103;89;285;680;1980;769;2265
330240;201806;18548;52193;15282;46795;3320;10995;7275;21581;10595;32576
330245;201806;1310;3656;910;2927;216;730;238;757;454;1487
330250;201806;34091;94439;29495;87207;7217;21648;13598;41079;20815;62727
330260;201806;4400;12363;3522;10925;575;1946;1812;5333;2387;7279
330270;201806;24308;51389;14824;37741;2779;7701;5991;15013;8770;22714
330280;201806;2238;6238;1775;5392;247;834;942;2728;1189;3562
330285;201806;19765;51162;16311;46181;2026;6411;10738;29479;12764;35890
330290;201806;3231;8956;2709;8086;409;1303;1494;4323;1903;5626
330300;201806;3395;10243;2914;9365;415;1520;1758;5456;2173;6976
330310;201806;2258;6095;1779;5269;141;402;1126;3346;1267;3748
330320;201806;13209;35517;11611;33264;1675;4897;8161;23427;9836;28324
330330;201806;29344;73560;24424;66318;3156;9509;16232;42720;19388;52229
330340;201806;13233;36536;10327;31483;2096;6972;4312;12486;6408;19458
330350;201806;94857;249739;81192;231185;8406;25623;58566;165505;66972;191128
330360;201806;7191;18604;6229;17467;376;1082;5124;14338;5500;15420
330370;201806;3568;11998;3090;10994;843;3127;1156;4089;1999;7216
330380;201806;4956;14749;3921;12832;883;3139;1474;4628;2357;7767
330385;201806;3866;12311;3334;11432;910;3392;1342;4612;2252;8004
330390;201806;22442;67868;18196;59512;3683;13044;8209;25810;11892;38854
330395;201806;3083;8400;2663;7800;215;722;1772;5118;1987;5840
330400;201806;2815;8101;2494;7516;208;781;1727;4862;1935;5643
330410;201806;2747;7952;2069;6707;409;1456;880;2682;1289;4138
330411;201806;2377;6917;1996;6172;194;726;1368;4025;1562;4751
330412;201806;1413;4442;1169;3965;193;714;595;1884;788;2598
330414;201806;23307;61574;19248;55880;2619;7471;12479;36271;15098;43742
330415;201806;3543;10179;2770;8837;479;1495;1342;4441;1821;5936
330420;201806;9284;24495;6152;19127;1039;3425;2085;6160;3124;9585
330430;201806;7681;21020;6727;19427;782;2626;4449;12354;5231;14980
330440;201806;1612;4976;1377;4580;347;1303;595;1846;942;3149
330450;201806;1308;4078;1081;3649;186;678;518;1685;704;2363
330452;201806;14542;39816;11379;34403;2275;7407;5647;16606;7922;24013
330455;201806;533111;1352044;411995;1164221;71353;214174;230278;638211;301631;852385
330460;201806;1210;3591;950;3170;196;692;441;1428;637;2120
330470;201806;4282;11694;3344;10182;878;2824;1326;3964;2204;6788
330475;201806;8338;23387;6878;21287;1680;5710;3436;10371;5116;16081
330480;201806;5818;16193;5015;14956;665;2209;3129;9014;3794;11223
330490;201806;114129;279379;96924;254709;10197;28941;67758;174318;77955;203259
330500;201806;5099;14616;4681;13986;675;2158;3281;9689;3956;11847
330510;201806;37960;104919;30833;94275;8340;25906;14195;43546;22535;69452
330513;201806;1164;3372;1013;3097;298;968;391;1166;689;2134
330515;201806;2733;7884;2262;7039;678;2204;829;2523;1507;4727
330520;201806;10385;30014;8794;27237;1569;5309;4335;12935;5904;18244
330530;201806;1545;4117;1210;3549;269;857;517;1446;786;2303
330540;201806;2774;7870;2227;6889;652;2073;758;2300;1410;4373
330550;201806;7636;23635;6483;21637;2384;8324;1628;5490;4012;13814
330555;201806;11389;29689;9714;27387;1473;4421;6350;17970;7823;22391
330560;201806;4206;12006;3559;10799;473;1519;2078;6125;2551;7644
330570;201806;2873;8343;2413;7529;474;1569;1331;4094;1805;5663
330575;201806;5324;14404;4639;13208;442;1418;3392;9331;3834;10749
330580;201806;11938;35141;9520;30554;2414;8232;3807;11885;6221;20117
330590;201806;1535;4386;1357;4152;156;482;960;2963;1116;3445
330600;201806;11070;31683;8857;27697;1351;4494;4529;14077;5880;18571
330610;201806;8717;25490;7545;23625;903;3299;4706;14291;5609;17590
330615;201806;1639;5235;1432;4934;399;1506;728;2473;1127;3979
330620;201806;3561;11397;2976;10284;961;3547;790;2592;1751;6139
330630;201806;23826;64723;18979;56406;2074;7179;12114;34405;14188;41584
350010;201806;1937;5434;1024;3355;242;828;95;243;337;1071
350020;201806;639;1725;345;1127;32;111;151;454;183;565
350030;201806;3874;11560;2926;9690;756;2657;870;2775;1626;5432
350040;201806;599;1888;385;1376;75;298;105;334;180;632
350050;201806;896;2547;661;2082;147;531;188;473;335;1004
350055;201806;744;2016;626;1841;49;160;483;1398;532;1558
350060;201806;115;340;90;297;18;65;39;131;57;196
350070;201806;3917;10801;2390;7715;443;1476;710;2056;1153;3532
350075;201806;610;1955;461;1625;187;683;55;174;242;857
350080;201806;683;1868;419;1315;47;161;178;522;225;683
350090;201806;637;1583;362;1055;88;259;107;300;195;559
350100;201806;2092;5893;1400;4601;183;716;646;1970;829;2686
350110;201806;421;1232;315;1014;24;86;193;609;217;695
350115;201806;1290;3891;1065;3387;191;664;508;1466;699;2130
350120;201806;798;2110;474;1439;59;164;255;789;314;953
350130;201806;3251;9186;2656;7998;365;1173;1391;3958;1756;5131
350140;201806;590;1898;474;1671;36;175;256;838;292;1013
350150;201806;520;1619;440;1462;128;434;127;407;255;841
350160;201806;10469;27011;6773;20260;904;3116;3712;10283;4616;13399
350170;201806;1574;4971;1224;4153;250;881;365;1186;615;2067
350180;201806;1148;2999;633;1931;132;436;227;657;359;1093
350190;201806;2959;8788;2156;7075;463;1694;778;2097;1241;3791
350200;201806;373;1096;317;994;22;70;222;669;244;739
350210;201806;5220;12892;3479;10007;685;2038;1722;4806;2407;6844
350220;201806;2372;7109;1848;5950;379;1346;712;2068;1091;3414
350230;201806;886;2618;771;2414;163;533;371;1151;534;1684
350240;201806;675;2016;465;1530;78;261;159;509;237;770
350250;201806;2244;7265;1790;6422;618;2383;367;1386;985;3769
350260;201806;822;2129;533;1576;75;219;274;792;349;1011
350270;201806;4555;13193;3685;11387;619;2086;1764;5068;2383;7154
350275;201806;2132;6325;1759;5654;372;1267;825;2543;1197;3810
350280;201806;20096;46941;12267;33944;2264;6650;4024;10744;6288;17394
350290;201806;3009;8854;2082;6915;389;1400;791;2530;1180;3930
350300;201806;658;1904;471;1485;100;324;167;488;267;812
350310;201806;809;2521;682;2230;84;323;291;884;375;1207
350315;201806;539;1540;381;1229;50;192;142;406;192;598
350320;201806;11655;33029;9388;28895;2502;8177;2249;6913;4751;15090
350330;201806;14897;38267;10184;28521;1304;3859;5574;14696;6878;18555
350335;201806;370;1077;307;966;20;62;217;688;237;750
350340;201806;1059;2875;662;2129;123;436;218;678;341;1114
350350;201806;719;2054;581;1876;97;327;263;825;360;1152
350360;201806;937;2991;785;2639;216;710;280;940;496;1650
350370;201806;591;1654;407;1255;115;355;81;224;196;579
350380;201806;4688;13064;3174;10147;778;2574;861;2716;1639;5290
350390;201806;9494;27350;7798;24209;2086;6697;2897;8713;4983;15410
350395;201806;406;1066;197;649;23;79;57;163;80;242
350400;201806;7599;20467;5528;16776;1419;4639;1573;4505;2992;9144
350410;201806;9053;27100;6719;22431;1610;5924;1910;5865;3520;11789
350420;201806;606;1805;456;1513;84;327;82;239;166;566
350430;201806;695;2004;574;1786;71;265;344;993;415;1258
350440;201806;1473;4225;1197;3685;185;625;683;2040;868;2665
350450;201806;6548;19619;5248;17061;1187;4114;1743;5353;2930;9467
350460;201806;1512;3934;810;2520;137;487;206;571;343;1058
350470;201806;222;578;183;507;7;23;124;324;131;347
350480;201806;821;2290;544;1726;101;354;77;203;178;557
350490;201806;1721;5005;1318;4237;290;957;440;1320;730;2277
350500;201806;601;1724;495;1530;90;316;249;743;339;1059
350510;201806;1100;3111;809;2531;99;348;412;1206;511;1554
350520;201806;1870;6336;1455;5367;258;1061;512;1757;770;2818
350530;201806;2343;6427;1772;5260;403;1279;696;1919;1099;3198
350535;201806;1382;4048;1225;3818;127;476;848;2574;975;3050
350540;201806;1618;4349;1194;3609;235;773;544;1642;779;2415
350550;201806;9222;23237;6190;18226;781;2655;2974;8193;3755;10848
350560;201806;3583;10923;2957;9616;314;1093;1777;5622;2091;6715
350570;201806;19478;58491;16353;52304;3999;13818;6942;21104;10941;34922
350580;201806;1726;5165;1024;3428;207;699;117;315;324;1014
350590;201806;4260;12374;3139;9890;613;2206;1475;4215;2088;6421
350600;201806;38670;95373;24896;69407;3427;10568;11729;29877;15156;40445
350610;201806;6629;19016;4981;15772;1042;3503;2030;6259;3072;9762
350620;201806;380;1047;274;887;32;120;131;408;163;528
350630;201806;1523;4204;1114;3414;96;336;596;1706;692;2042
350635;201806;6836;18609;5258;15961;1069;3602;2553;7336;3622;10938
350640;201806;818;2410;479;1559;68;249;153;431;221;680
350650;201806;8014;22641;5202;16513;1028;3499;1460;4293;2488;7792
350660;201806;4678;13065;3680;11299;718;2306;1707;5249;2425;7555
350670;201806;1580;4692;1400;4387;243;765;776;2451;1019;3216
350680;201806;1060;3005;728;2352;142;500;306;975;448;1475
350690;201806;1042;3085;782;2558;146;517;361;1120;507;1637
350700;201806;4223;11886;3087;9942;686;2441;1351;4066;2037;6507
350710;201806;2631;7747;2250;7028;304;1070;1283;3842;1587;4912
350715;201806;802;2351;686;2115;83;320;370;1023;453;1343
350720;201806;154;422;127;378;25;76;47;134;72;210
350730;201806;452;1468;357;1269;61;242;164;549;225;791
350740;201806;1603;4706;1063;3484;187;641;255;768;442;1409
350745;201806;579;1650;343;1096;38;130;139;384;177;514
350750;201806;8901;25731;7200;22453;1401;4965;2689;7410;4090;12375
350760;201806;13110;35265;9619;29225;2558;8333;2360;6340;4918;14673
350770;201806;673;1859;472;1458;61;200;285;863;346;1063
350775;201806;632;1659;486;1415;61;192;210;608;271;800
350780;201806;1869;5233;1416;4416;326;1113;374;1282;700;2395
350790;201806;1677;4892;1106;3748;219;810;173;505;392;1315
350800;201806;3110;9798;2790;9170;470;1679;1416;4508;1886;6187
350810;201806;2111;5676;1794;5250;327;998;991;3008;1318;4006
350820;201806;751;1897;427;1272;52;159;184;497;236;656
350830;201806;866;2537;505;1696;63;219;146;434;209;653
350840;201806;2618;8318;2002;7085;565;2172;620;2037;1185;4209
350850;201806;6118;18631;4792;15944;1316;4584;1411;4617;2727;9201
350860;201806;3152;9167;2871;8731;129;501;2180;6516;2309;7017
350870;201806;2748;8169;2082;7048;392;1514;1043;3421;1435;4935
350880;201806;1288;4038;1037;3443;236;792;312;1017;548;1809
350890;201806;662;1791;409;1260;50;170;130;328;180;498
350900;201806;5972;17455;4025;13295;1255;4538;486;1463;1741;6001
350910;201806;838;2299;720;2071;132;442;443;1221;575;1663
350920;201806;11793;31289;10096;28433;606;1986;7786;21016;8392;23002
350925;201806;4523;13220;3330;10915;717;2410;1174;3476;1891;5886
350930;201806;1398;3841;963;2959;139;447;446;1286;585;1733
350940;201806;1941;5810;1615;5173;230;815;940;2919;1170;3734
350945;201806;908;2695;699;2270;124;442;300;903;424;1345
350950;201806;77806;217334;61386;182837;9612;31431;33492;93905;43104;125336
350960;201806;5131;15221;4104;13225;697;2608;2165;6536;2862;9144
350970;201806;3710;11882;2897;10024;930;3467;400;1187;1330;4654
350980;201806;586;1793;487;1578;172;564;156;503;328;1067
350990;201806;1779;5484;1365;4707;353;1356;432;1371;785;2727
350995;201806;797;2581;716;2401;57;240;449;1431;506;1671
351000;201806;2586;7191;1937;5932;390;1328;565;1591;955;2919
351010;201806;312;840;180;565;21;70;86;257;107;327
351015;201806;697;2265;572;2024;93;374;257;859;350;1233
351020;201806;8696;25143;6995;22341;1305;4386;3862;12142;5167;16528
351030;201806;2493;7861;2026;6796;308;1193;1001;3162;1309;4355
351040;201806;4380;11863;3745;10839;262;934;2853;7947;3115;8881
351050;201806;16261;41979;11040;33350;2462;8027;3933;11650;6395;19677
351060;201806;41859;111553;32920;96076;4865;15307;19719;55753;24584;71060
351070;201806;1393;3699;815;2632;231;792;86;268;317;1060
351080;201806;2563;7146;1937;6324;421;1516;908;2779;1329;4295
351090;201806;367;1144;258;928;49;185;56;210;105;395
351100;201806;2496;7128;1627;5147;391;1317;368;1184;759;2501
351110;201806;5469;14686;3643;11270;823;2810;1229;3437;2052;6247
351120;201806;708;1953;491;1528;79;254;189;546;268;800
351130;201806;1011;2713;489;1637;88;313;91;279;179;592
351140;201806;1671;5313;1271;4461;334;1265;314;987;648;2252
351150;201806;1752;5472;1106;3891;219;821;208;632;427;1453
351160;201806;1125;3771;928;3315;207;795;301;949;508;1744
351170;201806;1360;4081;1188;3709;144;497;711;2088;855;2585
351190;201806;807;2495;607;1991;111;351;209;650;320;1001
351200;201806;1691;4401;1307;3787;89;286;774;2130;863;2416
351210;201806;1392;3555;858;2511;97;332;446;1167;543;1499
351220;201806;3079;9415;2701;8698;399;1335;1570;4978;1969;6313
351230;201806;1809;5249;1366;4437;283;1051;569;1649;852;2700
351240;201806;1732;4756;1139;3468;235;763;490;1367;725;2130
351250;201806;1055;3004;609;1983;82;288;206;656;288;944
351260;201806;911;2601;730;2238;198;592;210;635;408;1227
351270;201806;336;1046;287;942;59;232;142;400;201;632
351280;201806;4226;11895;3339;10125;601;2007;1506;4298;2107;6305
351290;201806;991;2698;675;2092;121;382;278;833;399;1215
351300;201806;14079;41165;9969;32956;2223;7850;3327;10935;5550;18785
351310;201806;2975;8366;2308;7174;284;1047;1312;3773;1596;4820
351320;201806;900;2848;706;2359;121;431;236;749;357;1180
351330;201806;1039;3831;975;3722;51;129;831;3276;882;3405
351340;201806;6164;18863;5002;16699;1371;4727;1842;6173;3213;10900
351350;201806;10478;28780;8918;26063;1177;3685;6123;17264;7300;20949
351360;201806;3896;11211;3314;10210;794;2698;1093;3088;1887;5786
351370;201806;2229;6622;1548;5104;377;1299;500;1467;877;2766
351380;201806;42019;110454;32477;93055;5720;17214;16206;45055;21926;62269
351385;201806;274;747;173;539;30;82;54;165;84;247
351390;201806;1345;3564;891;2865;153;591;469;1380;622;1971
351400;201806;946;2852;771;2472;172;574;345;1072;517;1646
351410;201806;2303;6813;1801;5815;316;1044;833;2640;1149;3684
351420;201806;318;835;186;575;38;116;64;188;102;304
351430;201806;759;2285;691;2154;70;249;511;1569;581;1818
351440;201806;3245;9106;2237;6919;417;1409;488;1251;905;2660
351450;201806;1584;4331;1148;3527;241;789;256;746;497;1535
351460;201806;712;2018;595;1802;196;585;256;773;452;1358
351470;201806;1083;3035;888;2666;92;332;522;1456;614;1788
351480;201806;2530;7904;2150;7234;289;1144;1091;3504;1380;4648
351490;201806;1811;5616;1581;5135;102;424;1101;3390;1203;3814
351492;201806;338;1005;278;865;19;68;151;434;170;502
351495;201806;182;567;145;464;20;72;70;210;90;282
351500;201806;34029;89030;25001;73002;5217;16135;11646;32431;16863;48566
351510;201806;10920;29812;8204;24732;1357;4519;4551;13114;5908;17633
351512;201806;508;1412;339;1025;59;182;118;326;177;508
351515;201806;3055;7503;1884;5466;373;1199;469;1352;842;2551
351518;201806;2243;6182;1515;4830;231;856;764;2192;995;3048
351519;201806;643;1897;432;1385;87;318;84;192;171;510
351520;201806;1056;2754;414;1329;61;214;143;391;204;605
351530;201806;341;998;188;619;31;102;59;158;90;260
351535;201806;2086;5285;1561;4408;154;533;941;2477;1095;3010
351540;201806;1882;5143;1330;4124;440;1499;222;561;662;2060
351550;201806;5685;15683;3883;11781;544;1832;1859;5192;2403;7024
351560;201806;403;1276;340;1130;78;299;82;256;160;555
351565;201806;168;564;140;499;31;119;52;173;83;292
351570;201806;15958;44886;12640;38209;1772;5887;7754;22426;9526;28313
351580;201806;292;776;160;509;22;66;52;179;74;245
351590;201806;513;1229;285;788;32;115;155;382;187;497
351600;201806;1648;4461;1257;3729;147;466;691;1911;838;2377
351610;201806;639;1646;444;1305;33;121;241;616;274;737
351620;201806;19548;57161;14763;47906;2674;9774;5439;15682;8113;25456
351630;201806;25151;71463;21122;64420;3822;12171;12418;36997;16240;49168
351640;201806;14610;41029;11751;35785;1533;5254;7434;21759;8967;27013
351650;201806;386;1119;172;587;26;84;33;113;59;197
351660;201806;766;2363;486;1641;81;310;77;216;158;526
351670;201806;4742;13654;3532;10925;663;2125;1688;4910;2351;7035
351680;201806;449;1370;279;910;52;148;72;225;124;373
351685;201806;436;1344;351;1177;95;313;102;336;197;649
351690;201806;994;2778;648;2028;121;400;227;612;348;1012
351700;201806;912;2595;762;2314;153;450;326;971;479;1421
351710;201806;621;1898;462;1564;55;232;197;605;252;837
351720;201806;1461;4098;986;3138;177;605;360;1095;537;1700
351730;201806;915;2578;748;2278;97;345;395;1109;492;1454
351740;201806;3926;10283;3014;8500;562;1665;1256;3271;1818;4936
351750;201806;1293;3880;797;2793;136;519;267;917;403;1436
351760;201806;3252;9719;2380;7809;536;1922;708;2132;1244;4054
351770;201806;1990;6126;1645;5416;419;1424;669;2144;1088;3568
351780;201806;1367;3690;711;2234;114;416;192;564;306;980
351790;201806;1216;3179;986;2830;175;467;574;1680;749;2147
351800;201806;566;1303;284;776;40;125;86;199;126;324
351810;201806;991;2765;815;2447;61;167;588;1714;649;1881
351820;201806;2499;7530;1760;5955;404;1451;303;985;707;2436
351830;201806;4369;12479;3314;10451;428;1548;1782;5357;2210;6905
351840;201806;6892;21170;5539;18568;1065;3957;2351;7353;3416;11310
351850;201806;1980;5268;1269;3968;236;848;375;1053;611;1901
351860;201806;2788;8649;2334;7731;490;1725;1135;3703;1625;5428
351870;201806;23477;64743;18594;56352;5939;18646;6429;19787;12368;38433
351880;201806;114103;326099;88906;278685;25595;85982;25098;73902;50693;159884
351885;201806;709;2275;631;2102;130;440;292;949;422;1389
351890;201806;607;1837;487;1611;104;356;80;217;184;573
351900;201806;1037;3041;811;2654;161;545;318;1044;479;1589
351905;201806;408;1178;285;918;35;126;112;311;147;437
351907;201806;20959;57650;16700;49723;1420;4857;11481;33092;12901;37949
351910;201806;1200;3353;868;2640;147;499;380;1029;527;1528
351920;201806;931;2529;713;2126;76;257;372;1056;448;1313
351925;201806;985;2825;770;2389;109;356;353;1029;462;1385
351930;201806;2767;8337;2607;8030;274;1073;2063;6142;2337;7215
351940;201806;1084;2958;796;2439;100;335;421;1257;521;1592
351950;201806;1401;3599;1077;3084;57;184;672;1882;729;2066
351960;201806;4886;13375;3622;11032;866;2819;1441;4136;2307;6955
351970;201806;5501;18565;4834;17284;974;3868;2362;7997;3336;11865
351980;201806;915;2511;656;1990;87;310;347;980;434;1290
351990;201806;1413;3602;996;2903;128;466;361;935;489;1401
352000;201806;2249;7013;1956;6385;215;830;1186;3629;1401;4459
352010;201806;1937;5744;1559;5004;380;1313;246;828;626;2141
352020;201806;1560;4465;1224;3868;228;786;543;1619;771;2405
352030;201806;5185;14510;4145;12869;848;2834;2124;6564;2972;9398
352040;201806;2128;6149;1383;4572;253;886;270;781;523;1667
352042;201806;3149;8125;1947;5900;394;1244;763;2298;1157;3542
352044;201806;1960;5651;1139;3968;186;711;234;750;420;1461
352050;201806;12415;35202;8110;25919;1960;7040;1180;3236;3140;10276
352060;201806;748;2192;561;1815;85;312;246;731;331;1043
352070;201806;818;1814;585;1472;89;246;270;654;359;900
352080;201806;468;1269;282;862;40;140;97;252;137;392
352090;201806;1389;4478;1092;3746;173;653;349;1073;522;1726
352100;201806;3263;9465;2609;8238;615;2101;1076;3220;1691;5321
352110;201806;564;1800;449;1536;96;364;161;492;257;856
352115;201806;534;1600;447;1447;101;348;226;723;327;1071
352120;201806;824;2585;659;2228;73;294;349;1090;422;1384
352130;201806;1877;5523;1192;3761;232;756;372;1120;604;1876
352140;201806;1454;3982;885;2824;136;458;368;1109;504;1567
352150;201806;825;2359;637;2010;158;501;297;939;455;1440
352160;201806;972;2521;706;2087;114;397;313;849;427;1246
352170;201806;2756;8037;2263;6939;441;1487;1083;3056;1524;4543
352180;201806;2811;7821;2244;6730;514;1663;755;2043;1269;3706
352190;201806;1149;3256;859;2740;145;526;321;957;466;1483
352200;201806;385;1236;256;943;35;143;75;273;110;416
352210;201806;16986;43508;13780;38734;1696;5129;9528;26513;11224;31642
352215;201806;507;1431;449;1350;60;196;292;850;352;1046
352220;201806;14730;40645;10526;32737;3002;9710;2872;8733;5874;18443
352230;201806;12322;39173;9703;33858;2581;9888;3006;9770;5587;19658
352240;201806;11586;31527;8525;26019;1938;6687;3105;8541;5043;15228
352250;201806;21199;63302;17642;56864;4390;14919;8339;26292;12729;41211
352260;201806;5477;15420;3762;11829;607;2080;1953;5904;2560;7984
352265;201806;890;2637;770;2428;61;248;543;1641;604;1889
352270;201806;1491;4837;1154;4055;265;988;337;1094;602;2082
352280;201806;2265;6216;1796;5461;195;720;942;2685;1137;3405
352290;201806;1067;3286;900;2908;165;583;413;1211;578;1794
352300;201806;943;2669;671;2093;102;355;292;799;394;1154
352310;201806;44771;123488;33750;104199;8899;27943;13668;42337;22567;70280
352320;201806;5638;16121;4505;13790;820;2786;2009;5465;2829;8251
352330;201806;1931;5725;1581;5214;389;1419;656;2045;1045;3464
352340;201806;4842;14065;3623;11840;835;2944;1275;3865;2110;6809
352350;201806;1849;5764;1540;5040;234;899;694;2022;928;2921
352360;201806;1063;3009;931;2797;139;520;654;1855;793;2375
352370;201806;968;3032;860;2804;42;188;633;1995;675;2183
352380;201806;867;2541;693;2223;160;551;208;641;368;1192
352390;201806;17765;44818;11609;33892;1815;5818;5821;15997;7636;21815
352400;201806;3470;9774;2819;8600;601;2199;1533;4250;2134;6449
352410;201806;2884;8130;2338;7187;319;1116;1311;3873;1630;4989
352420;201806;933;2356;646;1875;103;313;226;629;329;942
352430;201806;6998;19251;5315;16272;1529;5009;1900;5648;3429;10657
352440;201806;16577;48257;13017;41148;2835;9518;5417;16500;8252;26018
352450;201806;768;2064;383;1267;66;231;104;319;170;550
352460;201806;2627;7833;1903;6332;393;1472;623;1948;1016;3420
352470;201806;3791;9884;2735;8063;293;994;1482;4030;1775;5024
352480;201806;3619;9213;2513;7185;444;1390;1117;2917;1561;4307
352490;201806;702;2248;548;1900;108;410;215;712;323;1122
352500;201806;9320;24905;6998;20774;3450;11042;963;1916;4413;12958
352510;201806;3262;9350;2480;7932;618;2157;832;2494;1450;4651
352520;201806;2290;6852;1842;5971;438;1534;789;2373;1227;3907
352530;201806;8754;25719;5837;19085;1297;4595;862;2151;2159;6746
352540;201806;541;1632;389;1281;78;281;74;219;152;500
352550;201806;913;2799;653;2252;127;469;176;571;303;1040
352560;201806;558;1617;370;1195;68;232;85;235;153;467
352570;201806;1973;6068;1286;4566;307;1200;212;635;519;1835
352580;201806;818;2396;640;2030;118;420;239;701;357;1121
352585;201806;251;770;197;656;22;83;97;307;119;390
352590;201806;13437;37522;9685;29992;3015;9969;3555;10088;6570;20057
352600;201806;1992;5984;1552;5040;264;868;727;2320;991;3188
352610;201806;3163;9316;2447;8029;538;1963;810;2490;1348;4453
352620;201806;5413;15231;4423;13642;1318;4142;1621;5012;2939;9154
352630;201806;796;2081;613;1790;107;384;289;759;396;1143
352640;201806;2786;7625;2115;6466;180;583;1360;4084;1540;4667
352650;201806;633;1876;458;1442;73;245;151;448;224;693
352660;201806;975;3231;820;2899;174;627;324;1111;498;1738
352670;201806;10045;28457;5980;19820;1418;5142;468;1524;1886;6666
352680;201806;3071;9605;2228;7603;407;1564;924;2905;1331;4469
352690;201806;30564;80228;22079;64196;2176;7149;13079;35972;15255;43121
352700;201806;565;1490;421;1274;150;487;111;290;261;777
352710;201806;4985;13801;3614;11132;934;3159;1348;3823;2282;6982
352720;201806;8029;23713;6457;20458;2787;8959;1026;2929;3813;11888
352725;201806;423;1171;211;692;16;59;87;271;103;330
352730;201806;2598;7832;2277;7055;385;1358;1212;3383;1597;4741
352740;201806;2189;5541;1689;4756;232;718;892;2404;1124;3122
352750;201806;440;1154;225;714;43;132;58;160;101;292
352760;201806;1425;4362;1115;3635;180;637;496;1541;676;2178
352770;201806;775;2315;592;1895;116;397;209;636;325;1033
352780;201806;621;1992;466;1616;92;335;141;466;233;801
352790;201806;612;1679;419;1308;53;172;140;388;193;560
352800;201806;1189;3938;885;3148;217;792;175;567;392;1359
352810;201806;1082;2702;662;1894;102;312;308;825;410;1137
352820;201806;562;1453;370;1135;80;252;73;213;153;465
352830;201806;591;1586;276;871;41;139;50;122;91;261
352840;201806;3853;12061;3301;10967;1071;3735;1075;3415;2146;7150
352850;201806;10352;27436;7128;22097;1894;6308;2037;6094;3931;12402
352860;201806;886;2766;755;2478;148;520;301;939;449;1459
352870;201806;854;2249;572;1612;52;172;326;849;378;1021
352880;201806;1983;5020;1381;3883;213;628;663;1651;876;2279
352885;201806;261;807;210;710;26;92;132;437;158;529
352890;201806;672;1667;424;1129;51;150;201;461;252;611
352900;201806;17865;49308;12579;38714;2287;7671;5174;14778;7461;22449
352910;201806;412;1149;207;675;25;75;37;111;62;186
352920;201806;2515;6865;1818;5548;204;693;1049;3011;1253;3704
352930;201806;5493;16150;4243;13547;799;2700;1676;5068;2475;7768
352940;201806;22345;66209;17618;56238;4900;17177;4125;12045;9025;29222
352950;201806;478;1270;269;850;56;190;21;52;77;242
352960;201806;656;1887;347;1154;44;169;72;213;116;382
352965;201806;314;876;173;568;39;137;30;87;69;224
352970;201806;3109;7628;2441;6577;253;692;1606;4321;1859;5013
352980;201806;1314;3874;1061;3427;222;764;499;1569;721;2333
352990;201806;4021;11860;3354;10730;715;2571;1648;4972;2363;7543
353000;201806;473;1297;236;766;43;156;53;146;96;302
353010;201806;2637;6974;1776;5304;413;1340;558;1530;971;2870
353020;201806;3812;10137;2200;6703;297;976;781;2200;1078;3176
353030;201806;3964;10810;2792;8549;683;2206;595;1764;1278;3970
353040;201806;580;1500;438;1253;80;252;199;516;279;768
353050;201806;4900;15126;3775;12800;937;3444;1479;4744;2416;8188
353060;201806;44962;122763;37650;110669;3367;11842;26555;74696;29922;86538
353070;201806;9640;28403;6810;22432;1499;5266;2016;6316;3515;11582
353080;201806;4532;13422;3121;10479;663;2455;871;2685;1534;5140
353090;201806;539;1776;454;1578;40;162;260;844;300;1006
353100;201806;313;861;121;405;17;62;30;82;47;144
353110;201806;7215;21108;6097;19314;1023;3545;3599;11434;4622;14979
353120;201806;548;1514;365;1124;61;212;128;333;189;545
353130;201806;2435;6484;1720;5337;494;1644;517;1538;1011;3182
353140;201806;2195;5874;1668;4873;202;665;933;2552;1135;3217
353150;201806;1465;4040;1078;3344;269;831;357;1053;626;1884
353160;201806;642;1743;441;1381;91;321;154;424;245;745
353170;201806;501;1500;413;1373;75;299;202;635;277;934
353180;201806;9573;24856;7634;21776;1057;3307;5058;14087;6115;17394
353190;201806;3475;9903;2762;8385;339;1117;1621;4593;1960;5710
353200;201806;1540;4575;806;2702;150;534;190;583;340;1117
353205;201806;328;1077;283;963;63;241;131;436;194;677
353210;201806;956;2373;620;1764;34;122;371;1009;405;1131
353215;201806;427;1276;348;1097;51;182;136;374;187;556
353220;201806;643;1830;446;1435;113;370;81;247;194;617
353230;201806;785;2359;667;2166;181;643;246;695;427;1338
353240;201806;2083;6196;1746;5539;246;908;1003;3031;1249;3939
353250;201806;1274;3016;766;2131;110;322;360;978;470;1300
353260;201806;998;2550;581;1786;123;405;175;503;298;908
353270;201806;636;1808;517;1564;61;185;271;779;332;964
353280;201806;720;2072;510;1603;85;273;163;493;248;766
353282;201806;1804;5417;1584;4969;209;722;895;2687;1104;3409
353284;201806;401;1010;203;601;30;106;72;188;102;294
353286;201806;130;377;93;304;23;78;24;66;47;144
353290;201806;1175;3383;828;2649;105;396;419;1211;524;1607
353300;201806;1627;4642;1220;3790;199;688;503;1404;702;2092
353310;201806;329;865;231;677;25;95;126;336;151;431
353320;201806;618;1698;516;1503;28;85;378;1088;406;1173
353325;201806;619;1949;435;1511;87;310;127;431;214;741
353330;201806;561;1537;360;1091;49;172;180;503;229;675
353340;201806;2932;8073;1957;6240;508;1727;589;1859;1097;3586
353350;201806;3232;9258;2177;6908;463;1577;391;1079;854;2656
353360;201806;493;1549;411;1375;65;241;207;672;272;913
353370;201806;548;1760;456;1584;44;174;275;928;319;1102
353380;201806;268;860;213;734;34;119;87;291;121;410
353390;201806;5396;14460;4104;12014;699;2183;1794;4959;2493;7142
353400;201806;413;1233;322;1044;65;227;57;137;122;364
353410;201806;571;1616;449;1392;97;331;208;618;305;949
353420;201806;507;1426;295;929;49;145;35;92;84;237
353430;201806;2109;6435;1589;5342;397;1441;477;1501;874;2942
353440;201806;58349;169992;42246;136692;8917;30019;18482;57433;27399;87452
353450;201806;413;1117;287;869;37;130;120;338;157;468
353460;201806;3408;9565;2469;7641;229;792;1078;3311;1307;4103
353470;201806;7007;19693;5031;15816;1028;3536;1661;4819;2689;8355
353475;201806;1414;3985;1021;3078;129;423;436;1201;565;1624
353480;201806;1502;4322;1291;3883;89;298;899;2604;988;2902
353490;201806;923;2590;661;2016;128;383;264;772;392;1155
353500;201806;980;2448;788;2146;198;535;399;1117;597;1652
353510;201806;863;2708;626;2092;170;593;109;324;279;917
353520;201806;1161;3139;775;2405;81;278;370;1087;451;1365
353530;201806;2359;6529;1861;5543;255;863;971;2701;1226;3564
353540;201806;1951;5764;1637;5202;322;1067;822;2545;1144;3612
353550;201806;5825;16293;4630;14130;925;3040;2175;6264;3100;9304
353560;201806;2056;6291;1589;5469;519;1923;369;1188;888;3111
353570;201806;523;1494;381;1222;83;260;165;498;248;758
353580;201806;2138;5923;1714;5120;383;1171;780;2243;1163;3414
353590;201806;699;1996;438;1389;109;364;135;437;244;801
353600;201806;1711;4566;1407;3958;177;515;734;1987;911;2502
353610;201806;589;1946;441;1611;95;379;98;331;193;710
353620;201806;2483;7249;1829;5984;409;1424;487;1461;896;2885
353625;201806;519;1375;316;962;32;117;181;528;213;645
353630;201806;1248;4152;966;3457;208;773;222;729;430;1502
353640;201806;1348;3688;1049;3129;127;430;622;1812;749;2242
353650;201806;8949;25372;6580;20267;954;3208;3376;9667;4330;12875
353657;201806;303;894;243;788;31;98;107;326;138;424
353660;201806;1108;2512;750;1961;248;675;231;537;479;1212
353670;201806;3432;10422;2836;9204;685;2432;1228;3675;1913;6107
353680;201806;722;2091;555;1825;112;385;256;813;368;1198
353690;201806;503;1322;212;679;19;61;26;71;45;132
353700;201806;1918;5569;1628;4992;219;722;966;2838;1185;3560
353710;201806;3366;7862;1848;5214;266;730;923;2416;1189;3146
353715;201806;552;1546;364;1159;20;86;103;294;123;380
353720;201806;1924;5450;1550;4885;241;850;901;2722;1142;3572
353730;201806;4130;11876;3116;9724;510;1725;1338;3854;1848;5579
353740;201806;1858;5188;1297;4074;306;1084;341;958;647;2042
353750;201806;881;2804;609;2213;150;574;102;365;252;939
353760;201806;11679;29269;9252;25828;1299;3987;5820;15885;7119;19872
353770;201806;673;2050;336;1166;69;251;37;80;106;331
353780;201806;4436;13858;3528;11952;972;3596;852;2635;1824;6231
353790;201806;2218;7155;1725;6114;528;2170;341;998;869;3168
353800;201806;16413;47251;12762;40612;2450;8338;5777;18217;8227;26555
353810;201806;1093;3140;733;2400;127;491;251;769;378;1260
353820;201806;1621;4922;1215;4011;224;818;443;1414;667;2232
353830;201806;617;1614;473;1368;63;183;243;662;306;845
353850;201806;1694;4941;1306;4162;352;1089;384;1257;736;2346
353860;201806;2495;7564;1985;6471;498;1711;743;2303;1241;4014
353870;201806;27974;77535;19256;59883;3060;10464;8219;23195;11279;33659
353880;201806;2909;8578;2325;7479;261;955;1261;3920;1522;4875
353890;201806;2354;5519;1635;4430;163;495;1032;2637;1195;3132
353900;201806;739;2172;548;1784;111;392;202;630;313;1022
353910;201806;2006;6516;1776;6126;232;837;1224;4284;1456;5121
353920;201806;2259;6418;1533;4923;316;1156;341;925;657;2081
353930;201806;4219;11965;2886;9446;717;2527;638;1913;1355;4440
353940;201806;1093;3429;765;2659;150;544;204;670;354;1214
353950;201806;3061;9093;2486;7917;488;1723;1246;3627;1734;5350
353960;201806;621;1859;426;1432;92;286;129;426;221;712
353970;201806;608;1651;486;1430;47;146;308;878;355;1024
353980;201806;13498;37195;10850;32504;1541;4873;6488;18872;8029;23745
353990;201806;788;2059;515;1532;53;162;285;809;338;971
354000;201806;2320;6048;1376;4191;266;853;251;759;517;1612
354010;201806;357;1008;267;834;35;112;166;499;201;611
354020;201806;3741;11255;3011;9615;777;2661;941;2727;1718;5388
354025;201806;781;2194;522;1673;101;347;115;348;216;695
354030;201806;476;1153;266;742;44;123;91;233;135;356
354040;201806;754;1915;479;1403;37;112;284;785;321;897
354050;201806;955;2908;687;2353;158;583;169;557;327;1140
354060;201806;4246;12699;2841;9562;721;2521;683;2101;1404;4622
354070;201806;3114;9321;2268;7568;520;1889;532;1505;1052;3394
354075;201806;2128;6964;1700;6106;279;1151;869;2996;1148;4147
354080;201806;1464;4263;936;3138;164;569;241;732;405;1301
354085;201806;407;880;327;781;2;11;227;507;229;518
354090;201806;1469;4258;1307;3926;115;395;923;2727;1038;3122
354100;201806;15381;46063;11459;38938;2735;9979;4526;15186;7261;25165
354105;201806;1016;2854;862;2606;134;411;522;1568;656;1979
354110;201806;462;1290;360;1133;90;296;108;319;198;615
354120;201806;1613;4464;1070;3264;194;627;347;930;541;1557
354130;201806;5721;15694;3834;11966;1136;3847;188;398;1324;4245
354140;201806;21599;53731;13920;39810;2775;8422;4784;12646;7559;21068
354150;201806;3408;8679;2517;7111;504;1528;1046;2776;1550;4304
354160;201806;3252;9973;2424;8136;675;2347;673;2214;1348;4561
354165;201806;524;1620;424;1416;84;328;197;614;281;942
354170;201806;1466;4411;1176;3763;98;354;664;2000;762;2354
354180;201806;487;1446;355;1149;60;212;116;331;176;543
354190;201806;1461;4361;1107;3627;144;524;398;1273;542;1797
354200;201806;925;2517;730;2169;93;290;348;957;441;1247
354210;201806;677;2000;536;1739;51;192;326;974;377;1166
354220;201806;3036;8608;2354;7278;423;1395;1118;3291;1541;4686
354230;201806;690;1933;548;1721;60;247;335;976;395;1223
354240;201806;1442;4320;969;3291;176;646;241;725;417;1371
354250;201806;530;1440;350;1139;103;342;94;308;197;650
354260;201806;7922;22445;6228;19424;1511;4919;2055;6418;3566;11337
354270;201806;1132;3528;902;3070;182;636;326;1104;508;1740
354280;201806;727;1974;612;1796;89;322;361;977;450;1299
354290;201806;857;2904;738;2613;138;491;315;1124;453;1615
354300;201806;3705;11407;3296;10619;1094;3666;1014;3062;2108;6728
354310;201806;746;2266;598;1945;107;374;236;706;343;1080
354320;201806;854;2302;545;1710;103;363;198;543;301;906
354323;201806;529;1355;347;997;42;117;138;381;180;498
354325;201806;1217;3816;900;3096;162;581;327;1069;489;1650
354330;201806;6722;18263;5074;15093;841;2946;2773;7558;3614;10504
354340;201806;25289;69120;17873;56016;4356;14695;6699;20114;11055;34809
354350;201806;1118;3109;924;2722;139;449;548;1495;687;1944
354360;201806;542;1568;315;1095;58;203;49;164;107;367
354370;201806;1047;3382;870;3020;141;534;452;1531;593;2065
354380;201806;787;2142;535;1695;98;358;117;303;215;661
354390;201806;13340;34808;8565;26056;1679;5399;2384;6812;4063;12211
354400;201806;1594;5386;1247;4512;210;816;419;1509;629;2325
354410;201806;5031;14736;4012;12757;949;3249;1646;5019;2595;8268
354420;201806;1405;3932;1001;3068;150;492;537;1568;687;2060
354425;201806;2179;5866;1686;4953;401;1190;579;1753;980;2943
354430;201806;1508;4374;1210;3867;201;726;581;1743;782;2469
354440;201806;537;1532;352;1121;38;127;159;460;197;587
354450;201806;392;1070;220;728;30;107;53;160;83;267
354460;201806;930;2582;641;1977;103;338;270;802;373;1140
354470;201806;533;1363;356;1005;30;96;165;413;195;509
354480;201806;1035;2507;726;2015;63;189;460;1209;523;1398
354490;201806;803;2518;606;2069;128;472;199;625;327;1097
354500;201806;2073;6148;1754;5667;575;2021;413;1330;988;3351
354510;201806;821;2293;669;1970;91;279;336;902;427;1181
354515;201806;287;901;217;757;39;154;86;286;125;440
354520;201806;7195;21515;4391;14230;715;2561;2109;6335;2824;8896
354530;201806;3776;11827;2995;10171;726;2586;1091;3670;1817;6256
354540;201806;1323;3738;976;3073;227;780;291;907;518;1687
354550;201806;552;1488;415;1224;60;188;240;671;300;859
354560;201806;1884;4961;1047;3139;131;424;516;1472;647;1896
354570;201806;1164;3187;501;1544;88;303;72;198;160;501
354580;201806;9878;26960;6426;20224;1051;3648;2737;8057;3788;11705
354600;201806;1701;5020;1343;4329;207;726;705;2185;912;2911
354610;201806;371;1007;192;598;38;130;57;162;95;292
354620;201806;458;1354;311;1062;54;206;103;294;157;500
354625;201806;320;944;194;664;27;88;49;140;76;228
354630;201806;2019;6341;1658;5590;673;2401;173;535;846;2936
354640;201806;3150;9736;2287;7796;428;1631;562;1713;990;3344
354650;201806;896;2501;719;2153;80;244;432;1309;512;1553
354660;201806;2632;6879;1765;5412;117;442;1200;3604;1317;4046
354670;201806;1048;3040;743;2357;140;488;268;769;408;1257
354680;201806;4407;12867;3733;11712;962;3135;1833;5765;2795;8900
354690;201806;626;2027;429;1546;100;378;107;364;207;742
354700;201806;1022;2803;708;2136;120;397;304;799;424;1196
354710;201806;528;1493;357;1114;45;165;153;424;198;589
354720;201806;292;757;145;444;46;137;26;77;72;214
354730;201806;9524;27859;6979;22933;1099;3935;3573;11250;4672;15185
354740;201806;342;969;131;476;20;85;21;69;41;154
354750;201806;2459;6888;1669;5378;313;1145;630;1835;943;2980
354760;201806;1840;5417;1344;4411;382;1341;279;886;661;2227
354765;201806;293;814;135;441;17;67;28;81;45;148
354770;201806;2289;5962;1638;4812;360;1145;620;1731;980;2876
354780;201806;54386;144442;42479;120330;6279;19690;22733;60024;29012;79714
354790;201806;878;2666;736;2398;104;350;391;1239;495;1589
354800;201806;2565;7099;2011;6165;445;1445;836;2408;1281;3853
354805;201806;1033;2865;759;2304;87;285;321;864;408;1149
354810;201806;584;1792;338;1218;53;207;79;263;132;470
354820;201806;925;2919;704;2455;135;529;164;497;299;1026
354830;201806;471;1192;315;907;89;259;109;298;198;557
354840;201806;764;2190;494;1539;75;218;221;679;296;897
354850;201806;19474;54922;13830;43917;2194;8002;7222;21290;9416;29292
354860;201806;1380;4153;1004;3405;192;713;316;950;508;1663
354870;201806;48202;128094;38594;110206;6014;18610;21094;57498;27108;76108
354880;201806;5315;13812;2588;7729;355;1188;859;2081;1214;3269
354890;201806;15585;42039;12575;36818;1998;6362;6673;18796;8671;25158
354900;201806;456;1269;286;924;35;124;79;237;114;361
354910;201806;4999;14203;2952;10061;597;2154;277;884;874;3038
354920;201806;428;1159;181;609;25;108;36;99;61;207
354925;201806;268;812;133;484;20;71;31;93;51;164
354930;201806;374;956;228;691;28;98;107;302;135;400
354940;201806;1782;5919;1373;4925;470;1791;158;536;628;2327
354950;201806;1488;4332;1201;3856;86;368;760;2306;846;2674
354960;201806;773;2196;607;1936;137;495;238;723;375;1218
354970;201806;3742;11489;3065;10140;476;1715;1721;5494;2197;7209
354980;201806;28240;71535;18995;54746;2511;8444;9618;25515;12129;33959
354990;201806;58782;158436;43455;129501;5429;17685;23752;67408;29181;85093
354995;201806;2303;5967;1739;5147;316;1045;1005;2813;1321;3858
355000;201806;1434;4107;1156;3629;231;824;332;913;563;1737
355010;201806;3097;9264;2118;6961;721;2496;185;626;906;3122
355020;201806;3208;9683;2351;7949;755;2782;575;1869;1330;4651
355030;201806;1271419;3242965;953276;2619631;174111;519437;443115;1130689;617226;1650126
355040;201806;2801;7907;2353;7205;420;1315;1436;4410;1856;5725
355050;201806;991;2706;733;2243;218;645;168;480;386;1125
355060;201806;5016;14703;3817;12333;706;2593;1704;4927;2410;7520
355070;201806;7497;21229;6063;18739;886;3139;3358;9622;4244;12761
355080;201806;835;2614;536;1966;108;436;37;118;145;554
355090;201806;1127;3494;882;3001;200;682;268;925;468;1607
355100;201806;19889;55403;15692;48934;3099;10330;8752;26728;11851;37058
355110;201806;1041;3084;794;2656;270;963;140;471;410;1434
355120;201806;629;1812;462;1496;75;269;154;467;229;736
355130;201806;633;1538;288;803;31;83;127;332;158;415
355140;201806;1337;3755;1197;3528;144;497;863;2484;1007;2981
355150;201806;3932;11107;3147;9688;508;1664;1614;4838;2122;6502
355160;201806;1844;5421;1416;4633;352;1308;324;1003;676;2311
355170;201806;8450;23135;6721;20191;1871;5973;2868;8479;4739;14452
355180;201806;2725;7992;2039;6720;443;1721;642;1867;1085;3588
355190;201806;1664;4771;1370;4233;358;1184;602;1918;960;3102
355200;201806;812;2682;703;2481;261;1030;192;605;453;1635
355210;201806;3031;8774;2547;7767;298;1085;1521;4348;1819;5433
355220;201806;42008;118146;33378;101051;9033;28820;11445;31686;20478;60506
355230;201806;1237;3238;683;2073;134;396;166;484;300;880
355240;201806;22566;61519;15165;46592;2639;8436;6192;18539;8831;26975
355250;201806;33468;94290;25433;79346;6589;21880;8868;26605;15457;48485
355255;201806;823;2174;436;1372;79;236;140;452;219;688
355260;201806;1228;3327;934;2830;115;442;579;1626;694;2068
355270;201806;1461;4530;1136;3771;275;951;357;1100;632;2051
355280;201806;26687;73343;19666;59476;3470;11157;8469;24253;11939;35410
355290;201806;814;2492;624;2042;140;432;196;596;336;1028
355300;201806;1292;3942;1040;3406;213;742;307;975;520;1717
355310;201806;1036;2975;782;2524;85;309;413;1337;498;1646
355320;201806;548;1507;409;1227;76;272;154;388;230;660
355330;201806;2150;6085;1580;4996;204;728;944;2838;1148;3566
355340;201806;3146;7361;2672;6692;303;756;1834;4557;2137;5313
355350;201806;1329;4113;976;3338;202;745;282;950;484;1695
355360;201806;1255;3565;1072;3191;107;333;750;2253;857;2586
355365;201806;365;1017;187;648;37;111;25;85;62;196
355370;201806;6041;15697;4655;13700;1120;3393;1888;5914;3008;9307
355380;201806;2995;8547;2253;7015;405;1369;669;1772;1074;3141
355385;201806;1243;3697;1075;3392;150;557;573;1659;723;2216
355390;201806;741;2147;557;1747;123;392;211;614;334;1006
355395;201806;1963;5827;1386;4516;202;724;565;1659;767;2383
355400;201806;8957;28040;7369;24598;2112;7755;2004;6041;4116;13796
355410;201806;21920;62952;14943;49297;3648;13126;3161;10359;6809;23485
355420;201806;697;2406;584;2151;157;670;122;439;279;1109
355430;201806;3756;9907;2908;8399;746;2172;1190;3455;1936;5627
355440;201806;869;2479;561;1792;110;375;165;484;275;859
355450;201806;3707;10264;2296;7264;422;1406;772;2252;1194;3658
355460;201806;558;1475;358;1107;54;190;142;382;196;572
355465;201806;364;1096;263;862;49;175;78;248;127;423
355470;201806;1173;3148;636;1998;181;576;178;529;359;1105
355475;201806;277;719;246;663;22;64;185;496;207;560
355480;201806;3487;10657;2975;9756;484;1827;1747;5516;2231;7343
355490;201806;988;2814;537;1774;64;238;196;613;260;851
355495;201806;776;2388;593;2024;96;362;171;561;267;923
355500;201806;6686;18821;4087;13082;633;2217;1066;3154;1699;5371
355510;201806;1431;3833;862;2661;125;427;266;708;391;1135
355520;201806;400;946;189;533;28;86;70;171;98;257
355530;201806;475;1090;164;479;21;76;57;129;78;205
355535;201806;563;1621;437;1403;105;387;157;436;262;823
355540;201806;8861;24974;7498;22820;1406;4604;4313;12764;5719;17368
355550;201806;682;2080;539;1784;71;240;237;780;308;1020
355560;201806;1075;3088;584;1969;119;410;29;99;148;509
355570;201806;240;718;123;430;23;87;18;60;41;147
355580;201806;1254;3238;824;2479;110;399;373;1062;483;1461
355590;201806;188;483;139;405;17;53;83;230;100;283
355600;201806;1522;4006;1040;3095;272;859;372;1047;644;1906
355610;201806;1700;4582;1193;3593;176;565;541;1539;717;2104
355620;201806;4534;13219;3448;10855;483;1773;1710;4874;2193;6647
355630;201806;2204;6395;1532;5061;323;1100;609;1989;932;3089
355635;201806;952;2892;777;2578;122;449;431;1442;553;1891
355640;201806;2685;8133;1871;6472;448;1602;350;1217;798;2819
355645;201806;4236;12884;3401;11413;418;1589;2002;6580;2420;8169
355650;201806;6736;18980;5580;16808;1420;4566;2718;7598;4138;12164
355660;201806;1259;3567;910;2857;113;471;341;1013;454;1484
355670;201806;3364;10014;2321;7426;367;1365;1015;2824;1382;4189
355680;201806;3029;8796;1223;4175;348;1259;115;351;463;1610
355690;201806;651;2078;432;1597;119;457;17;52;136;509
355695;201806;233;746;129;461;11;44;14;36;25;80
355700;201806;6254;19108;5169;16630;1213;3944;2195;6861;3408;10805
355710;201806;8424;20605;5229;14728;961;2892;1869;4737;2830;7629
355715;201806;362;1102;224;757;58;220;45;138;103;358
355720;201806;1465;4567;1151;3902;227;817;482;1497;709;2314
355730;201806;959;2936;752;2484;191;619;236;747;427;1366
410010;201806;1263;3664;967;3021;199;688;217;669;416;1357
410020;201806;1052;3354;856;2884;299;993;242;807;541;1800
410030;201806;1358;4145;1155;3729;198;719;568;1806;766;2525
410040;201806;10391;31178;8255;27055;1755;6302;2653;8171;4408;14473
410045;201806;1007;2739;671;2094;108;374;185;541;293;915
410050;201806;2619;6747;1614;4844;370;1214;295;761;665;1975
410060;201806;2106;6297;1669;5355;422;1421;509;1580;931;3001
410070;201806;1677;4559;1259;3741;257;798;424;1211;681;2009
410080;201806;1362;3739;997;3056;163;525;401;1222;564;1747
410090;201806;979;2813;894;2642;111;332;480;1497;591;1829
410100;201806;2131;6464;1524;4960;220;830;255;809;475;1639
410105;201806;433;1223;240;780;46;179;52;151;98;330
410110;201806;3094;8357;2158;6422;305;959;767;2214;1072;3173
410115;201806;519;1350;371;1075;76;243;122;317;198;560
410120;201806;2451;7846;2160;7314;771;2781;583;1894;1354;4675
410130;201806;1116;3220;1005;3009;335;1104;335;879;670;1983
410140;201806;15188;38580;9406;27772;1898;6039;1885;5066;3783;11105
410150;201806;16451;40822;7835;22766;1487;4639;1390;3812;2877;8451
410160;201806;2865;8386;2429;7569;508;1742;905;2842;1413;4584
410165;201806;662;1908;545;1637;59;199;325;915;384;1114
410170;201806;2408;6606;1620;4834;419;1344;150;440;569;1784
410180;201806;13223;39707;10641;33890;1830;6217;5123;15334;6953;21551
410185;201806;509;1407;363;1121;61;189;104;299;165;488
410190;201806;2088;5619;1553;4593;342;1054;371;1049;713;2103
410200;201806;4532;11432;2637;7903;513;1777;541;1562;1054;3339
410210;201806;2607;7300;1767;5484;293;1045;482;1239;775;2284
410220;201806;617;1653;410;1237;55;197;85;255;140;452
410230;201806;1450;4266;1219;3788;206;749;603;1738;809;2487
410240;201806;4224;12158;3392;10483;995;3454;352;1039;1347;4493
410250;201806;2664;6806;1854;5308;269;881;674;1827;943;2708
410260;201806;1743;4506;1170;3506;240;789;490;1425;730;2214
410270;201806;496;1323;366;1063;30;98;177;495;207;593
410275;201806;724;2177;479;1594;64;222;207;646;271;868
410280;201806;2112;5973;1377;4382;273;969;432;1247;705;2216
410290;201806;3199;9406;2393;7665;527;1664;846;2744;1373;4408
410300;201806;676;1792;526;1500;80;250;225;590;305;840
410302;201806;359;955;176;582;27;93;85;272;112;365
410304;201806;1159;3399;993;3049;171;555;500;1508;671;2063
410305;201806;1688;4371;1236;3653;256;781;592;1737;848;2518
410310;201806;2358;7115;1940;6322;429;1529;628;2022;1057;3551
410315;201806;720;1864;357;1189;91;315;86;273;177;588
410320;201806;1145;3332;726;2374;110;418;105;334;215;752
410322;201806;520;1484;288;930;23;76;109;344;132;420
410330;201806;1445;3812;1060;3032;211;651;285;807;496;1458
410335;201806;875;2525;698;2157;114;382;298;864;412;1246
410337;201806;767;1954;538;1511;49;155;235;607;284;762
410340;201806;523;1440;353;1017;38;129;153;364;191;493
410345;201806;2202;5958;1184;3708;249;802;264;771;513;1573
410347;201806;703;1806;506;1442;50;178;136;358;186;536
410350;201806;1295;3665;951;2982;123;417;349;1010;472;1427
410360;201806;4104;10374;3155;8711;240;786;1969;5182;2209;5968
410370;201806;11108;30913;7665;23189;1092;3663;2755;7351;3847;11014
410380;201806;1397;3871;1098;3239;127;465;448;1223;575;1688
410390;201806;2550;7054;1693;5320;441;1516;342;975;783;2491
410395;201806;890;2733;723;2367;140;519;319;1050;459;1569
410400;201806;4968;14324;3857;12052;715;2345;1477;4426;2192;6771
410405;201806;813;2130;653;1867;145;430;293;820;438;1250
410410;201806;1162;3373;1133;3336;190;705;689;2030;879;2735
410420;201806;7403;22682;5765;19028;1163;4240;1494;4466;2657;8706
410425;201806;2823;8441;2079;6916;350;1260;639;1988;989;3248
410430;201806;12724;33201;8825;25879;1467;4633;2740;7715;4207;12348
410440;201806;2802;9292;2468;8641;391;1423;1345;4894;1736;6317
410442;201806;2301;7412;1975;6687;609;2153;610;2044;1219;4197
410445;201806;2221;6872;1793;5986;404;1505;489;1686;893;3191
410450;201806;1570;4352;1199;3612;223;745;273;698;496;1443
410460;201806;1714;4628;1337;4014;230;765;533;1503;763;2268
410465;201806;2503;7728;1945;6489;441;1481;555;1786;996;3267
410470;201806;1814;5542;1323;4420;321;1175;263;920;584;2095
410480;201806;31787;83855;18102;56719;2792;9635;2416;6467;5208;16102
410490;201806;10943;32016;7798;25155;1554;5362;2463;7423;4017;12785
410500;201806;1639;4816;1200;3844;304;1078;259;735;563;1813
410510;201806;2140;5561;1395;4025;261;760;419;1194;680;1954
410520;201806;2997;9887;2733;9341;750;2625;1176;4047;1926;6672
410530;201806;1535;4171;796;2423;138;419;98;236;236;655
410540;201806;2626;7518;1905;6035;290;979;881;2741;1171;3720
410550;201806;6615;18417;4276;13197;827;2777;847;2305;1674;5082
410560;201806;1383;3792;1085;3210;239;759;436;1181;675;1940
410570;201806;2588;7730;2034;6650;542;2018;229;806;771;2824
410580;201806;23281;64411;17829;53922;3582;11919;7160;20019;10742;31938
410590;201806;1382;4168;902;2914;153;528;209;601;362;1129
410600;201806;1743;4941;1362;4158;308;916;474;1494;782;2410
410610;201806;755;2053;548;1640;70;227;211;590;281;817
410620;201806;1912;6038;1265;4437;302;1136;181;562;483;1698
410630;201806;2309;6623;1500;4792;288;999;191;496;479;1495
410640;201806;4387;11177;2979;8673;755;2457;431;1188;1186;3645
410645;201806;1080;3491;962;3302;370;1316;291;1023;661;2339
410650;201806;1943;5694;1422;4559;355;1208;366;1048;721;2256
410655;201806;1348;4434;1095;3931;47;174;770;2913;817;3087
410657;201806;662;1777;411;1236;82;272;144;369;226;641
410660;201806;3195;8636;1706;5260;342;1089;279;804;621;1893
410670;201806;977;2516;594;1714;108;297;254;689;362;986
410680;201806;2847;8869;2056;6894;513;1667;478;1687;991;3354
410685;201806;587;1616;484;1430;95;322;229;631;324;953
410690;201806;120443;320438;79719;239450;14063;46916;23955;62874;38018;109790
410700;201806;2231;6056;1916;5512;375;1149;917;2473;1292;3622
410710;201806;872;2387;566;1777;62;209;270;802;332;1011
410712;201806;690;2063;585;1857;164;565;194;562;358;1127
410715;201806;862;2701;553;1929;108;374;141;482;249;856
410720;201806;2996;8312;2227;6721;328;1161;430;1133;758;2294
410725;201806;1077;2871;682;2085;114;373;114;302;228;675
410730;201806;566;1540;409;1246;96;343;76;207;172;550
410740;201806;951;2742;673;2193;123;439;258;822;381;1261
410750;201806;1720;4732;1396;4099;237;767;514;1437;751;2204
410752;201806;335;875;150;461;22;79;57;156;79;235
410753;201806;232;701;160;540;22;73;20;55;42;128
410754;201806;1169;3124;969;2799;67;161;614;1933;681;2094
410755;201806;686;1759;486;1379;49;153;247;643;296;796
410760;201806;3003;8329;2313;7058;695;2279;558;1685;1253;3964
410765;201806;12788;37868;9919;32112;1581;5626;1305;3974;2886;9600
410770;201806;943;2410;652;1894;89;278;269;767;358;1045
410773;201806;1292;3598;1150;3374;149;493;807;2310;956;2803
410775;201806;1426;3837;1242;3545;164;511;562;1578;726;2089
410780;201806;595;1556;357;1048;71;203;78;262;149;465
410785;201806;750;2211;603;1912;124;403;185;559;309;962
410790;201806;569;1735;457;1487;118;420;42;89;160;509
410800;201806;2991;7050;2365;6097;169;487;1251;3130;1420;3617
410810;201806;349;1000;266;834;39;135;112;332;151;467
410820;201806;780;2318;453;1439;90;295;74;218;164;513
410830;201806;28735;76250;21072;62726;5284;17553;6667;18696;11951;36249
410832;201806;1015;2771;856;2458;112;403;465;1235;577;1638
410840;201806;7266;19785;4420;13975;969;3381;643;1709;1612;5090
410845;201806;1174;3318;954;2907;183;601;332;982;515;1583
410850;201806;2409;7222;2108;6652;411;1404;843;2652;1254;4056
410855;201806;621;1640;444;1302;45;149;190;516;235;665
410860;201806;3848;10491;2971;8769;556;1745;972;2716;1528;4461
410865;201806;1385;4421;1243;4112;262;929;645;2202;907;3131
410870;201806;1235;3499;1087;3270;83;267;753;2264;836;2531
410880;201806;4003;11706;3015;9741;539;1936;424;1443;963;3379
410890;201806;922;2820;679;2274;151;538;181;605;332;1143
410895;201806;923;3097;785;2777;306;1154;123;414;429;1568
410900;201806;888;2454;591;1845;96;307;140;369;236;676
410910;201806;372;920;222;622;14;41;116;300;130;341
410920;201806;748;2032;580;1731;117;395;222;641;339;1036
410930;201806;1437;4146;1134;3514;305;1063;257;772;562;1835
410940;201806;21190;62856;16201;53134;4102;14480;3539;11726;7641;26206
410950;201806;1903;5809;1720;5512;80;314;1390;4390;1470;4704
410960;201806;7351;19720;4655;14762;1181;4136;1382;4193;2563;8329
410965;201806;1001;2831;756;2329;127;403;359;1075;486;1478
410970;201806;3865;10891;2803;8801;668;2480;423;1157;1091;3637
410975;201806;1325;3624;1008;3020;193;627;313;934;506;1561
410980;201806;6535;17653;4293;13279;569;1929;1647;4872;2216;6801
410990;201806;1150;3117;751;2347;237;835;142;356;379;1191
411000;201806;492;1418;345;1104;46;160;83;219;129;379
411005;201806;443;1247;280;889;54;170;43;139;97;309
411007;201806;2248;6748;1911;6102;440;1491;591;1879;1031;3370
411010;201806;4114;13008;3353;11311;860;3084;330;1032;1190;4116
411020;201806;2374;7035;1986;6335;599;2021;544;1665;1143;3686
411030;201806;707;1853;453;1283;67;197;167;422;234;619
411040;201806;767;2084;342;1041;53;173;75;197;128;370
411050;201806;1812;6015;1542;5382;432;1617;226;689;658;2306
411060;201806;1620;4507;1103;3418;197;754;219;582;416;1336
411065;201806;339;961;256;799;36;115;104;317;140;432
411070;201806;6379;17606;5027;15086;1011;3300;1865;5387;2876;8687
411080;201806;2133;5984;1727;5215;460;1508;429;1274;889;2782
411090;201806;821;2203;534;1643;54;197;103;280;157;477
411095;201806;1486;3763;1033;2960;139;463;348;933;487;1396
411100;201806;1153;3195;798;2483;100;361;211;653;311;1014
411110;201806;568;1573;261;858;24;62;17;47;41;109
411120;201806;1363;4038;1050;3365;330;1187;196;518;526;1705
411125;201806;4730;14486;4372;13821;961;3186;2068;6695;3029;9881
411130;201806;669;1899;469;1464;97;295;163;544;260;839
411140;201806;2205;7038;1795;6084;454;1646;666;2270;1120;3916
411150;201806;3610;9887;2592;7726;531;1803;214;494;745;2297
411155;201806;989;2641;615;1889;67;216;265;750;332;966
411160;201806;329;814;229;650;31;92;59;173;90;265
411170;201806;723;2226;544;1790;128;446;169;533;297;979
411180;201806;5421;15199;4232;12952;787;2649;1653;4801;2440;7450
411190;201806;1344;3685;1040;3069;213;671;288;752;501;1423
411200;201806;4896;13737;3396;10742;913;3139;753;2249;1666;5388
411210;201806;2252;5671;1635;4625;449;1432;183;456;632;1888
411220;201806;888;2405;663;1941;141;461;203;563;344;1024
411230;201806;982;2679;637;2003;130;421;199;636;329;1057
411240;201806;1409;3534;876;2523;79;252;454;1280;533;1532
411250;201806;1983;5604;1540;4783;355;1262;461;1407;816;2669
411260;201806;351;922;224;676;31;90;82;231;113;321
411270;201806;1808;5301;1448;4549;239;802;657;2008;896;2810
411275;201806;1350;3655;981;2951;170;555;394;1155;564;1710
411280;201806;1458;4093;903;2901;165;565;122;337;287;902
411290;201806;717;2015;503;1593;75;232;217;701;292;933
411295;201806;1098;2836;886;2434;92;287;423;1103;515;1390
411300;201806;1024;2605;634;1811;64;192;236;581;300;773
411310;201806;888;2216;676;1886;44;127;277;759;321;886
411320;201806;5248;14553;3782;11736;856;2774;1090;3095;1946;5869
411325;201806;1574;4633;1325;4156;245;767;675;2188;920;2955
411330;201806;3150;9191;2421;7743;623;2167;615;2004;1238;4171
411340;201806;788;2260;492;1566;65;232;198;596;263;828
411342;201806;842;2175;573;1649;83;245;272;761;355;1006
411345;201806;1008;2856;800;2460;110;386;490;1491;600;1877
411350;201806;2607;7464;1845;5878;463;1636;177;556;640;2192
411360;201806;610;1534;421;1226;52;171;139;378;191;549
411370;201806;46534;121863;34413;100293;3573;12136;18089;49048;21662;61184
411373;201806;1372;3786;1120;3367;139;449;504;1534;643;1983
411375;201806;1048;2793;779;2292;128;399;264;717;392;1116
411380;201806;1092;2715;739;1963;67;214;401;944;468;1158
411390;201806;1679;4883;1302;3976;221;753;447;1231;668;1984
411400;201806;2088;5576;1663;4732;283;955;708;1907;991;2862
411410;201806;2061;5999;1518;4814;357;1236;294;830;651;2066
411420;201806;3928;10301;2313;7039;336;1173;406;976;742;2149
411430;201806;3262;9248;2630;8142;573;1938;1034;2948;1607;4886
411435;201806;428;1247;279;920;50;159;105;315;155;474
411440;201806;2638;8043;2177;7069;496;1709;646;2149;1142;3858
411450;201806;2599;7216;2010;6196;335;1019;995;3122;1330;4141
411460;201806;3901;10785;2150;6980;357;1349;300;884;657;2233
411470;201806;703;2008;487;1532;74;252;114;329;188;581
411480;201806;4398;12756;3093;10092;578;2104;726;2200;1304;4304
411490;201806;1496;4206;1154;3567;175;638;376;1025;551;1663
411500;201806;1549;4116;1035;3098;155;540;309;871;464;1411
411510;201806;2045;5722;1671;4979;373;1258;367;1093;740;2351
411520;201806;26860;68844;15216;45430;2180;7193;4527;12036;6707;19229
411530;201806;896;2455;584;1848;126;447;128;368;254;815
411535;201806;473;1416;211;750;20;79;22;54;42;133
411540;201806;2884;7612;2026;5818;354;1134;694;1905;1048;3039
411545;201806;966;2954;823;2679;80;273;524;1708;604;1981
411550;201806;661;1791;490;1457;89;291;81;232;170;523
411560;201806;2004;5647;1246;3991;172;638;74;165;246;803
411570;201806;7216;17961;5009;14360;1028;3272;1311;3684;2339;6956
411573;201806;788;2208;682;2031;80;250;398;1168;478;1418
411575;201806;1671;4865;1301;4102;284;943;344;1082;628;2025
411580;201806;4199;10634;2405;7553;262;1009;301;858;563;1867
411585;201806;781;2377;353;1199;86;295;54;154;140;449
411590;201806;376;1091;267;840;28;106;137;389;165;495
411600;201806;284;787;180;588;40;147;61;193;101;340
411605;201806;1435;3829;940;2757;149;512;375;1009;524;1521
411610;201806;2256;6060;1597;4644;219;677;767;2172;986;2849
411620;201806;2866;8210;2500;7621;411;1378;1437;4289;1848;5667
411630;201806;625;1670;415;1265;84;296;100;263;184;559
411640;201806;502;1425;341;1028;44;143;128;345;172;488
411650;201806;189;561;129;424;19;57;22;81;41;138
411660;201806;890;2365;639;1867;63;186;320;921;383;1107
411670;201806;1121;2965;817;2299;115;330;307;813;422;1143
411680;201806;1555;4378;1248;3800;139;478;651;1968;790;2446
411690;201806;3324;9287;2567;7894;532;1649;763;2451;1295;4100
411695;201806;668;2081;490;1665;70;256;162;566;232;822
411700;201806;1540;4257;1040;3269;237;810;134;374;371;1184
411705;201806;1639;5569;1448;5198;295;1038;814;3069;1109;4107
411710;201806;1833;4966;1347;4032;379;1211;151;438;530;1649
411720;201806;959;2542;678;1950;93;290;224;597;317;887
411721;201806;828;2287;633;1884;123;381;135;396;258;777
411722;201806;698;2007;407;1303;60;235;153;412;213;647
411725;201806;1294;3914;812;2775;188;661;146;507;334;1168
411727;201806;1540;4490;1034;3356;300;1008;135;403;435;1411
411729;201806;663;1701;448;1286;80;247;117;302;197;549
411730;201806;5217;14693;3895;11934;1110;3524;1149;3489;2259;7013
411740;201806;570;1592;299;963;54;189;50;145;104;334
411745;201806;811;2403;548;1740;74;244;97;254;171;498
411750;201806;4868;13693;3623;11112;519;1715;1610;4686;2129;6401
411760;201806;7196;20062;5655;17212;1927;6147;1044;3381;2971;9528
411770;201806;3176;9813;2403;8001;629;2194;285;906;914;3100
411780;201806;2950;8618;2535;7817;668;2175;946;2913;1614;5088
411790;201806;3001;7932;1747;5365;403;1380;220;562;623;1942
411800;201806;1038;2982;683;2152;102;331;119;362;221;693
411810;201806;1703;4601;1289;3806;225;736;567;1544;792;2280
411820;201806;11346;35154;9264;30839;2869;9958;2842;9353;5711;19311
411830;201806;580;1453;400;1145;93;294;68;210;161;504
411840;201806;10905;29998;7264;22293;1344;4472;1776;5116;3120;9588
411845;201806;434;1297;233;781;40;154;22;69;62;223
411850;201806;7586;20966;5604;17177;1592;5357;819;2315;2411;7672
411860;201806;779;2340;587;1909;99;348;148;436;247;784
411870;201806;664;2096;466;1576;88;327;94;287;182;614
411880;201806;2036;5647;1497;4657;358;1224;238;722;596;1946
411885;201806;896;2415;687;2038;119;432;235;658;354;1090
411890;201806;1116;3231;756;2429;119;434;50;134;169;568
411900;201806;838;2527;509;1717;124;436;54;182;178;618
411910;201806;1053;3336;768;2664;217;789;186;611;403;1400
411915;201806;16702;42969;10296;30744;1802;5843;2774;7454;4576;13297
411920;201806;948;3024;805;2690;209;746;196;635;405;1381
411925;201806;573;1553;377;1175;89;296;100;293;189;589
411930;201806;5361;17362;4621;15849;2066;7674;301;1158;2367;8832
411940;201806;3168;10049;2498;8391;613;2110;582;1750;1195;3860
411950;201806;13125;38041;10835;33948;2196;7503;5149;15571;7345;23074
411960;201806;5496;15539;4662;13893;995;3277;1620;4489;2615;7766
411965;201806;465;1311;333;1050;55;208;124;357;179;565
411970;201806;855;2232;694;1992;131;340;383;1220;514;1560
411980;201806;1513;4157;1195;3552;295;914;399;1125;694;2039
411990;201806;35284;101362;24443;78963;5149;18352;7475;22602;12624;40954
411995;201806;2678;7204;2077;6234;602;2009;578;1613;1180;3622
412000;201806;2187;5186;1579;4164;90;299;980;2390;1070;2689
412010;201806;674;2165;472;1676;69;275;102;309;171;584
412015;201806;572;1676;476;1493;71;233;248;778;319;1011
412020;201806;450;1301;269;881;42;153;93;287;135;440
412030;201806;704;2098;493;1662;90;317;155;509;245;826
412033;201806;903;2638;635;2037;84;282;222;731;306;1013
412035;201806;862;2303;549;1745;75;273;249;748;324;1021
412040;201806;580;1659;388;1250;67;214;65;199;132;413
412050;201806;1650;4491;1201;3620;225;761;279;840;504;1601
412060;201806;7106;22816;6165;20867;1824;6728;1419;4602;3243;11330
412065;201806;666;1925;496;1564;95;317;142;428;237;745
412070;201806;1252;3268;921;2584;137;404;366;1009;503;1413
412080;201806;1733;5165;1079;3652;155;559;85;276;240;835
412085;201806;326;915;103;368;9;38;8;20;17;58
412090;201806;5388;14749;4504;13140;1219;3590;1916;5728;3135;9318
412100;201806;1826;5248;1399;4450;423;1434;262;876;685;2310
412110;201806;878;2489;638;1944;119;393;183;555;302;948
412120;201806;1771;5646;1435;4894;322;1204;399;1132;721;2336
412125;201806;644;1993;501;1646;112;366;155;490;267;856
412130;201806;640;1818;454;1393;71;249;107;338;178;587
412135;201806;593;1655;275;845;46;139;87;242;133;381
412140;201806;1617;4299;1078;3267;222;776;167;447;389;1223
412150;201806;2996;8183;2489;7215;306;981;1531;4295;1837;5276
412160;201806;1093;3493;654;2317;156;604;82;278;238;882
412170;201806;4204;12410;3509;11096;806;2756;1415;4148;2221;6904
412175;201806;1337;4223;1134;3821;285;940;388;1333;673;2273
412180;201806;1685;4851;1247;4024;191;726;528;1551;719;2277
412190;201806;3338;8829;2481;7232;366;1176;1028;3049;1394;4225
412200;201806;1900;5861;1333;4455;342;1208;223;720;565;1928
412210;201806;608;1584;367;1107;69;239;93;231;162;470
412215;201806;3839;10526;3157;9183;862;2514;1248;4025;2110;6539
412217;201806;1053;2891;886;2598;74;245;596;1660;670;1905
412220;201806;5723;16920;4831;15177;1224;3826;1657;5509;2881;9335
412230;201806;2802;8871;2273;7712;403;1552;606;1828;1009;3380
412240;201806;6966;18412;4409;13365;809;2705;1091;3038;1900;5743
412250;201806;1957;5353;1530;4495;385;1173;244;669;629;1842
412260;201806;1239;3487;869;2671;138;442;246;684;384;1126
412265;201806;858;2558;726;2274;168;559;279;853;447;1412
412270;201806;811;2436;542;1786;75;272;204;627;279;899
412280;201806;524;1596;431;1414;94;319;111;346;205;665
412290;201806;1000;2634;672;2009;112;356;196;549;308;905
412300;201806;1481;4331;1221;3788;306;999;256;787;562;1786
412310;201806;813;2344;667;2077;71;304;326;986;397;1290
412320;201806;828;2228;566;1703;79;311;191;556;270;867
412330;201806;1445;3992;995;3070;193;626;352;1089;545;1715
412340;201806;992;2917;627;2017;108;369;117;332;225;701
412350;201806;2700;7499;1767;5535;326;1074;291;895;617;1969
412360;201806;242;686;144;457;15;54;51;151;66;205
412370;201806;827;2492;611;2054;120;445;49;176;169;621
412380;201806;1564;4549;1114;3531;291;952;172;573;463;1525
412382;201806;569;1508;375;1122;59;184;101;260;160;444
412385;201806;2222;6415;1857;5652;638;1955;513;1657;1151;3612
412390;201806;2284;5985;1857;5285;366;1105;801;2286;1167;3391
412395;201806;718;2046;499;1585;58;181;223;673;281;854
412400;201806;905;2615;680;2130;152;492;162;544;314;1036
412402;201806;1750;4712;1332;3990;303;983;149;431;452;1414
412405;201806;3179;9045;2048;6559;436;1539;72;249;508;1788
412410;201806;5202;14672;3911;12231;871;3085;936;2731;1807;5816
412420;201806;460;1232;265;800;31;98;104;275;135;373
412430;201806;547;1470;352;1068;33;110;149;433;182;543
412440;201806;2856;8300;1969;6516;511;1834;333;1112;844;2946
412450;201806;335;1053;235;801;35;113;21;47;56;160
412460;201806;881;2548;732;2257;134;454;284;852;418;1306
412470;201806;1700;5603;1365;4784;342;1244;295;1094;637;2338
412480;201806;990;2851;635;1966;108;357;90;217;198;574
412490;201806;1082;2936;877;2518;123;361;410;1104;533;1465
412500;201806;1829;4949;1407;4113;295;872;265;691;560;1563
412510;201806;1974;6227;1429;4818;345;1226;141;430;486;1656
412520;201806;1422;3895;811;2493;179;545;85;244;264;789
412530;201806;627;1747;459;1392;65;216;121;355;186;571
412535;201806;777;2150;543;1655;123;411;103;284;226;695
412540;201806;1226;3343;855;2534;105;364;260;785;365;1149
412545;201806;697;1866;470;1369;83;255;132;348;215;603
412550;201806;31026;88685;21133;67174;4179;14123;6211;18225;10390;32348
412555;201806;240;666;153;474;22;73;41;103;63;176
412560;201806;5189;15515;3771;12174;787;2777;885;2777;1672;5554
412570;201806;3933;10780;2433;7631;505;1727;316;1051;821;2778
412575;201806;945;2693;770;2305;83;276;403;1113;486;1389
412580;201806;1356;3646;944;2829;156;510;393;1125;549;1635
412590;201806;491;1352;256;844;41;133;27;82;68;215
412600;201806;1387;4052;1018;3221;178;632;376;1147;554;1779
412610;201806;795;2261;505;1535;68;211;211;578;279;789
412620;201806;1271;3625;949;3022;193;709;288;831;481;1540
412625;201806;8348;23612;5544;17796;853;2938;534;1805;1387;4743
412627;201806;978;2881;670;2218;172;650;178;552;350;1202
412630;201806;3021;9105;2206;7207;415;1343;673;2016;1088;3359
412635;201806;358;998;246;749;43;136;47;117;90;253
412640;201806;1020;2890;577;1845;83;287;120;343;203;630
412650;201806;1538;4439;1272;3920;227;817;438;1185;665;2002
412660;201806;2571;7054;1815;5515;327;1077;487;1356;814;2433
412665;201806;564;1415;318;953;57;175;114;314;171;489
412667;201806;1718;4710;1279;3815;201;691;484;1366;685;2057
412670;201806;583;1660;456;1415;93;341;148;436;241;777
412680;201806;1417;4071;900;2994;130;514;323;928;453;1442
412690;201806;847;2443;622;1952;115;374;161;479;276;853
412700;201806;2059;5649;1642;4963;314;1141;715;2033;1029;3174
412710;201806;5987;18314;4798;15812;1005;3592;1297;3954;2302;7546
412720;201806;1256;3827;936;3038;157;552;182;493;339;1045
412730;201806;2122;6153;1192;3943;245;845;176;551;421;1396
412740;201806;1713;5022;1142;3729;215;770;159;540;374;1310
412750;201806;3939;11279;3406;10394;412;1512;2151;6277;2563;7789
412760;201806;2715;7848;2370;7244;359;1211;1353;4007;1712;5218
412770;201806;10331;27433;5542;17267;775;2526;1070;2949;1845;5475
412780;201806;1272;3693;1033;3220;212;699;377;1156;589;1855
412785;201806;2064;5484;1471;4361;319;960;647;1867;966;2827
412788;201806;1362;4041;1114;3528;261;878;457;1372;718;2250
412790;201806;1035;2984;648;2120;126;465;177;499;303;964
412795;201806;1158;3209;672;2077;136;448;141;411;277;859
412796;201806;2318;7119;1942;6254;391;1345;617;1817;1008;3162
412800;201806;3291;8678;2263;6592;306;1010;867;2303;1173;3313
412810;201806;10962;28863;6443;19193;894;2984;1915;4880;2809;7864
412820;201806;6773;19255;4915;15520;1073;3551;1480;4647;2553;8198
412830;201806;351;1047;253;825;36;110;52;163;88;273
412840;201806;1817;4950;1351;4020;213;680;407;1159;620;1839
412850;201806;2998;8278;2247;6895;366;1200;785;2325;1151;3525
412853;201806;1808;4942;1491;4222;168;520;748;1900;916;2420
412855;201806;1242;3498;859;2610;164;554;205;550;369;1104
412860;201806;937;2705;717;2249;140;460;252;762;392;1222
412862;201806;689;1681;442;1247;68;220;176;486;244;706
412863;201806;1195;3802;1121;3679;114;377;829;2719;943;3096
412865;201806;734;2129;542;1753;94;315;185;610;279;925
412870;201806;910;2553;697;2190;215;760;138;446;353;1206
412880;201806;838;2398;562;1769;101;348;77;226;178;574
420005;201806;453;1362;252;878;39;143;96;331;135;474
420010;201806;3648;9315;2414;7143;227;748;1641;4862;1868;5610
420020;201806;547;1719;320;1126;50;198;44;118;94;316
420030;201806;189;540;100;377;22;97;13;47;35;144
420040;201806;602;1871;330;1232;52;207;17;46;69;253
420050;201806;656;1678;425;1258;61;193;236;667;297;860
420055;201806;154;475;78;287;12;56;25;90;37;146
420060;201806;137;424;92;314;14;57;18;37;32;94
420070;201806;963;3035;716;2447;140;510;249;830;389;1340
420075;201806;104;286;59;185;11;36;14;29;25;65
420080;201806;444;1341;340;1128;101;335;92;296;193;631
420090;201806;377;1287;251;949;53;200;51;207;104;407
420100;201806;1136;3287;996;3081;70;232;772;2369;842;2601
420110;201806;246;820;225;773;49;185;87;274;136;459
420120;201806;358;1100;259;870;59;230;95;285;154;515
420125;201806;326;1085;264;957;64;269;125;435;189;704
420127;201806;305;860;108;378;22;86;19;49;41;135
420130;201806;1983;6160;1472;5088;308;1194;497;1539;805;2733
420140;201806;3391;9697;2449;7923;654;2394;308;933;962;3327
420150;201806;537;1428;339;1101;66;235;135;407;201;642
420160;201806;233;612;107;354;12;40;36;121;48;161
420165;201806;166;502;104;350;26;92;30;91;56;183
420170;201806;241;755;148;527;30;117;25;82;55;199
420180;201806;231;702;126;447;16;58;33;95;49;153
420190;201806;139;477;86;330;30;115;16;61;46;176
420195;201806;1302;3695;996;3160;273;978;122;334;395;1312
420200;201806;3113;8705;1819;5981;321;1282;524;1478;845;2760
420205;201806;1249;3671;921;3042;153;550;496;1665;649;2215
420207;201806;1537;4268;986;3176;231;851;304;920;535;1771
420208;201806;437;1208;247;869;39;175;101;350;140;525
420209;201806;169;560;107;382;31;127;37;118;68;245
420210;201806;2296;6383;1454;4947;315;1170;569;1846;884;3016
420213;201806;772;2591;680;2395;176;680;307;1067;483;1747
420215;201806;275;853;176;621;53;192;25;78;78;270
420220;201806;172;573;122;466;36;147;37;133;73;280
420230;201806;3775;10843;2861;9170;440;1617;1415;4368;1855;5985
420240;201806;11293;30919;7080;22451;912;3431;3445;9771;4357;13202
420243;201806;417;1257;332;1091;61;219;145;446;206;665
420245;201806;1213;3371;838;2671;91;360;432;1286;523;1646
420250;201806;447;1379;392;1269;85;311;175;526;260;837
420253;201806;515;1345;376;1135;29;86;200;596;229;682
420257;201806;210;561;127;402;25;81;59;191;84;272
420260;201806;1057;3184;808;2763;137;522;404;1354;541;1876
420270;201806;515;1414;233;736;19;65;81;243;100;308
420280;201806;1517;4183;943;3116;192;676;234;752;426;1428
420285;201806;101;275;52;180;8;32;9;25;17;57
420287;201806;420;1097;286;886;92;299;93;279;185;578
420290;201806;4090;12342;3100;10064;545;1940;1177;3435;1722;5375
420300;201806;6593;19085;3846;12768;792;2968;870;2474;1662;5442
420310;201806;861;2090;427;1201;74;197;235;633;309;830
420315;201806;843;2651;619;2174;152;561;214;748;366;1309
420320;201806;3994;11955;3181;10446;1037;3719;714;2124;1751;5843
420325;201806;235;743;175;617;50;177;47;159;97;336
420330;201806;842;2686;591;2087;125;490;180;578;305;1068
420340;201806;1122;3335;796;2647;158;537;59;190;217;727
420350;201806;1450;4017;1000;3122;133;459;567;1741;700;2200
420360;201806;2552;7532;1429;4977;271;1025;121;411;392;1436
420370;201806;1300;3616;1001;3106;136;513;644;1902;780;2415
420380;201806;5056;14223;3255;10527;727;2507;959;2997;1686;5504
420390;201806;1065;2772;698;2015;109;335;260;559;369;894
420395;201806;1043;3129;675;2307;104;377;80;230;184;607
420400;201806;987;3008;653;2257;128;505;151;498;279;1003
420410;201806;549;1545;405;1261;34;135;274;819;308;954
420415;201806;335;1037;256;866;77;275;68;234;145;509
420417;201806;654;2053;522;1747;116;408;193;642;309;1050
420419;201806;218;754;155;593;52;225;6;17;58;242
420420;201806;10133;28593;7319;23332;2518;8725;1542;4508;4060;13233
420425;201806;829;2222;563;1727;53;200;243;712;296;912
420430;201806;3200;9346;2000;6544;456;1578;541;1607;997;3185
420435;201806;284;784;128;447;23;102;46;145;69;247
420440;201806;772;2283;420;1410;126;476;104;303;230;779
420445;201806;325;909;193;616;43;146;56;159;99;305
420450;201806;668;2049;477;1612;95;371;132;401;227;772
420455;201806;1965;5281;1481;4459;216;740;725;2090;941;2830
420460;201806;8478;23794;6383;20009;1139;4005;2737;8129;3876;12134
420470;201806;653;1780;386;1244;71;268;94;257;165;525
420475;201806;39;117;30;95;12;37;5;15;17;52
420480;201806;4922;13119;3231;10079;657;2228;969;2922;1626;5150
420490;201806;562;1504;306;1036;72;277;70;238;142;515
420500;201806;1311;3934;935;3182;196;703;327;1089;523;1792
420510;201806;110;369;70;248;13;43;33;112;46;155
420515;201806;61;171;44;137;6;20;17;49;23;69
420517;201806;771;2184;682;2029;53;147;514;1530;567;1677
420519;201806;357;911;228;699;36;132;76;227;112;359
420520;201806;454;1236;208;731;20;62;19;59;39;121
420530;201806;948;2871;670;2258;135;509;186;551;321;1060
420535;201806;226;648;103;347;26;88;15;55;41;143
420540;201806;24965;64578;16319;47974;2996;9612;5359;13707;8355;23319
420543;201806;236;686;186;582;26;84;97;291;123;375
420545;201806;1259;3903;1001;3345;222;765;340;1110;562;1875
420550;201806;3573;10439;2387;8165;501;1915;859;3001;1360;4916
420555;201806;312;955;220;748;43;157;90;288;133;445
420560;201806;430;1181;321;997;73;221;165;510;238;731
420570;201806;2138;6437;1616;5337;337;1229;571;1760;908;2989
420580;201806;1730;4669;1300;3976;282;983;596;1709;878;2692
420590;201806;3016;8601;1815;5849;346;1259;350;822;696;2081
420600;201806;916;2846;742;2495;127;470;364;1200;491;1670
420610;201806;393;1181;213;750;52;195;40;133;92;328
420620;201806;485;1412;393;1242;110;370;125;388;235;758
420630;201806;841;2567;622;2031;129;461;272;820;401;1281
420640;201806;585;1693;275;978;68;267;25;67;93;334
420650;201806;2707;7658;1618;5288;266;927;550;1566;816;2493
420660;201806;403;1145;267;856;58;199;60;179;118;378
420665;201806;522;1430;333;1086;56;219;133;382;189;601
420670;201806;1541;4351;1030;3323;175;700;345;968;520;1668
420675;201806;156;474;102;353;26;108;18;47;44;155
420680;201806;336;825;192;615;34;122;85;259;119;381
420690;201806;816;2659;554;1966;79;288;116;316;195;604
420700;201806;2904;8256;2249;7009;361;1257;969;2880;1330;4137
420710;201806;641;2018;493;1707;86;374;217;663;303;1037
420720;201806;1369;3860;1027;3350;263;869;428;1391;691;2260
420730;201806;2816;7877;2178;6836;375;1284;1116;3368;1491;4652
420740;201806;724;2205;477;1672;131;487;77;271;208;758
420750;201806;1869;5741;1299;4438;215;828;445;1354;660;2182
420757;201806;78;179;22;88;4;19;8;31;12;50
420760;201806;386;1193;170;572;38;133;21;67;59;200
420765;201806;437;1400;226;813;36;134;63;230;99;364
420768;201806;1212;3842;1026;3481;225;787;611;2070;836;2857
420770;201806;506;1405;231;849;45;187;66;239;111;426
420775;201806;469;1376;265;914;59;221;48;144;107;365
420780;201806;1094;3190;646;2187;116;405;149;470;265;875
420785;201806;195;550;142;431;27;81;39;103;66;184
420790;201806;1005;3295;782;2842;188;750;330;1129;518;1879
420800;201806;744;2020;339;1141;79;276;88;282;167;558
420810;201806;1574;5345;1296;4705;395;1597;295;915;690;2512
420820;201806;9270;25118;6301;20127;1410;5010;2189;6314;3599;11324
420830;201806;2896;8422;2268;7249;530;1843;786;2430;1316;4273
420840;201806;677;1996;295;1052;69;265;56;179;125;444
420845;201806;1740;4769;1046;3498;238;880;322;1059;560;1939
420850;201806;1115;3738;694;2629;154;652;92;299;246;951
420860;201806;288;799;177;593;48;181;33;96;81;277
420870;201806;892;2470;686;2119;216;760;252;724;468;1484
420880;201806;915;2951;711;2474;161;621;182;551;343;1172
420890;201806;7586;20860;4162;13649;743;2682;1102;3070;1845;5752
420895;201806;167;494;93;296;31;103;27;81;58;184
420900;201806;1476;3890;882;2786;138;517;318;880;456;1397
420910;201806;23582;66524;15539;50538;2589;9408;5306;15561;7895;24969
420915;201806;555;2112;370;1548;63;278;157;635;220;913
420917;201806;354;1003;177;534;32;106;68;191;100;297
420920;201806;106;309;41;150;4;16;2;6;6;22
420930;201806;17619;48124;12720;39453;2249;7625;5541;16248;7790;23873
420940;201806;2407;6530;1575;4987;372;1289;144;354;516;1643
420945;201806;147;451;106;343;33;121;30;87;63;208
420950;201806;405;1163;219;748;29;125;64;204;93;329
420960;201806;912;2487;631;1937;124;447;218;593;342;1040
420970;201806;2586;7733;1794;6132;480;1701;295;1071;775;2772
420980;201806;354;1093;282;984;124;447;86;326;210;773
420985;201806;319;970;166;595;34;146;56;177;90;323
420990;201806;521;1553;282;1017;56;215;42;109;98;324
421000;201806;479;1636;326;1217;80;325;62;182;142;507
421003;201806;508;1258;173;544;17;49;22;53;39;102
421005;201806;64;225;57;212;16;66;22;87;38;153
421010;201806;3887;10869;2719;8776;580;2035;586;1704;1166;3739
421020;201806;399;1196;309;1039;20;80;204;691;224;771
421030;201806;721;2356;569;2006;177;679;137;448;314;1127
421040;201806;783;1908;471;1415;52;194;274;787;326;981
421050;201806;1300;3706;755;2459;142;496;233;692;375;1188
421055;201806;175;477;85;269;21;76;22;61;43;137
421060;201806;538;1650;365;1221;76;301;131;405;207;706
421070;201806;539;1704;315;1132;72;272;41;145;113;417
421080;201806;657;2673;607;2596;68;223;463;2137;531;2360
421085;201806;437;1266;185;664;28;107;28;89;56;196
421090;201806;394;1070;199;637;24;81;53;160;77;241
421100;201806;929;2378;456;1405;102;341;49;133;151;474
421105;201806;1413;4030;1103;3561;172;552;575;1925;747;2477
421110;201806;945;2913;811;2681;64;210;538;1814;602;2024
421120;201806;1064;3403;721;2613;102;424;192;606;294;1030
421125;201806;303;815;223;690;71;244;71;170;142;414
421130;201806;3562;11056;3039;10044;726;2635;1509;4850;2235;7485
421140;201806;288;837;197;641;41;132;59;171;100;303
421145;201806;469;1367;278;905;57;208;112;334;169;542
421150;201806;512;1468;325;1126;58;242;117;379;175;621
421160;201806;814;2187;433;1403;65;237;203;634;268;871
421165;201806;201;620;143;480;32;106;65;216;97;322
421170;201806;1170;3174;910;2766;143;425;557;1710;700;2135
421175;201806;1107;3013;724;2334;146;555;264;753;410;1308
421180;201806;430;1141;202;657;41;172;42;120;83;292
421185;201806;324;844;212;625;37;115;114;325;151;440
421187;201806;340;1020;225;733;32;103;88;266;120;369
421189;201806;358;1114;271;919;44;157;81;258;125;415
421190;201806;10293;28504;6371;21024;1262;4568;1250;3866;2512;8434
421200;201806;722;2257;591;2000;106;373;251;808;357;1181
421205;201806;197;559;151;480;29;106;68;204;97;310
421210;201806;1074;3048;722;2349;172;567;237;751;409;1318
421220;201806;1408;4613;1180;4094;293;1119;217;655;510;1774
421223;201806;414;1234;281;965;61;212;105;357;166;569
421225;201806;991;3117;851;2825;178;647;439;1471;617;2118
421227;201806;965;2662;609;1957;104;374;305;986;409;1360
421230;201806;574;1572;376;1216;101;350;123;402;224;752
421240;201806;328;1027;144;543;14;69;16;60;30;129
421250;201806;1474;4002;943;3090;188;690;291;906;479;1596
421260;201806;272;787;53;195;11;42;7;26;18;68
421265;201806;724;2171;661;2077;49;176;529;1654;578;1830
421270;201806;446;1195;206;735;38;135;72;254;110;389
421280;201806;1526;4693;1192;4062;270;1023;476;1558;746;2581
421290;201806;803;2242;462;1472;81;262;90;264;171;526
421300;201806;225;660;147;488;36;138;42;133;78;271
421310;201806;185;582;144;479;23;84;54;176;77;260
421315;201806;248;749;149;516;36;131;20;72;56;203
421320;201806;647;1947;368;1235;61;213;55;131;116;344
421330;201806;586;1785;434;1482;104;389;112;365;216;754
421335;201806;389;1276;316;1128;59;245;95;329;154;574
421340;201806;1392;4011;1053;3402;209;744;456;1419;665;2163
421350;201806;1107;3312;848;2830;151;609;380;1191;531;1800
421360;201806;2273;6488;1412;4745;317;1234;456;1353;773;2587
421370;201806;458;1542;297;1114;70;276;67;248;137;524
421380;201806;816;2347;694;2124;104;349;385;1130;489;1479
421390;201806;160;431;62;204;10;33;16;45;26;78
421400;201806;269;898;178;683;41;178;78;282;119;460
421410;201806;268;753;119;429;15;62;50;176;65;238
421415;201806;332;1028;151;518;36;124;26;78;62;202
421420;201806;608;1789;487;1560;77;266;257;786;334;1052
421430;201806;137;472;104;386;18;69;28;101;46;170
421440;201806;695;1932;463;1526;83;287;225;748;308;1035
421450;201806;399;1199;242;831;33;133;41;161;74;294
421460;201806;434;1231;264;916;60;227;70;220;130;447
421470;201806;252;812;178;640;37;162;51;169;88;331
421480;201806;2761;7627;1786;5846;480;1783;434;1243;914;3026
421490;201806;146;439;75;273;11;45;18;50;29;95
421500;201806;2065;6521;1474;5246;386;1533;251;816;637;2349
421505;201806;312;971;271;899;46;166;148;481;194;647
421507;201806;387;1168;234;827;59;231;74;247;133;478
421510;201806;236;690;146;476;34;104;60;176;94;280
421520;201806;561;1557;357;1095;50;179;176;494;226;673
421530;201806;322;1016;182;656;35;159;39;115;74;274
421535;201806;426;1236;277;936;36;141;139;437;175;578
421540;201806;231;611;154;483;18;61;62;180;80;241
421545;201806;682;2083;492;1700;106;420;205;672;311;1092
421550;201806;1971;5859;1662;5359;406;1432;759;2362;1165;3794
421555;201806;204;615;71;255;13;50;11;27;24;77
421560;201806;107;341;58;214;12;52;15;52;27;104
421565;201806;805;2210;587;1858;132;464;213;696;345;1160
421567;201806;503;1787;351;1337;159;624;52;192;211;816
421568;201806;412;1267;285;961;43;157;113;362;156;519
421569;201806;196;595;73;270;20;71;18;72;38;143
421570;201806;1123;3186;710;2310;178;626;129;382;307;1008
421575;201806;328;1019;287;905;42;151;150;437;192;588
421580;201806;2808;8531;2017;6856;421;1670;640;1882;1061;3552
421590;201806;147;490;119;411;30;110;30;92;60;202
421600;201806;466;1329;320;997;78;257;76;212;154;469
421605;201806;766;2113;510;1645;89;302;140;426;229;728
421610;201806;1219;3360;755;2433;149;526;161;478;310;1004
421620;201806;3819;10998;2275;7899;593;2234;498;1671;1091;3905
421625;201806;267;731;106;357;24;77;14;39;38;116
421630;201806;2644;7536;1476;4824;247;922;314;906;561;1828
421635;201806;242;713;139;456;16;58;52;144;68;202
421640;201806;820;2312;547;1800;116;399;148;471;264;870
421650;201806;2114;6316;1389;4774;306;1221;242;650;548;1871
421660;201806;7024;21824;5651;19083;1034;3922;2065;6403;3099;10325
421670;201806;899;2643;615;1989;143;542;228;693;371;1235
421680;201806;956;2988;749;2542;221;801;225;704;446;1505
421690;201806;1207;3831;875;3043;204;807;204;677;408;1484
421700;201806;469;1490;242;892;50;203;54;176;104;379
421710;201806;202;647;89;304;19;70;28;86;47;156
421715;201806;113;322;77;241;17;54;45;132;62;186
421720;201806;1849;5342;1083;3705;270;996;256;782;526;1778
421725;201806;176;471;105;334;25;86;35;91;60;177
421730;201806;376;1155;203;652;33;123;69;188;102;311
421740;201806;627;1904;431;1434;111;405;107;318;218;723
421750;201806;893;2206;463;1410;75;245;176;497;251;742
421755;201806;214;617;108;365;15;63;43;129;58;192
421760;201806;939;2734;512;1762;86;318;118;345;204;663
421770;201806;2351;6657;1728;5544;424;1376;603;2101;1027;3477
421775;201806;259;734;172;557;29;102;72;217;101;319
421780;201806;846;2757;582;2143;116;455;165;576;281;1031
421790;201806;639;1668;380;1253;100;354;156;487;256;841
421795;201806;241;722;146;463;23;85;52;144;75;229
421800;201806;2438;7156;1798;5942;377;1375;788;2480;1165;3855
421810;201806;645;1831;447;1437;67;246;208;628;275;874
421820;201806;857;2494;460;1571;89;323;71;221;160;544
421825;201806;1323;3950;1209;3764;163;567;828;2505;991;3072
421830;201806;2188;7117;1873;6486;448;1684;596;1939;1044;3623
421835;201806;216;590;124;420;19;83;57;170;76;253
421840;201806;224;707;152;556;35;138;43;145;78;283
421850;201806;411;1271;234;816;41;170;57;148;98;318
421860;201806;278;870;181;652;26;116;48;144;74;260
421870;201806;3368;9083;2328;7057;516;1741;803;2237;1319;3978
421875;201806;271;823;126;465;22;89;23;67;45;156
421880;201806;568;1658;418;1369;116;420;67;221;183;641
421885;201806;238;686;181;597;54;185;35;94;89;279
421890;201806;766;2506;620;2213;154;617;240;777;394;1394
421895;201806;353;1050;324;1009;45;159;213;660;258;819
421900;201806;936;2501;643;1926;114;399;289;786;403;1185
421910;201806;367;1152;257;903;54;218;46;129;100;347
421915;201806;403;1174;232;759;48;153;33;101;81;254
421917;201806;572;1565;372;1279;123;479;78;265;201;744
421920;201806;523;1530;346;1247;169;629;97;364;266;993
421930;201806;2337;6365;1168;4007;316;1157;133;414;449;1571
421935;201806;481;1592;380;1374;75;287;180;612;255;899
421940;201806;266;839;126;439;23;99;35;113;58;212
421950;201806;3119;8048;1516;4867;321;1136;283;808;604;1944
421960;201806;157;425;109;350;19;75;27;86;46;161
421970;201806;2037;5463;1107;3533;235;781;278;785;513;1566
421985;201806;331;846;180;550;22;74;54;180;76;254
422000;201806;1646;4696;1347;4147;213;753;742;2245;955;2998
430003;201806;550;1628;388;1329;80;308;138;455;218;763
430005;201806;280;780;181;588;52;172;68;216;120;388
430010;201806;1750;4696;1370;4026;218;696;788;2258;1006;2954
430020;201806;608;1471;473;1285;73;227;276;713;349;940
430030;201806;1045;2588;613;1790;181;546;166;472;347;1018
430040;201806;9933;25774;6094;18351;1570;5250;341;1079;1911;6329
430045;201806;581;1559;398;1179;46;143;198;546;244;689
430047;201806;273;636;113;341;22;70;33;99;55;169
430050;201806;972;2595;542;1667;116;371;128;365;244;736
430055;201806;284;733;126;389;15;50;58;164;73;214
430057;201806;107;253;38;118;8;32;7;20;15;52
430060;201806;16494;48367;13362;43224;3445;11914;5184;16818;8629;28732
430063;201806;877;2515;691;2102;130;395;384;1160;514;1555
430064;201806;1033;3027;767;2411;220;738;207;633;427;1371
430066;201806;128;297;91;235;4;15;61;147;65;162
430070;201806;670;1771;117;403;9;30;11;25;20;55
430080;201806;774;2070;452;1395;95;306;171;473;266;779
430085;201806;899;2228;534;1563;84;253;197;580;281;833
430087;201806;617;1874;514;1701;102;359;256;829;358;1188
430090;201806;643;1700;218;713;22;90;61;193;83;283
430100;201806;690;1778;366;1137;73;241;120;334;193;575
430105;201806;1025;2830;665;2188;111;422;297;983;408;1405
430107;201806;182;554;125;416;18;62;29;84;47;146
430110;201806;2092;5388;1523;4514;278;862;783;2247;1061;3109
430120;201806;1433;4421;903;3044;196;689;360;1247;556;1936
430130;201806;3887;10392;3094;9207;1025;2803;956;3503;1981;6306
430140;201806;972;2900;622;2094;163;545;208;691;371;1236
430150;201806;595;1558;328;1027;68;219;97;297;165;516
430155;201806;289;761;147;467;20;70;34;93;54;163
430160;201806;17701;46815;14243;41369;3266;9981;5442;16325;8708;26306
430163;201806;2347;6157;1694;5098;190;664;1016;3010;1206;3674
430165;201806;440;1029;87;276;10;26;7;19;17;45
430170;201806;902;2499;321;1135;60;212;59;193;119;405
430175;201806;704;2231;578;1921;142;456;269;891;411;1347
430180;201806;693;1843;552;1590;91;295;334;908;425;1203
430185;201806;484;1208;300;856;46;134;135;346;181;480
430187;201806;636;1685;453;1386;72;240;205;614;277;854
430190;201806;1475;4267;1224;3772;295;958;511;1544;806;2502
430192;201806;136;414;60;189;9;29;10;27;19;56
430195;201806;382;1149;66;232;10;34;7;22;17;56
430200;201806;1095;3489;924;3140;285;1028;272;911;557;1939
430205;201806;514;1433;400;1191;18;67;314;905;332;972
430210;201806;5309;13706;3614;10264;558;1719;1391;3197;1949;4916
430215;201806;323;884;209;635;40;129;75;221;115;350
430220;201806;655;1644;173;589;31;119;39;113;70;232
430222;201806;195;600;158;515;23;75;66;204;89;279
430223;201806;271;769;225;676;38;120;113;330;151;450
430225;201806;17;43;15;39;2;3;8;13;10;16
430230;201806;1607;4717;1503;4577;203;573;1153;3600;1356;4173
430235;201806;247;772;184;615;28;103;61;185;89;288
430237;201806;554;1383;373;1059;21;68;246;649;267;717
430240;201806;1185;2699;710;1964;66;218;416;1113;482;1331
430245;201806;741;2258;562;1881;185;624;246;843;431;1467
430250;201806;1026;2819;825;2509;238;768;44;127;282;895
430258;201806;114;329;87;277;7;23;44;144;51;167
430260;201806;622;1731;453;1390;85;258;214;653;299;911
430265;201806;193;576;140;480;22;85;40;135;62;220
430270;201806;2827;7406;2300;6584;252;780;1546;4348;1798;5128
430280;201806;4837;12207;3532;9846;789;2262;1444;4038;2233;6300
430290;201806;2195;5549;1949;5213;74;227;1678;4435;1752;4662
430300;201806;8685;24091;6885;20724;1384;4504;3187;9470;4571;13974
430310;201806;8436;22614;5754;17461;928;3212;2531;7159;3459;10371
430320;201806;930;2596;514;1662;92;253;243;848;335;1101
430330;201806;633;1606;430;1205;91;274;189;469;280;743
430340;201806;747;1751;373;1129;71;221;192;568;263;789
430350;201806;5822;16867;4717;14557;1222;3887;1913;5755;3135;9642
430355;201806;367;948;123;404;26;91;13;42;39;133
430360;201806;776;2057;557;1648;108;351;189;514;297;865
430367;201806;336;838;172;519;49;166;49;145;98;311
430370;201806;530;1489;258;850;58;205;58;169;116;374
430380;201806;698;1795;376;1197;106;386;89;287;195;673
430390;201806;3294;8435;1813;5549;303;987;140;342;443;1329
430400;201806;1148;2659;856;2187;110;293;552;1360;662;1653
430410;201806;592;1521;418;1213;54;182;250;710;304;892
430420;201806;2911;8341;2247;6812;688;2166;707;2051;1395;4217
430430;201806;681;1790;329;1041;75;241;63;190;138;431
430435;201806;1697;4447;1237;3640;282;885;440;1293;722;2178
430440;201806;3761;11099;2813;9097;535;1839;1358;4442;1893;6281
430450;201806;6270;17206;5261;15298;910;2922;2657;7551;3567;10473
430460;201806;27719;75558;19938;62500;4431;15387;7819;23351;12250;38738
430461;201806;466;1206;138;439;24;76;28;82;52;158
430462;201806;255;695;159;518;20;70;43;147;63;217
430463;201806;4618;13600;3748;12028;729;2546;1809;5741;2538;8287
430465;201806;488;1330;402;1158;73;227;241;672;314;899
430466;201806;3782;9820;3063;8632;738;2174;1420;3809;2158;5983
430467;201806;499;1324;366;1088;56;191;163;469;219;660
430468;201806;1372;3540;1086;3107;159;497;616;1746;775;2243
430469;201806;589;1673;70;235;10;27;10;27;20;54
430470;201806;6201;16848;4362;13539;1383;4525;871;2740;2254;7265
430471;201806;494;1577;435;1441;80;258;189;619;269;877
430480;201806;927;2471;462;1477;66;230;77;215;143;445
430485;201806;156;437;58;197;7;24;12;38;19;62
430490;201806;411;1117;227;701;36;127;100;295;136;422
430495;201806;384;1096;239;793;29;105;92;270;121;375
430500;201806;1105;2929;803;2417;212;710;285;778;497;1488
430510;201806;22944;62872;16629;50056;3790;12466;5869;16251;9659;28717
430511;201806;332;990;117;412;16;54;14;42;30;96
430512;201806;915;2246;743;1968;189;519;228;621;417;1140
430513;201806;795;2045;389;1123;86;263;156;418;242;681
430515;201806;393;1140;281;914;47;138;132;444;179;582
430517;201806;969;3067;785;2685;135;466;389;1378;524;1844
430520;201806;1390;3766;748;2369;141;462;130;376;271;838
430530;201806;1118;2898;400;1242;77;234;84;250;161;484
430535;201806;2953;8149;2081;6454;365;1181;918;2810;1283;3991
430537;201806;352;1259;312;1127;39;129;225;822;264;951
430540;201806;590;1388;346;1001;57;161;172;488;229;649
430543;201806;622;1270;403;1014;63;139;254;673;317;812
430544;201806;652;2001;477;1579;101;354;216;684;317;1038
430545;201806;1729;4977;1328;4354;304;1067;607;2039;911;3106
430550;201806;521;1475;287;935;54;182;73;211;127;393
430558;201806;136;342;68;209;14;43;19;51;33;94
430560;201806;408;958;173;528;18;59;41;122;59;181
430570;201806;893;2174;602;1668;87;288;340;859;427;1147
430580;201806;1121;2712;701;2042;135;456;309;848;444;1304
430583;201806;191;478;37;117;2;7;5;15;7;22
430585;201806;234;574;135;375;19;56;64;153;83;209
430587;201806;184;561;144;471;29;98;61;205;90;303
430590;201806;1428;3552;1230;3226;51;163;1070;2754;1121;2917
430593;201806;14;45;13;44;1;3;8;28;9;31
430595;201806;442;1087;93;334;8;36;14;44;22;80
430597;201806;337;976;231;718;24;79;81;199;105;278
430600;201806;1830;4914;861;2648;155;484;218;626;373;1110
430605;201806;1176;3444;885;2830;133;514;336;1037;469;1551
430607;201806;678;1550;483;1251;36;107;317;837;353;944
430610;201806;6048;15618;4365;12938;1231;3956;671;2077;1902;6033
430613;201806;295;692;89;270;7;26;23;56;30;82
430620;201806;581;1584;459;1339;118;377;199;548;317;925
430630;201806;464;1342;130;427;18;62;25;67;43;129
430632;201806;591;1619;268;825;32;101;111;324;143;425
430635;201806;538;1502;403;1219;69;221;248;729;317;950
430637;201806;425;1132;341;989;49;149;198;551;247;700
430640;201806;1300;3430;697;2155;99;314;195;539;294;853
430642;201806;394;1072;269;808;46;132;127;376;173;508
430645;201806;269;593;90;243;15;43;15;41;30;84
430650;201806;1602;5030;1336;4500;347;1214;616;2103;963;3317
430655;201806;206;494;131;365;24;70;62;156;86;226
430660;201806;4924;13417;3784;11371;823;2691;1648;4901;2471;7592
430670;201806;566;1494;436;1258;48;168;267;776;315;944
430673;201806;616;1466;239;730;50;162;78;232;128;394
430675;201806;229;684;57;201;17;71;11;35;28;106
430676;201806;4259;11412;3281;9727;572;1809;1587;4634;2159;6443
430680;201806;1025;2831;614;1978;143;461;138;415;281;876
430690;201806;3309;9353;2689;8188;793;2502;716;2159;1509;4661
430692;201806;207;648;161;576;15;50;110;410;125;460
430693;201806;1061;2794;588;1802;119;425;122;322;241;747
430695;201806;536;1331;321;926;36;109;168;453;204;562
430697;201806;414;1085;299;883;55;158;145;451;200;609
430700;201806;7485;19267;3969;12664;917;3139;321;1058;1238;4197
430705;201806;345;917;180;576;23;81;71;218;94;299
430710;201806;1740;4001;1233;3225;212;631;618;1544;830;2175
430720;201806;713;1768;387;1198;80;247;134;403;214;650
430730;201806;1304;3443;832;2576;145;451;378;1187;523;1638
430740;201806;608;1726;318;1083;52;180;80;300;132;480
430745;201806;470;1324;242;778;37;140;53;152;90;292
430750;201806;1378;3671;983;2997;196;660;506;1461;702;2121
430755;201806;487;1216;308;847;20;62;168;421;188;483
430760;201806;2112;5569;1603;4729;387;1191;665;1925;1052;3116
430770;201806;6056;16293;4601;13912;801;2635;2503;7355;3304;9990
430780;201806;2224;5727;1329;4169;265;872;406;1342;671;2214
430781;201806;404;1175;256;836;62;203;51;155;113;358
430783;201806;475;1148;279;814;29;97;139;379;168;476
430786;201806;58;197;34;133;6;23;3;14;9;37
430790;201806;4424;11722;3033;9015;524;1693;1539;4330;2063;6023
430800;201806;812;2141;578;1659;53;188;339;918;392;1106
430805;201806;515;1444;301;936;31;107;157;453;188;560
430807;201806;388;967;249;723;24;81;120;324;144;405
430810;201806;903;2301;289;959;44;150;74;221;118;371
430820;201806;1309;3626;717;2421;159;551;142;467;301;1018
430825;201806;284;751;88;252;19;54;18;42;37;96
430830;201806;1572;4782;1342;4355;104;388;923;2999;1027;3387
430840;201806;894;2545;756;2297;147;446;423;1285;570;1731
430843;201806;118;296;40;127;5;15;15;43;20;58
430845;201806;333;873;228;683;77;244;48;120;125;364
430850;201806;2385;6591;1818;5508;367;1246;828;2466;1195;3712
430860;201806;950;2336;477;1438;86;311;190;505;276;816
430865;201806;529;1408;447;1266;113;342;197;518;310;860
430870;201806;677;1838;300;984;52;186;86;245;138;431
430880;201806;1235;3036;811;2349;200;605;323;919;523;1524
430885;201806;227;552;101;342;7;33;59;193;66;226
430890;201806;1198;3216;794;2421;62;279;120;335;182;614
430900;201806;2976;7089;2031;5617;251;811;1120;2906;1371;3717
430905;201806;872;2362;550;1710;109;370;164;481;273;851
430910;201806;1507;4183;999;3113;174;622;398;1114;572;1736
430912;201806;490;1374;338;1094;36;108;207;684;243;792
430915;201806;517;1610;380;1358;100;374;126;468;226;842
430920;201806;21618;57324;16867;49622;2582;8343;9616;27543;12198;35886
430925;201806;139;310;51;146;10;28;19;59;29;87
430930;201806;10128;24883;6167;18485;1487;4770;1798;5610;3285;10380
430940;201806;1308;3887;701;2324;190;644;91;254;281;898
430950;201806;768;1951;478;1400;79;271;232;603;311;874
430955;201806;193;502;62;191;12;28;7;19;19;47
430957;201806;192;671;176;635;38;141;86;306;124;447
430960;201806;1326;3240;872;2453;183;569;429;1183;612;1752
430965;201806;1706;4271;1293;3610;80;261;969;2653;1049;2914
430970;201806;387;1019;197;620;28;100;98;290;126;390
430975;201806;470;1542;375;1297;92;335;144;495;236;830
430980;201806;430;1063;235;707;44;143;89;256;133;399
430990;201806;562;1681;326;1066;51;182;146;472;197;654
430995;201806;605;1638;435;1332;69;212;209;619;278;831
431000;201806;1464;3576;628;1888;107;351;33;83;140;434
431010;201806;2266;6165;1322;4349;188;706;127;351;315;1057
431020;201806;8840;20452;5457;14984;1262;3731;1611;4055;2873;7786
431030;201806;334;943;148;527;32;110;24;91;56;201
431033;201806;2961;8015;2088;6640;558;1818;692;2360;1250;4178
431036;201806;352;773;69;205;10;22;11;34;21;56
431040;201806;919;2483;597;1858;100;365;261;745;361;1110
431041;201806;481;1155;372;986;42;118;223;579;265;697
431043;201806;441;1130;227;738;76;252;69;220;145;472
431046;201806;124;331;57;170;6;18;12;33;18;51
431050;201806;1551;3875;1090;3136;218;660;548;1562;766;2222
431053;201806;525;1560;353;1201;91;330;90;292;181;622
431055;201806;608;1572;530;1448;48;124;391;1053;439;1177
431057;201806;290;845;134;454;22;81;34;100;56;181
431060;201806;5025;14282;3874;12135;1134;3841;773;2539;1907;6380
431065;201806;514;1381;336;1052;73;229;87;272;160;501
431070;201806;508;1513;295;990;77;283;39;107;116;390
431075;201806;215;660;153;530;34;124;48;165;82;289
431080;201806;660;1898;451;1442;84;279;129;401;213;680
431085;201806;687;1912;503;1485;78;219;271;786;349;1005
431087;201806;451;1315;372;1131;23;77;266;819;289;896
431090;201806;449;1084;160;510;29;98;38;119;67;217
431100;201806;3205;7742;2361;6563;426;1282;1012;2780;1438;4062
431110;201806;1393;3380;992;2668;254;704;418;1055;672;1759
431112;201806;534;1680;458;1520;90;311;223;725;313;1036
431113;201806;397;1132;325;991;99;317;133;412;232;729
431115;201806;1178;3364;930;2911;154;529;498;1503;652;2032
431120;201806;2499;7259;1754;5709;577;2108;384;1134;961;3242
431123;201806;402;1167;255;850;52;162;123;432;175;594
431125;201806;1171;3537;844;2808;315;1022;228;821;543;1843
431127;201806;282;775;67;221;8;24;11;26;19;50
431130;201806;3396;9373;2300;7205;489;1663;838;2558;1327;4221
431140;201806;5050;12314;2771;7975;377;1200;1009;2514;1386;3714
431142;201806;492;1379;371;1161;53;162;223;702;276;864
431150;201806;996;2834;707;2246;155;507;284;880;439;1387
431160;201806;669;1924;501;1576;111;348;185;592;296;940
431162;201806;532;1281;225;707;30;114;61;180;91;294
431164;201806;228;553;49;160;11;44;3;12;14;56
431170;201806;587;1581;373;1156;101;317;97;294;198;611
431171;201806;692;1796;573;1614;86;250;337;930;423;1180
431173;201806;427;1197;321;1007;121;406;80;248;201;654
431175;201806;1022;2636;643;1950;174;530;120;368;294;898
431177;201806;751;2256;557;1900;167;609;221;743;388;1352
431179;201806;359;755;74;219;14;44;16;33;30;77
431180;201806;2229;5897;1375;4227;360;1160;241;727;601;1887
431190;201806;517;1405;272;862;36;110;56;148;92;258
431198;201806;307;974;269;900;94;332;83;300;177;632
431200;201806;395;1054;105;340;13;31;1;3;14;34
431205;201806;213;620;89;327;22;84;34;127;56;211
431210;201806;649;1709;522;1516;134;375;255;779;389;1154
431213;201806;233;696;177;596;17;67;92;310;109;377
431215;201806;361;1024;219;700;21;74;91;267;112;341
431217;201806;145;424;98;328;13;43;49;154;62;197
431220;201806;690;1873;394;1258;36;142;179;519;215;661
431225;201806;1428;3706;1096;3111;142;434;630;1781;772;2215
431230;201806;723;2159;540;1685;84;282;286;851;370;1133
431235;201806;143;385;27;83;6;16;3;8;9;24
431237;201806;393;1187;318;1052;55;206;158;503;213;709
431238;201806;29;82;24;68;6;19;7;16;13;35
431240;201806;3909;10488;3093;9148;700;2294;1284;3615;1984;5909
431242;201806;345;996;282;869;61;194;126;388;187;582
431244;201806;343;845;163;474;22;81;53;114;75;195
431245;201806;1327;3299;844;2371;118;363;395;1054;513;1417
431247;201806;223;640;114;379;19;67;26;76;45;143
431250;201806;1439;4234;1157;3778;259;824;518;1794;777;2618
431260;201806;262;755;144;505;16;75;47;153;63;228
431261;201806;264;849;213;743;26;97;85;276;111;373
431262;201806;419;1205;181;621;18;63;101;337;119;400
431265;201806;1425;3461;587;1749;94;315;161;396;255;711
431267;201806;283;792;159;478;6;23;105;290;111;313
431270;201806;2708;6440;1451;4265;392;1255;403;1188;795;2443
431275;201806;168;470;82;272;18;64;11;30;29;94
431280;201806;258;717;75;261;8;29;9;23;17;52
431290;201806;306;876;214;693;26;90;76;217;102;307
431295;201806;75;204;26;85;3;13;7;21;10;34
431300;201806;412;1046;59;202;4;16;12;36;16;52
431301;201806;243;733;59;210;7;20;4;11;11;31
431303;201806;605;1607;339;1036;45;159;123;353;168;512
431306;201806;2188;5333;1279;3749;183;623;453;1201;636;1824
431308;201806;26;89;24;82;13;47;6;19;19;66
431310;201806;608;1759;349;1126;58;197;119;387;177;584
431320;201806;657;1812;309;1053;57;197;42;139;99;336
431330;201806;1895;4678;927;2862;221;759;178;489;399;1248
431333;201806;345;933;124;381;15;39;36;110;51;149
431335;201806;36;105;22;75;6;16;3;4;9;20
431337;201806;2649;7391;1808;5844;521;1844;447;1349;968;3193
431339;201806;492;1298;336;992;76;231;156;459;232;690
431340;201806;20766;53357;14584;42557;2948;9370;4744;13076;7692;22446
431342;201806;491;1160;363;964;39;128;280;710;319;838
431344;201806;375;996;245;740;17;53;158;472;175;525
431346;201806;273;693;99;310;14;34;17;56;31;90
431349;201806;693;1915;379;1165;67;214;132;372;199;586
431350;201806;3991;11035;2990;9214;631;2081;1176;3585;1807;5666
431360;201806;615;1521;361;1064;74;226;145;405;219;631
431365;201806;1773;4751;1470;4274;154;497;1020;2960;1174;3457
431370;201806;4298;11423;3205;9508;807;2516;1279;3937;2086;6453
431380;201806;732;2150;627;1971;67;239;380;1187;447;1426
431390;201806;2460;6366;1415;4326;242;852;480;1294;722;2146
431395;201806;1285;3581;941;3013;230;759;354;1171;584;1930
431400;201806;396;1202;198;660;34;111;43;137;77;248
431402;201806;982;2331;646;1753;105;304;370;962;475;1266
431403;201806;168;467;139;418;17;72;90;246;107;318
431405;201806;4304;11732;3483;10465;441;1544;2073;6081;2514;7625
431406;201806;476;1472;383;1292;94;307;191;655;285;962
431407;201806;482;1354;316;1000;61;197;126;384;187;581
431410;201806;14967;40843;9661;30425;1911;6771;3249;9638;5160;16409
431413;201806;181;463;50;163;2;7;6;19;8;26
431415;201806;713;1841;435;1372;77;295;154;421;231;716
431417;201806;591;1399;408;1111;70;203;212;553;282;756
431420;201806;1286;3344;1062;2979;216;625;432;1276;648;1901
431430;201806;529;1412;287;898;57;197;61;151;118;348
431440;201806;23457;60305;17539;50439;4120;12631;5358;15395;9478;28026
431442;201806;107;305;59;194;9;32;6;11;15;43
431445;201806;477;1354;157;527;27;82;23;71;50;153
431446;201806;360;1048;239;778;70;235;63;193;133;428
431447;201806;604;1690;405;1268;92;295;166;522;258;817
431449;201806;718;1973;458;1380;60;193;207;616;267;809
431450;201806;2110;4677;1756;4208;137;352;1304;3013;1441;3365
431454;201806;43;134;41;130;6;21;16;61;22;82
431455;201806;629;1569;307;870;45;144;138;340;183;484
431460;201806;2943;7791;2244;6434;605;1787;688;2030;1293;3817
431470;201806;1555;4453;1139;3566;226;711;443;1392;669;2103
431475;201806;247;719;31;121;1;5;2;9;3;14
431477;201806;530;1371;310;908;45;125;145;392;190;517
431478;201806;283;737;72;217;18;58;6;16;24;74
431480;201806;3212;8293;2466;7107;383;1200;1372;3900;1755;5100
431490;201806;99718;254293;82225;227418;8062;25754;58039;155831;66101;181585
431500;201806;491;1316;367;1067;85;228;182;527;267;755
431505;201806;433;1051;269;774;25;69;149;424;174;493
431507;201806;353;840;146;416;33;109;53;127;86;236
431510;201806;1599;4362;1149;3462;232;734;441;1338;673;2072
431513;201806;301;725;149;425;14;36;94;267;108;303
431514;201806;90;257;49;172;10;42;18;56;28;98
431515;201806;570;1507;375;1117;76;247;174;484;250;731
431517;201806;78;233;57;176;9;23;14;43;23;66
431520;201806;442;1091;168;546;33;120;52;148;85;268
431530;201806;4052;9144;2474;6823;695;1960;362;1028;1057;2988
431531;201806;199;556;135;423;17;55;53;156;70;211
431532;201806;483;1273;342;991;78;235;135;393;213;628
431535;201806;282;709;103;324;21;72;24;67;45;139
431540;201806;1835;6083;1701;5854;92;373;1310;4509;1402;4882
431545;201806;390;1044;76;236;5;21;21;55;26;76
431550;201806;1982;5518;1617;4796;322;1006;672;1910;994;2916
431555;201806;685;1622;432;1180;43;125;251;668;294;793
431560;201806;20221;54462;13747;43284;2925;9841;3627;12193;6552;22034
431570;201806;5064;12463;3950;10926;643;1937;2304;6207;2947;8144
431575;201806;176;542;136;450;18;61;22;57;40;118
431580;201806;551;1479;289;937;41;159;115;345;156;504
431590;201806;780;2116;551;1638;106;319;194;574;300;893
431595;201806;361;1033;239;756;39;116;107;324;146;440
431600;201806;1552;4019;1126;3324;296;954;323;943;619;1897
431610;201806;1360;3727;957;2910;125;354;460;1457;585;1811
431620;201806;537;1478;234;716;50;161;100;277;150;438
431630;201806;1246;3313;602;1914;167;555;152;427;319;982
431640;201806;6031;16079;5398;15154;780;2251;3638;10288;4418;12539
431642;201806;501;1301;322;935;33;96;154;424;187;520
431643;201806;354;911;158;459;23;61;44;116;67;177
431645;201806;1703;4438;1361;3869;152;463;915;2597;1067;3060
431647;201806;184;492;105;319;14;54;23;58;37;112
431650;201806;223;662;158;521;25;94;47;143;72;237
431660;201806;911;2484;504;1653;81;292;113;315;194;607
431670;201806;1192;2991;832;2355;143;457;388;1030;531;1487
431673;201806;246;665;91;338;17;51;10;32;27;83
431675;201806;698;1774;138;453;9;35;42;116;51;151
431680;201806;7755;21092;5777;17215;1508;4660;2002;5966;3510;10626
431690;201806;19774;52953;14331;42780;3598;11265;4483;13759;8081;25024
431695;201806;157;415;100;309;19;64;41;95;60;159
431697;201806;466;1177;369;1011;58;155;212;600;270;755
431700;201806;1449;3896;1223;3489;192;541;680;1924;872;2465
431710;201806;11489;30778;8903;26823;2312;7277;3345;10755;5657;18032
431720;201806;6215;16587;4081;12240;1006;3172;702;1937;1708;5109
431725;201806;28;81;18;61;3;12;6;19;9;31
431730;201806;3578;9540;2526;7753;680;2262;728;2339;1408;4601
431740;201806;4838;12515;3402;9961;1021;3362;628;1569;1649;4931
431750;201806;7328;20311;6235;18574;1141;3686;3198;9636;4339;13322
431755;201806;345;941;70;248;11;45;11;39;22;84
431760;201806;5524;13139;3565;9899;408;1342;2073;5410;2481;6752
431770;201806;1820;4592;1457;4066;163;503;1004;2741;1167;3244
431775;201806;210;566;101;319;21;74;13;34;34;108
431780;201806;1922;5169;1336;4006;251;784;446;1299;697;2083
431790;201806;967;2739;704;2183;139;455;262;766;401;1221
431795;201806;269;708;141;426;29;88;35;99;64;187
431800;201806;7457;20376;5405;16704;1674;5683;639;2022;2313;7705
431805;201806;297;697;92;293;6;23;39;112;45;135
431810;201806;3257;8120;2068;5856;375;1191;849;2249;1224;3440
431820;201806;2232;6503;1853;5816;452;1467;718;2269;1170;3736
431830;201806;9446;22045;7138;18639;1674;4819;2695;7005;4369;11824
431840;201806;2462;6999;2033;6241;410;1302;1079;3309;1489;4611
431842;201806;718;1800;252;779;33;114;69;191;102;305
431843;201806;325;911;255;764;37;123;109;306;146;429
431844;201806;258;690;72;236;19;71;15;37;34;108
431845;201806;492;1338;340;1015;20;61;211;624;231;685
431846;201806;251;733;219;685;12;48;181;555;193;603
431848;201806;196;509;98;306;6;21;15;30;21;51
431849;201806;435;1045;64;194;7;20;7;15;14;35
431850;201806;4090;11654;3258;9889;740;2412;994;2917;1734;5329
431860;201806;717;1855;448;1308;88;255;212;588;300;843
431861;201806;125;342;56;191;9;32;17;49;26;81
431862;201806;446;1463;364;1306;84;328;160;557;244;885
431870;201806;17509;48464;14090;42404;2493;8458;6651;19200;9144;27658
431880;201806;3673;10322;2893;8853;561;1922;1198;3508;1759;5430
431890;201806;4481;11904;2872;8725;848;2815;395;1254;1243;4069
431900;201806;1056;2822;632;1953;137;477;286;828;423;1305
431910;201806;794;1971;298;891;41;121;80;213;121;334
431912;201806;434;1276;360;1130;82;265;196;614;278;879
431915;201806;969;2671;774;2330;93;306;491;1434;584;1740
431920;201806;1197;3139;1014;2842;53;160;837;2326;890;2486
431930;201806;819;2407;589;1986;143;425;290;1048;433;1473
431935;201806;76;225;51;171;14;45;10;29;24;74
431936;201806;301;914;178;614;40;142;45;155;85;297
431937;201806;183;492;114;345;25;84;28;67;53;151
431940;201806;2284;5998;1430;4278;281;941;555;1560;836;2501
431950;201806;1708;4822;1427;4347;331;1040;645;1960;976;3000
431960;201806;2688;7276;2168;6240;574;1725;603;1690;1177;3415
431970;201806;392;1055;174;572;37;119;34;97;71;216
431971;201806;77;207;44;145;6;18;8;22;14;40
431973;201806;474;1538;390;1365;34;108;280;1002;314;1110
431975;201806;110;245;25;83;4;15;4;8;8;23
431980;201806;1140;3156;873;2664;189;615;357;1042;546;1657
431990;201806;5794;14912;3781;11724;685;2342;1249;3798;1934;6140
432000;201806;10347;26862;7787;22663;2113;6364;3077;8918;5190;15282
432010;201806;1959;5314;1514;4489;222;712;798;2262;1020;2974
432020;201806;1937;4769;1334;3763;328;987;593;1570;921;2557
432023;201806;519;1318;276;815;45;156;129;332;174;488
432026;201806;1006;2980;744;2432;178;571;347;1126;525;1697
432030;201806;349;942;211;649;37;117;109;322;146;439
432032;201806;440;1175;292;870;27;90;147;400;174;490
432035;201806;785;2309;687;2145;206;690;236;736;442;1426
432040;201806;1074;2528;424;1307;69;240;123;364;192;604
432045;201806;239;661;123;420;30;103;27;100;57;203
432050;201806;523;1408;406;1184;116;342;123;359;239;701
432055;201806;783;2094;497;1538;140;469;159;458;299;927
432057;201806;291;749;212;589;42;96;89;236;131;332
432060;201806;476;1189;146;486;27;107;52;145;79;252
432065;201806;219;621;163;493;36;109;57;172;93;281
432067;201806;786;2331;626;1972;87;280;381;1172;468;1452
432070;201806;2024;5447;1232;3798;270;893;247;694;517;1587
432080;201806;3709;9860;3003;8662;760;2457;1174;3238;1934;5695
432085;201806;389;990;248;766;83;241;84;278;167;519
432090;201806;1328;3646;969;2950;226;738;394;1142;620;1880
432100;201806;1114;3074;486;1622;80;289;37;89;117;378
432110;201806;2293;6518;1561;5078;359;1359;98;310;457;1669
432120;201806;3094;9021;2532;8010;784;2688;549;1679;1333;4367
432130;201806;2571;6990;2178;6437;791;2479;750;2227;1541;4706
432132;201806;263;732;126;425;25;90;42;132;67;222
432135;201806;901;2376;608;1793;70;231;401;1151;471;1382
432140;201806;1599;5006;1203;4204;223;803;591;2127;814;2930
432143;201806;1353;3787;1073;3332;121;428;634;1953;755;2381
432145;201806;1375;3943;826;2675;133;474;159;436;292;910
432146;201806;110;337;78;266;24;86;16;48;40;134
432147;201806;387;1250;299;1064;80;289;62;220;142;509
432149;201806;378;1014;226;667;26;79;99;277;125;356
432150;201806;3025;8381;2234;6851;553;1919;628;1854;1181;3773
432160;201806;4518;13212;3630;11716;1057;3617;1050;3365;2107;6982
432162;201806;339;798;45;133;5;12;6;18;11;30
432163;201806;208;565;41;132;4;14;1;2;5;16
432166;201806;547;1638;428;1376;74;257;133;380;207;637
432170;201806;1331;3806;862;2856;189;692;212;662;401;1354
432180;201806;2495;6524;1359;4182;276;914;366;1014;642;1928
432183;201806;382;1159;248;833;64;239;56;178;120;417
432185;201806;853;2276;510;1589;32;113;292;863;324;976
432190;201806;2178;5788;1401;4237;334;1123;486;1351;820;2474
432195;201806;1039;2690;669;2022;188;535;214;673;402;1208
432200;201806;3026;8434;2201;6948;482;1577;944;3056;1426;4633
432210;201806;383;1059;260;826;48;166;102;307;150;473
432215;201806;685;2073;599;1930;76;237;392;1288;468;1525
432218;201806;254;653;133;377;20;58;51;132;71;190
432220;201806;3931;9832;2940;8195;423;1353;1665;4397;2088;5750
432225;201806;108;315;78;254;18;57;31;101;49;158
432230;201806;762;1985;429;1288;67;216;154;414;221;630
432232;201806;459;1194;339;987;66;216;148;427;214;643
432234;201806;310;829;139;427;34;100;22;57;56;157
432235;201806;107;307;39;133;5;19;9;28;14;47
432237;201806;385;1023;338;940;15;42;232;611;247;653
432240;201806;13713;38546;10755;34187;1007;3610;6457;21452;7464;25062
432250;201806;4239;13926;3674;12778;1121;4049;1224;4377;2345;8426
432252;201806;452;1181;289;845;54;175;117;315;171;490
432253;201806;1173;3657;642;2232;150;575;33;102;183;677
432254;201806;966;2448;197;652;32;120;17;51;49;171
432255;201806;163;421;77;248;8;27;32;92;40;119
432260;201806;5586;14465;4027;11666;1080;3251;1165;3428;2245;6679
432270;201806;2078;6181;1705;5417;533;1814;255;786;788;2600
432280;201806;1191;3126;621;1940;92;308;217;646;309;954
432285;201806;186;586;15;56;0;0;2;5;2;5
432290;201806;395;1193;223;768;63;214;46;139;109;353
432300;201806;25295;68510;19893;59710;3054;10079;11436;33483;14490;43562
432310;201806;705;2030;529;1703;86;299;306;962;392;1261
432320;201806;231;564;76;228;9;37;20;53;29;90
432330;201806;268;686;91;305;22;70;15;52;37;122
432335;201806;177;504;64;239;14;56;9;31;23;87
432340;201806;328;791;150;454;26;92;47;129;73;221
432345;201806;580;1461;529;1394;39;144;404;1019;443;1163
432350;201806;342;925;168;559;29;95;51;159;80;254
432360;201806;213;635;41;137;5;25;7;21;12;46
432370;201806;338;905;228;684;21;72;137;399;158;471
432375;201806;539;1398;412;1169;58;157;232;649;290;806
432377;201806;239;769;38;133;5;16;9;24;14;40
432380;201806;1463;4253;914;3084;191;729;393;1250;584;1979
500020;201806;2165;6016;1648;5157;387;1326;689;2090;1076;3416
500025;201806;1305;3038;802;2174;73;201;468;1236;541;1437
500060;201806;6370;18691;4836;15929;713;2379;2781;9651;3494;12030
500070;201806;4138;11288;3013;9301;634;2015;1247;4022;1881;6037
500080;201806;1176;3325;860;2751;200;705;341;1046;541;1751
500085;201806;2053;5135;1392;4117;256;816;710;2038;966;2854
500090;201806;1984;5531;1359;4391;248;836;512;1715;760;2551
500100;201806;3359;8941;2566;7602;362;1185;1231;3464;1593;4649
500110;201806;7363;20503;5041;16673;1053;3728;1642;6104;2695;9832
500124;201806;1961;6227;1672;5725;360;1208;874;3215;1234;4423
500150;201806;1290;3072;801;2289;175;526;255;655;430;1181
500190;201806;4740;11695;3469;9982;729;2208;1526;4546;2255;6754
500200;201806;2238;5524;1664;4518;218;638;947;2419;1165;3057
500210;201806;4551;12589;3510;11021;890;2875;1497;4767;2387;7642
500215;201806;1324;3898;961;3183;108;401;460;1470;568;1871
500220;201806;2811;8102;2082;6804;349;1231;810;2633;1159;3864
500230;201806;2358;5820;1705;4811;228;670;992;2762;1220;3432
500240;201806;3561;11280;2500;8965;451;1869;641;2393;1092;4262
500260;201806;3135;6981;1894;5177;237;641;949;2537;1186;3178
500270;201806;123652;308647;73542;217814;15061;47910;20768;58940;35829;106850
500280;201806;1314;3387;953;2830;110;362;589;1705;699;2067
500290;201806;3990;9145;2182;6389;355;1134;736;2035;1091;3169
500295;201806;2903;7651;1664;5138;267;906;557;1503;824;2409
500310;201806;918;2139;661;1796;117;286;345;985;462;1271
500315;201806;3334;9975;2693;8907;350;1141;1700;5890;2050;7031
500320;201806;17990;53657;13035;44682;3472;12776;3799;13740;7271;26516
500325;201806;4015;9694;2727;7749;353;1087;1477;4187;1830;5274
500330;201806;6886;16623;4436;12585;409;1299;2305;6653;2714;7952
500345;201806;1910;4806;1306;3895;347;1047;436;1282;783;2329
500348;201806;2706;7021;2097;6032;249;753;1241;3609;1490;4362
500350;201806;1255;3556;656;2168;81;293;230;773;311;1066
500370;201806;21488;60091;14962;48568;2618;9631;6144;19880;8762;29511
500375;201806;2482;6900;1752;5328;364;1220;549;1620;913;2840
500380;201806;3544;9013;2499;7320;658;2025;876;2618;1534;4643
500390;201806;520;1138;313;839;43;126;156;400;199;526
500400;201806;1160;3309;806;2525;181;602;222;664;403;1266
500410;201806;2305;6232;1760;5366;266;796;1004;3151;1270;3947
500430;201806;2615;6894;1775;5575;311;1095;646;2154;957;3249
500440;201806;1273;3094;759;2227;113;335;272;838;385;1173
500450;201806;1327;3490;737;2349;139;446;119;336;258;782
500460;201806;3813;10730;2427;7960;487;1765;550;1852;1037;3617
500470;201806;2543;7148;1614;5148;474;1649;293;803;767;2452
500480;201806;2177;6462;1916;6109;136;412;1444;4890;1580;5302
500490;201806;869;2232;542;1705;137;497;163;509;300;1006
500500;201806;4078;11334;2822;9409;941;3585;664;2289;1605;5874
500510;201806;748;1905;461;1371;32;106;264;749;296;855
500515;201806;1959;4919;1594;4405;131;348;1134;3231;1265;3579
500520;201806;3159;10689;2596;9547;679;2689;1058;3879;1737;6568
500525;201806;974;2988;786;2680;111;438;422;1452;533;1890
500540;201806;4866;12873;2810;9140;741;2849;265;807;1006;3656
500560;201806;5200;15571;4351;14345;327;1185;3248;10861;3575;12046
500568;201806;4276;9832;2626;7366;623;1979;742;2034;1365;4013
500570;201806;7266;18029;4170;12420;967;3116;852;2370;1819;5486
500580;201806;3197;8900;2475;7656;441;1441;1345;4105;1786;5546
500600;201806;3355;8583;2187;6638;439;1435;754;2282;1193;3717
500620;201806;7609;21029;5212;16295;1017;3326;2004;6248;3021;9574
500625;201806;499;1430;276;918;61;222;96;311;157;533
500627;201806;742;1963;457;1424;83;254;117;371;200;625
500630;201806;6027;15310;3749;11353;854;2748;1052;3249;1906;5997
500635;201806;2595;9126;2096;8355;167;698;1497;6363;1664;7061
500640;201806;1721;3991;1133;3125;50;171;776;2062;826;2233
500660;201806;17471;49375;12577;41382;4142;15126;2742;9145;6884;24271
500690;201806;2325;6667;1645;5539;700;2629;120;350;820;2979
500710;201806;3065;8793;2355;7455;639;2142;618;1909;1257;4051
500720;201806;5447;13962;3267;10305;838;2911;655;2024;1493;4935
500730;201806;921;2503;594;1871;103;307;220;716;323;1023
500740;201806;4673;11765;3398;9534;327;1048;1832;5195;2159;6243
500750;201806;967;2563;721;2120;106;344;304;825;410;1169
500755;201806;991;2790;611;2035;117;409;80;233;197;642
500769;201806;5257;13529;2676;8219;481;1633;397;916;878;2549
500770;201806;1602;4433;1000;3276;170;585;308;1012;478;1597
500780;201806;1308;3419;869;2608;191;591;213;612;404;1203
500790;201806;8433;22430;6777;19782;1249;3907;3631;10690;4880;14597
500793;201806;1954;5318;1368;4285;441;1435;244;667;685;2102
500795;201806;2411;6615;1989;6045;157;422;1572;5017;1729;5439
500797;201806;741;2026;505;1566;115;369;168;503;283;872
500800;201806;2865;7117;1948;5731;658;2182;320;996;978;3178
500830;201806;18474;47716;12650;36892;1947;6153;5695;15868;7642;22021
500840;201806;1138;3074;738;2281;93;305;296;850;389;1155
510010;201806;1599;4116;1139;3436;199;587;619;1919;818;2506
510020;201806;3733;9852;1970;6173;420;1360;364;1009;784;2369
510025;201806;7028;19221;4465;14295;799;2820;1300;3900;2099;6720
510030;201806;2078;4884;1410;3927;339;937;508;1489;847;2426
510035;201806;1146;3015;700;2298;112;363;391;1371;503;1734
510040;201806;2173;5171;1563;4302;132;368;963;2655;1095;3023
510050;201806;1884;4786;1272;3791;277;936;643;1758;920;2694
510060;201806;1446;3819;1062;3183;159;502;508;1485;667;1987
510080;201806;1169;3360;812;2694;226;804;198;587;424;1391
510100;201806;692;1707;455;1271;63;189;218;581;281;770
510120;201806;287;557;170;416;8;23;119;289;127;312
510125;201806;2433;6138;1824;5183;278;1001;761;1981;1039;2982
510130;201806;1496;4012;1119;3373;267;847;309;932;576;1779
510140;201806;2919;8371;2115;7286;781;3031;631;2002;1412;5033
510160;201806;1351;4115;1134;3810;212;733;734;2485;946;3218
510170;201806;4689;13231;3515;11258;806;2718;1454;4610;2260;7328
510180;201806;12891;31728;8046;23781;2025;6465;2282;7508;4307;13973
510185;201806;1768;4703;1192;3867;408;1333;426;1668;834;3001
510190;201806;2339;6426;1551;5176;462;1712;448;1537;910;3249
510250;201806;14138;39282;11803;35981;2531;8091;6227;19666;8758;27757
510260;201806;2127;8705;1718;7911;262;1237;989;5102;1251;6339
510263;201806;3279;9285;2100;6957;434;1543;283;886;717;2429
510267;201806;5041;14820;3197;10663;683;2393;564;1890;1247;4283
510268;201806;1427;3712;966;2864;139;424;505;1447;644;1871
510269;201806;1102;3186;703;2378;195;722;206;654;401;1376
510270;201806;2839;8819;2127;7459;431;1597;762;2637;1193;4234
510279;201806;1803;5134;1321;4204;258;889;626;1906;884;2795
510285;201806;1124;3145;806;2590;236;814;195;596;431;1410
510300;201806;3563;9441;2742;8321;313;908;1774;5629;2087;6537
510305;201806;1358;4085;945;3266;203;727;274;1021;477;1748
510310;201806;814;2201;592;1820;196;625;188;606;384;1231
510320;201806;3797;10179;2813;8436;662;2169;754;2225;1416;4394
510325;201806;4694;14299;3751;12801;1023;3634;1647;5849;2670;9483
510330;201806;2943;9135;2074;7536;438;1666;708;2870;1146;4536
510335;201806;4852;14130;3649;12451;445;1636;2092;7539;2537;9175
510336;201806;532;1562;386;1305;70;227;175;635;245;862
510337;201806;1749;5379;1228;4412;487;1874;198;730;685;2604
510340;201806;80350;194803;50758;148526;15135;50931;10616;29244;25751;80175
510343;201806;1032;2986;713;2331;139;481;235;731;374;1212
510345;201806;1360;4035;1014;3346;177;579;411;1332;588;1911
510350;201806;2890;7797;1910;6183;458;1559;714;2352;1172;3911
510360;201806;1791;4073;1166;3275;59;209;856;2436;915;2645
510370;201806;1656;5116;1230;4348;207;785;653;2386;860;3171
510380;201806;510;1393;276;926;74;275;34;106;108;381
510385;201806;1022;3735;746;3128;84;392;429;1919;513;2311
510390;201806;1082;3360;857;3021;230;803;387;1490;617;2293
510395;201806;757;1761;510;1389;43;120;267;788;310;908
510410;201806;4162;12580;3209;10769;782;2684;1506;5293;2288;7977
510420;201806;2176;5099;1554;4198;168;531;870;2326;1038;2857
510450;201806;579;1488;345;1050;84;275;55;165;139;440
510452;201806;677;2026;464;1581;87;294;215;741;302;1035
510454;201806;824;2426;620;2056;68;227;359;1245;427;1472
510455;201806;923;2746;665;2171;105;394;247;737;352;1131
510460;201806;2056;5274;1466;4390;154;536;829;2357;983;2893
510480;201806;4438;11182;2974;8389;507;1522;1235;3306;1742;4828
510490;201806;1581;4686;1246;4212;269;914;618;2130;887;3044
510500;201806;1424;3969;905;2993;160;608;349;1130;509;1738
510510;201806;3182;10128;2479;8718;810;3110;556;2079;1366;5189
510515;201806;5802;16076;3762;12023;837;2921;922;2673;1759;5594
510517;201806;1305;3818;1015;3286;279;995;168;479;447;1474
510520;201806;2105;4453;1298;3450;63;184;737;2071;800;2255
510523;201806;970;2644;758;2278;115;339;456;1387;571;1726
510525;201806;5481;16101;4195;13456;756;2637;1666;4868;2422;7505
510530;201806;544;1401;400;1193;25;111;276;784;301;895
510550;201806;2809;8677;2045;7232;501;1822;715;2581;1216;4403
510558;201806;1969;5496;1581;4933;151;529;861;2878;1012;3407
510560;201806;1628;4855;957;3549;217;882;223;885;440;1767
510562;201806;5387;14886;3886;12027;879;2917;1331;4232;2210;7149
510590;201806;3165;8089;2305;6945;417;1214;1357;4297;1774;5511
510600;201806;1548;3763;949;2779;220;640;332;990;552;1630
510610;201806;2652;6901;1921;5876;185;651;1187;3563;1372;4214
510615;201806;2007;5728;1519;4867;301;976;805;2651;1106;3627
510617;201806;911;2667;700;2332;100;321;463;1640;563;1961
510618;201806;1337;3723;950;2985;191;703;455;1347;646;2050
510619;201806;758;2020;422;1395;72;260;77;249;149;509
510620;201806;1493;3470;710;2203;154;547;88;240;242;787
510621;201806;1239;3586;837;2795;176;631;240;787;416;1418
510622;201806;3974;11845;2851;9257;963;3428;478;1402;1441;4830
510623;201806;2932;7802;2125;6439;441;1580;616;1780;1057;3360
510624;201806;1602;4329;710;2456;103;405;99;280;202;685
510625;201806;2266;5848;1360;4193;316;1111;249;756;565;1867
510626;201806;1647;4040;982;3026;278;956;202;654;480;1610
510627;201806;655;1742;393;1216;95;305;89;287;184;592
510628;201806;1615;3721;1049;2954;176;479;623;1833;799;2312
510629;201806;1628;5026;1252;4242;300;1070;397;1392;697;2462
510630;201806;3143;9409;1920;6958;442;1753;299;1147;741;2900
510631;201806;472;1221;345;1022;18;46;237;712;255;758
510637;201806;3235;8412;2405;7042;703;2286;654;1856;1357;4142
510642;201806;5012;15373;4016;13851;1120;4179;1545;5527;2665;9706
510645;201806;930;2038;540;1513;153;430;155;434;308;864
510650;201806;6608;19195;5572;18010;805;2578;3991;13500;4796;16078
510665;201806;1892;4542;1102;3164;201;632;396;1162;597;1794
510670;201806;395;845;219;597;24;82;113;311;137;393
510675;201806;6150;17905;4472;14727;1263;4566;777;2485;2040;7051
510677;201806;2123;5622;1505;4684;229;763;786;2425;1015;3188
510680;201806;669;1904;443;1459;97;322;59;196;156;518
510682;201806;1732;5524;1286;4681;385;1512;255;938;640;2450
510685;201806;766;2204;581;1842;81;259;270;820;351;1079
510700;201806;3621;9530;2522;7862;490;1609;1360;4334;1850;5943
510704;201806;10097;25588;6720;19489;1319;4128;2107;5852;3426;9980
510706;201806;1888;5677;1296;4725;253;1036;634;2432;887;3468
510710;201806;2654;7165;1821;5504;363;1129;621;1776;984;2905
510715;201806;734;1747;500;1368;60;162;206;566;266;728
510718;201806;2607;5740;1421;4311;578;1805;240;986;818;2791
510719;201806;398;881;241;667;39;119;129;344;168;463
510720;201806;1009;2558;673;2006;181;582;165;467;346;1049
510724;201806;722;2040;501;1639;95;350;221;678;316;1028
510726;201806;877;1756;507;1251;68;169;295;729;363;898
510729;201806;667;1619;315;952;49;167;72;212;121;379
510730;201806;3070;7980;2103;6347;470;1490;751;2278;1221;3768
510735;201806;1022;3071;773;2717;86;333;520;1850;606;2183
510740;201806;1266;3428;893;2783;103;285;541;1834;644;2119
510757;201806;629;2041;507;1821;201;768;157;538;358;1306
510760;201806;36591;84845;21827;62191;6091;19558;4721;12284;10812;31842
510770;201806;4143;9871;3072;8586;296;763;2076;6122;2372;6885
510774;201806;373;1036;276;842;53;142;132;436;185;578
510775;201806;617;2083;446;1787;84;327;116;672;200;999
510776;201806;477;1336;340;1044;83;257;126;380;209;637
510777;201806;1701;4666;1216;3999;141;534;845;2759;986;3293
510779;201806;600;1717;472;1505;62;170;282;948;344;1118
510780;201806;3526;9950;2747;8712;689;2219;1072;3746;1761;5965
510785;201806;2078;5552;1215;3939;286;1015;175;605;461;1620
510787;201806;2470;7077;1746;5666;695;2352;147;454;842;2806
510788;201806;701;1698;485;1368;87;242;180;603;267;845
510790;201806;14804;40982;9288;30092;2067;7635;1253;3539;3320;11174
510792;201806;8896;24413;5667;18306;1133;3979;1236;3864;2369;7843
510794;201806;1248;3592;830;2800;253;939;174;523;427;1462
510795;201806;7338;20959;5202;16977;1341;4802;1145;3757;2486;8559
510800;201806;1598;4264;1137;3538;259;840;390;1171;649;2011
510805;201806;1820;5002;1209;3864;239;831;439;1255;678;2086
510810;201806;676;1509;453;1200;114;323;214;544;328;867
510820;201806;838;1680;459;1190;55;178;196;485;251;663
510830;201806;750;1984;543;1682;94;284;300;974;394;1258
510835;201806;585;1568;402;1264;57;191;189;577;246;768
510840;201806;43271;103161;32374;88993;6638;17819;16320;47854;22958;65673
510850;201806;1814;4585;1041;3282;317;1120;133;339;450;1459
510860;201806;2675;7586;1751;5924;559;2151;173;563;732;2714
510880;201806;625;1912;494;1662;127;453;210;722;337;1175
510885;201806;597;1573;417;1306;71;247;136;407;207;654
510890;201806;714;2148;572;1937;120;445;277;945;397;1390
510895;201806;1208;3305;837;2639;209;738;293;845;502;1583
520005;201806;2015;5677;1632;5185;457;1342;733;2658;1190;4000
520010;201806;2219;6807;1575;5448;471;1816;304;919;775;2735
520013;201806;2717;7498;1954;5971;460;1480;505;1628;965;3108
520015;201806;542;1431;407;1241;114;361;112;377;226;738
520017;201806;1126;3122;869;2706;175;597;445;1354;620;1951
520020;201806;384;967;304;855;65;208;165;441;230;649
520025;201806;32267;92983;28435;87865;3440;11219;19937;61584;23377;72803
520030;201806;5095;14293;4059;12633;514;1741;2384;7407;2898;9148
520050;201806;451;1104;275;769;21;49;154;457;175;506
520055;201806;1085;3004;819;2478;70;218;479;1425;549;1643
520060;201806;1456;4280;1130;3660;268;952;295;942;563;1894
520080;201806;1891;5070;1465;4480;246;736;690;2313;936;3049
520082;201806;1047;2621;872;2324;109;233;486;1361;595;1594
520085;201806;712;2068;573;1828;121;366;175;540;296;906
520090;201806;867;1863;612;1560;99;225;388;1047;487;1272
520110;201806;39416;110315;28270;92082;9487;35006;1831;5351;11318;40357
520120;201806;201;513;112;351;12;46;40;123;52;169
520130;201806;3676;9653;3074;8666;594;1772;1489;4288;2083;6060
520140;201806;36185;106918;28139;92249;10020;35635;2979;9966;12999;45601
520145;201806;490;1251;343;1016;64;203;138;386;202;589
520150;201806;566;1423;437;1257;80;223;231;680;311;903
520160;201806;875;2136;634;1767;102;289;286;793;388;1082
520170;201806;5184;10913;3744;9280;224;568;3061;7638;3285;8206
520180;201806;2033;5806;1674;5231;417;1394;694;2127;1111;3521
520215;201806;2030;4979;1470;4084;312;964;639;1723;951;2687
520235;201806;641;1565;421;1217;51;161;160;439;211;600
520250;201806;1573;4130;1118;3423;294;986;214;681;508;1667
520260;201806;858;2079;516;1472;87;272;191;535;278;807
520280;201806;647;1737;511;1484;153;430;191;608;344;1038
520310;201806;1271;2921;839;2259;212;590;305;873;517;1463
520320;201806;1908;5429;1500;4730;162;541;796;2551;958;3092
520330;201806;3306;9647;2383;8031;468;1792;937;3104;1405;4896
520340;201806;2234;5225;1525;4218;161;397;1002;2893;1163;3290
520350;201806;3077;7866;2224;6385;682;2087;680;1870;1362;3957
520355;201806;1773;5004;1362;4247;322;1111;521;1569;843;2680
520357;201806;829;2099;645;1811;34;104;462;1302;496;1406
520360;201806;726;1968;556;1669;164;499;142;448;306;947
520380;201806;1339;3466;800;2401;93;317;390;1082;483;1399
520390;201806;958;2206;557;1676;170;546;144;448;314;994
520393;201806;560;1352;392;1084;46;139;189;488;235;627
520396;201806;798;2284;670;2044;89;278;434;1305;523;1583
520400;201806;1626;4302;1299;3827;223;687;785;2318;1008;3005
520410;201806;1659;3729;1060;2871;135;378;621;1674;756;2052
520420;201806;386;975;287;778;25;80;200;509;225;589
520425;201806;1445;3568;963;2751;251;733;367;1056;618;1789
520430;201806;2219;5393;1165;3608;200;723;54;151;254;874
520440;201806;3434;8508;2144;6202;551;1695;520;1453;1071;3148
520450;201806;11615;29763;7773;23353;2383;7748;590;1814;2973;9562
520455;201806;681;1937;505;1652;154;530;121;390;275;920
520460;201806;931;2491;789;2290;107;287;579;1718;686;2005
520465;201806;845;2274;694;2037;111;356;431;1211;542;1567
520470;201806;1918;5608;1635;5220;385;1206;940;3219;1325;4425
520480;201806;854;2467;557;1911;144;525;106;359;250;884
520485;201806;1564;4406;1280;4017;143;493;866;2672;1009;3165
520490;201806;3919;11413;3023;10007;849;2806;1317;4551;2166;7357
520495;201806;1473;3522;1157;3101;75;211;871;2395;946;2606
520500;201806;1420;3847;1011;3107;236;817;372;1119;608;1936
520505;201806;725;1807;522;1525;99;281;269;778;368;1059
520510;201806;7085;19086;5061;15984;1174;4103;1279;4194;2453;8297
520520;201806;1098;2898;816;2464;233;686;228;773;461;1459
520530;201806;2033;6281;1517;5336;536;1924;360;1482;896;3406
520540;201806;2981;8035;1867;5777;420;1341;376;1188;796;2529
520545;201806;1002;2761;761;2357;131;419;270;833;401;1252
520547;201806;755;2232;588;1900;165;544;231;735;396;1279
520549;201806;11239;32209;9154;28855;1981;6377;4737;15192;6718;21569
520551;201806;4232;12144;3634;11260;508;1815;2427;7366;2935;9181
520552;201806;785;2216;705;2115;106;288;501;1574;607;1862
520570;201806;646;1608;431;1268;113;340;141;426;254;766
520580;201806;2861;6493;1998;5396;212;615;1276;3464;1488;4079
520590;201806;1314;3668;943;2972;237;764;159;520;396;1284
520620;201806;8282;22960;6702;20713;1741;5560;2938;9244;4679;14804
520630;201806;994;2500;617;1859;104;308;158;464;262;772
520640;201806;2614;6735;2022;5722;499;1423;759;2216;1258;3639
520650;201806;919;2283;629;1790;109;313;331;958;440;1271
520660;201806;452;1099;243;727;56;180;42;141;98;321
520670;201806;982;2801;818;2560;81;265;557;1707;638;1972
520680;201806;752;1919;548;1592;103;288;258;774;361;1062
520690;201806;378;901;248;709;69;195;75;231;144;426
520710;201806;565;1401;364;1040;14;42;223;617;237;659
520725;201806;1652;4035;1165;3230;132;407;745;2011;877;2418
520735;201806;823;2135;561;1659;112;333;179;544;291;877
520740;201806;1943;4723;1531;4202;252;669;934;2651;1186;3320
520750;201806;681;1707;498;1434;92;245;225;685;317;930
520753;201806;1478;3889;1193;3366;202;592;547;1504;749;2096
520760;201806;1197;2653;1057;2476;92;185;854;2094;946;2279
520780;201806;1699;4174;1260;3530;137;405;660;1799;797;2204
520790;201806;3470;8262;2421;6672;226;625;1481;4330;1707;4955
520800;201806;15541;41698;12583;37722;2432;7236;7320;23104;9752;30340
520810;201806;1300;2832;937;2419;162;454;526;1409;688;1863
520815;201806;652;1978;474;1601;129;464;74;281;203;745
520830;201806;1789;4157;1316;3607;71;143;1034;2844;1105;2987
520840;201806;2236;6313;1824;5750;771;2536;476;1613;1247;4149
520850;201806;681;1868;467;1527;160;592;92;294;252;886
520860;201806;6305;18033;4863;15662;1136;3953;1672;5450;2808;9403
520870;201806;92191;228983;64754;186966;17660;55160;16991;47785;34651;102945
520880;201806;6262;18141;4940;15969;1502;5176;1277;4097;2779;9273
520890;201806;3978;10243;2841;8376;613;2007;1153;3319;1766;5326
520910;201806;4165;10940;2718;8398;783;2645;483;1509;1266;4154
520915;201806;647;1858;459;1470;74;268;170;520;244;788
520920;201806;4261;10364;2872;8406;431;1371;1423;4201;1854;5572
520929;201806;693;1765;519;1457;109;258;240;755;349;1013
520940;201806;1127;3030;877;2675;57;194;655;1993;712;2187
520945;201806;544;1256;418;1046;29;60;290;715;319;775
520960;201806;1050;2816;824;2434;126;408;455;1287;581;1695
520970;201806;2493;7402;2081;6645;583;2029;487;1603;1070;3632
520980;201806;778;2069;614;1814;135;440;242;685;377;1125
520990;201806;2924;8902;2584;8355;366;1197;1547;5165;1913;6362
520993;201806;1012;2473;691;1942;30;95;494;1365;524;1460
520995;201806;2232;5915;1794;5303;436;1254;740;2255;1176;3509
521000;201806;7989;22379;5889;18473;1500;4939;1550;4836;3050;9775
521010;201806;3963;10552;2965;8821;374;1072;1574;4698;1948;5770
521015;201806;671;1757;559;1576;74;212;371;1035;445;1247
521020;201806;2939;7944;1806;5652;492;1645;183;571;675;2216
521030;201806;600;1426;424;1154;50;109;209;616;259;725
521040;201806;7513;18798;5667;15928;1489;4392;2101;6083;3590;10475
521056;201806;865;2407;672;2097;217;695;177;610;394;1305
521060;201806;1094;2802;811;2342;66;208;421;1230;487;1438
521080;201806;1102;2571;579;1684;83;256;178;433;261;689
521090;201806;3170;8374;2306;6954;657;2150;353;1085;1010;3235
521100;201806;1832;4303;1331;3590;267;694;692;1931;959;2625
521120;201806;4955;11679;3449;9779;385;1041;1602;5169;1987;6210
521130;201806;1011;2522;681;1896;41;142;387;1070;428;1212
521140;201806;1219;3268;901;2706;152;491;357;1058;509;1549
521150;201806;11900;27584;7672;21349;1830;5719;2910;8246;4740;13965
521160;201806;707;1587;465;1214;75;210;234;580;309;790
521170;201806;1141;2740;808;2227;85;232;509;1353;594;1585
521180;201806;6543;19637;5469;17632;1123;3860;2192;6930;3315;10790
521190;201806;10346;27467;6028;19583;1471;5154;1050;3548;2521;8702
521200;201806;776;1994;547;1598;70;214;278;803;348;1017
521205;201806;611;1606;462;1365;28;75;329;961;357;1036
521210;201806;768;2054;430;1334;97;334;56;121;153;455
521220;201806;4253;10415;2894;8353;590;1838;945;2599;1535;4437
521225;201806;361;841;284;753;30;64;193;537;223;601
521230;201806;1417;4360;1318;4200;443;1298;701;2435;1144;3733
521250;201806;31667;90099;25577;81200;10207;33620;7212;24559;17419;58179
521260;201806;632;1504;473;1259;76;215;266;699;342;914
521270;201806;1857;4819;1597;4510;109;247;1232;3580;1341;3827
521280;201806;1938;5427;1461;4569;426;1427;451;1437;877;2864
521290;201806;476;1249;354;1076;63;225;196;572;259;797
521295;201806;1210;2699;955;2388;99;222;698;1836;797;2058
521300;201806;1973;5085;1585;4545;283;768;1001;2994;1284;3762
521305;201806;742;1945;548;1613;82;237;288;851;370;1088
521308;201806;4677;13114;3439;10658;587;1849;1726;5319;2313;7168
521310;201806;8537;23060;5625;17637;1404;4684;1545;4706;2949;9390
521340;201806;397;966;307;827;24;61;230;617;254;678
521350;201806;2105;5477;1632;4756;199;636;1070;3023;1269;3659
521370;201806;1150;3056;717;2282;185;665;115;364;300;1029
521375;201806;1509;3963;1095;3369;265;853;399;1288;664;2141
521377;201806;1359;3067;1063;2697;60;146;906;2315;966;2461
521380;201806;6225;16973;4214;13254;483;1579;1023;3398;1506;4977
521385;201806;624;1547;491;1376;108;300;226;695;334;995
521390;201806;722;1875;532;1587;168;540;167;522;335;1062
521400;201806;2407;5745;1894;5149;220;660;1372;3758;1592;4418
521405;201806;1345;3540;1013;2973;217;641;446;1331;663;1972
521410;201806;765;2102;620;1890;129;378;311;1023;440;1401
521440;201806;1425;3842;1057;3179;290;929;259;755;549;1684
521450;201806;3929;12150;3000;10227;737;2553;763;2706;1500;5259
521460;201806;6333;17341;4761;14509;1573;5070;1172;3426;2745;8496
521470;201806;662;1869;397;1270;66;202;99;287;165;489
521480;201806;384;1045;219;710;44;151;53;157;97;308
521483;201806;2554;6409;1827;5191;467;1394;562;1547;1029;2941
521486;201806;1704;4116;1303;3565;77;218;977;2648;1054;2866
521487;201806;488;1226;337;996;62;193;139;417;201;610
521490;201806;844;2347;639;1990;41;166;442;1336;483;1502
521500;201806;1682;4405;1189;3589;110;402;754;2188;864;2590
521520;201806;831;1900;564;1501;94;255;232;639;326;894
521523;201806;11504;38571;10082;36050;3591;13716;2418;8966;6009;22682
521525;201806;1069;2555;820;2195;86;227;550;1455;636;1682
521530;201806;2226;5837;1309;3981;270;855;321;1030;591;1885
521540;201806;864;2255;561;1729;94;349;237;724;331;1073
521550;201806;1424;3655;848;2497;170;540;273;850;443;1390
521560;201806;3886;11266;2839;9837;659;2627;1330;4793;1989;7420
521565;201806;602;1529;490;1374;75;206;314;857;389;1063
521570;201806;4170;11197;2698;8394;551;1890;342;1094;893;2984
521580;201806;541;1339;303;918;47;154;60;159;107;313
521590;201806;615;1610;471;1370;129;418;181;498;310;916
521600;201806;410;1173;255;808;50;143;52;169;102;312
521630;201806;1569;3651;948;2699;195;600;284;780;479;1380
521640;201806;2141;5128;1534;4250;358;1011;562;1557;920;2568
521645;201806;580;1602;380;1221;77;243;106;347;183;590
521680;201806;1182;3721;948;3230;285;1024;109;407;394;1431
521690;201806;450;1265;405;1189;88;272;218;622;306;894
521710;201806;3090;8342;2151;6676;400;1327;438;1314;838;2641
521720;201806;2078;5455;1553;4555;211;659;835;2376;1046;3035
521730;201806;3786;11445;3010;9961;1005;3656;497;1382;1502;5038
521740;201806;3976;10864;3091;9502;895;2985;1008;3263;1903;6248
521760;201806;14222;42746;11779;38773;3453;12385;3774;12886;7227;25271
521770;201806;2871;7572;2047;6102;652;2088;447;1298;1099;3386
521800;201806;6235;17877;5021;15841;1436;4714;1581;5406;3017;10120
521805;201806;686;1555;466;1259;157;395;175;506;332;901
521810;201806;744;1759;503;1396;90;266;226;636;316;902
521830;201806;5281;15450;4361;14079;459;1676;2862;9093;3321;10769
521839;201806;709;1860;505;1483;100;302;186;526;286;828
521850;201806;5720;14829;4029;12032;981;3179;541;1497;1522;4676
521860;201806;1891;4944;1333;4027;220;726;427;1277;647;2003
521870;201806;660;1937;468;1576;109;381;131;411;240;792
521878;201806;727;1988;511;1570;85;295;203;571;288;866
521880;201806;19456;48464;13125;38647;3458;10670;3952;12079;7410;22749
521890;201806;3218;9012;2195;6940;534;1813;261;747;795;2560
521900;201806;1652;4025;1011;3045;245;719;265;820;510;1539
521910;201806;1211;2784;825;2325;81;246;486;1426;567;1672
521920;201806;404;1202;305;989;62;222;96;329;158;551
521925;201806;695;1989;521;1670;128;409;157;494;285;903
521930;201806;4459;12042;3342;10304;968;2948;1049;3468;2017;6416
521935;201806;769;2023;576;1665;92;271;304;840;396;1111
521940;201806;1292;3061;886;2501;217;702;355;956;572;1658
521945;201806;593;1741;485;1539;84;266;223;753;307;1019
521950;201806;624;1530;491;1362;30;90;392;1088;422;1178
521960;201806;725;2022;481;1517;74;254;217;652;291;906
521970;201806;2634;6828;2199;6319;135;351;1778;5270;1913;5621
521971;201806;882;2291;600;1821;145;473;129;369;274;842
521973;201806;1100;3088;906;2797;93;343;560;1685;653;2028
521975;201806;12545;33707;10663;31184;1809;5462;6521;19119;8330;24581
521980;201806;2519;6328;2008;5650;209;528;1459;4166;1668;4694
521990;201806;1168;3268;935;2893;124;383;506;1611;630;1994
522000;201806;3756;12359;3119;11534;248;814;2242;8909;2490;9723
522005;201806;335;845;247;717;62;168;97;298;159;466
522010;201806;3835;9919;2861;8335;830;2562;724;2029;1554;4591
522015;201806;970;2641;709;2220;151;499;260;808;411;1307
522020;201806;5397;13319;3674;10503;871;2591;1515;4394;2386;6985
522026;201806;672;1913;520;1662;91;301;227;739;318;1040
522028;201806;522;1412;375;1098;82;237;144;398;226;635
522040;201806;2908;6629;2057;5525;275;767;1381;3719;1656;4486
522045;201806;16621;49921;12693;42160;3114;11032;2679;8597;5793;19629
522050;201806;1134;3104;769;2432;170;558;253;763;423;1321
522060;201806;2561;7186;2045;6390;304;974;1129;3668;1433;4642
522068;201806;1731;4893;1428;4518;168;495;1008;3303;1176;3798
522070;201806;618;1688;515;1528;50;195;355;1002;405;1197
522100;201806;586;1604;429;1361;70;241;224;712;294;953
522108;201806;909;2547;708;2223;42;170;557;1702;599;1872
522119;201806;1604;4287;1246;3792;205;647;645;2026;850;2673
522130;201806;389;988;279;840;62;203;140;430;202;633
522140;201806;16357;45288;12129;37696;3626;11933;1985;6102;5611;18035
522145;201806;854;2166;624;1828;140;360;317;1017;457;1377
522150;201806;961;2374;725;2029;220;601;243;711;463;1312
522155;201806;942;2525;740;2187;159;452;339;1039;498;1491
522157;201806;566;1521;482;1402;27;109;359;1008;386;1117
522160;201806;6280;16811;4179;12915;1129;3797;338;1150;1467;4947
522170;201806;2516;6912;1836;5750;533;1738;595;1862;1128;3600
522180;201806;441;1159;285;879;61;194;39;135;100;329
522185;201806;16291;42543;12446;37480;4955;15891;3244;10693;8199;26584
522190;201806;794;1908;585;1598;103;274;230;668;333;942
522200;201806;1787;5429;1190;4081;231;831;143;473;374;1304
522205;201806;1555;3862;1192;3330;105;311;840;2361;945;2672
522220;201806;1369;3554;1044;3085;169;469;556;1697;725;2166
522230;201806;1236;3308;1028;3001;183;588;581;1695;764;2283
530010;201806;168301;495504;144230;455337;30301;105528;69214;213263;99515;318791
110001;201807;3511;10570;2646;8999;714;2595;1073;3620;1787;6215
110002;201807;11469;31207;8361;25890;2550;8395;2635;8179;5185;16574
110003;201807;684;2047;508;1685;166;594;99;309;265;903
110004;201807;9098;26410;6640;21668;1874;6427;1554;5415;3428;11842
110005;201807;2299;6286;1467;4714;391;1316;452;1552;843;2868
110006;201807;1715;4957;1076;3611;267;966;151;512;418;1478
110007;201807;1167;3407;897;2925;312;1032;296;1079;608;2111
110008;201807;2457;7898;2176;7472;295;953;1619;5760;1914;6713
110009;201807;4013;11733;2743;9483;820;2913;906;3274;1726;6187
110010;201807;6182;20958;5080;19010;1363;4957;2285;9583;3648;14540
110011;201807;6358;18400;4856;15543;1649;5421;1020;3352;2669;8773
110012;201807;13801;37041;9474;29396;2614;8467;1444;4626;4058;13093
110013;201807;5397;16441;4339;14390;1801;6130;725;2675;2526;8805
110014;201807;3811;10447;2747;8528;783;2466;1097;3378;1880;5844
110015;201807;5176;14416;3064;10114;830;2958;472;1505;1302;4463
110018;201807;3579;9557;2277;7308;542;1974;606;1861;1148;3835
110020;201807;69572;177648;48833;148485;11018;35176;19435;63078;30453;98254
110025;201807;4619;12024;3169;9493;625;1977;1567;4571;2192;6548
110026;201807;485;1468;404;1333;129;463;160;501;289;964
110028;201807;6207;17353;4227;13523;1228;4190;612;1942;1840;6132
110029;201807;1359;3420;832;2574;202;638;361;1128;563;1766
110030;201807;11799;29496;8080;24050;1574;5327;3032;9242;4606;14569
110032;201807;3145;9497;2316;7721;783;2623;592;2040;1375;4663
110033;201807;4109;13361;3374;11949;1210;4352;933;3660;2143;8012
110034;201807;3380;8626;2420;7241;738;2351;1058;3222;1796;5573
110037;201807;1673;5426;1344;4766;338;1241;626;2202;964;3443
110040;201807;2987;8891;2279;7557;727;2595;590;1892;1317;4487
110045;201807;4861;14814;4014;13433;1215;4383;1606;5418;2821;9801
110050;201807;1649;4993;1260;4204;515;1778;305;1031;820;2809
110060;201807;791;2484;579;2038;219;818;74;276;293;1094
110070;201807;1900;6187;1531;5327;549;1989;370;1213;919;3202
110080;201807;5513;13765;4157;12118;736;2122;2608;7948;3344;10070
110090;201807;627;1742;439;1400;131;438;167;520;298;958
110092;201807;1125;3485;900;3082;159;580;487;1719;646;2299
110094;201807;2970;8933;2350;7881;854;2986;687;2413;1541;5399
110100;201807;1841;5700;1553;5103;365;1281;761;2493;1126;3774
110110;201807;1611;4737;1208;4072;419;1471;276;992;695;2463
110120;201807;1410;4273;1056;3549;287;1012;293;971;580;1983
110130;201807;2613;6928;1652;5135;397;1366;545;1651;942;3017
110140;201807;2189;6931;1647;5804;471;1749;408;1430;879;3179
110143;201807;1359;3806;979;3073;344;1099;261;851;605;1950
110145;201807;985;2750;642;2085;161;562;215;690;376;1252
110146;201807;448;1249;320;1050;62;192;161;562;223;754
110147;201807;663;1819;439;1368;93;299;169;483;262;782
110148;201807;982;2953;589;2029;134;507;57;199;191;706
110149;201807;2797;8215;2108;7105;837;2729;605;2249;1442;4978
110150;201807;2264;6180;1645;5273;618;2178;468;1481;1086;3659
110155;201807;699;2183;555;1849;133;473;198;638;331;1111
110160;201807;1539;4880;1174;4076;406;1391;305;1115;711;2506
110170;201807;2280;6232;1499;4696;284;950;768;2325;1052;3275
110175;201807;1436;4289;1117;3792;210;748;547;1959;757;2707
110180;201807;1228;3573;903;2904;240;759;383;1261;623;2020
120001;201807;3632;12612;3207;11981;496;1674;2168;8657;2664;10331
120005;201807;1831;7151;1647;6837;184;836;1249;5308;1433;6144
120010;201807;5224;16578;4481;15346;688;2289;2958;10500;3646;12789
120013;201807;2132;8175;1997;7981;547;2117;1118;4795;1665;6912
120017;201807;2075;7205;1891;6898;357;1348;1105;4229;1462;5577
120020;201807;14155;60056;13416;58589;1480;6959;10017;44730;11497;51689
120025;201807;2743;8554;2339;8035;470;1653;1487;5257;1957;6910
120030;201807;6447;25734;6190;25299;408;2093;5103;20893;5511;22986
120032;201807;1614;7530;1538;7342;96;592;1234;5860;1330;6452
120033;201807;3925;15090;3696;14686;158;838;3182;12563;3340;13401
120034;201807;2450;9339;2141;8750;134;783;1708;6886;1842;7669
120035;201807;3359;14405;3217;14127;280;1459;2590;11438;2870;12897
120038;201807;2587;8882;2341;8441;592;2226;1226;4497;1818;6723
120039;201807;1920;8665;1835;8501;178;1060;1392;6464;1570;7524
120040;201807;41174;139653;36796;132188;6951;26528;21038;76958;27989;103486
120042;201807;3184;12483;2957;11995;175;936;2346;9459;2521;10395
120043;201807;1240;5461;1171;5301;83;478;993;4488;1076;4966
120045;201807;5539;16064;4992;15451;175;705;4547;13957;4722;14662
120050;201807;8678;33014;8085;31999;676;3190;6288;25140;6964;28330
120060;201807;8568;35688;8168;35006;496;2662;6933;29842;7429;32504
120070;201807;2826;9796;2604;9440;314;1173;1831;6861;2145;8034
120080;201807;4109;14432;3745;13820;577;2304;2568;9551;3145;11855
130002;201807;3136;12792;2873;12428;114;628;2559;11110;2673;11738
130006;201807;2264;8957;1929;8341;153;772;1461;6320;1614;7092
130008;201807;2496;9059;2234;8623;90;483;1835;7074;1925;7557
130010;201807;3825;11178;3326;10607;62;233;3109;9951;3171;10184
130014;201807;3076;9628;2519;8670;452;1578;1582;5573;2034;7151
130020;201807;2714;10763;2495;10385;162;943;1985;8224;2147;9167
130030;201807;9446;31933;8684;31108;162;524;8156;29678;8318;30202
130040;201807;3851;11684;3272;10910;201;706;2615;8818;2816;9524
130050;201807;7317;27265;6189;25809;254;1163;5503;23224;5757;24387
130060;201807;7145;29693;6247;28453;566;3256;4875;22154;5441;25410
130063;201807;5621;19816;5072;19170;123;520;4705;17938;4828;18458
130068;201807;3269;13106;2888;12363;217;1186;2170;9252;2387;10438
130070;201807;8325;26114;7193;24840;320;1062;6266;22121;6586;23183
130080;201807;6456;25715;5831;24876;430;2432;4701;20089;5131;22521
130083;201807;2534;9082;2294;8763;194;879;1833;6968;2027;7847
130090;201807;3152;10324;2888;9961;63;275;2597;9080;2660;9355
130100;201807;7211;23151;6387;22262;92;263;6038;21462;6130;21725
130110;201807;7880;23128;6740;21753;595;1675;5614;18681;6209;20356
130115;201807;5389;17458;4781;16696;111;476;4173;14752;4284;15228
130120;201807;14956;54565;13652;52869;1247;5105;11152;43929;12399;49034
130130;201807;4953;16966;4010;15735;477;2149;3007;11748;3484;13897
130140;201807;6640;24957;6347;24616;280;1337;5704;22142;5984;23479
130150;201807;3586;13917;3412;13693;110;626;3099;12457;3209;13083
130160;201807;4773;18283;4258;17601;332;1602;3498;14707;3830;16309
130165;201807;3090;12269;2937;12014;121;667;2577;10529;2698;11196
130170;201807;11437;35190;9430;32729;717;2835;7755;27188;8472;30023
130180;201807;4373;14031;4126;13739;54;253;3948;13128;4002;13381
130185;201807;17013;43688;13828;40291;555;1135;12297;37094;12852;38229
130190;201807;18109;61066;15220;56834;1838;6944;10843;41949;12681;48893
130195;201807;2291;8776;1922;8282;85;439;1706;7386;1791;7825
130200;201807;2305;7121;1961;6642;155;568;1539;5302;1694;5870
130210;201807;1380;5256;1239;5089;120;689;971;3911;1091;4600
130220;201807;2076;7957;1884;7637;115;593;1511;6150;1626;6743
130230;201807;4163;18194;3757;17597;343;1918;3072;14481;3415;16399
130240;201807;10617;34793;8955;32455;254;1460;7812;28244;8066;29704
130250;201807;25275;77940;22330;74577;1585;5024;18419;63791;20004;68815
130255;201807;4230;14793;3796;14025;236;1049;3007;11123;3243;12172
130260;201807;248461;749165;210575;690433;60849;213131;91419;304269;152268;517400
130270;201807;8555;32443;7365;30522;1020;4404;5163;22100;6183;26504
130280;201807;3494;14276;3286;14044;107;495;3044;13208;3151;13703
130290;201807;12533;43138;11247;41614;400;1365;10228;38639;10628;40004
130300;201807;4667;17099;4324;16574;217;1116;3660;13969;3877;15085
130310;201807;5582;20338;5034;19564;397;1615;4102;16234;4499;17849
130320;201807;3414;11454;2969;10872;274;989;2297;8639;2571;9628
130330;201807;4256;14291;3633;13512;189;866;3106;11579;3295;12445
130340;201807;20988;72300;18589;69486;1532;5599;15511;59672;17043;65271
130350;201807;3833;14400;3522;13994;171;983;3048;11991;3219;12974
130353;201807;6318;18779;5331;17519;892;2873;3602;12391;4494;15264
130356;201807;4991;17193;4406;16210;590;2235;3019;11420;3609;13655
130360;201807;3297;9660;2791;9105;74;224;2613;8604;2687;8828
130370;201807;5882;22602;5245;21750;192;1132;4576;18933;4768;20065
130380;201807;7654;31901;7236;31268;507;2779;6039;25888;6546;28667
130390;201807;5813;24807;5134;23600;563;3043;3752;17240;4315;20283
130395;201807;2363;7812;2056;7258;242;909;1459;5153;1701;6062
130400;201807;2594;8584;2269;8125;112;400;1981;7163;2093;7563
130406;201807;11213;41256;9871;39403;1757;7243;6747;27583;8504;34826
130410;201807;4052;14892;3541;14003;1050;4314;1745;7154;2795;11468
130420;201807;12557;47390;11057;45489;1124;5345;8727;36150;9851;41495
130423;201807;4032;13489;3595;12947;180;894;3138;11147;3318;12041
130426;201807;2804;11105;2684;10926;79;373;2486;10215;2565;10588
130430;201807;4006;12440;3603;11868;387;1345;2827;9332;3214;10677
130440;201807;4537;14532;4030;13934;80;340;3774;13111;3854;13451
140002;201807;1998;6075;1757;5749;107;432;1416;4561;1523;4993
140005;201807;3403;9345;3182;9094;157;454;2891;8275;3048;8729
140010;201807;53935;147776;42097;130210;11070;36022;15675;51549;26745;87571
140015;201807;3308;10482;2966;10064;272;933;2437;8437;2709;9370
140017;201807;3699;11271;3253;10673;360;1124;2353;8122;2713;9246
140020;201807;5071;15618;4348;14628;374;1545;3294;11090;3668;12635
140023;201807;2227;7034;1845;6479;234;909;1306;4641;1540;5550
140028;201807;2092;5541;1782;5132;168;560;1343;3773;1511;4333
140030;201807;4324;12274;3859;11692;338;943;3151;9768;3489;10711
140040;201807;2053;8801;1902;8583;111;637;1663;7455;1774;8092
140045;201807;2586;9682;2217;9149;417;1682;1426;6255;1843;7937
140047;201807;6083;18232;5189;16838;927;3098;3202;10670;4129;13768
140050;201807;1406;4267;1201;3963;135;462;838;2797;973;3259
140060;201807;1459;4180;1273;3892;103;308;1031;3194;1134;3502
140070;201807;1836;9849;1768;9657;160;1083;1364;7393;1524;8476
150010;201807;41961;110363;38555;105781;1360;4294;33738;91922;35098;96216
150013;201807;1895;5126;1580;4770;157;421;1180;3754;1337;4175
150020;201807;13599;42949;12857;41955;1183;2990;10777;36466;11960;39456
150030;201807;8882;33946;8134;33006;402;1801;7142;29251;7544;31052
150034;201807;4243;11247;3623;10405;257;756;2943;8549;3200;9305
150040;201807;14105;39879;12224;37725;1041;2262;10247;33465;11288;35727
150050;201807;6612;24007;6132;23309;143;704;5589;21378;5732;22082
150060;201807;20172;58018;17082;53419;3400;10601;10067;32570;13467;43171
150070;201807;6449;25025;5731;24179;181;944;5240;22389;5421;23333
150080;201807;82843;206103;69216;187796;16324;45250;28400;85884;44724;131134
150085;201807;6331;20153;5843;19548;216;671;5365;18154;5581;18825
150090;201807;10094;38189;9527;37206;719;3083;7676;30200;8395;33283
150095;201807;5552;17280;4977;16482;318;964;4086;13945;4404;14909
150100;201807;3133;11058;2778;10427;209;833;2145;8108;2354;8941
150110;201807;3960;17702;3855;17562;230;1103;3453;15870;3683;16973
150120;201807;7226;24470;7006;24150;327;931;6203;21988;6530;22919
150125;201807;759;2115;608;1920;119;420;365;1140;484;1560
150130;201807;23321;68541;20474;64366;2690;7604;14681;47927;17371;55531
150140;201807;201647;511651;175311;475423;27287;72572;110054;308524;137341;381096
150145;201807;4612;13961;4005;13130;722;2106;2803;9725;3525;11831
150150;201807;14621;39950;13066;37956;1089;3351;10142;29766;11231;33117
150157;201807;3252;9356;2719;8632;305;1060;1885;6149;2190;7209
150160;201807;2996;9310;2799;8978;682;2197;1587;5252;2269;7449
150170;201807;24370;81382;21300;76427;3908;13419;13062;49920;16970;63339
150172;201807;4066;12099;3368;11070;284;864;2492;8487;2776;9351
150175;201807;1730;5335;1515;4972;191;690;1045;3500;1236;4190
150178;201807;10255;29351;8578;27374;451;1431;7062;23083;7513;24514
150180;201807;20800;78170;19282;76223;1081;4507;16644;66856;17725;71363
150190;201807;7110;24114;6692;23570;245;1087;5940;20916;6185;22003
150195;201807;5486;17550;5196;17098;103;424;4791;15741;4894;16165
150200;201807;5398;16477;4946;15973;65;200;4678;15239;4743;15439
150210;201807;25110;91025;23702;89123;2016;7473;19106;74266;21122;81739
150215;201807;7341;22354;6382;20903;1792;5798;2975;10357;4767;16155
150220;201807;11219;33912;9970;31996;1696;5333;5979;19846;7675;25179
150230;201807;12575;36737;10891;34468;1414;4268;7468;24752;8882;29020
150240;201807;32948;95060;27225;84868;9090;28853;7397;23902;16487;52755
150250;201807;4217;17048;4006;16747;584;2446;3025;12941;3609;15387
150260;201807;2474;8650;2298;8360;240;855;1704;6308;1944;7163
150270;201807;8377;24346;6170;21136;1997;7156;2283;8246;4280;15402
150275;201807;6455;21695;5988;20980;372;1438;4959;17392;5331;18830
150276;201807;2266;6406;1955;6026;258;740;1421;4629;1679;5369
150277;201807;5051;14003;4206;12989;442;1314;3217;10376;3659;11690
150280;201807;6336;26900;6146;26530;552;2353;5010;21962;5562;24315
150285;201807;3230;11693;2894;11190;355;1477;1981;7821;2336;9298
150290;201807;11011;29638;10133;28682;478;1064;8995;26195;9473;27259
150293;201807;10047;25130;7278;21439;1623;4841;3383;10921;5006;15762
150295;201807;7966;21563;6058;19244;2065;6887;2367;8403;4432;15290
150300;201807;2133;6822;1927;6531;58;293;1659;5580;1717;5873
150304;201807;4027;12710;3481;11800;591;1941;2253;7887;2844;9828
150307;201807;6372;20769;5945;20114;434;1412;4881;16790;5315;18202
150309;201807;6126;19651;5149;17974;1224;4147;2581;9641;3805;13788
150310;201807;7213;28596;6839;28112;270;1425;5979;24817;6249;26242
150320;201807;9490;25596;8646;24471;490;1499;6904;19547;7394;21046
150330;201807;14191;46726;13143;45057;1735;5925;9628;33996;11363;39921
150340;201807;2716;8068;2435;7657;326;1014;1715;5468;2041;6482
150345;201807;7696;23332;6968;22374;477;1622;5823;18883;6300;20505
150350;201807;8729;24254;8041;23387;832;1791;6574;19879;7406;21670
150360;201807;23527;67646;19208;62171;2380;7111;13191;44779;15571;51890
150370;201807;9798;33022;8561;31322;926;3295;6299;24045;7225;27340
150375;201807;3239;13591;2945;13140;296;1412;2357;10663;2653;12075
150380;201807;10202;27926;8614;25769;357;1100;7329;22158;7686;23258
150390;201807;7801;32751;7147;31619;1178;5038;4845;22451;6023;27489
150400;201807;6275;23240;5996;22704;352;1426;4998;19025;5350;20451
150405;201807;9239;25014;8184;23723;576;1277;6535;19745;7111;21022
150410;201807;1827;6179;1601;5777;230;822;1027;3802;1257;4624
150420;201807;35527;108933;27681;96663;9441;34315;7778;31439;17219;65754
150430;201807;8081;25033;7569;24310;770;2115;5979;19881;6749;21996
150440;201807;5709;18784;5362;18272;449;1410;4326;15009;4775;16419
150442;201807;24076;63459;20396;58301;2635;7350;13185;39023;15820;46373
150445;201807;5893;19119;5316;18218;293;1045;4412;15280;4705;16325
150450;201807;4841;21591;4570;21187;389;1883;3811;17899;4200;19782
150460;201807;8081;27248;7512;26490;260;1054;6509;23673;6769;24727
150470;201807;18690;53580;17586;52277;952;2646;15582;46809;16534;49455
150475;201807;4342;14523;3918;13870;211;797;3248;11689;3459;12486
150480;201807;13946;46878;12505;44614;1929;6611;8780;32731;10709;39342
150490;201807;7732;28063;7308;27519;240;1175;6523;24620;6763;25795
150495;201807;5165;18439;5003;18228;115;501;4644;16971;4759;17472
150497;201807;2804;9387;2285;8426;602;2308;1081;4210;1683;6518
150500;201807;3337;8790;2966;8227;325;815;2278;6366;2603;7181
150503;201807;4248;12218;3212;10732;1052;3591;1193;4362;2245;7953
150506;201807;10004;33143;8961;31645;1918;6173;5764;21882;7682;28055
150510;201807;10085;37597;8819;35089;1291;5041;5768;24102;7059;29143
150520;201807;7259;27566;7000;27243;207;1028;6435;25096;6642;26124
150530;201807;12444;42706;10936;40360;1474;4594;7954;30899;9428;35493
150540;201807;4824;13861;4165;12883;182;572;3531;10927;3713;11499
150543;201807;6775;19057;5623;17533;871;2747;3815;12546;4686;15293
150548;201807;9836;31036;8926;29829;338;1101;7994;26889;8332;27990
150549;201807;2042;6298;1791;5989;60;239;1585;5297;1645;5536
150550;201807;19408;60019;16578;55246;4461;14997;7121;25094;11582;40091
150553;201807;23220;74166;18517;65179;6439;23360;5250;20303;11689;43663
150555;201807;1800;5122;1453;4561;107;354;1022;3187;1129;3541
150560;201807;1835;5842;1631;5433;309;983;906;3104;1215;4087
150563;201807;2478;7974;2198;7479;491;1800;1174;3965;1665;5765
150565;201807;4172;13829;3712;13055;118;590;3085;10882;3203;11472
150570;201807;6175;21121;5912;20694;355;1399;4892;17106;5247;18505
150580;201807;10312;42098;9384;41047;667;3254;7786;34778;8453;38032
150590;201807;7040;26240;6495;25522;224;1143;5876;23058;6100;24201
150600;201807;8693;31018;8106;30249;250;1142;7348;27541;7598;28683
150610;201807;2552;8176;2308;7705;158;596;1831;6043;1989;6639
150611;201807;2870;8953;2646;8591;118;471;2248;7231;2366;7702
150613;201807;13111;37200;10029;31958;2101;6979;4602;15061;6703;22040
150616;201807;3292;9415;2461;8004;609;2137;848;2661;1457;4798
150618;201807;6667;20863;5601;19047;882;3024;3372;11958;4254;14982
150619;201807;5802;17689;4894;16295;309;1149;3805;12696;4114;13845
150620;201807;6463;22106;5693;21028;853;3113;4014;15214;4867;18327
150630;201807;6268;17429;5785;16849;363;1044;4956;14597;5319;15641
150635;201807;4332;12951;3766;11960;701;2291;2094;6742;2795;9033
150640;201807;2177;6334;2006;6135;39;125;1865;5792;1904;5917
150650;201807;11764;34244;10425;31885;3153;9233;4514;14841;7667;24074
150655;201807;5663;16866;5190;16122;254;781;4392;13674;4646;14455
150658;201807;4484;12960;3690;11813;691;2336;2196;7356;2887;9692
150660;201807;5851;17197;5263;16374;587;1807;3621;11458;4208;13265
150670;201807;8067;19911;6381;17930;601;1464;5021;14676;5622;16140
150680;201807;66552;206378;51792;182451;13485;47410;22400;88214;35885;135624
150690;201807;2359;6339;2077;5948;134;345;1723;4995;1857;5340
150700;201807;6350;19255;5763;18513;501;1515;4461;14761;4962;16276
150710;201807;3979;13342;3623;12760;271;1055;2755;9755;3026;10810
150715;201807;5216;15983;4463;14788;368;1174;3534;11909;3902;13083
150720;201807;6416;24682;6059;24038;476;2155;4913;19594;5389;21749
150730;201807;11215;36060;9905;33994;1118;4032;7424;26013;8542;30045
150740;201807;3676;10974;3253;10228;440;1300;2196;7043;2636;8343
150745;201807;5020;15056;4251;13959;843;2912;2759;9173;3602;12085
150746;201807;1518;4894;1414;4718;87;285;1138;3846;1225;4131
150747;201807;5171;16454;4544;15511;850;2655;2881;10502;3731;13157
150750;201807;3684;11634;3166;10857;223;855;2452;8593;2675;9448
150760;201807;11862;35680;10843;34385;1365;4152;8032;26114;9397;30266
150770;201807;6173;22831;5905;22463;165;505;5474;21375;5639;21880
150775;201807;963;2821;781;2532;145;547;425;1361;570;1908
150780;201807;4460;13613;4135;13217;102;345;3831;12377;3933;12722
150790;201807;5447;16430;4788;15700;249;683;3935;13994;4184;14677
150795;201807;14186;45780;12806;43485;3231;10505;7111;25621;10342;36126
150796;201807;3505;9425;3051;8880;216;651;2489;7348;2705;7999
150797;201807;3968;12771;3429;11905;163;555;2813;9857;2976;10412
150800;201807;13339;42855;12256;41521;1802;5593;9045;32046;10847;37639
150803;201807;6711;23280;6300;22617;483;1817;5174;18701;5657;20518
150805;201807;3098;10302;2708;9664;288;1038;2059;7440;2347;8478
150808;201807;5884;17980;4460;15407;1711;6438;571;2182;2282;8620
150810;201807;20091;57075;15753;51567;2861;9229;9080;32089;11941;41318
150812;201807;5354;15762;4789;14760;505;1734;3502;10534;4007;12268
150815;201807;8895;28100;7719;26590;767;2672;6020;21146;6787;23818
150820;201807;11950;33027;10206;30969;922;2487;7973;25034;8895;27521
150830;201807;11873;44870;11232;44053;436;2305;9639;38625;10075;40930
150835;201807;2162;7524;1975;7165;412;1503;1024;3808;1436;5311
150840;201807;7671;22641;6127;19893;1295;4459;2968;9657;4263;14116
160005;201807;1184;3330;1079;3170;25;119;1012;2917;1037;3036
160010;201807;1883;5500;1839;5455;10;40;1796;5316;1806;5356
160015;201807;2258;7428;2081;7186;98;345;1886;6565;1984;6910
160020;201807;1972;6870;1774;6581;239;907;1326;4987;1565;5894
160021;201807;1123;4462;1041;4339;95;508;818;3369;913;3877
160023;201807;1223;4509;1111;4336;95;325;844;3480;939;3805
160025;201807;1735;4958;1692;4907;18;43;1652;4813;1670;4856
160027;201807;8658;24176;7882;23301;652;1740;6491;19795;7143;21535
160030;201807;57054;176321;47860;163820;11158;36315;25563;96267;36721;132582
160040;201807;5196;18498;4735;17865;109;605;4341;16347;4450;16952
160050;201807;4006;13434;3368;12498;1469;5134;1176;5237;2645;10371
160053;201807;3364;11517;3167;11260;399;1361;2422;8865;2821;10226
160055;201807;684;2403;674;2391;26;100;624;2223;650;2323
160060;201807;21486;61754;18199;58007;1238;3890;14735;48494;15973;52384
160070;201807;2985;11308;2716;10869;179;792;2183;8915;2362;9707
160080;201807;2850;10019;2680;9813;66;294;2453;9048;2519;9342
170025;201807;618;1743;476;1543;115;356;228;774;343;1130
170030;201807;1164;3711;946;3287;180;629;450;1613;630;2242
170035;201807;1447;3832;1073;3221;121;390;594;1801;715;2191
170040;201807;1824;5459;1499;5014;137;495;831;2944;968;3439
170070;201807;1650;4117;1185;3512;139;449;688;2085;827;2534
170100;201807;2459;7161;2039;6465;211;685;1362;4337;1573;5022
170105;201807;734;2225;523;1771;137;428;177;613;314;1041
170110;201807;894;2871;714;2519;127;466;338;1212;465;1678
170130;201807;1371;4231;1005;3497;189;690;495;1776;684;2466
170190;201807;1453;4191;1015;3477;370;1217;210;939;580;2156
170200;201807;1749;4495;1060;3257;277;926;241;727;518;1653
170210;201807;27156;75624;20650;64771;7223;24535;2528;9009;9751;33544
170215;201807;1346;3777;1128;3470;81;324;804;2443;885;2767
170220;201807;5862;18682;5054;17148;1210;3937;2552;9217;3762;13154
170230;201807;1277;3940;985;3350;263;944;242;825;505;1769
170240;201807;2703;7715;2112;6749;190;740;1409;4414;1599;5154
170255;201807;3988;11952;2779;9587;577;2080;1229;4354;1806;6434
170270;201807;1037;2522;676;2019;31;89;441;1297;472;1386
170290;201807;3021;8635;2581;8131;143;364;2116;6955;2259;7319
170300;201807;1951;5599;1597;5045;204;681;1006;3233;1210;3914
170305;201807;747;2197;582;1864;87;329;286;893;373;1222
170307;201807;970;3402;783;3016;135;537;407;1595;542;2132
170310;201807;1652;4374;1148;3500;211;715;523;1601;734;2316
170320;201807;1025;2808;764;2380;103;331;431;1363;534;1694
170330;201807;840;2662;757;2532;47;202;593;1937;640;2139
170360;201807;469;1359;353;1159;58;221;208;634;266;855
170370;201807;1339;3655;989;3072;192;619;441;1402;633;2021
170380;201807;1839;5559;1396;4843;152;593;786;2785;938;3378
170382;201807;571;1748;467;1565;66;245;296;983;362;1228
170384;201807;1509;5797;1290;5352;363;1577;532;2210;895;3787
170386;201807;780;2226;500;1661;73;295;132;402;205;697
170388;201807;589;1747;425;1449;62;240;198;667;260;907
170389;201807;1155;3936;998;3656;54;235;785;2916;839;3151
170390;201807;1614;3916;1190;3397;88;266;892;2605;980;2871
170410;201807;544;1646;400;1390;23;103;256;875;279;978
170460;201807;401;1110;314;959;41;132;192;596;233;728
170510;201807;862;2683;648;2252;60;280;373;1235;433;1515
170550;201807;6668;18262;4694;14854;1396;4702;841;2870;2237;7572
170555;201807;1348;3813;1067;3364;76;258;576;1867;652;2125
170560;201807;1038;3061;790;2703;103;384;441;1671;544;2055
170600;201807;1399;3897;1123;3484;260;713;614;2052;874;2765
170610;201807;1722;4856;1285;4113;96;375;814;2544;910;2919
170625;201807;436;1212;272;856;32;94;88;260;120;354
170650;201807;1255;3857;963;3333;204;730;402;1473;606;2203
170700;201807;3578;10707;2748;9196;596;2157;1138;3927;1734;6084
170710;201807;1630;4526;1258;3859;238;790;664;1996;902;2786
170720;201807;1939;4997;1562;4429;75;152;1305;3822;1380;3974
170730;201807;1021;2930;777;2530;191;634;341;1162;532;1796
170740;201807;2048;7206;1751;6609;233;917;1144;4348;1377;5265
170755;201807;884;2585;631;2087;71;262;306;1009;377;1271
170765;201807;1260;3333;870;2727;223;723;337;1130;560;1853
170770;201807;1763;5530;1519;5118;190;641;1003;3445;1193;4086
170820;201807;3875;13368;3359;12372;489;1750;1955;7604;2444;9354
170825;201807;997;2398;796;2124;85;240;528;1399;613;1639
170830;201807;1425;3936;1161;3513;37;117;949;2880;986;2997
170900;201807;2678;8874;2322;8304;200;790;1815;6564;2015;7354
170930;201807;3801;10780;3037;9431;710;2351;1251;3945;1961;6296
170950;201807;11864;33876;8348;27509;2430;9101;1186;4048;3616;13149
170980;201807;450;1297;362;1147;31;139;229;682;260;821
171050;201807;1575;5096;1399;4781;70;339;1093;3672;1163;4011
171070;201807;1365;4084;1179;3801;216;644;720;2522;936;3166
171090;201807;1083;2740;893;2470;59;158;647;1785;706;1943
171110;201807;582;1664;429;1391;96;345;176;518;272;863
171150;201807;1099;2846;669;2078;76;278;412;1261;488;1539
171180;201807;725;2081;484;1581;89;306;192;645;281;951
171190;201807;1596;5727;1409;5369;227;873;839;3316;1066;4189
171195;201807;846;2845;707;2578;137;520;389;1447;526;1967
171200;201807;557;1662;422;1418;92;337;168;552;260;889
171215;201807;430;1225;322;1022;64;220;157;487;221;707
171240;201807;745;2584;621;2333;49;255;388;1449;437;1704
171245;201807;621;1974;482;1672;77;299;234;770;311;1069
171250;201807;1031;2849;767;2409;223;735;337;1071;560;1806
171270;201807;385;1504;328;1368;85;343;147;682;232;1025
171280;201807;836;2603;659;2283;141;467;303;1159;444;1626
171320;201807;3960;11399;3110;9891;597;1888;1391;4667;1988;6555
171330;201807;2731;7666;2109;6576;446;1383;1046;3380;1492;4763
171360;201807;1446;4433;1222;4115;83;329;948;3216;1031;3545
171370;201807;699;1851;545;1633;57;180;377;1148;434;1328
171380;201807;1396;4074;1133;3644;142;501;712;2300;854;2801
171395;201807;932;2769;654;2195;93;364;324;1052;417;1416
171420;201807;1829;5707;1358;4727;223;883;620;2162;843;3045
171430;201807;1039;3126;842;2739;100;369;560;1761;660;2130
171488;201807;2457;7380;1959;6567;328;1157;1023;3531;1351;4688
171500;201807;937;2508;719;2166;54;169;530;1608;584;1777
171510;201807;796;2747;714;2592;45;208;500;1812;545;2020
171515;201807;483;1333;353;1109;32;120;207;636;239;756
171525;201807;630;1956;530;1785;43;201;325;1010;368;1211
171550;201807;338;1046;245;883;47;188;120;423;167;611
171570;201807;1170;3620;986;3272;171;538;576;1999;747;2537
171575;201807;1884;5085;1210;3838;204;687;506;1573;710;2260
171610;201807;5687;16493;4282;14083;1046;3775;1202;4204;2248;7979
171620;201807;2836;7949;2377;7316;161;590;1858;5747;2019;6337
171630;201807;996;2786;812;2527;155;513;497;1577;652;2090
171650;201807;2135;6367;1569;5272;384;1344;510;1810;894;3154
171660;201807;2415;6386;1676;5066;282;843;869;2647;1151;3490
171665;201807;1324;3830;1020;3345;198;718;471;1570;669;2288
171670;201807;1845;5062;1426;4381;212;731;770;2338;982;3069
171700;201807;1193;3536;894;2996;133;432;484;1634;617;2066
171720;201807;820;2217;642;1921;54;191;456;1365;510;1556
171750;201807;1236;3604;880;2940;237;815;159;608;396;1423
171780;201807;1294;3362;926;2833;79;288;627;1896;706;2184
171790;201807;1441;4954;1160;4318;268;1006;523;2035;791;3041
171800;201807;748;2159;580;1902;86;299;317;1051;403;1350
171820;201807;10810;31370;8199;26781;2007;6897;2794;9695;4801;16592
171830;201807;1464;5121;1249;4673;182;770;739;2743;921;3513
171840;201807;717;1924;580;1709;35;118;431;1247;466;1365
171845;201807;657;1732;493;1497;69;246;269;825;338;1071
171850;201807;870;3030;740;2757;76;339;507;1852;583;2191
171855;201807;1094;3389;952;3133;83;279;614;1996;697;2275
171865;201807;398;1311;337;1208;65;255;167;578;232;833
171870;201807;762;2200;553;1800;72;251;290;997;362;1248
171875;201807;1250;3819;1000;3404;59;241;733;2466;792;2707
171880;201807;1040;3384;938;3254;47;175;756;2681;803;2856
171884;201807;921;2462;666;2066;130;463;221;758;351;1221
171886;201807;1476;4273;1043;3501;314;1114;210;739;524;1853
171888;201807;770;2218;531;1753;48;163;323;1074;371;1237
171889;201807;465;1451;398;1317;83;296;174;582;257;878
171890;201807;1170;3326;886;2855;174;541;506;1664;680;2205
171900;201807;506;1805;378;1485;106;418;136;568;242;986
172000;201807;593;1849;491;1651;74;291;260;833;334;1124
172010;201807;1077;3801;929;3486;86;425;588;2119;674;2544
172015;201807;339;1275;269;1130;63;260;116;508;179;768
172020;201807;2368;7483;2165;7173;190;738;1615;5387;1805;6125
172025;201807;737;2106;536;1774;52;199;338;1125;390;1324
172030;201807;1261;3789;1090;3523;31;142;878;2825;909;2967
172049;201807;1376;3407;896;2663;280;867;417;1259;697;2126
172065;201807;1461;3748;1170;3396;69;165;1034;3077;1103;3242
172080;201807;2383;7275;1946;6453;153;575;1310;4350;1463;4925
172085;201807;478;1346;314;1005;60;178;90;280;150;458
172090;201807;4082;10616;3142;9303;137;505;2445;7182;2582;7687
172093;201807;511;1543;379;1300;55;244;194;625;249;869
172097;201807;637;1762;467;1488;75;254;212;694;287;948
172100;201807;45692;118705;31121;94580;6974;23046;9378;29740;16352;52786
172110;201807;1598;6050;1394;5726;146;635;1054;4495;1200;5130
172120;201807;4994;15330;3944;13596;691;2435;2028;7236;2719;9671
172125;201807;295;856;213;715;28;107;118;401;146;508
172130;201807;938;2959;797;2719;23;80;631;2186;654;2266
172208;201807;2435;6365;1946;5678;274;731;1217;3673;1491;4404
172210;201807;2749;7523;2134;6687;436;1419;1129;3583;1565;5002
210005;201807;20026;59943;16135;53639;4714;16360;6279;21837;10993;38197
210010;201807;1801;5892;1629;5611;50;208;1434;4966;1484;5174
210015;201807;3388;10290;3004;9747;147;394;2560;8490;2707;8884
210020;201807;7564;17250;6728;16295;96;259;6245;15087;6341;15346
210030;201807;4935;16466;4665;16091;235;1084;4029;13796;4264;14880
210040;201807;2203;6107;1992;5867;33;58;1863;5574;1896;5632
210043;201807;6800;18210;5515;16675;679;1927;3945;12568;4624;14495
210047;201807;6531;21970;5777;20912;251;1185;5002;18007;5253;19192
210050;201807;2210;7766;1758;6907;238;1028;1115;4419;1353;5447
210055;201807;1799;6036;1653;5788;65;279;1365;4766;1430;5045
210060;201807;6891;26549;6195;25160;821;3497;4308;17956;5129;21453
210070;201807;7358;21056;6925;20544;40;123;6646;19878;6686;20001
210080;201807;3902;13934;3808;13819;24;120;3707;13483;3731;13603
210083;201807;5273;16155;4553;15370;94;524;4292;14364;4386;14888
210087;201807;2930;8343;2623;7921;146;392;2203;6832;2349;7224
210090;201807;9604;30186;9124;29396;277;1052;8250;26414;8527;27466
210095;201807;6069;20711;5656;20184;269;1073;4941;17802;5210;18875
210100;201807;6906;20818;6355;20035;232;901;5392;17001;5624;17902
210110;201807;2814;9117;2658;8907;34;158;2487;8334;2521;8492
210120;201807;24347;67986;20782;63479;2765;7231;13953;45542;16718;52773
210125;201807;3996;11673;3685;11274;731;1791;2681;8750;3412;10541
210130;201807;4146;11563;3593;10855;168;484;3067;9309;3235;9793
210135;201807;1463;4545;1310;4303;59;246;1081;3547;1140;3793
210140;201807;17614;51608;14350;47164;3039;10109;7895;26920;10934;37029
210150;201807;4590;11309;4114;10678;88;293;3684;9448;3772;9741
210160;201807;16439;50446;14983;48310;1421;4657;11145;36942;12566;41599
210170;201807;14417;47729;13716;46804;647;2298;12236;41973;12883;44271
210173;201807;2421;9052;2273;8821;53;306;2098;8130;2151;8436
210177;201807;3153;9368;2958;9133;73;178;2772;8699;2845;8877
210180;201807;1476;4175;1329;3971;33;119;1172;3478;1205;3597
210190;201807;4766;14502;4330;13714;117;593;3576;11054;3693;11647
210193;201807;1228;3784;1112;3603;47;172;895;2919;942;3091
210197;201807;2036;6706;1881;6506;194;641;1465;5217;1659;5858
210200;201807;7630;25340;7053;24481;645;2293;5665;19981;6310;22274
210203;201807;6970;21408;6391;20626;522;1612;5320;17453;5842;19065
210207;201807;3578;10472;3218;9981;163;435;2641;8403;2804;8838
210210;201807;8281;27505;7808;26853;104;589;7251;24884;7355;25473
210215;201807;2059;6955;1884;6710;64;328;1659;5875;1723;6203
210220;201807;6002;21372;5687;20831;231;1311;4961;17834;5192;19145
210230;201807;5153;16103;4730;15482;241;669;4173;13852;4414;14521
210232;201807;11686;37558;9647;34684;1473;5495;6297;24027;7770;29522
210235;201807;3632;10895;3186;10325;120;496;2789;9060;2909;9556
210237;201807;2428;8739;2258;8530;24;128;2152;8143;2176;8271
210240;201807;2745;8708;2521;8329;93;379;2186;7180;2279;7559
210250;201807;5513;17221;5083;16687;111;577;4549;14890;4660;15467
210255;201807;2655;8242;2314;7615;284;979;1580;5158;1864;6137
210260;201807;5140;16267;4603;15447;294;1085;3802;12802;4096;13887
210270;201807;4968;14075;4465;13392;104;499;3956;11769;4060;12268
210275;201807;3644;9234;3305;8828;70;129;3098;8406;3168;8535
210280;201807;5607;16628;4644;15136;260;1279;3377;10714;3637;11993
210290;201807;6576;19401;6053;18760;158;572;5440;16881;5598;17453
210300;201807;35561;96476;29451;88684;2032;6300;21943;69032;23975;75332
210310;201807;3050;8047;2754;7646;76;156;2477;6936;2553;7092
210312;201807;2517;7035;2245;6711;63;249;2040;6067;2103;6316
210315;201807;2911;8378;2483;7868;78;203;2200;7187;2278;7390
210317;201807;4081;12957;3774;12601;114;505;3472;11547;3586;12052
210320;201807;19323;61908;18031;60205;528;2423;16237;54117;16765;56540
210325;201807;3539;10564;3121;9961;95;348;2770;8950;2865;9298
210330;201807;28132;78010;23162;71754;5812;16950;11709;41797;17521;58747
210340;201807;10603;32194;9551;30643;1003;3076;6982;23299;7985;26375
210350;201807;9477;28121;8464;26781;262;942;7294;23233;7556;24175
210355;201807;4225;14597;3706;13775;145;737;3086;11596;3231;12333
210360;201807;14711;44351;13224;42226;677;2735;10801;34233;11478;36968
210370;201807;10240;23522;8100;21238;265;539;7275;19538;7540;20077
210375;201807;3113;8902;2448;7998;661;2150;1180;4148;1841;6298
210380;201807;5708;15229;5087;14435;274;693;4345;12525;4619;13218
210390;201807;2679;9799;2506;9500;149;719;2067;7782;2216;8501
210400;201807;4690;14691;4293;14195;129;345;3935;13197;4064;13542
210405;201807;7439;20532;5998;18444;1145;3355;3324;10870;4469;14225
210407;201807;1969;6807;1646;6175;136;629;1271;4665;1407;5294
210408;201807;2379;9246;2254;9070;155;792;1843;7500;1998;8292
210409;201807;3708;13139;3405;12702;129;703;2856;10644;2985;11347
210410;201807;3590;11300;3159;10614;242;848;2388;8134;2630;8982
210420;201807;4102;13218;3702;12510;179;587;3117;10656;3296;11243
210430;201807;2220;6613;2089;6458;110;296;1836;5739;1946;6035
210440;201807;4177;11940;3893;11559;77;257;3664;10895;3741;11152
210450;201807;2603;8055;2327;7601;139;528;1878;6079;2017;6607
210455;201807;3859;10684;3188;9864;777;2355;1876;6010;2653;8365
210460;201807;3410;10587;3086;10119;114;462;2641;8652;2755;9114
210462;201807;1498;5031;1332;4716;56;263;1081;3781;1137;4044
210465;201807;2640;8007;2317;7558;83;288;1991;6526;2074;6814
210467;201807;5977;19762;5499;19183;295;1176;4795;16819;5090;17995
210470;201807;2124;5598;1469;4642;82;200;1115;3638;1197;3838
210480;201807;15574;47798;13208;44752;1458;4714;9539;34303;10997;39017
210490;201807;3775;9857;3123;8927;71;239;2730;7789;2801;8028
210500;201807;6206;25121;5829;24410;408;2058;4690;19510;5098;21568
210510;201807;6088;20933;5624;20379;139;600;5053;18581;5192;19181
210515;201807;3643;11082;3276;10691;122;378;2945;9764;3067;10142
210520;201807;2601;7557;2317;7190;100;344;2049;6386;2149;6730
210530;201807;49790;132430;40957;118873;7048;25310;12124;42680;19172;67990
210535;201807;3202;10917;3012;10626;98;376;2628;9378;2726;9754
210540;201807;14352;43857;12208;40972;1491;4882;8667;30285;10158;35167
210542;201807;6120;15767;5219;14764;272;511;4598;13557;4870;14068
210545;201807;2322;7274;2175;7041;56;257;1916;6116;1972;6373
210547;201807;3584;12898;3268;12293;341;1269;2383;9257;2724;10526
210550;201807;5893;17902;5067;16866;319;1120;4201;14249;4520;15369
210560;201807;3624;11258;3263;10632;118;426;2803;9073;2921;9499
210565;201807;1431;5048;1221;4717;55;282;978;3824;1033;4106
210570;201807;11295;31167;10230;29897;355;896;9282;27520;9637;28416
210580;201807;2999;8385;2617;7912;252;475;2099;6737;2351;7212
210590;201807;4186;12853;3739;12260;131;643;3302;10721;3433;11364
210592;201807;2575;7818;2422;7564;37;199;2151;6633;2188;6832
210594;201807;2750;7563;2154;6625;96;265;1584;5063;1680;5328
210596;201807;2464;8995;2277;8605;189;776;1777;6769;1966;7545
210598;201807;1812;5332;1695;5175;38;160;1561;4739;1599;4899
210600;201807;3071;8529;2533;7763;88;252;2048;6342;2136;6594
210610;201807;2493;7717;2250;7413;93;419;1969;6408;2062;6827
210620;201807;2355;7002;2068;6648;41;105;1906;6267;1947;6372
210630;201807;3206;11146;2906;10705;173;835;2368;8625;2541;9460
210632;201807;4295;14492;3891;13880;352;1462;3035;10783;3387;12245
210635;201807;1839;6433;1728;6243;138;458;1435;5343;1573;5801
210637;201807;2468;8422;2216;8030;159;718;1689;6156;1848;6874
210640;201807;5115;19768;5041;19690;31;114;4958;19432;4989;19546
210650;201807;7129;20843;6729;20307;80;316;6394;19253;6474;19569
210660;201807;8739;25293;7768;23819;344;1224;6665;20323;7009;21547
210663;201807;2570;7813;2435;7659;122;315;2151;6960;2273;7275
210667;201807;1898;6283;1777;6095;67;287;1583;5460;1650;5747
210670;201807;4498;15801;4194;15314;156;751;3647;13259;3803;14010
210675;201807;5100;14081;4493;13279;334;814;3714;11367;4048;12181
210680;201807;4099;10651;3460;9865;152;309;3033;8867;3185;9176
210690;201807;7507;24606;6859;23887;264;1064;6056;21459;6320;22523
210700;201807;2818;7776;2373;7228;164;392;1877;6209;2041;6601
210710;201807;4909;15735;4476;15111;137;657;3931;13180;4068;13837
210720;201807;2766;9388;2599;9169;58;312;2383;8344;2441;8656
210725;201807;1265;4471;1123;4222;48;230;802;3102;850;3332
210730;201807;1224;3393;1043;3139;80;234;813;2477;893;2711
210735;201807;4569;14079;3996;13234;318;1107;3295;11069;3613;12176
210740;201807;5309;14702;4781;14159;176;637;4193;12354;4369;12991
210745;201807;4594;13015;4346;12702;161;412;3926;11574;4087;11986
210750;201807;20548;53610;17765;50310;1577;4455;13470;39050;15047;43505
210760;201807;5664;16169;5144;15604;27;97;4975;15137;5002;15234
210770;201807;6062;16184;5226;15232;76;326;4797;13965;4873;14291
210780;201807;7287;24174;6572;22959;637;2155;5014;17884;5651;20039
210790;201807;4624;14743;4292;14315;168;520;3480;12259;3648;12779
210800;201807;5027;13588;4386;12766;77;314;3994;11509;4071;11823
210805;201807;3913;14836;3765;14607;114;648;3363;12977;3477;13625
210810;201807;5103;15156;4681;14610;237;527;4072;13157;4309;13684
210820;201807;7251;21044;6259;19420;755;2336;4074;12910;4829;15246
210825;201807;6428;20457;6032;19952;246;796;5318;17867;5564;18663
210830;201807;7804;22493;7377;21957;456;986;6435;19841;6891;20827
210840;201807;3371;9075;3043;8622;87;292;2666;7486;2753;7778
210845;201807;6160;17547;5852;17214;36;90;5780;17044;5816;17134
210850;201807;5798;20403;5163;19386;391;1835;3969;14883;4360;16718
210860;201807;18478;51726;15980;48392;856;2495;13076;40611;13932;43106
210870;201807;6466;18953;5696;18033;300;967;4893;15601;5193;16568
210880;201807;4405;13769;3991;13295;237;928;3337;11107;3574;12035
210890;201807;4362;13228;3972;12762;249;641;3330;11136;3579;11777
210900;201807;4867;14277;3697;12176;1433;5042;689;2531;2122;7573
210905;201807;1926;5592;1659;5215;50;118;1472;4716;1522;4834
210910;201807;7546;23680;6534;21977;850;3045;4372;14732;5222;17777
210920;201807;3142;10665;2784;10177;104;539;2440;8857;2544;9396
210923;201807;1442;4636;1299;4413;81;334;989;3350;1070;3684
210927;201807;5031;16067;4510;15500;119;446;4093;14231;4212;14677
210930;201807;2416;8575;2227;8253;116;592;1775;6493;1891;7085
210940;201807;3691;11404;3475;11106;126;578;3081;9654;3207;10232
210945;201807;5945;18024;5598;17611;255;718;4971;15843;5226;16561
210950;201807;5202;15435;4107;13760;574;1726;2768;9736;3342;11462
210955;201807;1710;5476;1511;5164;154;505;1072;3762;1226;4267
210960;201807;8847;27580;7968;26297;1560;4730;4926;17385;6486;22115
210970;201807;1300;4296;1101;3940;97;444;807;2770;904;3214
210975;201807;1673;5573;1564;5374;132;505;1185;4064;1317;4569
210980;201807;10599;23882;9470;22727;150;329;9025;21808;9175;22137
210990;201807;16244;48218;13324;44309;1493;5161;9130;31071;10623;36232
211000;201807;14606;44731;12641;42497;660;2703;10396;35752;11056;38455
211003;201807;5218;17101;4530;16262;197;825;3848;14099;4045;14924
211010;201807;6405;23440;5936;22791;76;450;5442;21055;5518;21505
211020;201807;8067;25440;7561;24765;338;1338;6503;21367;6841;22705
211023;201807;2108;7021;1996;6858;114;459;1662;5650;1776;6109
211027;201807;2732;9623;2675;9526;204;786;2284;8121;2488;8907
211030;201807;3817;11076;3481;10677;277;633;2906;9198;3183;9831
211040;201807;4500;16508;4278;16164;146;799;3794;14277;3940;15076
211050;201807;9732;24867;8925;23875;185;484;8308;22250;8493;22734
211060;201807;6584;21855;6168;21252;181;739;5644;19486;5825;20225
211065;201807;2125;6234;1833;5821;72;234;1577;5093;1649;5327
211070;201807;7741;25891;6874;24493;526;1953;5409;19480;5935;21433
211080;201807;1318;3779;1087;3413;50;279;840;2469;890;2748
211085;201807;2004;6196;1801;5899;115;335;1509;5020;1624;5355
211090;201807;3307;9258;2981;8827;53;257;2684;7841;2737;8098
211100;201807;6439;17040;6126;16615;44;153;5750;15586;5794;15739
211102;201807;2902;10675;2689;10368;164;776;2316;8917;2480;9693
211105;201807;2361;7736;2001;7061;215;792;1394;4879;1609;5671
211107;201807;4509;14323;3976;13574;176;660;3254;11402;3430;12062
211110;201807;6028;17187;4704;15143;595;1774;3220;10720;3815;12494
211120;201807;36054;100730;33265;97355;4396;11822;24714;74848;29110;86670
211125;201807;1961;6101;1707;5687;68;294;1454;4830;1522;5124
211130;201807;187973;481906;175009;465409;25518;68597;80793;243196;106311;311793
211140;201807;5062;15719;4622;15087;218;706;3945;12918;4163;13624
211150;201807;9400;26785;8253;25319;318;1152;7052;21692;7370;22844
211153;201807;2613;7918;2213;7413;398;1397;1439;5022;1837;6419
211157;201807;1106;3553;928;3257;53;292;645;2257;698;2549
211160;201807;3961;12341;3283;11206;220;1001;2381;7900;2601;8901
211163;201807;1800;5911;1664;5710;19;74;1567;5449;1586;5523
211167;201807;1543;5018;1449;4866;28;123;1354;4530;1382;4653
211170;201807;6058;15613;5768;15266;67;226;5500;14501;5567;14727
211172;201807;2492;7014;2162;6479;93;321;1797;5219;1890;5540
211174;201807;2778;8351;2568;8073;66;327;2317;7216;2383;7543
211176;201807;4045;12487;3359;11498;241;1001;2570;8778;2811;9779
211178;201807;4641;10920;4090;10291;36;152;3863;9603;3899;9755
211180;201807;4075;13854;3809;13461;244;940;3226;11466;3470;12406
211190;201807;3061;9293;2679;8712;56;279;2323;7469;2379;7748
211195;201807;1392;4044;1179;3749;80;210;969;3188;1049;3398
211200;201807;2056;6326;1723;5877;185;682;1188;4133;1373;4815
211210;201807;6588;20263;6097;19582;282;1012;5279;17012;5561;18024
211220;201807;35420;94819;30076;88171;3379;9865;21552;65034;24931;74899
211223;201807;4972;14638;4436;13815;477;1407;3279;10429;3756;11836
211227;201807;1678;5865;1544;5652;56;284;1331;4903;1387;5187
211230;201807;7284;23019;6639;21944;525;1739;5237;17431;5762;19170
211240;201807;8134;26819;7705;26268;173;926;7039;23727;7212;24653
211245;201807;6395;17183;6145;16929;56;96;6044;16725;6100;16821
211250;201807;13779;41109;12643;39732;552;2097;10969;34249;11521;36346
211260;201807;7723;25381;7105;24552;226;962;6430;22334;6656;23296
211270;201807;10384;33947;9146;32305;391;1877;7575;26940;7966;28817
211280;201807;13473;38397;12076;36593;875;2162;9791;30876;10666;33038
211285;201807;1689;6068;1495;5718;257;1029;765;3043;1022;4072
211290;201807;7074;22536;6610;21889;232;958;5672;18743;5904;19701
211300;201807;8201;23604;7484;22661;110;341;7021;21352;7131;21693
211400;201807;11438;34524;9571;31717;1631;5398;5734;20347;7365;25745
220005;201807;1859;5089;1669;4798;42;167;1356;3798;1398;3965
220010;201807;1508;4317;1265;3896;37;157;987;2993;1024;3150
220020;201807;3303;9962;2977;9413;334;1124;2194;6883;2528;8007
220025;201807;2246;5301;1943;4851;41;128;1594;3880;1635;4008
220027;201807;1254;3330;1092;3104;34;107;878;2474;912;2581
220030;201807;3389;9121;3223;8869;108;328;2814;7617;2922;7945
220040;201807;7085;21704;6403;20424;1191;3680;4035;13119;5226;16799
220045;201807;1435;4554;1230;4177;47;240;973;3230;1020;3470
220050;201807;4531;13122;3853;12093;138;598;3322;10308;3460;10906
220060;201807;2339;5215;1972;4787;29;67;1818;4396;1847;4463
220070;201807;2507;6673;2187;6193;84;212;1785;5036;1869;5248
220080;201807;670;1996;607;1898;29;127;514;1543;543;1670
220090;201807;1825;4476;1487;4009;19;74;1278;3467;1297;3541
220095;201807;669;1768;631;1717;10;22;585;1591;595;1613
220100;201807;1352;3894;1106;3448;58;244;867;2617;925;2861
220105;201807;2068;6510;1793;5946;158;544;1306;4345;1464;4889
220110;201807;3447;9661;3226;9270;61;289;2835;8007;2896;8296
220115;201807;2677;8332;2502;8057;84;357;2230;7055;2314;7412
220117;201807;1350;3405;1055;2962;20;73;889;2450;909;2523
220120;201807;11751;34082;10795;32861;151;640;10097;30643;10248;31283
220130;201807;1050;3026;891;2786;20;134;795;2419;815;2553
220140;201807;1886;4356;1625;4030;146;377;1382;3397;1528;3774
220150;201807;6592;19787;6172;19146;149;766;5269;15974;5418;16740
220155;201807;1106;3275;868;2831;22;100;606;1930;628;2030
220157;201807;1066;2683;895;2394;17;75;715;1846;732;1921
220160;201807;2687;7889;2335;7214;53;285;1908;5745;1961;6030
220170;201807;1385;3887;1178;3562;18;96;1035;3079;1053;3175
220173;201807;1981;5785;1601;5066;40;198;1295;3954;1335;4152
220177;201807;1891;5542;1835;5474;18;66;1776;5308;1794;5374
220180;201807;1172;3003;914;2514;10;48;668;1726;678;1774
220190;201807;5800;16279;5000;15168;437;1386;3721;11345;4158;12731
220191;201807;1406;4546;1306;4363;85;360;944;3086;1029;3446
220192;201807;1846;5109;1466;4431;29;110;1157;3425;1186;3535
220194;201807;1718;5056;1529;4733;78;321;1234;3726;1312;4047
220196;201807;1982;5494;1795;5166;51;221;1492;4186;1543;4407
220198;201807;1244;3575;1028;3277;8;24;963;3118;971;3142
220200;201807;4809;14735;4351;14129;338;1193;3471;11266;3809;12459
220202;201807;2193;6261;1882;5707;31;143;1578;4675;1609;4818
220205;201807;2581;7189;2284;6728;39;164;1963;5686;2002;5850
220207;201807;827;2510;699;2283;64;250;473;1532;537;1782
220208;201807;1726;5449;1411;4802;280;1037;671;2280;951;3317
220209;201807;1623;4735;1392;4330;26;125;1114;3436;1140;3561
220210;201807;1610;4236;1375;3832;27;120;1118;3009;1145;3129
220211;201807;1538;4144;1441;4012;24;98;1261;3516;1285;3614
220213;201807;1725;4752;1509;4332;30;122;1220;3382;1250;3504
220217;201807;1989;6213;1897;6096;37;152;1763;5704;1800;5856
220220;201807;10348;27736;8745;25231;587;1582;6277;18504;6864;20086
220225;201807;1157;3074;934;2783;17;70;813;2387;830;2457
220230;201807;5758;14510;4990;13487;208;558;4289;11610;4497;12168
220240;201807;2929;8757;2680;8289;88;322;2186;6728;2274;7050
220245;201807;1584;4029;1269;3614;12;44;1132;3281;1144;3325
220250;201807;2824;8352;2487;7900;37;170;2213;7009;2250;7179
220253;201807;1688;4666;1416;4187;88;275;1151;3329;1239;3604
220255;201807;1923;4802;1597;4302;35;168;1320;3386;1355;3554
220260;201807;4282;13538;3771;12630;223;815;2955;9868;3178;10683
220265;201807;1241;4146;1130;3972;61;271;874;3028;935;3299
220270;201807;6605;21036;6209;20320;327;1422;5112;16201;5439;17623
220271;201807;1502;3958;1291;3643;45;142;1099;3102;1144;3244
220272;201807;1714;5004;1531;4657;39;151;1185;3506;1224;3657
220273;201807;1195;3486;1017;3146;39;160;780;2361;819;2521
220275;201807;2256;5512;1732;4806;44;161;1491;4101;1535;4262
220277;201807;2156;5643;1853;5165;36;122;1543;4202;1579;4324
220280;201807;1599;4046;1342;3641;44;146;1110;2910;1154;3056
220285;201807;1538;3976;1284;3646;21;89;1142;3201;1163;3290
220290;201807;6036;18509;4958;16972;420;1677;3580;12257;4000;13934
220300;201807;1895;5885;1590;5436;56;334;1297;4326;1353;4660
220310;201807;2795;8181;2315;7627;59;302;1958;6349;2017;6651
220320;201807;2925;8768;2357;7685;143;583;1784;5692;1927;6275
220323;201807;1610;5162;1299;4657;83;370;1023;3615;1106;3985
220325;201807;1262;3817;1065;3447;42;187;847;2713;889;2900
220327;201807;1396;4204;1236;3927;51;242;1021;3148;1072;3390
220330;201807;4087;10467;3443;9610;132;389;2872;7970;3004;8359
220335;201807;1788;5413;1587;5181;34;103;1440;4729;1474;4832
220340;201807;1838;4936;1465;4308;58;219;1027;2893;1085;3112
220342;201807;1156;3538;1039;3358;42;178;824;2641;866;2819
220345;201807;3062;7146;2484;6349;19;59;2350;5991;2369;6050
220350;201807;3489;9236;2821;8147;156;511;2069;5874;2225;6385
220360;201807;1250;3227;1007;2843;24;77;800;2235;824;2312
220370;201807;9052;25752;8188;24535;231;959;7227;21389;7458;22348
220375;201807;1456;4471;1352;4321;7;25;1311;4193;1318;4218
220380;201807;1528;3741;1256;3352;32;95;1080;2834;1112;2929
220385;201807;812;2002;634;1686;8;29;544;1409;552;1438
220390;201807;8741;25115;7352;22676;1885;5711;3112;10230;4997;15941
220400;201807;1506;3689;1138;3099;30;108;871;2288;901;2396
220410;201807;1175;3329;975;2997;60;194;777;2345;837;2539
220415;201807;824;2218;704;2018;23;77;524;1465;547;1542
220420;201807;2019;5718;1645;4995;68;227;1254;3734;1322;3961
220430;201807;2486;6726;2414;6631;75;229;2173;5923;2248;6152
220435;201807;1723;4741;1529;4434;55;191;1177;3339;1232;3530
220440;201807;2458;7949;2153;7440;136;540;1743;5919;1879;6459
220450;201807;2276;6393;1879;5854;196;699;1392;4306;1588;5005
220455;201807;1319;4162;1247;4065;28;133;1106;3576;1134;3709
220460;201807;946;2434;852;2325;45;147;743;1983;788;2130
220465;201807;2359;7517;2115;7141;147;567;1625;5494;1772;6061
220470;201807;3582;10260;3203;9642;114;408;2572;7598;2686;8006
220480;201807;2467;6708;2005;5936;148;373;1462;4277;1610;4650
220490;201807;2355;6228;2142;5969;41;183;1910;5247;1951;5430
220500;201807;2739;7371;2447;6886;63;268;1960;5293;2023;5561
220510;201807;2709;7912;2200;6998;92;288;1679;5365;1771;5653
220515;201807;1719;4175;1525;3910;43;102;1337;3415;1380;3517
220520;201807;5074;13319;4590;12624;118;352;4063;11150;4181;11502
220525;201807;1247;3397;1132;3239;17;76;1004;2835;1021;2911
220527;201807;1294;3763;1140;3495;31;106;956;2947;987;3053
220530;201807;1227;3403;1104;3218;29;119;1019;2916;1048;3035
220535;201807;803;2294;741;2212;57;179;591;1764;648;1943
220540;201807;3366;10649;3167;10307;117;505;2742;8848;2859;9353
220545;201807;1364;4368;1275;4195;90;361;1036;3345;1126;3706
220550;201807;8939;27817;8050;26270;651;2434;5975;19187;6626;21621
220551;201807;1443;4347;1261;4035;52;216;989;3095;1041;3311
220552;201807;1523;4541;1286;4078;41;204;1035;3187;1076;3391
220553;201807;1598;4436;1355;4052;49;131;1057;3253;1106;3384
220554;201807;855;2339;646;1981;33;85;469;1421;502;1506
220555;201807;2027;6645;1885;6396;67;341;1544;5169;1611;5510
220556;201807;1312;3925;1126;3528;57;244;817;2437;874;2681
220557;201807;1552;4798;1324;4320;85;323;952;3030;1037;3353
220558;201807;1396;3710;1083;3274;28;127;904;2688;932;2815
220559;201807;1639;4345;1406;3965;12;55;1157;3268;1169;3323
220560;201807;1729;4070;1388;3602;44;108;1213;3133;1257;3241
220570;201807;7241;22446;6642;21502;529;1803;5149;16706;5678;18509
220580;201807;6700;19382;6321;18768;147;541;5613;16482;5760;17023
220585;201807;1933;6408;1744;6048;72;307;1412;4869;1484;5176
220590;201807;1280;3657;1084;3358;100;308;782;2447;882;2755
220595;201807;2469;6846;2278;6593;17;93;2118;6059;2135;6152
220600;201807;1442;3234;1179;2899;141;225;926;2372;1067;2597
220605;201807;1710;5016;1457;4563;36;166;1128;3424;1164;3590
220610;201807;2875;8995;2697;8740;43;191;2456;7945;2499;8136
220620;201807;7876;24849;7335;24097;246;1131;6588;21413;6834;22544
220630;201807;374;1130;294;990;41;145;178;612;219;757
220635;201807;1687;5410;1485;4980;75;304;1074;3549;1149;3853
220640;201807;2705;7440;2294;6816;99;368;1884;5511;1983;5879
220650;201807;2073;5965;1778;5435;67;246;1380;4171;1447;4417
220660;201807;2728;8397;2371;7857;104;502;1951;6249;2055;6751
220665;201807;1301;4044;1130;3754;29;150;947;3104;976;3254
220667;201807;1645;5314;1475;5007;87;341;1153;3906;1240;4247
220669;201807;1723;5399;1650;5267;93;413;1363;4250;1456;4663
220670;201807;2168;5807;1781;5341;43;148;1572;4673;1615;4821
220672;201807;3033;7711;2484;7051;119;366;2168;6125;2287;6491
220675;201807;1244;3475;1136;3270;55;153;894;2553;949;2706
220680;201807;2631;7428;2495;7237;119;321;2213;6423;2332;6744
220690;201807;1576;4301;1381;3983;128;336;1020;2987;1148;3323
220695;201807;952;2663;864;2494;23;77;713;2033;736;2110
220700;201807;8941;23436;7253;20988;366;1185;5530;15832;5896;17017
220710;201807;848;2437;646;2046;42;119;463;1457;505;1576
220720;201807;2059;5112;1859;4809;31;107;1593;4070;1624;4177
220730;201807;1318;3769;1114;3438;26;120;918;2766;944;2886
220735;201807;1003;2409;764;2011;26;77;629;1611;655;1688
220740;201807;1430;4037;1146;3664;39;149;967;3105;1006;3254
220750;201807;3669;10066;3334;9566;191;526;2866;8216;3057;8742
220755;201807;1178;3122;1007;2850;37;143;792;2166;829;2309
220760;201807;3016;8989;2654;8494;118;396;2238;7250;2356;7646
220770;201807;21016;66367;18146;61082;6198;21502;6012;21221;12210;42723
220775;201807;1144;3031;1068;2936;15;54;1034;2834;1049;2888
220777;201807;1571;4159;1243;3613;44;123;924;2675;968;2798
220779;201807;1381;3382;1231;3170;32;108;1061;2696;1093;2804
220780;201807;5620;14621;4829;13332;232;794;3901;10468;4133;11262
220785;201807;1424;3239;1290;3046;15;27;1224;2887;1239;2914
220790;201807;10208;29663;9197;28174;323;1448;7658;23030;7981;24478
220793;201807;850;2314;703;2058;26;74;575;1694;601;1768
220795;201807;1438;3816;1289;3623;30;119;1140;3163;1170;3282
220800;201807;16761;41558;14126;37708;860;2388;10025;26340;10885;28728
220810;201807;2969;8541;2576;7825;63;269;2128;6327;2191;6596
220820;201807;5259;13854;4535;12830;429;1132;3369;9567;3798;10699
220830;201807;7185;19761;6510;18756;292;942;5383;15392;5675;16334
220840;201807;12574;39192;10801;35577;2346;7466;5530;18780;7876;26246
220850;201807;3003;9639;2746;9311;77;403;2447;8212;2524;8615
220855;201807;605;1705;527;1572;16;74;434;1269;450;1343
220860;201807;1014;2562;878;2348;20;66;780;2067;800;2133
220865;201807;2553;6878;2007;5934;58;220;1556;4464;1614;4684
220870;201807;2651;8010;2210;7407;37;185;2002;6663;2039;6848
220880;201807;5199;12897;4633;12205;76;255;4262;11148;4338;11403
220885;201807;1284;4304;1101;3978;59;303;848;3054;907;3357
220887;201807;1351;3154;1210;2961;8;33;1135;2740;1143;2773
220890;201807;1593;5137;1339;4641;100;362;992;3460;1092;3822
220900;201807;2007;5041;1687;4584;47;130;1457;3908;1504;4038
220910;201807;1511;4353;1269;3983;45;158;1059;3307;1104;3465
220915;201807;989;2678;794;2296;18;73;626;1750;644;1823
220920;201807;1413;4746;1206;4452;89;412;924;3373;1013;3785
220930;201807;1594;4632;1401;4332;38;161;1239;3764;1277;3925
220935;201807;1031;2972;809;2504;34;140;540;1541;574;1681
220937;201807;1365;3742;1186;3465;27;110;960;2730;987;2840
220940;201807;1390;4117;1157;3658;37;170;860;2629;897;2799
220945;201807;424;1487;377;1399;29;148;263;944;292;1092
220950;201807;1397;3320;912;2530;19;67;711;1901;730;1968
220955;201807;1564;4146;1364;3801;35;96;1160;3228;1195;3324
220960;201807;880;2240;679;1918;13;51;521;1433;534;1484
220965;201807;1749;4897;1561;4618;33;188;1340;3848;1373;4036
220970;201807;1789;4712;1393;4068;56;164;1117;3259;1173;3423
220975;201807;712;2188;624;2072;23;149;554;1748;577;1897
220980;201807;1200;3465;1078;3267;38;163;880;2617;918;2780
220985;201807;1192;3350;1079;3179;49;200;823;2300;872;2500
220987;201807;1487;4469;1288;4120;66;304;1044;3252;1110;3556
220990;201807;1752;4973;1513;4594;35;189;1214;3570;1249;3759
220995;201807;1208;3589;932;3111;63;249;656;2179;719;2428
220997;201807;2431;7134;2278;6911;57;232;2059;6162;2116;6394
221000;201807;4108;11879;3781;11371;125;586;3171;9301;3296;9887
221005;201807;1445;4081;1303;3818;72;257;1042;2929;1114;3186
221010;201807;1238;3005;1014;2727;25;70;881;2333;906;2403
221020;201807;1570;4888;1446;4641;45;210;1068;3368;1113;3578
221030;201807;1591;4344;1371;4025;43;186;1143;3302;1186;3488
221035;201807;1391;3781;1248;3592;26;50;1124;3317;1150;3367
221037;201807;587;1751;508;1607;13;69;352;1056;365;1125
221038;201807;533;1516;418;1301;16;54;295;908;311;962
221039;201807;891;2409;785;2239;22;100;657;1802;679;1902
221040;201807;4278;13077;3852;12319;183;658;3020;9651;3203;10309
221050;201807;3667;10129;3330;9691;64;247;3012;8694;3076;8941
221060;201807;8535;23862;7088;21548;295;951;5448;16846;5743;17797
221062;201807;1216;4072;1055;3760;53;271;817;2846;870;3117
221063;201807;1200;3544;1027;3273;83;320;722;2228;805;2548
221065;201807;2678;6993;2349;6428;37;129;2032;5461;2069;5590
221070;201807;3429;10920;2870;9807;259;912;1949;6706;2208;7618
221080;201807;3534;8708;2855;7686;65;258;2327;6168;2392;6426
221090;201807;1396;3761;1153;3319;20;86;993;2779;1013;2865
221093;201807;1440;4193;1335;3978;138;435;866;2498;1004;2933
221095;201807;892;2372;755;2151;5;15;627;1745;632;1760
221097;201807;826;2191;643;1851;26;92;468;1287;494;1379
221100;201807;104927;293126;91288;269945;15073;46255;54430;158728;69503;204983
221110;201807;10087;30646;9332;29647;239;1216;8163;25479;8402;26695
221120;201807;4290;12725;3942;12149;256;894;3264;9972;3520;10866
221130;201807;4906;13264;3759;10948;958;2719;1590;4687;2548;7406
221135;201807;1593;4446;1432;4226;48;184;1248;3637;1296;3821
221140;201807;1318;3204;1152;2973;10;40;1026;2592;1036;2632
221150;201807;1120;2808;880;2385;24;105;686;1741;710;1846
221160;201807;807;2025;716;1900;31;66;572;1514;603;1580
221170;201807;1072;3140;968;2971;28;99;789;2408;817;2507
230010;201807;3211;8646;2595;7556;152;516;1946;5546;2098;6062
230015;201807;2938;9857;2697;9375;281;1163;1813;6170;2094;7333
230020;201807;13248;42274;12671;41325;470;1946;10778;34729;11248;36675
230030;201807;12357;32819;10750;30515;233;795;9420;26631;9653;27426
230040;201807;4263;11382;3618;10307;113;453;2948;8280;3061;8733
230050;201807;2729;8773;2011;6945;421;1393;751;2606;1172;3999
230060;201807;2348;6552;1912;5714;51;211;1543;4508;1594;4719
230070;201807;4020;11166;3323;9770;173;574;2256;6673;2429;7247
230075;201807;9143;30041;8454;28783;409;2024;6875;22845;7284;24869
230080;201807;2749;6189;2160;5359;29;132;1926;4705;1955;4837
230090;201807;4115;10792;3546;9863;200;619;2699;7386;2899;8005
230100;201807;17793;48718;15948;45996;1666;5142;10584;30520;12250;35662
230110;201807;12251;37315;10812;34371;1948;6239;5869;18807;7817;25046
230120;201807;7510;20810;6585;19277;585;1588;4761;14189;5346;15777
230125;201807;3079;8440;2523;7501;97;357;1918;5650;2015;6007
230130;201807;5725;18120;4751;15981;449;1675;3112;10239;3561;11914
230140;201807;3521;10738;2984;9697;146;620;2170;6893;2316;7513
230150;201807;1610;4878;1357;4316;226;670;747;2465;973;3135
230160;201807;6438;17474;5583;16156;189;718;4626;13162;4815;13880
230170;201807;6025;17885;5190;16264;273;968;3793;11665;4066;12633
230180;201807;1628;4645;1384;4148;32;148;1076;3099;1108;3247
230185;201807;4072;12407;3536;11455;316;1149;2551;8271;2867;9420
230190;201807;13131;39509;11261;35867;1754;5816;5989;19162;7743;24978
230195;201807;5198;15522;4622;14524;307;1068;3599;11158;3906;12226
230200;201807;4920;13713;4272;12446;182;574;3343;9529;3525;10103
230205;201807;4078;12798;3668;12058;200;837;2729;8805;2929;9642
230210;201807;9755;25193;8316;23109;506;1627;6140;16911;6646;18538
230220;201807;13585;35884;12097;33478;560;1739;9893;27015;10453;28754
230230;201807;6952;21357;6236;19875;480;1601;4483;14203;4963;15804
230240;201807;12972;34894;11441;32404;431;1374;9283;26007;9714;27381
230250;201807;9206;27093;9069;26873;375;1411;7116;20559;7491;21970
230260;201807;14278;45191;12839;42284;1713;5925;7605;25320;9318;31245
230270;201807;7503;21001;6049;18268;569;1766;3992;12108;4561;13874
230280;201807;20583;56986;17257;51275;806;3212;13304;38227;14110;41439
230290;201807;4683;13545;4040;12208;420;1171;2915;8887;3335;10058
230300;201807;4410;12520;4157;12157;117;513;3644;10409;3761;10922
230310;201807;4801;13887;4085;12626;166;673;2868;8606;3034;9279
230320;201807;7596;22207;6620;20381;342;1341;5045;15249;5387;16590
230330;201807;4760;13341;3917;11695;202;649;2891;8500;3093;9149
230340;201807;3576;11511;3072;10462;284;1019;2096;7080;2380;8099
230350;201807;18702;53197;16699;49788;1136;3990;10760;32396;11896;36386
230360;201807;2935;8179;2341;7073;161;572;1597;4733;1758;5305
230365;201807;3069;7821;2583;7033;63;296;2153;5743;2216;6039
230370;201807;54571;161067;47160;149205;9619;31102;23768;77812;33387;108914
230380;201807;6534;18431;5210;15910;195;748;3733;11193;3928;11941
230390;201807;3336;10161;2906;9414;142;616;2182;6929;2324;7545
230393;201807;2982;9345;2507;8352;113;579;1905;6081;2018;6660
230395;201807;5747;15893;5032;14635;482;1374;3405;10014;3887;11388
230400;201807;5719;16303;5071;15188;178;805;4007;11609;4185;12414
230410;201807;14716;44612;12013;39235;1353;4586;7493;24618;8846;29204
230420;201807;25771;75972;21982;68679;3028;10049;12270;37990;15298;48039
230423;201807;4673;14062;4084;12872;125;539;3260;10091;3385;10630
230425;201807;5523;17563;5047;16537;515;1716;3475;11390;3990;13106
230426;201807;2585;7013;1958;5779;42;174;1492;4334;1534;4508
230427;201807;1832;5305;1277;4030;64;221;881;2670;945;2891
230428;201807;9740;27286;8661;25563;1275;3907;5049;14857;6324;18764
230430;201807;4562;13577;3857;12297;206;787;2854;8854;3060;9641
230435;201807;5589;15673;4788;14281;580;1782;2972;8865;3552;10647
230440;201807;395042;1043167;332981;944380;51810;154197;182988;517511;234798;671708
230445;201807;4380;11778;3680;10553;230;649;2539;7148;2769;7797
230450;201807;3534;10664;3102;9894;213;860;2229;6973;2442;7833
230460;201807;2056;6022;1787;5552;86;354;1438;4430;1524;4784
230465;201807;3988;11487;3376;10358;112;511;2464;7273;2576;7784
230470;201807;11250;38338;10262;36410;907;3880;7444;26011;8351;29891
230480;201807;1438;4319;1222;3899;113;446;876;2697;989;3143
230490;201807;2345;6864;2038;6273;215;708;1196;3566;1411;4274
230495;201807;5780;17704;5145;16515;437;1745;3354;10560;3791;12305
230500;201807;8601;29330;8035;28218;417;1784;6275;21987;6692;23771
230510;201807;1647;5322;1218;4299;231;874;505;1760;736;2634
230520;201807;4363;12911;3912;12038;307;1020;2751;8340;3058;9360
230523;201807;15328;46461;12634;40605;2984;9725;3259;10993;6243;20718
230526;201807;3874;11319;3296;10256;153;655;2509;7580;2662;8235
230530;201807;5292;16616;4565;15297;445;1611;3187;10720;3632;12331
230533;201807;4126;10694;3528;9596;130;365;2852;7691;2982;8056
230535;201807;5561;15683;4706;14154;320;965;3204;9793;3524;10758
230540;201807;16283;45919;14518;43198;375;1580;12310;36072;12685;37652
230550;201807;20177;56122;16852;50149;1991;6347;9850;29114;11841;35461
230560;201807;7619;19879;6288;17525;103;414;5183;14232;5286;14646
230565;201807;3172;8753;2608;7741;86;345;1978;5790;2064;6135
230570;201807;3589;9238;3105;8593;75;229;2594;7127;2669;7356
230580;201807;9980;27908;8877;26273;368;1360;7415;21702;7783;23062
230590;201807;8914;26299;7395;23384;591;2115;5134;15766;5725;17881
230600;201807;3691;9889;2776;8093;100;337;1819;5367;1919;5704
230610;201807;6474;18677;5796;17600;518;1574;4339;13227;4857;14801
230620;201807;2108;5839;1617;4819;139;449;979;2830;1118;3279
230625;201807;8114;24396;7074;22294;2136;6962;1905;6277;4041;13239
230630;201807;10210;31719;9081;29388;2349;7082;4044;14088;6393;21170
230640;201807;27081;83959;24705;80022;1793;6825;19213;61552;21006;68377
230650;201807;4994;14244;4349;13027;277;935;3302;9700;3579;10635
230655;201807;9321;32762;8874;31948;692;2767;6899;24992;7591;27759
230660;201807;6320;18802;5173;16608;198;1033;4148;12990;4346;14023
230670;201807;6105;15165;4563;12551;198;610;3535;9470;3733;10080
230680;201807;2558;7351;2189;6632;212;650;1460;4421;1672;5071
230690;201807;6471;19990;5871;18691;567;2031;3613;11276;4180;13307
230700;201807;9549;25505;8283;23149;381;1284;6173;16662;6554;17946
230710;201807;7107;22489;6178;20591;545;1993;4433;14624;4978;16617
230720;201807;1912;5778;1579;5061;133;426;1038;3267;1171;3693
230725;201807;3640;11716;3209;10712;614;2175;1406;4604;2020;6779
230730;201807;56120;159227;46300;143247;11206;37265;15957;51834;27163;89099
230740;201807;6062;17364;5344;16128;167;673;4242;12645;4409;13318
230750;201807;8364;23041;7044;20827;229;879;5467;15713;5696;16592
230760;201807;11482;31778;10234;29659;738;2473;7449;21064;8187;23537
230763;201807;4467;12926;3823;11705;173;711;2968;8760;3141;9471
230765;201807;40508;117284;34574;106740;7287;23623;13680;42637;20967;66260
230770;201807;25890;68016;22206;62836;2915;8698;13749;38980;16664;47678
230780;201807;5918;21430;5571;20709;906;3393;3258;12507;4164;15900
230790;201807;2960;8774;2650;8250;158;612;1985;6068;2143;6680
230800;201807;7788;25861;7005;24188;915;3543;4038;13745;4953;17288
230810;201807;11825;36235;10699;34331;513;2031;8173;25681;8686;27712
230820;201807;3216;10670;2760;9666;304;1251;1665;5638;1969;6889
230830;201807;7516;21494;6457;19548;187;807;5183;15351;5370;16158
230835;201807;4091;10060;3189;8622;115;373;2579;6828;2694;7201
230837;201807;3178;10173;2713;9257;148;705;2028;6703;2176;7408
230840;201807;9007;27314;7891;25404;562;2013;6005;19306;6567;21319
230850;201807;9207;27700;8131;25587;517;1865;5762;17971;6279;19836
230860;201807;5132;13674;4339;12479;157;555;3642;10346;3799;10901
230870;201807;17285;43395;14909;39648;579;1703;11698;30897;12277;32600
230880;201807;2058;6518;1899;6242;74;388;1470;4673;1544;5061
230890;201807;4448;14806;4101;14132;371;1411;2921;9968;3292;11379
230900;201807;3044;9264;2559;8266;249;859;1633;5149;1882;6008
230910;201807;3066;8604;2487;7592;92;433;1942;5789;2034;6222
230920;201807;4565;12981;4059;12218;166;644;3315;9845;3481;10489
230930;201807;6617;19249;5570;17186;420;1405;3706;11348;4126;12753
230940;201807;7851;21107;6935;19632;232;735;5706;16020;5938;16755
230945;201807;6569;19152;5692;17376;418;1386;3880;11856;4298;13242
230950;201807;6418;16386;5831;15661;160;378;5155;14090;5315;14468
230960;201807;13754;41310;12399;38665;2054;6554;6123;19433;8177;25987
230970;201807;13569;38427;11666;35248;2198;6915;5664;17223;7862;24138
230980;201807;2770;8240;2384;7550;495;1518;1321;4370;1816;5888
230990;201807;1720;4945;1423;4342;79;336;971;2833;1050;3169
231000;201807;2550;6864;2116;5975;85;242;1499;4148;1584;4390
231010;201807;3119;7987;2565;7052;133;451;2029;5414;2162;5865
231020;201807;8057;26217;7347;24653;1342;4310;4276;14892;5618;19202
231025;201807;7472;21658;6617;20195;960;2979;4324;13337;5284;16316
231030;201807;7029;21694;5685;18790;1009;3369;3005;9944;4014;13313
231040;201807;3184;9358;2738;8517;116;470;2078;6313;2194;6783
231050;201807;11910;31757;9574;27551;705;1985;6996;19837;7701;21822
231060;201807;2470;7488;2257;7119;93;379;1821;5706;1914;6085
231070;201807;8231;24559;7065;22395;1048;3432;4041;12838;5089;16270
231080;201807;3963;11790;3553;11040;145;717;2707;8087;2852;8804
231085;201807;5826;15818;5113;14910;359;1049;3805;11269;4164;12318
231090;201807;4218;11414;3212;9379;119;451;2235;6341;2354;6792
231095;201807;2064;6431;1734;5676;162;593;1197;3868;1359;4461
231100;201807;3005;9034;2542;8163;153;523;1874;6005;2027;6528
231110;201807;3419;10682;3306;10482;170;674;2428;7544;2598;8218
231120;201807;2019;6287;1755;5801;123;467;1185;3871;1308;4338
231123;201807;1897;5067;1607;4530;78;229;1209;3361;1287;3590
231126;201807;5801;16313;4630;14003;227;794;3325;9828;3552;10622
231130;201807;19449;54676;16913;51026;1642;5656;11517;34752;13159;40408
231135;201807;4237;12094;3548;10805;177;662;2537;7574;2714;8236
231140;201807;17295;50346;14306;44848;932;3819;9639;29222;10571;33041
231150;201807;5448;15518;4484;13579;775;2300;2082;6476;2857;8776
231160;201807;5911;18694;5407;17696;1119;3470;2892;9826;4011;13296
231170;201807;4316;13065;3567;11521;251;945;2424;7583;2675;8528
231180;201807;13959;40897;11921;36415;2801;8618;4928;15082;7729;23700
231190;201807;3871;11189;3361;10234;153;627;2574;7552;2727;8179
231195;201807;4553;14623;3911;13248;221;988;2891;9507;3112;10495
231200;201807;7856;25308;6828;23133;319;1586;5165;16908;5484;18494
231210;201807;4723;14422;4093;13308;209;858;3077;9741;3286;10599
231220;201807;11837;31973;9548;27515;563;1695;6863;19210;7426;20905
231230;201807;9189;29476;8229;27892;599;2331;6020;20483;6619;22814
231240;201807;11737;35308;10490;32752;1810;5706;5956;18790;7766;24496
231250;201807;1990;5346;1353;3899;103;310;777;2184;880;2494
231260;201807;3230;9549;2854;8923;332;1034;1873;5985;2205;7019
231270;201807;6535;17404;5565;15821;180;736;4237;11750;4417;12486
231280;201807;1675;5328;1567;5113;150;501;1126;3674;1276;4175
231290;201807;36565;113077;31904;103277;5705;19164;14964;48131;20669;67295
231300;201807;4011;11456;3247;9889;273;908;2104;6274;2377;7182
231310;201807;7353;19999;5989;17262;660;1891;3789;10776;4449;12667
231320;201807;7451;21288;5954;18400;149;674;4577;13938;4726;14612
231325;201807;2557;7209;2141;6513;386;1137;1178;3673;1564;4810
231330;201807;10298;31947;8640;28502;1716;5609;4355;14732;6071;20341
231335;201807;5687;15207;4810;13722;120;544;4120;11498;4240;12042
231340;201807;17830;56026;16077;53063;1155;4082;11987;39811;13142;43893
231350;201807;15572;43255;14141;41251;378;1316;12521;36321;12899;37637
231355;201807;4551;13911;4068;13054;235;883;3071;9778;3306;10661
231360;201807;7548;23300;6583;21602;513;1832;4769;15688;5282;17520
231370;201807;2298;6229;1828;5399;49;161;1395;4079;1444;4240
231375;201807;4317;13844;3947;13153;157;722;3226;10584;3383;11306
231380;201807;5829;16101;5403;15556;210;528;4514;13256;4724;13784
231390;201807;3342;10040;3011;9468;209;807;2153;6571;2362;7378
231395;201807;3963;12118;3339;11058;605;2002;1813;6101;2418;8103
231400;201807;9009;26772;8042;24913;389;1541;6165;18721;6554;20262
231410;201807;15148;47639;13451;44806;840;3137;10345;34091;11185;37228
240010;201807;2527;6997;1959;5917;201;707;1212;3539;1413;4246
240020;201807;11235;33282;9795;30558;984;3519;6163;18927;7147;22446
240030;201807;2666;7043;2504;6802;137;398;2158;5806;2295;6204
240040;201807;849;2436;696;2135;17;87;512;1507;529;1594
240050;201807;3338;8969;2736;7870;67;215;2126;5993;2193;6208
240060;201807;1409;3861;1194;3457;40;136;951;2701;991;2837
240070;201807;2227;6693;2045;6310;219;712;1483;4501;1702;5213
240080;201807;2827;7730;2420;7046;84;323;1845;5290;1929;5613
240090;201807;2256;5750;1842;5023;35;114;1498;4023;1533;4137
240100;201807;9056;23644;7483;20647;402;1235;5666;15172;6068;16407
240110;201807;4495;13391;3935;12318;306;1112;2688;8258;2994;9370
240120;201807;3629;10014;2699;8901;257;1016;1719;5815;1976;6831
240130;201807;3403;7560;2901;6833;65;196;2605;6019;2670;6215
240140;201807;2124;6365;1789;5722;186;697;1145;3589;1331;4286
240145;201807;6258;18259;5315;16615;764;2567;3291;10364;4055;12931
240150;201807;880;2666;796;2487;61;229;600;1805;661;2034
240160;201807;1443;4425;1236;4019;81;347;872;2825;953;3172
240165;201807;924;2645;788;2375;83;247;561;1686;644;1933
240170;201807;2370;6758;2019;6119;235;790;1273;3736;1508;4526
240180;201807;3104;9075;2487;7885;477;1497;1333;4368;1810;5865
240185;201807;1273;4169;1151;3969;68;293;925;3171;993;3464
240190;201807;991;3015;877;2822;28;125;717;2265;745;2390
240200;201807;11066;29763;9282;26661;1386;4120;4597;13227;5983;17347
240210;201807;2873;7645;2575;7147;62;256;2126;5684;2188;5940
240220;201807;7290;23125;6613;22074;531;2217;4828;15929;5359;18146
240230;201807;5909;15203;4825;13393;247;680;3814;10576;4061;11256
240240;201807;2198;7434;1506;5642;139;459;711;2947;850;3406
240250;201807;2777;7741;2534;7391;140;387;2058;6024;2198;6411
240260;201807;13290;41084;11781;38452;1777;5767;7145;24237;8922;30004
240270;201807;2259;6782;2038;6436;117;339;1617;5212;1734;5551
240280;201807;1631;4282;1405;3944;46;138;1145;3160;1191;3298
240290;201807;1207;3613;1004;3172;39;197;683;2007;722;2204
240300;201807;2276;5951;1640;4712;93;285;988;2750;1081;3035
240310;201807;9216;24996;7674;22295;958;2930;4121;11902;5079;14832
240320;201807;1983;5514;1488;4529;29;134;1134;3292;1163;3426
240325;201807;30966;85873;24297;74133;6361;20385;7214;23044;13575;43429
240330;201807;1526;4434;1250;3870;54;195;862;2568;916;2763
240340;201807;1981;4868;1587;4253;73;194;1242;3258;1315;3452
240350;201807;2067;5558;1918;5378;35;128;1696;4766;1731;4894
240360;201807;7685;22445;6806;21033;1217;3717;3904;12634;5121;16351
240370;201807;2059;5536;1597;4615;112;347;1051;2985;1163;3332
240375;201807;889;2303;762;2056;32;131;589;1495;621;1626
240380;201807;2333;6732;1691;5279;148;480;987;3011;1135;3491
240390;201807;941;2467;695;1956;12;39;482;1274;494;1313
240400;201807;1371;3730;1105;3221;38;139;792;2238;830;2377
240410;201807;536;1707;464;1539;49;192;284;911;333;1103
240420;201807;4676;17173;4222;16145;649;3004;2255;8411;2904;11415
240430;201807;3327;9137;2886;8275;245;844;2082;5749;2327;6593
240440;201807;2597;6048;2187;5462;180;459;1609;3952;1789;4411
240450;201807;4183;11859;3424;10447;368;1272;1999;5905;2367;7177
240460;201807;3040;8829;2802;8472;246;797;2223;6709;2469;7506
240470;201807;3628;11497;2856;9889;333;1140;1651;5876;1984;7016
240480;201807;548;1511;394;1203;37;121;186;560;223;681
240485;201807;2133;6315;1781;5611;197;634;1100;3479;1297;4113
240490;201807;1767;4422;1422;3825;45;102;1160;3133;1205;3235
240500;201807;2224;6018;1947;5623;61;213;1646;4715;1707;4928
240510;201807;1684;4602;1538;4388;86;283;1286;3594;1372;3877
240520;201807;1307;3426;1085;3112;40;161;886;2474;926;2635
240530;201807;1913;6007;1771;5748;120;457;1390;4456;1510;4913
240540;201807;2142;5584;1913;5236;84;253;1626;4424;1710;4677
240550;201807;693;1957;617;1814;36;113;464;1337;500;1450
240560;201807;3337;8992;2877;8380;300;765;2104;6263;2404;7028
240570;201807;2987;7967;2045;5878;277;846;900;2339;1177;3185
240580;201807;7638;22830;7008;21745;533;1824;5611;17310;6144;19134
240590;201807;697;1887;604;1719;20;75;457;1276;477;1351
240600;201807;1736;4796;1282;3848;84;289;817;2363;901;2652
240610;201807;4557;12627;3833;11282;208;697;2731;7893;2939;8590
240615;201807;1057;3009;850;2573;81;289;562;1614;643;1903
240620;201807;1851;5336;1592;4867;124;343;1258;3855;1382;4198
240630;201807;2081;6109;1860;5721;153;407;1264;4009;1417;4416
240640;201807;909;2532;738;2241;43;185;522;1525;565;1710
240650;201807;3938;11206;3508;10489;214;660;2711;8057;2925;8717
240660;201807;2704;7515;2436;7159;77;274;2164;6278;2241;6552
240670;201807;2496;7214;2065;6315;174;595;1289;3812;1463;4407
240680;201807;1606;4448;1290;3875;66;250;925;2688;991;2938
240690;201807;908;2367;721;2035;19;71;579;1578;598;1649
240700;201807;2466;7199;2040;6413;75;317;1578;4837;1653;5154
240710;201807;16217;43368;13840;39157;2602;7219;7552;21796;10154;29015
240720;201807;5349;14084;4651;12959;651;1914;2939;8020;3590;9934
240725;201807;1058;3121;830;2610;40;145;561;1709;601;1854
240730;201807;2130;6105;1800;5458;108;377;1358;4030;1466;4407
240740;201807;1895;5224;1586;4641;68;297;1150;3157;1218;3454
240750;201807;2327;7895;1979;7160;353;1382;1027;3756;1380;5138
240760;201807;1480;3720;1052;3042;63;153;798;2340;861;2493
240770;201807;3067;8765;2703;8240;135;528;2210;6594;2345;7122
240780;201807;5770;15616;4518;13542;570;1684;2657;8219;3227;9903
240790;201807;838;2445;701;2174;24;98;521;1591;545;1689
240800;201807;37045;99651;31529;90666;5001;15168;15398;44212;20399;59380
240810;201807;83609;229493;74220;213156;15783;45450;38208;110784;53991;156234
240820;201807;5599;17304;4899;16078;917;3086;2700;9137;3617;12223
240830;201807;8762;25950;8032;24802;333;1401;6559;19879;6892;21280
240840;201807;1143;2964;929;2589;67;193;652;1754;719;1947
240850;201807;1300;3735;946;2922;55;185;533;1623;588;1808
240860;201807;1240;3431;955;2887;24;107;722;2089;746;2196
240870;201807;1174;2989;922;2563;77;224;633;1715;710;1939
240880;201807;1285;4099;1193;3926;84;308;946;3084;1030;3392
240890;201807;4726;13148;3694;11126;619;1996;1748;5131;2367;7127
240895;201807;2714;8872;2434;8444;218;796;1928;6729;2146;7525
240910;201807;3146;8972;2699;8084;67;255;2220;6533;2287;6788
240920;201807;828;2531;703;2281;78;263;380;1243;458;1506
240930;201807;3671;8756;3123;8078;154;268;2454;6524;2608;6792
240933;201807;1905;4598;1558;4060;49;183;1287;3263;1336;3446
240940;201807;6377;15910;5037;13669;297;877;3600;9462;3897;10339
240950;201807;941;2936;835;2716;41;183;645;2039;686;2222
240960;201807;778;2378;675;2169;46;172;481;1515;527;1687
240970;201807;1780;4829;1486;4273;62;258;1210;3333;1272;3591
240980;201807;2994;9441;2723;8930;234;885;1990;6415;2224;7300
240990;201807;2552;7514;2341;7073;305;996;1617;4781;1922;5777
241000;201807;949;2563;780;2241;40;115;540;1541;580;1656
241010;201807;2754;9017;2559;8611;244;995;1822;5963;2066;6958
241020;201807;1994;5466;1490;4417;154;449;932;2715;1086;3164
241025;201807;1730;5034;1418;4436;87;292;917;2859;1004;3151
241030;201807;2429;7792;2024;6939;207;753;1343;4588;1550;5341
241040;201807;2272;7334;2032;6930;119;532;1576;5345;1695;5877
241050;201807;1304;3696;1074;3256;44;146;787;2335;831;2481
241060;201807;752;2132;664;1959;51;163;453;1319;504;1482
241070;201807;664;1855;580;1708;28;103;458;1282;486;1385
241080;201807;1125;3244;867;2730;17;78;638;1973;655;2051
241090;201807;2067;6043;1655;5316;66;314;1285;4061;1351;4375
241100;201807;1117;3247;924;2809;46;144;643;1890;689;2034
241105;201807;1117;3378;936;3032;280;930;322;1069;602;1999
241110;201807;875;2583;683;2152;32;120;449;1362;481;1482
241120;201807;7293;21420;6368;19764;1228;3640;3422;11202;4650;14842
241140;201807;3300;8788;2700;7607;163;476;1974;5401;2137;5877
241142;201807;754;2097;566;1714;36;114;325;937;361;1051
241150;201807;5695;15651;5049;14561;212;788;4005;11280;4217;12068
241160;201807;1576;4743;1385;4427;156;442;992;3230;1148;3672
241170;201807;1278;3343;1127;3083;50;161;923;2426;973;2587
241180;201807;983;2633;724;2114;70;209;417;1193;487;1402
241190;201807;1148;3090;932;2649;27;108;664;1792;691;1900
241200;201807;19455;52432;16654;48144;3435;10127;8268;24352;11703;34479
241210;201807;1417;3922;1081;3235;104;330;648;1918;752;2248
241220;201807;8785;27032;7727;25147;2178;7074;3235;11130;5413;18204
241230;201807;2931;8054;2642;7575;112;414;2195;6125;2307;6539
241240;201807;1180;3433;698;2282;44;175;334;1086;378;1261
241250;201807;5766;17212;4726;15197;219;1065;3462;10636;3681;11701
241255;201807;1923;6566;1705;6080;155;665;1152;4004;1307;4669
241260;201807;4902;13126;3886;11408;111;509;2960;8463;3071;8972
241270;201807;1805;5338;1531;4792;137;507;1080;3316;1217;3823
241280;201807;2025;5357;1803;4963;76;228;1512;4116;1588;4344
241290;201807;3302;8429;2571;7203;101;378;1975;5366;2076;5744
241300;201807;1459;4045;1210;3578;46;168;814;2337;860;2505
241310;201807;1924;5150;1677;4764;35;132;1413;3992;1448;4124
241320;201807;997;3256;831;2907;105;408;501;1744;606;2152
241330;201807;1741;4581;1384;4140;36;160;1187;3523;1223;3683
241335;201807;2995;8633;2705;8106;98;356;2278;6722;2376;7078
241340;201807;1738;5167;1385;4361;304;998;591;1817;895;2815
241350;201807;1927;5795;1724;5408;121;436;1287;3954;1408;4390
241355;201807;1335;3693;1090;3229;35;137;839;2455;874;2592
241360;201807;2099;5509;1635;4591;67;210;1173;3184;1240;3394
241370;201807;1360;3865;1075;3288;79;281;704;2056;783;2337
241380;201807;675;1875;542;1612;67;212;330;968;397;1180
241390;201807;2720;8415;2491;8035;233;758;1876;6086;2109;6844
241400;201807;3677;10290;3286;9716;227;752;2604;7644;2831;8396
241410;201807;2357;7154;2019;6516;404;1365;1084;3504;1488;4869
241415;201807;1632;4869;1374;4391;106;359;977;3071;1083;3430
241420;201807;2247;7522;1943;6942;529;2031;724;2610;1253;4641
241430;201807;529;1534;397;1245;33;112;243;743;276;855
241440;201807;7061;23133;6364;21848;498;2017;4798;16285;5296;18302
241445;201807;1031;2793;954;2701;21;48;866;2510;887;2558
241450;201807;2876;7341;2542;6833;284;720;1837;4955;2121;5675
241460;201807;3568;9998;3022;8827;201;676;2103;5960;2304;6636
241470;201807;1443;3838;1145;3400;46;165;929;2732;975;2897
241475;201807;1228;3580;972;3071;35;196;705;2099;740;2295
241480;201807;2749;8841;2384;8097;851;2876;661;2609;1512;5485
241490;201807;705;1767;556;1536;28;89;361;955;389;1044
241500;201807;824;2432;693;2262;24;116;592;1910;616;2026
250010;201807;2739;8296;2253;7240;86;356;1613;5031;1699;5387
250020;201807;1580;4369;1163;3548;57;165;819;2458;876;2623
250030;201807;6884;19264;6213;18253;389;1300;4923;14164;5312;15464
250040;201807;3909;12589;3534;11840;275;1070;2520;8297;2795;9367
250050;201807;3474;9866;3178;9425;200;699;2521;7336;2721;8035
250053;201807;1203;3521;1085;3340;92;303;784;2425;876;2728
250057;201807;661;2435;633;2396;7;37;594;2273;601;2310
250060;201807;5279;14636;4814;14023;428;1232;3772;11119;4200;12351
250070;201807;3867;11422;3517;10775;73;360;2704;8000;2777;8360
250073;201807;778;2201;646;1982;15;65;498;1471;513;1536
250077;201807;2207;6118;1660;5183;101;344;1195;3705;1296;4049
250080;201807;4358;11820;3959;11235;117;438;3353;9328;3470;9766
250090;201807;2826;7423;2582;7059;85;255;2201;5943;2286;6198
250100;201807;3795;11848;3507;11312;170;694;2848;8926;3018;9620
250110;201807;4784;13739;4408;13176;407;1454;3426;9948;3833;11402
250115;201807;531;1555;465;1443;13;67;344;1029;357;1096
250120;201807;1717;5281;1498;4906;59;272;1176;3801;1235;4073
250130;201807;5410;15773;4656;14552;123;648;3734;11439;3857;12087
250135;201807;1126;3205;1029;3050;20;87;896;2632;916;2719
250140;201807;2092;6528;2011;6407;93;422;1718;5390;1811;5812
250150;201807;4764;15644;4357;14850;197;974;3421;11372;3618;12346
250153;201807;1496;3869;1243;3502;33;130;1006;2772;1039;2902
250157;201807;1788;5510;1599;5110;165;535;1155;3692;1320;4227
250160;201807;3790;9820;3082;8849;38;125;2811;8061;2849;8186
250170;201807;1719;4639;1528;4347;51;189;1285;3599;1336;3788
250180;201807;17617;46743;15731;44143;1027;3334;11897;32703;12924;36037
250190;201807;4062;11350;3586;10571;442;1226;2406;7062;2848;8288
250200;201807;1862;5336;1569;4860;60;217;1308;4023;1368;4240
250205;201807;782;2635;732;2536;26;138;594;2024;620;2162
250210;201807;1531;4717;1391;4485;59;280;1091;3439;1150;3719
250215;201807;1550;4507;1306;4094;76;265;804;2507;880;2772
250220;201807;709;2032;578;1831;29;107;422;1312;451;1419
250230;201807;1645;3894;1215;3213;34;114;953;2423;987;2537
250240;201807;2181;6875;1997;6548;51;217;1682;5440;1733;5657
250250;201807;4489;12954;3965;12190;118;433;3283;10031;3401;10464
250260;201807;1704;4819;1442;4358;45;156;1135;3414;1180;3570
250270;201807;1234;3781;1093;3606;81;268;806;2774;887;3042
250280;201807;3305;9550;2866;8842;130;435;2257;6936;2387;7371
250290;201807;1698;4522;1442;4163;25;78;1191;3430;1216;3508
250300;201807;5361;14992;5031;14583;242;1019;4221;11840;4463;12859
250310;201807;1154;3294;991;2991;45;148;746;2215;791;2363
250320;201807;9983;26095;8989;24825;554;1696;7462;20350;8016;22046
250330;201807;2385;6997;2012;6451;144;498;1572;4989;1716;5487
250340;201807;1101;3001;973;2810;14;49;836;2374;850;2423
250350;201807;4107;11351;3711;10809;152;398;3115;9228;3267;9626
250355;201807;1961;6102;1794;5874;31;174;1622;5282;1653;5456
250360;201807;1822;5178;1675;4941;49;166;1366;4001;1415;4167
250370;201807;12073;33163;10452;30920;462;1694;8613;25134;9075;26828
250375;201807;1069;3006;950;2842;17;63;852;2565;869;2628
250380;201807;1636;4417;1519;4262;53;218;1252;3366;1305;3584
250390;201807;1836;4811;1518;4296;178;474;1026;2943;1204;3417
250400;201807;69368;178446;51287;149234;13861;42181;16709;50374;30570;92555
250403;201807;1624;4932;1485;4753;132;582;1072;3294;1204;3876
250407;201807;1234;3220;1047;2935;77;158;766;2177;843;2335
250410;201807;572;1670;503;1545;10;58;418;1243;428;1301
250415;201807;1903;5515;1690;5154;66;233;1333;4047;1399;4280
250420;201807;1237;3557;1117;3391;22;87;1029;3118;1051;3205
250430;201807;6303;16081;5477;14889;190;616;4505;11986;4695;12602
250435;201807;1386;4055;1215;3759;40;168;934;2825;974;2993
250440;201807;4494;12368;3993;11679;99;358;3401;9851;3500;10209
250450;201807;1847;5094;1568;4716;43;174;1276;3778;1319;3952
250460;201807;7085;19723;6434;18848;383;1160;5335;15664;5718;16824
250470;201807;1567;4059;1287;3655;73;234;965;2670;1038;2904
250480;201807;3755;10840;3416;10407;44;194;3097;9477;3141;9671
250485;201807;701;1625;507;1350;32;88;379;968;411;1056
250490;201807;4496;11980;4106;11497;239;794;3413;9435;3652;10229
250500;201807;1940;5511;1709;5123;87;294;1377;4103;1464;4397
250510;201807;5315;13719;4625;12783;85;269;4146;11470;4231;11739
250520;201807;1827;5146;1596;4800;181;595;1061;3139;1242;3734
250523;201807;2074;5366;1901;5150;69;317;1652;4322;1721;4639
250527;201807;1631;4398;1508;4247;37;123;1357;3808;1394;3931
250530;201807;601;1713;524;1604;18;72;458;1387;476;1459
250535;201807;1335;4023;1228;3812;41;194;977;2947;1018;3141
250540;201807;2695;6738;2294;6278;59;173;2002;5480;2061;5653
250550;201807;843;2766;757;2621;30;146;588;1973;618;2119
250560;201807;1667;4818;1525;4613;63;234;1246;3672;1309;3906
250570;201807;2558;7828;2231;7220;88;399;1770;5580;1858;5979
250580;201807;1064;2783;953;2623;48;172;789;2130;837;2302
250590;201807;828;2435;737;2294;25;119;611;1853;636;1972
250600;201807;7324;20408;6639;19364;376;1063;5485;16034;5861;17097
250610;201807;3003;8545;2750;8165;154;546;2246;6592;2400;7138
250620;201807;709;1991;617;1812;26;108;470;1335;496;1443
250625;201807;2527;7496;2333;7193;60;271;1978;5949;2038;6220
250630;201807;9728;28215;8351;25608;1117;3616;5192;15548;6309;19164
250640;201807;3342;9786;3104;9453;113;522;2592;7682;2705;8204
250650;201807;909;2288;761;2089;37;112;613;1629;650;1741
250660;201807;1660;4235;1471;3975;48;124;1274;3402;1322;3526
250670;201807;2283;7307;2147;7073;54;277;1855;5969;1909;6246
250680;201807;5607;13585;5133;13047;139;471;4636;11537;4775;12008
250690;201807;6474;15463;5878;14703;158;387;5285;13097;5443;13484
250700;201807;4350;12566;3903;11851;399;1285;2899;8709;3298;9994
250710;201807;4533;13262;3936;12449;339;1217;2840;9011;3179;10228
250720;201807;2726;7348;2474;6960;47;207;2208;6138;2255;6345
250730;201807;3886;10671;3455;10094;161;596;2872;8161;3033;8757
250740;201807;1976;5200;1634;4708;125;404;1276;3590;1401;3994
250750;201807;99896;263346;88076;246059;8827;27221;60554;165566;69381;192787
250760;201807;2361;6241;2057;5766;136;412;1570;4280;1706;4692
250770;201807;3766;12016;3445;11598;266;1067;2537;8450;2803;9517
250780;201807;1727;4843;1452;4326;116;382;1025;2980;1141;3362
250790;201807;2380;7361;2149;6995;304;1052;1360;4438;1664;5490
250800;201807;2514;6806;2154;6221;112;260;1747;5071;1859;5331
250810;201807;1278;3559;1055;3223;40;140;861;2633;901;2773
250820;201807;1817;5588;1749;5498;65;259;1571;4893;1636;5152
250830;201807;5362;16704;4773;15487;360;1427;3358;10602;3718;12029
250840;201807;841;2690;722;2437;19;89;502;1704;521;1793
250850;201807;1891;5689;1681;5330;49;254;1377;4235;1426;4489
250855;201807;1011;2973;869;2722;72;261;619;1899;691;2160
250860;201807;3211;9900;2641;8883;464;1646;1379;4693;1843;6339
250870;201807;1062;2958;904;2661;49;186;721;2087;770;2273
250880;201807;1543;4111;1258;3688;147;439;849;2512;996;2951
250890;201807;9487;26823;8855;25948;625;2446;7059;19932;7684;22378
250900;201807;2755;8244;2380;7533;99;363;1920;5955;2019;6318
250905;201807;2202;6465;2078;6292;74;280;1846;5543;1920;5823
250910;201807;5473;14550;4714;13584;137;489;3998;11518;4135;12007
250915;201807;1851;4687;1431;4252;21;51;1318;3998;1339;4049
250920;201807;3182;8718;2938;8322;302;795;2180;6119;2482;6914
250930;201807;2110;5913;1956;5690;79;311;1641;4662;1720;4973
250933;201807;1131;3545;1003;3291;34;169;738;2350;772;2519
250937;201807;698;1982;578;1763;30;108;439;1331;469;1439
250939;201807;1632;4555;1454;4271;47;195;1184;3387;1231;3582
250940;201807;3825;10743;3489;10220;65;273;3014;8776;3079;9049
250950;201807;1520;4121;1265;3784;30;128;1095;3241;1125;3369
250960;201807;1064;3237;971;3087;41;189;778;2385;819;2574
250970;201807;8442;22709;7241;20731;434;1448;5461;15353;5895;16801
250980;201807;2530;7014;2283;6565;62;258;1857;5179;1919;5437
250990;201807;1892;6140;1650;5622;92;435;1220;4062;1312;4497
251000;201807;2100;5968;1739;5392;38;168;1442;4420;1480;4588
251010;201807;2630;7575;2372;7164;40;163;2120;6400;2160;6563
251020;201807;1692;4568;1558;4403;41;124;1427;4016;1468;4140
251030;201807;1009;2785;867;2506;44;139;607;1701;651;1840
251040;201807;1817;5372;1573;4954;62;310;1263;3846;1325;4156
251050;201807;1116;3088;916;2703;77;259;651;1840;728;2099
251060;201807;1080;2363;788;1979;14;68;639;1552;653;1620
251065;201807;452;1279;372;1169;21;83;258;752;279;835
251070;201807;749;2094;645;1958;15;57;555;1666;570;1723
251080;201807;19269;50999;16065;46148;2432;7326;9592;27789;12024;35115
251090;201807;2840;8379;2422;7574;88;347;1886;5817;1974;6164
251100;201807;854;2661;755;2486;42;203;535;1670;577;1873
251110;201807;1728;4837;1496;4390;56;167;1145;3320;1201;3487
251120;201807;6800;20842;6041;19732;317;1330;4651;15040;4968;16370
251130;201807;3705;8998;3363;8608;203;533;2998;7657;3201;8190
251140;201807;4242;12221;3864;11673;116;474;3161;9457;3277;9931
251150;201807;2690;8024;2446;7649;133;576;1938;5882;2071;6458
251160;201807;1988;6211;1812;5931;94;331;1535;5019;1629;5350
251170;201807;1513;4316;1368;4148;48;167;1204;3643;1252;3810
251180;201807;2563;7251;2201;6717;202;697;1463;4415;1665;5112
251190;201807;4449;11827;4168;11491;79;344;3780;10190;3859;10534
251200;201807;4081;12644;3774;12246;99;419;3325;10834;3424;11253
251203;201807;952;3126;906;3030;44;195;687;2230;731;2425
251207;201807;1035;3063;842;2706;29;150;583;1800;612;1950
251210;201807;7362;19839;6174;18303;295;869;4917;14714;5212;15583
251220;201807;1138;2887;920;2583;44;123;721;2036;765;2159
251230;201807;4664;12845;4125;12088;180;644;3384;9688;3564;10332
251240;201807;3450;9865;2966;9154;201;694;2221;6713;2422;7407
251250;201807;9981;27962;9001;26465;813;2605;6503;18550;7316;21155
251260;201807;463;1427;418;1342;15;63;321;1010;336;1073
251270;201807;4147;13189;3729;12650;127;567;3180;10801;3307;11368
251272;201807;1324;3661;1224;3513;41;163;1078;3053;1119;3216
251274;201807;899;2617;737;2325;52;218;510;1519;562;1737
251275;201807;1238;3510;1083;3252;47;197;785;2240;832;2437
251276;201807;1261;3467;1145;3316;45;194;942;2650;987;2844
251278;201807;576;1675;518;1562;46;126;370;1131;416;1257
251280;201807;2268;6421;2036;6053;60;263;1648;4747;1708;5010
251290;201807;5666;14597;5321;14154;285;1040;4454;11380;4739;12420
251300;201807;785;2461;734;2380;18;75;614;1988;632;2063
251310;201807;2793;8143;2540;7755;85;384;2038;6077;2123;6461
251315;201807;1637;5309;1519;5100;80;303;1186;3919;1266;4222
251320;201807;1707;4591;1215;3751;43;154;860;2647;903;2801
251330;201807;1935;4789;1590;4368;36;128;1448;3967;1484;4095
251335;201807;1174;3938;1079;3786;44;202;897;3102;941;3304
251340;201807;3510;9347;2928;8572;129;430;2202;6378;2331;6808
251350;201807;1100;3352;1004;3188;36;166;818;2514;854;2680
251360;201807;1814;5324;1505;4896;29;139;1292;4222;1321;4361
251365;201807;730;2101;585;1787;14;48;445;1351;459;1399
251370;201807;22614;65315;21123;63217;2287;7387;15048;44885;17335;52272
251380;201807;1234;3647;1086;3396;25;121;909;2736;934;2857
251385;201807;728;1901;571;1623;24;74;420;1135;444;1209
251390;201807;6133;19150;5339;17665;910;3196;2988;9765;3898;12961
251392;201807;982;2787;837;2539;29;129;632;1864;661;1993
251394;201807;634;1991;538;1822;22;87;414;1389;436;1476
251396;201807;726;2014;628;1851;35;102;422;1227;457;1329
251398;201807;904;2435;685;2053;23;99;490;1416;513;1515
251400;201807;1168;3085;962;2805;43;164;718;2020;761;2184
251410;201807;1632;3949;1339;3511;27;109;1120;2847;1147;2956
251420;201807;1897;5176;1576;4805;56;230;1237;3678;1293;3908
251430;201807;1554;4956;1380;4671;48;238;1180;3941;1228;4179
251440;201807;1131;3284;918;2867;22;78;727;2267;749;2345
251445;201807;1515;4423;1414;4280;81;326;1148;3356;1229;3682
251450;201807;4427;13441;4032;12885;99;437;3356;10630;3455;11067
251455;201807;977;3019;880;2830;46;192;650;2047;696;2239
251460;201807;883;2593;787;2438;33;118;637;1990;670;2108
251465;201807;445;1361;373;1202;16;74;278;876;294;950
251470;201807;1163;3284;890;2708;80;270;539;1579;619;1849
251480;201807;930;2523;792;2294;26;116;585;1631;611;1747
251490;201807;1859;5154;1526;4667;82;281;1074;3255;1156;3536
251500;201807;1762;5375;1664;5200;73;284;1427;4406;1500;4690
251510;201807;2431;7862;2165;7295;191;755;1411;4637;1602;5392
251520;201807;951;2564;723;2092;72;189;460;1321;532;1510
251530;201807;13225;33546;11550;31385;163;803;10243;27346;10406;28149
251540;201807;2797;8545;2575;8129;127;491;2038;6282;2165;6773
251550;201807;3616;8954;2906;8027;80;254;2434;6699;2514;6953
251560;201807;601;1833;539;1733;92;321;329;1017;421;1338
251570;201807;912;2658;754;2339;21;96;563;1671;584;1767
251580;201807;1895;4789;1682;4487;103;289;1385;3606;1488;3895
251590;201807;1582;4262;1393;4022;57;188;1117;3160;1174;3348
251593;201807;961;2870;881;2745;109;369;536;1619;645;1988
251597;201807;2008;5905;1902;5768;29;125;1729;5183;1758;5308
251600;201807;6392;17865;5743;16868;205;681;4769;13805;4974;14486
251610;201807;3353;9670;2889;8811;314;915;1966;6054;2280;6969
251615;201807;1178;3112;956;2736;27;108;731;2020;758;2128
251620;201807;17477;42123;14368;38460;239;592;12146;33926;12385;34518
251630;201807;4707;11512;3809;10251;211;608;2921;7781;3132;8389
251640;201807;2100;6127;1919;5779;68;303;1632;4785;1700;5088
251650;201807;4124;11123;3662;10526;174;567;3099;8851;3273;9418
251660;201807;3492;10673;3088;9940;100;485;2542;7972;2642;8457
251670;201807;4273;12060;3786;11394;41;193;3472;10427;3513;10620
251675;201807;657;1970;602;1894;96;333;386;1195;482;1528
251680;201807;2696;7461;2189;6715;57;218;1747;5315;1804;5533
251690;201807;3272;9451;2853;8648;92;327;2068;6134;2160;6461
251700;201807;1893;5920;1754;5732;76;372;1471;4681;1547;5053
251710;201807;839;2208;564;1620;59;209;307;844;366;1053
251720;201807;1381;4019;1150;3590;39;176;864;2587;903;2763
251740;201807;678;1883;527;1610;40;151;366;1075;406;1226
260005;201807;28449;62937;23389;56156;2316;5612;16656;39469;18972;45081
260010;201807;9820;26090;8152;23623;537;1631;5023;14848;5560;16479
260020;201807;6789;16594;5728;15058;143;592;4702;12119;4845;12711
260030;201807;6367;17247;5445;15798;234;805;4288;12380;4522;13185
260040;201807;8033;22226;6696;20144;677;2023;4459;13616;5136;15639
260050;201807;12340;34845;11246;33526;395;1244;9781;29652;10176;30896
260060;201807;3896;10368;3352;9448;225;614;2566;7243;2791;7857
260070;201807;10267;27482;8987;25505;606;2024;6691;18621;7297;20645
260080;201807;6633;15683;5754;14396;196;619;4703;11457;4899;12076
260090;201807;5150;13402;4624;12700;654;1778;3229;8979;3883;10757
260100;201807;3235;8671;2718;7905;104;397;2216;6388;2320;6785
260105;201807;5258;14173;4686;13357;178;685;3822;10617;4000;11302
260110;201807;22542;60544;20354;57580;1076;3360;17063;47792;18139;51152
260120;201807;13828;38768;11894;35622;1697;5125;7266;22270;8963;27395
260130;201807;3072;8258;2789;7820;215;654;2068;5680;2283;6334
260140;201807;13183;30970;11380;28682;629;1660;9345;23373;9974;25033
260150;201807;3440;8545;2962;7955;144;494;2482;6528;2626;7022
260160;201807;6357;17471;5438;16249;131;529;4708;14168;4839;14697
260170;201807;17633;46099;15668;43260;1623;4316;11579;32161;13202;36477
260180;201807;3312;9484;2986;8995;143;504;2500;7442;2643;7946
260190;201807;17372;37372;15205;34794;234;725;13273;29786;13507;30511
260200;201807;11149;27443;9752;25684;438;1237;8372;21992;8810;23229
260210;201807;12050;34715;10300;31858;383;1522;8234;25368;8617;26890
260220;201807;10089;25662;9465;24883;247;856;8440;21897;8687;22753
260230;201807;10209;26797;8961;25022;316;1033;7235;19980;7551;21013
260240;201807;2832;8417;2468;7827;197;680;1871;5917;2068;6597
260250;201807;2189;5989;1892;5553;92;320;1484;4253;1576;4573
260260;201807;12676;34365;11127;31964;511;1886;8700;24497;9211;26383
260270;201807;3736;10094;3368;9571;176;759;2625;7182;2801;7941
260280;201807;13056;40375;11883;38698;589;2332;10086;32691;10675;35023
260290;201807;37539;102012;33038;94972;4291;12737;21024;59900;25315;72637
260300;201807;9264;26331;8113;24637;304;1352;6522;19648;6826;21000
260310;201807;4588;12608;4113;11928;463;1278;2986;8818;3449;10096
260320;201807;7434;22219;6619;20783;314;1049;5347;16768;5661;17817
260330;201807;2535;7936;2296;7446;78;293;1828;5786;1906;6079
260340;201807;2010;5523;1754;5140;32;141;1522;4400;1554;4541
260345;201807;24215;67601;21026;62543;4253;13509;9592;27886;13845;41395
260350;201807;5045;12788;4533;12121;138;436;3942;10428;4080;10864
260360;201807;2524;6824;2299;6423;70;306;1562;4276;1632;4582
260370;201807;5498;16303;4803;15086;237;947;3642;11286;3879;12233
260380;201807;4911;15136;4275;14079;227;899;3163;10288;3390;11187
260390;201807;4318;13365;3696;12080;270;968;2485;7987;2755;8955
260392;201807;3451;11105;3068;10603;144;790;2493;8514;2637;9304
260400;201807;15487;39252;13778;36884;903;2733;10471;27273;11374;30006
260410;201807;62944;165880;51255;148559;10939;33475;22546;66836;33485;100311
260415;201807;4098;11701;3521;10629;118;535;2665;7779;2783;8314
260420;201807;12892;27940;11064;25865;227;656;9946;23054;10173;23710
260430;201807;2918;9077;2504;8283;143;547;1742;5694;1885;6241
260440;201807;3578;9929;3102;9063;153;566;2398;6825;2551;7391
260450;201807;5507;14499;5046;13920;260;648;4235;11817;4495;12465
260460;201807;5457;17151;4760;15764;601;2261;2784;9035;3385;11296
260470;201807;4978;13260;4242;12405;136;351;3756;11260;3892;11611
260480;201807;4171;11214;3529;10290;342;1144;2329;6880;2671;8024
260490;201807;5237;12724;4573;11624;103;367;3971;9832;4074;10199
260500;201807;6044;15946;5112;14546;521;1431;3472;9982;3993;11413
260510;201807;9385;23430;8049;21600;210;716;7056;18729;7266;19445
260515;201807;4450;12764;3404;10715;170;625;2216;6799;2386;7424
260520;201807;17612;42295;15803;39853;1023;2662;12688;31634;13711;34296
260530;201807;9568;28228;8291;26183;243;1078;7029;21980;7272;23058
260540;201807;6792;15353;6051;14467;480;991;5078;12326;5558;13317
260545;201807;46;140;23;93;6;26;5;21;11;47
260550;201807;2904;8702;2417;7731;213;914;1473;4571;1686;5485
260560;201807;6101;15890;5246;14682;160;675;4369;11979;4529;12654
260570;201807;7321;21269;6554;20162;536;1768;5089;15605;5625;17373
260580;201807;4216;10576;3751;9909;47;192;3391;8864;3438;9056
260590;201807;6770;16097;5798;14997;294;808;4816;12497;5110;13305
260600;201807;30110;81707;25035;73638;1528;5170;18199;52827;19727;57997
260610;201807;6771;18838;6241;18081;491;1554;4662;13361;5153;14915
260620;201807;15411;43369;13835;40946;1873;6084;8918;25905;10791;31989
260630;201807;2381;6476;1969;5823;52;221;1605;4683;1657;4904
260640;201807;19435;47436;16785;44255;1091;3145;12919;33731;14010;36876
260650;201807;5594;16140;4734;14845;210;871;3893;12060;4103;12931
260660;201807;7407;19840;6414;18550;183;780;5401;15336;5584;16116
260670;201807;2276;5947;1866;5337;108;321;1330;3769;1438;4090
260680;201807;24654;62978;20910;57191;2373;6729;12779;34493;15152;41222
260690;201807;3679;9611;3031;8599;137;473;2392;6691;2529;7164
260700;201807;5951;17587;5692;17289;23;48;5544;17009;5567;17057
260710;201807;1347;3631;1256;3514;67;229;910;2603;977;2832
260720;201807;20855;58354;18602;54895;3026;9225;11186;32768;14212;41993
260730;201807;7172;21871;6402;20740;382;1503;5189;16495;5571;17998
260740;201807;1337;3797;1141;3478;25;124;907;2743;932;2867
260750;201807;6930;19665;6020;18472;159;492;5371;16730;5530;17222
260760;201807;5453;13448;4771;12586;222;662;3877;10269;4099;10931
260765;201807;7678;23854;6902;22680;673;2824;4689;14962;5362;17786
260770;201807;3816;10059;3286;9171;116;400;2579;7107;2695;7507
260775;201807;5177;14303;4710;13607;272;1070;3541;9857;3813;10927
260780;201807;3708;11308;3349;10688;376;1352;2096;6532;2472;7884
260790;201807;114340;269886;97812;247102;16744;41822;57689;145597;74433;187419
260795;201807;3102;8510;2691;7896;159;538;2003;5892;2162;6430
260800;201807;5430;12895;4918;12162;138;453;4353;10402;4491;10855
260805;201807;3659;10733;3090;9729;226;840;2163;6689;2389;7529
260810;201807;6630;18357;6000;17186;570;1680;4330;12164;4900;13844
260820;201807;4415;10993;3904;10265;258;904;2975;7534;3233;8438
260825;201807;2882;8870;2521;8232;150;575;1860;6041;2010;6616
260830;201807;4267;12650;3572;11342;484;1442;2314;7557;2798;8999
260840;201807;4238;11481;3731;10730;200;587;3034;8648;3234;9235
260845;201807;4102;11362;3782;10790;295;842;2788;7912;3083;8754
260850;201807;4967;14840;4295;13440;517;1701;2528;7761;3045;9462
260860;201807;3593;10377;3033;9339;117;441;2407;7283;2524;7724
260870;201807;4444;11078;3850;10326;119;472;3340;8769;3459;9241
260875;201807;6567;17579;5580;15990;724;2034;3619;10489;4343;12523
260880;201807;9905;28245;8685;26154;450;1375;6917;20965;7367;22340
260890;201807;13386;36144;12025;34097;894;2922;8632;23967;9526;26889
260900;201807;5433;16201;4622;14770;318;1213;3098;9719;3416;10932
260910;201807;3156;8908;2789;8300;133;483;2148;6315;2281;6798
260915;201807;5060;15273;4513;14596;89;359;4079;13257;4168;13616
260920;201807;3299;9149;2946;8696;125;410;2424;7181;2549;7591
260930;201807;3617;11746;3200;10997;209;820;2430;8317;2639;9137
260940;201807;14551;36133;12822;33537;997;2850;9384;24121;10381;26971
260950;201807;6580;19049;5325;16588;676;2324;2797;8288;3473;10612
260960;201807;63001;153672;52223;138305;7760;21882;29935;77988;37695;99870
260970;201807;5174;14348;4640;13640;184;527;3593;10669;3777;11196
260980;201807;4381;13295;3964;12758;79;320;3602;11640;3681;11960
260990;201807;17474;50844;15261;47776;927;3327;11782;36769;12709;40096
261000;201807;15787;39912;13435;36583;740;2490;9909;26718;10649;29208
261010;201807;2507;6662;2229;6303;84;217;1968;5573;2052;5790
261020;201807;6483;18311;5585;16616;366;1216;4257;12293;4623;13509
261030;201807;4113;11645;3581;10785;234;704;2791;8367;3025;9071
261040;201807;5125;15789;4262;13954;264;1043;3044;9760;3308;10803
261050;201807;7633;20959;6934;19766;642;1674;4772;13703;5414;15377
261060;201807;13219;35175;11819;33152;634;1987;9423;26137;10057;28124
261070;201807;57607;131439;48333;118728;3890;9396;34966;84993;38856;94389
261080;201807;5923;15759;5566;15248;201;568;5024;13780;5225;14348
261090;201807;17328;44043;15693;41864;476;1549;13341;35279;13817;36828
261100;201807;8083;23883;7093;22283;716;2401;4914;15561;5630;17962
261110;201807;60354;175300;52041;161554;11094;36216;25321;79576;36415;115792
261120;201807;3804;9696;3292;9049;76;238;2923;8053;2999;8291
261130;201807;7623;18534;6739;17426;151;482;5973;15338;6124;15820
261140;201807;3443;8538;3090;8042;235;703;2395;6092;2630;6795
261150;201807;5332;14471;4705;13486;135;525;4005;11323;4140;11848
261153;201807;1962;5866;1685;5407;92;367;1145;3638;1237;4005
261160;201807;207652;508963;175875;463577;44342;120407;70910;191515;115252;311922
261170;201807;5937;15787;5392;14982;354;977;4283;11906;4637;12883
261180;201807;9879;25824;8842;24428;629;1960;6293;17154;6922;19114
261190;201807;4957;14941;4487;14218;347;1403;3229;9926;3576;11329
261200;201807;3406;8054;2993;7530;220;572;2403;6000;2623;6572
261210;201807;1917;4775;1647;4389;60;173;1419;3747;1479;3920
261220;201807;13766;40502;11453;35978;1554;5330;6408;19953;7962;25283
261230;201807;4624;13573;3905;12648;102;436;3246;10621;3348;11057
261240;201807;5050;13523;4451;12568;308;866;3541;9977;3849;10843
261245;201807;3505;10321;3006;9436;127;594;2355;7105;2482;7699
261247;201807;3002;9108;2546;8269;155;592;1805;5821;1960;6413
261250;201807;19957;48691;17476;45682;2394;5918;12147;32781;14541;38699
261255;201807;4027;12148;3475;11090;171;753;2615;8066;2786;8819
261260;201807;12928;35140;11190;32924;438;1682;9351;27352;9789;29034
261270;201807;4003;10999;3567;10319;255;866;2797;7923;3052;8789
261280;201807;2573;7498;2278;6975;96;415;1791;5323;1887;5738
261290;201807;2963;8072;2569;7559;127;469;2036;6023;2163;6492
261300;201807;11634;34283;9943;31254;759;2944;6939;21276;7698;24220
261310;201807;7478;21009;6656;19775;1039;3246;4279;12486;5318;15732
261320;201807;5949;17363;5227;16088;123;503;4285;12959;4408;13462
261330;201807;5861;15193;5402;14575;218;773;4633;12279;4851;13052
261340;201807;4172;12555;3626;11748;215;903;2730;8741;2945;9644
261350;201807;8395;25582;7726;24469;170;848;6308;19565;6478;20413
261360;201807;8363;20946;7153;19222;334;1007;5722;15030;6056;16037
261370;201807;20095;54883;17726;51363;3157;9193;10242;29999;13399;39192
261380;201807;4015;12838;3637;12099;494;1837;2310;7552;2804;9389
261390;201807;16314;47914;14093;44171;1471;4975;8847;27679;10318;32654
261400;201807;4693;15414;4113;14178;211;952;2989;10090;3200;11042
261410;201807;9303;24535;7924;22302;563;1610;6226;17440;6789;19050
261420;201807;7185;22954;6680;22274;1052;4003;4306;14255;5358;18258
261430;201807;3482;10096;2935;9233;125;484;2357;7364;2482;7848
261440;201807;1502;4617;1309;4230;52;252;911;2851;963;3103
261450;201807;14283;39583;13160;37938;309;1202;11157;32051;11466;33253
261460;201807;7150;20247;6549;19375;260;917;5586;16435;5846;17352
261470;201807;4236;10912;3792;10326;55;257;3147;8582;3202;8839
261480;201807;4657;14983;4086;14009;266;1082;3093;10382;3359;11464
261485;201807;5037;14720;4381;13639;422;1556;2987;9105;3409;10661
261500;201807;5617;15097;4948;14179;490;1320;3441;10184;3931;11504
261510;201807;1822;5652;1571;5182;91;344;1159;3849;1250;4193
261520;201807;2545;7852;2379;7531;100;392;1585;5096;1685;5488
261530;201807;10652;33317;9127;30258;1363;5189;4255;13856;5618;19045
261540;201807;7590;22721;6891;21609;1179;3663;4002;12935;5181;16598
261550;201807;3625;9812;3210;9153;247;833;2301;6404;2548;7237
261560;201807;7518;23163;6631;21866;428;1748;4935;16227;5363;17975
261570;201807;3441;9669;2853;8675;226;834;1910;5654;2136;6488
261580;201807;6470;17610;5854;16713;145;641;5238;14748;5383;15389
261590;201807;2716;7126;2209;6365;95;295;1637;4699;1732;4994
261600;201807;5349;13837;4472;12534;465;1240;2984;8593;3449;9833
261610;201807;2458;6662;2070;6069;90;323;1571;4592;1661;4915
261618;201807;2573;6648;2288;6261;106;333;1829;4927;1935;5260
261620;201807;3980;11980;3707;11538;803;2359;2238;7259;3041;9618
261630;201807;6960;19744;5875;17713;517;1915;3670;10563;4187;12478
261640;201807;37026;85785;32559;80246;2008;4448;25477;64375;27485;68823
261650;201807;4161;10886;3704;10284;168;610;2741;7583;2909;8193
270010;201807;4348;15276;3882;14403;201;1105;3001;10874;3202;11979
270020;201807;4012;10386;3557;9779;239;765;2864;7679;3103;8444
270030;201807;35248;99430;30823;92254;4827;14425;19050;57566;23877;71991
270040;201807;11403;31218;9905;29395;511;1917;8079;23783;8590;25700
270050;201807;5525;12869;4715;11964;207;540;4134;10506;4341;11046
270060;201807;2078;5507;1816;5171;174;480;1347;3903;1521;4383
270070;201807;4581;13368;4030;12589;151;718;3365;10254;3516;10972
270080;201807;1414;4050;1176;3617;85;292;852;2519;937;2811
270090;201807;1948;6031;1719;5576;77;361;1328;4151;1405;4512
270100;201807;5593;15642;4922;14618;286;1093;3882;11308;4168;12401
270110;201807;3197;8046;2621;7389;169;505;2061;5958;2230;6463
270120;201807;3089;8358;2697;7875;88;340;2362;6855;2450;7195
270130;201807;5388;14437;4692;13642;236;773;3826;11181;4062;11954
270135;201807;2015;4994;1750;4687;76;203;1556;4170;1632;4373
270140;201807;10299;23776;8375;21173;414;1548;6739;16093;7153;17641
270150;201807;2649;8153;2541;8021;15;40;2488;7865;2503;7905
270160;201807;5379;16114;4744;15326;97;532;4255;13590;4352;14122
270170;201807;3576;10745;3112;10099;273;1200;2214;6910;2487;8110
270180;201807;2275;7165;2081;6891;64;313;1787;5809;1851;6122
270190;201807;1712;5254;1575;5063;81;335;1271;4045;1352;4380
270200;201807;2547;7822;2216;7380;159;654;1616;5241;1775;5895
270210;201807;5574;13960;4900;13153;171;563;4366;11586;4537;12149
270220;201807;1425;4087;1219;3784;228;771;681;2077;909;2848
270230;201807;9782;29085;8325;26711;895;3407;5383;16794;6278;20201
270235;201807;5929;18776;5314;17729;246;1037;4255;14038;4501;15075
270240;201807;10780;29699;8866;27243;1100;3689;6165;18904;7265;22593
270250;201807;2908;7587;2578;7140;251;662;1946;5443;2197;6105
270255;201807;4711;13670;3616;11629;208;872;2568;8064;2776;8936
270260;201807;5653;17192;5279;16600;165;794;4532;13797;4697;14591
270270;201807;1066;2907;975;2782;150;435;653;1856;803;2291
270280;201807;3865;9778;3139;8843;447;869;2176;6504;2623;7373
270290;201807;7912;25667;7164;24435;345;1612;5935;19940;6280;21552
270300;201807;4117;11384;3280;10465;251;866;2349;7566;2600;8432
270310;201807;7210;20838;6286;19388;200;1032;5236;15602;5436;16634
270320;201807;5866;17501;5265;16417;654;2180;3601;10983;4255;13163
270330;201807;3800;12835;3465;12343;295;1166;2700;9645;2995;10811
270340;201807;1650;4733;1409;4411;71;266;1141;3521;1212;3787
270350;201807;1917;4774;1621;4406;183;536;1126;3090;1309;3626
270360;201807;2347;6385;2137;6135;81;225;1938;5625;2019;5850
270370;201807;1437;4541;1308;4303;62;273;1014;3296;1076;3569
270375;201807;3094;7524;2608;6925;33;108;2385;6319;2418;6427
270380;201807;5739;16954;4986;15934;482;1587;3488;11407;3970;12994
270390;201807;1225;3233;1022;2948;32;141;821;2319;853;2460
270400;201807;6295;17567;5416;16169;261;999;4045;11638;4306;12637
270410;201807;4555;13864;4049;12988;257;999;3122;9864;3379;10863
270420;201807;5757;17389;5304;16763;212;936;4379;13578;4591;14514
270430;201807;142915;366384;116305;330626;26962;80861;48473;140596;75435;221457
270440;201807;4921;13624;4241;12771;141;611;3485;10431;3626;11042
270450;201807;6662;18912;6025;18127;311;1221;4959;14731;5270;15952
270460;201807;3617;8553;3186;8037;61;234;2921;7221;2982;7455
270470;201807;11063;32697;9809;30848;978;3282;6968;22212;7946;25494
270480;201807;2874;8058;2475;7433;194;748;1889;5453;2083;6201
270490;201807;995;2919;883;2781;62;218;681;2125;743;2343
270500;201807;4878;15382;4463;14825;195;907;3696;12083;3891;12990
270510;201807;5850;16395;5092;15341;522;1965;3594;10356;4116;12321
270520;201807;3974;11731;3205;10367;815;2768;1137;3914;1952;6682
270530;201807;1112;3382;1008;3215;62;190;774;2480;836;2670
270540;201807;2146;6535;1912;6229;88;430;1607;5107;1695;5537
270550;201807;6852;18569;5688;17258;519;1473;4267;13346;4786;14819
270560;201807;3175;8780;2830;8291;168;570;2189;6290;2357;6860
270570;201807;4041;11941;3480;11059;197;827;2772;8621;2969;9448
270580;201807;2232;6545;2075;6316;92;288;1814;5521;1906;5809
270590;201807;1558;4694;1455;4571;9;38;1416;4449;1425;4487
270600;201807;2861;8977;2550;8455;106;536;2148;6947;2254;7483
270610;201807;3592;9840;3067;9164;113;454;2659;7802;2772;8256
270620;201807;1326;4142;1208;3929;57;243;995;3154;1052;3397
270630;201807;15635;43003;13865;40235;1093;3526;10672;30691;11765;34217
270640;201807;5637;16410;4878;15247;222;919;3876;11780;4098;12699
270642;201807;2347;7852;2160;7575;165;827;1683;5690;1848;6517
270644;201807;3423;8834;2809;8034;246;704;2090;6061;2336;6765
270650;201807;3366;10124;3024;9634;440;1707;2066;6299;2506;8006
270660;201807;2207;5519;1752;4887;85;287;1299;3565;1384;3852
270670;201807;15965;39530;13664;36760;884;2528;10976;29435;11860;31963
270680;201807;5128;13194;4631;12634;155;269;4282;11872;4437;12141
270690;201807;9579;24273;8078;22525;1217;3141;5691;16275;6908;19416
270700;201807;557;1724;480;1581;44;187;336;1091;380;1278
270710;201807;5872;17804;5426;17209;319;1386;4461;13826;4780;15212
270720;201807;3411;10623;3038;9982;103;617;2564;8180;2667;8797
270730;201807;7431;18448;6851;17815;363;893;5622;15518;5985;16411
270740;201807;2352;6392;2107;6076;102;357;1726;4877;1828;5234
270750;201807;5424;15258;4781;14343;260;961;3861;11491;4121;12452
270760;201807;3427;9811;3002;9175;83;409;2542;7636;2625;8045
270770;201807;21279;52823;16883;47378;3131;8304;9476;28537;12607;36841
270780;201807;1794;5385;1690;5238;106;371;1394;4305;1500;4676
270790;201807;1600;4704;1402;4422;138;449;947;2999;1085;3448
270800;201807;11001;31169;9926;29631;487;2060;8319;24139;8806;26199
270810;201807;3233;9787;2596;8651;202;806;1780;5856;1982;6662
270820;201807;1732;5320;1468;4866;103;423;1090;3537;1193;3960
270830;201807;5581;13616;4635;12447;254;806;3666;9816;3920;10622
270840;201807;8292;24808;7409;23573;237;1313;6425;19840;6662;21153
270850;201807;8548;22274;7732;21216;528;1837;6356;16878;6884;18715
270860;201807;12137;30732;10065;28206;622;2027;7899;21791;8521;23818
270870;201807;2099;6135;1815;5629;202;697;1266;3909;1468;4606
270880;201807;8236;25024;7426;23843;294;1284;6075;19199;6369;20483
270890;201807;2530;7150;2218;6703;163;572;1609;4771;1772;5343
270895;201807;2963;9903;2761;9630;101;561;2409;8180;2510;8741
270900;201807;1808;4746;1409;4117;54;184;1099;3145;1153;3329
270910;201807;3719;11277;3238;10456;157;663;2439;7735;2596;8398
270915;201807;9119;28235;7773;25795;934;3665;4923;15859;5857;19524
270920;201807;5675;17702;5298;17113;268;1257;4367;13632;4635;14889
270930;201807;17396;42573;13759;38227;2214;5806;8987;25812;11201;31618
270940;201807;6033;17769;5390;16958;314;1459;4109;12556;4423;14015
280010;201807;682;1874;576;1678;29;121;393;1047;422;1168
280020;201807;4797;12861;4120;11751;562;1545;2690;7737;3252;9282
280030;201807;74243;181617;59447;160521;15042;41561;23184;65558;38226;107119
280040;201807;3127;8909;2753;8324;281;916;1896;5669;2177;6585
280050;201807;3915;11466;3438;10676;598;1969;2000;6207;2598;8176
280060;201807;5325;14974;4333;13378;795;2617;2123;6744;2918;9361
280067;201807;6899;18146;5853;16484;526;1587;4017;11146;4543;12733
280070;201807;1933;5980;1838;5818;109;371;1536;4815;1645;5186
280100;201807;3697;10751;3259;10024;371;1268;2262;6912;2633;8180
280110;201807;1323;3856;1197;3638;37;157;1013;2980;1050;3137
280120;201807;7651;22938;6924;21705;724;2159;5164;16456;5888;18615
280130;201807;8723;21578;7798;20271;708;1929;5930;15458;6638;17387
280140;201807;5560;13993;4992;13201;296;808;4113;10853;4409;11661
280150;201807;3803;10187;3462;9715;241;702;2781;7765;3022;8467
280160;201807;1255;3678;1036;3296;142;469;641;2006;783;2475
280170;201807;5145;13964;4669;13300;276;771;3845;11019;4121;11790
280190;201807;1237;2909;1026;2602;60;184;815;2002;875;2186
280200;201807;1339;3604;1091;3190;96;354;768;2194;864;2548
280210;201807;15191;40645;13333;38018;2103;6340;7810;22430;9913;28770
280220;201807;1784;4969;1550;4650;38;200;1270;3813;1308;4013
280230;201807;3662;9831;3283;9286;241;736;2460;6841;2701;7577
280240;201807;3432;9288;3098;8773;89;391;2623;7230;2712;7621
280250;201807;851;2199;675;1924;81;273;379;1015;460;1288
280260;201807;2127;5370;1957;5161;47;136;1810;4771;1857;4907
280270;201807;2269;6623;2008;6211;130;487;1666;5051;1796;5538
280280;201807;4090;13030;3694;12418;567;1716;2408;8565;2975;10281
280290;201807;17493;48824;15511;45979;1764;5793;10064;29968;11828;35761
280300;201807;10366;27810;9076;26355;361;1272;7086;21560;7447;22832
280310;201807;1366;3665;1147;3276;41;142;851;2357;892;2499
280320;201807;8732;24930;7695;23323;890;2900;4996;14895;5886;17795
280330;201807;4854;12303;4148;11259;291;873;3122;8359;3413;9232
280340;201807;5271;11437;4563;10639;292;634;3889;9215;4181;9849
280350;201807;23578;60236;20490;55687;1825;5256;14785;39835;16610;45091
280360;201807;5909;17151;5279;16032;952;2934;2888;8888;3840;11822
280370;201807;2152;5386;1763;4732;88;236;1386;3669;1474;3905
280380;201807;1015;2905;884;2710;99;349;583;1757;682;2106
280390;201807;3487;9205;2861;8144;141;467;2210;6157;2351;6624
280400;201807;4026;10720;3528;9972;613;1651;2086;6132;2699;7783
280410;201807;2140;6363;1747;5622;207;702;1031;3237;1238;3939
280420;201807;4267;11740;3881;11190;115;403;3462;9922;3577;10325
280430;201807;2088;5304;1837;4952;90;332;1437;3788;1527;4120
280440;201807;4609;12538;4044;11738;248;845;3221;9107;3469;9952
280445;201807;2321;6068;2086;5639;60;186;1530;3964;1590;4150
280450;201807;10230;23837;9148;22444;392;762;7892;19588;8284;20350
280460;201807;6692;16660;6097;15809;518;1307;4905;12694;5423;14001
280470;201807;1788;5151;1578;4773;87;308;1163;3467;1250;3775
280480;201807;36951;96433;32940;90698;3323;10169;23016;62204;26339;72373
280490;201807;3868;11129;3292;10154;112;494;2482;7430;2594;7924
280500;201807;952;2393;821;2205;47;163;667;1768;714;1931
280510;201807;2570;7100;2242;6612;124;487;1618;4726;1742;5213
280520;201807;1696;4407;1503;4141;88;242;1216;3332;1304;3574
280530;201807;2673;6551;2324;6136;140;382;1885;4969;2025;5351
280540;201807;9106;24727;8329;23633;247;1071;7278;20182;7525;21253
280550;201807;6706;16458;5557;14695;311;915;4301;11095;4612;12010
280560;201807;7168;20598;6771;20025;198;777;5903;17200;6101;17977
280570;201807;6352;16250;5234;14789;273;953;3821;10661;4094;11614
280580;201807;5450;15615;4660;14287;608;1833;3085;9577;3693;11410
280590;201807;3039;7463;2535;6823;160;644;1838;4681;1998;5325
280600;201807;3417;9724;3076;9230;228;794;2211;6558;2439;7352
280610;201807;2576;6505;2312;6141;199;537;1827;4815;2026;5352
280620;201807;5354;14138;4632;13074;455;1125;3304;9672;3759;10797
280630;201807;3661;11221;3320;10691;226;829;2589;8390;2815;9219
280640;201807;2419;6755;2223;6538;56;149;2045;6070;2101;6219
280650;201807;1271;3383;1000;2983;84;290;711;2061;795;2351
280660;201807;3120;7593;2777;7191;129;358;2409;6213;2538;6571
280670;201807;19141;44920;16809;41892;1271;3335;12830;31928;14101;35263
280680;201807;2818;7083;2401;6416;186;444;1755;4660;1941;5104
280690;201807;977;2537;832;2327;49;133;614;1694;663;1827
280700;201807;1109;2936;959;2692;23;82;744;2046;767;2128
280710;201807;14709;33860;12695;31534;564;970;11007;28056;11571;29026
280720;201807;2794;6287;2275;5684;143;376;1494;3980;1637;4356
280730;201807;1102;2798;986;2629;69;218;750;1969;819;2187
280740;201807;13870;35350;11844;32142;1155;3223;7975;21413;9130;24636
280750;201807;3500;10113;3139;9472;178;666;2274;6716;2452;7382
280760;201807;6041;17171;5346;16061;649;1949;3486;10745;4135;12694
290010;201807;3067;6632;2124;5173;14;50;1752;4067;1766;4117
290020;201807;5219;14560;4892;14116;339;677;4204;12450;4543;13127
290030;201807;3906;10101;3397;9503;198;511;2829;7968;3027;8479
290035;201807;5193;11732;4170;10397;314;614;3276;8482;3590;9096
290040;201807;4415;10849;3686;9975;156;478;2862;7937;3018;8415
290050;201807;2205;7108;1866;6444;157;614;1272;4341;1429;4955
290060;201807;1305;3314;1005;2824;105;365;664;1792;769;2157
290070;201807;34340;81325;29636;75141;2853;7471;20065;51192;22918;58663
290080;201807;5652;16798;4757;15501;574;1930;3154;10501;3728;12431
290090;201807;2296;4411;1714;3791;46;101;1548;3408;1594;3509
290100;201807;9405;25735;7967;23530;992;2807;4909;14907;5901;17714
290110;201807;5048;14086;4624;13341;478;1432;3174;9066;3652;10498
290115;201807;4375;12662;3761;11759;231;790;2927;9164;3158;9954
290120;201807;6998;17229;5734;15673;164;596;4891;13157;5055;13753
290130;201807;4619;11604;3703;10457;146;608;2937;8110;3083;8718
290135;201807;4480;10664;3638;9310;245;692;2711;6734;2956;7426
290140;201807;4708;12879;3767;11665;131;461;3229;9975;3360;10436
290150;201807;2277;6567;2131;6331;197;638;1601;4652;1798;5290
290160;201807;3189;7809;2909;7451;346;775;2168;5629;2514;6404
290170;201807;2936;8339;2669;8006;88;339;2402;7163;2490;7502
290180;201807;2977;8253;2476;7449;102;371;1944;5778;2046;6149
290190;201807;3999;12109;3611;11557;179;751;2897;9115;3076;9866
290195;201807;2368;6114;1897;5399;53;240;1534;4330;1587;4570
290200;201807;4029;11618;3408;10622;251;853;2613;8091;2864;8944
290205;201807;3472;9088;3067;8501;124;490;2466;6614;2590;7104
290210;201807;13398;38383;11914;36236;1106;3125;8999;28195;10105;31320
290220;201807;2741;7185;2486;6856;171;512;2013;5464;2184;5976
290225;201807;3492;7481;2855;6806;37;89;2685;6411;2722;6500
290230;201807;2480;7028;2266;6774;67;266;1983;5897;2050;6163
290240;201807;3714;9596;3080;8787;129;436;2514;7089;2643;7525
290250;201807;4143;12125;3688;11519;169;507;2995;9754;3164;10261
290260;201807;5416;13974;4419;12516;246;849;3486;9759;3732;10608
290265;201807;3621;10755;3002;9617;145;590;2263;7189;2408;7779
290270;201807;11895;40758;11233;39624;805;3436;8706;30298;9511;33734
290280;201807;5953;17931;5267;16782;411;1473;3771;11921;4182;13394
290290;201807;9944;29823;8394;26971;831;2818;5709;18261;6540;21079
290300;201807;4473;12274;3227;9921;194;685;2272;6982;2466;7667
290310;201807;1543;4082;1300;3745;108;399;941;2632;1049;3031
290320;201807;24890;67928;20786;61990;5118;15419;9831;30607;14949;46026
290323;201807;3662;10093;3255;9521;74;253;2691;7789;2765;8042
290327;201807;4314;12569;3722;11447;323;970;2620;8085;2943;9055
290330;201807;2047;4584;1715;4220;53;118;1531;3785;1584;3903
290340;201807;5768;15574;4673;14174;661;2059;3203;9835;3864;11894
290350;201807;4737;13868;4019;12640;323;1086;2874;9126;3197;10212
290360;201807;5035;13708;4359;12810;131;428;3714;10899;3845;11327
290370;201807;5235;13082;4004;11467;223;569;3040;8864;3263;9433
290380;201807;5621;15365;4827;14246;126;413;4157;12353;4283;12766
290390;201807;15020;43402;12860;40140;1440;4651;8559;27195;9999;31846
290395;201807;2789;8493;2356;7722;74;356;1836;5957;1910;6313
290400;201807;3649;10227;2959;9113;142;557;2179;6553;2321;7110
290405;201807;4724;14047;3952;12660;282;985;2735;8887;3017;9872
290410;201807;5750;16166;4597;14264;168;755;3459;10321;3627;11076
290420;201807;2994;8558;2498;7757;145;466;1917;5952;2062;6418
290430;201807;3136;9095;2604;8217;329;1080;1657;5234;1986;6314
290440;201807;2847;7283;2123;6182;71;240;1539;4552;1610;4792
290450;201807;3305;9073;2713;8203;167;633;2046;6060;2213;6693
290460;201807;12218;34350;10557;31239;2663;8011;4403;12976;7066;20987
290470;201807;4416;11655;3317;10018;413;1397;1817;5553;2230;6950
290475;201807;6346;18898;5418;17224;143;714;4271;13253;4414;13967
290480;201807;1969;5112;1720;4746;128;396;1129;3083;1257;3479
290485;201807;4562;13778;3989;12906;150;789;3377;10673;3527;11462
290490;201807;8878;21658;8092;20623;557;1447;6359;16304;6916;17751
290500;201807;3937;11974;3024;10043;434;1537;1543;5015;1977;6552
290510;201807;3355;8815;2868;8159;98;369;2447;6859;2545;7228
290515;201807;3784;10170;3170;9373;85;226;2736;8283;2821;8509
290520;201807;11508;33995;9026;29095;422;1710;5891;18630;6313;20340
290530;201807;5018;14509;4337;13398;187;627;3544;10946;3731;11573
290540;201807;3758;10149;3372;9651;82;268;3014;8595;3096;8863
290550;201807;4427;11486;3889;10871;43;126;3597;10157;3640;10283
290560;201807;6786;18016;5394;15921;534;1810;3661;10568;4195;12378
290570;201807;44083;113287;40016;108023;2947;8413;31208;83679;34155;92092
290580;201807;7594;23439;6804;22245;624;2009;5142;17183;5766;19192
290590;201807;6987;21860;6046;20190;178;757;4945;16496;5123;17253
290600;201807;18241;52455;16558;49899;882;2822;13141;39928;14023;42750
290610;201807;2513;8160;2022;7162;117;517;1388;4837;1505;5354
290620;201807;6418;18216;5656;16995;233;759;4755;14179;4988;14938
290630;201807;9170;22541;7389;20245;626;1724;5713;15699;6339;17423
290640;201807;2758;7483;2087;6387;105;335;1581;4785;1686;5120
290650;201807;11962;32318;10930;30992;2752;7486;6155;18429;8907;25915
290660;201807;3714;9739;3151;8926;102;255;2279;6751;2381;7006
290670;201807;6914;19855;5999;18352;477;1456;4506;13940;4983;15396
290680;201807;10472;29912;9036;27789;276;1363;7266;21755;7542;23118
290682;201807;4661;12638;4081;11799;152;445;3423;9901;3575;10346
290685;201807;3638;8316;2393;6566;195;516;1549;4422;1744;4938
290687;201807;6914;19466;5531;17131;827;2540;3264;10462;4091;13002
290689;201807;2929;8416;2411;7530;145;503;1734;5465;1879;5968
290690;201807;5724;15170;4680;13745;494;1477;3180;9288;3674;10765
290700;201807;2636;7379;2367;7010;99;362;1974;5838;2073;6200
290710;201807;8586;24464;7380;22819;217;825;6294;19407;6511;20232
290720;201807;19128;52418;17614;50328;992;3065;14484;41294;15476;44359
290730;201807;7198;18290;6223;17084;283;745;4768;13092;5051;13837
290740;201807;1040;2909;793;2468;46;187;584;1803;630;1990
290750;201807;10798;28598;9383;26061;1008;3007;6273;16941;7281;19948
290755;201807;2239;6276;1735;5356;105;389;1213;3685;1318;4074
290760;201807;3938;11695;3112;10065;370;1080;1854;6282;2224;7362
290770;201807;2512;8459;2325;8215;68;349;1926;6863;1994;7212
290780;201807;8468;21558;7312;19921;397;878;5719;15903;6116;16781
290790;201807;4478;12716;4004;12061;160;486;3420;10372;3580;10858
290800;201807;7250;15280;5410;13166;380;895;4106;10165;4486;11060
290810;201807;5781;15819;4609;13953;122;444;3461;10484;3583;10928
290820;201807;5193;14016;4614;13170;270;866;3379;9660;3649;10526
290830;201807;4650;10978;4157;10314;97;299;3473;8486;3570;8785
290840;201807;16944;46789;14826;43462;1716;4446;9832;30148;11548;34594
290850;201807;6435;16643;5830;15970;474;1104;4642;13127;5116;14231
290860;201807;5717;17536;4994;16673;247;902;4158;14109;4405;15011
290870;201807;4773;13371;3728;11535;144;536;2666;8163;2810;8699
290880;201807;1439;3662;1124;3204;79;201;782;2273;861;2474
290890;201807;8078;18035;7126;16962;193;533;6571;15514;6764;16047
290900;201807;2378;6460;1795;5445;117;388;1152;3442;1269;3830
290910;201807;5142;13122;4045;11452;62;266;3348;9341;3410;9607
290920;201807;5226;13020;4799;12488;85;213;4440;11550;4525;11763
290930;201807;8179;23092;6755;20645;238;1085;5328;15775;5566;16860
290940;201807;3873;11120;3243;10198;191;689;2433;7696;2624;8385
290950;201807;1535;4012;1291;3644;79;214;918;2615;997;2829
290960;201807;5355;14761;4861;14104;161;499;4096;11903;4257;12402
290970;201807;3679;10770;3065;9747;197;658;2265;7231;2462;7889
290980;201807;11186;28894;9462;25992;1092;3257;5319;14214;6411;17471
290990;201807;9061;25453;7908;23507;410;1552;6342;18364;6752;19916
291000;201807;3324;9113;2680;8288;246;712;2083;6569;2329;7281
291005;201807;15053;36900;13335;34749;695;1951;11057;28676;11752;30627
291010;201807;3091;9389;2482;8123;143;504;1643;5301;1786;5805
291020;201807;1309;3345;1046;2852;37;129;705;1806;742;1935
291030;201807;2422;6221;1682;4830;102;317;1058;2938;1160;3255
291040;201807;5417;15504;4695;14440;239;981;3702;11193;3941;12174
291050;201807;7558;22073;6634;20629;1105;3701;4119;12642;5224;16343
291060;201807;5956;19903;5222;18834;481;2141;3652;12974;4133;15115
291070;201807;15617;43619;13456;40252;628;2348;10681;31606;11309;33954
291072;201807;24510;66544;18194;54586;3835;12056;6906;21054;10741;33110
291075;201807;5090;13709;4525;12740;198;587;3609;10018;3807;10605
291077;201807;1564;4211;1247;3642;56;157;874;2567;930;2724
291080;201807;82378;235111;69901;214486;26579;82947;11738;38452;38317;121399
291085;201807;5792;14794;4824;13412;202;615;4063;11262;4265;11877
291090;201807;1870;3768;1465;3304;37;105;1267;2815;1304;2920
291100;201807;3082;6936;2147;5835;108;376;1634;4332;1742;4708
291110;201807;5698;17953;4919;16599;504;1996;3461;11289;3965;13285
291120;201807;7800;19678;6789;18286;436;1291;5142;13783;5578;15074
291125;201807;2101;3816;1550;3204;93;168;1205;2564;1298;2732
291130;201807;2987;8925;2356;7717;92;445;1715;5387;1807;5832
291140;201807;4602;12913;3482;10730;441;1236;2266;7056;2707;8292
291150;201807;2247;5241;1943;4883;31;81;1742;4351;1773;4432
291160;201807;4931;14635;4302;13600;420;1455;2902;9068;3322;10523
291165;201807;2308;6361;1768;5333;30;129;1285;3748;1315;3877
291170;201807;20969;54108;17705;48768;1134;3376;11290;30966;12424;34342
291180;201807;6086;15118;4713;13064;447;1254;3382;9359;3829;10613
291185;201807;3183;8907;2767;8157;108;355;2201;6405;2309;6760
291190;201807;7620;19318;6410;17662;406;1250;4999;13698;5405;14948
291200;201807;2880;8230;2164;6869;128;434;1332;4173;1460;4607
291210;201807;6872;15597;5363;13775;181;564;4022;10303;4203;10867
291220;201807;4043;11844;3630;11185;289;1037;2690;8172;2979;9209
291230;201807;4377;9932;3407;8844;89;187;3090;8137;3179;8324
291240;201807;4302;11327;3752;10385;70;238;3203;8724;3273;8962
291250;201807;3416;10241;2732;8972;190;605;1814;6026;2004;6631
291260;201807;1311;3198;1146;2976;49;175;956;2462;1005;2637
291270;201807;5143;14522;4166;12902;753;2285;2497;7957;3250;10242
291280;201807;2422;6530;1864;5589;210;688;1063;3117;1273;3805
291290;201807;5938;16012;4799;14254;519;1590;3130;9323;3649;10913
291300;201807;4025;11114;3045;9439;154;521;2195;6727;2349;7248
291310;201807;5243;14403;4465;12961;165;560;3607;10310;3772;10870
291320;201807;6152;18065;4801;15347;1148;3439;2238;7502;3386;10941
291330;201807;1808;4723;1530;4270;75;231;1122;3033;1197;3264
291340;201807;4182;11021;3500;9914;82;319;2709;7526;2791;7845
291345;201807;3078;9507;2844;9168;153;542;2307;7482;2460;8024
291350;201807;6652;17350;5165;15324;145;457;4320;12991;4465;13448
291360;201807;34880;86608;28308;77975;4482;12649;15735;44594;20217;57243
291370;201807;7947;21973;7251;21007;443;1455;5568;16026;6011;17481
291380;201807;3400;9937;3026;9320;126;528;2453;7392;2579;7920
291390;201807;12706;29589;10300;26824;466;1384;8257;21412;8723;22796
291400;201807;13995;37540;11916;34406;1781;4672;7294;22405;9075;27077
291410;201807;2953;7809;2253;6621;64;279;1687;4809;1751;5088
291420;201807;1922;4933;1583;4497;53;217;1328;3740;1381;3957
291430;201807;3052;8571;2658;7969;101;458;2126;6170;2227;6628
291440;201807;6520;19041;5627;17504;376;1289;4428;13849;4804;15138
291450;201807;8569;22906;7262;21277;157;366;6257;18854;6414;19220
291460;201807;14687;40815;13021;38315;979;3144;9441;27763;10420;30907
291465;201807;9001;24644;7390;22704;306;1294;6139;18776;6445;20070
291470;201807;16022;39028;13666;36295;700;1818;10167;27763;10867;29581
291480;201807;40166;92421;30065;78592;3989;10964;15510;40826;19499;51790
291490;201807;5089;13732;4512;13003;252;787;3804;10980;4056;11767
291500;201807;5063;12647;4191;11445;81;342;3729;10117;3810;10459
291510;201807;3832;10723;3113;9648;106;518;2478;7620;2584;8138
291520;201807;4379;10636;3446;9382;225;636;2486;6791;2711;7427
291530;201807;2250;5532;1681;4727;330;809;954;2957;1284;3766
291535;201807;3217;9839;2958;9398;205;629;2256;7281;2461;7910
291540;201807;2251;5048;1602;4315;60;211;1400;3700;1460;3911
291550;201807;5441;13139;4313;11603;489;1232;2705;7414;3194;8646
291560;201807;20316;45580;13829;37812;971;2532;9299;26769;10270;29301
291570;201807;2320;5618;1893;5095;107;229;1559;4316;1666;4545
291580;201807;6155;16870;4964;15226;371;1354;3544;10697;3915;12051
291590;201807;1786;5132;1632;4903;153;481;1289;3876;1442;4357
291600;201807;5284;13561;3945;11413;562;1720;2299;6502;2861;8222
291610;201807;5375;15383;5088;15056;102;344;4747;14060;4849;14404
291620;201807;3191;7146;2301;6158;116;330;1754;4771;1870;5101
291630;201807;3262;7602;2495;6612;149;442;1963;5147;2112;5589
291640;201807;15826;41354;12227;35872;2182;6510;4783;14874;6965;21384
291650;201807;8707;23794;7732;22576;483;1169;6527;19416;7010;20585
291660;201807;2248;5473;1625;4501;124;442;1083;2836;1207;3278
291670;201807;2029;5376;1742;4973;113;289;1366;3957;1479;4246
291680;201807;3951;10488;3348;9493;311;939;2486;7012;2797;7951
291685;201807;4802;11665;3824;10382;309;696;2835;7993;3144;8689
291690;201807;4174;9673;3023;7995;111;260;2434;6377;2545;6637
291700;201807;8782;25985;7776;24164;503;1677;6184;19072;6687;20749
291710;201807;5315;13206;4014;11374;305;1003;2768;7698;3073;8701
291720;201807;4590;14354;3776;12666;407;1528;2440;7970;2847;9498
291730;201807;6452;17284;5556;16087;296;993;4480;12940;4776;13933
291733;201807;2986;7798;2495;7117;75;247;1861;5474;1936;5721
291735;201807;3029;7957;2505;7164;84;277;2051;5843;2135;6120
291740;201807;3930;10233;3080;8862;130;412;2351;6667;2481;7079
291750;201807;20223;49906;16211;43767;1980;5449;10148;27645;12128;33094
291760;201807;10673;32038;8581;28536;2895;10805;2100;7093;4995;17898
291770;201807;7114;20035;5924;17832;573;1880;4133;12177;4706;14057
291780;201807;4905;13568;4428;12842;117;412;3845;11041;3962;11453
291790;201807;2662;7747;2462;7463;226;621;1872;5760;2098;6381
291800;201807;30053;78261;23671;68680;3410;9671;13256;39580;16666;49251
291810;201807;10823;26731;8961;24399;222;774;7689;20735;7911;21509
291820;201807;3830;10502;3354;9787;137;483;2600;7574;2737;8057
291830;201807;4327;10686;3705;9818;241;651;2934;7801;3175;8452
291835;201807;6331;19205;5061;16751;802;2773;2888;9809;3690;12582
291840;201807;46801;129894;40622;121693;4926;15165;27880;85044;32806;100209
291845;201807;2446;6880;2125;6444;132;399;1741;5341;1873;5740
291850;201807;4137;11907;3373;10589;290;825;2408;7813;2698;8638
291855;201807;2066;4382;1644;3871;69;184;1399;3271;1468;3455
291860;201807;2270;6004;1597;4711;39;135;1065;3032;1104;3167
291870;201807;1383;3566;919;2713;65;206;608;1735;673;1941
291875;201807;2694;8242;2393;7696;105;403;1785;5590;1890;5993
291880;201807;5326;15854;4687;14678;337;1062;3452;10790;3789;11852
291890;201807;1521;3331;1029;2727;189;417;647;1764;836;2181
291900;201807;1206;3091;927;2611;24;99;725;1983;749;2082
291905;201807;2770;7056;2109;5945;85;294;1562;4284;1647;4578
291910;201807;2853;7395;2430;6882;80;262;2091;5929;2171;6191
291915;201807;7133;20899;5921;18803;281;1064;4463;14167;4744;15231
291920;201807;25879;71972;22778;67554;2885;9212;14788;43331;17673;52543
291930;201807;2464;7080;2131;6519;211;724;1458;4355;1669;5079
291940;201807;3597;9680;2464;7685;239;768;1472;4468;1711;5236
291950;201807;8882;27843;7746;25651;707;2549;4893;16315;5600;18864
291955;201807;13661;36149;12385;34492;1480;4049;9067;25815;10547;29864
291960;201807;3144;8645;2543;7752;165;505;1905;5937;2070;6442
291970;201807;4101;11498;3586;10745;200;781;2601;7743;2801;8524
291980;201807;10494;29815;8333;26490;722;2284;5607;18035;6329;20319
291990;201807;2074;5827;1922;5651;17;60;1811;5358;1828;5418
291992;201807;4235;10404;3101;8828;306;827;2370;6826;2676;7653
291995;201807;2185;6015;1767;5380;63;282;1423;4223;1486;4505
292000;201807;2490;6357;2067;5749;163;540;1496;4122;1659;4662
292010;201807;6258;14648;5103;13037;266;724;4159;10507;4425;11231
292020;201807;4548;13609;3861;12374;295;1048;2804;8799;3099;9847
292030;201807;1713;5495;1647;5383;96;367;1035;3281;1131;3648
292040;201807;4324;11424;3559;10348;227;593;2835;8492;3062;9085
292045;201807;4026;10885;3040;9412;68;154;2670;8459;2738;8613
292050;201807;6486;18839;5289;16543;396;1382;3331;10299;3727;11681
292060;201807;12865;29614;11761;28247;719;1695;9978;23692;10697;25387
292070;201807;5666;15287;4981;14460;305;936;4237;12274;4542;13210
292080;201807;3242;8257;2634;7483;125;396;2294;6522;2419;6918
292090;201807;4550;10111;3364;8720;259;689;2597;6865;2856;7554
292100;201807;10518;27184;8961;25070;1572;4527;5061;14300;6633;18827
292105;201807;3176;8800;2828;8250;80;355;2351;6719;2431;7074
292110;201807;6346;16234;4597;13321;1094;3205;2052;6010;3146;9215
292120;201807;6918;18397;5610;16065;533;1568;3926;11134;4459;12702
292130;201807;3207;8132;2699;7485;181;559;2043;5637;2224;6196
292140;201807;5114;12439;4260;11184;229;587;3437;8943;3666;9530
292145;201807;2270;6838;1939;6248;101;336;1420;4594;1521;4930
292150;201807;13152;37428;11865;35467;338;1385;9902;29244;10240;30629
292160;201807;2677;7084;2218;6490;81;239;1880;5576;1961;5815
292170;201807;8395;23119;6942;20650;599;1893;4775;14178;5374;16071
292180;201807;2946;8097;2151;6709;327;969;1196;3744;1523;4713
292190;201807;2984;8117;2516;7441;225;709;1757;5261;1982;5970
292200;201807;7561;20344;5879;17772;1016;3159;3101;9574;4117;12733
292205;201807;3784;10778;3327;10074;74;366;2922;8684;2996;9050
292210;201807;6107;15231;5091;13869;115;483;4479;12013;4594;12496
292220;201807;2038;5159;1804;4822;93;271;1367;3579;1460;3850
292225;201807;3253;9623;2895;9079;95;399;2383;7377;2478;7776
292230;201807;8034;20027;7278;19023;206;801;6097;15541;6303;16342
292240;201807;5019;14610;4318;13258;393;1194;2845;8719;3238;9913
292250;201807;5309;14918;4844;14168;646;1823;3158;9380;3804;11203
292260;201807;3329;9130;2983;8657;167;468;2527;7438;2694;7906
292265;201807;3294;9474;2794;8632;94;412;2165;6512;2259;6924
292270;201807;4113;9854;3358;8936;204;594;2752;7348;2956;7942
292273;201807;2561;5772;2096;5196;84;156;1625;4185;1709;4341
292275;201807;1818;5041;1454;4508;73;186;1145;3669;1218;3855
292280;201807;2537;6253;2100;5746;107;232;1717;4882;1824;5114
292285;201807;2523;6366;1996;5608;105;297;1538;4369;1643;4666
292290;201807;6861;19448;5717;17769;218;797;4626;14357;4844;15154
292300;201807;9921;26459;7932;23880;988;3175;5065;15412;6053;18587
292303;201807;2900;8449;2551;7904;68;211;2180;6764;2248;6975
292305;201807;2523;6766;2324;6471;49;222;2055;5613;2104;5835
292310;201807;6582;17547;5694;16411;220;732;4809;13740;5029;14472
292320;201807;6375;17334;5217;15228;296;983;3939;11177;4235;12160
292330;201807;2465;5894;2149;5498;108;267;1704;4421;1812;4688
292335;201807;4895;12801;4361;12028;306;803;3533;9831;3839;10634
292340;201807;6178;17024;5180;15196;279;864;3832;11083;4111;11947
292350;201807;2467;6731;2031;6144;84;311;1676;5092;1760;5403
292360;201807;4950;13335;4203;11961;311;1007;2934;8112;3245;9119
292370;201807;10843;25147;9462;23287;174;545;8665;20940;8839;21485
292380;201807;6959;19752;6279;18583;487;1455;4724;13908;5211;15363
292390;201807;4220;8548;3062;7195;122;235;2652;6280;2774;6515
292400;201807;21668;64332;19313;60288;2032;6778;13335;41537;15367;48315
292405;201807;4495;11032;3677;9891;182;437;2948;7950;3130;8387
292410;201807;2078;5252;1824;4949;63;211;1577;4283;1640;4494
292420;201807;3679;11303;3410;10892;181;782;2821;8891;3002;9673
292430;201807;4967;15175;3854;13392;331;1195;2608;9236;2939;10431
292440;201807;8069;26433;7491;25615;118;588;6900;23687;7018;24275
292450;201807;3799;11313;3095;9928;138;491;2387;7661;2525;8152
292460;201807;4891;13834;4043;12368;362;1095;2891;8882;3253;9977
292465;201807;2523;6867;2075;6200;104;287;1458;4534;1562;4821
292467;201807;1731;5211;1600;5030;217;657;1110;3593;1327;4250
292470;201807;3033;7692;2380;6634;80;194;1867;5228;1947;5422
292480;201807;6563;15812;5245;14179;110;416;4633;12299;4743;12715
292490;201807;2172;5840;1805;5275;110;334;1368;4026;1478;4360
292500;201807;6530;18338;5352;16222;610;1857;3494;10617;4104;12474
292510;201807;12838;35397;10429;31716;660;2402;7590;23001;8250;25403
292520;201807;6718;17455;5818;16089;805;2192;3945;11054;4750;13246
292525;201807;5724;13889;4719;12722;124;357;4108;11079;4232;11436
292530;201807;27317;74475;22280;66504;6127;18454;8333;26100;14460;44554
292540;201807;3667;7922;2977;7155;166;400;2555;6149;2721;6549
292550;201807;7755;21641;6098;19485;436;1543;4507;14802;4943;16345
292560;201807;4292;11196;3667;10293;117;455;2983;8297;3100;8752
292570;201807;4056;10682;3494;9826;80;289;3112;8635;3192;8924
292575;201807;6874;20676;6408;20041;320;1110;5352;16711;5672;17821
292580;201807;7302;19316;6300;17851;209;726;5307;14895;5516;15621
292590;201807;7235;19603;6580;18630;301;1035;5574;15377;5875;16412
292593;201807;2839;7108;2380;6335;90;242;1931;5097;2021;5339
292595;201807;5476;14762;4788;13893;197;728;3985;11430;4182;12158
292600;201807;11103;30543;9655;28442;532;1481;7462;22138;7994;23619
292610;201807;4480;11756;3694;10412;223;551;2620;7559;2843;8110
292620;201807;6470;18135;5526;17068;68;187;5224;16292;5292;16479
292630;201807;8866;22207;7254;19577;533;1457;4989;13527;5522;14984
292640;201807;8172;24597;7234;23088;283;1141;5268;16810;5551;17951
292650;201807;4601;11477;4183;10925;166;481;3743;9631;3909;10112
292660;201807;11159;31246;9696;29066;555;1832;7586;22743;8141;24575
292665;201807;2221;6694;2025;6439;55;217;1767;5658;1822;5875
292670;201807;3595;9859;2787;8364;146;538;1880;5538;2026;6076
292680;201807;3958;10889;3250;9573;196;580;2354;6774;2550;7354
292690;201807;2641;7071;1857;5774;167;498;1189;3841;1356;4339
292700;201807;9662;26985;8406;25094;893;2581;5693;17515;6586;20096
292710;201807;2349;7606;2162;7364;62;234;1948;6685;2010;6919
292720;201807;9458;22899;7967;21228;315;954;6517;17498;6832;18452
292730;201807;4244;10698;3992;10378;187;406;3458;9028;3645;9434
292740;201807;334114;849459;301775;799948;51301;139459;177059;465726;228360;605185
292750;201807;6383;17156;5455;15768;291;903;4073;11864;4364;12767
292760;201807;3897;11427;3470;10665;283;953;2486;7571;2769;8524
292770;201807;5934;16654;5003;15231;863;2743;2907;9186;3770;11929
292780;201807;1951;4094;1457;3480;48;127;1174;2712;1222;2839
292790;201807;4125;8884;3315;7998;121;350;2945;7058;3066;7408
292800;201807;10727;27633;9368;25531;423;1188;7629;20591;8052;21779
292805;201807;3406;8625;2710;7663;217;577;1992;5653;2209;6230
292810;201807;10379;28558;8223;25256;317;1236;6080;18417;6397;19653
292820;201807;7806;21194;5629;17858;477;1753;3915;12208;4392;13961
292830;201807;2779;6598;2403;6134;81;300;2125;5356;2206;5656
292840;201807;8991;23823;7983;22450;177;705;6977;19100;7154;19805
292850;201807;2683;7273;2212;6520;161;560;1483;4218;1644;4778
292860;201807;16238;38536;14582;36412;909;2257;11681;29163;12590;31420
292870;201807;17644;46464;15445;43148;1167;3775;10049;27636;11216;31411
292880;201807;11793;32352;10231;30071;438;1782;7734;21904;8172;23686
292890;201807;6132;18328;5484;17255;315;1182;4408;13731;4723;14913
292895;201807;2994;6712;2203;5527;95;233;1690;4212;1785;4445
292900;201807;2746;7748;2544;7416;83;380;2018;5645;2101;6025
292905;201807;4377;11951;3392;10445;218;739;2330;7186;2548;7925
292910;201807;5039;14231;4537;13390;347;1158;3257;9501;3604;10659
292920;201807;9944;27600;9331;26765;318;1260;8103;22763;8421;24023
292925;201807;5283;15224;4688;14216;269;841;3518;10555;3787;11396
292930;201807;6269;19399;5592;18054;495;2023;3533;11024;4028;13047
292935;201807;2220;6061;1802;5600;37;172;1597;5034;1634;5206
292937;201807;3133;7616;2714;7107;77;238;2373;6224;2450;6462
292940;201807;3162;8253;2532;7252;187;471;1847;5430;2034;5901
292950;201807;9716;25605;8646;23986;417;1273;6671;18167;7088;19440
292960;201807;5417;13050;4600;11952;107;314;3721;9503;3828;9817
292970;201807;4023;11749;3475;10965;124;542;2843;8985;2967;9527
292975;201807;4507;9896;4002;9308;200;381;3549;8377;3749;8758
292980;201807;3324;8293;2646;7243;132;417;2025;5436;2157;5853
292990;201807;11380;31450;9675;28569;718;2284;7243;21385;7961;23669
293000;201807;2681;6528;2388;6132;35;150;1849;4871;1884;5021
293010;201807;18037;47513;14761;42129;1951;5717;9039;25710;10990;31427
293015;201807;7660;24501;6202;21551;553;2316;4159;14292;4712;16608
293020;201807;9538;29008;8701;27850;173;818;7687;24687;7860;25505
293030;201807;5617;15323;4294;13265;134;475;2856;9103;2990;9578
293040;201807;3977;11481;3532;10852;110;408;3059;9330;3169;9738
293050;201807;21643;55038;19198;51576;1581;4396;13482;36412;15063;40808
293060;201807;3513;9330;2882;8294;182;595;2120;5959;2302;6554
293070;201807;24920;62607;20694;56808;3438;9483;12108;34113;15546;43596
293075;201807;3320;10824;2990;10275;244;1073;2318;7886;2562;8959
293076;201807;3630;9368;3237;8831;106;305;2700;7429;2806;7734
293077;201807;5506;16149;4653;14916;514;1667;3089;10193;3603;11860
293080;201807;4752;14409;4209;13496;158;694;3369;10592;3527;11286
293090;201807;3193;9626;2519;8496;292;1076;1564;5237;1856;6313
293100;201807;5768;16020;4728;14134;311;954;3590;10740;3901;11694
293105;201807;3779;12082;3297;11117;250;904;2342;7802;2592;8706
293110;201807;2420;6044;2033;5509;73;271;1684;4423;1757;4694
293120;201807;4195;11945;3778;11252;136;389;3160;9411;3296;9800
293130;201807;3797;10737;3389;10216;104;412;2899;8694;3003;9106
293135;201807;30544;74520;22635;63264;4386;13532;9434;26681;13820;40213
293140;201807;2234;5446;1996;5148;91;264;1654;4170;1745;4434
293150;201807;5374;16824;4513;15111;516;1759;2957;10036;3473;11795
293160;201807;3938;9691;3350;8991;274;543;2703;7603;2977;8146
293170;201807;4081;9798;3559;9097;125;364;2891;7349;3016;7713
293180;201807;4779;13064;3870;11545;122;556;3119;9052;3241;9608
293190;201807;13740;38972;12259;36754;314;1371;10507;31210;10821;32581
293200;201807;8062;20486;6655;18426;256;970;5116;13957;5372;14927
293210;201807;5165;13927;4410;12735;260;778;3451;9963;3711;10741
293220;201807;5056;13904;3867;11767;926;2800;1480;4749;2406;7549
293230;201807;3939;10665;3052;9355;304;1007;2019;6288;2323;7295
293240;201807;4418;11905;3534;10429;110;329;2682;8052;2792;8381
293245;201807;4091;11101;3638;10470;192;652;2999;8516;3191;9168
293250;201807;5642;14055;4825;12914;293;772;3782;10101;4075;10873
293260;201807;4517;12747;3725;11514;128;440;2610;7980;2738;8420
293270;201807;6729;15900;5468;14510;539;1019;4210;11878;4749;12897
293280;201807;4977;13372;4245;12342;255;718;3187;9308;3442;10026
293290;201807;13274;41809;12056;39720;2814;9185;5977;20703;8791;29888
293300;201807;6228;14915;5322;13705;361;839;3918;10299;4279;11138
293305;201807;4189;10556;3654;9834;66;217;3199;8583;3265;8800
293310;201807;2201;5698;1794;4999;79;243;1340;3674;1419;3917
293315;201807;4221;10397;3458;9223;174;465;2778;7353;2952;7818
293317;201807;2513;6420;2232;5959;132;315;1703;4551;1835;4866
293320;201807;9429;26328;8817;25597;601;1827;7430;21611;8031;23438
293325;201807;1753;4644;1392;4089;208;644;882;2585;1090;3229
293330;201807;45280;143011;39531;132418;8960;30669;17574;59998;26534;90667
293340;201807;2452;6924;1986;6112;142;502;1320;4012;1462;4514
293345;201807;3280;9310;2734;8543;282;633;1957;6570;2239;7203
293350;201807;6827;19417;6078;18574;76;225;5632;17574;5708;17799
293360;201807;15200;40080;13228;37625;503;1720;11631;32793;12134;34513
310010;201807;854;2103;620;1758;68;226;274;732;342;958
310020;201807;2237;6527;1743;5667;404;1440;288;902;692;2342
310030;201807;2241;6569;1790;5751;265;989;1117;3431;1382;4420
310040;201807;966;2515;785;2242;57;213;571;1556;628;1769
310050;201807;1602;5206;1451;4924;256;1004;746;2447;1002;3451
310060;201807;3378;9706;2905;9077;161;721;2357;7235;2518;7956
310070;201807;347;849;249;679;10;31;178;471;188;502
310080;201807;824;2283;567;1753;80;292;225;647;305;939
310090;201807;4509;12630;3796;11439;354;1202;2721;8073;3075;9275
310100;201807;3374;9725;2865;8882;131;565;2264;6825;2395;7390
310110;201807;5052;13683;4034;11859;758;2523;1861;5191;2619;7714
310120;201807;652;1699;436;1330;74;285;195;510;269;795
310130;201807;377;1078;319;976;53;206;182;492;235;698
310140;201807;214;677;158;578;44;197;41;119;85;316
310150;201807;4657;13455;3650;11478;738;2532;1327;4028;2065;6560
310160;201807;7244;20220;5533;17222;1373;4711;1487;4484;2860;9195
310163;201807;1053;3160;863;2813;262;957;241;706;503;1663
310170;201807;9133;24255;7551;21829;775;2356;5237;15151;6012;17507
310180;201807;1709;4542;1382;4022;120;446;939;2620;1059;3066
310190;201807;3025;9431;2528;8452;629;2329;332;1049;961;3378
310200;201807;1733;5422;1356;4639;244;911;517;1729;761;2640
310205;201807;1129;3138;838;2684;187;627;285;905;472;1532
310210;201807;2828;7573;2332;6794;110;348;1743;5044;1853;5392
310220;201807;1091;3047;908;2749;100;330;639;1889;739;2219
310230;201807;2349;6815;1969;6045;227;860;1178;3388;1405;4248
310240;201807;894;2989;777;2768;70;312;522;1821;592;2133
310250;201807;1003;2847;842;2574;72;287;573;1678;645;1965
310260;201807;2840;8217;1860;6359;483;1885;311;814;794;2699
310270;201807;2692;7005;2124;6219;137;543;1681;4796;1818;5339
310280;201807;2353;5770;1868;5047;246;785;1118;2838;1364;3623
310285;201807;1921;6449;1674;6019;179;763;1026;3683;1205;4446
310290;201807;1126;3161;991;2917;205;700;539;1437;744;2137
310300;201807;1510;4799;1376;4567;249;989;671;2048;920;3037
310310;201807;323;829;223;657;33;89;118;353;151;442
310320;201807;501;1333;321;998;30;126;168;483;198;609
310330;201807;524;1260;318;886;40;132;131;323;171;455
310340;201807;8007;22452;6396;19700;1140;3439;3045;9752;4185;13191
310350;201807;12483;31733;8736;25554;2118;6690;2704;7674;4822;14364
310360;201807;469;1198;390;1095;15;51;298;818;313;869
310370;201807;1317;4258;1115;3862;227;844;394;1389;621;2233
310375;201807;1020;2697;666;2109;111;371;248;776;359;1147
310380;201807;379;905;201;589;38;106;70;187;108;293
310390;201807;458;1457;382;1304;105;389;84;225;189;614
310400;201807;9869;25361;6975;20696;1180;3902;3187;9183;4367;13085
310410;201807;787;2368;500;1826;124;491;117;394;241;885
310420;201807;4031;10837;2597;7909;504;1735;634;1704;1138;3439
310430;201807;1395;4059;936;3153;197;715;242;771;439;1486
310440;201807;588;1536;408;1208;27;116;232;663;259;779
310445;201807;1370;4078;1022;3397;62;244;721;2359;783;2603
310450;201807;4792;12417;3598;10527;239;826;2683;7761;2922;8587
310460;201807;1730;4761;1206;3760;250;849;329;1000;579;1849
310470;201807;3975;8738;3174;7682;280;820;2482;5860;2762;6680
310480;201807;1169;3159;846;2590;141;471;478;1408;619;1879
310490;201807;2999;8886;2411;7758;403;1552;1080;3221;1483;4773
310500;201807;1488;4398;1090;3621;219;784;486;1586;705;2370
310510;201807;1866;5282;1286;4146;296;1038;323;1038;619;2076
310520;201807;1397;3515;1008;2878;129;373;580;1648;709;2021
310530;201807;877;2448;456;1460;70;252;81;205;151;457
310540;201807;3353;9956;2794;8942;701;2358;1086;3349;1787;5707
310550;201807;1245;3273;891;2670;97;374;541;1526;638;1900
310560;201807;14193;39539;10952;33956;2404;8312;3688;10441;6092;18753
310570;201807;1123;3190;926;2862;106;406;604;1796;710;2202
310590;201807;4255;11792;3479;10418;379;1292;1934;5542;2313;6834
310600;201807;1489;4573;1225;3998;187;673;552;1691;739;2364
310610;201807;524;1455;344;1143;59;235;160;484;219;719
310620;201807;158257;431324;120410;361814;26003;87824;44808;120364;70811;208188
310630;201807;4549;12960;3829;11641;317;1121;2609;7712;2926;8833
310640;201807;1055;3286;876;2925;214;786;274;857;488;1643
310650;201807;2542;7624;1883;6360;238;910;1026;3353;1264;4263
310660;201807;1309;3661;1119;3428;59;195;887;2662;946;2857
310665;201807;1292;3580;1073;3248;55;201;845;2550;900;2751
310670;201807;48063;132970;40546;119225;6470;20955;22712;63568;29182;84523
310680;201807;691;1769;590;1628;30;87;453;1229;483;1316
310690;201807;1687;4751;1275;4045;147;566;700;2097;847;2663
310700;201807;528;1208;396;1047;54;168;262;663;316;831
310710;201807;5630;17059;4113;14784;962;4082;451;1555;1413;5637
310720;201807;869;2310;720;2100;71;247;506;1432;577;1679
310730;201807;9277;26711;8007;24607;648;2431;5444;16397;6092;18828
310740;201807;5477;16008;3848;12557;740;2622;1003;3078;1743;5700
310750;201807;1336;3316;942;2748;153;504;394;1075;547;1579
310760;201807;557;1574;431;1349;41;134;190;614;231;748
310770;201807;1092;3106;737;2559;118;458;363;1232;481;1690
310780;201807;4046;10445;3255;9162;194;563;2263;6281;2457;6844
310790;201807;1930;6108;1703;5671;327;1092;746;2625;1073;3717
310800;201807;2443;7552;1797;6220;465;1898;116;353;581;2251
310810;201807;1149;3051;939;2663;71;242;592;1611;663;1853
310820;201807;1133;3158;739;2395;152;521;189;602;341;1123
310825;201807;2843;9427;2337;8545;103;588;1837;6541;1940;7129
310830;201807;1457;4386;1101;3677;235;898;422;1318;657;2216
310840;201807;2088;5875;1455;4728;353;1273;360;1052;713;2325
310850;201807;1509;4218;1298;3935;70;342;1009;2924;1079;3266
310855;201807;3256;8950;2581;7890;232;859;1838;5481;2070;6340
310860;201807;7053;20789;5684;18102;575;1986;3448;11004;4023;12990
310870;201807;1069;2613;801;2208;89;254;560;1545;649;1799
310880;201807;1009;3074;804;2657;103;368;479;1552;582;1920
310890;201807;2401;6932;1658;5573;408;1536;239;694;647;2230
310900;201807;4583;13171;3440;10951;598;2140;1484;4349;2082;6489
310910;201807;1730;4665;1054;3364;150;543;148;396;298;939
310920;201807;1867;5171;1448;4477;242;791;739;2271;981;3062
310925;201807;981;2899;823;2627;119;429;548;1698;667;2127
310930;201807;5883;16007;4344;13504;814;2667;2174;6932;2988;9599
310940;201807;6313;16416;5071;14538;392;1324;3451;9619;3843;10943
310945;201807;1267;3473;1065;3175;108;380;651;1880;759;2260
310950;201807;1955;5946;1360;4639;280;1075;445;1390;725;2465
310960;201807;757;1937;449;1363;68;229;151;471;219;700
310970;201807;1172;3622;832;2896;215;823;199;638;414;1461
310980;201807;382;886;239;657;25;73;153;397;178;470
310990;201807;1258;3742;963;3129;213;717;367;1169;580;1886
311000;201807;4137;12039;3186;10416;879;3074;1140;3588;2019;6662
311010;201807;777;2467;654;2188;247;887;211;680;458;1567
311020;201807;1006;2703;682;2082;88;305;302;870;390;1175
311030;201807;1554;4119;1063;3243;292;1003;343;932;635;1935
311040;201807;347;1124;276;950;68;240;72;224;140;464
311050;201807;2408;6645;1905;5827;438;1494;738;2149;1176;3643
311060;201807;2757;7616;1893;5786;307;1093;716;1950;1023;3043
311070;201807;1840;5184;1363;4335;200;771;617;1839;817;2610
311080;201807;978;2482;799;2169;75;274;535;1335;610;1609
311090;201807;2033;6809;1619;6029;417;1735;463;1685;880;3420
311100;201807;2053;6232;1382;4857;374;1482;192;600;566;2082
311110;201807;3330;7524;2136;5796;483;1402;877;2408;1360;3810
311115;201807;1265;3389;1037;3056;88;323;764;2193;852;2516
311120;201807;6874;18669;5069;15284;921;3153;1654;4433;2575;7586
311130;201807;1950;5536;1563;4942;177;714;784;2353;961;3067
311140;201807;1342;3381;989;2876;82;270;620;1835;702;2105
311150;201807;1547;5083;1305;4607;207;806;701;2396;908;3202
311160;201807;3836;11748;2782;9807;812;3185;724;2465;1536;5650
311170;201807;845;2349;659;2037;43;145;406;1279;449;1424
311180;201807;1303;3159;863;2474;211;650;334;952;545;1602
311190;201807;1101;3066;810;2496;126;461;319;881;445;1342
311200;201807;1754;5017;1286;4082;356;1216;274;800;630;2016
311205;201807;925;2892;768;2583;64;272;426;1388;490;1660
311210;201807;990;3044;884;2905;133;425;625;2094;758;2519
311220;201807;762;2265;631;2002;102;364;302;881;404;1245
311230;201807;8006;24856;6031;20705;1176;4269;1985;7070;3161;11339
311240;201807;937;2721;752;2434;153;563;400;1251;553;1814
311250;201807;851;2510;698;2250;164;562;314;979;478;1541
311260;201807;2348;5947;1571;4663;330;1035;509;1418;839;2453
311265;201807;1229;3320;943;2845;65;245;643;1881;708;2126
311270;201807;3187;9767;2782;9146;226;1030;1953;6112;2179;7142
311280;201807;1232;3375;617;2005;111;399;102;306;213;705
311290;201807;1901;5997;1772;5714;183;606;1205;3869;1388;4475
311300;201807;4582;13505;3843;12281;240;1104;2928;9129;3168;10233
311310;201807;637;1942;541;1752;98;346;200;597;298;943
311320;201807;3189;10206;2808;9333;451;1718;1248;3814;1699;5532
311330;201807;4741;13301;4044;12105;521;1727;2177;6591;2698;8318
311340;201807;10802;32685;8780;28749;2636;9142;2094;6988;4730;16130
311350;201807;2245;5941;1639;4802;185;646;832;2189;1017;2835
311360;201807;925;2546;733;2275;303;1034;171;528;474;1562
311370;201807;4366;11546;3307;9710;249;979;1930;5333;2179;6312
311380;201807;426;1353;341;1174;85;288;117;425;202;713
311390;201807;1746;5735;1457;5318;614;2559;367;1160;981;3719
311400;201807;1446;4270;1051;3452;164;624;405;1190;569;1814
311410;201807;1591;5063;1370;4762;277;1074;669;2335;946;3409
311420;201807;1715;5332;1158;4045;215;797;161;426;376;1223
311430;201807;3493;9846;2349;7465;441;1480;606;1920;1047;3400
311440;201807;2441;7358;1752;6059;439;1727;470;1565;909;3292
311450;201807;1840;5863;1381;4941;351;1396;281;876;632;2272
311455;201807;986;2428;692;1952;190;529;235;669;425;1198
311460;201807;559;1823;387;1462;88;424;100;330;188;754
311470;201807;448;1456;335;1185;78;307;56;188;134;495
311480;201807;1529;5329;1403;5162;54;150;1238;4733;1292;4883
311490;201807;227;734;192;647;53;207;78;233;131;440
311500;201807;436;1158;323;962;41;145;178;524;219;669
311510;201807;2806;8015;1982;6451;408;1525;596;1818;1004;3343
311520;201807;575;1768;530;1675;127;453;271;809;398;1262
311530;201807;9416;23116;6260;17827;1509;4799;1655;4651;3164;9450
311535;201807;775;2149;518;1675;101;383;130;386;231;769
311540;201807;536;1759;484;1660;121;406;244;857;365;1263
311545;201807;2097;5971;1785;5558;109;458;1325;4029;1434;4487
311547;201807;1521;4000;1311;3663;47;170;978;2747;1025;2917
311550;201807;2786;8194;2210;7067;393;1419;802;2442;1195;3861
311560;201807;261;611;199;534;36;101;105;250;141;351
311570;201807;1932;4608;1430;3919;59;162;1135;3197;1194;3359
311580;201807;2271;4328;1540;3471;207;398;970;2292;1177;2690
311590;201807;502;1437;414;1304;72;267;210;628;282;895
311600;201807;1539;3833;1274;3492;69;218;1054;2841;1123;3059
311610;201807;2453;8411;2100;7602;418;1537;962;3513;1380;5050
311615;201807;3021;9154;2477;8266;196;803;1823;5977;2019;6780
311620;201807;400;1152;352;1076;22;88;274;822;296;910
311630;201807;1369;3839;1097;3318;88;288;738;2160;826;2448
311640;201807;584;1802;479;1594;103;394;206;648;309;1042
311650;201807;2006;5404;1700;4923;155;552;1121;3102;1276;3654
311660;201807;2957;8803;2145;7227;431;1583;413;1196;844;2779
311670;201807;1589;4239;1227;3647;215;718;524;1578;739;2296
311680;201807;2114;6249;1623;5373;266;942;975;3188;1241;4130
311690;201807;572;1293;459;1157;38;98;346;900;384;998
311700;201807;2298;5639;1771;4918;44;169;1435;3897;1479;4066
311710;201807;1522;4551;1053;3618;267;995;338;1180;605;2175
311720;201807;412;1288;338;1144;36;152;182;590;218;742
311730;201807;4760;12009;2839;8500;915;3020;398;1151;1313;4171
311740;201807;773;2330;707;2237;41;118;629;2017;670;2135
311750;201807;3971;12347;3290;11202;467;1820;1815;5916;2282;7736
311760;201807;674;2040;561;1819;109;431;199;537;308;968
311770;201807;1987;6078;1547;5212;321;1190;543;1707;864;2897
311780;201807;1230;3902;917;3217;197;788;240;735;437;1523
311783;201807;2146;6265;1783;5626;58;275;1460;4510;1518;4785
311787;201807;709;2141;514;1678;69;262;199;562;268;824
311790;201807;1561;4197;1037;3284;251;882;341;1073;592;1955
311800;201807;5203;16458;4339;14477;790;2878;637;1914;1427;4792
311810;201807;984;3126;798;2761;63;263;469;1620;532;1883
311820;201807;731;1996;579;1712;80;291;354;973;434;1264
311830;201807;8667;26125;6119;20375;1655;5887;662;2110;2317;7997
311840;201807;3020;8428;2615;7829;336;1124;1763;5234;2099;6358
311850;201807;308;885;258;804;25;83;164;500;189;583
311860;201807;53864;143510;42674;124827;7090;22059;23364;66653;30454;88712
311870;201807;1940;5442;1348;4302;252;920;487;1372;739;2292
311880;201807;6192;16985;5346;15772;408;1189;4030;11992;4438;13181
311890;201807;1516;4016;1211;3535;140;457;752;2129;892;2586
311900;201807;690;1877;532;1639;51;186;367;1107;418;1293
311910;201807;4323;11490;3319;10170;701;2225;1589;4926;2290;7151
311920;201807;1992;5854;1628;5236;184;632;938;2995;1122;3627
311930;201807;3255;8489;2563;7439;970;2998;745;2027;1715;5025
311940;201807;14037;39189;10608;32455;1687;5693;4464;12859;6151;18552
311950;201807;2188;6231;1648;5291;122;538;1102;3433;1224;3971
311960;201807;573;1423;474;1263;35;166;319;709;354;875
311970;201807;438;1459;291;1073;52;221;62;207;114;428
311980;201807;448;1273;267;902;39;141;82;259;121;400
311990;201807;524;1330;364;1102;97;340;144;406;241;746
311995;201807;1012;2925;556;1851;27;97;54;122;81;219
312000;201807;565;1583;487;1465;33;102;347;1053;380;1155
312010;201807;906;2758;714;2355;81;294;398;1271;479;1565
312015;201807;1311;4038;1176;3790;77;323;880;2740;957;3063
312020;201807;1140;3589;986;3312;223;814;386;1260;609;2074
312030;201807;2014;5191;1763;4900;34;158;1618;4436;1652;4594
312040;201807;778;2547;591;2124;78;311;230;798;308;1109
312050;201807;1229;4096;983;3580;242;1002;244;783;486;1785
312060;201807;817;2215;597;1915;139;466;278;882;417;1348
312070;201807;894;2690;635;2144;76;279;337;1100;413;1379
312080;201807;2789;7136;2071;6028;174;605;1251;3413;1425;4018
312083;201807;924;2482;712;2150;85;288;461;1332;546;1620
312087;201807;2226;6202;1902;5728;97;362;1451;4372;1548;4734
312090;201807;9442;26548;7371;22976;1575;5221;3086;9523;4661;14744
312100;201807;1514;4676;1084;3882;146;645;520;1769;666;2414
312110;201807;1022;3341;862;3004;252;985;224;691;476;1676
312120;201807;713;2080;531;1741;148;561;185;518;333;1079
312125;201807;1351;3892;1188;3645;154;496;858;2598;1012;3094
312130;201807;877;2287;663;1896;64;207;278;740;342;947
312140;201807;797;2468;658;2148;148;518;253;765;401;1283
312150;201807;462;1338;394;1178;14;59;267;746;281;805
312160;201807;7972;24019;6292;20786;1048;4019;2634;8182;3682;12201
312170;201807;840;2351;671;2047;36;116;453;1346;489;1462
312180;201807;1409;4010;1155;3498;170;590;586;1656;756;2246
312190;201807;558;1709;404;1378;93;356;77;264;170;620
312200;201807;4772;13247;3906;11713;719;2222;2184;6494;2903;8716
312210;201807;1330;3247;969;2725;78;282;645;1747;723;2029
312220;201807;1962;6129;1730;5744;153;513;1124;3732;1277;4245
312230;201807;11740;33052;8154;26260;2372;8406;1182;3476;3554;11882
312235;201807;1644;4605;1386;4227;128;457;973;2903;1101;3360
312240;201807;749;2472;577;2091;133;521;152;525;285;1046
312245;201807;2514;6783;2133;6252;82;310;1720;4991;1802;5301
312247;201807;842;2262;612;1899;137;438;291;920;428;1358
312250;201807;1033;2746;694;2110;131;415;259;763;390;1178
312260;201807;929;2691;745;2395;62;245;511;1579;573;1824
312270;201807;701;2020;557;1736;35;157;292;830;327;987
312280;201807;442;1363;353;1186;114;387;45;148;159;535
312290;201807;776;2459;654;2223;133;512;222;730;355;1242
312300;201807;895;2752;654;2163;170;616;100;266;270;882
312310;201807;777;2664;670;2444;103;453;302;1053;405;1506
312320;201807;1931;5225;1456;4366;413;1348;272;756;685;2104
312330;201807;894;2616;745;2374;85;312;504;1554;589;1866
312340;201807;270;721;202;612;31;105;105;310;136;415
312350;201807;266;605;224;563;25;75;160;386;185;461
312352;201807;1651;4942;1427;4560;140;452;914;3070;1054;3522
312360;201807;2705;8352;2077;6983;463;1707;481;1564;944;3271
312370;201807;1765;5031;1484;4528;309;1066;675;1941;984;3007
312380;201807;2175;5188;1847;4762;27;67;1652;4267;1679;4334
312385;201807;1260;3585;1027;3170;155;551;568;1657;723;2208
312390;201807;1945;5884;1489;5013;270;1015;462;1386;732;2401
312400;201807;3004;9095;2359;7823;790;2751;649;2215;1439;4966
312410;201807;11518;33978;9558;30423;1955;6589;4501;14101;6456;20690
312420;201807;3776;11029;3303;10165;581;1926;1786;5392;2367;7318
312430;201807;8122;22234;6606;19557;658;2103;4278;12516;4936;14619
312440;201807;942;3004;709;2467;339;1248;81;256;420;1504
312450;201807;1185;3695;902;3138;258;962;308;1090;566;2052
312460;201807;409;1077;289;898;43;147;169;547;212;694
312470;201807;517;1360;332;1025;58;209;103;276;161;485
312480;201807;1216;3047;826;2521;121;394;460;1378;581;1772
312490;201807;1998;5052;1541;4342;238;696;840;2303;1078;2999
312500;201807;833;2202;670;1959;63;231;430;1214;493;1445
312510;201807;3812;10663;2912;8911;571;1757;1135;3380;1706;5137
312520;201807;190;570;158;516;44;146;68;221;112;367
312530;201807;610;1641;526;1531;31;105;442;1291;473;1396
312540;201807;1433;4261;936;3161;197;720;391;1295;588;2015
312550;201807;767;2186;600;1797;57;185;353;953;410;1138
312560;201807;1989;5255;1651;4781;79;307;1293;3687;1372;3994
312570;201807;2304;6131;1768;5355;539;1721;630;1955;1169;3676
312580;201807;560;1699;436;1423;61;233;187;578;248;811
312590;201807;1687;5169;1387;4565;151;635;756;2337;907;2972
312595;201807;1671;5391;1525;5091;273;890;912;3161;1185;4051
312600;201807;982;2575;598;1997;87;359;223;722;310;1081
312610;201807;6689;17607;4383;13311;771;2577;1198;3438;1969;6015
312620;201807;2421;6356;1769;5455;73;320;1352;4223;1425;4543
312630;201807;252;815;210;738;44;177;81;282;125;459
312640;201807;603;1681;401;1323;59;198;127;426;186;624
312650;201807;2099;5660;1432;4320;112;398;918;2628;1030;3026
312660;201807;1375;3438;1055;2944;110;361;703;1886;813;2247
312670;201807;5172;14171;4194;12747;369;1484;2749;8010;3118;9494
312675;201807;1298;3706;1052;3263;80;326;785;2367;865;2693
312680;201807;1375;3966;1159;3645;78;334;883;2709;961;3043
312690;201807;2329;5741;1844;5082;128;397;1406;3789;1534;4186
312695;201807;954;2906;823;2668;68;222;608;1989;676;2211
312700;201807;2047;5665;1495;4640;164;553;813;2433;977;2986
312705;201807;1310;3523;1081;3141;33;122;848;2421;881;2543
312707;201807;1416;4364;1080;3708;95;457;625;2025;720;2482
312710;201807;6665;15528;3909;11292;1158;3666;907;2687;2065;6353
312720;201807;998;2897;756;2476;101;386;387;1210;488;1596
312730;201807;1658;4072;1262;3528;74;236;820;2241;894;2477
312733;201807;1544;4115;1182;3446;46;166;770;2141;816;2307
312735;201807;709;1925;602;1726;84;294;398;1034;482;1328
312737;201807;791;1934;560;1579;91;292;281;733;372;1025
312738;201807;570;1587;393;1250;70;266;172;510;242;776
312740;201807;371;922;209;669;52;175;47;124;99;299
312750;201807;1273;4184;1066;3770;168;674;485;1629;653;2303
312760;201807;1908;5892;1391;4798;278;1021;411;1374;689;2395
312770;201807;41188;105158;27455;81432;6659;20933;8113;23558;14772;44491
312780;201807;2519;8132;2179;7513;271;1081;1342;4596;1613;5677
312790;201807;289;742;184;591;16;67;75;215;91;282
312800;201807;4974;15035;3879;12751;766;2828;1590;5036;2356;7864
312810;201807;1852;5260;1239;4125;294;1089;354;1045;648;2134
312820;201807;1878;5194;1545;4601;71;282;1068;3067;1139;3349
312825;201807;1300;3251;1125;3028;42;136;925;2476;967;2612
312830;201807;2389;7098;1590;5502;402;1533;328;1097;730;2630
312840;201807;1150;3579;888;3033;152;611;319;985;471;1596
312850;201807;832;2238;603;1854;70;268;288;807;358;1075
312860;201807;1440;3772;934;2922;234;775;240;732;474;1507
312870;201807;6147;17734;3849;12830;606;2232;974;3022;1580;5254
312880;201807;1410;3729;1147;3336;65;218;660;1954;725;2172
312890;201807;2075;5710;1373;4314;195;640;529;1687;724;2327
312900;201807;1203;3315;969;2997;85;295;595;1892;680;2187
312910;201807;1589;3012;884;2084;139;337;420;973;559;1310
312920;201807;990;2809;709;2323;124;468;345;1057;469;1525
312930;201807;2145;5765;1744;5140;398;1207;732;2143;1130;3350
312940;201807;909;2752;766;2496;132;464;356;1146;488;1610
312950;201807;2674;7150;1999;6083;592;1935;668;1989;1260;3924
312960;201807;1948;5297;1640;4841;126;379;1199;3610;1325;3989
312965;201807;1744;5258;1460;4721;126;436;921;2952;1047;3388
312970;201807;1095;3313;849;2901;195;769;339;1089;534;1858
312980;201807;21560;63867;18365;57950;3217;11350;9354;28071;12571;39421
312990;201807;428;1201;284;961;67;264;114;367;181;631
313000;201807;443;1369;358;1213;59;268;155;479;214;747
313005;201807;2593;7706;2246;7118;163;604;1624;5006;1787;5610
313010;201807;4506;13215;3678;11774;710;2508;2062;6399;2772;8907
313020;201807;959;3051;663;2358;107;428;87;241;194;669
313030;201807;1288;3231;882;2600;114;414;467;1318;581;1732
313040;201807;812;2607;672;2282;78;308;335;1076;413;1384
313050;201807;1812;5303;1287;4496;250;1031;359;1121;609;2152
313055;201807;1717;4997;1550;4743;49;155;1340;4103;1389;4258
313060;201807;991;2678;702;2177;228;781;143;391;371;1172
313065;201807;1818;5667;1553;5234;107;452;1140;3771;1247;4223
313070;201807;866;2414;689;2095;89;295;386;1140;475;1435
313080;201807;386;1106;279;885;73;259;67;167;140;426
313090;201807;4782;13465;4040;12180;916;2983;2056;6105;2972;9088
313100;201807;1450;3862;1121;3370;71;268;811;2396;882;2664
313110;201807;1556;4231;1086;3344;118;462;543;1524;661;1986
313115;201807;2452;7607;2167;7032;358;1291;1080;3288;1438;4579
313120;201807;3692;9025;2836;7897;295;905;1789;4968;2084;5873
313130;201807;27438;77048;22099;66662;3313;11300;10998;31350;14311;42650
313140;201807;527;1274;352;998;24;88;242;668;266;756
313150;201807;1336;3982;1030;3365;296;1023;247;765;543;1788
313160;201807;991;2661;768;2270;67;228;494;1400;561;1628
313170;201807;11816;36469;8473;29461;1637;5942;2871;9620;4508;15562
313180;201807;2329;6335;1625;4925;251;839;793;2344;1044;3183
313190;201807;4237;12892;3174;10602;630;2247;983;3082;1613;5329
313200;201807;1111;3242;949;2941;39;155;770;2308;809;2463
313210;201807;3973;11882;3213;10503;482;1764;1805;5716;2287;7480
313220;201807;1762;4864;1202;3761;203;732;438;1215;641;1947
313230;201807;2665;8140;2396;7778;80;250;2070;6753;2150;7003
313240;201807;8948;24108;5868;18735;1127;4079;2301;6754;3428;10833
313250;201807;6280;19152;5142;17012;660;2398;2616;8528;3276;10926
313260;201807;636;1753;435;1346;65;246;186;549;251;795
313270;201807;5558;15687;4431;13772;818;2673;2513;7821;3331;10494
313280;201807;392;1173;278;938;41;153;100;315;141;468
313290;201807;792;2637;624;2368;238;977;155;558;393;1535
313300;201807;1694;5054;1299;4257;365;1296;220;642;585;1938
313310;201807;1036;3290;870;2946;163;640;199;565;362;1205
313320;201807;2237;6090;1569;5018;304;1114;705;2251;1009;3365
313330;201807;4102;11616;3218;10182;229;1006;2084;6351;2313;7357
313340;201807;1433;3352;1015;2745;143;403;637;1735;780;2138
313350;201807;2301;6776;1618;5300;246;898;556;1669;802;2567
313360;201807;1311;3455;902;2749;166;606;453;1264;619;1870
313370;201807;1294;3937;1163;3679;149;562;669;1984;818;2546
313375;201807;1851;4932;1209;3830;230;850;289;862;519;1712
313380;201807;5593;15101;4148;12400;861;2837;1715;4638;2576;7475
313390;201807;879;2927;789;2773;66;284;503;1720;569;2004
313400;201807;3568;9377;2913;8512;194;593;2263;6528;2457;7121
313410;201807;1254;3389;992;2952;107;370;708;2063;815;2433
313420;201807;15542;36342;8460;24147;1841;5773;1157;3384;2998;9157
313430;201807;908;2734;683;2281;115;459;275;827;390;1286
313440;201807;6217;13829;4055;10988;366;1021;2475;6740;2841;7761
313450;201807;632;1821;468;1495;103;346;145;419;248;765
313460;201807;2183;6737;1787;6088;405;1629;793;2498;1198;4127
313470;201807;3144;7879;2540;7038;203;558;1825;5074;2028;5632
313480;201807;913;2706;545;1863;83;317;142;419;225;736
313490;201807;1503;3618;758;2503;263;1028;61;204;324;1232
313500;201807;422;1320;330;1092;33;127;121;359;154;486
313505;201807;9384;25951;8213;24475;347;1224;6927;20573;7274;21797
313507;201807;1495;3877;1248;3527;54;206;983;2743;1037;2949
313510;201807;13166;37386;10983;33471;1447;4865;5547;16441;6994;21306
313520;201807;13675;40529;11222;36133;918;3462;7742;24522;8660;27984
313530;201807;531;1560;437;1401;27;99;206;623;233;722
313535;201807;2464;6906;2153;6333;173;514;1487;4313;1660;4827
313540;201807;861;2690;643;2105;155;529;216;684;371;1213
313545;201807;1186;4089;1018;3746;182;740;555;1965;737;2705
313550;201807;1791;5496;1507;4910;373;1315;713;2223;1086;3538
313560;201807;2549;5259;1899;4481;88;215;1567;3657;1655;3872
313570;201807;953;3036;775;2681;189;721;303;1001;492;1722
313580;201807;5578;15333;4355;13339;664;2146;2267;7210;2931;9356
313590;201807;948;2762;732;2428;262;954;255;871;517;1825
313600;201807;3721;10504;3131;9554;182;722;2452;7357;2634;8079
313610;201807;1004;2730;820;2386;125;374;495;1414;620;1788
313620;201807;5770;16137;4730;14304;914;3026;2240;6562;3154;9588
313630;201807;8454;21746;5872;17835;818;2805;2999;9139;3817;11944
313640;201807;1026;2493;633;1932;192;643;212;605;404;1248
313650;201807;1838;5731;1545;5245;112;474;996;3384;1108;3858
313652;201807;796;2737;735;2603;134;521;440;1497;574;2018
313655;201807;1038;2958;842;2663;56;213;622;1933;678;2146
313657;201807;1320;3588;1006;3070;55;230;724;2071;779;2301
313660;201807;867;2615;714;2305;116;445;364;1089;480;1534
313665;201807;4464;12856;3574;11201;559;1987;1913;5721;2472;7708
313670;201807;43575;117142;29666;91455;5646;19103;10930;32034;16576;51137
313680;201807;1011;2815;858;2577;72;243;541;1578;613;1821
313690;201807;849;2850;682;2500;152;582;216;801;368;1383
313695;201807;1616;4724;1274;4136;104;385;882;2850;986;3235
313700;201807;3238;10705;2791;10110;263;969;2156;7891;2419;8860
313710;201807;1439;3659;1032;3029;109;336;623;1829;732;2165
313720;201807;5703;16665;4166;13407;691;2488;1590;4713;2281;7201
313730;201807;1299;3190;989;2757;85;232;631;1719;716;1951
313740;201807;1778;6423;1467;5598;386;1631;181;617;567;2248
313750;201807;1967;5642;1537;4773;360;1230;545;1551;905;2781
313753;201807;2106;5281;1468;4243;184;597;802;2254;986;2851
313760;201807;5013;14480;3741;11946;916;3160;1324;4001;2240;7161
313770;201807;3710;10844;2986;9742;263;921;1998;6545;2261;7466
313780;201807;4058;11216;3042;9498;379;1362;833;2658;1212;4020
313790;201807;457;1470;414;1388;62;225;225;715;287;940
313800;201807;1324;3216;1063;2835;75;226;775;2072;850;2298
313810;201807;1627;4374;1314;3918;102;354;928;2765;1030;3119
313820;201807;13020;32607;9333;26110;1558;4941;3649;9660;5207;14601
313830;201807;339;1018;295;941;69;246;134;427;203;673
313835;201807;917;2801;765;2533;106;402;376;1164;482;1566
313840;201807;6702;18269;4928;15193;1241;4117;1088;3360;2329;7477
313850;201807;994;2570;818;2284;120;414;445;1119;565;1533
313860;201807;2731;7787;2010;6277;363;1218;691;2016;1054;3234
313862;201807;1500;3480;809;2398;79;245;416;1191;495;1436
313865;201807;2275;6485;1968;6005;143;471;1451;4351;1594;4822
313867;201807;1115;3700;945;3344;289;1079;402;1404;691;2483
313868;201807;1695;5486;1434;4948;114;495;1037;3501;1151;3996
313870;201807;814;2292;620;1944;121;411;206;577;327;988
313880;201807;1443;4080;1109;3518;230;814;428;1223;658;2037
313890;201807;2030;4806;1486;4096;141;418;949;2655;1090;3073
313900;201807;3730;11998;2972;10423;848;3258;676;2326;1524;5584
313910;201807;635;1994;483;1689;129;477;87;298;216;775
313920;201807;3040;9814;2525;8785;551;1939;1232;4376;1783;6315
313925;201807;1722;4547;1327;3813;260;719;753;2169;1013;2888
313930;201807;6057;20829;5091;19098;449;1650;3476;13658;3925;15308
313940;201807;8537;25977;6219;21855;1326;5342;1521;5793;2847;11135
313950;201807;4695;11441;3437;9695;553;1960;1935;5262;2488;7222
313960;201807;5538;14107;3774;11168;861;2802;1243;3453;2104;6255
313970;201807;1343;3927;1189;3661;70;288;725;2232;795;2520
313980;201807;1375;3846;908;3027;147;566;311;981;458;1547
313990;201807;1763;6082;1365;5096;389;1589;394;1358;783;2947
314000;201807;9354;26317;8011;23864;605;2300;5276;15383;5881;17683
314010;201807;1291;3284;1037;2944;45;174;801;2217;846;2391
314015;201807;2086;5906;1631;5183;225;866;880;2721;1105;3587
314020;201807;532;1521;319;1068;60;233;59;200;119;433
314030;201807;811;2495;630;2100;78;279;302;996;380;1275
314040;201807;740;2065;600;1792;108;353;278;797;386;1150
314050;201807;1579;4551;1197;3799;200;741;529;1531;729;2272
314053;201807;1733;5228;1432;4701;219;703;864;2974;1083;3677
314055;201807;2293;6373;1982;5916;58;245;1640;4885;1698;5130
314060;201807;1175;3326;903;2863;45;164;620;1921;665;2085
314070;201807;4435;12738;3463;10902;801;2600;1341;4115;2142;6715
314080;201807;1781;5279;1257;4110;215;839;392;1113;607;1952
314085;201807;2060;6433;1712;5882;367;1351;796;2719;1163;4070
314090;201807;3736;11273;3226;10430;262;1061;2123;6790;2385;7851
314100;201807;3260;7803;2614;6914;70;150;2101;5642;2171;5792
314110;201807;4267;12900;3576;11493;565;2057;1778;5297;2343;7354
314120;201807;860;2015;394;1222;93;339;63;187;156;526
314130;201807;786;2193;409;1375;57;223;150;487;207;710
314140;201807;4806;14261;3656;11899;658;2268;1562;4987;2220;7255
314150;201807;1484;3924;1140;3320;115;359;711;2003;826;2362
314160;201807;2448;6546;1775;5373;265;867;770;2375;1035;3242
314170;201807;1038;3025;845;2626;90;318;499;1442;589;1760
314180;201807;5315;15405;4432;13956;552;1871;2533;8015;3085;9886
314190;201807;741;2104;544;1787;98;352;267;874;365;1226
314200;201807;2915;8492;2418;7589;158;643;1695;5090;1853;5733
314210;201807;1980;5368;1657;4824;156;508;972;2763;1128;3271
314220;201807;1281;3749;906;3054;258;982;242;738;500;1720
314225;201807;1211;3491;1053;3263;79;262;766;2389;845;2651
314230;201807;774;2151;665;2008;102;347;394;1208;496;1555
314240;201807;1116;3157;873;2778;214;748;330;1067;544;1815
314250;201807;525;1520;341;1102;55;187;130;388;185;575
314260;201807;980;3122;806;2778;186;745;335;1053;521;1798
314270;201807;3150;9332;2551;8304;120;487;1870;5959;1990;6446
314280;201807;3387;8264;2119;6082;360;1157;827;2208;1187;3365
314290;201807;4566;12229;3818;10953;495;1444;2392;6766;2887;8210
314300;201807;1543;4751;1137;3850;297;1065;314;1045;611;2110
314310;201807;5238;14387;3823;11859;1171;3940;834;2411;2005;6351
314315;201807;878;3217;767;2966;68;323;530;1988;598;2311
314320;201807;2865;7950;1923;6303;435;1536;695;2269;1130;3805
314330;201807;49037;141198;38502;123041;11361;38124;9085;29689;20446;67813
314340;201807;2488;6446;1345;4239;267;996;257;636;524;1632
314345;201807;1363;4235;1145;3836;154;539;693;2281;847;2820
314350;201807;990;2844;687;2259;145;521;166;518;311;1039
314360;201807;649;1968;402;1408;65;253;101;330;166;583
314370;201807;655;1905;542;1716;34;129;398;1221;432;1350
314380;201807;1185;3460;809;2708;212;784;128;423;340;1207
314390;201807;11964;32680;8082;25304;1793;5999;2079;5885;3872;11884
314400;201807;4180;12459;3341;11040;942;3247;1165;3980;2107;7227
314410;201807;2778;8066;1964;6464;345;1265;668;2349;1013;3614
314420;201807;746;1955;577;1712;24;117;439;1245;463;1362
314430;201807;6544;17724;4972;14948;1022;3239;1804;5400;2826;8639
314435;201807;1463;4401;1244;4038;49;210;924;2966;973;3176
314437;201807;925;2438;708;2122;38;140;397;1197;435;1337
314440;201807;536;1587;410;1352;109;403;126;372;235;775
314450;201807;1399;3953;1160;3551;143;535;666;1916;809;2451
314460;201807;3605;11484;2644;9291;669;2472;422;1490;1091;3962
314465;201807;2237;6652;1964;6115;63;262;1534;4665;1597;4927
314467;201807;927;2620;776;2354;25;72;609;1837;634;1909
314470;201807;2234;6696;1837;5864;375;1324;767;2279;1142;3603
314480;201807;5962;18384;4205;14267;775;2854;1023;3161;1798;6015
314490;201807;877;2498;666;2058;94;331;392;1148;486;1479
314500;201807;1784;4760;1283;3911;253;792;456;1368;709;2160
314505;201807;1971;5169;1660;4733;121;411;1173;3285;1294;3696
314510;201807;1788;4783;1219;3944;259;925;492;1558;751;2483
314520;201807;3919;12675;2738;9913;522;2139;291;904;813;3043
314530;201807;5580;18682;5090;17729;538;2121;3444;11974;3982;14095
314535;201807;2630;7034;2134;6313;155;580;1588;4593;1743;5173
314537;201807;1127;3314;858;2849;74;288;576;1864;650;2152
314540;201807;400;1066;279;837;31;120;132;367;163;487
314545;201807;1684;4499;1508;4256;57;168;1255;3686;1312;3854
314550;201807;680;1726;498;1466;46;178;241;632;287;810
314560;201807;4088;13178;3260;11323;598;2275;1037;3401;1635;5676
314570;201807;307;881;237;746;37;127;111;346;148;473
314580;201807;491;1596;368;1331;93;349;66;250;159;599
314585;201807;755;2413;569;1993;77;338;252;815;329;1153
314587;201807;1948;5618;1519;4891;229;668;835;2753;1064;3421
314590;201807;3098;9453;2245;7625;409;1520;737;2373;1146;3893
314600;201807;1821;5373;1104;3895;255;996;118;367;373;1363
314610;201807;8402;23535;6206;19932;1274;4781;2463;7598;3737;12379
314620;201807;1876;4907;1512;4390;85;299;1214;3449;1299;3748
314625;201807;1511;4632;1327;4356;99;489;1001;3137;1100;3626
314630;201807;4999;13743;4180;12510;156;644;3386;10062;3542;10706
314640;201807;603;1584;434;1287;88;303;194;517;282;820
314650;201807;969;2514;648;1988;64;227;270;736;334;963
314655;201807;1558;4464;1117;3609;235;762;473;1531;708;2293
314660;201807;333;811;210;574;16;35;116;298;132;333
314670;201807;1672;4126;1205;3372;65;242;748;2037;813;2279
314675;201807;1795;4975;1533;4511;116;424;1151;3300;1267;3724
314690;201807;2122;6410;1624;5537;520;1948;371;1238;891;3186
314700;201807;10035;30322;6547;22890;1492;5784;1442;4820;2934;10604
314710;201807;8265;24096;5887;18962;1200;4215;1241;3544;2441;7759
314720;201807;2253;7049;1662;5771;380;1449;384;1317;764;2766
314730;201807;2094;6077;1555;5017;405;1374;422;1278;827;2652
314740;201807;2870;8410;2318;7407;277;1009;1229;3825;1506;4834
314750;201807;340;985;261;823;27;104;135;393;162;497
314760;201807;1852;5868;1283;4515;186;754;303;883;489;1637
314770;201807;1049;3159;521;1758;38;140;132;386;170;526
314780;201807;329;822;224;666;46;160;116;323;162;483
314790;201807;10873;31137;7797;25361;2329;8565;1368;3997;3697;12562
314795;201807;1470;4081;1252;3710;58;259;965;2726;1023;2985
314800;201807;11405;30420;6849;21559;1499;5085;1086;3068;2585;8153
314810;201807;9701;27623;7225;23166;1982;6545;2013;6822;3995;13367
314820;201807;945;2529;703;2130;89;329;396;1153;485;1482
314830;201807;1530;4857;1296;4400;299;1097;602;2024;901;3121
314840;201807;914;3017;723;2722;90;465;464;1659;554;2124
314850;201807;2004;5133;1597;4479;75;265;1321;3669;1396;3934
314860;201807;3231;10161;2712;9136;430;1600;1563;5128;1993;6728
314870;201807;5989;16601;4752;14859;399;1364;3455;10871;3854;12235
314875;201807;1732;5374;1559;5149;103;302;1308;4367;1411;4669
314880;201807;917;2281;721;2014;41;111;483;1402;524;1513
314890;201807;466;1369;333;1072;52;192;121;349;173;541
314900;201807;675;1858;519;1581;119;388;185;555;304;943
314910;201807;1670;5068;1285;4441;285;1184;605;1952;890;3136
314915;201807;2293;7034;1945;6412;153;622;1301;4154;1454;4776
314920;201807;462;1202;319;1006;19;69;197;602;216;671
314930;201807;5388;16373;4167;13912;914;3293;1379;4372;2293;7665
314940;201807;407;1083;345;973;31;86;212;560;243;646
314950;201807;405;1112;271;883;30;121;111;331;141;452
314960;201807;777;2098;589;1723;58;213;374;1020;432;1233
314970;201807;679;2068;553;1835;103;381;246;785;349;1166
314980;201807;1377;3918;1064;3430;310;1108;230;709;540;1817
314990;201807;2313;6908;1591;5225;358;1325;328;935;686;2260
314995;201807;1563;4642;1311;4211;106;429;794;2432;900;2861
315000;201807;1056;2942;804;2506;90;325;489;1465;579;1790
315010;201807;409;1221;305;1007;62;242;119;348;181;590
315015;201807;2162;6392;1951;6087;210;714;1267;4011;1477;4725
315020;201807;837;2505;604;2035;85;326;291;919;376;1245
315030;201807;587;1699;431;1393;122;440;93;258;215;698
315040;201807;834;2497;743;2293;108;362;463;1420;571;1782
315050;201807;1163;3166;910;2803;96;362;483;1457;579;1819
315053;201807;1157;3206;914;2754;95;324;504;1471;599;1795
315057;201807;1633;5342;1428;4915;193;666;869;3036;1062;3702
315060;201807;622;1962;420;1530;95;357;78;293;173;650
315070;201807;646;1824;471;1489;123;409;137;408;260;817
315080;201807;2654;8302;2087;7045;451;1512;943;3195;1394;4707
315090;201807;807;2627;622;2218;124;476;195;652;319;1128
315100;201807;1167;3733;771;2744;139;572;286;926;425;1498
315110;201807;1453;3908;1131;3353;155;470;547;1633;702;2103
315120;201807;12203;29190;8740;24204;1164;3267;4409;12766;5573;16033
315130;201807;1301;3974;1054;3453;183;697;388;1190;571;1887
315140;201807;2918;8453;2275;7240;457;1671;1020;2935;1477;4606
315150;201807;4264;11001;3044;8953;480;1567;1280;3678;1760;5245
315160;201807;1538;3962;1011;3092;213;680;399;1179;612;1859
315170;201807;1525;4828;1066;3754;255;930;176;623;431;1553
315180;201807;17514;45995;9276;29123;1447;5190;2176;5956;3623;11146
315190;201807;2077;4922;1650;4320;276;746;1143;2964;1419;3710
315200;201807;3703;11352;2810;9671;850;3158;624;2118;1474;5276
315210;201807;8091;22245;5975;17675;783;2585;2571;6941;3354;9526
315213;201807;1132;3135;974;2904;27;89;775;2289;802;2378
315217;201807;2494;8024;1992;7089;128;632;1310;4494;1438;5126
315220;201807;8772;24609;7051;21599;1975;6343;2360;7227;4335;13570
315230;201807;3107;7699;2708;7230;81;137;2375;6584;2456;6721
315240;201807;2586;7956;2241;7368;574;2039;1105;3544;1679;5583
315250;201807;10330;29685;7804;24920;1456;5139;3115;9587;4571;14726
315260;201807;969;2881;551;1903;102;362;49;137;151;499
315270;201807;774;2382;545;1906;92;387;146;435;238;822
315280;201807;2894;7642;1663;5143;412;1363;261;781;673;2144
315290;201807;1254;3298;772;2511;226;804;185;597;411;1401
315300;201807;704;1772;479;1468;207;695;117;367;324;1062
315310;201807;1326;3877;1008;3251;95;335;544;1663;639;1998
315320;201807;691;2057;509;1728;65;309;218;683;283;992
315330;201807;743;2635;410;1677;77;337;109;394;186;731
315340;201807;3228;8442;2474;7329;238;777;1488;4326;1726;5103
315350;201807;1589;4405;1166;3677;150;526;545;1691;695;2217
315360;201807;1670;5231;1234;4257;210;777;445;1449;655;2226
315370;201807;457;1380;373;1203;67;219;164;511;231;730
315380;201807;193;613;148;507;39;155;28;73;67;228
315390;201807;1262;3874;944;3198;189;695;310;985;499;1680
315400;201807;4194;12052;3322;10399;498;1658;1685;5121;2183;6779
315410;201807;2329;5501;1815;4770;435;1257;581;1481;1016;2738
315415;201807;1194;3519;976;3163;259;951;377;1200;636;2151
315420;201807;1156;3513;797;2786;168;605;103;327;271;932
315430;201807;3580;9164;2569;7528;591;2022;911;2474;1502;4496
315440;201807;990;2777;826;2496;107;395;440;1225;547;1620
315445;201807;2023;5171;1513;4386;157;506;1010;2883;1167;3389
315450;201807;2252;6664;1922;6123;288;918;1183;3842;1471;4760
315460;201807;31333;94968;26797;86236;7448;25652;9372;28654;16820;54306
315470;201807;479;1410;377;1223;39;141;190;594;229;735
315480;201807;1452;4284;991;3284;203;727;253;821;456;1548
315490;201807;3002;7610;2113;6330;293;957;766;2246;1059;3203
315500;201807;500;1421;309;985;21;86;148;414;169;500
315510;201807;1269;3578;1087;3295;42;178;905;2685;947;2863
315520;201807;1106;3171;871;2784;62;238;573;1766;635;2004
315530;201807;655;2070;518;1737;186;677;178;560;364;1237
315540;201807;1193;3413;856;2762;127;484;345;1082;472;1566
315550;201807;1840;5018;1323;4184;309;1120;408;1217;717;2337
315560;201807;6137;19774;5433;18512;409;1477;3574;12231;3983;13708
315570;201807;1882;5610;1616;5096;126;516;910;2750;1036;3266
315580;201807;2272;5992;1775;5157;422;1400;556;1580;978;2980
315590;201807;928;2545;744;2247;104;370;356;1032;460;1402
315600;201807;2406;8054;1791;6821;268;1034;973;3817;1241;4851
315610;201807;946;2501;732;2092;134;480;310;735;444;1215
315620;201807;309;1017;283;976;58;196;158;587;216;783
315630;201807;878;2600;731;2320;180;626;218;609;398;1235
315640;201807;388;1046;324;944;39;136;179;498;218;634
315645;201807;911;2446;620;1942;176;600;159;466;335;1066
315650;201807;1802;4684;1405;4108;71;290;1079;3061;1150;3351
315660;201807;2500;6273;1890;5237;133;390;1267;3415;1400;3805
315670;201807;12793;37635;10397;33142;2216;7528;4555;14081;6771;21609
315680;201807;3006;9463;2269;7982;448;1731;933;3224;1381;4955
315690;201807;2910;7774;1883;5925;447;1479;480;1629;927;3108
315700;201807;7291;21347;5726;18230;1039;3562;2569;7896;3608;11458
315710;201807;1924;5019;1339;4066;77;338;888;2531;965;2869
315720;201807;4190;12465;3604;11365;216;1002;2427;7275;2643;8277
315725;201807;1627;4626;1367;4269;177;562;949;3039;1126;3601
315727;201807;570;1599;427;1328;65;232;200;580;265;812
315730;201807;681;2108;602;1934;86;318;276;833;362;1151
315733;201807;1425;3781;1018;3048;177;626;366;1022;543;1648
315737;201807;1131;3358;899;2916;44;190;630;2007;674;2197
315740;201807;981;2846;770;2403;138;514;373;1046;511;1560
315750;201807;1220;3416;1025;3092;93;310;672;2026;765;2336
315760;201807;1210;2936;1117;2827;48;107;997;2543;1045;2650
315765;201807;1838;5087;1538;4700;42;163;1353;4139;1395;4302
315770;201807;1182;3661;1001;3392;355;1329;304;980;659;2309
315780;201807;26387;77573;22742;70746;2463;9200;13360;39486;15823;48686
315790;201807;3656;11521;3116;10508;264;923;2030;7020;2294;7943
315800;201807;1240;4754;920;3819;187;858;197;752;384;1610
315810;201807;1307;3337;1138;3088;60;219;893;2288;953;2507
315820;201807;2455;7415;2107;6833;259;949;1389;4417;1648;5366
315830;201807;1168;3477;860;2905;77;318;366;1173;443;1491
315840;201807;765;1936;467;1362;64;212;183;481;247;693
315850;201807;1063;3410;922;3173;200;759;456;1467;656;2226
315860;201807;524;1633;362;1300;74;294;101;338;175;632
315870;201807;453;1238;370;1114;35;134;239;665;274;799
315880;201807;1138;3004;803;2434;66;255;271;762;337;1017
315890;201807;1498;4789;1281;4410;378;1400;539;1777;917;3177
315895;201807;5978;17109;4739;14541;670;2354;2170;6127;2840;8481
315900;201807;838;2225;737;2082;63;207;574;1561;637;1768
315910;201807;490;1528;428;1422;75;272;271;866;346;1138
315920;201807;1602;4341;843;2675;163;552;223;647;386;1199
315930;201807;1072;2619;735;2076;135;381;306;853;441;1234
315935;201807;842;2684;705;2413;160;593;216;763;376;1356
315940;201807;613;1847;511;1642;65;231;267;843;332;1074
315950;201807;1206;3437;1023;3128;131;389;739;2284;870;2673
315960;201807;3649;10700;2293;8108;748;3100;124;266;872;3366
315970;201807;647;1831;516;1641;58;187;361;1170;419;1357
315980;201807;3764;8782;2203;6151;468;1423;752;1921;1220;3344
315990;201807;3783;9971;2976;8595;340;1076;1673;4726;2013;5802
316000;201807;531;1513;424;1341;72;279;177;514;249;793
316010;201807;708;2159;557;1858;61;256;308;936;369;1192
316020;201807;985;3044;814;2719;82;380;513;1585;595;1965
316030;201807;2990;8453;2162;6947;247;854;1327;4328;1574;5182
316040;201807;3190;10455;2412;8886;337;1248;828;3311;1165;4559
316045;201807;1973;5605;1828;5386;142;364;1469;4444;1611;4808
316050;201807;349;1066;263;901;45;185;141;452;186;637
316060;201807;712;1945;539;1676;56;230;334;958;390;1188
316070;201807;5820;16963;4851;15049;884;3001;2158;6418;3042;9419
316080;201807;744;2451;610;2165;169;666;77;267;246;933
316090;201807;469;1428;326;1126;54;218;122;388;176;606
316095;201807;1371;4297;1158;3865;248;871;533;1748;781;2619
316100;201807;2581;8039;1861;6372;351;1304;562;1776;913;3080
316105;201807;878;2405;654;2038;86;282;398;1242;484;1524
316110;201807;12370;38405;10602;35318;1280;4543;6795;22760;8075;27303
316120;201807;1042;3240;732;2465;144;506;187;539;331;1045
316130;201807;1432;3232;835;2293;89;295;404;1047;493;1342
316140;201807;1087;2963;726;2335;134;454;355;1141;489;1595
316150;201807;1638;4036;1379;3627;258;783;625;1520;883;2303
316160;201807;1090;3116;877;2727;93;332;512;1527;605;1859
316165;201807;894;2281;691;1959;118;398;379;1028;497;1426
316170;201807;1144;3092;860;2656;97;353;484;1426;581;1779
316180;201807;1392;4201;934;3183;195;738;127;354;322;1092
316190;201807;2638;7818;1537;5072;266;905;518;1510;784;2415
316200;201807;3514;10627;2586;8805;586;2279;591;1890;1177;4169
316210;201807;4521;13680;3270;10948;1064;3775;345;1157;1409;4932
316220;201807;643;1999;430;1514;93;362;47;191;140;553
316225;201807;1354;3306;1037;2764;54;213;753;1862;807;2075
316230;201807;429;1161;328;1012;35;104;163;522;198;626
316240;201807;6073;17826;5333;16696;561;1842;3910;12174;4471;14016
316245;201807;3092;10500;2787;9991;175;958;2121;7323;2296;8281
316250;201807;9698;25499;7006;20750;1817;5857;1741;4967;3558;10824
316255;201807;2810;8096;2426;7518;258;869;1695;5292;1953;6161
316257;201807;1278;3245;896;2622;126;400;438;1243;564;1643
316260;201807;1901;5019;1432;4287;50;172;792;2455;842;2627
316265;201807;1292;3483;932;2857;55;207;616;1833;671;2040
316270;201807;3499;11337;3047;10299;608;2212;1325;4297;1933;6509
316280;201807;3136;9584;2738;8828;405;1460;1447;4481;1852;5941
316290;201807;3363;9910;2652;8497;453;1694;914;2902;1367;4596
316292;201807;4491;12626;3705;11329;406;1433;2570;7675;2976;9108
316294;201807;785;2375;578;2005;112;433;100;341;212;774
316295;201807;2588;7550;2189;6817;127;553;1579;4708;1706;5261
316300;201807;977;3089;824;2794;69;275;525;1781;594;2056
316310;201807;967;2402;554;1737;89;309;210;640;299;949
316320;201807;578;1701;440;1453;68;256;170;549;238;805
316330;201807;1069;3021;801;2477;69;255;542;1608;611;1863
316340;201807;1085;3178;804;2616;87;365;421;1271;508;1636
316350;201807;1233;3769;1077;3515;135;484;682;2208;817;2692
316360;201807;684;1796;545;1571;62;199;381;1075;443;1274
316370;201807;4745;13766;3743;11779;849;3052;1088;3058;1937;6110
316380;201807;1645;4128;1255;3593;46;141;894;2540;940;2681
316390;201807;870;2364;654;1988;195;662;213;623;408;1285
316400;201807;1295;3811;881;2993;152;551;312;993;464;1544
316410;201807;1063;3241;892;2960;70;247;705;2305;775;2552
316420;201807;1740;5317;1539;5041;108;459;1198;3851;1306;4310
316430;201807;900;2595;577;1936;129;452;130;419;259;871
316440;201807;701;2228;535;1945;144;602;72;246;216;848
316443;201807;577;1696;451;1450;116;418;113;356;229;774
316447;201807;1791;4983;1565;4643;65;223;1259;3721;1324;3944
316450;201807;2195;6918;1716;5920;209;786;1088;3700;1297;4486
316460;201807;919;2569;771;2332;214;684;366;1072;580;1756
316470;201807;6209;18666;4777;15736;979;3656;1551;4712;2530;8368
316480;201807;196;597;167;536;32;121;73;213;105;334
316490;201807;325;914;240;731;33;113;98;263;131;376
316500;201807;1231;4088;794;2929;157;624;121;421;278;1045
316510;201807;654;2365;585;2216;142;585;231;887;373;1472
316520;201807;1022;2898;810;2520;134;503;338;980;472;1483
316530;201807;986;2881;751;2431;124;514;315;896;439;1410
316540;201807;735;2221;637;2047;123;464;224;656;347;1120
316550;201807;1292;4048;1154;3776;112;435;812;2600;924;3035
316553;201807;3204;10059;2201;7608;554;2063;437;1374;991;3437
316555;201807;2660;8784;2392;8406;150;588;1818;6526;1968;7114
316556;201807;644;1588;452;1271;34;102;244;612;278;714
316557;201807;915;3111;806;2908;331;1254;240;834;571;2088
316560;201807;273;856;206;759;54;239;52;174;106;413
316570;201807;1131;3544;1010;3302;274;906;356;1166;630;2072
316580;201807;381;948;240;683;53;168;92;235;145;403
316590;201807;1392;3728;986;2976;175;565;523;1475;698;2040
316600;201807;1014;3205;880;2928;149;540;452;1480;601;2020
316610;201807;598;1989;503;1816;67;328;307;1046;374;1374
316620;201807;2084;6018;1789;5574;114;429;1285;4013;1399;4442
316630;201807;1518;4695;1211;4082;345;1159;459;1705;804;2864
316640;201807;152;426;122;374;25;84;55;137;80;221
316650;201807;986;3288;802;3000;67;275;508;1962;575;2237
316660;201807;195;496;88;268;13;51;12;32;25;83
316670;201807;1952;5194;1481;4392;415;1302;442;1258;857;2560
316680;201807;2096;5501;1637;4761;160;536;1141;3221;1301;3757
316690;201807;1096;3443;913;3094;219;841;361;1186;580;2027
316695;201807;985;2982;847;2737;49;212;567;1787;616;1999
316700;201807;388;997;327;926;20;88;238;628;258;716
316710;201807;2739;9645;2173;8397;644;2561;698;2786;1342;5347
316720;201807;19483;57369;14894;48038;3169;11002;5547;17086;8716;28088
316730;201807;356;1053;300;931;63;216;129;359;192;575
316740;201807;685;2099;618;2001;70;302;428;1368;498;1670
316750;201807;413;1299;313;1091;67;250;112;378;179;628
316760;201807;3690;11824;2978;10477;1285;4829;849;2934;2134;7763
316770;201807;1495;3762;1212;3370;32;114;1032;2891;1064;3005
316780;201807;609;1907;478;1649;147;576;65;191;212;767
316790;201807;726;2016;530;1651;123;411;174;527;297;938
316800;201807;5620;16786;4600;14888;469;1788;2643;8250;3112;10038
316805;201807;971;2211;837;2059;25;40;743;1909;768;1949
316810;201807;565;1624;408;1327;103;377;166;520;269;897
316820;201807;332;833;172;542;27;98;39;125;66;223
316830;201807;663;1978;555;1792;102;400;330;1014;432;1414
316840;201807;2652;7673;2263;6936;401;1404;1159;3378;1560;4782
316850;201807;2092;5658;1530;4651;216;748;706;2076;922;2824
316860;201807;17680;50254;13933;44246;2778;10089;5915;18223;8693;28312
316870;201807;6720;20005;5128;16671;1115;3944;1668;5133;2783;9077
316880;201807;860;2392;725;2184;147;513;312;905;459;1418
316890;201807;1213;2845;792;2272;171;594;418;1061;589;1655
316900;201807;2344;6666;1859;5649;415;1411;616;1695;1031;3106
316905;201807;475;1488;386;1297;86;313;164;549;250;862
316910;201807;887;2558;601;2022;158;626;56;170;214;796
316920;201807;1659;4380;1121;3511;195;665;487;1535;682;2200
316930;201807;7959;25119;5931;20980;1142;4420;1269;4290;2411;8710
316935;201807;4099;11769;2888;9412;665;2300;848;2729;1513;5029
316940;201807;6799;21057;5214;17489;988;3700;1640;5033;2628;8733
316950;201807;1760;4446;1380;3900;65;237;1073;2951;1138;3188
316960;201807;4955;11850;3693;10062;541;1614;2270;6076;2811;7690
316970;201807;3274;9948;2913;9234;738;2410;1020;3094;1758;5504
316980;201807;792;2390;551;1905;166;630;64;218;230;848
316990;201807;10307;30209;7711;24581;2124;7191;831;2428;2955;9619
317000;201807;2673;8384;2470;8090;181;615;1775;6041;1956;6656
317005;201807;2564;7516;2107;6684;374;1215;1078;3377;1452;4592
317010;201807;23878;57839;14370;43117;3570;11721;3383;10768;6953;22489
317020;201807;61467;156273;35596;107216;7018;23086;8646;23756;15664;46842
317030;201807;678;1916;541;1713;40;167;379;1172;419;1339
317040;201807;10704;28511;7689;23165;1890;5980;2825;8600;4715;14580
317043;201807;780;1934;620;1711;114;345;377;1034;491;1379
317047;201807;1168;2881;808;2306;123;330;447;1299;570;1629
317050;201807;1329;4250;944;3337;137;525;334;1075;471;1600
317052;201807;2350;7015;1947;6322;257;921;1259;4018;1516;4939
317057;201807;1664;4263;1182;3421;60;228;761;2133;821;2361
317060;201807;420;1151;237;755;38;128;86;248;124;376
317065;201807;1266;3665;1034;3229;58;239;718;2106;776;2345
317070;201807;8476;24547;5616;18506;1217;4484;1077;3343;2294;7827
317075;201807;977;2903;692;2288;147;494;143;446;290;940
317080;201807;6022;15200;4687;12942;1556;4479;1242;3201;2798;7680
317090;201807;4533;14226;4130;13579;399;1353;2955;9712;3354;11065
317100;201807;2717;6770;1846;5373;569;1743;554;1575;1123;3318
317103;201807;1855;6024;1624;5595;220;1002;976;3156;1196;4158
317107;201807;1330;3811;1087;3315;67;283;661;1810;728;2093
317110;201807;672;1483;332;999;51;199;116;339;167;538
317115;201807;1129;3349;940;2971;75;237;655;2068;730;2305
317120;201807;12038;35574;9426;30833;1542;5688;4652;14626;6194;20314
317130;201807;8946;22599;5945;17587;1275;4133;1893;5521;3168;9654
317140;201807;583;1763;497;1608;55;177;303;989;358;1166
317150;201807;1022;2592;817;2332;45;173;635;1752;680;1925
317160;201807;3647;9093;2541;7436;260;791;1515;4452;1775;5243
317170;201807;1995;5193;1410;4137;237;811;500;1274;737;2085
317180;201807;1667;5487;1295;4612;314;1212;319;1059;633;2271
317190;201807;1320;3679;979;3132;115;389;593;1881;708;2270
317200;201807;4854;13474;3643;11243;882;2987;825;2349;1707;5336
317210;201807;1084;2871;859;2544;56;216;617;1847;673;2063
317220;201807;268;887;239;819;61;226;92;303;153;529
320010;201807;4629;13942;3810;12326;456;1636;2320;7296;2776;8932
320013;201807;1704;5153;1229;4049;205;649;539;1836;744;2485
320016;201807;3092;8180;2501;7318;139;405;1984;5794;2123;6199
320020;201807;3931;11230;3039;9557;800;2692;980;3165;1780;5857
320030;201807;1456;4441;1021;3484;263;980;309;971;572;1951
320035;201807;1710;4898;1442;4454;420;1405;610;1831;1030;3236
320040;201807;3418;10462;2807;9290;480;1710;1343;4372;1823;6082
320050;201807;1764;4299;1540;3941;301;847;839;2083;1140;2930
320060;201807;10381;30876;7699;25347;1476;5296;2746;8702;4222;13998
320070;201807;1430;4295;1059;3513;213;751;316;1017;529;1768
320080;201807;5430;14891;3995;12058;814;2585;1528;4585;2342;7170
320090;201807;6924;19590;5171;16007;1262;4114;2060;6171;3322;10285
320100;201807;2559;7659;1991;6535;514;1798;792;2524;1306;4322
320110;201807;1320;3607;1043;3094;238;737;366;1089;604;1826
320115;201807;1809;6075;1573;5644;721;2658;466;1754;1187;4412
320120;201807;15775;43541;11379;35424;2329;7969;3805;11356;6134;19325
320130;201807;36552;109205;31218;99329;5221;18314;16698;51641;21919;69955
320140;201807;3052;9173;2220;7378;482;1833;691;2237;1173;4070
320150;201807;14011;38925;10104;31099;2851;9170;2009;6253;4860;15423
320160;201807;5374;16055;4176;13637;794;2811;1870;6022;2664;8833
320170;201807;1614;4874;1194;3979;322;1086;438;1450;760;2536
320180;201807;699;2308;569;2043;209;793;128;460;337;1253
320190;201807;3038;10062;2287;8313;596;2253;475;1721;1071;3974
320200;201807;1027;2995;762;2507;219;804;219;730;438;1534
320210;201807;4637;12369;3646;10583;618;1970;1841;5124;2459;7094
320220;201807;2687;7592;2068;6500;383;1275;1056;3285;1439;4560
320225;201807;1296;4227;928;3296;350;1323;131;455;481;1778
320230;201807;4438;13188;3444;11430;873;3177;1354;4474;2227;7651
320240;201807;13658;37432;10592;32293;2245;7352;4428;13490;6673;20842
320245;201807;2966;9419;2505;8423;1014;3521;596;1990;1610;5511
320250;201807;1981;5848;1344;4326;314;1108;295;874;609;1982
320255;201807;1696;5636;1495;5276;550;1989;609;2269;1159;4258
320260;201807;1020;3054;737;2379;220;781;190;528;410;1309
320265;201807;2414;7631;2029;6871;892;3174;515;1741;1407;4915
320270;201807;2305;6792;1751;5660;353;1203;785;2564;1138;3767
320280;201807;5703;16709;4721;14866;1273;4227;1526;4747;2799;8974
320290;201807;1324;4121;903;3083;270;1021;186;590;456;1611
320300;201807;3783;12186;3095;10629;1013;3705;641;2143;1654;5848
320305;201807;4692;14090;3751;12093;873;2964;1563;4904;2436;7868
320310;201807;1831;5318;1346;4284;288;952;544;1695;832;2647
320313;201807;2141;5784;1421;4307;340;1128;280;806;620;1934
320316;201807;1510;4415;1189;3773;245;828;593;1871;838;2699
320320;201807;20411;56449;14591;46135;3700;12312;5103;16100;8803;28412
320330;201807;2892;8309;2318;7249;623;1912;992;3271;1615;5183
320332;201807;5422;16391;4513;14715;1064;3704;2244;7209;3308;10913
320334;201807;2046;6193;1393;4751;318;1255;293;873;611;2128
320335;201807;1846;5446;1158;3810;311;1109;220;651;531;1760
320340;201807;4941;13105;4159;11873;720;2158;2186;6368;2906;8526
320350;201807;5055;13063;3544;10258;579;1791;1605;4459;2184;6250
320360;201807;1560;4083;1131;3241;167;458;531;1480;698;1938
320370;201807;2546;8287;1986;6971;579;2082;659;2295;1238;4377
320380;201807;2220;6309;1865;5695;359;1210;994;2923;1353;4133
320390;201807;7325;20755;5514;16949;1266;4137;2095;6212;3361;10349
320400;201807;3355;9951;2747;8680;716;2402;1102;3425;1818;5827
320405;201807;4509;12472;3524;10778;551;1787;1864;5650;2415;7437
320410;201807;4949;13485;3716;11526;635;2034;1827;5895;2462;7929
320420;201807;2685;7664;2100;6619;598;2064;509;1589;1107;3653
320425;201807;2013;4978;1537;4179;135;415;979;2560;1114;2975
320430;201807;2687;7091;2116;5928;346;1054;1218;3218;1564;4272
320435;201807;2327;7493;1841;6489;672;2485;530;1914;1202;4399
320440;201807;1172;3488;896;2911;158;563;390;1243;548;1806
320450;201807;1654;5002;1310;4324;323;1172;580;1829;903;3001
320455;201807;3770;11937;2652;9265;768;2846;709;2434;1477;5280
320460;201807;2295;7149;1621;5584;389;1403;360;1168;749;2571
320465;201807;1289;3810;975;3148;128;454;536;1723;664;2177
320470;201807;3963;11312;2680;8562;722;2452;552;1657;1274;4109
320480;201807;1705;5065;1447;4534;265;917;704;2148;969;3065
320490;201807;16877;47525;13238;41067;2584;8885;5441;16889;8025;25774
320495;201807;1404;4009;933;3016;209;726;288;919;497;1645
320500;201807;46060;130128;38352;116447;7019;22957;20257;59560;27276;82517
320501;201807;4698;13991;3411;11665;964;3708;959;3174;1923;6882
320503;201807;2108;6705;1581;5552;488;1909;469;1516;957;3425
320506;201807;3274;9889;2235;7457;622;2245;139;431;761;2676
320510;201807;9320;26718;7640;23679;1275;4376;4149;12501;5424;16877
320515;201807;1824;5083;1415;4227;418;1309;365;1099;783;2408
320517;201807;2052;6489;1654;5632;578;2122;379;1260;957;3382
320520;201807;33323;93575;25635;80181;5322;18153;10000;30776;15322;48929
320530;201807;29089;81596;22844;70164;3127;11368;12891;37162;16018;48530
330010;201807;19855;57493;16800;52062;3392;10962;8937;27573;12329;38535
330015;201807;1383;3710;1150;3293;181;586;587;1607;768;2193
330020;201807;19258;51298;16949;47829;2529;8071;11513;31589;14042;39660
330022;201807;1875;5263;1497;4630;267;913;888;2680;1155;3593
330023;201807;3420;9349;2632;8153;612;1999;1065;3229;1677;5228
330025;201807;4716;12379;3320;9843;1019;3297;1040;3013;2059;6310
330030;201807;9115;27213;7394;24011;1104;4086;4053;12493;5157;16579
330040;201807;11745;33374;10167;30546;1461;4866;6369;18422;7830;23288
330045;201807;80688;201893;68209;184950;7447;19931;50387;135450;57834;155381
330050;201807;2376;6647;1848;5738;427;1437;804;2350;1231;3787
330060;201807;5273;14572;4396;13142;995;3286;1876;5305;2871;8591
330070;201807;20117;55914;17064;51115;3380;10690;8773;26219;12153;36909
330080;201807;8751;24043;7713;22443;917;2777;5083;14723;6000;17500
330090;201807;2477;6199;2054;5592;240;699;1295;3416;1535;4115
330093;201807;2106;5795;1628;5010;197;610;1051;3285;1248;3895
330095;201807;1030;3261;856;2900;117;459;425;1343;542;1802
330100;201807;62810;177358;53958;163753;4916;17461;37271;111291;42187;128752
330110;201807;2122;6458;1870;6017;360;1301;847;2618;1207;3919
330115;201807;1820;4940;1479;4424;251;833;869;2549;1120;3382
330120;201807;2992;7368;2401;6586;217;664;1760;4726;1977;5390
330130;201807;3546;10463;3005;9619;556;1932;1687;5390;2243;7322
330140;201807;3299;9328;2787;8543;463;1650;1650;4890;2113;6540
330150;201807;2062;5848;1642;5136;352;1181;667;2035;1019;3216
330160;201807;1157;3380;968;3085;225;782;469;1428;694;2210
330170;201807;94386;260534;81504;241672;13369;40441;49558;147378;62927;187819
330180;201807;2105;5652;1693;4967;129;486;1141;3203;1270;3689
330185;201807;9207;25610;7685;22946;950;3243;5132;14809;6082;18052
330187;201807;3634;9946;3033;8998;473;1545;1834;5338;2307;6883
330190;201807;28759;74746;25401;69984;2663;7680;19200;52446;21863;60126
330200;201807;13715;38784;11710;35992;2703;8049;6647;21081;9350;29130
330205;201807;1933;5143;1609;4611;121;424;1095;3017;1216;3441
330210;201807;3190;8540;2353;6955;492;1544;834;2322;1326;3866
330220;201807;10014;28057;7820;23809;1858;6103;2169;6068;4027;12171
330225;201807;3618;10263;2943;9141;295;1182;1943;5764;2238;6946
330227;201807;16306;43104;14237;40272;1336;4119;10927;30598;12263;34717
330230;201807;1261;3451;1056;3125;90;280;694;2022;784;2302
330240;201807;18806;52800;15487;47306;3341;11080;7546;22380;10887;33460
330245;201807;1313;3669;910;2934;221;749;251;800;472;1549
330250;201807;34403;95105;29735;87730;7467;22316;13892;41988;21359;64304
330260;201807;4431;12422;3544;10967;583;1971;1857;5459;2440;7430
330270;201807;24528;51873;14941;38050;2869;7912;6123;15405;8992;23317
330280;201807;2247;6252;1778;5397;249;837;961;2795;1210;3632
330285;201807;20018;51714;16514;46649;2062;6541;10936;29933;12998;36474
330290;201807;3248;8971;2721;8095;419;1330;1507;4348;1926;5678
330300;201807;3481;10417;2980;9507;421;1550;1825;5626;2246;7176
330310;201807;2262;6102;1778;5264;143;418;1112;3291;1255;3709
330320;201807;13341;35802;11715;33502;1692;4933;8263;23718;9955;28651
330330;201807;29665;74049;24648;66660;3241;9781;16461;43180;19702;52961
330340;201807;13420;36940;10456;31780;2158;7159;4444;12856;6602;20015
330350;201807;96329;252701;82458;233868;8551;25949;60004;169102;68555;195051
330360;201807;7270;18724;6291;17565;399;1152;5156;14374;5555;15526
330370;201807;3606;12061;3109;10961;839;3121;1199;4210;2038;7331
330380;201807;5022;14891;3967;12949;919;3280;1527;4788;2446;8068
330385;201807;3910;12391;3349;11460;906;3380;1379;4736;2285;8116
330390;201807;22707;68475;18370;59937;3738;13235;8461;26622;12199;39857
330395;201807;3091;8398;2668;7794;223;760;1779;5118;2002;5878
330400;201807;2859;8189;2530;7590;207;778;1759;4940;1966;5718
330410;201807;2752;7967;2066;6709;420;1507;889;2719;1309;4226
330411;201807;2417;7022;2024;6246;198;737;1381;4059;1579;4796
330412;201807;1431;4487;1183;4001;194;723;612;1930;806;2653
330414;201807;23397;61754;19322;56021;2603;7463;12655;36738;15258;44201
330415;201807;3589;10281;2810;8927;481;1518;1379;4536;1860;6054
330420;201807;9324;24563;6186;19185;1075;3573;2158;6377;3233;9950
330430;201807;7804;21200;6835;19586;756;2521;4562;12575;5318;15096
330440;201807;1613;4970;1378;4575;353;1331;604;1880;957;3211
330450;201807;1318;4097;1087;3660;185;676;530;1736;715;2412
330452;201807;14712;40158;11516;34696;2313;7541;5804;16988;8117;24529
330455;201807;538490;1362873;416086;1172650;72781;218069;234779;650054;307560;868123
330460;201807;1214;3598;952;3174;200;709;444;1435;644;2144
330470;201807;4306;11758;3364;10232;889;2864;1362;4075;2251;6939
330475;201807;8386;23486;6913;21367;1660;5624;3555;10775;5215;16399
330480;201807;5825;16208;5018;14963;662;2225;3133;9013;3795;11238
330490;201807;115288;281470;97864;256466;10434;29716;68793;176551;79227;206267
330500;201807;5177;14787;4743;14133;676;2160;3342;9845;4018;12005
330510;201807;38209;105431;31015;94657;8342;25881;14615;44844;22957;70725
330513;201807;1164;3371;1013;3096;293;955;403;1205;696;2160
330515;201807;2745;7916;2273;7072;684;2231;845;2572;1529;4803
330520;201807;10409;30051;8813;27261;1623;5509;4414;13173;6037;18682
330530;201807;1555;4129;1218;3558;284;904;525;1459;809;2363
330540;201807;2789;7868;2236;6879;672;2136;779;2352;1451;4488
330550;201807;7768;23889;6596;21868;2437;8470;1717;5757;4154;14227
330555;201807;11737;30254;9993;27876;1468;4398;6622;18570;8090;22968
330560;201807;4246;12068;3583;10832;482;1543;2100;6163;2582;7706
330570;201807;2879;8326;2414;7501;477;1574;1348;4131;1825;5705
330575;201807;5380;14534;4695;13331;445;1440;3450;9458;3895;10898
330580;201807;12089;35480;9622;30800;2487;8516;3945;12319;6432;20835
330590;201807;1538;4390;1359;4155;160;493;963;2972;1123;3465
330600;201807;11192;31893;8952;27868;1401;4629;4583;14191;5984;18820
330610;201807;8821;25654;7619;23737;921;3366;4764;14375;5685;17741
330615;201807;1655;5264;1444;4959;388;1478;755;2552;1143;4030
330620;201807;3612;11470;3008;10333;968;3565;852;2785;1820;6350
330630;201807;24102;65292;19167;56833;2122;7398;12315;34908;14437;42306
350010;201807;1964;5502;1040;3396;260;886;105;278;365;1164
350020;201807;641;1726;342;1118;38;133;143;433;181;566
350030;201807;3903;11643;2943;9738;776;2719;885;2836;1661;5555
350040;201807;598;1881;384;1369;83;334;104;327;187;661
350050;201807;896;2547;661;2082;151;547;190;479;341;1026
350055;201807;743;2012;625;1837;51;172;483;1398;534;1570
350060;201807;114;335;89;292;19;66;40;135;59;201
350070;201807;3947;10870;2407;7769;465;1547;724;2123;1189;3670
350075;201807;620;1980;470;1645;188;685;60;183;248;868
350080;201807;688;1878;421;1318;50;167;178;519;228;686
350090;201807;638;1589;363;1060;89;265;111;312;200;577
350100;201807;2097;5896;1401;4593;187;737;656;1996;843;2733
350110;201807;424;1231;317;1014;25;89;189;590;214;679
350115;201807;1304;3924;1070;3402;202;698;514;1476;716;2174
350120;201807;776;2061;460;1399;59;168;252;783;311;951
350130;201807;3300;9299;2685;8065;382;1239;1416;4013;1798;5252
350140;201807;595;1915;478;1687;43;208;257;840;300;1048
350150;201807;526;1635;442;1468;129;440;123;393;252;833
350160;201807;10553;27181;6827;20381;914;3168;3780;10488;4694;13656
350170;201807;1608;5039;1253;4206;272;965;386;1226;658;2191
350180;201807;1152;3011;632;1928;126;419;230;662;356;1081
350190;201807;2991;8864;2166;7104;478;1736;781;2109;1259;3845
350200;201807;376;1103;320;1001;22;70;224;675;246;745
350210;201807;5288;13011;3522;10095;708;2127;1762;4898;2470;7025
350220;201807;2401;7177;1858;5982;389;1360;712;2083;1101;3443
350230;201807;897;2650;780;2441;159;526;380;1173;539;1699
350240;201807;682;2042;467;1538;83;277;162;525;245;802
350250;201807;2263;7315;1803;6451;632;2418;377;1431;1009;3849
350260;201807;833;2137;543;1581;75;218;280;793;355;1011
350270;201807;4577;13220;3710;11424;647;2177;1799;5156;2446;7333
350275;201807;2164;6382;1787;5704;376;1295;857;2595;1233;3890
350280;201807;20251;47222;12314;34022;2354;6883;4098;10954;6452;17837
350290;201807;3039;8917;2105;6970;399;1450;813;2601;1212;4051
350300;201807;659;1906;471;1484;103;337;167;489;270;826
350310;201807;822;2560;694;2262;92;354;294;896;386;1250
350315;201807;550;1557;389;1244;47;174;150;434;197;608
350320;201807;11847;33450;9530;29221;2572;8389;2353;7182;4925;15571
350330;201807;14998;38435;10248;28614;1369;4056;5593;14714;6962;18770
350335;201807;369;1068;306;957;22;68;213;668;235;736
350340;201807;1063;2888;664;2136;125;438;223;699;348;1137
350350;201807;724;2063;586;1885;101;349;272;847;373;1196
350360;201807;937;2990;784;2635;223;740;286;964;509;1704
350370;201807;588;1643;404;1244;117;348;84;244;201;592
350380;201807;4721;13153;3199;10214;807;2672;868;2734;1675;5406
350390;201807;9576;27515;7846;24306;2102;6742;3003;9063;5105;15805
350395;201807;408;1067;198;649;25;84;55;155;80;239
350400;201807;7678;20638;5576;16899;1469;4810;1606;4607;3075;9417
350410;201807;9134;27289;6774;22556;1676;6184;1983;6079;3659;12263
350420;201807;605;1802;455;1510;91;350;85;250;176;600
350430;201807;699;2013;577;1795;73;285;348;1001;421;1286
350440;201807;1501;4266;1218;3725;180;609;714;2138;894;2747
350450;201807;6636;19823;5304;17212;1234;4262;1809;5575;3043;9837
350460;201807;1541;4009;826;2565;150;532;206;567;356;1099
350470;201807;229;592;187;517;7;23;124;319;131;342
350480;201807;822;2285;544;1717;102;362;80;205;182;567
350490;201807;1732;5021;1323;4241;310;1034;445;1321;755;2355
350500;201807;607;1743;499;1542;90;310;255;762;345;1072
350510;201807;1097;3103;805;2521;111;387;411;1209;522;1596
350520;201807;1881;6376;1463;5403;266;1115;528;1806;794;2921
350530;201807;2357;6465;1782;5291;418;1324;725;2014;1143;3338
350535;201807;1386;4050;1227;3814;134;506;835;2525;969;3031
350540;201807;1629;4371;1203;3633;222;717;567;1725;789;2442
350550;201807;9344;23485;6257;18379;793;2719;3051;8374;3844;11093
350560;201807;3613;10985;2974;9653;310;1084;1793;5653;2103;6737
350570;201807;19974;59746;16671;53145;4062;14006;7161;21771;11223;35777
350580;201807;1741;5212;1030;3458;223;767;120;329;343;1096
350590;201807;4325;12530;3175;9962;621;2222;1509;4319;2130;6541
350600;201807;38986;96066;25072;69907;3555;10967;11922;30384;15477;41351
350610;201807;6676;19145;5010;15866;1043;3485;2081;6442;3124;9927
350620;201807;385;1061;278;900;33;121;131;408;164;529
350630;201807;1549;4258;1121;3433;101;368;600;1706;701;2074
350635;201807;7018;18980;5382;16227;1094;3691;2664;7592;3758;11283
350640;201807;827;2423;489;1575;70;251;158;438;228;689
350650;201807;8106;22861;5261;16666;1052;3587;1509;4449;2561;8036
350660;201807;4692;13068;3682;11278;720;2304;1735;5342;2455;7646
350670;201807;1589;4707;1409;4402;250;799;788;2470;1038;3269
350680;201807;1072;3039;734;2367;146;512;310;978;456;1490
350690;201807;1070;3150;804;2613;150;523;376;1162;526;1685
350700;201807;4253;11944;3116;9996;687;2414;1363;4116;2050;6530
350710;201807;2689;7868;2298;7128;311;1084;1311;3900;1622;4984
350715;201807;806;2356;687;2116;79;300;374;1038;453;1338
350720;201807;165;443;130;386;26;79;48;134;74;213
350730;201807;461;1493;365;1291;63;243;166;546;229;789
350740;201807;1615;4727;1075;3506;189;637;270;816;459;1453
350745;201807;581;1656;345;1102;41;148;138;381;179;529
350750;201807;9084;26160;7321;22746;1465;5190;2794;7706;4259;12896
350760;201807;13225;35493;9699;29380;2608;8512;2511;6790;5119;15302
350770;201807;680;1877;477;1473;60;204;296;898;356;1102
350775;201807;644;1681;491;1428;64;203;208;597;272;800
350780;201807;1872;5236;1414;4413;342;1170;383;1311;725;2481
350790;201807;1689;4929;1110;3773;239;889;174;516;413;1405
350800;201807;3132;9850;2803;9205;480;1732;1427;4557;1907;6289
350810;201807;2137;5717;1815;5284;311;927;1012;3057;1323;3984
350820;201807;754;1897;423;1258;56;178;187;508;243;686
350830;201807;870;2554;504;1699;67;236;146;435;213;671
350840;201807;2662;8422;2033;7158;568;2176;667;2192;1235;4368
350850;201807;6164;18765;4821;16045;1336;4642;1474;4868;2810;9510
350860;201807;3178;9222;2892;8782;146;566;2179;6506;2325;7072
350870;201807;2755;8186;2082;7049;400;1564;1033;3377;1433;4941
350880;201807;1298;4064;1043;3460;253;858;317;1029;570;1887
350890;201807;661;1786;409;1259;53;187;133;337;186;524
350900;201807;6142;17908;4097;13479;1294;4621;549;1662;1843;6283
350910;201807;854;2340;734;2106;133;439;458;1265;591;1704
350920;201807;11874;31447;10148;28527;626;2061;7808;21043;8434;23104
350925;201807;4544;13283;3340;10956;738;2524;1209;3600;1947;6124
350930;201807;1413;3853;969;2958;146;472;459;1319;605;1791
350940;201807;1958;5847;1630;5204;241;857;964;2979;1205;3836
350945;201807;911;2697;700;2270;126;462;304;909;430;1371
350950;201807;79172;220359;62299;184967;9873;32220;34311;96090;44184;128310
350960;201807;5262;15568;4189;13467;716;2658;2224;6708;2940;9366
350970;201807;3735;11935;2915;10068;970;3621;414;1243;1384;4864
350980;201807;589;1797;490;1584;173;579;164;528;337;1107
350990;201807;1786;5496;1371;4716;367;1413;442;1414;809;2827
350995;201807;796;2570;715;2390;59;247;446;1412;505;1659
351000;201807;2620;7277;1942;5967;406;1379;571;1623;977;3002
351010;201807;315;845;182;570;20;67;89;265;109;332
351015;201807;716;2302;585;2050;91;375;259;848;350;1223
351020;201807;8738;25203;7008;22344;1322;4425;3816;11971;5138;16396
351030;201807;2513;7906;2038;6823;322;1250;1007;3173;1329;4423
351040;201807;4373;11840;3739;10818;263;945;2856;7956;3119;8901
351050;201807;16493;42526;11197;33757;2543;8215;4058;12051;6601;20266
351060;201807;42522;113134;33346;97075;4958;15585;20065;56567;25023;72152
351070;201807;1396;3699;816;2631;246;858;95;299;341;1157
351080;201807;2593;7197;1961;6364;420;1518;938;2854;1358;4372
351090;201807;368;1144;258;925;52;193;54;203;106;396
351100;201807;2538;7217;1645;5207;416;1391;389;1256;805;2647
351110;201807;5540;14856;3686;11383;825;2786;1274;3590;2099;6376
351120;201807;714;1959;493;1526;83;271;192;546;275;817
351130;201807;1017;2723;491;1638;94;336;92;282;186;618
351140;201807;1678;5316;1274;4462;347;1305;321;1007;668;2312
351150;201807;1806;5626;1140;3987;234;885;241;738;475;1623
351160;201807;1136;3802;937;3339;205;780;310;983;515;1763
351170;201807;1372;4110;1198;3733;144;502;724;2121;868;2623
351190;201807;815;2500;612;1993;110;346;220;682;330;1028
351200;201807;1714;4448;1327;3829;90;291;799;2189;889;2480
351210;201807;1393;3561;861;2517;98;333;452;1190;550;1523
351220;201807;3085;9435;2705;8717;400;1344;1578;5014;1978;6358
351230;201807;1816;5271;1373;4457;295;1099;578;1672;873;2771
351240;201807;1746;4778;1140;3456;226;740;487;1348;713;2088
351250;201807;1054;2997;606;1973;84;295;203;647;287;942
351260;201807;913;2605;729;2236;194;583;218;667;412;1250
351270;201807;339;1055;291;952;56;222;148;414;204;636
351280;201807;4238;11941;3345;10154;607;2043;1536;4412;2143;6455
351290;201807;1003;2726;680;2108;123;377;285;860;408;1237
351300;201807;14332;41849;10108;33343;2296;8054;3448;11335;5744;19389
351310;201807;3060;8537;2373;7311;287;1057;1374;3898;1661;4955
351320;201807;913;2892;711;2380;125;468;239;749;364;1217
351330;201807;1039;3795;975;3686;54;141;830;3237;884;3378
351340;201807;6221;18988;5041;16796;1396;4796;1903;6404;3299;11200
351350;201807;10653;29169;9074;26416;1150;3574;6334;17823;7484;21397
351360;201807;3917;11235;3327;10225;826;2818;1115;3146;1941;5964
351370;201807;2244;6646;1549;5101;386;1324;512;1514;898;2838
351380;201807;42878;112162;32873;93891;5815;17445;16621;46101;22436;63546
351385;201807;272;741;171;533;29;78;53;163;82;241
351390;201807;1352;3583;895;2878;164;630;468;1375;632;2005
351400;201807;947;2848;769;2459;176;577;339;1050;515;1627
351410;201807;2328;6875;1817;5857;331;1094;841;2661;1172;3755
351420;201807;322;841;186;575;38;112;64;190;102;302
351430;201807;772;2326;703;2194;69;241;524;1612;593;1853
351440;201807;3256;9122;2232;6896;442;1493;500;1279;942;2772
351450;201807;1603;4377;1155;3554;252;826;258;753;510;1579
351460;201807;719;2037;599;1816;183;535;267;814;450;1349
351470;201807;1092;3054;891;2672;85;307;532;1487;617;1794
351480;201807;2564;7983;2176;7296;307;1217;1099;3513;1406;4730
351490;201807;1827;5649;1596;5165;97;390;1118;3447;1215;3837
351492;201807;340;1009;280;869;18;63;152;434;170;497
351495;201807;182;567;145;464;21;80;71;214;92;294
351500;201807;34524;90228;25276;73632;5321;16389;11928;33203;17249;49592
351510;201807;11083;30213;8281;24907;1384;4582;4635;13370;6019;17952
351512;201807;509;1418;341;1035;64;201;119;331;183;532
351515;201807;3079;7553;1894;5491;387;1241;479;1388;866;2629
351518;201807;2265;6226;1526;4850;240;893;775;2218;1015;3111
351519;201807;645;1903;434;1391;90;331;89;209;179;540
351520;201807;1065;2768;420;1337;67;234;151;415;218;649
351530;201807;341;998;188;619;32;104;59;158;91;262
351535;201807;2100;5313;1567;4420;162;554;939;2476;1101;3030
351540;201807;1884;5155;1329;4130;446;1527;222;563;668;2090
351550;201807;5767;15878;3932;11912;563;1920;1906;5316;2469;7236
351560;201807;409;1291;346;1145;85;324;87;272;172;596
351565;201807;171;567;140;498;35;133;51;170;86;303
351570;201807;16222;45615;12774;38596;1808;6042;7868;22775;9676;28817
351580;201807;294;783;162;517;21;64;55;184;76;248
351590;201807;515;1234;287;795;33;116;155;386;188;502
351600;201807;1647;4436;1248;3695;151;491;685;1890;836;2381
351610;201807;650;1662;452;1318;34;133;240;608;274;741
351620;201807;19791;57751;14928;48348;2819;10351;5627;16264;8446;26615
351630;201807;25635;72762;21410;65199;3947;12589;12623;37598;16570;50187
351640;201807;14885;41814;11888;36177;1564;5358;7537;22048;9101;27406
351650;201807;387;1119;172;585;27;89;31;104;58;193
351660;201807;768;2352;483;1620;81;304;84;241;165;545
351670;201807;4777;13745;3554;10988;678;2168;1692;4935;2370;7103
351680;201807;449;1369;277;906;58;170;70;216;128;386
351685;201807;441;1351;353;1178;95;312;110;359;205;671
351690;201807;1001;2793;648;2016;127;427;228;614;355;1041
351700;201807;912;2594;763;2316;159;470;331;989;490;1459
351710;201807;628;1920;468;1585;54;215;198;620;252;835
351720;201807;1479;4142;991;3159;182;626;366;1114;548;1740
351730;201807;910;2564;743;2264;100;360;392;1100;492;1460
351740;201807;3966;10372;3036;8545;588;1743;1275;3313;1863;5056
351750;201807;1318;3940;814;2840;149;572;271;921;420;1493
351760;201807;3285;9806;2399;7867;556;1987;743;2242;1299;4229
351770;201807;1999;6150;1654;5445;419;1432;685;2200;1104;3632
351780;201807;1370;3693;707;2222;115;421;191;559;306;980
351790;201807;1231;3204;1001;2855;177;470;582;1696;759;2166
351800;201807;562;1300;278;765;38;120;82;193;120;313
351810;201807;997;2777;815;2447;62;170;587;1710;649;1880
351820;201807;2517;7548;1765;5954;416;1494;313;1016;729;2510
351830;201807;4398;12523;3333;10484;443;1593;1787;5345;2230;6938
351840;201807;6960;21321;5574;18661;1102;4122;2390;7486;3492;11608
351850;201807;1981;5269;1265;3953;247;885;367;1032;614;1917
351860;201807;2824;8725;2352;7770;496;1737;1162;3797;1658;5534
351870;201807;23623;65010;18691;56539;6006;18705;6622;20535;12628;39240
351880;201807;115934;330634;89912;281191;26171;87529;26251;77569;52422;165098
351885;201807;723;2311;643;2133;130;441;305;992;435;1433
351890;201807;609;1839;486;1605;110;378;81;219;191;597
351900;201807;1040;3052;815;2666;163;545;328;1078;491;1623
351905;201807;408;1176;287;921;37;131;112;308;149;439
351907;201807;21162;58043;16836;49964;1505;5138;11499;33015;13004;38153
351910;201807;1213;3377;878;2658;143;483;403;1093;546;1576
351920;201807;936;2542;714;2129;89;304;365;1031;454;1335
351925;201807;989;2825;772;2386;113;369;363;1047;476;1416
351930;201807;2793;8404;2628;8088;278;1058;2079;6210;2357;7268
351940;201807;1101;3003;806;2467;106;359;422;1253;528;1612
351950;201807;1424;3618;1091;3091;58;187;684;1884;742;2071
351960;201807;4939;13515;3660;11147;879;2880;1470;4229;2349;7109
351970;201807;5561;18753;4884;17461;999;4004;2439;8299;3438;12303
351980;201807;919;2517;660;2000;98;354;351;980;449;1334
351990;201807;1422;3624;1005;2926;129;467;368;953;497;1420
352000;201807;2272;7058;1972;6414;222;868;1192;3628;1414;4496
352010;201807;2006;5862;1628;5122;406;1366;273;904;679;2270
352020;201807;1568;4475;1231;3875;230;793;555;1654;785;2447
352030;201807;5246;14619;4190;12953;871;2897;2161;6628;3032;9525
352040;201807;2165;6244;1409;4637;278;977;302;874;580;1851
352042;201807;3171;8185;1959;5940;403;1276;778;2353;1181;3629
352044;201807;1955;5630;1134;3947;205;778;237;765;442;1543
352050;201807;12563;35613;8204;26206;2035;7284;1219;3367;3254;10651
352060;201807;749;2190;559;1806;87;326;247;733;334;1059
352070;201807;816;1811;583;1469;92;256;269;654;361;910
352080;201807;473;1279;287;872;45;151;99;255;144;406
352090;201807;1399;4498;1099;3759;185;720;363;1101;548;1821
352100;201807;3271;9493;2612;8256;626;2108;1089;3289;1715;5397
352110;201807;570;1817;454;1550;97;365;167;516;264;881
352115;201807;536;1602;447;1446;98;342;234;745;332;1087
352120;201807;823;2584;658;2228;77;311;350;1096;427;1407
352130;201807;1904;5577;1203;3770;238;746;393;1173;631;1919
352140;201807;1475;4038;902;2865;138;461;376;1133;514;1594
352150;201807;831;2367;641;2013;157;497;300;940;457;1437
352160;201807;987;2546;715;2106;118;400;319;868;437;1268
352170;201807;2784;8076;2267;6935;444;1492;1111;3147;1555;4639
352180;201807;2805;7805;2238;6714;530;1708;762;2078;1292;3786
352190;201807;1157;3292;866;2775;151;545;334;1014;485;1559
352200;201807;391;1255;260;955;37;153;72;257;109;410
352210;201807;17061;43624;13840;38835;1718;5189;9627;26796;11345;31985
352215;201807;507;1429;449;1348;58;192;294;854;352;1046
352220;201807;15195;41827;10753;33349;3095;9957;3035;9232;6130;19189
352230;201807;12422;39381;9765;33988;2619;10012;3105;10128;5724;20140
352240;201807;11641;31619;8569;26092;1996;6876;3175;8752;5171;15628
352250;201807;21348;63612;17710;56971;4368;14792;8625;27255;12993;42047
352260;201807;5527;15547;3789;11893;619;2128;1982;5994;2601;8122
352265;201807;889;2635;768;2423;47;189;559;1707;606;1896
352270;201807;1500;4859;1161;4071;279;1051;338;1095;617;2146
352280;201807;2283;6237;1801;5465;193;706;945;2682;1138;3388
352290;201807;1083;3333;915;2954;174;614;421;1235;595;1849
352300;201807;947;2681;674;2104;108;373;292;804;400;1177
352310;201807;45343;124994;34011;104855;9002;28165;13929;43221;22931;71386
352320;201807;5685;16239;4543;13895;829;2799;2082;5692;2911;8491
352330;201807;1959;5797;1606;5282;408;1499;690;2140;1098;3639
352340;201807;4862;14103;3634;11860;836;2944;1313;4016;2149;6960
352350;201807;1870;5795;1555;5066;236;905;718;2075;954;2980
352360;201807;1075;3039;941;2821;140;511;664;1884;804;2395
352370;201807;977;3036;868;2806;47;210;640;1992;687;2202
352380;201807;873;2557;693;2224;159;548;209;638;368;1186
352390;201807;17866;45030;11666;34022;1875;6008;5899;16218;7774;22226
352400;201807;3496;9815;2840;8630;587;2133;1564;4325;2151;6458
352410;201807;2903;8162;2350;7205;312;1097;1321;3887;1633;4984
352420;201807;940;2376;652;1891;116;363;222;612;338;975
352430;201807;7092;19464;5352;16357;1510;4976;1954;5771;3464;10747
352440;201807;16739;48642;13101;41373;2922;9780;5509;16833;8431;26613
352450;201807;785;2103;389;1287;68;234;106;327;174;561
352460;201807;2644;7869;1914;6355;412;1548;626;1946;1038;3494
352470;201807;3834;9974;2762;8134;309;1053;1493;4059;1802;5112
352480;201807;3626;9224;2512;7178;448;1408;1131;2944;1579;4352
352490;201807;711;2274;556;1925;117;451;217;710;334;1161
352500;201807;9553;25555;7110;21082;3562;11457;992;2007;4554;13464
352510;201807;3295;9459;2508;8032;644;2250;863;2600;1507;4850
352520;201807;2303;6901;1854;6019;444;1561;807;2437;1251;3998
352530;201807;8901;26044;5905;19246;1396;4990;899;2251;2295;7241
352540;201807;545;1648;393;1295;81;286;80;241;161;527
352550;201807;918;2797;656;2250;127;468;180;582;307;1050
352560;201807;567;1641;377;1214;67;227;92;259;159;486
352570;201807;1992;6119;1298;4600;318;1227;223;683;541;1910
352580;201807;818;2396;640;2030;131;473;240;705;371;1178
352585;201807;257;787;202;670;23;89;95;295;118;384
352590;201807;13504;37664;9727;30072;3023;9979;3627;10355;6650;20334
352600;201807;1984;5950;1544;5012;272;881;730;2328;1002;3209
352610;201807;3186;9373;2466;8075;562;2050;826;2538;1388;4588
352620;201807;5470;15334;4458;13705;1338;4184;1665;5153;3003;9337
352630;201807;804;2086;621;1796;107;376;295;771;402;1147
352640;201807;2814;7681;2139;6518;190;637;1363;4057;1553;4694
352650;201807;636;1880;461;1445;77;265;154;454;231;719
352660;201807;979;3235;824;2905;185;671;323;1107;508;1778
352670;201807;10089;28550;5995;19851;1525;5493;499;1641;2024;7134
352680;201807;3083;9629;2229;7595;415;1569;929;2923;1344;4492
352690;201807;30762;80587;22232;64481;2285;7570;13203;36190;15488;43760
352700;201807;565;1482;422;1269;163;530;115;296;278;826
352710;201807;5059;13954;3665;11241;960;3253;1373;3866;2333;7119
352720;201807;8122;23956;6496;20546;2873;9176;1032;2981;3905;12157
352725;201807;426;1179;212;696;17;62;84;260;101;322
352730;201807;2623;7885;2296;7097;402;1425;1217;3381;1619;4806
352740;201807;2200;5555;1694;4759;249;764;878;2354;1127;3118
352750;201807;441;1150;226;711;44;131;58;158;102;289
352760;201807;1448;4405;1136;3670;180;621;515;1594;695;2215
352770;201807;781;2324;595;1899;126;427;208;625;334;1052
352780;201807;626;2000;469;1622;96;350;143;465;239;815
352790;201807;610;1667;415;1288;53;178;135;359;188;537
352800;201807;1213;4003;898;3185;232;849;178;574;410;1423
352810;201807;1090;2716;665;1893;102;315;316;836;418;1151
352820;201807;561;1446;369;1128;80;255;74;215;154;470
352830;201807;600;1605;283;889;48;163;53;126;101;289
352840;201807;3889;12145;3323;11020;1099;3825;1080;3448;2179;7273
352850;201807;10471;27755;7194;22274;1987;6615;2071;6206;4058;12821
352860;201807;893;2778;758;2482;152;550;309;962;461;1512
352870;201807;861;2259;579;1624;53;181;339;884;392;1065
352880;201807;2001;5045;1396;3909;220;641;677;1689;897;2330
352885;201807;262;811;211;714;27;97;133;443;160;540
352890;201807;677;1686;428;1144;49;140;209;484;258;624
352900;201807;18008;49684;12653;38919;2317;7787;5288;15134;7605;22921
352910;201807;410;1143;205;670;25;76;37;114;62;190
352920;201807;2554;6957;1854;5632;217;739;1079;3099;1296;3838
352930;201807;5561;16310;4292;13659;813;2732;1727;5222;2540;7954
352940;201807;22797;67573;17829;56880;5091;17746;4401;12989;9492;30735
352950;201807;483;1293;271;867;58;198;21;56;79;254
352960;201807;662;1909;351;1166;50;190;74;224;124;414
352965;201807;314;879;173;571;42;150;30;90;72;240
352970;201807;3137;7680;2454;6603;262;726;1617;4349;1879;5075
352980;201807;1337;3912;1069;3437;227;774;503;1570;730;2344
352990;201807;4037;11847;3366;10708;750;2715;1646;4934;2396;7649
353000;201807;475;1302;236;767;43;157;56;154;99;311
353010;201807;2651;7008;1784;5330;431;1399;558;1538;989;2937
353020;201807;3836;10172;2207;6697;328;1080;779;2188;1107;3268
353030;201807;3994;10884;2817;8613;730;2333;611;1833;1341;4166
353040;201807;588;1518;444;1269;85;267;202;523;287;790
353050;201807;4940;15196;3797;12829;940;3451;1502;4802;2442;8253
353060;201807;45510;123951;38042;111487;3459;12218;26863;75321;30322;87539
353070;201807;9763;28792;6894;22708;1531;5375;2103;6604;3634;11979
353080;201807;4580;13531;3154;10559;701;2601;895;2734;1596;5335
353090;201807;540;1775;454;1575;39;152;258;844;297;996
353100;201807;316;867;122;405;22;80;30;76;52;156
353110;201807;7262;21218;6135;19410;1060;3624;3609;11473;4669;15097
353120;201807;546;1506;363;1118;66;229;129;340;195;569
353130;201807;2461;6530;1737;5366;512;1704;528;1555;1040;3259
353140;201807;2224;5959;1677;4905;220;730;911;2487;1131;3217
353150;201807;1475;4049;1087;3349;267;815;376;1112;643;1927
353160;201807;639;1734;438;1371;94;331;151;419;245;750
353170;201807;500;1491;412;1364;77;311;202;630;279;941
353180;201807;9686;25078;7702;21899;1074;3374;5117;14182;6191;17556
353190;201807;3482;9908;2766;8388;346;1135;1628;4618;1974;5753
353200;201807;1589;4695;821;2740;157;564;193;578;350;1142
353205;201807;330;1088;284;970;64;248;130;430;194;678
353210;201807;959;2373;622;1763;34;125;370;997;404;1122
353215;201807;429;1268;351;1095;48;167;142;384;190;551
353220;201807;651;1849;449;1442;113;360;87;264;200;624
353230;201807;792;2373;673;2179;186;680;251;703;437;1383
353240;201807;2110;6245;1763;5570;254;918;1002;3023;1256;3941
353250;201807;1284;3042;772;2157;108;299;373;1034;481;1333
353260;201807;1014;2590;592;1814;123;404;183;525;306;929
353270;201807;645;1827;524;1578;63;190;279;800;342;990
353280;201807;728;2092;514;1616;94;303;163;488;257;791
353282;201807;1813;5423;1588;4965;213;741;903;2702;1116;3443
353284;201807;401;1011;203;602;30;106;73;189;103;295
353286;201807;140;394;92;303;22;74;24;69;46;143
353290;201807;1183;3398;832;2651;103;387;421;1204;524;1591
353300;201807;1658;4713;1235;3823;207;728;509;1401;716;2129
353310;201807;338;887;236;691;28;102;129;343;157;445
353320;201807;625;1714;522;1516;28;83;386;1111;414;1194
353325;201807;617;1941;433;1503;88;315;127;432;215;747
353330;201807;561;1534;360;1089;53;184;182;507;235;691
353340;201807;2965;8169;1979;6305;523;1763;607;1933;1130;3696
353350;201807;3266;9332;2199;6949;501;1706;398;1092;899;2798
353360;201807;500;1578;415;1395;63;231;205;669;268;900
353370;201807;548;1755;456;1579;49;190;276;927;325;1117
353380;201807;269;862;213;734;39;132;87;291;126;423
353390;201807;5469;14600;4161;12131;720;2234;1862;5130;2582;7364
353400;201807;416;1251;325;1059;65;236;60;148;125;384
353410;201807;575;1624;452;1398;98;332;210;628;308;960
353420;201807;505;1422;294;928;56;166;35;92;91;258
353430;201807;2135;6491;1611;5390;399;1442;502;1579;901;3021
353440;201807;59467;172878;42820;138142;9084;30545;19012;58926;28096;89471
353450;201807;416;1123;288;872;37;131;121;339;158;470
353460;201807;3404;9552;2466;7626;224;788;1079;3308;1303;4096
353470;201807;7134;19967;5096;15984;1061;3618;1723;5024;2784;8642
353475;201807;1426;3989;1025;3065;139;460;437;1197;576;1657
353480;201807;1534;4372;1296;3885;98;329;883;2544;981;2873
353490;201807;925;2592;662;2014;131;397;270;788;401;1185
353500;201807;1010;2511;808;2193;197;529;427;1191;624;1720
353510;201807;870;2731;630;2106;171;595;113;340;284;935
353520;201807;1171;3171;782;2429;99;347;362;1065;461;1412
353530;201807;2378;6563;1877;5570;267;902;979;2707;1246;3609
353540;201807;1983;5830;1655;5243;327;1075;841;2603;1168;3678
353550;201807;5895;16429;4671;14213;954;3139;2168;6207;3122;9346
353560;201807;2070;6333;1597;5500;532;1982;376;1214;908;3196
353570;201807;526;1494;382;1217;86;273;171;516;257;789
353580;201807;2160;5996;1734;5189;389;1189;781;2245;1170;3434
353590;201807;705;2007;440;1393;111;373;137;442;248;815
353600;201807;1716;4575;1406;3953;176;516;730;1980;906;2496
353610;201807;590;1945;441;1609;97;393;103;342;200;735
353620;201807;2504;7293;1841;6010;424;1483;498;1484;922;2967
353625;201807;518;1372;315;959;32;114;181;529;213;643
353630;201807;1261;4182;974;3478;218;821;231;754;449;1575
353640;201807;1348;3682;1048;3123;134;455;623;1811;757;2266
353650;201807;9086;25696;6637;20412;973;3288;3420;9771;4393;13059
353657;201807;304;897;244;791;33;108;110;333;143;441
353660;201807;1138;2582;768;2006;304;826;188;420;492;1246
353670;201807;3514;10608;2906;9371;710;2514;1282;3813;1992;6327
353680;201807;723;2089;556;1823;115;400;261;825;376;1225
353690;201807;503;1320;210;670;22;78;25;67;47;145
353700;201807;1926;5586;1635;5007;229;756;980;2890;1209;3646
353710;201807;3406;7949;1874;5273;268;736;954;2497;1222;3233
353715;201807;558;1555;369;1166;20;87;106;298;126;385
353720;201807;1939;5476;1559;4898;243;869;923;2777;1166;3646
353730;201807;4168;11956;3131;9770;528;1801;1363;3948;1891;5749
353740;201807;1880;5249;1303;4095;321;1140;355;1014;676;2154
353750;201807;892;2830;615;2234;152;578;107;378;259;956
353760;201807;11833;29591;9367;26081;1352;4117;5853;15937;7205;20054
353770;201807;673;2040;333;1150;67;235;38;88;105;323
353780;201807;4449;13887;3537;11971;995;3655;887;2769;1882;6424
353790;201807;2244;7209;1736;6124;537;2175;350;1051;887;3226
353800;201807;16561;47522;12867;40803;2463;8372;5900;18519;8363;26891
353810;201807;1094;3137;734;2397;127;493;258;799;385;1292
353820;201807;1640;4967;1223;4035;249;900;438;1404;687;2304
353830;201807;620;1618;474;1369;64;192;246;668;310;860
353850;201807;1696;4948;1306;4166;352;1082;398;1316;750;2398
353860;201807;2507;7616;1999;6525;503;1745;767;2381;1270;4126
353870;201807;28305;78321;19471;60415;3167;10780;8442;23884;11609;34664
353880;201807;2931;8631;2336;7513;266;996;1273;3958;1539;4954
353890;201807;2359;5519;1638;4424;164;495;1021;2598;1185;3093
353900;201807;743;2181;553;1794;111;390;213;663;324;1053
353910;201807;2035;6591;1796;6186;236;842;1251;4383;1487;5225
353920;201807;2265;6418;1536;4923;316;1151;349;951;665;2102
353930;201807;4266;12053;2913;9501;741;2622;684;2055;1425;4677
353940;201807;1091;3422;763;2650;157;573;210;691;367;1264
353950;201807;3094;9166;2513;7979;502;1768;1268;3686;1770;5454
353960;201807;621;1858;426;1431;92;282;130;433;222;715
353970;201807;619;1677;495;1451;47;149;316;900;363;1049
353980;201807;13773;37851;10992;32794;1585;5029;6599;19093;8184;24122
353990;201807;797;2083;522;1550;60;193;276;777;336;970
354000;201807;2364;6130;1389;4213;285;898;255;777;540;1675
354010;201807;360;1016;270;842;32;104;170;509;202;613
354020;201807;3761;11291;3016;9609;790;2699;965;2800;1755;5499
354025;201807;779;2186;520;1666;100;343;120;365;220;708
354030;201807;477;1149;262;725;46;128;87;219;133;347
354040;201807;764;1936;486;1423;39;124;290;804;329;928
354050;201807;962;2916;693;2358;168;611;174;575;342;1186
354060;201807;4258;12706;2847;9562;745;2610;712;2205;1457;4815
354070;201807;3148;9389;2284;7597;532;1918;563;1601;1095;3519
354075;201807;2150;7023;1717;6149;279;1157;880;3015;1159;4172
354080;201807;1472;4295;944;3168;184;640;239;725;423;1365
354085;201807;409;881;328;781;2;11;223;493;225;504
354090;201807;1464;4243;1303;3912;113;390;926;2735;1039;3125
354100;201807;15565;46517;11569;39236;2802;10171;4630;15563;7432;25734
354105;201807;1026;2867;868;2614;138;429;521;1553;659;1982
354110;201807;461;1288;359;1131;100;337;107;316;207;653
354120;201807;1615;4467;1075;3280;199;642;352;949;551;1591
354130;201807;5883;16094;3908;12173;1208;4092;200;418;1408;4510
354140;201807;21691;53930;13965;39897;2847;8638;4853;12865;7700;21503
354150;201807;3420;8691;2524;7112;525;1589;1065;2831;1590;4420
354160;201807;3289;10063;2452;8199;728;2534;702;2306;1430;4840
354165;201807;536;1654;432;1439;88;338;200;622;288;960
354170;201807;1483;4470;1188;3809;96;350;673;2038;769;2388
354180;201807;491;1451;359;1156;62;223;121;341;183;564
354190;201807;1471;4386;1107;3623;153;556;393;1250;546;1806
354200;201807;934;2536;737;2189;93;283;359;993;452;1276
354210;201807;684;2011;540;1742;55;215;328;966;383;1181
354220;201807;3100;8750;2371;7312;434;1434;1120;3282;1554;4716
354230;201807;694;1941;550;1724;66;274;331;959;397;1233
354240;201807;1458;4357;978;3311;190;691;248;749;438;1440
354250;201807;539;1458;359;1157;106;350;100;324;206;674
354260;201807;7995;22582;6272;19507;1579;5132;2105;6553;3684;11685
354270;201807;1143;3564;908;3093;185;651;329;1115;514;1766
354280;201807;738;1989;623;1812;81;297;368;983;449;1280
354290;201807;855;2896;736;2605;139;495;320;1144;459;1639
354300;201807;3704;11383;3296;10597;1094;3667;1036;3139;2130;6806
354310;201807;751;2285;599;1953;113;408;227;676;340;1084
354320;201807;872;2338;553;1727;101;357;203;552;304;909
354323;201807;528;1351;346;993;41;113;138;381;179;494
354325;201807;1220;3821;903;3098;169;615;336;1094;505;1709
354330;201807;6942;18881;5153;15318;854;2985;2823;7717;3677;10702
354340;201807;25643;69876;18050;56400;4439;14937;6882;20666;11321;35603
354350;201807;1132;3155;935;2758;143;472;558;1531;701;2003
354360;201807;543;1570;314;1092;62;214;50;172;112;386
354370;201807;1052;3384;874;3021;149;557;449;1514;598;2071
354380;201807;795;2174;541;1723;102;382;117;305;219;687
354390;201807;13518;35140;8663;26250;1779;5752;2517;7157;4296;12909
354400;201807;1609;5423;1259;4540;232;884;428;1541;660;2425
354410;201807;5135;15023;4053;12875;976;3345;1685;5144;2661;8489
354420;201807;1410;3931;1005;3063;147;479;547;1588;694;2067
354425;201807;2207;5922;1705;4989;423;1237;597;1809;1020;3046
354430;201807;1514;4367;1207;3845;207;736;572;1709;779;2445
354440;201807;539;1540;349;1113;37;123;154;449;191;572
354450;201807;395;1077;221;732;31;110;52;159;83;269
354460;201807;934;2579;640;1965;107;353;271;798;378;1151
354470;201807;540;1383;359;1017;30;93;168;421;198;514
354480;201807;1037;2505;727;2010;62;187;466;1221;528;1408
354490;201807;814;2545;611;2081;136;503;204;635;340;1138
354500;201807;2097;6204;1766;5702;592;2092;418;1349;1010;3441
354510;201807;821;2293;669;1970;92;284;337;906;429;1190
354515;201807;288;902;218;759;40;156;87;291;127;447
354520;201807;7217;21576;4400;14267;733;2637;2131;6420;2864;9057
354530;201807;3811;11906;3021;10212;741;2615;1109;3735;1850;6350
354540;201807;1327;3749;973;3068;223;748;298;958;521;1706
354550;201807;560;1512;420;1242;63;198;242;677;305;875
354560;201807;1893;4970;1046;3136;137;429;523;1497;660;1926
354570;201807;1173;3212;503;1547;102;340;74;210;176;550
354580;201807;9956;27155;6470;20330;1076;3713;2806;8273;3882;11986
354600;201807;1707;5029;1348;4335;218;759;713;2208;931;2967
354610;201807;375;1008;191;591;36;120;59;167;95;287
354620;201807;460;1369;311;1069;62;238;104;300;166;538
354625;201807;322;950;195;671;27;89;50;147;77;236
354630;201807;2036;6389;1673;5632;690;2455;193;612;883;3067
354640;201807;3173;9800;2300;7842;444;1690;575;1761;1019;3451
354650;201807;902;2519;726;2174;84;262;432;1302;516;1564
354660;201807;2665;6958;1782;5456;130;497;1201;3582;1331;4079
354670;201807;1061;3082;752;2389;147;512;269;782;416;1294
354680;201807;4446;12951;3756;11768;953;3089;1873;5905;2826;8994
354690;201807;628;2030;431;1551;100;372;106;362;206;734
354700;201807;1016;2778;702;2111;121;398;304;798;425;1196
354710;201807;530;1500;356;1112;48;182;154;423;202;605
354720;201807;293;761;144;442;46;140;27;79;73;219
354730;201807;9667;28311;7085;23265;1114;4006;3668;11548;4782;15554
354740;201807;343;966;129;466;21;87;20;67;41;154
354750;201807;2465;6909;1676;5394;329;1207;613;1778;942;2985
354760;201807;1869;5468;1359;4434;394;1363;302;956;696;2319
354765;201807;293;814;135;441;22;85;28;81;50;166
354770;201807;2303;5990;1646;4836;363;1145;630;1764;993;2909
354780;201807;55045;146216;42775;121054;6487;20436;23034;60811;29521;81247
354790;201807;874;2655;733;2388;106;364;392;1242;498;1606
354800;201807;2583;7119;2017;6156;466;1479;827;2387;1293;3866
354805;201807;1051;2898;773;2334;101;335;330;885;431;1220
354810;201807;586;1803;339;1225;55;214;81;274;136;488
354820;201807;937;2939;704;2447;145;564;159;481;304;1045
354830;201807;475;1201;317;913;91;262;110;302;201;564
354840;201807;761;2183;493;1535;75;218;224;687;299;905
354850;201807;19934;55834;14139;44547;2238;8161;7516;22062;9754;30223
354860;201807;1393;4190;1008;3422;200;735;321;975;521;1710
354870;201807;48975;129927;39104;111383;6135;19012;21641;58903;27776;77915
354880;201807;5442;14166;2606;7809;378;1264;858;2095;1236;3359
354890;201807;15755;42323;12686;37009;2044;6495;6763;18994;8807;25489
354900;201807;455;1264;285;919;39;140;79;231;118;371
354910;201807;5043;14291;2960;10084;629;2252;293;952;922;3204
354920;201807;428;1159;181;609;27;115;36;99;63;214
354925;201807;269;813;134;485;22;81;32;96;54;177
354930;201807;377;969;230;701;27;94;112;323;139;417
354940;201807;1804;5960;1385;4946;474;1809;168;562;642;2371
354950;201807;1499;4345;1212;3869;88;382;756;2263;844;2645
354960;201807;782;2203;612;1935;136;489;246;725;382;1214
354970;201807;3765;11543;3075;10164;502;1801;1728;5514;2230;7315
354980;201807;28613;72324;19226;55287;2582;8667;9806;26046;12388;34713
354990;201807;59649;160439;43982;130779;5580;18183;24271;68802;29851;86985
354995;201807;2357;6060;1782;5225;309;1019;1044;2896;1353;3915
355000;201807;1444;4118;1163;3633;232;835;348;953;580;1788
355010;201807;3124;9348;2126;6990;748;2568;195;684;943;3252
355020;201807;3186;9589;2326;7850;755;2794;587;1919;1342;4713
355030;201807;1302500;3321674;966090;2651737;177728;529487;451956;1152836;629684;1682323
355040;201807;2820;7938;2368;7231;425;1346;1437;4373;1862;5719
355050;201807;994;2705;734;2241;230;685;168;484;398;1169
355060;201807;5078;14834;3860;12434;717;2619;1744;5049;2461;7668
355070;201807;7653;21562;6193;19020;892;3147;3496;9985;4388;13132
355080;201807;845;2633;539;1976;111;449;40;133;151;582
355090;201807;1150;3563;897;3046;217;725;273;953;490;1678
355100;201807;20225;56172;15948;49571;3140;10423;9019;27564;12159;37987
355110;201807;1043;3087;795;2658;280;997;147;502;427;1499
355120;201807;628;1804;460;1487;76;268;155;471;231;739
355130;201807;638;1538;291;805;27;69;137;353;164;422
355140;201807;1385;3838;1240;3606;141;490;895;2530;1036;3020
355150;201807;3982;11201;3185;9761;513;1671;1662;4972;2175;6643
355160;201807;1865;5465;1429;4659;356;1305;339;1039;695;2344
355170;201807;8575;23415;6811;20401;1848;5841;3006;8905;4854;14746
355180;201807;2743;8015;2041;6714;465;1795;638;1850;1103;3645
355190;201807;1682;4788;1377;4233;370;1208;599;1908;969;3116
355200;201807;819;2703;707;2493;266;1044;196;616;462;1660
355210;201807;3040;8807;2549;7782;314;1145;1500;4283;1814;5428
355220;201807;42688;119830;33885;102333;9227;29284;11864;32911;21091;62195
355230;201807;1242;3254;686;2088;140;427;171;500;311;927
355240;201807;22955;62548;15476;47448;2707;8709;6530;19485;9237;28194
355250;201807;34038;95777;25727;80135;6769;22369;9161;27585;15930;49954
355255;201807;825;2175;433;1363;78;234;138;440;216;674
355260;201807;1256;3396;951;2872;125;462;573;1611;698;2073
355270;201807;1459;4519;1134;3765;270;933;367;1144;637;2077
355280;201807;27093;74322;19779;59751;3566;11466;8597;24645;12163;36111
355290;201807;819;2495;626;2035;139;434;212;649;351;1083
355300;201807;1300;3955;1043;3409;217;760;315;1005;532;1765
355310;201807;1039;2979;784;2527;80;294;421;1366;501;1660
355320;201807;552;1521;413;1241;80;286;154;392;234;678
355330;201807;2188;6172;1608;5065;198;693;980;2951;1178;3644
355340;201807;3188;7449;2708;6773;311;773;1849;4594;2160;5367
355350;201807;1347;4153;985;3358;205;750;292;980;497;1730
355360;201807;1253;3557;1070;3183;107;331;750;2253;857;2584
355365;201807;371;1041;189;660;41;124;26;92;67;216
355370;201807;6061;15729;4666;13715;1112;3370;1940;6067;3052;9437
355380;201807;3023;8582;2272;7026;424;1431;686;1800;1110;3231
355385;201807;1262;3743;1090;3432;156;585;586;1691;742;2276
355390;201807;748;2162;562;1760;125;404;213;615;338;1019
355395;201807;1996;5913;1397;4550;204;724;575;1705;779;2429
355400;201807;9060;28277;7440;24763;2167;7940;2090;6340;4257;14280
355410;201807;22065;63332;15021;49542;3795;13648;3268;10780;7063;24428
355420;201807;695;2399;582;2144;163;693;124;445;287;1138
355430;201807;3761;9920;2897;8376;751;2170;1181;3431;1932;5601
355440;201807;879;2500;557;1780;112;371;169;505;281;876
355450;201807;3808;10461;2327;7334;452;1524;783;2272;1235;3796
355460;201807;561;1480;359;1110;49;166;148;405;197;571
355465;201807;363;1095;262;861;48;178;81;257;129;435
355470;201807;1178;3159;641;2009;186;599;187;554;373;1153
355475;201807;277;717;246;661;23;70;187;501;210;571
355480;201807;3503;10692;2990;9795;491;1858;1770;5598;2261;7456
355490;201807;999;2843;544;1797;65;240;206;648;271;888
355495;201807;775;2374;592;2010;94;347;175;574;269;921
355500;201807;6867;19130;4139;13163;652;2266;1105;3250;1757;5516
355510;201807;1441;3852;868;2671;132;443;276;738;408;1181
355520;201807;399;943;188;530;29;88;69;168;98;256
355530;201807;481;1097;165;480;22;78;60;141;82;219
355535;201807;562;1611;436;1393;98;359;164;461;262;820
355540;201807;8985;25239;7607;23056;1447;4669;4384;12972;5831;17641
355550;201807;687;2076;542;1777;73;258;246;784;319;1042
355560;201807;1099;3161;600;2023;123;421;27;95;150;516
355570;201807;238;709;121;421;23;86;17;57;40;143
355580;201807;1268;3264;826;2491;105;377;378;1080;483;1457
355590;201807;188;483;139;405;15;45;86;240;101;285
355600;201807;1532;4028;1045;3113;274;869;378;1064;652;1933
355610;201807;1720;4619;1202;3616;182;586;552;1563;734;2149
355620;201807;4577;13320;3477;10928;501;1858;1745;4976;2246;6834
355630;201807;2229;6470;1549;5113;327;1110;624;2043;951;3153
355635;201807;956;2906;778;2585;129;470;428;1435;557;1905
355640;201807;2702;8172;1890;6515;476;1714;366;1287;842;3001
355645;201807;4260;12918;3404;11398;454;1740;1986;6497;2440;8237
355650;201807;6779;19082;5610;16877;1432;4586;2761;7742;4193;12328
355660;201807;1286;3621;920;2878;118;488;341;1017;459;1505
355670;201807;3415;10152;2355;7502;377;1392;1044;2894;1421;4286
355680;201807;3064;8877;1236;4201;359;1293;126;393;485;1686
355690;201807;658;2089;433;1599;125;478;19;58;144;536
355695;201807;233;746;129;461;12;48;14;36;26;84
355700;201807;6331;19286;5220;16761;1240;4017;2237;7000;3477;11017
355710;201807;8475;20719;5263;14808;990;2979;1911;4862;2901;7841
355715;201807;362;1104;225;762;62;234;45;138;107;372
355720;201807;1474;4582;1160;3917;228;821;493;1530;721;2351
355730;201807;955;2919;748;2467;193;630;241;762;434;1392
410010;201807;1271;3677;972;3027;204;714;217;655;421;1369
410020;201807;1056;3346;856;2866;305;997;243;817;548;1814
410030;201807;1377;4188;1172;3765;190;701;589;1847;779;2548
410040;201807;10526;31499;8320;27232;1847;6644;2711;8348;4558;14992
410045;201807;1010;2749;674;2101;109;375;196;576;305;951
410050;201807;2628;6773;1621;4866;382;1267;299;770;681;2037
410060;201807;2131;6366;1682;5396;435;1455;519;1607;954;3062
410070;201807;1693;4592;1263;3753;261;822;430;1231;691;2053
410080;201807;1369;3757;1004;3072;162;516;411;1253;573;1769
410090;201807;983;2824;896;2650;106;311;486;1523;592;1834
410100;201807;2139;6478;1530;4970;230;864;268;849;498;1713
410105;201807;439;1231;241;776;45;174;52;147;97;321
410110;201807;3130;8424;2184;6468;332;1028;789;2271;1121;3299
410115;201807;525;1361;376;1084;76;238;123;319;199;557
410120;201807;2449;7837;2157;7300;762;2771;616;2016;1378;4787
410130;201807;1123;3229;1007;3010;334;1103;349;923;683;2026
410140;201807;15352;38925;9493;27964;1992;6326;1930;5199;3922;11525
410150;201807;16548;41029;7910;22930;1547;4789;1477;4068;3024;8857
410160;201807;2883;8410;2439;7572;530;1822;906;2830;1436;4652
410165;201807;667;1916;551;1646;55;187;331;929;386;1116
410170;201807;2415;6646;1620;4860;428;1381;155;475;583;1856
410180;201807;13524;40512;10838;34468;1891;6461;5308;15903;7199;22364
410185;201807;514;1413;361;1112;61;190;108;307;169;497
410190;201807;2093;5627;1553;4595;359;1117;376;1072;735;2189
410200;201807;4582;11533;2661;7964;522;1821;552;1597;1074;3418
410210;201807;2625;7333;1777;5514;312;1121;503;1306;815;2427
410220;201807;615;1641;408;1225;56;197;80;236;136;433
410230;201807;1475;4326;1239;3833;220;817;617;1766;837;2583
410240;201807;4259;12242;3409;10534;1029;3556;356;1058;1385;4614
410250;201807;2667;6786;1856;5292;282;938;682;1836;964;2774
410260;201807;1753;4532;1179;3526;242;787;498;1459;740;2246
410270;201807;494;1311;364;1051;30;99;178;495;208;594
410275;201807;727;2164;479;1575;67;229;203;624;270;853
410280;201807;2138;6014;1385;4388;277;952;449;1314;726;2266
410290;201807;3227;9450;2397;7651;540;1719;854;2750;1394;4469
410300;201807;676;1794;526;1503;80;255;227;595;307;850
410302;201807;365;969;180;593;29;97;89;285;118;382
410304;201807;1164;3402;996;3046;162;523;513;1538;675;2061
410305;201807;1691;4365;1233;3639;240;724;609;1782;849;2506
410310;201807;2377;7138;1955;6341;434;1547;648;2079;1082;3626
410315;201807;722;1859;358;1184;90;305;88;281;178;586
410320;201807;1159;3358;731;2381;110;411;108;347;218;758
410322;201807;529;1502;292;939;25;82;115;360;140;442
410330;201807;1452;3817;1065;3034;214;658;285;799;499;1457
410335;201807;880;2527;702;2154;107;357;307;878;414;1235
410337;201807;777;1980;547;1530;54;168;243;633;297;801
410340;201807;521;1433;352;1011;41;137;153;364;194;501
410345;201807;2253;6082;1205;3749;265;844;269;775;534;1619
410347;201807;706;1815;506;1441;53;187;137;362;190;549
410350;201807;1293;3650;950;2970;131;450;347;1000;478;1450
410360;201807;4112;10379;3159;8710;262;868;1961;5136;2223;6004
410370;201807;11255;31256;7742;23374;1172;3942;2787;7439;3959;11381
410380;201807;1402;3886;1096;3232;129;466;451;1237;580;1703
410390;201807;2577;7122;1710;5372;462;1579;353;1018;815;2597
410395;201807;894;2733;726;2366;138;511;326;1065;464;1576
410400;201807;4990;14366;3865;12067;733;2408;1491;4476;2224;6884
410405;201807;821;2133;653;1861;148;456;288;794;436;1250
410410;201807;1158;3359;1129;3322;198;737;693;2046;891;2783
410420;201807;7496;22894;5840;19212;1217;4399;1568;4676;2785;9075
410425;201807;2854;8515;2092;6945;373;1329;647;2012;1020;3341
410430;201807;12847;33475;8876;26007;1528;4808;2803;7903;4331;12711
410440;201807;2817;9323;2480;8665;398;1464;1362;4938;1760;6402
410442;201807;2331;7472;1987;6697;610;2113;630;2111;1240;4224
410445;201807;2228;6900;1798;6014;411;1530;507;1761;918;3291
410450;201807;1605;4423;1212;3632;230;752;282;735;512;1487
410460;201807;1724;4646;1347;4035;234;764;544;1536;778;2300
410465;201807;2521;7773;1960;6528;443;1488;571;1829;1014;3317
410470;201807;1825;5571;1328;4430;334;1226;269;934;603;2160
410480;201807;32388;85079;18394;57454;3008;10376;2667;7214;5675;17590
410490;201807;11081;32366;7873;25349;1584;5494;2545;7656;4129;13150
410500;201807;1655;4842;1208;3849;304;1071;264;738;568;1809
410510;201807;2140;5549;1393;4011;266;758;428;1232;694;1990
410520;201807;3015;9934;2750;9384;784;2749;1177;4049;1961;6798
410530;201807;1543;4196;797;2425;142;429;101;246;243;675
410540;201807;2649;7570;1920;6072;296;1003;894;2772;1190;3775
410550;201807;6730;18707;4356;13416;877;2933;913;2462;1790;5395
410560;201807;1391;3801;1094;3224;237;756;443;1175;680;1931
410570;201807;2599;7731;2035;6625;571;2110;235;821;806;2931
410580;201807;23342;64396;17840;53782;3712;12326;7287;20338;10999;32664
410590;201807;1396;4188;914;2926;174;584;216;624;390;1208
410600;201807;1763;4971;1375;4174;311;919;486;1526;797;2445
410610;201807;760;2067;553;1658;68;225;216;606;284;831
410620;201807;1924;6080;1274;4469;332;1239;187;586;519;1825
410630;201807;2330;6669;1509;4814;299;1029;205;541;504;1570
410640;201807;4405;11204;2985;8683;763;2498;448;1248;1211;3746
410645;201807;1093;3512;967;3307;362;1275;313;1107;675;2382
410650;201807;1977;5768;1439;4601;361;1221;388;1116;749;2337
410655;201807;1363;4467;1106;3956;47;172;773;2916;820;3088
410657;201807;673;1820;418;1270;82;277;146;375;228;652
410660;201807;3227;8727;1724;5302;366;1156;292;845;658;2001
410670;201807;997;2578;606;1766;107;303;263;715;370;1018
410680;201807;2866;8898;2056;6886;524;1682;491;1738;1015;3420
410685;201807;588;1609;480;1412;94;308;226;625;320;933
410690;201807;121908;323503;80463;241035;14727;49102;24578;64558;39305;113660
410700;201807;2253;6111;1936;5562;378;1169;936;2520;1314;3689
410710;201807;880;2404;571;1786;63;209;276;820;339;1029
410712;201807;694;2069;591;1869;163;557;206;605;369;1162
410715;201807;870;2706;560;1931;122;423;143;480;265;903
410720;201807;3027;8351;2239;6711;346;1230;458;1178;804;2408
410725;201807;1089;2897;690;2105;123;395;113;290;236;685
410730;201807;582;1583;422;1283;92;324;84;228;176;552
410740;201807;952;2743;670;2185;116;415;260;831;376;1246
410750;201807;1737;4763;1405;4116;241;772;526;1468;767;2240
410752;201807;341;887;157;483;26;93;64;172;90;265
410753;201807;237;715;163;548;23;76;22;63;45;139
410754;201807;1183;3151;981;2822;75;189;614;1911;689;2100
410755;201807;682;1748;482;1368;54;167;243;632;297;799
410760;201807;3011;8335;2314;7053;734;2419;544;1630;1278;4049
410765;201807;12937;38298;10044;32486;1732;6138;1365;4178;3097;10316
410770;201807;952;2413;660;1898;87;273;278;784;365;1057
410773;201807;1300;3606;1149;3363;147;492;795;2255;942;2747
410775;201807;1446;3863;1254;3558;162;510;593;1651;755;2161
410780;201807;610;1598;367;1081;72;206;81;267;153;473
410785;201807;760;2243;611;1942;127;422;195;592;322;1014
410790;201807;557;1685;440;1435;122;422;42;85;164;507
410800;201807;3037;7135;2400;6158;167;487;1308;3237;1475;3724
410810;201807;352;1006;270;844;42;149;117;343;159;492
410820;201807;786;2338;454;1441;92;309;79;232;171;541
410830;201807;29008;76711;21191;62904;5371;17818;6792;19047;12163;36865
410832;201807;1030;2806;865;2481;111;396;469;1246;580;1642
410840;201807;7348;19960;4461;14070;971;3371;712;1953;1683;5324
410845;201807;1190;3329;958;2891;190;613;339;1006;529;1619
410850;201807;2431;7251;2118;6664;415;1399;870;2740;1285;4139
410855;201807;635;1670;450;1316;45;145;191;519;236;664
410860;201807;3887;10545;2997;8791;593;1877;987;2726;1580;4603
410865;201807;1386;4422;1239;4103;243;859;664;2283;907;3142
410870;201807;1259;3533;1105;3292;76;247;776;2310;852;2557
410880;201807;4055;11823;3041;9808;586;2097;423;1449;1009;3546
410890;201807;935;2854;687;2294;166;608;180;595;346;1203
410895;201807;915;3077;783;2770;309;1169;130;435;439;1604
410900;201807;890;2462;591;1844;106;335;136;359;242;694
410910;201807;372;909;196;556;14;42;106;269;120;311
410920;201807;746;2024;578;1723;118;397;226;653;344;1050
410930;201807;1456;4185;1145;3538;308;1081;271;812;579;1893
410940;201807;21364;63290;16289;53360;4208;14903;3700;12252;7908;27155
410950;201807;1916;5829;1732;5531;85;351;1403;4402;1488;4753
410960;201807;7415;19828;4695;14827;1229;4290;1427;4330;2656;8620
410965;201807;1006;2839;760;2333;129;409;360;1072;489;1481
410970;201807;3899;10979;2822;8838;689;2557;424;1159;1113;3716
410975;201807;1342;3650;1019;3041;201;654;330;986;531;1640
410980;201807;6561;17716;4288;13254;604;2059;1636;4847;2240;6906
410990;201807;1160;3134;761;2367;241;843;147;370;388;1213
411000;201807;492;1421;345;1103;55;194;80;209;135;403
411005;201807;453;1265;284;893;66;211;45;138;111;349
411007;201807;2257;6761;1912;6097;450;1543;594;1883;1044;3426
411010;201807;4139;13060;3363;11330;905;3260;328;1030;1233;4290
411020;201807;2385;7053;1994;6348;595;2013;560;1727;1155;3740
411030;201807;717;1877;464;1309;68;210;181;462;249;672
411040;201807;781;2122;351;1075;55;186;81;215;136;401
411050;201807;1827;6057;1549;5400;438;1638;228;697;666;2335
411060;201807;1643;4556;1111;3433;201;763;219;585;420;1348
411065;201807;338;955;254;791;39;123;105;316;144;439
411070;201807;6439;17731;5080;15200;1017;3320;1923;5528;2940;8848
411080;201807;2149;6026;1741;5258;472;1539;434;1303;906;2842
411090;201807;825;2205;533;1639;57;208;108;294;165;502
411095;201807;1505;3797;1046;2979;141;452;360;968;501;1420
411100;201807;1162;3211;802;2489;99;358;212;648;311;1006
411110;201807;576;1592;264;860;35;98;17;43;52;141
411120;201807;1379;4064;1061;3388;341;1217;199;520;540;1737
411125;201807;4778;14613;4418;13942;956;3169;2117;6843;3073;10012
411130;201807;668;1897;468;1462;102;311;163;546;265;857
411140;201807;2216;7049;1806;6097;469;1706;669;2263;1138;3969
411150;201807;3663;10000;2614;7778;571;1928;223;517;794;2445
411155;201807;1006;2680;615;1892;68;214;262;747;330;961
411160;201807;334;818;229;649;33;98;58;169;91;267
411170;201807;723;2227;540;1782;131;448;171;546;302;994
411180;201807;5477;15335;4272;13052;800;2689;1698;4926;2498;7615
411190;201807;1361;3720;1047;3086;213;666;292;765;505;1431
411200;201807;4930;13833;3411;10790;952;3268;763;2290;1715;5558
411210;201807;2269;5707;1649;4659;466;1490;190;488;656;1978
411220;201807;898;2434;668;1960;143;454;214;614;357;1068
411230;201807;988;2698;641;2018;130;423;208;671;338;1094
411240;201807;1431;3585;885;2546;81;257;447;1248;528;1505
411250;201807;2009;5659;1555;4808;359;1272;470;1429;829;2701
411260;201807;349;918;219;664;25;70;86;248;111;318
411270;201807;1820;5338;1452;4568;257;877;644;1954;901;2831
411275;201807;1370;3679;994;2966;179;581;403;1167;582;1748
411280;201807;1474;4121;913;2918;175;587;128;356;303;943
411290;201807;724;2036;505;1601;73;223;223;720;296;943
411295;201807;1100;2839;886;2437;92;291;427;1113;519;1404
411300;201807;1029;2614;637;1813;65;203;243;594;308;797
411310;201807;897;2234;679;1894;43;126;280;765;323;891
411320;201807;5294;14649;3813;11810;861;2789;1141;3243;2002;6032
411325;201807;1587;4648;1336;4170;237;734;691;2226;928;2960
411330;201807;3206;9325;2458;7835;645;2231;642;2087;1287;4318
411340;201807;797;2283;496;1574;70;251;197;589;267;840
411342;201807;841;2164;572;1638;81;238;271;746;352;984
411345;201807;1016;2863;806;2466;111;386;494;1502;605;1888
411350;201807;2635;7539;1860;5931;484;1692;187;586;671;2278
411360;201807;614;1546;425;1238;51;165;140;387;191;552
411370;201807;47201;123331;34810;101253;3718;12743;18397;49756;22115;62499
411373;201807;1381;3793;1126;3370;142;460;502;1521;644;1981
411375;201807;1061;2814;786;2301;125;377;277;764;402;1141
411380;201807;1096;2740;743;1986;69;216;404;970;473;1186
411390;201807;1694;4908;1308;3978;224;760;459;1262;683;2022
411400;201807;2111;5614;1676;4753;272;910;735;1968;1007;2878
411410;201807;2115;6134;1560;4925;359;1239;304;853;663;2092
411420;201807;3947;10342;2323;7055;360;1268;408;982;768;2250
411430;201807;3307;9376;2658;8238;594;1997;1060;3067;1654;5064
411435;201807;429;1254;276;911;45;145;107;321;152;466
411440;201807;2649;8051;2181;7062;497;1727;667;2202;1164;3929
411450;201807;2620;7262;2025;6220;333;1006;1000;3123;1333;4129
411460;201807;3927;10844;2167;7023;378;1411;309;917;687;2328
411470;201807;724;2054;501;1562;79;274;134;380;213;654
411480;201807;4456;12885;3141;10194;606;2216;761;2287;1367;4503
411490;201807;1503;4222;1165;3590;185;668;391;1069;576;1737
411500;201807;1567;4170;1042;3128;165;587;310;873;475;1460
411510;201807;2073;5777;1694;5026;373;1237;383;1152;756;2389
411520;201807;27389;70068;15465;46075;2275;7450;4714;12568;6989;20018
411530;201807;897;2459;584;1849;130;454;120;335;250;789
411535;201807;474;1435;211;756;21;79;23;60;44;139
411540;201807;2900;7631;2038;5828;331;1066;744;2045;1075;3111
411545;201807;968;2950;820;2665;79;271;524;1706;603;1977
411550;201807;675;1823;496;1474;91;300;81;235;172;535
411560;201807;2030;5700;1245;3976;187;692;74;168;261;860
411570;201807;7272;18028;5022;14355;1074;3434;1329;3729;2403;7163
411573;201807;785;2190;678;2010;80;261;399;1156;479;1417
411575;201807;1698;4916;1318;4121;292;960;348;1067;640;2027
411580;201807;4232;10672;2427;7583;285;1113;303;862;588;1975
411585;201807;784;2386;355;1207;88;303;55;160;143;463
411590;201807;380;1107;271;855;28;108;140;401;168;509
411600;201807;286;788;180;587;40;144;60;188;100;332
411605;201807;1459;3867;958;2786;145;505;400;1067;545;1572
411610;201807;2276;6086;1607;4655;220;679;788;2213;1008;2892
411620;201807;2901;8257;2522;7642;427;1434;1449;4290;1876;5724
411630;201807;626;1671;417;1268;89;314;102;270;191;584
411640;201807;499;1414;339;1021;41;136;130;347;171;483
411650;201807;190;566;130;428;25;82;22;81;47;163
411660;201807;901;2383;648;1881;61;171;326;916;387;1087
411670;201807;1135;2988;826;2315;121;335;314;832;435;1167
411680;201807;1571;4413;1258;3822;136;460;656;1988;792;2448
411690;201807;3350;9333;2593;7943;529;1645;804;2562;1333;4207
411695;201807;673;2085;493;1663;74;265;162;559;236;824
411700;201807;1549;4279;1049;3295;243;832;139;386;382;1218
411705;201807;1655;5604;1461;5230;302;1067;821;3078;1123;4145
411710;201807;1856;5007;1360;4057;387;1227;168;504;555;1731
411720;201807;973;2564;682;1955;102;329;228;600;330;929
411721;201807;835;2299;636;1891;134;410;136;399;270;809
411722;201807;709;2032;415;1318;66;255;154;413;220;668
411725;201807;1306;3943;820;2789;197;689;150;518;347;1207
411727;201807;1538;4481;1024;3320;318;1065;124;368;442;1433
411729;201807;661;1694;445;1278;81;254;121;313;202;567
411730;201807;5248;14756;3913;11965;1142;3607;1178;3611;2320;7218
411740;201807;573;1600;301;970;53;175;51;159;104;334
411745;201807;816;2420;547;1742;72;236;99;264;171;500
411750;201807;4918;13802;3645;11166;538;1802;1628;4707;2166;6509
411760;201807;7271;20222;5692;17290;1985;6337;1094;3566;3079;9903
411770;201807;3202;9848;2403;7971;653;2281;302;952;955;3233
411780;201807;2950;8596;2533;7793;682;2229;950;2917;1632;5146
411790;201807;3044;8006;1750;5366;431;1468;222;569;653;2037
411800;201807;1038;2976;685;2154;102;332;119;363;221;695
411810;201807;1720;4627;1293;3812;224;732;585;1596;809;2328
411820;201807;11400;35306;9292;30939;2943;10183;2960;9801;5903;19984
411830;201807;587;1467;407;1159;92;290;78;235;170;525
411840;201807;11051;30344;7349;22481;1400;4645;1822;5176;3222;9821
411845;201807;437;1302;234;783;44;166;22;70;66;236
411850;201807;7624;21037;5617;17205;1660;5603;840;2375;2500;7978
411860;201807;800;2386;590;1921;107;382;150;447;257;829
411870;201807;668;2113;460;1562;95;354;92;287;187;641
411880;201807;2031;5613;1492;4623;376;1276;244;742;620;2018
411885;201807;915;2457;703;2076;120;437;243;673;363;1110
411890;201807;1126;3249;761;2435;126;464;56;154;182;618
411900;201807;877;2614;517;1742;126;438;59;202;185;640
411910;201807;1056;3339;765;2656;217;787;191;631;408;1418
411915;201807;16811;43208;10355;30842;1832;5947;2871;7728;4703;13675
411920;201807;976;3114;820;2747;211;764;214;697;425;1461
411925;201807;575;1552;377;1171;90;299;101;292;191;591
411930;201807;5394;17423;4645;15880;2144;7887;315;1205;2459;9092
411940;201807;3196;10101;2519;8433;639;2219;608;1828;1247;4047
411950;201807;13305;38406;10974;34232;2239;7655;5292;15888;7531;23543
411960;201807;5539;15623;4682;13929;1025;3393;1623;4491;2648;7884
411965;201807;468;1315;335;1054;57;206;123;357;180;563
411970;201807;862;2237;701;1997;121;308;383;1208;504;1516
411980;201807;1533;4207;1202;3575;304;938;402;1140;706;2078
411990;201807;35651;102282;24651;79534;5341;19030;7699;23362;13040;42392
411995;201807;2717;7282;2102;6292;624;2060;588;1650;1212;3710
412000;201807;2199;5194;1580;4145;97;319;981;2380;1078;2699
412010;201807;676;2172;473;1681;75;297;102;316;177;613
412015;201807;576;1681;478;1496;73;245;251;784;324;1029
412020;201807;448;1297;267;877;44;161;93;291;137;452
412030;201807;706;2091;491;1646;91;328;157;509;248;837
412033;201807;903;2631;633;2025;81;273;223;724;304;997
412035;201807;866;2316;550;1749;70;255;255;764;325;1019
412040;201807;588;1676;392;1258;69;224;67;204;136;428
412050;201807;1658;4493;1205;3616;230;771;288;855;518;1626
412060;201807;7153;22905;6191;20899;1884;6944;1497;4870;3381;11814
412065;201807;668;1929;500;1576;95;312;144;441;239;753
412070;201807;1258;3275;929;2594;144;422;363;989;507;1411
412080;201807;1757;5235;1103;3727;174;625;89;281;263;906
412085;201807;328;919;103;361;11;43;8;20;19;63
412090;201807;5436;14850;4527;13182;1216;3562;1935;5784;3151;9346
412100;201807;1852;5288;1409;4466;437;1495;262;876;699;2371
412110;201807;895;2521;651;1970;124;401;191;570;315;971
412120;201807;1777;5659;1441;4909;337;1270;410;1171;747;2441
412125;201807;646;1999;501;1644;119;396;157;500;276;896
412130;201807;643;1814;455;1383;77;267;111;343;188;610
412135;201807;593;1654;272;840;50;148;86;244;136;392
412140;201807;1639;4345;1092;3301;241;842;170;453;411;1295
412150;201807;2995;8177;2485;7203;319;1028;1527;4273;1846;5301
412160;201807;1099;3512;661;2334;160;618;84;285;244;903
412170;201807;4239;12504;3528;11152;803;2738;1437;4210;2240;6948
412175;201807;1348;4244;1143;3840;298;987;406;1387;704;2374
412180;201807;1698;4887;1255;4050;198;761;532;1560;730;2321
412190;201807;3375;8883;2505;7251;373;1192;1047;3060;1420;4252
412200;201807;1917;5898;1334;4448;339;1187;235;770;574;1957
412210;201807;612;1592;367;1104;67;230;95;238;162;468
412215;201807;3853;10554;3161;9201;859;2487;1279;4132;2138;6619
412217;201807;1055;2880;886;2587;79;269;587;1638;666;1907
412220;201807;5771;17003;4853;15197;1276;3991;1638;5425;2914;9416
412230;201807;2823;8924;2286;7756;445;1720;603;1805;1048;3525
412240;201807;7057;18661;4458;13514;848;2859;1128;3143;1976;6002
412250;201807;1974;5378;1541;4512;388;1156;280;798;668;1954
412260;201807;1250;3505;874;2680;145;449;255;722;400;1171
412265;201807;869;2592;737;2309;178;600;287;880;465;1480
412270;201807;820;2464;549;1805;85;301;203;618;288;919
412280;201807;536;1608;432;1416;100;346;111;346;211;692
412290;201807;1004;2633;672;1995;109;356;205;571;314;927
412300;201807;1488;4334;1227;3792;316;1039;256;779;572;1818
412310;201807;815;2342;669;2076;78;325;320;958;398;1283
412320;201807;840;2250;572;1718;81;321;199;580;280;901
412330;201807;1458;4030;1002;3095;196;641;361;1127;557;1768
412340;201807;1010;2980;637;2059;106;359;125;364;231;723
412350;201807;2751;7616;1806;5626;352;1136;308;952;660;2088
412360;201807;244;690;146;461;18;69;52;151;70;220
412370;201807;826;2494;610;2053;128;477;49;185;177;662
412380;201807;1585;4603;1124;3561;303;976;169;564;472;1540
412382;201807;579;1529;382;1135;65;205;108;279;173;484
412385;201807;2233;6438;1864;5666;651;1990;526;1707;1177;3697
412390;201807;2295;6001;1869;5302;361;1070;821;2343;1182;3413
412395;201807;716;2038;497;1577;64;210;222;667;286;877
412400;201807;909;2613;677;2112;152;499;166;543;318;1042
412402;201807;1779;4770;1338;3995;337;1091;155;456;492;1547
412405;201807;3199;9080;2060;6579;457;1616;75;260;532;1876
412410;201807;5253;14786;3944;12308;883;3128;986;2886;1869;6014
412420;201807;463;1237;267;804;28;89;107;283;135;372
412430;201807;548;1474;354;1075;34;111;150;437;184;548
412440;201807;2892;8359;1984;6536;530;1880;339;1127;869;3007
412450;201807;345;1079;240;811;39;127;22;53;61;180
412460;201807;882;2539;730;2244;135;444;282;848;417;1292
412470;201807;1674;5550;1346;4740;353;1285;305;1145;658;2430
412480;201807;996;2870;638;1979;118;396;90;213;208;609
412490;201807;1086;2940;880;2521;125;361;416;1123;541;1484
412500;201807;1827;4942;1407;4107;323;954;276;726;599;1680
412510;201807;1977;6234;1430;4815;357;1273;146;449;503;1722
412520;201807;1443;3933;814;2496;184;557;87;248;271;805
412530;201807;635;1769;463;1407;66;220;123;360;189;580
412535;201807;778;2155;542;1656;124;416;101;276;225;692
412540;201807;1235;3369;860;2551;99;347;265;796;364;1143
412545;201807;703;1872;476;1379;86;260;138;360;224;620
412550;201807;31362;89534;21342;67692;4328;14642;6415;18802;10743;33444
412555;201807;245;675;157;480;23;78;45;109;68;187
412560;201807;5239;15631;3787;12205;799;2838;930;2909;1729;5747
412570;201807;3967;10863;2445;7668;532;1800;324;1088;856;2888
412575;201807;946;2683;769;2291;83;285;407;1115;490;1400
412580;201807;1360;3651;948;2836;156;514;398;1136;554;1650
412590;201807;493;1360;259;853;48;158;30;92;78;250
412600;201807;1409;4104;1034;3257;177;629;393;1187;570;1816
412610;201807;795;2260;502;1523;69;218;211;568;280;786
412620;201807;1280;3648;959;3048;198;712;298;861;496;1573
412625;201807;8477;23956;5614;18007;931;3253;539;1813;1470;5066
412627;201807;988;2905;675;2227;170;632;181;572;351;1204
412630;201807;3033;9115;2204;7191;422;1374;688;2060;1110;3434
412635;201807;369;1031;256;781;46;153;53;135;99;288
412640;201807;1033;2931;588;1881;86;296;125;358;211;654
412650;201807;1551;4478;1285;3960;233;828;437;1178;670;2006
412660;201807;2602;7142;1842;5593;339;1119;515;1448;854;2567
412665;201807;568;1423;322;962;56;171;118;323;174;494
412667;201807;1728;4716;1285;3808;204;700;494;1386;698;2086
412670;201807;611;1709;468;1436;88;313;154;450;242;763
412680;201807;1436;4114;917;3044;133;526;325;917;458;1443
412690;201807;856;2449;621;1947;118;382;160;476;278;858
412700;201807;2067;5657;1647;4965;321;1169;726;2062;1047;3231
412710;201807;6016;18384;4817;15846;1041;3713;1319;4025;2360;7738
412720;201807;1262;3831;935;3032;165;579;183;500;348;1079
412730;201807;2139;6194;1199;3968;250;871;183;574;433;1445
412740;201807;1728;5061;1149;3744;229;825;166;566;395;1391
412750;201807;3959;11315;3412;10415;427;1592;2141;6220;2568;7812
412760;201807;2779;7963;2400;7298;377;1273;1359;3990;1736;5263
412770;201807;10394;27592;5556;17338;827;2707;1090;3027;1917;5734
412780;201807;1278;3701;1034;3220;217;722;373;1140;590;1862
412785;201807;2076;5504;1478;4373;309;931;665;1923;974;2854
412788;201807;1362;4035;1110;3516;262;886;464;1396;726;2282
412790;201807;1050;3031;656;2157;127;477;179;513;306;990
412795;201807;1171;3245;680;2099;150;489;142;410;292;899
412796;201807;2316;7111;1945;6254;396;1360;637;1889;1033;3249
412800;201807;3346;8797;2291;6652;324;1075;880;2318;1204;3393
412810;201807;11067;29085;6505;19331;941;3155;1981;5087;2922;8242
412820;201807;6821;19354;4939;15571;1102;3644;1496;4720;2598;8364
412830;201807;349;1042;250;817;41;131;50;155;91;286
412840;201807;1829;4959;1352;4005;206;659;420;1190;626;1849
412850;201807;3006;8269;2252;6881;385;1260;787;2320;1172;3580
412853;201807;1817;4953;1493;4217;172;534;754;1919;926;2453
412855;201807;1244;3498;856;2597;168;557;212;581;380;1138
412860;201807;960;2742;724;2258;140;464;260;786;400;1250
412862;201807;694;1690;445;1251;71;224;177;484;248;708
412863;201807;1208;3811;1128;3674;120;397;827;2696;947;3093
412865;201807;733;2120;539;1738;101;337;185;608;286;945
412870;201807;918;2572;703;2204;222;783;145;467;367;1250
412880;201807;849;2423;567;1787;106;359;79;239;185;598
420005;201807;452;1361;249;874;37;136;95;333;132;469
420010;201807;3673;9345;2428;7154;233;764;1641;4827;1874;5591
420020;201807;547;1722;318;1121;52;206;46;128;98;334
420030;201807;189;540;100;377;24;107;13;47;37;154
420040;201807;602;1877;332;1243;56;228;18;50;74;278
420050;201807;659;1678;427;1256;61;191;234;654;295;845
420055;201807;153;470;77;282;14;63;23;82;37;145
420060;201807;137;424;92;314;15;61;18;37;33;98
420070;201807;971;3052;718;2451;145;536;251;830;396;1366
420075;201807;104;285;57;181;12;40;12;24;24;64
420080;201807;444;1340;340;1127;107;361;95;304;202;665
420090;201807;388;1309;254;946;58;223;51;196;109;419
420100;201807;1143;3288;1001;3079;73;245;758;2304;831;2549
420110;201807;250;827;225;774;48;182;89;279;137;461
420120;201807;365;1117;263;882;60;229;100;304;160;533
420125;201807;334;1117;271;987;66;275;126;441;192;716
420127;201807;310;875;109;384;25;102;18;52;43;154
420130;201807;2003;6217;1484;5127;327;1285;518;1609;845;2894
420140;201807;3468;9880;2502;8056;678;2460;324;994;1002;3454
420150;201807;546;1445;345;1113;72;254;137;417;209;671
420160;201807;233;608;107;350;15;51;36;117;51;168
420165;201807;166;502;104;350;24;83;30;91;54;174
420170;201807;243;761;149;531;30;118;26;81;56;199
420180;201807;232;706;127;451;14;49;35;104;49;153
420190;201807;145;495;89;342;33;130;14;52;47;182
420195;201807;1323;3732;1012;3190;302;1087;127;341;429;1428
420200;201807;3173;8854;1847;6063;324;1305;552;1571;876;2876
420205;201807;1250;3664;920;3031;155;553;504;1686;659;2239
420207;201807;1565;4339;1005;3232;227;827;324;989;551;1816
420208;201807;435;1204;247;870;41;177;101;354;142;531
420209;201807;168;559;106;381;34;144;38;121;72;265
420210;201807;2336;6465;1480;5012;314;1178;585;1886;899;3064
420213;201807;786;2615;684;2395;179;689;310;1067;489;1756
420215;201807;274;844;174;611;53;192;27;86;80;278
420220;201807;179;592;126;477;36;148;42;146;78;294
420230;201807;3862;11069;2925;9335;459;1678;1458;4479;1917;6157
420240;201807;11584;31664;7224;22797;967;3639;3543;9941;4510;13580
420243;201807;419;1261;334;1095;63;218;151;472;214;690
420245;201807;1229;3434;844;2702;97;395;428;1282;525;1677
420250;201807;452;1393;396;1281;82;299;186;561;268;860
420253;201807;517;1343;379;1134;33;105;197;565;230;670
420257;201807;212;561;128;400;23;75;62;193;85;268
420260;201807;1053;3173;804;2752;140;543;404;1352;544;1895
420270;201807;517;1419;236;746;21;74;81;237;102;311
420280;201807;1521;4191;943;3117;198;708;234;749;432;1457
420285;201807;101;276;51;178;7;28;10;31;17;59
420287;201807;422;1096;286;882;87;280;96;290;183;570
420290;201807;4176;12585;3172;10272;553;1978;1253;3661;1806;5639
420300;201807;6659;19229;3888;12862;820;3052;905;2616;1725;5668
420310;201807;866;2093;431;1203;74;199;238;631;312;830
420315;201807;852;2655;623;2168;157;582;222;764;379;1346
420320;201807;3990;11971;3175;10449;1047;3751;720;2182;1767;5933
420325;201807;238;747;178;621;47;164;53;176;100;340
420330;201807;862;2735;603;2117;127;504;193;622;320;1126
420340;201807;1130;3357;803;2666;184;625;60;193;244;818
420350;201807;1450;3992;1000;3096;133;459;561;1701;694;2160
420360;201807;2626;7717;1459;5062;304;1144;132;451;436;1595
420370;201807;1315;3640;1009;3120;144;550;645;1889;789;2439
420380;201807;5085;14275;3275;10576;769;2658;971;3023;1740;5681
420390;201807;1083;2802;711;2031;121;391;268;552;389;943
420395;201807;1058;3168;685;2335;119;440;82;241;201;681
420400;201807;996;3025;648;2236;135;522;158;524;293;1046
420410;201807;547;1541;404;1258;38;147;266;791;304;938
420415;201807;337;1041;257;868;79;281;69;239;148;520
420417;201807;657;2051;525;1743;125;438;196;648;321;1086
420419;201807;219;757;156;596;56;244;6;16;62;260
420420;201807;10289;28951;7416;23568;2556;8803;1647;4872;4203;13675
420425;201807;830;2226;564;1729;60;227;239;696;299;923
420430;201807;3227;9392;2015;6565;477;1670;560;1641;1037;3311
420435;201807;288;791;131;453;24;100;48;154;72;254
420440;201807;777;2285;424;1411;128;477;107;305;235;782
420445;201807;326;909;195;618;42;139;60;174;102;313
420450;201807;667;2048;476;1611;96;376;133;406;229;782
420455;201807;1997;5312;1494;4456;214;731;729;2067;943;2798
420460;201807;8644;24255;6489;20322;1187;4169;2820;8370;4007;12539
420470;201807;646;1772;388;1251;76;288;97;271;173;559
420475;201807;39;117;30;95;12;37;6;19;18;56
420480;201807;5039;13384;3298;10243;689;2342;992;3013;1681;5355
420490;201807;567;1524;309;1046;75;290;71;241;146;531
420500;201807;1323;3965;944;3211;199;710;331;1096;530;1806
420510;201807;114;382;72;254;12;38;32;110;44;148
420515;201807;62;180;44;143;6;20;16;48;22;68
420517;201807;773;2170;680;2008;61;178;501;1473;562;1651
420519;201807;357;909;227;694;35;124;79;242;114;366
420520;201807;452;1231;207;725;27;95;18;53;45;148
420530;201807;951;2858;662;2230;139;528;181;514;320;1042
420535;201807;226;651;103;350;25;87;16;58;41;145
420540;201807;25678;66274;16762;49201;3160;10194;5623;14408;8783;24602
420543;201807;239;692;187;586;31;94;97;294;128;388
420545;201807;1266;3915;1004;3351;237;821;343;1111;580;1932
420550;201807;3600;10496;2407;8211;497;1891;898;3131;1395;5022
420555;201807;311;946;218;737;47;182;89;276;136;458
420560;201807;429;1174;320;990;74;225;162;498;236;723
420570;201807;2175;6527;1648;5422;360;1305;574;1749;934;3054
420580;201807;1757;4706;1305;3976;284;956;595;1719;879;2675
420590;201807;3056;8709;1841;5928;372;1354;367;877;739;2231
420600;201807;940;2894;748;2505;143;543;347;1122;490;1665
420610;201807;397;1194;216;761;56;212;41;136;97;348
420620;201807;499;1444;403;1269;114;373;129;404;243;777
420630;201807;854;2603;632;2058;130;460;276;822;406;1282
420640;201807;587;1691;277;976;71;267;28;83;99;350
420650;201807;2747;7763;1643;5356;280;978;580;1656;860;2634
420660;201807;405;1147;270;861;61;219;67;200;128;419
420665;201807;538;1461;342;1105;59;221;139;400;198;621
420670;201807;1555;4405;1038;3365;188;763;342;968;530;1731
420675;201807;158;477;102;353;29;117;18;48;47;165
420680;201807;337;822;192;610;32;114;87;265;119;379
420690;201807;841;2730;564;1994;85;313;121;336;206;649
420700;201807;2969;8356;2278;7063;373;1290;989;2923;1362;4213
420710;201807;658;2056;503;1732;90;381;233;728;323;1109
420720;201807;1374;3870;1025;3346;275;912;426;1381;701;2293
420730;201807;2867;8006;2220;6939;396;1335;1140;3439;1536;4774
420740;201807;727;2205;476;1666;135;501;76;269;211;770
420750;201807;1870;5723;1293;4397;223;855;444;1345;667;2200
420757;201807;78;179;22;88;3;15;9;35;12;50
420760;201807;387;1194;172;576;38;131;23;73;61;204
420765;201807;450;1434;235;839;43;167;72;251;115;418
420768;201807;1224;3870;1036;3502;216;762;634;2137;850;2899
420770;201807;510;1414;235;858;46;190;70;258;116;448
420775;201807;472;1384;270;926;61;229;50;147;111;376
420780;201807;1089;3176;645;2174;122;432;144;435;266;867
420785;201807;195;550;142;431;26;77;40;107;66;184
420790;201807;1015;3316;788;2855;197;780;331;1134;528;1914
420800;201807;748;2029;340;1141;80;285;87;275;167;560
420810;201807;1574;5333;1290;4682;410;1662;290;898;700;2560
420820;201807;9459;25560;6427;20451;1480;5253;2272;6563;3752;11816
420830;201807;2945;8566;2300;7359;571;1991;803;2494;1374;4485
420840;201807;681;2005;299;1061;74;283;55;172;129;455
420845;201807;1803;4925;1072;3582;241;890;345;1141;586;2031
420850;201807;1137;3812;703;2665;171;720;101;326;272;1046
420860;201807;292;804;180;598;47;176;33;98;80;274
420870;201807;894;2478;688;2127;219;773;254;727;473;1500
420880;201807;929;2991;719;2504;162;622;197;614;359;1236
420890;201807;7644;21014;4166;13674;748;2696;1112;3102;1860;5798
420895;201807;170;506;96;310;33;113;24;72;57;185
420900;201807;1497;3918;889;2789;139;520;332;909;471;1429
420910;201807;23919;67445;15732;51124;2727;9921;5413;15920;8140;25841
420915;201807;580;2174;389;1601;69;299;166;673;235;972
420917;201807;362;1024;180;541;30;98;71;199;101;297
420920;201807;106;309;41;150;6;25;2;6;8;31
420930;201807;17751;48341;12792;39561;2346;7964;5567;16283;7913;24247
420940;201807;2430;6582;1584;5008;393;1362;147;365;540;1727
420945;201807;147;447;105;338;35;129;29;78;64;207
420950;201807;404;1162;215;736;27;112;62;190;89;302
420960;201807;922;2513;638;1958;126;455;232;639;358;1094
420970;201807;2593;7731;1796;6116;515;1840;296;1076;811;2916
420980;201807;354;1090;282;981;118;416;93;354;211;770
420985;201807;330;996;170;608;38;157;54;163;92;320
420990;201807;532;1588;284;1019;59;224;50;142;109;366
421000;201807;488;1661;332;1234;87;356;67;197;154;553
421003;201807;519;1283;176;553;17;52;26;63;43;115
421005;201807;64;219;57;206;15;60;25;91;40;151
421010;201807;3912;10932;2737;8818;598;2110;595;1727;1193;3837
421020;201807;398;1192;308;1035;24;96;203;688;227;784
421030;201807;727;2349;573;1998;182;691;140;451;322;1142
421040;201807;792;1936;476;1436;53;192;275;796;328;988
421050;201807;1311;3726;757;2466;144;502;235;694;379;1196
421055;201807;171;473;86;273;24;84;19;51;43;135
421060;201807;545;1664;370;1226;79;309;137;417;216;726
421070;201807;551;1744;316;1138;79;299;44;161;123;460
421080;201807;658;2678;608;2601;68;225;461;2132;529;2357
421085;201807;439;1270;187;672;26;100;32;101;58;201
421090;201807;394;1065;197;627;24;78;52;157;76;235
421100;201807;934;2376;452;1391;108;362;48;132;156;494
421105;201807;1444;4092;1129;3612;178;566;594;1972;772;2538
421110;201807;959;2933;818;2691;65;211;542;1822;607;2033
421120;201807;1078;3448;726;2634;101;414;197;627;298;1041
421125;201807;305;819;225;694;73;252;73;176;146;428
421130;201807;3664;11337;3124;10280;719;2606;1599;5113;2318;7719
421140;201807;288;833;196;636;41;132;58;166;99;298
421145;201807;471;1370;278;907;56;203;116;354;172;557
421150;201807;513;1473;328;1137;66;276;115;368;181;644
421160;201807;822;2208;440;1422;63;229;212;664;275;893
421165;201807;205;638;146;493;31;102;64;215;95;317
421170;201807;1179;3201;918;2791;150;459;556;1703;706;2162
421175;201807;1113;3024;729;2348;155;580;263;763;418;1343
421180;201807;433;1144;204;661;41;171;44;129;85;300
421185;201807;335;880;223;661;39;120;122;353;161;473
421187;201807;343;1030;224;729;37;124;86;261;123;385
421189;201807;365;1133;274;928;51;190;81;255;132;445
421190;201807;10435;28866;6443;21242;1339;4883;1328;4117;2667;9000
421200;201807;727;2270;594;2009;107;378;260;838;367;1216
421205;201807;196;555;150;476;29;105;68;204;97;309
421210;201807;1101;3092;726;2362;178;581;244;786;422;1367
421220;201807;1417;4630;1183;4095;305;1167;228;690;533;1857
421223;201807;414;1236;280;964;59;204;108;369;167;573
421225;201807;989;3091;845;2794;172;618;443;1482;615;2100
421227;201807;989;2701;619;1970;105;365;308;993;413;1358
421230;201807;578;1574;380;1218;105;357;125;401;230;758
421240;201807;329;1029;141;535;14;71;17;64;31;135
421250;201807;1499;4057;965;3140;191;700;325;1001;516;1701
421260;201807;271;782;52;190;10;37;7;26;17;63
421265;201807;723;2169;660;2075;48;173;530;1659;578;1832
421270;201807;445;1188;205;729;43;154;71;248;114;402
421280;201807;1541;4727;1196;4074;281;1061;472;1542;753;2603
421290;201807;815;2275;466;1484;93;296;90;277;183;573
421300;201807;231;678;150;500;35;137;47;149;82;286
421310;201807;188;593;147;491;25;93;56;185;81;278
421315;201807;254;765;152;526;40;144;20;75;60;219
421320;201807;676;2032;373;1261;67;241;56;141;123;382
421330;201807;617;1849;450;1520;105;389;117;369;222;758
421335;201807;390;1277;315;1125;59;246;103;363;162;609
421340;201807;1396;4006;1054;3391;213;758;460;1432;673;2190
421350;201807;1141;3379;861;2863;167;669;387;1211;554;1880
421360;201807;2284;6494;1420;4746;319;1246;465;1368;784;2614
421370;201807;471;1578;302;1125;72;286;71;259;143;545
421380;201807;828;2365;704;2139;109;364;395;1153;504;1517
421390;201807;163;444;64;214;11;35;16;49;27;84
421400;201807;278;929;184;705;43;191;84;298;127;489
421410;201807;268;753;119;429;15;62;50;176;65;238
421415;201807;335;1031;152;518;39;137;26;75;65;212
421420;201807;604;1774;485;1549;78;272;258;785;336;1057
421430;201807;138;470;105;386;17;66;29;102;46;168
421440;201807;710;1966;471;1547;92;320;229;759;321;1079
421450;201807;398;1195;241;827;32;127;43;170;75;297
421460;201807;434;1224;260;897;57;211;67;212;124;423
421470;201807;254;813;177;635;42;175;51;174;93;349
421480;201807;2782;7679;1801;5888;477;1739;453;1318;930;3057
421490;201807;148;445;77;279;10;41;20;58;30;99
421500;201807;2080;6560;1480;5259;408;1623;261;847;669;2470
421505;201807;315;973;273;899;42;152;157;503;199;655
421507;201807;392;1185;236;832;63;251;75;252;138;503
421510;201807;234;682;144;468;31;93;63;187;94;280
421520;201807;565;1561;358;1092;50;177;180;502;230;679
421530;201807;331;1053;189;687;37;167;39;119;76;286
421535;201807;432;1241;279;934;34;132;139;433;173;565
421540;201807;233;613;155;484;19;62;66;190;85;252
421545;201807;685;2087;495;1699;104;401;212;701;316;1102
421550;201807;1999;5920;1686;5417;407;1441;781;2412;1188;3853
421555;201807;205;616;71;254;13;49;10;22;23;71
421560;201807;95;304;54;201;13;56;14;49;27;105
421565;201807;821;2256;597;1889;142;494;216;712;358;1206
421567;201807;508;1796;349;1323;157;611;56;200;213;811
421568;201807;410;1251;283;945;42;155;116;365;158;520
421569;201807;197;597;73;270;20;71;18;72;38;143
421570;201807;1124;3189;710;2308;180;637;134;399;314;1036
421575;201807;328;1014;287;900;45;160;150;435;195;595
421580;201807;2843;8596;2025;6864;439;1725;646;1888;1085;3613
421590;201807;147;490;119;411;35;129;30;92;65;221
421600;201807;472;1339;325;1005;84;273;82;228;166;501
421605;201807;763;2100;509;1640;103;356;148;455;251;811
421610;201807;1224;3374;754;2431;157;545;165;499;322;1044
421620;201807;3867;11127;2300;7983;611;2309;537;1801;1148;4110
421625;201807;267;734;105;354;24;77;13;36;37;113
421630;201807;2686;7634;1497;4880;267;994;320;922;587;1916
421635;201807;244;711;140;453;18;66;55;151;73;217
421640;201807;819;2310;548;1803;116;398;152;485;268;883
421650;201807;2161;6425;1416;4838;328;1290;261;704;589;1994
421660;201807;7158;22141;5751;19330;1080;4139;2117;6531;3197;10670
421670;201807;906;2655;620;1997;141;534;236;714;377;1248
421680;201807;968;3018;756;2561;232;840;232;725;464;1565
421690;201807;1223;3849;879;3042;208;814;216;717;424;1531
421700;201807;461;1465;235;866;51;199;54;179;105;378
421710;201807;203;651;88;303;19;71;28;86;47;157
421715;201807;115;326;78;243;17;53;46;135;63;188
421720;201807;1894;5445;1104;3759;286;1042;272;843;558;1885
421725;201807;180;477;108;339;26;84;38;99;64;183
421730;201807;379;1160;205;655;35;121;70;194;105;315
421740;201807;626;1893;429;1420;114;409;106;314;220;723
421750;201807;900;2221;469;1421;84;273;177;496;261;769
421755;201807;215;617;109;365;15;63;44;132;59;195
421760;201807;948;2753;516;1773;93;354;125;366;218;720
421770;201807;2384;6710;1752;5584;435;1405;620;2134;1055;3539
421775;201807;263;743;172;557;30;105;73;222;103;327
421780;201807;863;2797;586;2160;123;486;172;612;295;1098
421790;201807;637;1656;378;1241;94;334;162;504;256;838
421795;201807;246;740;151;481;25;90;55;154;80;244
421800;201807;2468;7222;1817;5987;381;1375;820;2594;1201;3969
421810;201807;651;1843;450;1443;69;258;211;629;280;887
421820;201807;870;2534;468;1599;94;339;80;255;174;594
421825;201807;1321;3932;1207;3746;167;575;836;2527;1003;3102
421830;201807;2195;7135;1881;6505;469;1783;610;1981;1079;3764
421835;201807;217;585;125;415;19;89;58;166;77;255
421840;201807;225;706;152;552;38;149;41;135;79;284
421850;201807;412;1267;233;810;43;176;57;150;100;326
421860;201807;283;869;185;650;27;119;53;147;80;266
421870;201807;3413;9186;2359;7133;515;1735;832;2304;1347;4039
421875;201807;271;819;126;461;21;87;22;60;43;147
421880;201807;570;1654;420;1367;120;436;68;223;188;659
421885;201807;241;704;183;610;55;191;35;97;90;288
421890;201807;771;2524;622;2228;162;660;244;791;406;1451
421895;201807;350;1038;321;997;48;173;210;648;258;821
421900;201807;952;2543;646;1938;114;398;290;785;404;1183
421910;201807;362;1127;254;882;56;221;45;126;101;347
421915;201807;398;1155;226;744;48;153;31;92;79;245
421917;201807;578;1574;375;1284;135;520;76;254;211;774
421920;201807;523;1530;345;1240;171;638;101;374;272;1012
421930;201807;2355;6416;1173;4014;323;1186;151;466;474;1652
421935;201807;482;1588;381;1370;76;297;183;619;259;916
421940;201807;284;882;125;437;24;101;33;106;57;207
421950;201807;3157;8136;1532;4912;333;1185;299;870;632;2055
421960;201807;158;427;109;350;19;77;27;84;46;161
421970;201807;2061;5517;1120;3564;245;814;294;832;539;1646
421985;201807;335;861;185;565;22;73;58;189;80;262
422000;201807;1650;4696;1349;4141;210;740;756;2289;966;3029
430003;201807;549;1622;387;1323;81;307;140;462;221;769
430005;201807;280;780;181;588;50;165;73;238;123;403
430010;201807;1765;4709;1382;4034;219;695;800;2275;1019;2970
430020;201807;614;1486;477;1296;77;237;279;719;356;956
430030;201807;1052;2602;618;1800;182;545;169;480;351;1025
430040;201807;10001;25915;6114;18408;1649;5488;373;1186;2022;6674
430045;201807;585;1569;401;1185;50;173;204;561;254;734
430047;201807;275;642;114;345;23;75;34;104;57;179
430050;201807;991;2633;545;1672;119;384;132;377;251;761
430055;201807;285;736;127;392;16;53;58;164;74;217
430057;201807;106;248;37;113;8;32;6;15;14;47
430060;201807;16616;48625;13437;43368;3505;12127;5336;17297;8841;29424
430063;201807;879;2514;691;2095;130;396;389;1171;519;1567
430064;201807;1048;3054;778;2431;227;759;220;677;447;1436
430066;201807;130;301;92;238;4;15;63;152;67;167
430070;201807;681;1791;117;402;15;56;12;29;27;85
430080;201807;779;2084;455;1402;98;320;173;477;271;797
430085;201807;899;2226;532;1557;88;262;198;586;286;848
430087;201807;622;1874;519;1701;104;376;266;851;370;1227
430090;201807;643;1703;218;715;23;92;62;199;85;291
430100;201807;688;1770;364;1129;75;254;121;334;196;588
430105;201807;1036;2854;668;2201;123;475;294;972;417;1447
430107;201807;183;556;126;418;18;63;30;84;48;147
430110;201807;2111;5435;1543;4562;271;837;814;2340;1085;3177
430120;201807;1433;4417;902;3032;200;701;365;1258;565;1959
430130;201807;3900;10399;3099;9203;1043;2849;976;3560;2019;6409
430140;201807;979;2915;625;2097;165;540;218;732;383;1272
430150;201807;598;1564;330;1028;74;239;95;282;169;521
430155;201807;290;765;146;464;20;69;35;97;55;166
430160;201807;17797;46926;14322;41450;3243;9864;5679;17031;8922;26895
430163;201807;2373;6191;1709;5118;190;656;1035;3051;1225;3707
430165;201807;442;1031;88;277;11;28;9;23;20;51
430170;201807;908;2512;324;1145;64;224;61;199;125;423
430175;201807;705;2223;579;1913;146;480;275;906;421;1386
430180;201807;691;1839;551;1588;90;285;337;923;427;1208
430185;201807;488;1211;300;852;49;145;137;350;186;495
430187;201807;652;1721;462;1409;75;251;217;650;292;901
430190;201807;1483;4273;1226;3765;307;1006;518;1555;825;2561
430192;201807;138;422;61;195;11;36;12;32;23;68
430195;201807;383;1150;67;234;10;34;6;19;16;53
430200;201807;1093;3479;922;3130;297;1060;280;946;577;2006
430205;201807;512;1417;397;1173;18;67;314;901;332;968
430210;201807;5350;13803;3633;10319;597;1846;1386;3182;1983;5028
430215;201807;327;897;211;642;38;121;77;230;115;351
430220;201807;658;1645;178;598;34;126;43;125;77;251
430222;201807;195;597;158;512;28;97;66;201;94;298
430223;201807;273;768;227;675;39;125;117;334;156;459
430225;201807;17;43;15;39;2;3;8;13;10;16
430230;201807;1624;4755;1514;4608;206;580;1160;3630;1366;4210
430235;201807;247;776;183;616;33;118;60;185;93;303
430237;201807;556;1387;373;1055;23;80;244;640;267;720
430240;201807;1188;2704;711;1962;63;213;417;1111;480;1324
430245;201807;741;2254;562;1877;182;609;251;859;433;1468
430250;201807;1025;2815;824;2505;261;846;45;131;306;977
430258;201807;114;325;87;273;8;28;45;144;53;172
430260;201807;629;1731;455;1380;87;268;218;661;305;929
430265;201807;189;567;137;473;21;82;41;139;62;221
430270;201807;2835;7422;2301;6590;252;792;1547;4334;1799;5126
430280;201807;4872;12256;3538;9847;800;2275;1467;4111;2267;6386
430290;201807;2200;5530;1953;5191;79;245;1674;4395;1753;4640
430300;201807;8752;24231;6933;20826;1395;4489;3245;9657;4640;14146
430310;201807;8589;22992;5848;17708;960;3308;2610;7420;3570;10728
430320;201807;932;2597;514;1659;90;251;248;856;338;1107
430330;201807;635;1611;432;1209;100;310;190;465;290;775
430340;201807;746;1749;372;1127;72;226;191;566;263;792
430350;201807;5878;17008;4755;14653;1220;3857;1986;6001;3206;9858
430355;201807;367;944;123;400;29;94;13;42;42;136
430360;201807;786;2066;564;1650;122;403;183;474;305;877
430367;201807;335;836;171;517;48;159;50;151;98;310
430370;201807;533;1494;261;855;57;201;59;171;116;372
430380;201807;700;1799;379;1206;105;380;88;294;193;674
430390;201807;3311;8450;1829;5577;339;1118;151;368;490;1486
430400;201807;1145;2651;853;2179;114;304;554;1368;668;1672
430410;201807;597;1528;419;1212;56;192;240;673;296;865
430420;201807;2932;8381;2258;6829;697;2191;743;2165;1440;4356
430430;201807;689;1804;333;1047;81;262;64;190;145;452
430435;201807;1717;4484;1249;3665;288;907;460;1337;748;2244
430440;201807;3794;11162;2840;9152;549;1910;1371;4424;1920;6334
430450;201807;6334;17328;5310;15393;884;2830;2773;7850;3657;10680
430460;201807;28005;76093;20155;62888;4555;15761;8045;23923;12600;39684
430461;201807;466;1205;137;433;24;79;30;84;54;163
430462;201807;263;716;165;533;24;80;44;153;68;233
430463;201807;4712;13854;3813;12231;749;2621;1855;5900;2604;8521
430465;201807;490;1334;403;1160;74;231;241;673;315;904
430466;201807;3808;9877;3082;8674;763;2245;1435;3848;2198;6093
430467;201807;501;1325;367;1088;54;178;165;478;219;656
430468;201807;1373;3540;1087;3107;162;520;625;1763;787;2283
430469;201807;598;1691;70;235;10;27;10;27;20;54
430470;201807;6239;16914;4373;13537;1439;4692;900;2825;2339;7517
430471;201807;498;1586;439;1450;90;292;192;622;282;914
430480;201807;925;2469;461;1470;72;260;79;214;151;474
430485;201807;157;438;58;196;7;23;13;42;20;65
430490;201807;414;1117;226;697;32;111;100;295;132;406
430495;201807;385;1089;239;784;31;112;96;279;127;391
430500;201807;1111;2934;799;2405;214;715;282;771;496;1486
430510;201807;23227;63546;16797;50493;3847;12615;6030;16719;9877;29334
430511;201807;332;988;117;412;17;58;14;42;31;100
430512;201807;914;2244;742;1966;191;527;233;641;424;1168
430513;201807;796;2038;388;1122;81;250;165;450;246;700
430515;201807;397;1143;285;917;43;124;139;456;182;580
430517;201807;969;3066;785;2684;134;466;395;1400;529;1866
430520;201807;1404;3796;751;2372;148;479;133;384;281;863
430530;201807;1116;2890;397;1232;80;239;79;237;159;476
430535;201807;2977;8198;2096;6487;381;1239;936;2858;1317;4097
430537;201807;353;1264;314;1134;36;118;230;843;266;961
430540;201807;590;1391;344;1000;60;167;169;485;229;652
430543;201807;639;1294;408;1023;61;143;254;667;315;810
430544;201807;652;2001;477;1579;101;349;221;705;322;1054
430545;201807;1752;5006;1346;4373;305;1045;630;2100;935;3145
430550;201807;519;1463;285;923;55;182;70;201;125;383
430558;201807;135;337;67;204;13;38;20;55;33;93
430560;201807;411;963;175;532;19;63;42;124;61;187
430570;201807;896;2180;605;1675;91;299;344;871;435;1170
430580;201807;1124;2716;703;2043;130;441;314;863;444;1304
430583;201807;189;471;35;110;3;8;5;15;8;23
430585;201807;235;576;129;359;18;55;60;141;78;196
430587;201807;187;564;141;458;28;94;57;182;85;276
430590;201807;1427;3549;1229;3223;52;169;1071;2759;1123;2928
430593;201807;13;42;12;41;1;3;7;25;8;28
430595;201807;443;1089;94;335;9;40;16;49;25;89
430597;201807;345;984;231;714;30;105;82;198;112;303
430600;201807;1830;4903;858;2636;154;482;222;640;376;1122
430605;201807;1178;3445;881;2818;126;482;336;1043;462;1525
430607;201807;680;1550;485;1253;34;100;322;850;356;950
430610;201807;6080;15646;4361;12907;1305;4134;696;2160;2001;6294
430613;201807;296;697;90;275;8;31;24;61;32;92
430620;201807;586;1585;461;1336;118;378;201;549;319;927
430630;201807;464;1343;130;428;19;66;26;71;45;137
430632;201807;590;1619;268;826;34;108;110;324;144;432
430635;201807;540;1507;405;1224;70;227;251;737;321;964
430637;201807;425;1132;338;979;49;156;197;542;246;698
430640;201807;1302;3429;700;2158;99;312;204;568;303;880
430642;201807;399;1079;272;809;48;141;128;370;176;511
430645;201807;269;592;89;240;16;46;14;39;30;85
430650;201807;1615;5036;1344;4502;358;1240;622;2123;980;3363
430655;201807;210;501;134;370;25;69;65;166;90;235
430660;201807;4947;13459;3803;11412;851;2787;1664;4918;2515;7705
430670;201807;564;1487;434;1251;48;165;267;776;315;941
430673;201807;620;1473;242;738;50;162;80;238;130;400
430675;201807;230;687;58;204;15;64;13;42;28;106
430676;201807;4329;11590;3325;9860;588;1870;1647;4808;2235;6678
430680;201807;1031;2836;618;1980;148;471;148;448;296;919
430690;201807;3323;9368;2698;8194;841;2656;723;2174;1564;4830
430692;201807;207;648;160;574;13;47;109;404;122;451
430693;201807;1069;2813;593;1809;121;430;124;328;245;758
430695;201807;536;1331;321;926;39;119;168;453;207;572
430697;201807;413;1082;298;880;56;160;145;451;201;611
430700;201807;7528;19358;3986;12695;970;3302;344;1138;1314;4440
430705;201807;356;936;182;582;24;89;73;224;97;313
430710;201807;1740;4001;1233;3225;214;637;621;1556;835;2193
430720;201807;715;1767;389;1197;79;242;144;436;223;678
430730;201807;1304;3444;832;2573;148;468;378;1189;526;1657
430740;201807;612;1734;319;1080;51;183;84;307;135;490
430745;201807;468;1317;237;764;37;136;55;162;92;298
430750;201807;1378;3669;981;2992;201;665;507;1472;708;2137
430755;201807;494;1231;309;845;24;81;165;408;189;489
430760;201807;2115;5571;1605;4730;398;1231;675;1946;1073;3177
430770;201807;6126;16437;4635;13991;825;2751;2530;7433;3355;10184
430780;201807;2231;5741;1334;4182;276;886;402;1323;678;2209
430781;201807;409;1189;257;844;67;222;52;155;119;377
430783;201807;476;1150;279;814;30;94;138;385;168;479
430786;201807;58;197;34;133;6;23;3;14;9;37
430790;201807;4465;11809;3066;9092;517;1675;1568;4402;2085;6077
430800;201807;819;2155;583;1671;59;215;341;921;400;1136
430805;201807;515;1442;300;933;29;95;158;456;187;551
430807;201807;387;966;248;722;24;84;120;324;144;408
430810;201807;910;2326;295;981;47;165;76;230;123;395
430820;201807;1348;3697;729;2446;176;617;147;486;323;1103
430825;201807;285;752;88;251;18;52;22;51;40;103
430830;201807;1575;4778;1343;4347;103;389;919;2971;1022;3360
430840;201807;893;2542;755;2294;150;460;429;1311;579;1771
430843;201807;118;292;40;124;4;11;15;40;19;51
430845;201807;337;882;232;692;83;265;51;126;134;391
430850;201807;2407;6619;1824;5499;364;1213;828;2458;1192;3671
430860;201807;954;2328;478;1426;84;297;193;505;277;802
430865;201807;533;1424;449;1280;110;327;202;539;312;866
430870;201807;682;1847;303;987;51;178;92;267;143;445
430880;201807;1245;3061;816;2362;208;631;329;944;537;1575
430885;201807;228;547;101;334;8;34;57;182;65;216
430890;201807;1199;3217;790;2405;65;294;116;324;181;618
430900;201807;3030;7197;2054;5671;254;833;1132;2917;1386;3750
430905;201807;880;2383;555;1724;118;409;169;490;287;899
430910;201807;1520;4220;1007;3137;191;685;400;1130;591;1815
430912;201807;489;1369;335;1085;39;123;205;678;244;801
430915;201807;522;1627;383;1371;104;399;130;482;234;881
430920;201807;21788;57690;17005;49932;2660;8574;9728;27803;12388;36377
430925;201807;142;315;53;150;11;33;21;63;32;96
430930;201807;10212;25051;6215;18587;1521;4846;1868;5820;3389;10666
430940;201807;1324;3939;714;2362;217;735;93;259;310;994
430950;201807;769;1953;476;1398;75;256;233;611;308;867
430955;201807;193;502;62;191;13;32;7;19;20;51
430957;201807;191;665;175;629;38;144;88;313;126;457
430960;201807;1337;3256;879;2468;183;574;440;1211;623;1785
430965;201807;1722;4293;1302;3621;87;288;975;2654;1062;2942
430970;201807;386;1017;196;618;31;109;97;288;128;397
430975;201807;472;1546;377;1301;91;335;150;515;241;850
430980;201807;431;1066;236;710;47;149;92;268;139;417
430990;201807;574;1712;335;1092;47;172;157;501;204;673
430995;201807;606;1639;436;1334;64;195;208;619;272;814
431000;201807;1460;3572;623;1882;111;375;36;89;147;464
431010;201807;2279;6199;1331;4381;215;807;132;370;347;1177
431020;201807;8884;20511;5474;14989;1306;3833;1635;4138;2941;7971
431030;201807;334;948;149;532;29;102;25;93;54;195
431033;201807;3026;8156;2101;6684;556;1811;728;2479;1284;4290
431036;201807;352;773;68;203;10;22;11;34;21;56
431040;201807;927;2498;602;1868;99;361;266;757;365;1118
431041;201807;480;1151;371;982;42;108;229;601;271;709
431043;201807;445;1139;231;747;75;249;74;235;149;484
431046;201807;124;331;57;170;5;13;12;32;17;45
431050;201807;1557;3888;1094;3148;227;680;550;1572;777;2252
431053;201807;525;1553;351;1191;94;347;91;296;185;643
431055;201807;612;1577;531;1448;48;129;392;1051;440;1180
431057;201807;290;845;134;454;21;77;36;107;57;184
431060;201807;5045;14323;3886;12160;1178;3954;791;2592;1969;6546
431065;201807;513;1377;336;1050;78;240;89;278;167;518
431070;201807;510;1515;295;988;79;288;43;121;122;409
431075;201807;213;658;146;512;29;108;45;160;74;268
431080;201807;671;1927;458;1462;98;336;127;388;225;724
431085;201807;689;1903;503;1470;81;230;276;798;357;1028
431087;201807;454;1330;369;1135;23;80;261;810;284;890
431090;201807;450;1086;162;513;35;127;38;114;73;241
431100;201807;3223;7773;2373;6581;448;1352;1027;2834;1475;4186
431110;201807;1407;3393;1002;2679;256;709;436;1082;692;1791
431112;201807;533;1680;458;1522;91;314;224;727;315;1041
431113;201807;397;1131;325;990;92;291;142;443;234;734
431115;201807;1194;3412;939;2941;151;520;509;1536;660;2056
431120;201807;2508;7254;1762;5700;602;2191;388;1138;990;3329
431123;201807;404;1166;256;850;56;171;122;427;178;598
431125;201807;1173;3527;844;2793;320;1043;232;825;552;1868
431127;201807;282;773;67;219;8;24;11;24;19;48
431130;201807;3404;9369;2304;7198;501;1693;854;2608;1355;4301
431140;201807;5114;12469;2803;8057;408;1326;1052;2616;1460;3942
431142;201807;491;1375;370;1157;55;169;224;704;279;873
431150;201807;1002;2836;709;2240;159;523;287;881;446;1404
431160;201807;666;1915;498;1567;105;334;188;598;293;932
431162;201807;533;1283;226;709;31;116;59;172;90;288
431164;201807;228;553;49;160;13;49;3;12;16;61
431170;201807;587;1577;372;1151;101;320;100;306;201;626
431171;201807;691;1794;572;1612;82;236;341;945;423;1181
431173;201807;427;1196;321;1006;116;393;84;257;200;650
431175;201807;1032;2652;645;1946;172;516;126;393;298;909
431177;201807;763;2289;569;1934;168;613;231;774;399;1387
431179;201807;364;767;75;222;14;44;17;36;31;80
431180;201807;2242;5919;1385;4237;382;1202;253;766;635;1968
431190;201807;519;1410;270;857;37;114;55;148;92;262
431198;201807;306;970;268;896;97;336;83;300;180;636
431200;201807;395;1054;105;340;16;41;1;3;17;44
431205;201807;213;620;89;327;24;93;34;127;58;220
431210;201807;651;1714;523;1520;133;370;258;790;391;1160
431213;201807;239;708;179;602;17;69;95;317;112;386
431215;201807;380;1064;225;714;27;97;92;268;119;365
431217;201807;146;430;98;329;12;44;51;159;63;203
431220;201807;687;1860;391;1246;39;148;179;519;218;667
431225;201807;1449;3733;1113;3133;147;449;644;1810;791;2259
431230;201807;725;2160;541;1684;83;284;296;880;379;1164
431235;201807;145;387;27;83;7;19;2;6;9;25
431237;201807;396;1194;320;1058;58;217;159;508;217;725
431238;201807;29;78;23;62;5;13;7;16;12;29
431240;201807;3950;10554;3120;9185;715;2337;1313;3695;2028;6032
431242;201807;344;992;281;865;58;184;131;403;189;587
431244;201807;345;850;164;476;25;92;54;117;79;209
431245;201807;1329;3284;844;2354;120;365;396;1046;516;1411
431247;201807;224;639;113;376;21;75;25;73;46;148
431250;201807;1449;4258;1164;3799;263;831;531;1843;794;2674
431260;201807;262;753;144;503;22;97;46;147;68;244
431261;201807;263;845;212;739;25;91;86;281;111;372
431262;201807;421;1198;180;610;18;61;103;340;121;401
431265;201807;1474;3540;596;1764;99;324;162;393;261;717
431267;201807;284;792;160;478;6;19;106;294;112;313
431270;201807;2708;6439;1449;4252;398;1268;404;1188;802;2456
431275;201807;171;476;84;278;19;64;12;35;31;99
431280;201807;258;714;75;260;6;21;10;25;16;46
431290;201807;310;886;215;697;29;103;70;195;99;298
431295;201807;75;204;26;85;3;13;7;21;10;34
431300;201807;421;1071;63;223;5;24;12;36;17;60
431301;201807;241;727;58;205;7;17;4;11;11;28
431303;201807;613;1643;343;1052;46;167;121;342;167;509
431306;201807;2192;5375;1287;3790;193;662;451;1196;644;1858
431308;201807;26;89;24;82;13;47;6;19;19;66
431310;201807;619;1773;359;1142;62;210;123;388;185;598
431320;201807;664;1823;311;1051;64;224;44;140;108;364
431330;201807;1924;4743;938;2886;231;788;181;497;412;1285
431333;201807;345;932;124;380;18;44;36;110;54;154
431335;201807;36;105;22;75;6;16;3;4;9;20
431337;201807;2677;7438;1831;5887;516;1814;493;1499;1009;3313
431339;201807;489;1290;333;984;73;220;162;482;235;702
431340;201807;20947;53737;14697;42808;3078;9724;4888;13482;7966;23206
431342;201807;491;1160;363;964;39;128;280;710;319;838
431344;201807;379;1009;243;738;16;49;157;469;173;518
431346;201807;274;695;101;315;15;42;20;63;35;105
431349;201807;693;1914;379;1164;68;216;137;391;205;607
431350;201807;4060;11150;3032;9292;615;2037;1245;3759;1860;5796
431360;201807;615;1516;357;1050;72;216;141;396;213;612
431365;201807;1786;4741;1480;4260;161;520;1033;2959;1194;3479
431370;201807;4345;11503;3234;9549;832;2596;1306;3997;2138;6593
431380;201807;733;2150;629;1972;59;207;390;1219;449;1426
431390;201807;2468;6394;1414;4329;254;885;490;1332;744;2217
431395;201807;1282;3570;938;3002;237;758;361;1207;598;1965
431400;201807;397;1195;197;654;32;106;45;142;77;248
431402;201807;995;2343;653;1756;110;324;371;955;481;1279
431403;201807;171;475;141;424;17;72;92;252;109;324
431405;201807;4351;11815;3518;10527;453;1587;2080;6049;2533;7636
431406;201807;477;1475;384;1295;89;290;198;678;287;968
431407;201807;481;1349;315;995;66;215;127;387;193;602
431410;201807;15195;41267;9766;30620;1936;6798;3377;10011;5313;16809
431413;201807;187;490;53;176;4;13;7;22;11;35
431415;201807;715;1841;436;1370;72;274;161;446;233;720
431417;201807;600;1411;411;1115;73;214;216;565;289;779
431420;201807;1290;3347;1063;2980;220;633;440;1305;660;1938
431430;201807;530;1405;284;888;62;218;59;149;121;367
431440;201807;23871;61212;17845;51165;4253;12952;5638;16147;9891;29099
431442;201807;109;318;61;207;8;30;7;16;15;46
431445;201807;473;1347;153;517;25;77;23;71;48;148
431446;201807;360;1046;238;775;74;245;65;201;139;446
431447;201807;609;1700;412;1283;93;293;169;529;262;822
431449;201807;723;1974;455;1361;72;230;203;601;275;831
431450;201807;2113;4661;1753;4181;145;379;1298;2977;1443;3356
431454;201807;43;134;41;130;7;25;16;61;23;86
431455;201807;636;1582;311;880;45;145;144;360;189;505
431460;201807;2978;7866;2269;6492;609;1809;706;2077;1315;3886
431470;201807;1565;4478;1143;3578;240;769;451;1410;691;2179
431475;201807;247;719;31;121;2;9;2;9;4;18
431477;201807;528;1363;306;894;45;125;144;389;189;514
431478;201807;283;737;72;217;19;60;6;16;25;76
431480;201807;3239;8355;2482;7151;393;1214;1378;3922;1771;5136
431490;201807;101013;256889;83231;229491;8382;26789;58899;157616;67281;184405
431500;201807;492;1317;367;1065;82;216;182;527;264;743
431505;201807;434;1054;270;777;25;69;150;427;175;496
431507;201807;353;844;147;422;36;118;54;133;90;251
431510;201807;1614;4383;1150;3449;246;787;437;1308;683;2095
431513;201807;301;724;149;424;18;49;94;266;112;315
431514;201807;91;259;50;174;11;44;18;56;29;100
431515;201807;570;1507;375;1117;77;250;177;496;254;746
431517;201807;78;233;57;176;9;23;14;43;23;66
431520;201807;442;1091;166;542;33;121;52;148;85;269
431530;201807;4068;9172;2485;6846;709;1998;377;1065;1086;3063
431531;201807;200;560;136;427;17;54;57;171;74;225
431532;201807;481;1268;340;987;79;240;133;389;212;629
431535;201807;287;729;105;331;19;63;25;71;44;134
431540;201807;1841;6074;1702;5837;91;369;1309;4495;1400;4864
431545;201807;388;1040;75;235;5;19;21;58;26;77
431550;201807;1995;5521;1623;4786;325;1019;689;1953;1014;2972
431555;201807;683;1617;431;1176;39;111;255;681;294;792
431560;201807;20409;54839;13831;43471;3014;10177;3699;12439;6713;22616
431570;201807;5072;12471;3954;10924;660;1993;2317;6242;2977;8235
431575;201807;176;539;136;447;21;75;25;63;46;138
431580;201807;559;1493;294;941;43;160;116;346;159;506
431590;201807;779;2113;551;1636;100;294;202;603;302;897
431595;201807;361;1033;239;756;43;136;108;326;151;462
431600;201807;1566;4041;1136;3343;299;964;336;990;635;1954
431610;201807;1358;3723;955;2906;131;370;460;1461;591;1831
431620;201807;539;1489;234;719;47;150;103;287;150;437
431630;201807;1249;3320;600;1906;167;544;156;444;323;988
431640;201807;6071;16122;5428;15183;781;2273;3656;10282;4437;12555
431642;201807;504;1305;322;934;34;101;155;426;189;527
431643;201807;357;919;160;465;22;61;45;117;67;178
431645;201807;1715;4439;1369;3864;149;461;927;2608;1076;3069
431647;201807;184;492;105;319;14;54;23;58;37;112
431650;201807;222;659;157;518;27;98;47;144;74;242
431660;201807;916;2498;507;1664;92;336;110;304;202;640
431670;201807;1188;2968;828;2334;141;443;394;1045;535;1488
431673;201807;245;661;90;334;19;60;10;32;29;92
431675;201807;701;1778;140;457;10;40;40;113;50;153
431680;201807;7809;21207;5809;17284;1542;4755;2048;6100;3590;10855
431690;201807;19879;53172;14374;42867;3710;11536;4593;14114;8303;25650
431695;201807;156;412;99;306;21;73;40;92;61;165
431697;201807;468;1179;370;1012;61;164;212;595;273;759
431700;201807;1459;3913;1230;3499;192;542;692;1956;884;2498
431710;201807;11555;30845;8946;26850;2330;7306;3396;10875;5726;18181
431720;201807;6262;16691;4100;12276;1044;3309;713;1967;1757;5276
431725;201807;28;81;18;61;3;12;6;19;9;31
431730;201807;3625;9611;2548;7787;671;2226;750;2404;1421;4630
431740;201807;4870;12569;3418;9992;1044;3416;639;1603;1683;5019
431750;201807;7350;20314;6252;18576;1136;3656;3259;9840;4395;13496
431755;201807;346;944;70;250;11;44;12;46;23;90
431760;201807;5582;13254;3604;9979;425;1408;2077;5373;2502;6781
431770;201807;1825;4590;1460;4061;172;535;998;2705;1170;3240
431775;201807;211;569;101;319;22;78;14;36;36;114
431780;201807;1935;5203;1344;4032;262;817;449;1303;711;2120
431790;201807;972;2749;709;2193;137;445;275;811;412;1256
431795;201807;273;715;139;418;28;84;39;113;67;197
431800;201807;7485;20438;5427;16753;1731;5855;673;2165;2404;8020
431805;201807;298;698;92;292;8;30;36;101;44;131
431810;201807;3273;8137;2074;5858;376;1183;867;2302;1243;3485
431820;201807;2241;6522;1861;5832;459;1488;734;2319;1193;3807
431830;201807;9501;22140;7180;18712;1705;4892;2749;7179;4454;12071
431840;201807;2478;7018;2045;6252;404;1284;1107;3382;1511;4666
431842;201807;715;1794;250;773;36;122;70;194;106;316
431843;201807;327;917;257;770;39;128;112;316;151;444
431844;201807;258;688;72;236;17;65;17;43;34;108
431845;201807;501;1357;347;1031;20;62;215;631;235;693
431846;201807;253;737;221;689;14;55;182;555;196;610
431848;201807;196;508;98;305;8;29;15;30;23;59
431849;201807;434;1044;65;198;6;16;8;20;14;36
431850;201807;4113;11698;3276;9931;770;2512;1004;2952;1774;5464
431860;201807;723;1865;446;1301;88;264;213;588;301;852
431861;201807;125;343;57;193;10;36;17;49;27;85
431862;201807;449;1464;367;1307;90;346;163;564;253;910
431870;201807;17774;49092;14303;42934;2511;8492;6902;19945;9413;28437
431880;201807;3684;10339;2900;8863;575;1968;1215;3562;1790;5530
431890;201807;4527;12013;2882;8733;894;2931;417;1333;1311;4264
431900;201807;1077;2873;650;2001;137;476;296;849;433;1325
431910;201807;801;1978;301;891;49;150;84;219;133;369
431912;201807;435;1273;360;1126;82;266;191;591;273;857
431915;201807;976;2686;780;2343;87;281;507;1490;594;1771
431920;201807;1198;3123;1013;2824;52;165;841;2317;893;2482
431930;201807;825;2417;593;1995;133;383;303;1098;436;1481
431935;201807;77;228;50;169;15;50;9;27;24;77
431936;201807;300;911;177;611;42;149;44;152;86;301
431937;201807;189;499;118;348;27;91;33;77;60;168
431940;201807;2307;6040;1446;4315;281;931;567;1591;848;2522
431950;201807;1732;4878;1446;4394;342;1068;662;2007;1004;3075
431960;201807;2766;7352;2186;6248;610;1821;603;1686;1213;3507
431970;201807;389;1044;172;563;38;115;34;97;72;212
431971;201807;77;205;44;143;5;15;8;22;13;37
431973;201807;474;1539;388;1364;38;127;273;981;311;1108
431975;201807;111;244;24;79;3;11;4;8;7;19
431980;201807;1154;3173;879;2669;192;630;366;1063;558;1693
431990;201807;5834;14990;3810;11788;705;2408;1279;3875;1984;6283
432000;201807;10418;27012;7837;22769;2130;6374;3173;9251;5303;15625
432010;201807;1986;5373;1535;4540;232;733;811;2308;1043;3041
432020;201807;1945;4798;1338;3782;328;985;593;1585;921;2570
432023;201807;519;1323;276;821;47;160;131;349;178;509
432026;201807;1009;2981;746;2432;170;546;356;1151;526;1697
432030;201807;353;950;213;653;36;113;112;331;148;444
432032;201807;438;1171;291;867;31;106;148;403;179;509
432035;201807;785;2309;687;2145;212;711;239;745;451;1456
432040;201807;1087;2566;426;1313;74;257;120;350;194;607
432045;201807;239;661;123;420;30;105;30;110;60;215
432050;201807;530;1426;412;1202;116;337;129;382;245;719
432055;201807;783;2094;497;1538;141;473;165;483;306;956
432057;201807;292;747;213;587;47;110;87;227;134;337
432060;201807;475;1185;145;482;28;109;51;141;79;250
432065;201807;221;624;163;493;35;107;59;179;94;286
432067;201807;789;2334;629;1975;86;282;388;1190;474;1472
432070;201807;2034;5463;1244;3823;285;938;258;721;543;1659
432080;201807;3738;9882;3017;8660;761;2447;1182;3260;1943;5707
432085;201807;397;1019;256;795;88;260;89;296;177;556
432090;201807;1348;3682;977;2962;233;758;401;1155;634;1913
432100;201807;1114;3065;485;1612;89;319;39;98;128;417
432110;201807;2296;6519;1562;5078;382;1434;106;337;488;1771
432120;201807;3094;9002;2518;7964;777;2634;570;1759;1347;4393
432130;201807;2569;6970;2177;6420;782;2435;781;2347;1563;4782
432132;201807;264;734;127;428;29;103;41;130;70;233
432135;201807;905;2371;612;1788;68;222;408;1160;476;1382
432140;201807;1605;5023;1206;4215;231;844;596;2142;827;2986
432143;201807;1354;3778;1074;3323;122;429;640;1973;762;2402
432145;201807;1388;3976;821;2670;145;515;160;447;305;962
432146;201807;110;337;77;265;23;82;16;51;39;133
432147;201807;398;1266;302;1066;88;320;62;219;150;539
432149;201807;378;1014;225;664;25;76;98;274;123;350
432150;201807;3039;8396;2241;6856;568;1982;641;1892;1209;3874
432160;201807;4619;13442;3699;11890;1105;3771;1101;3526;2206;7297
432162;201807;339;798;45;133;5;12;6;18;11;30
432163;201807;207;560;40;127;2;6;2;5;4;11
432166;201807;553;1654;431;1386;76;263;138;400;214;663
432170;201807;1341;3827;870;2873;199;722;225;701;424;1423
432180;201807;2516;6572;1367;4198;283;941;376;1038;659;1979
432183;201807;385;1166;250;838;71;264;56;178;127;442
432185;201807;853;2275;510;1586;37;133;291;858;328;991
432190;201807;2182;5779;1397;4208;336;1140;474;1293;810;2433
432195;201807;1042;2694;665;2013;196;554;218;690;414;1244
432200;201807;3065;8538;2223;7021;474;1549;983;3185;1457;4734
432210;201807;385;1068;262;834;48;170;106;315;154;485
432215;201807;689;2082;603;1939;73;217;400;1318;473;1535
432218;201807;254;649;133;373;18;52;54;139;72;191
432220;201807;3965;9874;2954;8193;429;1364;1687;4434;2116;5798
432225;201807;106;306;75;243;18;57;28;90;46;147
432230;201807;768;1990;430;1285;76;249;157;420;233;669
432232;201807;465;1210;341;991;72;228;140;406;212;634
432234;201807;314;840;140;430;33;94;25;68;58;162
432235;201807;104;299;37;126;4;13;10;34;14;47
432237;201807;384;1011;337;928;17;52;232;604;249;656
432240;201807;13797;38604;10818;34215;1031;3692;6496;21464;7527;25156
432250;201807;4292;14039;3719;12879;1159;4175;1273;4542;2432;8717
432252;201807;447;1167;285;833;52;168;115;310;167;478
432253;201807;1169;3642;637;2215;164;637;37;113;201;750
432254;201807;966;2439;195;639;33;124;20;55;53;179
432255;201807;164;423;78;250;8;28;30;84;38;112
432260;201807;5631;14547;4058;11714;1089;3289;1187;3459;2276;6748
432270;201807;2084;6184;1708;5416;558;1871;269;837;827;2708
432280;201807;1200;3147;629;1961;102;345;217;627;319;972
432285;201807;190;596;18;64;0;0;2;5;2;5
432290;201807;395;1187;222;760;63;215;47;139;110;354
432300;201807;25561;69110;20083;60138;3189;10534;11543;33666;14732;44200
432310;201807;713;2048;531;1710;87;299;308;972;395;1271
432320;201807;231;564;76;228;11;42;20;53;31;95
432330;201807;258;658;89;291;20;62;18;56;38;118
432335;201807;182;528;67;257;15;60;11;45;26;105
432340;201807;328;790;150;453;28;98;48;130;76;228
432345;201807;581;1458;530;1391;38;135;405;1024;443;1159
432350;201807;339;918;169;561;29;96;50;153;79;249
432360;201807;213;636;41;137;5;24;6;18;11;42
432370;201807;340;907;227;682;21;69;135;395;156;464
432375;201807;542;1400;414;1169;61;166;234;655;295;821
432377;201807;240;773;38;133;5;16;9;24;14;40
432380;201807;1470;4269;919;3094;195;742;405;1291;600;2033
500020;201807;2351;6384;1658;5165;373;1275;702;2135;1075;3410
500025;201807;1317;3055;808;2174;73;200;474;1251;547;1451
500060;201807;6409;18753;4859;15957;731;2444;2801;9683;3532;12127
500070;201807;4157;11319;3026;9325;651;2070;1275;4116;1926;6186
500080;201807;1204;3389;884;2806;202;720;360;1079;562;1799
500085;201807;2078;5186;1410;4156;271;869;728;2072;999;2941
500090;201807;1993;5530;1365;4384;263;888;524;1730;787;2618
500100;201807;3410;9065;2609;7711;391;1283;1260;3551;1651;4834
500110;201807;7353;20472;5032;16644;1077;3812;1681;6257;2758;10069
500124;201807;1982;6239;1688;5734;373;1233;895;3258;1268;4491
500150;201807;1287;3060;799;2279;177;536;263;683;440;1219
500190;201807;4744;11700;3468;9981;744;2260;1510;4513;2254;6773
500200;201807;2244;5534;1666;4522;225;670;951;2425;1176;3095
500210;201807;4597;12661;3526;11048;898;2884;1530;4876;2428;7760
500215;201807;1338;3942;967;3211;107;387;471;1522;578;1909
500220;201807;2783;8025;2050;6713;353;1261;799;2600;1152;3861
500230;201807;2374;5855;1717;4842;233;672;990;2753;1223;3425
500240;201807;3575;11324;2516;9011;483;1969;644;2405;1127;4374
500260;201807;3148;7020;1906;5212;243;665;951;2553;1194;3218
500270;201807;128379;317437;75590;222387;15705;49910;22017;62058;37722;111968
500280;201807;1317;3397;953;2834;114;381;593;1722;707;2103
500290;201807;4022;9232;2187;6415;369;1197;740;2043;1109;3240
500295;201807;2925;7689;1680;5171;292;992;571;1534;863;2526
500310;201807;908;2120;656;1783;118;285;347;988;465;1273
500315;201807;3359;10027;2718;8961;358;1173;1723;5942;2081;7115
500320;201807;18105;53857;13114;44835;3553;13030;3946;14270;7499;27300
500325;201807;4153;9931;2790;7873;370;1140;1520;4262;1890;5402
500330;201807;6954;16724;4458;12628;420;1327;2321;6688;2741;8015
500345;201807;1934;4858;1319;3929;352;1083;455;1333;807;2416
500348;201807;2707;7008;2094;6011;265;793;1243;3613;1508;4406
500350;201807;1262;3574;656;2166;78;278;236;790;314;1068
500370;201807;21827;60871;15191;49159;2715;9960;6364;20554;9079;30514
500375;201807;2510;6951;1763;5349;363;1217;567;1654;930;2871
500380;201807;3575;9090;2509;7358;668;2048;888;2669;1556;4717
500390;201807;532;1161;316;854;43;129;162;426;205;555
500400;201807;1172;3329;812;2534;193;658;232;687;425;1345
500410;201807;2305;6216;1755;5342;276;843;992;3102;1268;3945
500430;201807;2633;6915;1779;5574;307;1079;651;2159;958;3238
500440;201807;1270;3087;757;2221;115;342;279;861;394;1203
500450;201807;1334;3503;739;2351;157;509;120;344;277;853
500460;201807;3826;10764;2424;7956;498;1826;560;1893;1058;3719
500470;201807;2541;7142;1609;5137;487;1692;303;843;790;2535
500480;201807;2179;6465;1915;6109;137;417;1444;4892;1581;5309
500490;201807;919;2317;554;1735;146;527;168;525;314;1052
500500;201807;4102;11378;2836;9437;935;3537;684;2359;1619;5896
500510;201807;750;1907;459;1366;30;100;265;751;295;851
500515;201807;1955;4904;1591;4392;134;352;1140;3247;1274;3599
500520;201807;3163;10680;2596;9531;690;2716;1086;3981;1776;6697
500525;201807;987;3031;798;2721;107;420;435;1496;542;1916
500540;201807;4889;12905;2818;9136;768;2941;274;835;1042;3776
500560;201807;5221;15562;4364;14321;336;1198;3240;10794;3576;11992
500568;201807;4291;9834;2638;7363;662;2100;749;2058;1411;4158
500570;201807;7295;18105;4181;12457;995;3191;901;2527;1896;5718
500580;201807;3222;8939;2491;7678;470;1543;1335;4058;1805;5601
500600;201807;3413;8714;2220;6733;444;1452;792;2395;1236;3847
500620;201807;7635;21057;5209;16266;1043;3421;2001;6218;3044;9639
500625;201807;495;1405;268;880;60;217;97;309;157;526
500627;201807;750;1983;463;1440;82;252;118;374;200;626
500630;201807;6055;15354;3768;11380;862;2777;1077;3306;1939;6083
500635;201807;2619;9160;2117;8389;166;698;1502;6347;1668;7045
500640;201807;1745;4039;1138;3141;53;179;783;2081;836;2260
500660;201807;17600;49598;12638;41485;4284;15593;2838;9502;7122;25095
500690;201807;2327;6671;1646;5540;741;2781;121;363;862;3144
500710;201807;3057;8763;2346;7422;656;2186;630;1952;1286;4138
500720;201807;5482;14034;3286;10358;856;2965;683;2126;1539;5091
500730;201807;929;2508;596;1861;105;310;223;713;328;1023
500740;201807;4683;11752;3394;9495;345;1118;1837;5196;2182;6314
500750;201807;996;2626;727;2143;110;354;303;824;413;1178
500755;201807;990;2788;609;2031;119;419;84;244;203;663
500769;201807;5295;13599;2692;8240;536;1827;402;932;938;2759
500770;201807;1610;4456;1005;3293;188;654;309;1017;497;1671
500780;201807;1318;3434;872;2608;194;603;219;626;413;1229
500790;201807;8467;22468;6799;19795;1290;4038;3633;10666;4923;14704
500793;201807;1970;5350;1381;4310;447;1437;261;711;708;2148
500795;201807;2437;6651;2005;6070;165;453;1589;5042;1754;5495
500797;201807;745;2032;508;1571;114;364;175;523;289;887
500800;201807;2907;7178;1962;5747;677;2240;337;1064;1014;3304
500830;201807;18572;47841;12694;36936;1985;6267;5776;16059;7761;22326
500840;201807;1133;3055;733;2262;103;340;295;849;398;1189
510010;201807;1665;4193;1160;3466;199;580;645;1970;844;2550
510020;201807;3769;9909;1992;6213;444;1441;375;1049;819;2490
510025;201807;7101;19372;4504;14396;841;2983;1347;4055;2188;7038
510030;201807;2107;4927;1425;3955;352;978;510;1496;862;2474
510035;201807;1166;3072;710;2334;116;377;400;1409;516;1786
510040;201807;2190;5193;1578;4324;140;402;972;2658;1112;3060
510050;201807;1914;4798;1293;3791;259;852;684;1856;943;2708
510060;201807;1450;3825;1059;3175;161;516;508;1489;669;2005
510080;201807;1172;3374;817;2711;235;837;208;615;443;1452
510100;201807;692;1708;456;1275;64;192;218;578;282;770
510120;201807;286;556;169;415;9;28;119;289;128;317
510125;201807;2439;6136;1828;5179;283;1034;754;1931;1037;2965
510130;201807;1495;4001;1116;3359;274;872;310;934;584;1806
510140;201807;2943;8392;2122;7287;788;3048;664;2132;1452;5180
510160;201807;1360;4126;1136;3812;207;720;745;2521;952;3241
510170;201807;4756;13383;3553;11348;809;2738;1501;4758;2310;7496
510180;201807;13080;32076;8132;23970;2063;6470;2376;7835;4439;14305
510185;201807;1761;4685;1185;3848;409;1321;430;1682;839;3003
510190;201807;2354;6465;1552;5181;475;1742;444;1553;919;3295
510250;201807;14280;39457;11878;36076;2559;8207;6347;19967;8906;28174
510260;201807;2137;8719;1723;7917;271;1264;991;5109;1262;6373
510263;201807;3287;9311;2098;6949;462;1656;281;873;743;2529
510267;201807;5048;14825;3194;10653;702;2453;578;1943;1280;4396
510268;201807;1442;3736;977;2882;147;453;506;1435;653;1888
510269;201807;1107;3200;703;2381;194;704;223;725;417;1429
510270;201807;2861;8863;2146;7500;460;1704;773;2670;1233;4374
510279;201807;1807;5137;1316;4190;259;899;632;1926;891;2825
510285;201807;1129;3145;809;2588;239;829;202;614;441;1443
510300;201807;3597;9502;2760;8358;325;939;1771;5616;2096;6555
510305;201807;1394;4173;964;3321;212;766;283;1055;495;1821
510310;201807;925;2450;660;1995;213;672;194;611;407;1283
510320;201807;3820;10219;2830;8467;677;2220;773;2278;1450;4498
510325;201807;4742;14335;3761;12771;1012;3554;1676;5946;2688;9500
510330;201807;2977;9203;2092;7577;456;1712;711;2869;1167;4581
510335;201807;4895;14219;3666;12491;460;1703;2095;7518;2555;9221
510336;201807;533;1559;385;1298;72;234;175;635;247;869
510337;201807;1751;5380;1227;4410;499;1929;206;758;705;2687
510340;201807;82384;198017;51570;150064;15522;52068;11175;30776;26697;82844
510343;201807;1033;2984;715;2333;140;490;239;743;379;1233
510345;201807;1368;4050;1020;3353;185;603;410;1319;595;1922
510350;201807;2907;7817;1912;6176;460;1552;734;2407;1194;3959
510360;201807;1806;4080;1172;3272;61;220;862;2433;923;2653
510370;201807;1668;5121;1240;4346;223;859;647;2330;870;3189
510380;201807;508;1389;274;922;79;290;34;111;113;401
510385;201807;1053;3820;769;3192;94;425;440;1952;534;2377
510390;201807;1082;3346;857;3007;233;794;393;1528;626;2322
510395;201807;754;1747;505;1372;46;128;264;777;310;905
510410;201807;4232;12710;3261;10878;793;2712;1556;5424;2349;8136
510420;201807;2177;5078;1552;4175;169;538;875;2327;1044;2865
510450;201807;578;1485;344;1046;80;255;60;188;140;443
510452;201807;674;2015;460;1569;92;314;217;750;309;1064
510454;201807;830;2442;625;2072;67;219;368;1280;435;1499
510455;201807;922;2732;662;2153;106;404;249;729;355;1133
510460;201807;2077;5319;1480;4420;151;524;847;2404;998;2928
510480;201807;4534;11504;3009;8534;552;1672;1218;3258;1770;4930
510490;201807;1644;4796;1267;4252;275;935;624;2141;899;3076
510500;201807;1430;3994;908;3006;165;620;351;1136;516;1756
510510;201807;3206;10175;2493;8741;817;3104;582;2194;1399;5298
510515;201807;5840;16164;3767;12039;878;3063;939;2742;1817;5805
510517;201807;1305;3814;1015;3283;292;1053;177;503;469;1556
510520;201807;2119;4475;1304;3462;76;216;726;2039;802;2255
510523;201807;980;2663;763;2288;117;343;457;1390;574;1733
510525;201807;5655;16531;4335;13811;783;2734;1779;5155;2562;7889
510530;201807;542;1396;398;1188;25;112;275;783;300;895
510550;201807;2818;8691;2048;7221;518;1894;734;2640;1252;4534
510558;201807;1986;5543;1591;4976;154;528;863;2886;1017;3414
510560;201807;1644;4873;966;3552;221;878;238;946;459;1824
510562;201807;5428;14958;3922;12095;906;3009;1351;4264;2257;7273
510590;201807;3172;8093;2312;6946;399;1136;1382;4354;1781;5490
510600;201807;1567;3799;961;2810;222;634;344;1041;566;1675
510610;201807;2728;7045;1953;5954;196;704;1200;3595;1396;4299
510615;201807;2018;5743;1524;4871;300;974;824;2708;1124;3682
510617;201807;913;2672;702;2332;103;334;459;1619;562;1953
510618;201807;1345;3747;955;3000;193;702;458;1369;651;2071
510619;201807;753;2000;416;1373;70;247;77;254;147;501
510620;201807;1496;3481;712;2212;175;637;83;214;258;851
510621;201807;1255;3623;850;2827;184;655;247;806;431;1461
510622;201807;4044;12017;2873;9306;1000;3549;480;1396;1480;4945
510623;201807;2952;7835;2139;6463;477;1715;614;1775;1091;3490
510624;201807;1613;4382;712;2478;107;412;112;329;219;741
510625;201807;2289;5873;1365;4188;325;1128;264;805;589;1933
510626;201807;1676;4080;998;3039;305;1035;205;658;510;1693
510627;201807;663;1750;394;1206;99;321;91;290;190;611
510628;201807;1647;3768;1059;2970;181;498;636;1858;817;2356
510629;201807;1629;5010;1249;4214;308;1092;399;1392;707;2484
510630;201807;3184;9475;1926;6950;461;1796;309;1201;770;2997
510631;201807;483;1256;348;1045;20;58;240;728;260;786
510637;201807;3260;8449;2420;7064;710;2274;677;1938;1387;4212
510642;201807;5067;15512;4057;13954;1143;4233;1577;5646;2720;9879
510645;201807;935;2050;539;1515;150;418;160;454;310;872
510650;201807;6668;19255;5616;18055;791;2471;4053;13685;4844;16156
510665;201807;1893;4546;1103;3165;199;623;400;1175;599;1798
510670;201807;399;851;221;601;25;84;116;318;141;402
510675;201807;6186;18011;4504;14814;1304;4683;802;2585;2106;7268
510677;201807;2129;5616;1507;4671;236;785;786;2413;1022;3198
510680;201807;664;1884;440;1445;107;357;57;183;164;540
510682;201807;1750;5556;1300;4704;406;1569;270;1004;676;2573
510685;201807;764;2195;579;1833;79;261;276;839;355;1100
510700;201807;3660;9616;2554;7940;475;1555;1411;4486;1886;6041
510704;201807;10232;25847;6792;19612;1379;4282;2136;5926;3515;10208
510706;201807;1910;5730;1313;4770;255;1022;658;2524;913;3546
510710;201807;2668;7192;1831;5525;383;1191;635;1822;1018;3013
510715;201807;733;1746;498;1366;62;171;206;568;268;739
510718;201807;2622;5763;1426;4322;600;1874;244;998;844;2872
510719;201807;401;889;242;672;39;114;131;355;170;469
510720;201807;1015;2564;674;2005;175;543;192;562;367;1105
510724;201807;724;2045;502;1641;94;339;226;699;320;1038
510726;201807;980;1929;558;1361;70;174;322;787;392;961
510729;201807;671;1631;316;958;51;174;73;218;124;392
510730;201807;3091;8006;2110;6347;477;1529;763;2294;1240;3823
510735;201807;1028;3086;776;2728;92;350;524;1870;616;2220
510740;201807;1283;3459;901;2783;100;279;547;1832;647;2111
510757;201807;634;2042;509;1812;198;753;163;552;361;1305
510760;201807;37161;86061;22101;62823;6135;19687;4991;13013;11126;32700
510770;201807;4180;9917;3091;8608;315;844;2056;6002;2371;6846
510774;201807;373;1036;276;842;51;138;135;444;186;582
510775;201807;620;1894;446;1591;97;372;109;452;206;824
510776;201807;516;1428;359;1089;91;282;115;349;206;631
510777;201807;1703;4663;1217;3993;139;532;850;2763;989;3295
510779;201807;599;1719;472;1507;66;173;282;954;348;1127
510780;201807;3571;10006;2760;8717;711;2299;1091;3799;1802;6098
510785;201807;2086;5563;1217;3942;297;1046;180;624;477;1670
510787;201807;2503;7151;1764;5712;725;2432;155;489;880;2921
510788;201807;705;1707;484;1367;90;248;181;609;271;857
510790;201807;15021;41498;9399;30362;2187;8062;1334;3780;3521;11842
510792;201807;9012;24678;5725;18466;1177;4125;1272;3978;2449;8103
510794;201807;1253;3598;831;2800;256;944;179;546;435;1490
510795;201807;7405;21100;5245;17079;1419;5056;1193;3927;2612;8983
510800;201807;1609;4284;1140;3542;269;872;392;1174;661;2046
510805;201807;1829;5028;1212;3872;266;930;442;1256;708;2186
510810;201807;678;1511;453;1199;114;327;214;546;328;873
510820;201807;850;1696;462;1192;54;170;201;499;255;669
510830;201807;762;2008;549;1698;97;304;308;992;405;1296
510835;201807;591;1575;403;1267;58;196;189;579;247;775
510840;201807;44484;104830;32870;89872;6659;17810;16782;49001;23441;66811
510850;201807;1833;4632;1055;3324;324;1129;136;367;460;1496
510860;201807;2710;7672;1766;5974;587;2247;187;621;774;2868
510880;201807;646;1942;502;1674;129;457;218;741;347;1198
510885;201807;603;1587;422;1315;68;232;142;429;210;661
510890;201807;715;2152;572;1938;122;450;276;954;398;1404
510895;201807;1216;3318;840;2641;215;752;292;833;507;1585
520005;201807;2031;5706;1646;5212;455;1337;757;2741;1212;4078
520010;201807;2246;6855;1596;5478;465;1788;335;1013;800;2801
520013;201807;2735;7517;1960;5968;470;1511;517;1663;987;3174
520015;201807;544;1435;410;1246;117;371;117;390;234;761
520017;201807;1134;3136;876;2719;172;583;454;1389;626;1972
520020;201807;384;966;304;854;66;214;166;442;232;656
520025;201807;32637;93734;28739;88508;3463;11546;20237;62091;23700;73637
520030;201807;5164;14416;4118;12747;543;1838;2429;7498;2972;9336
520050;201807;457;1105;277;766;22;50;154;451;176;501
520055;201807;1095;3021;823;2482;67;203;480;1427;547;1630
520060;201807;1460;4287;1134;3669;285;1030;304;963;589;1993
520080;201807;1894;5072;1463;4476;256;760;692;2324;948;3084
520082;201807;1049;2628;874;2331;110;239;496;1393;606;1632
520085;201807;717;2086;575;1840;131;410;173;531;304;941
520090;201807;868;1867;612;1562;101;232;392;1057;493;1289
520110;201807;39768;111150;28507;92673;9904;36522;1959;5818;11863;42340
520120;201807;202;517;113;355;12;46;41;127;53;173
520130;201807;3694;9673;3089;8682;595;1772;1496;4285;2091;6057
520140;201807;36656;107942;28383;92889;10332;36612;3109;10498;13441;47110
520145;201807;492;1257;345;1022;67;211;138;384;205;595
520150;201807;572;1431;441;1263;77;212;236;699;313;911
520160;201807;884;2153;640;1781;106;292;294;822;400;1114
520170;201807;5231;10921;3762;9245;240;625;3024;7411;3264;8036
520180;201807;2038;5830;1678;5252;421;1416;701;2159;1122;3575
520215;201807;2039;5001;1478;4101;324;992;634;1706;958;2698
520235;201807;643;1568;423;1220;49;157;163;451;212;608
520250;201807;1568;4121;1116;3418;303;1026;224;712;527;1738
520260;201807;877;2115;526;1495;99;307;192;539;291;846
520280;201807;649;1736;513;1483;152;443;196;607;348;1050
520310;201807;1279;2936;847;2276;213;593;313;893;526;1486
520320;201807;1917;5439;1508;4735;171;579;793;2521;964;3100
520330;201807;3351;9731;2418;8103;475;1813;962;3160;1437;4973
520340;201807;2258;5276;1535;4246;157;384;1009;2908;1166;3292
520350;201807;3083;7877;2228;6387;675;2071;693;1915;1368;3986
520355;201807;1785;5038;1372;4274;314;1083;540;1633;854;2716
520357;201807;841;2136;656;1842;38;118;466;1310;504;1428
520360;201807;730;1973;558;1671;167;515;149;471;316;986
520380;201807;1343;3473;802;2405;95;322;398;1105;493;1427
520390;201807;960;2211;558;1677;173;553;145;458;318;1011
520393;201807;568;1374;397;1099;49;149;189;490;238;639
520396;201807;815;2312;683;2066;83;247;437;1306;520;1553
520400;201807;1637;4322;1309;3845;232;727;801;2358;1033;3085
520410;201807;1668;3753;1066;2892;136;394;622;1673;758;2067
520420;201807;385;972;286;775;28;90;199;506;227;596
520425;201807;1445;3556;961;2734;252;733;372;1071;624;1804
520430;201807;2226;5404;1166;3605;205;735;58;168;263;903
520440;201807;3448;8562;2156;6248;553;1698;548;1544;1101;3242
520450;201807;11620;29781;7785;23349;2443;7938;645;1994;3088;9932
520455;201807;688;1947;506;1652;156;550;124;397;280;947
520460;201807;935;2492;792;2290;108;286;584;1734;692;2020
520465;201807;843;2258;692;2021;112;359;433;1207;545;1566
520470;201807;1918;5605;1635;5217;361;1119;968;3315;1329;4434
520480;201807;869;2499;567;1941;149;540;116;404;265;944
520485;201807;1584;4457;1297;4059;173;579;857;2647;1030;3226
520490;201807;3965;11485;3054;10056;874;2882;1340;4626;2214;7508
520495;201807;1479;3496;1158;3067;72;189;872;2373;944;2562
520500;201807;1424;3850;1014;3108;239;819;380;1142;619;1961
520505;201807;725;1800;522;1519;100;285;269;775;369;1060
520510;201807;7163;19242;5106;16092;1223;4266;1314;4352;2537;8618
520520;201807;1110;2932;832;2505;235;692;238;785;473;1477
520530;201807;2044;6294;1527;5348;532;1918;397;1605;929;3523
520540;201807;3026;8157;1889;5845;437;1408;386;1214;823;2622
520545;201807;1000;2752;759;2348;134;428;278;862;412;1290
520547;201807;757;2235;592;1910;156;510;249;793;405;1303
520549;201807;11342;32429;9241;29053;2025;6524;4843;15478;6868;22002
520551;201807;4260;12186;3648;11283;508;1819;2440;7372;2948;9191
520552;201807;792;2236;709;2126;105;285;505;1582;610;1867
520570;201807;652;1609;434;1267;115;341;142;425;257;766
520580;201807;2913;6588;2037;5473;206;578;1290;3503;1496;4081
520590;201807;1319;3677;947;2980;239;762;174;575;413;1337
520620;201807;8423;23318;6788;20967;1750;5586;3058;9635;4808;15221
520630;201807;993;2501;610;1846;106;324;163;483;269;807
520640;201807;2629;6753;2027;5719;511;1463;767;2232;1278;3695
520650;201807;919;2279;629;1786;112;322;332;961;444;1283
520660;201807;523;1266;248;761;49;161;46;158;95;319
520670;201807;988;2797;823;2555;81;262;553;1675;634;1937
520680;201807;756;1929;553;1604;107;304;261;780;368;1084
520690;201807;377;896;248;705;72;201;77;238;149;439
520710;201807;567;1401;366;1040;12;37;227;624;239;661
520725;201807;1658;4040;1173;3239;133;415;753;2022;886;2437
520735;201807;829;2146;564;1665;114;341;187;570;301;911
520740;201807;1959;4758;1542;4228;264;692;931;2639;1195;3331
520750;201807;681;1707;498;1434;92;248;228;697;320;945
520753;201807;1489;3927;1198;3387;214;645;546;1486;760;2131
520760;201807;1204;2653;1063;2475;90;181;862;2095;952;2276
520780;201807;1702;4192;1262;3546;142;424;654;1793;796;2217
520790;201807;3503;8315;2438;6690;237;657;1478;4314;1715;4971
520800;201807;15629;41866;12652;37860;2462;7360;7421;23359;9883;30719
520810;201807;1312;2865;944;2445;161;450;544;1467;705;1917
520815;201807;656;2037;479;1666;119;427;91;386;210;813
520830;201807;1804;4172;1329;3618;74;168;1046;2846;1120;3014
520840;201807;2268;6362;1847;5786;786;2562;508;1719;1294;4281
520850;201807;689;1876;474;1534;163;597;96;309;259;906
520860;201807;6386;18216;4919;15812;1164;4054;1709;5543;2873;9597
520870;201807;93219;231084;65411;188463;18157;56824;17666;49768;35823;106592
520880;201807;6313;18295;4980;16090;1534;5285;1336;4283;2870;9568
520890;201807;4002;10270;2850;8381;632;2062;1163;3345;1795;5407
520910;201807;4232;11106;2755;8502;794;2654;511;1607;1305;4261
520915;201807;651;1866;457;1463;74;268;174;537;248;805
520920;201807;4278;10375;2892;8424;433;1364;1437;4218;1870;5582
520929;201807;717;1792;528;1459;84;192;255;777;339;969
520940;201807;1127;3029;877;2675;64;231;656;1994;720;2225
520945;201807;544;1256;418;1046;28;54;292;722;320;776
520960;201807;1059;2834;830;2445;134;426;454;1282;588;1708
520970;201807;2512;7417;2095;6654;595;2064;500;1637;1095;3701
520980;201807;779;2057;614;1801;135;441;239;668;374;1109
520990;201807;2922;8889;2581;8342;376;1225;1556;5194;1932;6419
520993;201807;1019;2489;695;1950;32;99;493;1356;525;1455
520995;201807;2245;5948;1808;5335;417;1214;775;2334;1192;3548
521000;201807;8020;22411;5902;18474;1536;5053;1556;4843;3092;9896
521010;201807;3979;10591;2976;8847;403;1175;1558;4636;1961;5811
521015;201807;672;1761;555;1573;70;210;364;1006;434;1216
521020;201807;2973;8031;1828;5713;533;1785;188;590;721;2375
521030;201807;598;1421;423;1151;55;126;209;615;264;741
521040;201807;7571;18887;5698;15969;1459;4267;2142;6176;3601;10443
521056;201807;869;2418;675;2107;221;707;181;622;402;1329
521060;201807;1092;2793;807;2330;65;201;419;1226;484;1427
521080;201807;1103;2568;579;1680;82;256;181;440;263;696
521090;201807;3274;8579;2343;7051;687;2220;362;1110;1049;3330
521100;201807;1854;4359;1348;3639;260;682;714;1989;974;2671
521120;201807;5016;11789;3485;9856;384;1036;1617;5195;2001;6231
521130;201807;1020;2544;687;1911;47;164;380;1052;427;1216
521140;201807;1229;3290;907;2721;161;512;359;1067;520;1579
521150;201807;12058;27858;7704;21444;1777;5524;2977;8461;4754;13985
521160;201807;714;1590;473;1217;76;216;245;594;321;810
521170;201807;1142;2735;808;2218;73;206;522;1376;595;1582
521180;201807;6606;19757;5522;17735;1169;4034;2240;7020;3409;11054
521190;201807;10490;27781;6106;19771;1557;5469;1113;3732;2670;9201
521200;201807;781;1996;554;1603;70;204;282;810;352;1014
521205;201807;612;1608;463;1367;29;80;330;963;359;1043
521210;201807;775;2068;433;1341;111;379;56;123;167;502
521220;201807;4271;10460;2892;8344;626;1960;935;2586;1561;4546
521225;201807;364;842;286;752;32;73;194;533;226;606
521230;201807;1422;4358;1321;4196;461;1353;701;2423;1162;3776
521250;201807;31867;90450;25719;81449;10227;33629;7445;25363;17672;58992
521260;201807;636;1513;476;1266;81;232;267;702;348;934
521270;201807;1870;4816;1609;4507;112;269;1236;3544;1348;3813
521280;201807;1946;5448;1466;4587;428;1432;472;1513;900;2945
521290;201807;480;1258;356;1080;62;220;193;566;255;786
521295;201807;1207;2693;952;2382;92;202;705;1855;797;2057
521300;201807;1982;5092;1588;4545;300;832;966;2856;1266;3688
521305;201807;742;1941;548;1613;82;235;287;851;369;1086
521308;201807;4733;13210;3475;10723;580;1800;1777;5463;2357;7263
521310;201807;8645;23408;5703;17921;1421;4743;1652;5081;3073;9824
521340;201807;396;965;304;820;25;66;223;596;248;662
521350;201807;2107;5475;1632;4750;198;631;1077;3045;1275;3676
521370;201807;1166;3086;722;2295;191;686;127;409;318;1095
521375;201807;1530;4001;1109;3391;266;846;402;1292;668;2138
521377;201807;1380;3099;1075;2717;62;147;911;2318;973;2465
521380;201807;6239;16999;4208;13238;499;1651;992;3304;1491;4955
521385;201807;629;1561;496;1390;106;297;231;710;337;1007
521390;201807;723;1870;533;1582;166;521;171;537;337;1058
521400;201807;2402;5732;1890;5137;226;671;1377;3776;1603;4447
521405;201807;1354;3552;1023;2989;222;651;448;1328;670;1979
521410;201807;765;2103;620;1890;125;367;319;1047;444;1414
521440;201807;1436;3866;1066;3200;292;940;275;806;567;1746
521450;201807;3951;12205;3011;10255;733;2555;804;2844;1537;5399
521460;201807;6327;17311;4756;14475;1654;5337;1194;3515;2848;8852
521470;201807;662;1870;397;1271;68;204;100;294;168;498
521480;201807;382;1037;218;703;46;165;52;148;98;313
521483;201807;2565;6404;1829;5179;449;1354;601;1638;1050;2992
521486;201807;1717;4147;1315;3594;79;223;983;2659;1062;2882
521487;201807;490;1231;339;1001;66;205;141;423;207;628
521490;201807;851;2362;645;2005;43;174;437;1317;480;1491
521500;201807;1694;4421;1202;3610;117;431;763;2202;880;2633
521520;201807;835;1899;566;1498;101;270;232;636;333;906
521523;201807;11566;38715;10133;36161;3650;13907;2500;9283;6150;23190
521525;201807;1065;2544;818;2186;90;247;551;1455;641;1702
521530;201807;2255;5904;1326;4029;289;922;334;1079;623;2001
521540;201807;870;2258;563;1720;102;381;239;722;341;1103
521550;201807;1433;3675;854;2513;168;529;276;859;444;1388
521560;201807;3917;11336;2860;9890;660;2594;1359;4900;2019;7494
521565;201807;610;1546;495;1383;76;201;315;859;391;1060
521570;201807;4214;11308;2725;8460;575;1978;360;1147;935;3125
521580;201807;543;1343;305;920;45;148;64;166;109;314
521590;201807;618;1621;473;1380;124;407;187;516;311;923
521600;201807;414;1188;254;811;53;151;49;161;102;312
521630;201807;1583;3664;950;2693;202;624;283;772;485;1396
521640;201807;2142;5126;1533;4245;359;1024;561;1549;920;2573
521645;201807;582;1605;381;1223;80;248;112;365;192;613
521680;201807;1183;3722;949;3232;284;1021;116;439;400;1460
521690;201807;483;1319;423;1220;86;267;234;654;320;921
521710;201807;3123;8394;2175;6723;438;1479;447;1329;885;2808
521720;201807;2076;5437;1551;4538;208;662;853;2426;1061;3088
521730;201807;3819;11524;3029;10014;1050;3848;522;1465;1572;5313
521740;201807;4010;10942;3120;9570;931;3122;1027;3297;1958;6419
521760;201807;14321;42874;11849;38853;3587;12804;3835;13060;7422;25864
521770;201807;2890;7588;2056;6102;649;2065;469;1360;1118;3425
521800;201807;6264;17929;5035;15864;1416;4631;1675;5720;3091;10351
521805;201807;685;1549;464;1251;159;403;177;509;336;912
521810;201807;745;1748;500;1381;88;258;232;655;320;913
521830;201807;5309;15497;4376;14105;465;1732;2885;9155;3350;10887
521839;201807;712;1864;507;1485;102;310;184;515;286;825
521850;201807;5760;14922;4044;12076;1030;3340;543;1508;1573;4848
521860;201807;1905;4974;1333;4023;222;731;421;1252;643;1983
521870;201807;673;1971;476;1600;115;412;139;438;254;850
521878;201807;732;1998;513;1574;86;301;202;567;288;868
521880;201807;19564;48646;13185;38738;3518;10797;3973;12145;7491;22942
521890;201807;3240;9068;2202;6958;565;1922;280;819;845;2741
521900;201807;1660;4039;1012;3043;252;729;252;789;504;1518
521910;201807;1222;2791;823;2313;86;267;489;1420;575;1687
521920;201807;407;1212;308;1002;60;213;103;354;163;567
521925;201807;698;1994;522;1673;120;379;165;517;285;896
521930;201807;4528;12150;3370;10363;982;2972;1073;3567;2055;6539
521935;201807;770;2025;579;1670;89;261;310;856;399;1117
521940;201807;1289;3052;883;2492;215;693;360;975;575;1668
521945;201807;592;1733;484;1531;90;291;220;735;310;1026
521950;201807;632;1556;497;1385;32;98;392;1089;424;1187
521960;201807;726;2022;479;1512;76;263;219;656;295;919
521970;201807;2642;6808;2205;6295;130;339;1785;5246;1915;5585
521971;201807;887;2296;604;1828;148;476;134;392;282;868
521973;201807;1112;3108;915;2815;92;346;575;1721;667;2067
521975;201807;12636;33883;10715;31302;1788;5410;6591;19330;8379;24740
521980;201807;2536;6344;2013;5652;213;556;1471;4188;1684;4744
521990;201807;1174;3282;942;2908;127;401;510;1607;637;2008
522000;201807;3746;12236;3108;11410;254;828;2241;8834;2495;9662
522005;201807;338;854;249;724;62;164;101;312;163;476
522010;201807;3847;9929;2864;8328;839;2575;733;2065;1572;4640
522015;201807;972;2651;709;2225;143;470;272;851;415;1321
522020;201807;5433;13394;3701;10556;865;2551;1560;4541;2425;7092
522026;201807;670;1904;518;1653;87;286;232;761;319;1047
522028;201807;518;1401;368;1078;82;240;142;390;224;630
522040;201807;2959;6758;2095;5632;298;848;1382;3709;1680;4557
522045;201807;16789;50282;12810;42425;3245;11523;2786;8954;6031;20477
522050;201807;1138;3113;772;2440;166;549;267;805;433;1354
522060;201807;2581;7216;2062;6414;303;960;1139;3679;1442;4639
522068;201807;1752;4927;1445;4549;176;520;1017;3306;1193;3826
522070;201807;616;1684;513;1524;50;197;357;1011;407;1208
522100;201807;591;1611;433;1368;68;235;230;730;298;965
522108;201807;908;2544;708;2221;42;168;561;1720;603;1888
522119;201807;1608;4268;1249;3772;210;660;644;2006;854;2666
522130;201807;395;999;284;849;60;185;148;456;208;641
522140;201807;16517;45630;12235;37947;3724;12271;2120;6520;5844;18791
522145;201807;857;2165;627;1827;141;365;315;1007;456;1372
522150;201807;964;2374;728;2030;218;582;256;748;474;1330
522155;201807;944;2518;740;2178;152;418;343;1050;495;1468
522157;201807;567;1518;482;1398;26;105;361;1016;387;1121
522160;201807;6301;16841;4189;12928;1173;3928;357;1216;1530;5144
522170;201807;2543;6956;1860;5793;534;1734;664;2076;1198;3810
522180;201807;453;1175;294;891;67;212;39;132;106;344
522185;201807;16447;42849;12552;37702;5025;16055;3289;10865;8314;26920
522190;201807;794;1909;585;1600;100;257;237;686;337;943
522200;201807;1791;5430;1192;4081;243;886;147;485;390;1371
522205;201807;1569;3867;1201;3329;108;318;831;2304;939;2622
522220;201807;1376;3555;1050;3086;163;442;566;1724;729;2166
522230;201807;1247;3320;1034;3005;184;593;587;1703;771;2296
530010;201807;170028;499373;145529;458466;30692;106937;71057;219114;101749;326051
110001;201808;3427;10281;2546;8637;699;2554;1024;3445;1723;5999
110002;201808;10532;28776;7705;23945;2404;7921;2569;8087;4973;16008
110003;201808;625;1875;458;1523;144;524;99;308;243;832
110004;201808;8542;24699;6169;20128;1770;6044;1541;5360;3311;11404
110005;201808;2254;6156;1414;4545;360;1223;442;1514;802;2737
110006;201808;1657;4745;1042;3461;258;928;154;522;412;1450
110007;201808;1036;3035;795;2615;299;990;264;971;563;1961
110008;201808;2441;7827;2151;7387;288;948;1592;5669;1880;6617
110009;201808;3749;10967;2549;8828;777;2750;889;3221;1666;5971
110010;201808;5858;20138;4809;18247;1268;4652;2257;9541;3525;14193
110011;201808;5856;16812;4418;14115;1609;5254;908;3023;2517;8277
110012;201808;12809;34164;8536;26552;2405;7784;1248;4097;3653;11881
110013;201808;4935;15139;3979;13267;1743;5951;665;2474;2408;8425
110014;201808;3530;9705;2532;7889;730;2317;1029;3197;1759;5514
110015;201808;4748;13243;2781;9215;782;2785;441;1418;1223;4203
110018;201808;3173;8501;1995;6444;509;1856;545;1680;1054;3536
110020;201808;66480;169325;46783;141610;10672;33720;19112;61967;29784;95687
110025;201808;4497;11630;3045;9066;628;1985;1514;4387;2142;6372
110026;201808;439;1332;367;1212;119;422;139;439;258;861
110028;201808;5592;15575;3774;12062;1156;3923;578;1832;1734;5755
110029;201808;1280;3200;769;2368;180;566;340;1062;520;1628
110030;201808;11337;28279;7763;23045;1538;5193;2898;8863;4436;14056
110032;201808;2811;8500;2035;6836;706;2383;538;1863;1244;4246
110033;201808;3745;12268;3060;10946;1124;4058;846;3366;1970;7424
110034;201808;3241;8258;2293;6898;702;2235;1004;3096;1706;5331
110037;201808;1513;4964;1239;4406;317;1167;600;2118;917;3285
110040;201808;2786;8285;2102;6994;672;2377;561;1819;1233;4196
110045;201808;4645;14161;3771;12639;1104;4009;1506;5088;2610;9097
110050;201808;1569;4758;1202;4017;504;1742;298;1011;802;2753
110060;201808;737;2319;534;1890;210;790;66;247;276;1037
110070;201808;1783;5794;1430;4974;515;1874;337;1110;852;2984
110080;201808;5391;13405;4047;11776;662;1888;2623;8015;3285;9903
110090;201808;585;1635;411;1312;124;411;161;510;285;921
110092;201808;1037;3220;830;2844;148;538;458;1618;606;2156
110094;201808;2772;8433;2185;7405;805;2816;613;2213;1418;5029
110100;201808;1707;5339;1448;4785;338;1192;727;2390;1065;3582
110110;201808;1562;4590;1144;3882;394;1373;255;940;649;2313
110120;201808;1248;3858;957;3248;266;942;284;967;550;1909
110130;201808;2492;6630;1577;4917;371;1288;540;1652;911;2940
110140;201808;1985;6367;1489;5331;435;1649;382;1387;817;3036
110143;201808;1260;3536;897;2816;316;1000;241;788;557;1788
110145;201808;929;2594;595;1943;153;533;194;639;347;1172
110146;201808;430;1198;307;1003;57;175;157;555;214;730
110147;201808;657;1776;428;1309;84;253;174;485;258;738
110148;201808;817;2446;493;1705;122;464;54;198;176;662
110149;201808;2725;8033;2029;6904;818;2719;548;2048;1366;4767
110150;201808;2183;5948;1547;5006;594;2082;462;1497;1056;3579
110155;201808;637;1996;505;1689;129;457;179;572;308;1029
110160;201808;1462;4686;1105;3869;386;1340;280;1037;666;2377
110170;201808;2097;5695;1359;4242;254;843;727;2199;981;3042
110175;201808;1343;4045;1045;3570;192;683;524;1880;716;2563
110180;201808;1161;3385;852;2742;227;718;359;1193;586;1911
120001;201808;3511;12242;3106;11649;462;1552;2176;8670;2638;10222
120005;201808;1814;7097;1631;6789;172;782;1258;5343;1430;6125
120010;201808;5154;16362;4431;15158;662;2191;2953;10445;3615;12636
120013;201808;2072;7957;1952;7786;534;2050;1115;4768;1649;6818
120017;201808;2049;7105;1866;6804;351;1329;1120;4278;1471;5607
120020;201808;13759;58489;13045;57037;1394;6576;9959;44295;11353;50871
120025;201808;2665;8294;2258;7772;456;1595;1457;5168;1913;6763
120030;201808;6375;25577;6136;25161;400;2073;5069;20812;5469;22885
120032;201808;1583;7412;1514;7241;98;602;1222;5806;1320;6408
120033;201808;3872;14931;3645;14531;139;773;3165;12529;3304;13302
120034;201808;2448;9345;2141;8762;131;764;1720;6923;1851;7687
120035;201808;3321;14256;3188;14000;286;1474;2572;11353;2858;12827
120038;201808;2541;8677;2286;8231;573;2162;1212;4434;1785;6596
120039;201808;1922;8651;1836;8486;173;1033;1404;6489;1577;7522
120040;201808;38416;130866;34475;124104;6360;24222;20696;75697;27056;99919
120042;201808;3170;12434;2942;11947;172;924;2332;9414;2504;10338
120043;201808;1240;5444;1173;5295;79;457;1000;4500;1079;4957
120045;201808;5410;15738;4875;15139;155;631;4462;13748;4617;14379
120050;201808;8488;32350;7942;31451;629;3011;6330;25260;6959;28271
120060;201808;8430;35193;8050;34558;458;2482;6948;29899;7406;32381
120070;201808;2756;9569;2535;9226;292;1131;1819;6803;2111;7934
120080;201808;4092;14272;3711;13630;560;2218;2551;9457;3111;11675
130002;201808;3073;12613;2831;12284;110;611;2536;11027;2646;11638
130006;201808;2230;8852;1900;8242;152;765;1449;6283;1601;7048
130008;201808;2458;8929;2217;8538;82;435;1850;7117;1932;7552
130010;201808;3815;11153;3319;10589;64;228;3109;9974;3173;10202
130014;201808;2868;9071;2360;8189;419;1463;1524;5416;1943;6879
130020;201808;2626;10525;2416;10175;151;885;1943;8154;2094;9039
130030;201808;9303;31676;8565;30869;152;540;8074;29474;8226;30014
130040;201808;3666;11240;3143;10533;186;659;2543;8614;2729;9273
130050;201808;7260;27111;6145;25676;249;1152;5490;23168;5739;24320
130060;201808;7017;29283;6140;28079;555;3236;4838;22020;5393;25256
130063;201808;5596;19762;5064;19140;118;508;4719;17971;4837;18479
130068;201808;3174;12837;2813;12131;216;1196;2131;9126;2347;10322
130070;201808;8132;25604;7050;24394;298;993;6192;21843;6490;22836
130080;201808;6316;25277;5726;24503;390;2249;4699;20125;5089;22374
130083;201808;2469;8900;2257;8625;185;855;1841;6972;2026;7827
130090;201808;3226;10444;2957;10079;63;275;2593;9057;2656;9332
130100;201808;7112;22866;6298;21992;90;261;5960;21224;6050;21485
130110;201808;7723;22823;6592;21447;606;1704;5482;18408;6088;20112
130115;201808;5237;17037;4654;16324;106;462;4118;14598;4224;15060
130120;201808;14326;53005;13190;51517;1182;4880;10941;43313;12123;48193
130130;201808;4969;16917;4000;15648;470;2078;3016;11772;3486;13850
130140;201808;6481;24520;6183;24174;258;1263;5562;21777;5820;23040
130150;201808;3520;13713;3363;13511;102;591;3072;12354;3174;12945
130160;201808;4739;18136;4219;17451;318;1554;3495;14674;3813;16228
130165;201808;2961;11902;2849;11710;110;618;2544;10411;2654;11029
130170;201808;11167;34518;9272;32189;678;2701;7709;26961;8387;29662
130180;201808;4336;13979;4100;13700;48;246;3947;13138;3995;13384
130185;201808;16842;43416;13831;40199;557;1113;12395;37225;12952;38338
130190;201808;17599;59717;14856;55670;1771;6715;10759;41619;12530;48334
130195;201808;2254;8674;1888;8184;78;414;1686;7332;1764;7746
130200;201808;2275;7004;1926;6518;136;527;1545;5273;1681;5800
130210;201808;1343;5145;1207;4983;113;658;963;3891;1076;4549
130220;201808;1999;7728;1837;7457;106;551;1512;6141;1618;6692
130230;201808;4104;18048;3722;17484;333;1897;3071;14466;3404;16363
130240;201808;10548;34476;8892;32158;243;1409;7802;28157;8045;29566
130250;201808;24828;77034;21984;73800;1482;4777;18320;63626;19802;68403
130255;201808;4118;14505;3710;13762;222;995;2961;10994;3183;11989
130260;201808;234189;704498;198865;650470;58286;203240;89233;296737;147519;499977
130270;201808;8445;32087;7290;30222;1007;4353;5144;21988;6151;26341
130280;201808;3443;14144;3240;13920;107;500;3015;13124;3122;13624
130290;201808;12525;43182;11212;41622;424;1517;10140;38333;10564;39850
130300;201808;4477;16616;4186;16162;199;1029;3604;13818;3803;14847
130310;201808;5480;20069;4969;19337;382;1561;4083;16162;4465;17723
130320;201808;3288;11105;2873;10570;252;924;2272;8554;2524;9478
130330;201808;4247;14240;3628;13464;184;837;3123;11599;3307;12436
130340;201808;20605;71246;18294;68535;1472;5361;15420;59303;16892;64664
130350;201808;3770;14245;3476;13862;163;951;3033;11958;3196;12909
130353;201808;6028;18118;5131;16951;838;2716;3543;12167;4381;14883
130356;201808;4756;16489;4189;15544;544;2108;2925;11118;3469;13226
130360;201808;3158;9454;2711;8959;72;217;2542;8478;2614;8695
130370;201808;5711;22211;5125;21430;186;1125;4518;18778;4704;19903
130380;201808;7391;31085;7004;30499;476;2667;5929;25520;6405;28187
130390;201808;5675;24372;5024;23213;570;3122;3659;16821;4229;19943
130395;201808;2316;7673;2029;7164;251;955;1447;5090;1698;6045
130400;201808;2573;8517;2248;8062;116;409;1970;7148;2086;7557
130406;201808;10705;39931;9477;38253;1686;7029;6594;27194;8280;34223
130410;201808;3983;14661;3488;13811;1034;4251;1737;7120;2771;11371
130420;201808;12271;46516;10821;44683;1055;5101;8664;35918;9719;41019
130423;201808;3892;13161;3498;12679;164;831;3100;11070;3264;11901
130426;201808;2774;11013;2662;10843;78;373;2492;10209;2570;10582
130430;201808;3896;12195;3514;11652;381;1327;2778;9204;3159;10531
130440;201808;4490;14522;3986;13918;82;335;3725;13087;3807;13422
140002;201808;1949;5920;1722;5613;103;417;1412;4515;1515;4932
140005;201808;3227;8945;3010;8698;154;445;2728;7888;2882;8333
140010;201808;51053;139285;40005;122995;10623;34412;15591;50488;26214;84900
140015;201808;3247;10809;2911;10397;257;880;2413;8858;2670;9738
140017;201808;3553;10930;3160;10403;345;1075;2320;8008;2665;9083
140020;201808;4901;15164;4213;14230;354;1490;3238;10936;3592;12426
140023;201808;2168;6872;1804;6339;224;865;1292;4599;1516;5464
140028;201808;2042;5395;1741;5001;160;526;1326;3715;1486;4241
140030;201808;4245;12083;3803;11526;311;863;3158;9779;3469;10642
140040;201808;2052;8789;1893;8556;112;655;1652;7402;1764;8057
140045;201808;2495;9467;2135;8941;407;1677;1391;6159;1798;7836
140047;201808;5815;17510;4992;16253;866;2954;3205;10622;4071;13576
140050;201808;1358;4117;1166;3828;123;425;837;2780;960;3205
140060;201808;1418;4081;1246;3818;96;293;1030;3185;1126;3478
140070;201808;1773;9591;1708;9409;156;1060;1343;7319;1499;8379
150010;201808;41122;108152;38005;103954;1233;3878;33754;91584;34987;95462
150013;201808;1848;5023;1545;4683;144;393;1185;3779;1329;4172
150020;201808;13393;42339;12694;41416;1146;2869;10756;36339;11902;39208
150030;201808;8742;33560;8021;32654;383;1738;7101;29116;7484;30854
150034;201808;4077;10897;3497;10116;242;717;2878;8406;3120;9123
150040;201808;13910;39423;12158;37421;1026;2190;10280;33451;11306;35641
150050;201808;6538;23827;6070;23141;138;694;5580;21370;5718;22064
150060;201808;19366;55803;16423;51424;3212;9986;9927;32141;13139;42127
150070;201808;6310;24800;5693;24054;174;911;5220;22332;5394;23243
150080;201808;77659;194128;65319;177575;15716;43614;27511;83451;43227;127065
150085;201808;6255;19895;5773;19296;205;644;5334;18009;5539;18653
150090;201808;9799;37322;9288;36410;683;2964;7598;29922;8281;32886
150095;201808;5379;16836;4853;16114;290;867;4040;13814;4330;14681
150100;201808;3018;10768;2697;10199;203;812;2099;8001;2302;8813
150110;201808;3915;17542;3812;17409;217;1055;3440;15819;3657;16874
150120;201808;7137;24189;6939;23905;308;865;6221;21999;6529;22864
150125;201808;709;2016;559;1819;114;411;336;1087;450;1498
150130;201808;22343;66294;19705;62401;2551;7234;14393;47271;16944;54505
150140;201808;197310;499584;171650;463973;27054;71701;107802;301915;134856;373616
150145;201808;4466;13606;3882;12805;719;2099;2710;9494;3429;11593
150150;201808;14080;38427;12623;36577;994;3048;10045;29365;11039;32413
150157;201808;3148;9082;2659;8426;282;996;1896;6154;2178;7150
150160;201808;2859;8985;2695;8706;662;2148;1556;5165;2218;7313
150170;201808;23832;79607;20805;74721;3821;13069;12882;49267;16703;62336
150172;201808;4040;11971;3347;10959;281;845;2490;8455;2771;9300
150175;201808;1692;5273;1485;4918;187;687;1032;3474;1219;4161
150178;201808;9755;28280;8252;26500;414;1320;6960;22771;7374;24091
150180;201808;20317;76949;18970;75220;1027;4294;16602;66716;17629;71010
150190;201808;6875;23538;6511;23068;245;1085;5818;20564;6063;21649
150195;201808;5316;17140;5070;16759;94;390;4720;15563;4814;15953
150200;201808;5246;16161;4827;15699;58;179;4599;15069;4657;15248
150210;201808;24472;89239;23161;87468;1878;7090;18987;73739;20865;80829
150215;201808;6747;20628;5909;19379;1662;5330;2865;10034;4527;15364
150220;201808;11003;33276;9818;31477;1628;5122;6027;19949;7655;25071
150230;201808;12224;35822;10640;33694;1363;4099;7410;24519;8773;28618
150240;201808;30809;88881;25550;79571;8566;27131;7440;23868;16006;50999
150250;201808;4059;16607;3875;16346;558;2361;2977;12811;3535;15172
150260;201808;2402;8459;2237;8186;227;824;1695;6292;1922;7116
150270;201808;7930;23297;5884;20273;1947;6975;2163;7882;4110;14857
150275;201808;6336;21300;5907;20648;345;1342;4972;17360;5317;18702
150276;201808;2162;6156;1864;5793;239;690;1374;4518;1613;5208
150277;201808;4792;13349;4027;12433;425;1282;3145;10100;3570;11382
150280;201808;6171;26401;6030;26127;520;2240;5005;21949;5525;24189
150285;201808;3111;11340;2797;10875;340;1437;1970;7776;2310;9213
150290;201808;10661;29036;9876;28177;418;959;8891;25978;9309;26937
150293;201808;9536;24077;6977;20653;1545;4613;3401;10953;4946;15566
150295;201808;7333;20627;5648;18545;1947;6776;2241;8050;4188;14826
150300;201808;2082;6677;1890;6410;55;281;1655;5566;1710;5847
150304;201808;3781;12026;3285;11190;557;1838;2174;7616;2731;9454
150307;201808;6210;20350;5821;19749;427;1381;4816;16603;5243;17984
150309;201808;5883;18998;4957;17393;1147;3886;2572;9617;3719;13503
150310;201808;7031;28086;6694;27655;252;1355;5929;24672;6181;26027
150320;201808;9264;25181;8469;24114;462;1442;6823;19397;7285;20839
150330;201808;13698;45464;12779;43965;1644;5629;9509;33602;11153;39231
150340;201808;2619;7818;2362;7439;318;977;1694;5414;2012;6391
150345;201808;7570;23022;6883;22123;445;1505;5829;18924;6274;20429
150350;201808;8544;23711;7904;22900;800;1686;6515;19616;7315;21302
150360;201808;22633;65510;18559;60315;2244;6694;12951;44051;15195;50745
150370;201808;9237;31604;8170;30134;852;3080;6172;23608;7024;26688
150375;201808;3169;13388;2880;12948;292;1410;2304;10482;2596;11892
150380;201808;9896;27239;8428;25243;315;1000;7275;21924;7590;22924
150390;201808;7474;31599;6889;30612;1133;4843;4805;22310;5938;27153
150400;201808;6108;22786;5883;22351;317;1297;5015;19117;5332;20414
150405;201808;8990;24565;8046;23393;528;1182;6518;19674;7046;20856
150410;201808;1799;6072;1582;5687;220;765;1029;3807;1249;4572
150420;201808;32848;100702;25590;89407;8911;32244;7580;30778;16491;63022
150430;201808;7968;24629;7490;23959;766;2025;5989;19874;6755;21899
150440;201808;5462;18179;5164;17736;402;1308;4261;14816;4663;16124
150442;201808;23141;60922;19656;56090;2496;6920;13070;38544;15566;45464
150445;201808;5762;18725;5233;17898;273;981;4440;15294;4713;16275
150450;201808;4769;21361;4507;20977;378;1854;3791;17824;4169;19678
150460;201808;7917;26871;7414;26192;246;1023;6491;23613;6737;24636
150470;201808;18101;52350;17109;51175;916;2526;15232;46057;16148;48583
150475;201808;4212;14221;3814;13599;183;727;3212;11584;3395;12311
150480;201808;13478;45598;12151;43520;1931;6568;8630;32317;10561;38885
150490;201808;7694;27948;7282;27429;244;1200;6508;24551;6752;25751
150495;201808;5031;18091;4898;17913;103;460;4569;16740;4672;17200
150497;201808;2659;8947;2175;8048;577;2220;1056;4126;1633;6346
150500;201808;3229;8550;2893;8038;312;775;2251;6315;2563;7090
150503;201808;4184;11928;3113;10399;1010;3467;1133;4161;2143;7628
150506;201808;9490;31398;8496;29979;1789;5712;5591;21195;7380;26907
150510;201808;9712;36500;8549;34194;1256;4912;5697;23874;6953;28786
150520;201808;7168;27380;6906;27047;193;987;6364;24963;6557;25950
150530;201808;12102;41839;10682;39645;1452;4550;7858;30653;9310;35203
150540;201808;4730;13642;4108;12716;175;549;3504;10847;3679;11396
150543;201808;6591;18570;5460;17080;846;2684;3769;12356;4615;15040
150548;201808;9646;30739;8802;29586;327;1078;7872;26621;8199;27699
150549;201808;1970;6150;1740;5867;49;206;1560;5247;1609;5453
150550;201808;18392;57076;15805;52713;4254;14307;7145;25129;11399;39436
150553;201808;21682;69330;17383;61183;6138;22177;5101;19803;11239;41980
150555;201808;1737;4932;1405;4392;102;324;1008;3162;1110;3486
150560;201808;1782;5677;1593;5286;306;962;900;3085;1206;4047
150563;201808;2350;7591;2091;7130;473;1734;1144;3882;1617;5616
150565;201808;4086;13582;3651;12852;112;564;3073;10828;3185;11392
150570;201808;6025;20645;5790;20265;332;1326;4884;17044;5216;18370
150580;201808;10067;41483;9174;40484;632;3166;7691;34558;8323;37724
150590;201808;6974;26066;6444;25365;213;1128;5843;22944;6056;24072
150600;201808;8521;30543;8001;29870;258;1163;7287;27280;7545;28443
150610;201808;2501;8019;2268;7564;147;555;1820;5991;1967;6546
150611;201808;2764;8658;2570;8347;113;457;2229;7171;2342;7628
150613;201808;12566;35723;9609;30644;1971;6611;4584;14949;6555;21560
150616;201808;3093;8831;2310;7513;601;2097;829;2603;1430;4700
150618;201808;6475;20195;5429;18421;818;2767;3366;11927;4184;14694
150619;201808;5678;17324;4810;15990;283;1065;3817;12692;4100;13757
150620;201808;6242;21401;5527;20388;823;2996;3947;14916;4770;17912
150630;201808;6079;17047;5637;16506;344;996;4859;14375;5203;15371
150635;201808;4193;12445;3664;11544;684;2198;2118;6795;2802;8993
150640;201808;2139;6262;1972;6069;33;110;1846;5749;1879;5859
150650;201808;11185;32597;9967;30483;3079;8983;4443;14626;7522;23609
150655;201808;5555;16577;5105;15873;237;733;4367;13603;4604;14336
150658;201808;4214;12357;3498;11303;663;2246;2131;7175;2794;9421
150660;201808;5594;16572;5082;15848;555;1712;3582;11340;4137;13052
150670;201808;7699;19124;6157;17315;587;1413;4925;14395;5512;15808
150680;201808;63216;197212;49222;174576;12910;45430;21881;86827;34791;132257
150690;201808;2296;6173;2045;5826;129;340;1726;4966;1855;5306
150700;201808;6109;18692;5576;18023;451;1363;4435;14690;4886;16053
150710;201808;3733;12698;3437;12218;239;949;2692;9601;2931;10550
150715;201808;4977;15387;4302;14303;347;1108;3468;11719;3815;12827
150720;201808;6246;24178;5939;23629;446;2064;4897;19505;5343;21569
150730;201808;10865;35058;9627;33119;1069;3883;7319;25642;8388;29525
150740;201808;3538;10588;3160;9924;415;1227;2196;7027;2611;8254
150745;201808;4838;14512;4089;13430;810;2794;2690;8925;3500;11719
150746;201808;1483;4810;1384;4639;81;259;1134;3843;1215;4102
150747;201808;4890;15883;4376;15083;824;2558;2820;10329;3644;12887
150750;201808;3533;11304;3054;10578;214;813;2395;8472;2609;9285
150760;201808;11541;34814;10616;33645;1314;4001;7980;25856;9294;29857
150770;201808;5984;22417;5753;22096;147;453;5390;21163;5537;21616
150775;201808;855;2558;701;2308;123;468;409;1328;532;1796
150780;201808;4336;13349;4036;12980;95;329;3761;12208;3856;12537
150790;201808;5290;16069;4674;15389;224;609;3885;13846;4109;14455
150795;201808;13496;43937;12266;41869;3160;10288;6965;25201;10125;35489
150796;201808;3407;9156;2990;8654;208;592;2486;7308;2694;7900
150797;201808;3856;12396;3352;11596;155;514;2798;9770;2953;10284
150800;201808;12728;41323;11799;40175;1674;5195;8896;31580;10570;36775
150803;201808;6530;22700;6163;22101;447;1695;5202;18710;5649;20405
150805;201808;3036;10103;2658;9494;275;996;2048;7384;2323;8380
150808;201808;5533;16840;4185;14445;1653;6203;559;2145;2212;8348
150810;201808;19430;55247;15225;49933;2754;8898;8868;31409;11622;40307
150812;201808;5201;15363;4667;14403;486;1656;3464;10453;3950;12109
150815;201808;8574;27329;7484;25928;734;2558;5914;20841;6648;23399
150820;201808;11516;32137;9903;30216;902;2424;7867;24795;8769;27219
150830;201808;11410;43599;10888;42970;412;2186;9520;38202;9932;40388
150835;201808;2053;7225;1884;6905;389;1424;1005;3768;1394;5192
150840;201808;7205;21502;5797;18970;1248;4305;2936;9604;4184;13909
160005;201808;1170;3265;1070;3117;22;106;1012;2902;1034;3008
160010;201808;2127;5814;2078;5764;11;41;2035;5627;2046;5668
160015;201808;2204;7283;2029;7047;94;331;1840;6434;1934;6765
160020;201808;1926;6707;1738;6434;229;865;1318;4945;1547;5810
160021;201808;1084;4351;1009;4237;88;492;807;3327;895;3819
160023;201808;1210;4457;1090;4268;103;362;806;3331;909;3693
160025;201808;1792;5092;1747;5037;10;31;1718;4964;1728;4995
160027;201808;8505;23934;7773;23086;585;1612;6473;19695;7058;21307
160030;201808;54919;170041;46135;158302;10780;34973;25118;94824;35898;129797
160040;201808;5065;18232;4611;17607;102;570;4239;16182;4341;16752
160050;201808;3904;13194;3299;12297;1435;5007;1172;5259;2607;10266
160053;201808;3372;11543;3173;11287;357;1183;2500;9163;2857;10346
160055;201808;678;2367;668;2355;25;98;620;2193;645;2291
160060;201808;21714;61771;18294;57855;1193;3670;14812;48612;16005;52282
160070;201808;2914;11134;2661;10715;186;810;2146;8823;2332;9633
160080;201808;2814;9917;2647;9717;66;291;2425;8964;2491;9255
170025;201808;588;1655;446;1455;105;326;220;748;325;1074
170030;201808;1154;3666;916;3181;167;580;421;1483;588;2063
170035;201808;1422;3760;1046;3141;116;379;590;1779;706;2158
170040;201808;1728;5259;1442;4863;127;462;829;2945;956;3407
170070;201808;1515;3788;1094;3243;126;408;652;1994;778;2402
170100;201808;2362;6931;1984;6294;205;648;1338;4288;1543;4936
170105;201808;712;2177;506;1730;136;426;169;598;305;1024
170110;201808;854;2757;679;2411;118;433;330;1188;448;1621
170130;201808;1309;4059;963;3374;178;649;496;1788;674;2437
170190;201808;1357;3967;957;3307;360;1203;197;898;557;2101
170200;201808;1667;4271;1015;3116;263;874;247;753;510;1627
170210;201808;23838;67046;18321;57802;6711;22848;2237;8178;8948;31026
170215;201808;1294;3650;1094;3366;74;298;802;2436;876;2734
170220;201808;5651;18031;4874;16554;1165;3806;2513;9104;3678;12910
170230;201808;1204;3749;937;3207;252;903;233;809;485;1712
170240;201808;2560;7404;2042;6549;184;726;1397;4376;1581;5102
170255;201808;3864;11600;2690;9315;537;1937;1231;4382;1768;6319
170270;201808;1021;2481;664;1982;30;88;438;1289;468;1377
170290;201808;2908;8455;2508;7995;131;347;2068;6866;2199;7213
170300;201808;1821;5303;1543;4862;191;635;1005;3227;1196;3862
170305;201808;722;2124;567;1815;82;311;277;854;359;1165
170307;201808;928;3299;757;2942;131;520;404;1593;535;2113
170310;201808;1591;4186;1101;3343;203;679;508;1555;711;2234
170320;201808;919;2524;704;2182;87;269;424;1333;511;1602
170330;201808;819;2619;750;2509;49;206;598;1960;647;2166
170360;201808;443;1290;332;1096;55;203;200;621;255;824
170370;201808;1266;3481;943;2942;190;606;429;1378;619;1984
170380;201808;1793;5443;1365;4743;144;561;781;2784;925;3345
170382;201808;529;1647;438;1485;63;239;286;957;349;1196
170384;201808;1430;5535;1223;5109;341;1496;519;2173;860;3669
170386;201808;772;2198;496;1646;72;293;133;399;205;692
170388;201808;613;1794;437;1466;61;235;204;680;265;915
170389;201808;1114;3820;972;3569;49;215;782;2908;831;3123
170390;201808;1582;3841;1170;3338;83;244;895;2620;978;2864
170410;201808;532;1611;391;1356;22;101;248;836;270;937
170460;201808;360;1005;289;883;38;118;185;576;223;694
170510;201808;848;2649;635;2220;60;279;373;1237;433;1516
170550;201808;6210;17101;4410;14010;1377;4638;817;2809;2194;7447
170555;201808;1308;3721;1046;3296;71;245;570;1853;641;2098
170560;201808;1028;3032;784;2680;97;366;442;1668;539;2034
170600;201808;1323;3724;1078;3354;239;654;610;2040;849;2694
170610;201808;1659;4681;1242;3983;90;345;800;2508;890;2853
170625;201808;434;1209;271;859;30;90;89;268;119;358
170650;201808;1206;3747;934;3260;199;717;399;1471;598;2188
170700;201808;3334;10052;2588;8694;575;2060;1109;3843;1684;5903
170710;201808;1469;4153;1156;3587;209;719;640;1953;849;2672
170720;201808;1877;4863;1523;4338;71;144;1282;3771;1353;3915
170730;201808;980;2834;747;2445;184;615;336;1148;520;1763
170740;201808;1968;6972;1694;6420;222;880;1126;4298;1348;5178
170755;201808;867;2521;619;2043;71;263;310;1013;381;1276
170765;201808;1211;3227;837;2642;215;704;331;1112;546;1816
170770;201808;1718;5396;1479;4991;183;615;991;3413;1174;4028
170820;201808;3738;12993;3252;12051;468;1688;1924;7511;2392;9199
170825;201808;945;2260;756;2004;82;225;517;1368;599;1593
170830;201808;1336;3741;1107;3369;29;100;915;2791;944;2891
170900;201808;2584;8635;2245;8099;190;765;1778;6472;1968;7237
170930;201808;3526;10119;2823;8842;662;2229;1189;3753;1851;5982
170950;201808;10576;30316;7472;24676;2252;8479;1154;3984;3406;12463
170980;201808;423;1225;341;1086;27;123;227;681;254;804
171050;201808;1515;4978;1358;4692;69;339;1079;3650;1148;3989
171070;201808;1311;3959;1137;3694;209;632;700;2458;909;3090
171090;201808;1029;2603;856;2362;56;143;636;1760;692;1903
171110;201808;561;1604;407;1323;89;320;173;511;262;831
171150;201808;1052;2725;644;1993;75;271;408;1248;483;1519
171180;201808;718;2070;483;1584;89;310;190;648;279;958
171190;201808;1536;5551;1363;5219;227;882;834;3284;1061;4166
171195;201808;799;2710;683;2487;137;522;386;1431;523;1953
171200;201808;517;1514;392;1287;84;300;173;561;257;861
171215;201808;374;1088;287;930;60;210;152;475;212;685
171240;201808;739;2569;617;2321;48;249;386;1445;434;1694
171245;201808;596;1896;465;1607;70;268;235;781;305;1049
171250;201808;1016;2798;761;2386;217;727;340;1071;557;1798
171270;201808;364;1433;309;1297;80;328;141;655;221;983
171280;201808;809;2528;633;2211;136;451;300;1151;436;1602
171320;201808;3848;11063;3024;9596;567;1795;1379;4601;1946;6396
171330;201808;2603;7331;2026;6320;438;1343;1011;3279;1449;4622
171360;201808;1380;4279;1181;3994;74;291;924;3147;998;3438
171370;201808;677;1802;532;1598;53;170;372;1137;425;1307
171380;201808;1366;3999;1119;3599;138;472;719;2335;857;2807
171395;201808;901;2679;631;2123;85;331;327;1064;412;1395
171420;201808;1804;5624;1353;4677;225;888;613;2120;838;3008
171430;201808;983;2970;810;2626;84;314;561;1758;645;2072
171488;201808;2321;6994;1845;6215;302;1064;982;3411;1284;4475
171500;201808;927;2484;710;2137;56;175;524;1590;580;1765
171510;201808;744;2619;677;2490;43;201;485;1779;528;1980
171515;201808;450;1254;332;1049;30;116;204;628;234;744
171525;201808;622;1931;522;1758;40;192;328;1021;368;1213
171550;201808;331;997;239;836;44;168;122;419;166;587
171570;201808;1108;3472;944;3162;162;513;562;1961;724;2474
171575;201808;1824;4942;1163;3703;195;668;488;1523;683;2191
171610;201808;5348;15469;4031;13233;1004;3614;1160;4067;2164;7681
171620;201808;2697;7676;2296;7121;156;580;1825;5671;1981;6251
171630;201808;948;2657;779;2416;141;469;491;1552;632;2021
171650;201808;1990;5937;1472;4951;373;1326;495;1770;868;3096
171660;201808;2300;6100;1612;4874;273;813;858;2620;1131;3433
171665;201808;1290;3719;998;3253;186;664;473;1578;659;2242
171670;201808;1730;4778;1352;4157;200;693;758;2302;958;2995
171700;201808;1146;3415;863;2903;123;404;477;1618;600;2022
171720;201808;792;2159;621;1875;48;177;455;1366;503;1543
171750;201808;1175;3431;837;2805;227;783;147;579;374;1362
171780;201808;1215;3222;891;2759;72;273;623;1887;695;2160
171790;201808;1394;4841;1124;4219;266;1001;506;1993;772;2994
171800;201808;707;2058;544;1810;75;271;302;1015;377;1286
171820;201808;10255;29910;7787;25519;1938;6649;2699;9439;4637;16088
171830;201808;1417;4960;1214;4537;170;733;739;2737;909;3470
171840;201808;727;1921;581;1700;38;129;425;1229;463;1358
171845;201808;643;1686;482;1454;72;260;265;813;337;1073
171850;201808;837;2942;719;2695;74;338;499;1831;573;2169
171855;201808;1057;3279;922;3036;80;268;600;1951;680;2219
171865;201808;363;1206;313;1122;62;242;160;552;222;794
171870;201808;746;2175;542;1785;70;248;287;997;357;1245
171875;201808;1191;3694;965;3311;59;242;715;2422;774;2664
171880;201808;1030;3356;929;3227;47;175;752;2672;799;2847
171884;201808;832;2254;605;1898;120;429;219;755;339;1184
171886;201808;1362;3964;962;3246;297;1075;199;700;496;1775
171888;201808;755;2178;521;1721;48;163;322;1073;370;1236
171889;201808;414;1316;357;1205;72;257;167;565;239;822
171890;201808;1085;3131;835;2704;162;498;492;1633;654;2131
171900;201808;501;1786;374;1470;101;396;133;563;234;959
172000;201808;560;1745;469;1574;69;272;260;832;329;1104
172010;201808;1030;3667;892;3361;82;407;580;2100;662;2507
172015;201808;328;1203;255;1059;58;235;113;494;171;729
172020;201808;2280;7219;2098;6940;173;683;1613;5366;1786;6049
172025;201808;718;2068;525;1742;51;192;337;1127;388;1319
172030;201808;1213;3674;1060;3435;27;125;873;2818;900;2943
172049;201808;1287;3222;858;2569;265;826;402;1207;667;2033
172065;201808;1437;3719;1166;3389;71;173;1024;3054;1095;3227
172080;201808;2281;7019;1873;6249;144;549;1279;4273;1423;4822
172085;201808;463;1307;303;969;57;168;87;269;144;437
172090;201808;3939;10335;3079;9147;134;498;2416;7102;2550;7600
172093;201808;487;1489;367;1268;53;235;190;617;243;852
172097;201808;579;1605;425;1357;68;234;203;671;271;905
172100;201808;44741;115196;30254;91447;6862;22528;9355;29575;16217;52103
172110;201808;1537;5847;1349;5556;135;582;1034;4427;1169;5009
172120;201808;4673;14528;3746;12972;657;2301;1966;7061;2623;9362
172125;201808;286;829;207;697;28;100;113;390;141;490
172130;201808;907;2892;783;2681;24;88;622;2162;646;2250
172208;201808;2366;6195;1907;5555;255;673;1228;3685;1483;4358
172210;201808;2656;7306;2069;6501;432;1423;1114;3541;1546;4964
210005;201808;19015;57076;15273;50953;4601;15927;6063;21213;10664;37140
210010;201808;1754;5785;1602;5544;53;246;1435;4956;1488;5202
210015;201808;3294;10075;2951;9599;142;389;2553;8464;2695;8853
210020;201808;7400;17006;6613;16114;89;237;6170;15019;6259;15256
210030;201808;4754;15968;4525;15646;214;992;3991;13711;4205;14703
210040;201808;2131;5932;1931;5702;28;50;1818;5437;1846;5487
210043;201808;6399;17630;5291;16288;647;1885;3874;12478;4521;14363
210047;201808;6372;21430;5661;20449;233;1097;4971;17861;5204;18958
210050;201808;2107;7428;1697;6671;220;956;1119;4416;1339;5372
210055;201808;1770;5965;1638;5737;68;293;1361;4741;1429;5034
210060;201808;6818;26257;6118;24846;795;3361;4323;18005;5118;21366
210070;201808;7084;20541;6752;20150;27;81;6550;19677;6577;19758
210080;201808;3853;13795;3767;13688;23;115;3676;13379;3699;13494
210083;201808;5093;15855;4434;15138;85;484;4203;14229;4288;14713
210087;201808;2850;8182;2575;7804;135;370;2192;6798;2327;7168
210090;201808;9339;29619;8935;28940;261;993;8133;26171;8394;27164
210095;201808;5919;20301;5537;19820;252;1016;4891;17659;5143;18675
210100;201808;6613;20154;6143;19470;220;864;5305;16791;5525;17655
210110;201808;2766;9001;2619;8802;28;136;2476;8320;2504;8456
210120;201808;22841;64463;19596;60346;2513;6606;13498;44253;16011;50859
210125;201808;3923;11470;3612;11069;736;1830;2619;8545;3355;10375
210130;201808;4024;11308;3502;10636;151;438;3026;9215;3177;9653
210135;201808;1402;4414;1266;4199;58;238;1063;3509;1121;3747
210140;201808;16488;48331;13489;44254;2876;9457;7636;26031;10512;35488
210150;201808;4436;11032;4019;10464;83;282;3628;9334;3711;9616
210160;201808;15660;48341;14321;46391;1355;4495;10758;35748;12113;40243
210170;201808;13979;46633;13350;45787;578;2084;12064;41513;12642;43597
210173;201808;2373;8917;2219;8673;55;309;2061;8054;2116;8363
210177;201808;3046;9118;2873;8906;61;135;2720;8572;2781;8707
210180;201808;1412;4038;1285;3859;31;113;1152;3442;1183;3555
210190;201808;4629;14091;4237;13387;107;550;3593;11065;3700;11615
210193;201808;1201;3717;1093;3548;46;161;891;2918;937;3079
210197;201808;1906;6484;1791;6323;156;570;1444;5186;1600;5756
210200;201808;7367;24649;6871;23892;613;2191;5615;19749;6228;21940
210203;201808;6865;21224;6286;20428;526;1655;5215;17230;5741;18885
210207;201808;3397;9862;3076;9441;134;377;2606;8155;2740;8532
210210;201808;8091;27039;7647;26431;99;562;7139;24612;7238;25174
210215;201808;2039;6894;1871;6661;63;322;1655;5865;1718;6187
210220;201808;5848;21012;5589;20554;215;1253;4947;17819;5162;19072
210230;201808;5059;15865;4672;15298;246;678;4138;13729;4384;14407
210232;201808;11097;36169;9276;33550;1423;5301;6199;23617;7622;28918
210235;201808;3488;10564;3085;10038;109;456;2742;8932;2851;9388
210237;201808;2425;8711;2259;8505;19;101;2156;8133;2175;8234
210240;201808;2659;8509;2456;8157;89;379;2160;7102;2249;7481
210250;201808;5405;16974;4996;16468;104;550;4501;14780;4605;15330
210255;201808;2567;7986;2243;7378;270;930;1554;5083;1824;6013
210260;201808;5005;15962;4483;15159;268;1010;3749;12676;4017;13686
210270;201808;4778;13639;4342;13054;99;476;3910;11644;4009;12120
210275;201808;3522;9048;3223;8682;53;106;3053;8321;3106;8427
210280;201808;5361;16040;4482;14670;249;1223;3328;10598;3577;11821
210290;201808;6360;18926;5895;18364;140;519;5371;16731;5511;17250
210300;201808;32968;91402;28030;84997;1855;5745;21542;67896;23397;73641
210310;201808;2998;7930;2721;7553;80;165;2453;6866;2533;7031
210312;201808;2520;6936;2258;6632;57;228;2082;6062;2139;6290
210315;201808;2839;8231;2437;7757;72;183;2183;7146;2255;7329
210317;201808;3986;12774;3701;12443;115;517;3406;11397;3521;11914
210320;201808;18749;60348;17587;58799;467;2184;16019;53370;16486;55554
210325;201808;3417;10268;3038;9731;83;290;2737;8879;2820;9169
210330;201808;25878;74215;21735;68861;5555;16515;11288;40716;16843;57231
210340;201808;10041;30980;9112;29577;912;2864;6871;22969;7783;25833
210350;201808;9033;27158;8191;26053;226;838;7221;23081;7447;23919
210355;201808;4235;14689;3761;13933;140;713;3207;11957;3347;12670
210360;201808;14211;43343;12836;41361;623;2599;10610;33857;11233;36456
210370;201808;10126;23369;8087;21183;275;537;7309;19574;7584;20111
210375;201808;2932;8453;2318;7605;625;2026;1161;4079;1786;6105
210380;201808;5416;14534;4865;13830;244;619;4239;12211;4483;12830
210390;201808;2577;9533;2424;9264;150;729;2031;7669;2181;8398
210400;201808;4506;14316;4157;13870;116;313;3845;12994;3961;13307
210405;201808;6879;19283;5625;17463;1077;3196;3228;10589;4305;13785
210407;201808;1914;6613;1608;6021;118;536;1285;4721;1403;5257
210408;201808;2327;9119;2225;8969;157;801;1849;7478;2006;8279
210409;201808;3620;12925;3338;12523;121;665;2825;10573;2946;11238
210410;201808;3374;10720;2954;10049;220;817;2256;7703;2476;8520
210420;201808;3958;12875;3602;12241;174;558;3079;10565;3253;11123
210430;201808;2163;6491;2041;6342;104;275;1810;5689;1914;5964
210440;201808;4059;11692;3805;11351;74;246;3608;10771;3682;11017
210450;201808;2466;7673;2222;7261;122;461;1851;6004;1973;6465
210455;201808;3704;10300;3049;9499;762;2314;1777;5736;2539;8050
210460;201808;3306;10299;3014;9877;106;432;2630;8584;2736;9016
210462;201808;1476;4933;1313;4626;52;241;1083;3773;1135;4014
210465;201808;2566;7824;2267;7404;82;288;1953;6404;2035;6692
210467;201808;5725;19183;5305;18678;256;1062;4696;16585;4952;17647
210470;201808;2106;5551;1458;4608;81;194;1109;3619;1190;3813
210480;201808;15025;46649;12849;43832;1402;4549;9446;34026;10848;38575
210490;201808;3670;9654;3060;8782;68;229;2697;7720;2765;7949
210500;201808;6020;24559;5681;23921;385;1986;4650;19402;5035;21388
210510;201808;5844;20404;5450;19941;113;538;4996;18449;5109;18987
210515;201808;3568;10884;3208;10499;112;362;2898;9617;3010;9979
210520;201808;2498;7313;2246;6995;93;322;2023;6321;2116;6643
210530;201808;44883;119787;37027;107734;6563;23505;11620;41067;18183;64572
210535;201808;3086;10653;2932;10410;94;374;2587;9276;2681;9650
210540;201808;13968;42721;11910;39948;1400;4551;8687;30248;10087;34799
210542;201808;5961;15378;5114;14439;256;441;4556;13427;4812;13868
210545;201808;2251;7091;2121;6883;55;242;1886;6038;1941;6280
210547;201808;3533;12736;3187;12058;324;1200;2335;9102;2659;10302
210550;201808;5585;17454;4875;16508;318;1135;4015;13851;4333;14986
210560;201808;3389;10710;3123;10235;107;391;2732;8883;2839;9274
210565;201808;1392;4958;1202;4657;55;277;967;3792;1022;4069
210570;201808;10938;30401;9936;29200;284;775;9127;27142;9411;27917
210580;201808;2934;8257;2566;7802;229;436;2079;6672;2308;7108
210590;201808;4175;12735;3692;12086;116;588;3274;10629;3390;11217
210592;201808;2516;7658;2372;7417;34;185;2133;6584;2167;6769
210594;201808;2531;7087;2011;6254;83;234;1568;5012;1651;5246
210596;201808;2347;8644;2189;8310;170;711;1749;6673;1919;7384
210598;201808;1775;5238;1664;5088;36;151;1552;4715;1588;4866
210600;201808;2855;8029;2381;7348;80;223;1980;6182;2060;6405
210610;201808;2408;7467;2184;7191;79;358;1941;6331;2020;6689
210620;201808;2334;6945;2044;6583;40;112;1900;6238;1940;6350
210630;201808;3039;10672;2789;10324;157;777;2340;8552;2497;9329
210632;201808;4078;13881;3726;13348;324;1362;2972;10563;3296;11925
210635;201808;1773;6307;1687;6152;134;452;1422;5318;1556;5770
210637;201808;2292;7975;2095;7671;154;690;1627;5987;1781;6677
210640;201808;5029;19539;4971;19478;29;107;4905;19264;4934;19371
210650;201808;7032;20543;6643;20029;80;321;6303;18934;6383;19255
210660;201808;8330;24393;7469;23067;327;1165;6469;19854;6796;21019
210663;201808;2495;7619;2372;7479;112;280;2113;6863;2225;7143
210667;201808;1842;6162;1738;5998;63;272;1571;5441;1634;5713
210670;201808;4343;15369;4070;14923;154;743;3579;13038;3733;13781
210675;201808;4945;13766;4394;13031;322;782;3674;11257;3996;12039
210680;201808;4007;10514;3403;9767;140;288;3014;8862;3154;9150
210690;201808;7309;24171;6715;23501;245;1021;6020;21286;6265;22307
210700;201808;2696;7547;2264;7010;147;358;1843;6111;1990;6469
210710;201808;4811;15456;4387;14851;126;597;3899;13088;4025;13685
210720;201808;2714;9300;2578;9123;54;294;2392;8390;2446;8684
210725;201808;1276;4511;1134;4259;46;220;808;3134;854;3354
210730;201808;1178;3255;1013;3031;78;214;808;2460;886;2674
210735;201808;4465;13834;3931;13053;297;1022;3292;11077;3589;12099
210740;201808;5130;14299;4614;13758;157;565;4081;12104;4238;12669
210745;201808;4463;12693;4235;12401;147;384;3869;11390;4016;11774
210750;201808;19789;51800;17271;48806;1490;4121;13306;38604;14796;42725
210760;201808;5490;15817;5026;15313;23;87;4889;14910;4912;14997
210770;201808;5802;15631;5080;14810;60;264;4757;13831;4817;14095
210780;201808;6969;23253;6319;22131;601;2024;4956;17680;5557;19704
210790;201808;4468;14401;4159;14001;161;514;3442;12152;3603;12666
210800;201808;4873;13293;4296;12541;71;294;3938;11383;4009;11677
210805;201808;3800;14487;3672;14287;103;596;3335;12878;3438;13474
210810;201808;4913;14817;4546;14345;212;500;4004;13026;4216;13526
210820;201808;6941;20245;6009;18713;710;2224;3999;12685;4709;14909
210825;201808;6384;20371;6007;19880;228;745;5326;17902;5554;18647
210830;201808;7484;21816;7135;21378;440;947;6276;19480;6716;20427
210840;201808;3254;8807;2951;8390;83;280;2636;7406;2719;7686
210845;201808;6067;17352;5773;17038;24;70;5719;16900;5743;16970
210850;201808;5503;19537;4942;18644;345;1645;3927;14755;4272;16400
210860;201808;17795;50090;15532;47082;791;2291;12989;40330;13780;42621
210870;201808;6174;18284;5498;17467;255;841;4839;15416;5094;16257
210880;201808;4281;13414;3902;12980;224;872;3312;11001;3536;11873
210890;201808;4152;12755;3805;12341;217;565;3252;10914;3469;11479
210900;201808;4621;13647;3537;11688;1397;4919;664;2466;2061;7385
210905;201808;1860;5439;1614;5093;42;105;1461;4678;1503;4783
210910;201808;7009;22052;6086;20508;801;2840;4226;14278;5027;17118
210920;201808;3098;10543;2750;10069;100;516;2435;8850;2535;9366
210923;201808;1396;4500;1271;4303;70;289;992;3337;1062;3626
210927;201808;4993;16025;4478;15455;115;426;4058;14171;4173;14597
210930;201808;2342;8389;2173;8093;112;572;1754;6443;1866;7015
210940;201808;3613;11122;3420;10866;114;538;3095;9638;3209;10176
210945;201808;5779;17602;5461;17219;241;696;4871;15531;5112;16227
210950;201808;5010;14964;3977;13391;569;1682;2699;9570;3268;11252
210955;201808;1607;5211;1441;4943;138;457;1066;3735;1204;4192
210960;201808;8454;26542;7643;25353;1468;4424;4880;17269;6348;21693
210970;201808;1230;4059;1045;3720;85;395;784;2685;869;3080
210975;201808;1577;5309;1484;5136;118;473;1166;3997;1284;4470
210980;201808;10316;23427;9238;22322;129;281;8864;21551;8993;21832
210990;201808;15570;46291;12763;42587;1342;4629;9082;30906;10424;35535
211000;201808;14030;43493;12244;41475;625;2598;10222;35265;10847;37863
211003;201808;5043;16575;4417;15816;172;701;3842;14028;4014;14729
211010;201808;6222;23102;5809;22520;76;456;5373;20933;5449;21389
211020;201808;7791;24772;7346;24203;307;1238;6424;21195;6731;22433
211023;201808;2017;6761;1914;6613;105;429;1626;5554;1731;5983
211027;201808;2654;9391;2610;9312;195;755;2253;8018;2448;8773
211030;201808;3745;10895;3424;10509;258;610;2882;9072;3140;9682
211040;201808;4438;16360;4224;16026;141;779;3776;14240;3917;15019
211050;201808;9426;24309;8689;23391;172;450;8125;21886;8297;22336
211060;201808;6511;21526;6103;20941;155;645;5661;19439;5816;20084
211065;201808;2050;6040;1784;5669;72;229;1536;4973;1608;5202
211070;201808;7367;24883;6602;23640;493;1838;5308;19154;5801;20992
211080;201808;1252;3630;1040;3287;50;292;816;2415;866;2707
211085;201808;1919;5940;1730;5673;98;286;1502;4997;1600;5283
211090;201808;3209;9009;2913;8619;48;234;2662;7782;2710;8016
211100;201808;6357;16859;6048;16438;41;142;5685;15444;5726;15586
211102;201808;2810;10456;2625;10185;158;774;2275;8756;2433;9530
211105;201808;2283;7513;1947;6876;209;766;1371;4807;1580;5573
211107;201808;4399;14101;3897;13385;163;645;3225;11333;3388;11978
211110;201808;5746;16527;4537;14646;557;1671;3177;10589;3734;12260
211120;201808;34718;97245;32146;94130;4178;11068;24203;73405;28381;84473
211125;201808;1969;6099;1711;5688;68;290;1458;4824;1526;5114
211130;201808;178069;455312;166240;440246;24305;64666;79052;237253;103357;301919
211140;201808;4815;15028;4404;14435;204;659;3807;12489;4011;13148
211150;201808;9009;25938;7987;24626;289;1056;6929;21368;7218;22424
211153;201808;2476;7567;2087;7076;345;1233;1398;4920;1743;6153
211157;201808;1074;3474;907;3195;47;265;651;2268;698;2533
211160;201808;3707;11515;3102;10521;196;878;2358;7827;2554;8705
211163;201808;1746;5790;1625;5610;17;80;1548;5390;1565;5470
211167;201808;1520;4961;1427;4811;25;110;1333;4485;1358;4595
211170;201808;5894;15238;5654;14956;54;188;5450;14371;5504;14559
211172;201808;2422;6873;2112;6366;86;303;1771;5170;1857;5473
211174;201808;2706;8215;2529;7982;68;338;2296;7166;2364;7504
211176;201808;3838;12024;3220;11119;220;946;2523;8653;2743;9599
211178;201808;4521;10715;3997;10115;31;139;3795;9497;3826;9636
211180;201808;3950;13545;3719;13197;216;870;3201;11372;3417;12242
211190;201808;2992;9108;2626;8543;46;227;2309;7441;2355;7668
211195;201808;1342;3955;1157;3694;78;203;960;3169;1038;3372
211200;201808;1987;6118;1664;5681;174;652;1181;4078;1355;4730
211210;201808;6296;19657;5864;19059;268;959;5131;16711;5399;17670
211220;201808;33684;90712;28837;84703;3151;9209;21213;64139;24364;73348
211223;201808;4737;14011;4246;13258;455;1328;3209;10246;3664;11574
211227;201808;1674;5821;1539;5611;54;265;1341;4917;1395;5182
211230;201808;6932;21916;6389;21016;461;1473;5182;17182;5643;18655
211240;201808;7953;26332;7572;25840;167;903;6955;23445;7122;24348
211245;201808;6364;17043;6110;16784;54;102;6013;16578;6067;16680
211250;201808;13337;40095;12320;38857;488;1966;10798;33696;11286;35662
211260;201808;7573;25071;6990;24285;196;872;6393;22279;6589;23151
211270;201808;10081;33301;8968;31802;362;1787;7544;26824;7906;28611
211280;201808;12808;36998;11620;35461;842;2093;9607;30412;10449;32505
211285;201808;1584;5756;1421;5467;242;969;772;3094;1014;4063
211290;201808;6911;22164;6480;21557;213;920;5637;18632;5850;19552
211300;201808;7917;22997;7266;22125;110;321;6857;20980;6967;21301
211400;201808;10902;33289;9197;30731;1531;5096;5724;20275;7255;25371
220005;201808;1796;4931;1631;4679;38;164;1349;3773;1387;3937
220010;201808;1455;4187;1231;3789;34;144;978;2972;1012;3116
220020;201808;3217;9738;2899;9197;312;1064;2173;6831;2485;7895
220025;201808;2112;5019;1845;4615;33;106;1565;3808;1598;3914
220027;201808;1206;3218;1060;3020;31;104;873;2458;904;2562
220030;201808;3279;8866;3130;8639;104;317;2763;7518;2867;7835
220040;201808;6714;20682;6091;19500;1141;3530;3916;12789;5057;16319
220045;201808;1410;4459;1211;4100;44;234;970;3213;1014;3447
220050;201808;4360;12671;3738;11738;122;530;3292;10236;3414;10766
220060;201808;2266;5033;1915;4623;29;70;1788;4305;1817;4375
220070;201808;2424;6442;2123;5990;76;178;1775;5000;1851;5178
220080;201808;652;1922;587;1822;23;101;511;1533;534;1634
220090;201808;1763;4343;1470;3927;16;62;1273;3450;1289;3512
220095;201808;637;1690;605;1651;10;22;562;1534;572;1556
220100;201808;1307;3783;1074;3370;52;228;862;2613;914;2841
220105;201808;1975;6285;1745;5801;150;522;1294;4304;1444;4826
220110;201808;3363;9446;3152;9069;53;257;2800;7929;2853;8186
220115;201808;2584;8050;2417;7787;74;322;2184;6915;2258;7237
220117;201808;1325;3348;1034;2917;18;69;873;2408;891;2477
220120;201808;11297;33158;10505;32126;125;539;9932;30268;10057;30807
220130;201808;1047;3022;892;2789;19;130;798;2429;817;2559
220140;201808;1842;4247;1602;3948;142;373;1377;3355;1519;3728
220150;201808;6395;19247;6010;18647;136;678;5195;15745;5331;16423
220155;201808;1093;3235;863;2805;23;101;609;1926;632;2027
220157;201808;1036;2606;874;2339;16;70;713;1845;729;1915
220160;201808;2641;7762;2301;7118;47;253;1908;5760;1955;6013
220170;201808;1329;3753;1152;3480;13;68;1026;3062;1039;3130
220173;201808;1956;5729;1584;5020;38;183;1290;3949;1328;4132
220177;201808;1878;5499;1827;5438;18;58;1776;5297;1794;5355
220180;201808;1124;2859;885;2410;11;54;665;1701;676;1755
220190;201808;5692;15963;4936;14895;427;1356;3696;11234;4123;12590
220191;201808;1370;4443;1273;4267;77;333;941;3082;1018;3415
220192;201808;1799;5004;1434;4348;28;105;1151;3414;1179;3519
220194;201808;1683;4951;1510;4656;78;318;1242;3730;1320;4048
220196;201808;1887;5251;1723;4978;42;195;1458;4097;1500;4292
220198;201808;1214;3512;1027;3255;5;11;971;3123;976;3134
220200;201808;4634;14286;4220;13739;314;1113;3431;11154;3745;12267
220202;201808;2143;6114;1848;5594;30;138;1576;4669;1606;4807
220205;201808;2505;7061;2244;6644;38;165;1944;5656;1982;5821
220207;201808;785;2404;670;2196;61;238;466;1511;527;1749
220208;201808;1688;5328;1380;4696;280;1035;669;2269;949;3304
220209;201808;1574;4613;1365;4250;27;131;1112;3424;1139;3555
220210;201808;1532;4045;1326;3694;22;99;1106;2984;1128;3083
220211;201808;1510;4054;1415;3931;21;81;1263;3515;1284;3596
220213;201808;1685;4629;1480;4232;28;109;1208;3333;1236;3442
220217;201808;1963;6153;1876;6041;35;139;1765;5719;1800;5858
220220;201808;10031;26963;8484;24526;549;1480;6182;18260;6731;19740
220225;201808;1092;2913;899;2664;13;53;808;2365;821;2418
220230;201808;5555;14112;4873;13204;192;516;4249;11524;4441;12040
220240;201808;2896;8672;2657;8199;85;298;2184;6720;2269;7018
220245;201808;1563;3987;1270;3607;10;42;1145;3301;1155;3343
220250;201808;2714;8121;2421;7728;34;162;2184;6938;2218;7100
220253;201808;1617;4505;1383;4095;83;261;1146;3311;1229;3572
220255;201808;1843;4626;1562;4193;36;175;1305;3340;1341;3515
220260;201808;4157;13175;3675;12326;209;765;2934;9802;3143;10567
220265;201808;1205;4027;1103;3868;55;240;870;3004;925;3244
220270;201808;6293;20121;5944;19489;291;1269;5022;15979;5313;17248
220271;201808;1455;3831;1260;3544;46;145;1098;3086;1144;3231
220272;201808;1700;4947;1521;4608;43;145;1183;3500;1226;3645
220273;201808;1184;3431;1001;3086;40;156;767;2319;807;2475
220275;201808;2164;5354;1681;4693;42;163;1464;4048;1506;4211
220277;201808;2038;5377;1777;4965;31;107;1516;4149;1547;4256
220280;201808;1563;3939;1320;3568;43;142;1105;2901;1148;3043
220285;201808;1481;3889;1249;3585;18;84;1115;3157;1133;3241
220290;201808;5716;17595;4731;16197;385;1510;3533;12122;3918;13632
220300;201808;1833;5734;1551;5326;55;329;1285;4298;1340;4627
220310;201808;2674;7827;2227;7315;53;266;1929;6260;1982;6526
220320;201808;2875;8671;2316;7600;132;551;1760;5637;1892;6188
220323;201808;1553;4999;1275;4536;78;335;1014;3566;1092;3901
220325;201808;1231;3718;1051;3390;37;167;861;2741;898;2908
220327;201808;1393;4185;1237;3921;49;231;1016;3134;1065;3365
220330;201808;3972;10218;3367;9422;123;360;2846;7925;2969;8285
220335;201808;1753;5334;1567;5120;34;106;1429;4685;1463;4791
220340;201808;1775;4775;1423;4191;51;192;1016;2860;1067;3052
220342;201808;1147;3509;1030;3330;43;191;823;2622;866;2813
220345;201808;3017;7066;2451;6279;17;59;2318;5910;2335;5969
220350;201808;3325;8814;2702;7796;142;461;2034;5791;2176;6252
220360;201808;1215;3143;983;2771;20;63;796;2222;816;2285
220370;201808;8800;25222;8010;24090;210;897;7153;21248;7363;22145
220375;201808;1429;4419;1335;4287;8;31;1297;4165;1305;4196
220380;201808;1480;3640;1234;3283;28;84;1078;2824;1106;2908
220385;201808;768;1914;620;1639;10;35;540;1394;550;1429
220390;201808;8244;23741;6948;21489;1786;5413;3063;10115;4849;15528
220400;201808;1461;3603;1114;3053;31;108;856;2265;887;2373
220410;201808;1132;3221;944;2898;58;179;760;2295;818;2474
220415;201808;789;2127;679;1941;21;70;520;1456;541;1526
220420;201808;1943;5519;1593;4836;63;206;1237;3680;1300;3886
220430;201808;2432;6601;2366;6511;78;230;2127;5808;2205;6038
220435;201808;1652;4559;1479;4283;55;188;1164;3301;1219;3489
220440;201808;2359;7667;2074;7185;134;527;1703;5807;1837;6334
220450;201808;2222;6225;1851;5724;180;644;1412;4328;1592;4972
220455;201808;1282;4049;1218;3964;26;125;1096;3531;1122;3656
220460;201808;919;2378;829;2273;39;138;732;1959;771;2097
220465;201808;2262;7255;2039;6907;136;524;1603;5447;1739;5971
220470;201808;3411;9814;3075;9262;105;375;2529;7487;2634;7862
220480;201808;2450;6663;1994;5896;143;362;1463;4268;1606;4630
220490;201808;2307;6119;2119;5882;39;166;1905;5216;1944;5382
220500;201808;2510;6834;2311;6504;55;240;1923;5209;1978;5449
220510;201808;2572;7548;2103;6712;91;278;1663;5313;1754;5591
220515;201808;1660;4055;1490;3820;38;87;1321;3378;1359;3465
220520;201808;4892;12902;4435;12239;107;328;3967;10901;4074;11229
220525;201808;1230;3343;1116;3184;18;77;1004;2825;1022;2902
220527;201808;1268;3685;1129;3446;25;83;971;2981;996;3064
220530;201808;1191;3306;1078;3144;26;105;1003;2877;1029;2982
220535;201808;757;2194;698;2117;43;150;577;1738;620;1888
220540;201808;3302;10480;3115;10150;102;437;2735;8847;2837;9284
220545;201808;1336;4278;1250;4112;87;348;1027;3319;1114;3667
220550;201808;8480;26563;7700;25198;601;2225;5858;18907;6459;21132
220551;201808;1400;4209;1231;3915;48;195;991;3094;1039;3289
220552;201808;1493;4453;1268;4015;38;188;1034;3179;1072;3367
220553;201808;1539;4294;1321;3955;54;131;1057;3245;1111;3376
220554;201808;843;2314;631;1953;31;79;455;1394;486;1473
220555;201808;1957;6463;1826;6234;65;319;1514;5105;1579;5424
220556;201808;1241;3726;1079;3376;57;242;806;2407;863;2649
220557;201808;1525;4738;1305;4273;84;321;944;3008;1028;3329
220558;201808;1380;3654;1072;3223;26;116;906;2688;932;2804
220559;201808;1594;4209;1379;3870;6;36;1143;3228;1149;3264
220560;201808;1678;3956;1365;3535;36;76;1209;3134;1245;3210
220570;201808;6985;21706;6444;20868;485;1658;5132;16630;5617;18288
220580;201808;6605;19020;6226;18402;131;496;5584;16326;5715;16822
220585;201808;1859;6208;1695;5889;62;266;1404;4854;1466;5120
220590;201808;1236;3562;1045;3267;95;307;771;2412;866;2719
220595;201808;2405;6704;2232;6477;14;80;2084;5988;2098;6068
220600;201808;1381;3112;1149;2817;135;212;922;2360;1057;2572
220605;201808;1649;4846;1424;4444;30;139;1131;3440;1161;3579
220610;201808;2785;8784;2628;8562;40;181;2426;7887;2466;8068
220620;201808;7762;24561;7243;23828;228;1073;6567;21361;6795;22434
220630;201808;367;1103;289;965;42;145;177;604;219;749
220635;201808;1626;5241;1445;4856;68;275;1073;3553;1141;3828
220640;201808;2615;7219;2232;6640;99;369;1853;5414;1952;5783
220650;201808;1961;5659;1684;5165;56;208;1346;4076;1402;4284
220660;201808;2587;8156;2272;7649;95;458;1874;6114;1969;6572
220665;201808;1262;3959;1107;3697;29;151;931;3056;960;3207
220667;201808;1612;5202;1444;4891;81;321;1141;3854;1222;4175
220669;201808;1661;5222;1601;5114;86;386;1349;4218;1435;4604
220670;201808;2152;5762;1765;5285;36;120;1558;4631;1594;4751
220672;201808;2964;7538;2434;6904;116;344;2135;6036;2251;6380
220675;201808;1194;3344;1097;3158;47;135;883;2518;930;2653
220680;201808;2577;7295;2475;7143;113;287;2227;6436;2340;6723
220690;201808;1478;4074;1316;3808;120;319;1007;2954;1127;3273
220695;201808;888;2507;819;2377;19;67;703;2015;722;2082
220700;201808;8752;22874;7102;20503;349;1103;5509;15754;5858;16857
220710;201808;846;2426;642;2032;39;111;469;1466;508;1577
220720;201808;2005;4989;1819;4716;27;96;1585;4056;1612;4152
220730;201808;1245;3601;1069;3315;25;115;900;2721;925;2836
220735;201808;967;2325;746;1965;27;78;625;1600;652;1678
220740;201808;1375;3926;1114;3581;37;141;945;3048;982;3189
220750;201808;3581;9797;3250;9299;188;508;2841;8133;3029;8641
220755;201808;1179;3077;999;2788;33;120;792;2137;825;2257
220760;201808;2894;8701;2573;8257;110;373;2206;7166;2316;7539
220770;201808;19603;62392;17086;57779;6014;20905;5965;21030;11979;41935
220775;201808;1095;2957;1023;2864;14;53;992;2768;1006;2821
220777;201808;1599;4194;1243;3603;42;117;925;2675;967;2792
220779;201808;1325;3278;1182;3075;29;102;1024;2630;1053;2732
220780;201808;5610;14558;4840;13294;227;763;3930;10484;4157;11247
220785;201808;1404;3200;1272;3010;14;23;1216;2875;1230;2898
220790;201808;9843;28778;8925;27440;295;1370;7572;22843;7867;24213
220793;201808;836;2271;695;2022;25;79;578;1686;603;1765
220795;201808;1401;3732;1259;3549;28;112;1123;3126;1151;3238
220800;201808;16090;39726;13634;36159;801;2156;9888;25933;10689;28089
220810;201808;2884;8310;2521;7639;53;236;2110;6253;2163;6489
220820;201808;5081;13433;4407;12484;419;1089;3291;9362;3710;10451
220830;201808;6900;19039;6282;18130;255;840;5326;15246;5581;16086
220840;201808;11902;37219;10313;33967;2320;7362;5365;18280;7685;25642
220850;201808;2939;9497;2701;9191;69;376;2425;8149;2494;8525
220855;201808;577;1635;511;1523;15;73;434;1262;449;1335
220860;201808;989;2494;864;2294;17;57;778;2042;795;2099
220865;201808;2528;6823;1993;5896;63;229;1545;4439;1608;4668
220870;201808;2625;7927;2197;7341;38;196;1996;6616;2034;6812
220880;201808;5068;12567;4537;11914;71;233;4213;10993;4284;11226
220885;201808;1237;4187;1070;3891;58;294;837;3023;895;3317
220887;201808;1413;3201;1209;2926;9;34;1136;2710;1145;2744
220890;201808;1458;4758;1251;4365;87;324;973;3411;1060;3735
220900;201808;1931;4861;1635;4447;39;107;1433;3850;1472;3957
220910;201808;1457;4236;1241;3911;52;177;1035;3243;1087;3420
220915;201808;969;2629;774;2245;16;60;616;1729;632;1789
220920;201808;1335;4526;1154;4270;79;371;913;3337;992;3708
220930;201808;1544;4505;1363;4222;37;155;1226;3743;1263;3898
220935;201808;1028;2966;805;2496;30;129;545;1561;575;1690
220937;201808;1314;3631;1154;3379;27;109;949;2711;976;2820
220940;201808;1397;4125;1157;3652;38;175;870;2660;908;2835
220945;201808;403;1435;366;1366;29;148;260;938;289;1086
220950;201808;1385;3299;904;2513;17;61;712;1906;729;1967
220955;201808;1525;4054;1341;3736;36;95;1156;3221;1192;3316
220960;201808;836;2144;657;1859;13;50;510;1402;523;1452
220965;201808;1732;4835;1548;4561;26;152;1341;3848;1367;4000
220970;201808;1742;4571;1355;3946;46;135;1091;3159;1137;3294
220975;201808;689;2112;605;2002;23;150;541;1697;564;1847
220980;201808;1145;3326;1042;3164;37;157;871;2596;908;2753
220985;201808;1143;3212;1040;3058;44;179;809;2265;853;2444
220987;201808;1467;4422;1275;4091;65;300;1041;3249;1106;3549
220990;201808;1662;4753;1457;4427;34;180;1204;3555;1238;3735
220995;201808;1167;3500;919;3062;60;235;655;2174;715;2409
220997;201808;2387;7038;2240;6824;52;213;2035;6119;2087;6332
221000;201808;3968;11499;3681;11054;110;528;3148;9225;3258;9753
221005;201808;1383;3908;1257;3679;53;207;1046;2943;1099;3150
221010;201808;1195;2928;993;2674;24;65;866;2289;890;2354
221020;201808;1505;4706;1387;4465;39;182;1052;3318;1091;3500
221030;201808;1537;4161;1334;3871;41;177;1148;3282;1189;3459
221035;201808;1337;3673;1208;3499;24;46;1098;3258;1122;3304
221037;201808;585;1753;507;1614;11;59;347;1044;358;1103
221038;201808;517;1480;409;1274;15;51;295;911;310;962
221039;201808;855;2329;764;2182;19;93;645;1769;664;1862
221040;201808;4067;12527;3700;11860;161;597;2983;9530;3144;10127
221050;201808;3644;9995;3307;9563;56;218;3033;8713;3089;8931
221060;201808;8216;23014;6875;20899;268;858;5450;16849;5718;17707
221062;201808;1144;3878;1002;3598;50;247;803;2819;853;3066
221063;201808;1147;3370;983;3120;73;277;717;2208;790;2485
221065;201808;2594;6795;2300;6285;30;123;2030;5430;2060;5553
221070;201808;3281;10518;2772;9502;272;958;1890;6530;2162;7488
221080;201808;3402;8404;2782;7470;56;226;2306;6097;2362;6323
221090;201808;1377;3706;1133;3264;20;82;986;2763;1006;2845
221093;201808;1341;3888;1244;3693;119;373;858;2485;977;2858
221095;201808;873;2320;741;2111;5;13;618;1727;623;1740
221097;201808;823;2176;639;1834;28;100;466;1276;494;1376
221100;201808;98779;275501;86300;254429;14017;43009;53513;155627;67530;198636
221110;201808;9771;29810;9094;28904;210;1094;8115;25351;8325;26445
221120;201808;4211;12435;3860;11844;223;770;3267;9955;3490;10725
221130;201808;4756;12854;3645;10614;911;2590;1594;4698;2505;7288
221135;201808;1569;4385;1419;4181;46;178;1245;3616;1291;3794
221140;201808;1272;3119;1121;2901;10;39;1007;2542;1017;2581
221150;201808;1073;2701;859;2323;23;100;679;1720;702;1820
221160;201808;783;1963;693;1839;30;63;561;1485;591;1548
221170;201808;1000;2961;924;2832;25;87;781;2384;806;2471
230010;201808;3128;8465;2545;7422;137;468;1933;5519;2070;5987
230015;201808;2829;9486;2605;9054;262;1083;1808;6161;2070;7244
230020;201808;12725;40814;12209;39971;417;1754;10559;34139;10976;35893
230030;201808;12003;31888;10501;29737;209;726;9325;26316;9534;27042
230040;201808;4272;11362;3609;10259;108;440;2957;8264;3065;8704
230050;201808;2715;8699;2001;6892;420;1371;759;2615;1179;3986
230060;201808;2286;6415;1871;5602;44;187;1538;4508;1582;4695
230070;201808;3884;10824;3218;9486;163;555;2223;6552;2386;7107
230075;201808;8823;29088;8221;28002;376;1888;6813;22612;7189;24500
230080;201808;2726;6103;2160;5302;22;101;1950;4725;1972;4826
230090;201808;3979;10430;3459;9588;185;570;2697;7384;2882;7954
230100;201808;17001;46446;15283;43973;1558;4748;10524;30299;12082;35047
230110;201808;11487;35118;10186;32453;1832;5854;5726;18391;7558;24245
230120;201808;7248;20163;6400;18747;564;1514;4712;14071;5276;15585
230125;201808;3029;8284;2504;7408;92;328;1935;5684;2027;6012
230130;201808;5520;17521;4611;15529;425;1585;3073;10124;3498;11709
230140;201808;3395;10361;2897;9399;134;565;2156;6828;2290;7393
230150;201808;1562;4720;1327;4197;221;637;749;2466;970;3103
230160;201808;6227;16985;5457;15786;174;677;4592;13045;4766;13722
230170;201808;5795;17184;5054;15761;270;930;3765;11560;4035;12490
230180;201808;1597;4559;1365;4084;29;140;1076;3096;1105;3236
230185;201808;4033;12251;3513;11332;311;1097;2566;8296;2877;9393
230190;201808;12415;37276;10698;34008;1685;5540;5906;18932;7591;24472
230195;201808;5011;15006;4505;14136;302;1047;3570;11069;3872;12116
230200;201808;4816;13425;4191;12200;161;523;3323;9469;3484;9992
230205;201808;3899;12301;3537;11653;187;791;2709;8758;2896;9549
230210;201808;9603;24669;8229;22699;469;1501;6185;16871;6654;18372
230220;201808;12788;34027;11603;32125;489;1525;9759;26722;10248;28247
230230;201808;6707;20644;6056;19286;436;1475;4465;14107;4901;15582
230240;201808;12353;33522;11039;31385;394;1262;9180;25851;9574;27113
230250;201808;8659;25482;8531;25283;315;1177;6970;20203;7285;21380
230260;201808;13488;42841;12211;40301;1635;5648;7520;25075;9155;30723
230270;201808;7347;20642;5954;17991;552;1712;3979;12054;4531;13766
230280;201808;19904;55100;16737;49678;721;2915;13200;37910;13921;40825
230290;201808;4525;13066;3928;11846;387;1070;2920;8868;3307;9938
230300;201808;4282;12182;4058;11856;97;427;3606;10326;3703;10753
230310;201808;4577;13274;3937;12148;161;650;2851;8560;3012;9210
230320;201808;7473;21906;6535;20125;325;1260;5020;15180;5345;16440
230330;201808;4562;12767;3791;11283;190;607;2855;8366;3045;8973
230340;201808;3479;11200;2991;10185;281;1001;2081;7034;2362;8035
230350;201808;17757;50591;15934;47512;1062;3713;10642;31996;11704;35709
230360;201808;2760;7767;2247;6800;156;544;1562;4648;1718;5192
230365;201808;3016;7695;2544;6946;54;267;2142;5736;2196;6003
230370;201808;51387;151823;44607;141140;8884;28607;23611;77153;32495;105760
230380;201808;6276;17714;5033;15373;174;681;3723;11182;3897;11863
230390;201808;3204;9821;2827;9179;139;590;2160;6890;2299;7480
230393;201808;2899;9091;2450;8149;107;551;1897;6058;2004;6609
230395;201808;5518;15312;4848;14130;442;1258;3354;9879;3796;11137
230400;201808;5621;16042;5011;14990;163;738;3994;11538;4157;12276
230410;201808;14189;43037;11634;38001;1263;4303;7495;24583;8758;28886
230420;201808;24818;73054;21218;66151;2858;9455;12277;37962;15135;47417
230423;201808;4611;13880;4037;12707;117;516;3268;10087;3385;10603
230425;201808;5226;16701;4824;15832;468;1588;3478;11372;3946;12960
230426;201808;2531;6884;1923;5683;42;171;1481;4305;1523;4476
230427;201808;1827;5259;1260;3963;71;240;876;2649;947;2889
230428;201808;9350;26068;8316;24454;1221;3702;5027;14795;6248;18497
230430;201808;4418;13107;3727;11847;186;696;2846;8835;3032;9531
230435;201808;5353;14989;4623;13723;550;1668;2984;8868;3534;10536
230440;201808;378001;993684;319425;901518;48209;142468;183359;516324;231568;658792
230445;201808;4213;11390;3554;10224;218;626;2512;7085;2730;7711
230450;201808;3343;10168;2969;9512;206;829;2200;6915;2406;7744
230460;201808;2021;5874;1768;5444;79;317;1460;4468;1539;4785
230465;201808;3877;11174;3315;10135;107;481;2468;7265;2575;7746
230470;201808;10823;36943;9901;35149;878;3758;7347;25648;8225;29406
230480;201808;1363;4115;1168;3737;110;439;860;2636;970;3075
230490;201808;2264;6614;1973;6064;204;675;1204;3570;1408;4245
230495;201808;5678;17339;5049;16172;413;1667;3360;10553;3773;12220
230500;201808;8339;28493;7813;27450;383;1618;6202;21755;6585;23373
230510;201808;1582;5119;1174;4141;221;837;500;1743;721;2580
230520;201808;4241;12570;3804;11717;304;994;2731;8294;3035;9288
230523;201808;14276;43196;11780;37789;2869;9279;3216;10861;6085;20140
230526;201808;3748;11011;3207;10012;144;620;2486;7554;2630;8174
230530;201808;5153;16307;4464;15013;413;1510;3159;10632;3572;12142
230533;201808;4020;10429;3464;9410;116;320;2863;7715;2979;8035
230535;201808;5361;15165;4562;13738;296;896;3194;9759;3490;10655
230540;201808;15405;43629;13794;41163;317;1358;11981;35206;12298;36564
230550;201808;19322;53737;16190;48151;1878;5974;9817;29006;11695;34980
230560;201808;7436;19487;6186;17276;95;393;5166;14232;5261;14625
230565;201808;3046;8495;2535;7564;76;316;1956;5744;2032;6060
230570;201808;3461;8944;3025;8368;69;205;2578;7102;2647;7307
230580;201808;9705;27134;8680;25603;362;1290;7340;21448;7702;22738
230590;201808;8634;25533;7243;22867;554;1958;5160;15843;5714;17801
230600;201808;3576;9555;2706;7868;93;313;1819;5343;1912;5656
230610;201808;6335;18249;5698;17248;532;1545;4319;13176;4851;14721
230620;201808;2054;5705;1587;4738;137;436;969;2814;1106;3250
230625;201808;7657;22916;6686;20983;2091;6765;1895;6252;3986;13017
230630;201808;9937;30883;8858;28631;2246;6725;4067;14086;6313;20811
230640;201808;26395;82061;24231;78463;1679;6423;19171;61352;20850;67775
230650;201808;4844;13848;4226;12674;243;844;3276;9647;3519;10491
230655;201808;9022;31827;8623;31095;630;2573;6855;24825;7485;27398
230660;201808;6076;18164;5017;16157;185;976;4101;12876;4286;13852
230670;201808;5970;14806;4454;12234;182;565;3501;9381;3683;9946
230680;201808;2498;7120;2157;6473;198;589;1477;4448;1675;5037
230690;201808;6492;19965;5863;18611;555;1977;3597;11202;4152;13179
230700;201808;9126;24311;7946;22109;358;1196;6095;16465;6453;17661
230710;201808;6791;21533;5946;19801;551;2012;4328;14236;4879;16248
230720;201808;1868;5650;1551;4960;124;398;1045;3270;1169;3668
230725;201808;3580;11482;3174;10547;577;2049;1464;4764;2041;6813
230730;201808;52383;149026;43465;134582;10719;35540;15676;51090;26395;86630
230740;201808;5846;16804;5187;15682;150;617;4206;12570;4356;13187
230750;201808;8129;22413;6868;20295;204;811;5449;15645;5653;16456
230760;201808;11008;30315;9856;28422;712;2365;7341;20687;8053;23052
230763;201808;4348;12609;3765;11500;159;659;2972;8777;3131;9436
230765;201808;37911;109303;32436;99742;6832;22016;13752;42716;20584;64732
230770;201808;25077;65740;21556;60829;2836;8390;13572;38427;16408;46817
230780;201808;5819;21091;5488;20411;894;3348;3257;12471;4151;15819
230790;201808;2869;8548;2586;8064;148;585;1965;5989;2113;6574
230800;201808;7402;24639;6716;23177;878;3401;4011;13622;4889;17023
230810;201808;11389;35004;10332;33222;466;1843;8035;25325;8501;27168
230820;201808;3085;10295;2668;9355;290;1191;1653;5595;1943;6786
230830;201808;7272;20771;6287;18981;171;738;5146;15193;5317;15931
230835;201808;4015;9880;3139;8485;104;328;2577;6831;2681;7159
230837;201808;3040;9795;2625;8979;140;683;2016;6667;2156;7350
230840;201808;8779;26581;7710;24777;550;1976;5915;18965;6465;20941
230850;201808;8944;27053;7940;25037;480;1737;5714;17841;6194;19578
230860;201808;4975;13303;4235;12176;126;453;3640;10336;3766;10789
230870;201808;16415;41266;14252;37864;520;1532;11528;30440;12048;31972
230880;201808;1999;6300;1861;6064;67;350;1483;4678;1550;5028
230890;201808;4295;14343;4005;13772;361;1373;2927;9948;3288;11321
230900;201808;2939;8948;2493;8028;243;834;1629;5119;1872;5953
230910;201808;2888;8173;2384;7292;79;382;1907;5697;1986;6079
230920;201808;4343;12528;3859;11787;157;630;3148;9461;3305;10091
230930;201808;6313;18369;5313;16396;399;1314;3657;11221;4056;12535
230940;201808;7570;20376;6714;19008;215;681;5614;15754;5829;16435
230945;201808;6459;18870;5626;17174;409;1376;3908;11899;4317;13275
230950;201808;6091;15712;5604;15103;140;314;5056;13840;5196;14154
230960;201808;12944;38874;11748;36577;1912;6059;6073;19213;7985;25272
230970;201808;12684;35949;11015;33231;2129;6667;5583;16990;7712;23657
230980;201808;2621;7903;2299;7308;470;1433;1307;4346;1777;5779
230990;201808;1649;4765;1383;4232;79;329;961;2808;1040;3137
231000;201808;2450;6633;2044;5789;83;238;1478;4105;1561;4343
231010;201808;3095;7893;2574;7008;119;404;2068;5469;2187;5873
231020;201808;7630;24972;7003;23600;1280;4105;4188;14620;5468;18725
231025;201808;7105;20655;6332;19344;897;2789;4266;13137;5163;15926
231030;201808;6822;21080;5543;18323;987;3292;2972;9851;3959;13143
231040;201808;3069;9033;2664;8272;111;449;2071;6290;2182;6739
231050;201808;11521;30862;9342;26909;682;1943;6935;19665;7617;21608
231060;201808;2479;7445;2260;7065;87;344;1847;5748;1934;6092
231070;201808;7757;23255;6679;21251;971;3165;3978;12692;4949;15857
231080;201808;3814;11285;3431;10600;130;645;2702;8062;2832;8707
231085;201808;5676;15323;4975;14438;326;952;3773;11070;4099;12022
231090;201808;4184;11297;3190;9283;113;429;2248;6353;2361;6782
231095;201808;2036;6347;1707;5579;158;576;1193;3847;1351;4423
231100;201808;2881;8686;2465;7910;145;498;1859;5957;2004;6455
231110;201808;3331;10369;3218;10165;162;642;2421;7521;2583;8163
231120;201808;2032;6299;1758;5787;111;428;1191;3875;1302;4303
231123;201808;1850;4954;1568;4429;72;215;1200;3352;1272;3567
231126;201808;5515;15562;4441;13446;214;743;3266;9666;3480;10409
231130;201808;18735;52752;16368;49381;1505;5282;11481;34466;12986;39748
231135;201808;4134;11803;3480;10572;162;609;2521;7510;2683;8119
231140;201808;16407;47917;13714;42973;858;3538;9570;29033;10428;32571
231150;201808;5212;14900;4284;13021;756;2258;2027;6305;2783;8563
231160;201808;5730;18169;5250;17223;1086;3377;2877;9786;3963;13163
231170;201808;4261;12930;3534;11438;241;917;2420;7577;2661;8494
231180;201808;13244;38769;11345;34633;2743;8458;4802;14718;7545;23176
231190;201808;3719;10762;3242;9846;138;571;2562;7508;2700;8079
231195;201808;4441;14239;3832;12935;208;934;2887;9479;3095;10413
231200;201808;7641;24737;6698;22729;312;1560;5129;16799;5441;18359
231210;201808;4539;13961;3963;12914;204;826;3046;9681;3250;10507
231220;201808;11521;31175;9293;26814;548;1641;6791;19028;7339;20669
231230;201808;8940;28772;8002;27183;558;2185;5970;20335;6528;22520
231240;201808;11175;33697;10050;31400;1715;5405;5883;18565;7598;23970
231250;201808;2005;5345;1350;3862;104;313;793;2211;897;2524
231260;201808;3137;9286;2777;8690;312;984;1871;5981;2183;6965
231270;201808;6263;16771;5354;15254;160;666;4164;11557;4324;12223
231280;201808;1594;5079;1504;4902;143;486;1120;3647;1263;4133
231290;201808;35351;109270;30930;100037;5572;18604;14850;47760;20422;66364
231300;201808;3844;11003;3134;9551;262;872;2042;6102;2304;6974
231310;201808;7047;19144;5788;16651;613;1750;3777;10738;4390;12488
231320;201808;7333;20927;5895;18175;130;599;4601;13982;4731;14581
231325;201808;2434;6881;2045;6224;365;1079;1174;3638;1539;4717
231330;201808;9739;30181;8179;26970;1644;5358;4268;14426;5912;19784
231335;201808;5572;14946;4751;13560;105;478;4121;11537;4226;12015
231340;201808;16839;53237;15303;50638;1122;3872;11604;38685;12726;42557
231350;201808;15264;42533;13934;40663;344;1238;12506;36201;12850;37439
231355;201808;4374;13431;3937;12652;218;824;3051;9727;3269;10551
231360;201808;7218;22438;6374;20941;462;1674;4755;15595;5217;17269
231370;201808;2250;6107;1798;5302;40;121;1388;4063;1428;4184
231375;201808;4273;13654;3910;12984;158;719;3253;10628;3411;11347
231380;201808;5682;15739;5269;15213;198;514;4448;13075;4646;13589
231390;201808;3252;9763;2937;9221;195;746;2148;6551;2343;7297
231395;201808;3823;11741;3237;10767;583;1943;1801;6085;2384;8028
231400;201808;8759;26009;7847;24287;364;1444;6115;18564;6479;20008
231410;201808;14804;46735;13207;44017;799;2994;10348;34081;11147;37075
240010;201808;2434;6750;1908;5736;193;661;1208;3532;1401;4193
240020;201808;10940;32379;9576;29838;896;3249;6242;19127;7138;22376
240030;201808;2626;6933;2470;6700;127;368;2144;5747;2271;6115
240040;201808;811;2320;669;2050;13;69;505;1491;518;1560
240050;201808;3131;8464;2634;7555;61;189;2091;5884;2152;6073
240060;201808;1365;3733;1163;3358;33;110;948;2690;981;2800
240070;201808;2105;6369;1949;6039;205;679;1465;4480;1670;5159
240080;201808;2655;7377;2337;6814;76;299;1835;5265;1911;5564
240090;201808;2177;5549;1801;4898;28;90;1496;4010;1524;4100
240100;201808;8842;23015;7332;20146;370;1137;5666;15149;6036;16286
240110;201808;4277;12766;3778;11821;279;1027;2678;8217;2957;9244
240120;201808;3507;9617;2602;8561;232;929;1713;5764;1945;6693
240130;201808;3321;7376;2850;6694;60;185;2592;5983;2652;6168
240140;201808;2009;6073;1710;5492;180;676;1131;3546;1311;4222
240145;201808;6081;17747;5177;16159;732;2432;3289;10339;4021;12771
240150;201808;849;2558;778;2414;60;223;605;1814;665;2037
240160;201808;1389;4296;1197;3911;74;332;864;2813;938;3145
240165;201808;862;2458;743;2227;74;229;559;1671;633;1900
240170;201808;2311;6615;1979;6006;229;780;1267;3722;1496;4502
240180;201808;3004;8829;2418;7690;470;1457;1309;4315;1779;5772
240185;201808;1225;4060;1117;3879;63;283;917;3151;980;3434
240190;201808;984;2992;873;2809;29;128;715;2269;744;2397
240200;201808;10222;27552;8605;24727;1233;3707;4548;13050;5781;16757
240210;201808;2804;7417;2531;6967;54;219;2128;5670;2182;5889
240220;201808;7144;22574;6496;21565;492;2061;4881;16001;5373;18062
240230;201808;5712;14788;4691;13063;242;658;3743;10411;3985;11069
240240;201808;2178;7364;1493;5590;136;452;717;2946;853;3398
240250;201808;2765;7683;2531;7338;150;408;2043;5959;2193;6367
240260;201808;12937;39883;11432;37243;1709;5501;7078;23975;8787;29476
240270;201808;2195;6588;1986;6262;110;310;1606;5179;1716;5489
240280;201808;1600;4203;1376;3868;46;135;1134;3133;1180;3268
240290;201808;1186;3551;988;3120;39;191;681;2000;720;2191
240300;201808;2132;5610;1554;4479;88;276;988;2759;1076;3035
240310;201808;8637;23388;7182;20839;896;2707;4008;11566;4904;14273
240320;201808;1989;5512;1486;4514;26;119;1130;3273;1156;3392
240325;201808;28516;79571;22499;68895;5878;18868;7195;23003;13073;41871
240330;201808;1483;4300;1217;3760;45;159;861;2553;906;2712
240340;201808;1853;4551;1519;4034;57;151;1238;3229;1295;3380
240350;201808;1996;5410;1876;5265;32;117;1680;4724;1712;4841
240360;201808;7433;21648;6625;20344;1121;3389;3986;12811;5107;16200
240370;201808;1958;5310;1542;4468;105;324;1038;2949;1143;3273
240375;201808;872;2243;745;1997;29;116;590;1502;619;1618
240380;201808;2231;6442;1635;5097;150;480;975;2982;1125;3462
240390;201808;928;2442;685;1938;15;43;471;1253;486;1296
240400;201808;1353;3694;1094;3199;35;137;789;2238;824;2375
240410;201808;527;1683;459;1524;52;210;277;893;329;1103
240420;201808;4508;16521;4052;15494;621;2872;2244;8346;2865;11218
240430;201808;3231;8829;2797;7984;240;800;2035;5599;2275;6399
240440;201808;2475;5722;2101;5193;156;389;1605;3912;1761;4301
240450;201808;4121;11679;3365;10263;344;1181;2002;5916;2346;7097
240460;201808;2891;8447;2695;8140;237;753;2177;6576;2414;7329
240470;201808;3472;10685;2746;9181;333;1157;1595;5333;1928;6490
240480;201808;532;1473;384;1173;34;108;184;558;218;666
240485;201808;2052;6091;1715;5418;186;613;1090;3460;1276;4073
240490;201808;1742;4369;1398;3771;46;97;1141;3098;1187;3195
240500;201808;2157;5845;1896;5465;51;184;1624;4637;1675;4821
240510;201808;1628;4425;1485;4216;74;243;1265;3530;1339;3773
240520;201808;1270;3338;1065;3047;36;133;877;2455;913;2588
240530;201808;1908;5952;1761;5684;113;421;1398;4488;1511;4909
240540;201808;2140;5534;1912;5187;85;239;1636;4420;1721;4659
240550;201808;651;1847;597;1745;32;95;461;1328;493;1423
240560;201808;3218;8651;2766;8052;288;752;2030;6025;2318;6777
240570;201808;2819;7491;1935;5532;265;819;878;2278;1143;3097
240580;201808;7351;22067;6774;21070;502;1694;5530;17127;6032;18821
240590;201808;677;1836;586;1674;16;58;452;1267;468;1325
240600;201808;1697;4696;1262;3785;77;268;821;2365;898;2633
240610;201808;4296;11903;3649;10707;167;573;2732;7870;2899;8443
240615;201808;1034;2929;836;2510;75;261;558;1591;633;1852
240620;201808;1811;5206;1577;4767;122;323;1258;3823;1380;4146
240630;201808;2001;5886;1803;5538;147;385;1252;3970;1399;4355
240640;201808;885;2482;720;2200;37;159;528;1559;565;1718
240650;201808;3735;10656;3353;10009;214;649;2636;7837;2850;8486
240660;201808;2721;7421;2463;7089;67;255;2226;6312;2293;6567
240670;201808;2395;6911;2002;6094;158;525;1290;3818;1448;4343
240680;201808;1559;4304;1256;3764;68;260;926;2683;994;2943
240690;201808;869;2261;692;1948;17;62;564;1534;581;1596
240700;201808;2343;6848;1965;6157;73;313;1561;4783;1634;5096
240710;201808;15511;41410;13296;37539;2433;6703;7510;21645;9943;28348
240720;201808;5074;13355;4427;12325;567;1708;2937;8001;3504;9709
240725;201808;1029;3046;807;2552;32;116;557;1716;589;1832
240730;201808;2025;5857;1752;5304;94;315;1358;4040;1452;4355
240740;201808;1815;4983;1529;4443;61;271;1148;3142;1209;3413
240750;201808;2237;7571;1900;6851;330;1270;1011;3701;1341;4971
240760;201808;1481;3703;1054;3025;63;153;811;2351;874;2504
240770;201808;2951;8526;2636;8069;132;523;2167;6509;2299;7032
240780;201808;5395;14731;4259;12836;538;1595;2602;8081;3140;9676
240790;201808;820;2406;689;2144;18;74;516;1570;534;1644
240800;201808;35565;95385;30447;87106;4782;14315;15304;43896;20086;58211
240810;201808;78038;214220;69545;199483;14314;41236;38211;110332;52525;151568
240820;201808;5436;16835;4755;15633;873;2965;2691;9065;3564;12030
240830;201808;8382;24957;7753;23950;306;1286;6425;19521;6731;20807
240840;201808;1106;2869;902;2500;60;170;652;1749;712;1919
240850;201808;1213;3497;896;2777;47;162;536;1632;583;1794
240860;201808;1200;3336;932;2819;19;87;710;2051;729;2138
240870;201808;1147;2908;903;2491;75;214;632;1710;707;1924
240880;201808;1264;4032;1169;3858;90;334;930;3033;1020;3367
240890;201808;4495;12478;3510;10553;579;1859;1751;5141;2330;7000
240895;201808;2590;8487;2342;8117;197;728;1921;6674;2118;7402
240910;201808;3082;8772;2674;7958;69;257;2218;6489;2287;6746
240920;201808;812;2453;694;2222;74;237;382;1243;456;1480
240930;201808;3522;8417;3008;7775;153;243;2430;6474;2583;6717
240933;201808;1782;4286;1468;3807;38;137;1263;3207;1301;3344
240940;201808;6067;15216;4850;13147;265;785;3555;9337;3820;10122
240950;201808;903;2823;802;2614;40;180;633;1998;673;2178
240960;201808;709;2193;634;2042;43;162;472;1482;515;1644
240970;201808;1736;4692;1447;4145;60;247;1200;3302;1260;3549
240980;201808;2877;9100;2642;8657;208;798;2002;6453;2210;7251
240990;201808;2494;7345;2294;6923;289;930;1625;4813;1914;5743
241000;201808;908;2466;753;2162;39;110;531;1515;570;1625
241010;201808;2671;8773;2482;8374;227;950;1811;5947;2038;6897
241020;201808;2006;5484;1497;4424;147;424;951;2766;1098;3190
241025;201808;1711;4999;1407;4409;80;269;918;2868;998;3137
241030;201808;2419;7759;2015;6901;210;753;1339;4566;1549;5319
241040;201808;2227;7187;2006;6814;113;510;1588;5350;1701;5860
241050;201808;1248;3554;1035;3141;41;141;791;2346;832;2487
241060;201808;719;2038;636;1873;49;152;450;1312;499;1464
241070;201808;630;1777;559;1647;20;74;452;1278;472;1352
241080;201808;1089;3141;845;2651;10;43;638;1979;648;2022
241090;201808;1993;5856;1605;5181;61;300;1271;4032;1332;4332
241100;201808;1096;3183;903;2744;46;147;630;1845;676;1992
241105;201808;1030;3141;858;2811;278;931;297;1006;575;1937
241110;201808;876;2577;684;2150;35;128;453;1369;488;1497
241120;201808;7032;20703;6184;19192;1136;3385;3453;11240;4589;14625
241140;201808;3202;8560;2628;7430;155;458;1948;5337;2103;5795
241142;201808;734;2032;551;1661;32;102;320;919;352;1021
241150;201808;5528;15210;4942;14208;191;721;4006;11250;4197;11971
241160;201808;1542;4623;1359;4321;152;424;994;3221;1146;3645
241170;201808;1250;3270;1104;3019;44;150;917;2407;961;2557
241180;201808;941;2520;700;2039;73;222;419;1193;492;1415
241190;201808;1099;2961;902;2560;26;103;661;1786;687;1889
241200;201808;18410;49672;15943;45913;3205;9428;8466;24701;11671;34129
241210;201808;1334;3719;1027;3094;98;316;637;1888;735;2204
241220;201808;8439;26082;7471;24354;2103;6826;3224;11099;5327;17925
241230;201808;2844;7806;2576;7358;104;381;2172;6058;2276;6439
241240;201808;1164;3382;689;2250;49;188;326;1057;375;1245
241250;201808;5415;16234;4540;14526;190;922;3445;10562;3635;11484
241255;201808;1866;6332;1660;5878;141;604;1165;4032;1306;4636
241260;201808;4706;12648;3760;11039;100;465;2927;8363;3027;8828
241270;201808;1725;5116;1464;4598;132;494;1057;3255;1189;3749
241280;201808;1963;5190;1763;4840;73;221;1503;4084;1576;4305
241290;201808;3296;8406;2577;7203;99;373;1986;5377;2085;5750
241300;201808;1407;3890;1164;3448;43;165;789;2257;832;2422
241310;201808;1939;5171;1687;4785;32;117;1436;4062;1468;4179
241320;201808;978;3214;818;2879;99;400;501;1748;600;2148
241330;201808;1720;4516;1373;4087;26;110;1188;3534;1214;3644
241335;201808;2947;8493;2679;8001;93;334;2280;6715;2373;7049
241340;201808;1629;4836;1311;4114;287;933;585;1806;872;2739
241350;201808;1906;5699;1710;5331;118;404;1296;3971;1414;4375
241355;201808;1265;3513;1057;3125;29;120;838;2442;867;2562
241360;201808;2035;5351;1598;4487;62;202;1154;3114;1216;3316
241370;201808;1322;3742;1046;3186;74;263;693;2014;767;2277
241380;201808;650;1799;521;1547;69;206;311;928;380;1134
241390;201808;2656;8199;2439;7840;218;682;1875;6080;2093;6762
241400;201808;3497;9901;3158;9401;196;682;2585;7602;2781;8284
241410;201808;2235;6849;1919;6218;377;1271;1057;3419;1434;4690
241415;201808;1597;4763;1344;4289;93;327;968;3033;1061;3360
241420;201808;2109;7084;1823;6542;501;1937;739;2665;1240;4602
241430;201808;482;1386;361;1116;25;88;231;695;256;783
241440;201808;6863;22572;6207;21348;475;1935;4767;16176;5242;18111
241445;201808;1034;2764;954;2664;18;44;883;2514;901;2558
241450;201808;2747;7056;2454;6602;286;720;1812;4904;2098;5624
241460;201808;3500;9774;2969;8641;183;606;2106;5943;2289;6549
241470;201808;1395;3712;1110;3293;41;149;931;2740;972;2889
241475;201808;1192;3479;933;2955;33;184;691;2065;724;2249
241480;201808;2645;8552;2304;7841;829;2807;673;2636;1502;5443
241490;201808;647;1600;510;1384;27;84;354;926;381;1010
241500;201808;795;2352;689;2210;14;65;605;1931;619;1996
250010;201808;2578;7852;2168;6975;76;321;1608;5029;1684;5350
250020;201808;1579;4365;1159;3529;61;176;815;2442;876;2618
250030;201808;6600;18564;6012;17666;420;1344;4772;13789;5192;15133
250040;201808;3741;12048;3399;11384;258;1028;2503;8210;2761;9238
250050;201808;3351;9508;3084;9104;192;660;2497;7246;2689;7906
250053;201808;1144;3354;1047;3205;80;265;783;2402;863;2667
250057;201808;641;2398;611;2355;10;53;570;2211;580;2264
250060;201808;5060;14052;4671;13557;415;1168;3722;10955;4137;12123
250070;201808;3731;10970;3404;10362;63;296;2706;7986;2769;8282
250073;201808;704;1989;590;1810;10;39;482;1428;492;1467
250077;201808;2142;5950;1626;5063;94;322;1192;3681;1286;4003
250080;201808;4297;11608;3914;11063;95;360;3378;9379;3473;9739
250090;201808;2829;7400;2578;7033;82;247;2207;5950;2289;6197
250100;201808;3633;11363;3384;10891;154;641;2801;8754;2955;9395
250110;201808;4623;13256;4271;12733;380;1342;3380;9816;3760;11158
250115;201808;517;1515;452;1403;11;55;344;1031;355;1086
250120;201808;1634;5045;1436;4707;52;243;1149;3720;1201;3963
250130;201808;5199;15140;4515;14064;106;567;3730;11393;3836;11960
250135;201808;1092;3072;1000;2927;13;54;906;2641;919;2695
250140;201808;2035;6343;1955;6228;93;427;1708;5344;1801;5771
250150;201808;4536;14901;4184;14224;184;891;3397;11267;3581;12158
250153;201808;1432;3728;1203;3400;31;119;990;2737;1021;2856
250157;201808;1694;5196;1530;4862;138;451;1152;3664;1290;4115
250160;201808;3744;9647;3052;8694;38;122;2809;7983;2847;8105
250170;201808;1664;4492;1501;4242;42;165;1302;3621;1344;3786
250180;201808;17014;44789;15256;42401;894;2885;11924;32487;12818;35372
250190;201808;3844;10817;3407;10102;411;1143;2355;6958;2766;8101
250200;201808;1740;4990;1490;4587;54;194;1284;3937;1338;4131
250205;201808;726;2457;693;2400;20;107;590;2007;610;2114
250210;201808;1483;4614;1354;4403;55;269;1088;3450;1143;3719
250215;201808;1486;4288;1252;3888;64;220;800;2478;864;2698
250220;201808;689;1977;570;1796;27;102;423;1303;450;1405
250230;201808;1554;3665;1150;3033;24;86;932;2375;956;2461
250240;201808;2097;6603;1936;6324;43;185;1669;5380;1712;5565
250250;201808;4329;12497;3856;11809;107;378;3284;10008;3391;10386
250260;201808;1660;4697;1418;4278;45;156;1136;3411;1181;3567
250270;201808;1172;3663;1058;3517;77;260;801;2752;878;3012
250280;201808;3167;9167;2767;8536;101;331;2230;6860;2331;7191
250290;201808;1563;4210;1363;3922;25;71;1154;3326;1179;3397
250300;201808;5182;14546;4908;14211;229;986;4155;11617;4384;12603
250310;201808;1100;3136;950;2865;33;110;738;2188;771;2298
250320;201808;9800;25439;8859;24260;478;1448;7529;20421;8007;21869
250330;201808;2280;6740;1959;6277;142;486;1556;4925;1698;5411
250340;201808;1049;2849;933;2681;8;27;819;2320;827;2347
250350;201808;3982;11095;3621;10597;146;373;3082;9193;3228;9566
250355;201808;1919;5979;1768;5774;35;186;1607;5219;1642;5405
250360;201808;1758;4977;1611;4750;42;144;1341;3923;1383;4067
250370;201808;11536;31808;10056;29697;418;1550;8412;24487;8830;26037
250375;201808;990;2821;894;2689;13;50;822;2484;835;2534
250380;201808;1548;4187;1453;4064;44;186;1231;3303;1275;3489
250390;201808;1737;4556;1460;4105;170;449;1028;2945;1198;3394
250400;201808;62976;162379;47146;137024;13345;40575;15949;48254;29294;88829
250403;201808;1544;4697;1433;4557;122;552;1080;3285;1202;3837
250407;201808;1192;3098;1016;2836;73;147;759;2156;832;2303
250410;201808;551;1579;487;1465;5;30;420;1236;425;1266
250415;201808;1843;5331;1641;4992;58;218;1349;4069;1407;4287
250420;201808;1185;3421;1077;3272;19;73;1015;3080;1034;3153
250430;201808;5979;15209;5248;14168;166;541;4427;11743;4593;12284
250435;201808;1333;3915;1173;3638;34;148;925;2801;959;2949
250440;201808;4292;11928;3856;11325;90;326;3364;9787;3454;10113
250450;201808;1768;4894;1511;4548;35;151;1270;3782;1305;3933
250460;201808;6903;19224;6296;18396;375;1124;5269;15433;5644;16557
250470;201808;1485;3843;1236;3484;66;212;959;2644;1025;2856
250480;201808;3591;10420;3312;10086;30;127;3069;9395;3099;9522
250485;201808;701;1621;507;1345;29;70;376;958;405;1028
250490;201808;4473;11752;4093;11276;223;748;3477;9442;3700;10190
250500;201808;1864;5316;1674;4999;82;271;1377;4099;1459;4370
250510;201808;5178;13386;4557;12564;80;267;4133;11381;4213;11648
250520;201808;1743;4911;1530;4596;164;538;1058;3131;1222;3669
250523;201808;2074;5301;1895;5077;67;298;1657;4307;1724;4605
250527;201808;1639;4348;1512;4194;39;126;1359;3772;1398;3898
250530;201808;574;1622;506;1525;16;60;450;1351;466;1411
250535;201808;1291;3892;1195;3704;37;176;981;2959;1018;3135
250540;201808;2648;6593;2262;6149;61;171;1996;5440;2057;5611
250550;201808;795;2608;719;2480;26;123;577;1932;603;2055
250560;201808;1593;4557;1449;4355;49;172;1230;3616;1279;3788
250570;201808;2514;7697;2209;7134;76;345;1772;5580;1848;5925
250580;201808;1022;2693;937;2568;52;177;777;2084;829;2261
250590;201808;773;2286;703;2181;19;91;605;1846;624;1937
250600;201808;7145;19907;6497;18925;345;974;5484;15992;5829;16966
250610;201808;2888;8239;2662;7910;134;484;2222;6520;2356;7004
250620;201808;668;1875;593;1731;22;101;469;1322;491;1423
250625;201808;2479;7353;2289;7055;53;258;1951;5869;2004;6127
250630;201808;9177;26605;7882;24160;988;3212;5141;15406;6129;18618
250640;201808;3232;9473;3014;9168;104;487;2548;7525;2652;8012
250650;201808;845;2142;722;1976;35;107;603;1607;638;1714
250660;201808;1578;4059;1399;3814;40;105;1218;3273;1258;3378
250670;201808;2220;7129;2095;6913;53;273;1825;5880;1878;6153
250680;201808;5521;13336;5013;12760;122;441;4537;11275;4659;11716
250690;201808;6339;15127;5772;14397;144;355;5229;12943;5373;13298
250700;201808;4125;11901;3722;11271;354;1121;2872;8632;3226;9753
250710;201808;4250;12546;3743;11857;299;1055;2825;8965;3124;10020
250720;201808;2658;7135;2423;6792;42;189;2178;6034;2220;6223
250730;201808;3815;10488;3437;9982;148;547;2892;8169;3040;8716
250740;201808;1862;4894;1553;4457;114;377;1262;3549;1376;3926
250750;201808;93121;244987;82620;229782;7901;24128;59292;161945;67193;186073
250760;201808;2284;6046;2015;5622;130;388;1555;4230;1685;4618
250770;201808;3611;11571;3324;11199;252;1005;2506;8342;2758;9347
250780;201808;1654;4625;1402;4154;97;324;1030;2985;1127;3309
250790;201808;2275;7043;2065;6715;286;1003;1360;4399;1646;5402
250800;201808;2369;6470;2073;6003;104;234;1728;5033;1832;5267
250810;201808;1195;3312;995;3021;28;93;859;2620;887;2713
250820;201808;1746;5419;1698;5351;54;228;1560;4859;1614;5087
250830;201808;5099;15899;4566;14797;340;1317;3299;10439;3639;11756
250840;201808;793;2544;686;2318;18;81;502;1697;520;1778
250850;201808;1813;5489;1630;5177;46;238;1370;4228;1416;4466
250855;201808;950;2805;827;2599;68;246;614;1890;682;2136
250860;201808;3009;9314;2512;8450;441;1575;1359;4634;1800;6209
250870;201808;1037;2890;891;2625;46;171;726;2107;772;2278
250880;201808;1485;4002;1236;3628;144;432;845;2484;989;2916
250890;201808;9100;25660;8527;24861;537;2131;7016;19763;7553;21894
250900;201808;2670;7948;2317;7285;96;354;1919;5911;2015;6265
250905;201808;2153;6291;2041;6135;56;216;1854;5533;1910;5749
250910;201808;5335;14163;4608;13251;117;419;4010;11517;4127;11936
250915;201808;1851;4663;1428;4223;16;42;1323;3982;1339;4024
250920;201808;3051;8348;2825;7978;292;767;2128;5967;2420;6734
250930;201808;2068;5762;1921;5549;70;285;1648;4641;1718;4926
250933;201808;1087;3372;972;3151;27;145;740;2318;767;2463
250937;201808;675;1910;567;1713;31;109;439;1329;470;1438
250939;201808;1635;4564;1456;4278;55;203;1180;3399;1235;3602
250940;201808;3701;10413;3376;9920;58;244;2940;8566;2998;8810
250950;201808;1505;4053;1266;3750;31;136;1104;3224;1135;3360
250960;201808;1053;3185;956;3028;33;158;780;2384;813;2542
250970;201808;7983;21514;6933;19798;392;1285;5393;15178;5785;16463
250980;201808;2378;6583;2176;6221;60;245;1827;5085;1887;5330
250990;201808;1788;5828;1597;5426;83;390;1220;4061;1303;4451
251000;201808;2027;5780;1690;5238;31;138;1429;4378;1460;4516
251010;201808;2548;7369;2340;7046;36;153;2126;6381;2162;6534
251020;201808;1632;4434;1526;4305;34;118;1403;3926;1437;4044
251030;201808;949;2621;830;2393;38;117;600;1681;638;1798
251040;201808;1787;5281;1547;4864;59;282;1259;3843;1318;4125
251050;201808;1065;2945;885;2604;62;207;651;1846;713;2053
251060;201808;1017;2233;764;1905;12;53;641;1563;653;1616
251065;201808;412;1146;341;1047;15;51;254;741;269;792
251070;201808;727;2050;639;1937;12;45;555;1668;567;1713
251080;201808;17985;47651;15077;43305;2198;6644;9511;27551;11709;34195
251090;201808;2685;7890;2308;7184;71;275;1862;5735;1933;6010
251100;201808;797;2476;709;2326;37;173;531;1658;568;1831
251110;201808;1643;4573;1441;4196;50;136;1129;3265;1179;3401
251120;201808;6619;20192;5872;19122;276;1177;4645;14980;4921;16157
251130;201808;3620;8843;3306;8478;192;521;2932;7483;3124;8004
251140;201808;4084;11798;3753;11328;106;421;3137;9387;3243;9808
251150;201808;2541;7638;2338;7324;123;549;1919;5815;2042;6364
251160;201808;1966;6108;1789;5820;117;406;1483;4792;1600;5198
251170;201808;1477;4211;1337;4050;43;152;1185;3575;1228;3727
251180;201808;2451;6913;2109;6419;190;650;1439;4323;1629;4973
251190;201808;4292;11450;4050;11169;63;268;3730;10108;3793;10376
251200;201808;3927;12256;3640;11889;88;375;3256;10666;3344;11041
251203;201808;906;3012;871;2937;38;175;672;2195;710;2370
251207;201808;997;2931;810;2590;27;140;576;1777;603;1917
251210;201808;6931;18786;5892;17447;260;744;4801;14365;5061;15109
251220;201808;1111;2810;908;2526;46;126;715;2001;761;2127
251230;201808;4497;12469;3993;11717;155;563;3292;9449;3447;10012
251240;201808;3320;9489;2874;8832;176;577;2204;6649;2380;7226
251250;201808;9412;26362;8529;24993;746;2334;6370;18120;7116;20454
251260;201808;456;1397;416;1320;14;64;324;1001;338;1065
251270;201808;3899;12620;3590;12207;118;538;3114;10600;3232;11138
251272;201808;1288;3590;1197;3458;36;144;1065;3030;1101;3174
251274;201808;871;2536;720;2260;49;206;501;1487;550;1693
251275;201808;1182;3353;1032;3102;43;180;770;2209;813;2389
251276;201808;1232;3387;1122;3246;39;172;950;2678;989;2850
251278;201808;528;1544;485;1461;40;102;368;1127;408;1229
251280;201808;2148;6074;1948;5759;51;213;1626;4694;1677;4907
251290;201808;5403;13864;5127;13498;243;870;4427;11233;4670;12103
251300;201808;774;2403;727;2333;13;54;621;1991;634;2045
251310;201808;2617;7692;2409;7358;79;356;1995;5969;2074;6325
251315;201808;1618;5212;1507;5019;75;281;1182;3882;1257;4163
251320;201808;1577;4249;1130;3488;36;128;839;2582;875;2710
251330;201808;1882;4635;1565;4254;27;97;1446;3934;1473;4031
251335;201808;1111;3727;1032;3606;34;143;893;3088;927;3231
251340;201808;3510;9299;2921;8512;122;410;2196;6332;2318;6742
251350;201808;1027;3135;945;2999;34;160;806;2484;840;2644
251360;201808;1742;5146;1467;4779;25;122;1288;4219;1313;4341
251365;201808;704;2025;566;1730;15;52;439;1341;454;1393
251370;201808;21143;60859;19751;58925;2193;6931;14211;42450;16404;49381
251380;201808;1173;3456;1045;3248;22;115;895;2691;917;2806
251385;201808;701;1834;556;1574;24;78;416;1123;440;1201
251390;201808;5909;18458;5189;17124;856;2999;3001;9775;3857;12774
251392;201808;910;2591;783;2377;22;104;616;1829;638;1933
251394;201808;614;1925;526;1769;24;100;405;1345;429;1445
251396;201808;682;1890;594;1741;29;83;415;1205;444;1288
251398;201808;838;2212;628;1843;15;65;488;1402;503;1467
251400;201808;1111;2899;920;2637;33;118;718;1999;751;2117
251410;201808;1527;3682;1292;3353;24;103;1117;2818;1141;2921
251420;201808;1793;4944;1511;4613;52;214;1220;3647;1272;3861
251430;201808;1491;4751;1340;4501;43;201;1169;3885;1212;4086
251440;201808;1093;3155;899;2788;19;69;730;2260;749;2329
251445;201808;1455;4258;1370;4135;70;299;1146;3334;1216;3633
251450;201808;4179;12781;3841;12298;84;372;3284;10418;3368;10790
251455;201808;907;2810;827;2663;37;162;639;2011;676;2173
251460;201808;861;2532;772;2389;32;119;640;1986;672;2105
251465;201808;412;1253;354;1126;15;69;276;855;291;924
251470;201808;1144;3216;876;2652;80;267;540;1572;620;1839
251480;201808;916;2479;780;2252;26;114;586;1629;612;1743
251490;201808;1799;4955;1471;4493;69;214;1080;3295;1149;3509
251500;201808;1780;5416;1683;5243;73;282;1447;4448;1520;4730
251510;201808;2354;7607;2103;7071;169;673;1426;4680;1595;5353
251520;201808;925;2494;710;2060;69;188;464;1330;533;1518
251530;201808;12787;32513;11201;30471;137;706;10067;26942;10204;27648
251540;201808;2689;8191;2497;7822;121;454;2025;6215;2146;6669
251550;201808;3483;8612;2805;7733;73;223;2418;6656;2491;6879
251560;201808;559;1712;505;1625;83;283;326;1003;409;1286
251570;201808;878;2569;737;2286;19;96;566;1678;585;1774
251580;201808;1822;4563;1636;4298;90;265;1402;3592;1492;3857
251590;201808;1520;4086;1340;3860;51;171;1103;3100;1154;3271
251593;201808;909;2727;839;2616;103;344;525;1590;628;1934
251597;201808;1950;5754;1856;5633;33;127;1665;4992;1698;5119
251600;201808;6157;17183;5557;16271;172;565;4700;13552;4872;14117
251610;201808;3166;9174;2760;8424;306;895;1921;5913;2227;6808
251615;201808;1142;3007;931;2653;25;101;739;2035;764;2136
251620;201808;16810;40927;13820;37421;192;475;12095;33731;12287;34206
251630;201808;4457;10907;3672;9828;201;583;2900;7700;3101;8283
251640;201808;2005;5844;1857;5567;56;256;1608;4704;1664;4960
251650;201808;3974;10755;3553;10218;158;504;3072;8798;3230;9302
251660;201808;3311;10126;2960;9500;88;428;2492;7806;2580;8234
251670;201808;4086;11641;3618;10993;41;202;3334;10063;3375;10265
251675;201808;624;1877;580;1818;87;304;384;1187;471;1491
251680;201808;2562;7097;2105;6427;46;172;1717;5217;1763;5389
251690;201808;3094;8935;2705;8203;77;277;2054;6101;2131;6378
251700;201808;1799;5644;1682;5487;58;293;1453;4626;1511;4919
251710;201808;794;2099;547;1574;56;198;313;866;369;1064
251720;201808;1294;3733;1088;3365;32;140;846;2526;878;2666
251740;201808;647;1799;507;1544;39;146;366;1073;405;1219
260005;201808;27602;60473;22843;54206;2076;4989;16985;39780;19061;44769
260010;201808;9458;25200;7893;22893;493;1510;4990;14728;5483;16238
260020;201808;6631;16174;5648;14757;137;581;4704;12048;4841;12629
260030;201808;6192;16818;5342;15477;215;767;4268;12265;4483;13032
260040;201808;7759;21675;6511;19717;637;1938;4395;13498;5032;15436
260050;201808;12161;34333;11159;33130;366;1162;9815;29611;10181;30773
260060;201808;3801;10075;3294;9216;226;616;2581;7236;2807;7852
260070;201808;9800;26253;8606;24421;544;1818;6617;18456;7161;20274
260080;201808;6405;15166;5615;13995;181;581;4676;11372;4857;11953
260090;201808;4950;12962;4471;12321;627;1705;3181;8871;3808;10576
260100;201808;3073;8321;2617;7635;99;390;2162;6236;2261;6626
260105;201808;5133;13822;4575;13030;164;628;3779;10515;3943;11143
260110;201808;21928;59489;19902;56712;1062;3338;16735;47168;17797;50506
260120;201808;13267;37314;11464;34406;1596;4848;7203;22109;8799;26957
260130;201808;2943;7937;2683;7535;193;597;2026;5555;2219;6152
260140;201808;12813;30080;11119;27926;610;1669;9252;23008;9862;24677
260150;201808;3349;8343;2903;7790;138;469;2455;6451;2593;6920
260160;201808;6308;17276;5412;16093;121;501;4727;14151;4848;14652
260170;201808;17041;44732;15174;42027;1574;4184;11300;31544;12874;35728
260180;201808;3195;9193;2900;8752;123;432;2465;7349;2588;7781
260190;201808;16792;36095;14788;33724;201;633;13082;29311;13283;29944
260200;201808;10813;26756;9493;25092;418;1171;8222;21700;8640;22871
260210;201808;11739;33949;10073;31220;354;1430;8138;25072;8492;26502
260220;201808;9790;24852;9209;24132;218;738;8307;21562;8525;22300
260230;201808;9978;26096;8770;24390;291;953;7226;19836;7517;20789
260240;201808;2734;8206;2408;7662;187;664;1848;5842;2035;6506
260250;201808;2122;5801;1844;5388;84;290;1462;4172;1546;4462
260260;201808;12437;33574;10954;31263;489;1771;8654;24203;9143;25974
260270;201808;3582;9693;3257;9238;158;683;2614;7170;2772;7853
260280;201808;12681;39442;11633;37935;563;2286;9982;32297;10545;34583
260290;201808;35940;97339;31684;90790;4046;11998;20798;59143;24844;71141
260300;201808;9079;25714;8014;24154;276;1208;6592;19729;6868;20937
260310;201808;4499;12333;4054;11709;427;1165;3016;8882;3443;10047
260320;201808;7215;21569;6445;20208;293;962;5316;16672;5609;17634
260330;201808;2487;7786;2251;7304;73;288;1816;5756;1889;6044
260340;201808;1973;5413;1723;5028;33;145;1491;4280;1524;4425
260345;201808;23008;63910;19985;59166;4012;12670;9595;27916;13607;40586
260350;201808;4948;12509;4455;11869;129;405;3926;10378;4055;10783
260360;201808;2409;6530;2207;6165;62;289;1551;4221;1613;4510
260370;201808;5311;15803;4663;14674;221;885;3600;11198;3821;12083
260380;201808;4755;14653;4165;13678;204;810;3138;10162;3342;10972
260390;201808;4136;12846;3570;11682;258;932;2467;7940;2725;8872
260392;201808;3353;10943;3017;10496;145;799;2467;8498;2612;9297
260400;201808;15057;37982;13438;35777;820;2481;10440;27067;11260;29548
260410;201808;59835;157446;48886;141461;10402;31662;22396;66436;32798;98098
260415;201808;4068;11544;3506;10511;108;498;2691;7789;2799;8287
260420;201808;12496;27258;10809;25328;214;623;9756;22676;9970;23299
260430;201808;2814;8789;2432;8059;133;526;1715;5615;1848;6141
260440;201808;3471;9625;3036;8836;138;515;2407;6815;2545;7330
260450;201808;5418;14244;4969;13686;262;643;4181;11641;4443;12284
260460;201808;5132;16172;4497;14911;553;2090;2725;8862;3278;10952
260470;201808;4860;13013;4173;12216;127;326;3740;11196;3867;11522
260480;201808;4038;10913;3427;10045;315;1102;2302;6802;2617;7904
260490;201808;5171;12507;4533;11461;89;335;3997;9849;4086;10184
260500;201808;5873;15480;4989;14162;479;1320;3485;9988;3964;11308
260510;201808;9176;23028;7874;21231;196;681;6951;18527;7147;19208
260515;201808;4262;12209;3278;10293;163;601;2184;6690;2347;7291
260520;201808;17047;40951;15298;38577;949;2475;12444;31049;13393;33524
260530;201808;9275;27545;8106;25671;218;983;6954;21798;7172;22781
260540;201808;6666;15106;5986;14291;454;946;5096;12312;5550;13258
260545;201808;36;108;16;68;6;26;4;19;10;45
260550;201808;2733;8166;2309;7342;193;843;1487;4589;1680;5432
260560;201808;5904;15430;5108;14301;147;623;4305;11815;4452;12438
260570;201808;7175;20822;6448;19781;519;1704;5051;15463;5570;17167
260580;201808;4167;10428;3731;9807;43;178;3403;8852;3446;9030
260590;201808;6630;15845;5691;14784;278;749;4726;12328;5004;13077
260600;201808;29005;78511;24218;70972;1470;4861;17965;52029;19435;56890
260610;201808;6655;18459;6143;17727;467;1483;4640;13241;5107;14724
260620;201808;14655;41118;13173;38855;1736;5587;8767;25457;10503;31044
260630;201808;2295;6313;1907;5695;46;207;1574;4636;1620;4843
260640;201808;18870;46036;16327;43001;993;2862;12815;33462;13808;36324
260650;201808;5411;15654;4623;14495;188;821;3870;11939;4058;12760
260660;201808;7187;19372;6262;18158;170;746;5330;15150;5500;15896
260670;201808;2178;5742;1805;5189;98;292;1313;3734;1411;4026
260680;201808;23987;60856;20412;55403;2184;6183;12980;34809;15164;40992
260690;201808;3557;9322;2951;8380;132;459;2365;6618;2497;7077
260700;201808;5824;17381;5586;17108;21;46;5449;16839;5470;16885
260710;201808;1298;3508;1206;3390;55;189;908;2585;963;2774
260720;201808;19876;54970;17791;51903;2860;8578;11194;32514;14054;41092
260730;201808;7041;21394;6296;20306;357;1371;5190;16448;5547;17819
260740;201808;1303;3709;1108;3398;25;130;874;2660;899;2790
260750;201808;6707;19222;5875;18126;147;465;5301;16565;5448;17030
260760;201808;5411;13275;4731;12416;215;630;3882;10247;4097;10877
260765;201808;7343;22822;6635;21775;612;2587;4635;14767;5247;17354
260770;201808;3709;9794;3204;8939;107;364;2553;7045;2660;7409
260775;201808;4986;13793;4547;13133;254;1012;3498;9741;3752;10753
260780;201808;3540;10807;3213;10261;366;1350;2052;6375;2418;7725
260790;201808;109251;256677;93437;235225;15815;39345;57079;144096;72894;183441
260795;201808;2982;8187;2602;7624;150;502;1983;5830;2133;6332
260800;201808;5310;12641;4820;11937;143;484;4292;10287;4435;10771
260805;201808;3540;10422;3025;9510;223;827;2147;6612;2370;7439
260810;201808;6444;17867;5835;16720;555;1612;4257;11958;4812;13570
260820;201808;4207;10487;3766;9854;234;825;2956;7471;3190;8296
260825;201808;2781;8642;2456;8050;142;546;1841;6003;1983;6549
260830;201808;4192;12429;3514;11164;477;1415;2290;7482;2767;8897
260840;201808;4062;11057;3619;10405;192;562;3007;8577;3199;9139
260845;201808;3959;10986;3650;10435;271;769;2725;7738;2996;8507
260850;201808;4721;14013;4097;12742;476;1561;2503;7652;2979;9213
260860;201808;3420;9961;2922;9037;108;411;2381;7221;2489;7632
260870;201808;4325;10819;3786;10137;109;437;3341;8750;3450;9187
260875;201808;6450;17196;5472;15637;694;1943;3614;10426;4308;12369
260880;201808;9475;27211;8397;25360;432;1315;6778;20595;7210;21910
260890;201808;12916;34801;11625;32863;903;2886;8424;23389;9327;26275
260900;201808;5101;15192;4383;13958;294;1096;3054;9579;3348;10675
260910;201808;3076;8679;2729;8110;127;458;2128;6254;2255;6712
260915;201808;4970;15031;4459;14409;85;339;4060;13182;4145;13521
260920;201808;3169;8781;2836;8357;118;404;2392;7027;2510;7431
260930;201808;3428;11264;3068;10598;188;753;2399;8227;2587;8980
260940;201808;14040;34826;12405;32396;945;2688;9283;23845;10228;26533
260950;201808;6190;17823;5025;15564;629;2167;2765;8151;3394;10318
260960;201808;60463;145998;50136;131576;7401;20598;29735;77124;37136;97722
260970;201808;4990;13943;4513;13304;170;482;3550;10556;3720;11038
260980;201808;4289;13054;3891;12544;74;303;3569;11534;3643;11837
260990;201808;16978;49645;14889;46740;884;3147;11649;36434;12533;39581
261000;201808;15080;38280;12990;35329;642;2250;9949;26641;10591;28891
261010;201808;2436;6492;2175;6152;76;201;1934;5482;2010;5683
261020;201808;6258;17700;5419;16102;335;1125;4231;12192;4566;13317
261030;201808;3990;11321;3501;10529;223;655;2777;8311;3000;8966
261040;201808;4955;15245;4139;13533;243;960;3002;9615;3245;10575
261050;201808;7464;20403;6800;19276;628;1555;4761;13664;5389;15219
261060;201808;12871;34171;11571;32354;574;1811;9415;26047;9989;27858
261070;201808;55517;126183;46858;114400;3544;8455;34978;84632;38522;93087
261080;201808;5804;15383;5466;14905;178;518;5003;13638;5181;14156
261090;201808;17001;43198;15472;41172;415;1405;13338;35111;13753;36516
261100;201808;7774;22916;6860;21474;659;2203;4906;15464;5565;17667
261110;201808;56453;164893;48963;152475;10381;33872;24985;78618;35366;112490
261120;201808;3676;9457;3210;8858;71;228;2875;7948;2946;8176
261130;201808;7365;18028;6546;16987;137;437;5864;15113;6001;15550
261140;201808;3368;8250;3044;7799;224;651;2420;6074;2644;6725
261150;201808;5150;14060;4582;13155;115;465;3957;11203;4072;11668
261153;201808;1920;5760;1657;5323;85;343;1140;3622;1225;3965
261160;201808;197223;481070;166749;437827;42931;116142;69128;186627;112059;302769
261170;201808;5777;15377;5265;14610;344;943;4238;11750;4582;12693
261180;201808;9590;25010;8580;23660;586;1805;6225;16981;6811;18786
261190;201808;4641;14081;4250;13451;309;1263;3165;9715;3474;10978
261200;201808;3283;7783;2927;7323;206;522;2389;5923;2595;6445
261210;201808;1880;4689;1615;4314;55;161;1394;3688;1449;3849
261220;201808;13210;39020;11070;34839;1522;5221;6331;19730;7853;24951
261230;201808;4472;13197;3772;12287;92;394;3208;10553;3300;10947
261240;201808;4911;13132;4344;12232;285;808;3538;9923;3823;10731
261245;201808;3421;10100;2949;9264;117;563;2341;7070;2458;7633
261247;201808;2870;8772;2463;8018;154;571;1766;5708;1920;6279
261250;201808;19316;47030;16942;44191;2188;5372;12049;32399;14237;37771
261255;201808;3912;11836;3390;10835;163;717;2576;7964;2739;8681
261260;201808;12600;34400;10966;32313;415;1626;9295;27167;9710;28793
261270;201808;3829;10501;3436;9899;234;793;2785;7876;3019;8669
261280;201808;2514;7321;2230;6807;91;396;1780;5278;1871;5674
261290;201808;2846;7823;2502;7380;117;450;2025;5984;2142;6434
261300;201808;11436;33656;9821;30754;706;2742;6944;21251;7650;23993
261310;201808;7277;20377;6491;19207;943;2958;4340;12604;5283;15562
261320;201808;5812;16916;5124;15697;110;452;4288;12920;4398;13372
261330;201808;5649;14724;5257;14195;195;714;4586;12157;4781;12871
261340;201808;4053;12169;3540;11426;209;877;2733;8717;2942;9594
261350;201808;8211;24996;7574;23941;155;780;6278;19445;6433;20225
261360;201808;8121;20414;6977;18796;301;926;5648;14865;5949;15791
261370;201808;19245;52311;16997;49029;2953;8505;10240;29909;13193;38414
261380;201808;3846;12313;3487;11614;483;1801;2281;7466;2764;9267
261390;201808;15678;46094;13579;42578;1391;4719;8792;27520;10183;32239
261400;201808;4562;14959;4017;13795;209;947;2964;9954;3173;10901
261410;201808;8925;23663;7659;21598;526;1505;6131;17204;6657;18709
261420;201808;6809;21755;6333;21117;952;3597;4224;13989;5176;17586
261430;201808;3330;9717;2839;8946;114;454;2330;7289;2444;7743
261440;201808;1445;4462;1260;4085;52;248;891;2789;943;3037
261450;201808;13899;38621;12822;37010;268;1056;10972;31579;11240;32635
261460;201808;6930;19674;6370;18872;231;821;5496;16213;5727;17034
261470;201808;4121;10638;3702;10080;51;241;3122;8508;3173;8749
261480;201808;4583;14736;4027;13798;261;1061;3078;10331;3339;11392
261485;201808;4828;14139;4236;13169;398;1468;2952;8961;3350;10429
261500;201808;5419;14656;4834;13838;482;1302;3383;9996;3865;11298
261510;201808;1777;5526;1536;5075;85;326;1139;3791;1224;4117
261520;201808;2413;7487;2258;7184;88;347;1572;5057;1660;5404
261530;201808;10296;32155;8775;29133;1317;5037;4164;13545;5481;18582
261540;201808;7374;21995;6708;20930;1118;3412;3940;12723;5058;16135
261550;201808;3526;9568;3132;8926;242;802;2255;6290;2497;7092
261560;201808;7372;22747;6529;21513;422;1713;4921;16133;5343;17846
261570;201808;3300;9275;2759;8361;224;818;1878;5575;2102;6393
261580;201808;6353;17307;5776;16475;140;623;5213;14676;5353;15299
261590;201808;2608;6874;2120;6137;84;266;1598;4599;1682;4865
261600;201808;5131;13309;4326;12122;444;1153;2919;8450;3363;9603
261610;201808;2395;6507;2025;5939;88;316;1545;4513;1633;4829
261618;201808;2458;6377;2216;6056;94;297;1799;4840;1893;5137
261620;201808;3841;11522;3596;11136;782;2259;2225;7176;3007;9435
261630;201808;6557;18575;5562;16733;481;1789;3613;10361;4094;12150
261640;201808;35549;82751;31203;77367;1806;3995;24726;62626;26532;66621
261650;201808;4031;10546;3606;9991;162;605;2713;7444;2875;8049
270010;201808;4195;14781;3766;13996;194;1069;2937;10640;3131;11709
270020;201808;3890;10108;3461;9540;222;721;2832;7620;3054;8341
270030;201808;33601;94657;29356;87807;4483;13318;18864;56945;23347;70263
270040;201808;11104;30454;9692;28744;447;1746;8076;23705;8523;25451
270050;201808;5433;12712;4649;11839;194;512;4123;10525;4317;11037
270060;201808;1962;5232;1722;4925;146;415;1347;3893;1493;4308
270070;201808;4482;13122;3968;12388;142;671;3357;10222;3499;10893
270080;201808;1410;4026;1175;3600;78;278;865;2546;943;2824
270090;201808;1870;5833;1660;5417;85;399;1296;4054;1381;4453
270100;201808;5391;15151;4769;14201;256;991;3843;11208;4099;12199
270110;201808;3181;8007;2572;7275;136;411;2045;5930;2181;6341
270120;201808;3010;8171;2640;7713;87;332;2320;6735;2407;7067
270130;201808;5205;14027;4574;13302;201;668;3818;11149;4019;11817
270135;201808;1960;4898;1716;4613;66;187;1548;4153;1614;4340
270140;201808;9813;22840;8061;20466;385;1466;6580;15805;6965;17271
270150;201808;2606;8022;2512;7902;11;29;2473;7788;2484;7817
270160;201808;5324;15855;4726;15122;78;460;4323;13657;4401;14117
270170;201808;3421;10300;2993;9720;251;1102;2185;6831;2436;7933
270180;201808;2205;6976;2038;6745;60;288;1784;5802;1844;6090
270190;201808;1631;5027;1499;4844;74;321;1253;3984;1327;4305
270200;201808;2430;7451;2117;7040;145;584;1589;5152;1734;5736
270210;201808;5555;13800;4901;13030;172;582;4412;11568;4584;12150
270220;201808;1375;3906;1170;3609;218;733;664;2020;882;2753
270230;201808;9147;27108;7815;24958;828;3102;5297;16498;6125;19600
270235;201808;5661;18049;5099;17081;216;922;4172;13810;4388;14732
270240;201808;10307;28571;8555;26330;1029;3441;6140;18879;7169;22320
270250;201808;2845;7442;2529;7006;242;645;1931;5391;2173;6036
270255;201808;4597;13331;3540;11369;194;810;2552;8007;2746;8817
270260;201808;5520;16778;5153;16197;133;663;4478;13645;4611;14308
270270;201808;987;2707;913;2610;137;401;635;1813;772;2214
270280;201808;3756;9432;3056;8550;437;824;2151;6405;2588;7229
270290;201808;7688;24998;6993;23857;318;1481;5894;19814;6212;21295
270300;201808;3987;11054;3167;10157;220;773;2343;7581;2563;8354
270310;201808;6911;20066;6085;18759;181;932;5169;15403;5350;16335
270320;201808;5624;16766;5033;15682;616;2048;3516;10701;4132;12749
270330;201808;3693;12524;3387;12081;288;1142;2663;9508;2951;10650
270340;201808;1594;4596;1372;4298;63;231;1130;3498;1193;3729
270350;201808;1873;4624;1584;4269;181;513;1113;3037;1294;3550
270360;201808;2347;6313;2139;6068;74;205;1963;5614;2037;5819
270370;201808;1385;4379;1266;4162;59;264;1010;3272;1069;3536
270375;201808;3026;7403;2599;6883;30;98;2404;6353;2434;6451
270380;201808;5597;16614;4862;15614;448;1516;3468;11371;3916;12887
270390;201808;1161;3077;979;2827;25;121;808;2287;833;2408
270400;201808;6044;16781;5221;15478;229;809;4022;11580;4251;12389
270410;201808;4425;13475;3936;12630;235;903;3105;9823;3340;10726
270420;201808;5523;16751;5095;16159;194;854;4307;13408;4501;14262
270430;201808;133129;339294;108331;306659;25272;75390;47927;138683;73199;214073
270440;201808;4739;13168;4101;12377;127;552;3465;10360;3592;10912
270450;201808;6488;18382;5896;17662;286;1102;4959;14697;5245;15799
270460;201808;3538;8322;3132;7835;50;213;2923;7170;2973;7383
270470;201808;10543;31329;9410;29670;924;3081;6864;21893;7788;24974
270480;201808;2793;7789;2407;7192;166;637;1900;5479;2066;6116
270490;201808;961;2818;855;2689;60;213;670;2086;730;2299
270500;201808;4790;15144;4405;14621;192;875;3650;11955;3842;12830
270510;201808;5581;15711;4893;14748;486;1826;3536;10186;4022;12012
270520;201808;3920;11561;3156;10191;788;2660;1162;3981;1950;6641
270530;201808;1095;3334;995;3172;63;187;767;2460;830;2647
270540;201808;2100;6403;1880;6112;76;379;1607;5100;1683;5479
270550;201808;6582;17925;5495;16708;499;1414;4199;13139;4698;14553
270560;201808;3097;8553;2772;8097;168;562;2175;6236;2343;6798
270570;201808;3969;11566;3432;10740;165;701;2796;8567;2961;9268
270580;201808;2181;6381;2030;6160;93;283;1784;5408;1877;5691
270590;201808;1568;4697;1461;4567;11;51;1415;4420;1426;4471
270600;201808;2733;8657;2474;8225;91;465;2141;6951;2232;7416
270610;201808;3549;9666;3028;8994;106;416;2665;7776;2771;8192
270620;201808;1279;3991;1172;3796;48;199;980;3102;1028;3301
270630;201808;14946;41045;13360;38536;950;3119;10688;30469;11638;33588
270640;201808;5444;15887;4744;14808;203;843;3829;11610;4032;12453
270642;201808;2293;7667;2110;7394;158;793;1670;5637;1828;6430
270644;201808;3355;8670;2789;7934;237;683;2105;6061;2342;6744
270650;201808;3224;9752;2906;9294;436;1643;1992;6115;2428;7758
270660;201808;2142;5377;1727;4798;82;275;1293;3531;1375;3806
270670;201808;15157;37748;13142;35307;731;2118;10906;29093;11637;31211
270680;201808;5074;13051;4611;12530;153;242;4285;11844;4438;12086
270690;201808;9213;23439;7805;21786;1131;2904;5608;16007;6739;18911
270700;201808;547;1672;472;1532;37;159;344;1097;381;1256
270710;201808;5684;17270;5251;16688;278;1213;4401;13682;4679;14895
270720;201808;3283;10275;2943;9692;93;563;2544;8124;2637;8687
270730;201808;7294;18035;6746;17429;362;888;5542;15236;5904;16124
270740;201808;2322;6314;2085;6010;102;355;1713;4834;1815;5189
270750;201808;5262;14791;4660;13953;225;860;3866;11469;4091;12329
270760;201808;3330;9586;2942;9009;76;381;2528;7610;2604;7991
270770;201808;20489;51061;16373;45955;3070;8085;9324;28057;12394;36142
270780;201808;1742;5234;1656;5115;97;343;1391;4257;1488;4600
270790;201808;1560;4593;1368;4315;126;411;937;2972;1063;3383
270800;201808;10392;29685;9429;28313;441;1900;8054;23492;8495;25392
270810;201808;3202;9714;2585;8615;201;802;1783;5853;1984;6655
270820;201808;1669;5135;1427;4721;93;378;1091;3527;1184;3905
270830;201808;5309;13089;4434;11996;209;736;3586;9580;3795;10316
270840;201808;8040;24266;7243;23126;228;1280;6359;19675;6587;20955
270850;201808;8451;21769;7664;20762;505;1724;6417;16845;6922;18569
270860;201808;11724;29684;9808;27365;578;1862;7879;21690;8457;23552
270870;201808;2006;5851;1758;5419;217;725;1235;3814;1452;4539
270880;201808;7982;24358;7235;23267;275;1205;6031;19074;6306;20279
270890;201808;2463;6941;2164;6521;151;524;1594;4719;1745;5243
270895;201808;2860;9554;2672;9304;88;493;2380;8085;2468;8578
270900;201808;1791;4692;1390;4058;57;206;1076;3066;1133;3272
270910;201808;3618;11001;3170;10225;145;604;2441;7736;2586;8340
270915;201808;8821;27221;7521;24866;871;3434;4933;15818;5804;19252
270920;201808;5462;17146;5111;16588;244;1162;4257;13336;4501;14498
270930;201808;16842;41158;13408;37086;2083;5361;8990;25741;11073;31102
270940;201808;5838;17150;5231;16373;277;1313;4096;12460;4373;13773
280010;201808;659;1827;561;1644;27;119;390;1047;417;1166
280020;201808;4580;12253;3974;11266;543;1471;2672;7650;3215;9121
280030;201808;69610;170401;56022;151156;14380;39515;22942;64912;37322;104427
280040;201808;3007;8594;2662;8051;272;880;1874;5630;2146;6510
280050;201808;3725;10948;3289;10221;569;1868;1969;6124;2538;7992
280060;201808;5092;14297;4164;12825;781;2539;2097;6657;2878;9196
280067;201808;6693;17596;5728;16068;480;1457;4035;11134;4515;12591
280070;201808;1853;5800;1781;5667;95;344;1511;4745;1606;5089
280100;201808;3511;10239;3135;9620;364;1214;2209;6744;2573;7958
280110;201808;1277;3699;1159;3492;32;139;1000;2923;1032;3062
280120;201808;7332;22145;6701;21067;690;2040;5084;16221;5774;18261
280130;201808;8506;21043;7641;19818;646;1764;5929;15406;6575;17170
280140;201808;5402;13601;4827;12806;263;736;4039;10675;4302;11411
280150;201808;3699;9892;3375;9440;225;654;2750;7655;2975;8309
280160;201808;1180;3496;1001;3179;129;434;637;1984;766;2418
280170;201808;4950;13486;4541;12933;266;739;3794;10847;4060;11586
280190;201808;1164;2744;999;2507;60;179;808;1966;868;2145
280200;201808;1276;3430;1042;3040;92;338;751;2141;843;2479
280210;201808;14665;39209;12997;36863;1986;5947;7858;22449;9844;28396
280220;201808;1746;4784;1519;4480;39;200;1254;3678;1293;3878
280230;201808;3636;9727;3277;9216;252;744;2454;6813;2706;7557
280240;201808;3335;9037;3036;8573;77;350;2608;7169;2685;7519
280250;201808;799;2083;645;1853;78;271;377;1014;455;1285
280260;201808;2062;5227;1895;5018;43;124;1764;4678;1807;4802
280270;201808;2227;6520;1998;6139;122;451;1682;5066;1804;5517
280280;201808;3872;12510;3538;11999;532;1636;2378;8494;2910;10130
280290;201808;16810;46672;14946;44021;1662;5412;9987;29590;11649;35002
280300;201808;10288;27420;9044;26030;321;1127;7184;21656;7505;22783
280310;201808;1301;3515;1104;3163;34;122;843;2338;877;2460
280320;201808;8255;23504;7302;22031;867;2762;4914;14645;5781;17407
280330;201808;4756;12071;4071;11060;279;825;3076;8259;3355;9084
280340;201808;5206;11177;4531;10428;276;568;3908;9149;4184;9717
280350;201808;22767;57785;20023;53749;1678;4846;14988;39891;16666;44737
280360;201808;5628;16360;5058;15363;917;2827;2822;8692;3739;11519
280370;201808;2085;5225;1729;4615;82;220;1396;3683;1478;3903
280380;201808;951;2722;834;2548;91;314;566;1721;657;2035
280390;201808;3389;8900;2809;7931;133;430;2219;6149;2352;6579
280400;201808;3796;10233;3378;9604;568;1538;2065;6092;2633;7630
280410;201808;2047;6056;1683;5378;208;705;1012;3158;1220;3863
280420;201808;4160;11472;3806;10974;111;394;3429;9826;3540;10220
280430;201808;1966;5032;1747;4728;79;289;1411;3739;1490;4028
280440;201808;4348;11934;3864;11234;225;758;3162;8978;3387;9736
280445;201808;2261;5922;2042;5528;58;187;1505;3889;1563;4076
280450;201808;10049;23419;9000;22062;362;711;7814;19357;8176;20068
280460;201808;6505;16182;5977;15418;492;1220;4893;12606;5385;13826
280470;201808;1702;4927;1513;4593;80;291;1129;3378;1209;3669
280480;201808;35869;93241;32128;87903;3099;9350;23022;61976;26121;71326
280490;201808;3762;10875;3234;9979;108;496;2469;7352;2577;7848
280500;201808;913;2293;788;2115;41;140;657;1749;698;1889
280510;201808;2484;6848;2182;6400;113;436;1607;4667;1720;5103
280520;201808;1569;4128;1411;3906;80;209;1158;3198;1238;3407
280530;201808;2564;6325;2251;5960;135;359;1836;4863;1971;5222
280540;201808;8825;24139;8151;23152;241;1013;7200;20031;7441;21044
280550;201808;6432;15788;5405;14212;286;872;4305;11030;4591;11902
280560;201808;6876;19901;6546;19420;183;719;5785;16923;5968;17642
280570;201808;6107;15714;5101;14396;244;867;3821;10656;4065;11523
280580;201808;5284;15038;4585;13890;611;1785;3106;9554;3717;11339
280590;201808;2914;7080;2455;6499;152;593;1836;4625;1988;5218
280600;201808;3278;9298;2959;8838;203;697;2170;6433;2373;7130
280610;201808;2501;6320;2273;6007;195;504;1816;4783;2011;5287
280620;201808;5191;13670;4514;12684;434;1052;3275;9552;3709;10604
280630;201808;3570;10919;3251;10424;206;770;2588;8302;2794;9072
280640;201808;2382;6654;2183;6431;55;157;2003;5947;2058;6104
280650;201808;1236;3267;975;2880;80;282;712;2037;792;2319
280660;201808;3075;7472;2744;7082;113;318;2404;6173;2517;6491
280670;201808;18533;43302;16379;40513;1173;3029;12844;31749;14017;34778
280680;201808;2643;6691;2290;6135;180;426;1700;4535;1880;4961
280690;201808;935;2442;798;2236;43;115;601;1654;644;1769
280700;201808;1067;2793;930;2588;21;76;734;2004;755;2080
280710;201808;14391;33219;12514;31067;509;847;10986;27947;11495;28794
280720;201808;2699;6115;2204;5533;134;375;1479;3914;1613;4289
280730;201808;1075;2758;967;2597;70;220;741;1956;811;2176
280740;201808;13445;34226;11599;31317;1090;3049;8022;21385;9112;24434
280750;201808;3411;9912;3076;9310;174;656;2275;6751;2449;7407
280760;201808;5874;16727;5232;15695;612;1827;3504;10774;4116;12601
290010;201808;3030;6565;2102;5124;14;50;1739;4040;1753;4090
290020;201808;5175;14354;4859;13921;348;677;4195;12378;4543;13055
290030;201808;3891;9992;3396;9411;189;482;2859;7976;3048;8458
290035;201808;5064;11478;4085;10202;301;582;3250;8419;3551;9001
290040;201808;4253;10557;3611;9779;142;428;2846;7919;2988;8347
290050;201808;2102;6804;1788;6173;155;611;1246;4222;1401;4833
290060;201808;1264;3212;981;2742;98;349;659;1766;757;2115
290070;201808;32958;77869;28664;72294;2600;6734;20280;51395;22880;58129
290080;201808;5406;16269;4607;15088;543;1862;3121;10397;3664;12259
290090;201808;2212;4265;1658;3674;38;87;1513;3334;1551;3421
290100;201808;9341;25519;7930;23367;997;2786;4910;14875;5907;17661
290110;201808;4952;13817;4540;13089;460;1380;3176;9063;3636;10443
290115;201808;4236;12389;3675;11534;223;760;2866;8983;3089;9743
290120;201808;6719;16680;5577;15261;156;565;4825;13002;4981;13567
290130;201808;4494;11269;3623;10180;129;518;2926;8068;3055;8586
290135;201808;4267;10180;3505;8950;235;648;2684;6665;2919;7313
290140;201808;4522;12409;3654;11290;126;458;3133;9632;3259;10090
290150;201808;2214;6353;2078;6141;188;610;1588;4593;1776;5203
290160;201808;3090;7594;2824;7255;334;758;2138;5562;2472;6320
290170;201808;2931;8247;2668;7929;97;359;2405;7119;2502;7478
290180;201808;2895;8026;2419;7261;95;342;1939;5751;2034;6093
290190;201808;3942;11856;3568;11333;175;723;2907;9065;3082;9788
290195;201808;2256;5884;1819;5227;50;225;1510;4309;1560;4534
290200;201808;3877;11187;3291;10235;241;811;2548;7892;2789;8703
290205;201808;3367;8800;2994;8271;116;453;2446;6570;2562;7023
290210;201808;12982;37477;11643;35489;1022;2889;8955;28023;9977;30912
290220;201808;2713;7112;2463;6792;168;498;2005;5453;2173;5951
290225;201808;3432;7380;2816;6728;30;75;2658;6360;2688;6435
290230;201808;2334;6576;2137;6344;56;220;1895;5598;1951;5818
290240;201808;3603;9366;3001;8596;126;436;2482;7030;2608;7466
290250;201808;3972;11744;3524;11141;154;458;2934;9593;3088;10051
290260;201808;5182;13463;4306;12172;223;775;3481;9711;3704;10486
290265;201808;3579;10616;2966;9495;144;583;2245;7099;2389;7682
290270;201808;11397;39271;10845;38318;758;3222;8620;30040;9378;33262
290280;201808;5729;17238;5081;16160;380;1379;3740;11780;4120;13159
290290;201808;9521;28696;8071;26010;803;2718;5583;17911;6386;20629
290300;201808;4244;11763;3155;9701;191;684;2239;6868;2430;7552
290310;201808;1491;3937;1258;3619;101;379;935;2616;1036;2995
290320;201808;23186;63648;19452;58120;4756;14323;9507;29647;14263;43970
290323;201808;3654;10057;3242;9461;74;267;2704;7794;2778;8061
290327;201808;4116;12100;3606;11129;294;894;2597;8032;2891;8926
290330;201808;2021;4505;1673;4119;45;100;1492;3673;1537;3773
290340;201808;5499;14910;4436;13554;588;1860;3131;9643;3719;11503
290350;201808;4538;13328;3874;12193;300;995;2840;9023;3140;10018
290360;201808;4897;13388;4295;12582;132;426;3723;10883;3855;11309
290370;201808;5245;13069;3980;11391;217;549;3012;8786;3229;9335
290380;201808;5502;15097;4753;14046;113;382;4163;12351;4276;12733
290390;201808;14073;40890;12125;37948;1312;4232;8355;26573;9667;30805
290395;201808;2710;8253;2296;7520;70;333;1813;5883;1883;6216
290400;201808;3476;9808;2832;8760;129;525;2133;6437;2262;6962
290405;201808;4581;13644;3857;12361;279;968;2711;8796;2990;9764
290410;201808;5582;15717;4471;13881;148;675;3434;10255;3582;10930
290420;201808;2893;8288;2422;7533;131;416;1901;5919;2032;6335
290430;201808;3030;8797;2529;7977;310;1029;1658;5197;1968;6226
290440;201808;2713;7006;2038;5967;60;203;1510;4469;1570;4672
290450;201808;3149;8700;2625;7917;159;579;2038;6032;2197;6611
290460;201808;11521;32594;10039;29794;2531;7643;4409;13044;6940;20687
290470;201808;4191;11122;3182;9620;388;1315;1796;5485;2184;6800
290475;201808;6247;18625;5347;16989;133;668;4291;13298;4424;13966
290480;201808;1779;4709;1557;4373;109;341;1075;2921;1184;3262
290485;201808;4334;13234;3866;12521;141;753;3307;10440;3448;11193
290490;201808;8587;21003;7847;20016;519;1324;6246;16078;6765;17402
290500;201808;3891;11872;2996;9959;455;1611;1488;4826;1943;6437
290510;201808;3264;8575;2799;7956;89;328;2434;6821;2523;7149
290515;201808;3636;9908;3094;9205;73;201;2730;8296;2803;8497
290520;201808;11140;32843;8719;28036;415;1686;5745;18118;6160;19804
290530;201808;4905;14200;4256;13144;175;593;3522;10872;3697;11465
290540;201808;3599;9768;3255;9334;68;230;2959;8458;3027;8688
290550;201808;4283;11220;3796;10663;31;95;3564;10103;3595;10198
290560;201808;6476;17304;5153;15291;463;1623;3566;10339;4029;11962
290570;201808;41895;107893;38282;103252;2733;7720;30659;82292;33392;90012
290580;201808;7597;23363;6800;22154;641;2066;5131;17056;5772;19122
290590;201808;6849;21513;5988;19980;161;689;4943;16446;5104;17135
290600;201808;17932;51582;16316;49109;841;2708;13094;39593;13935;42301
290610;201808;2426;7915;1974;6974;112;496;1386;4819;1498;5315
290620;201808;6299;17884;5550;16678;215;693;4724;14078;4939;14771
290630;201808;8930;22110;7216;19869;608;1684;5616;15513;6224;17197
290640;201808;2674;7237;2030;6187;97;300;1570;4743;1667;5043
290650;201808;11684;31488;10705;30249;2711;7304;6129;18344;8840;25648
290660;201808;3561;9377;3044;8638;83;206;2275;6732;2358;6938
290670;201808;6600;19014;5762;17626;453;1365;4423;13660;4876;15025
290680;201808;10271;29433;8899;27394;260;1313;7233;21671;7493;22984
290682;201808;4535;12333;4009;11579;142;401;3409;9848;3551;10249
290685;201808;3507;8038;2337;6396;190;499;1526;4353;1716;4852
290687;201808;6619;18670;5341;16524;783;2407;3262;10407;4045;12814
290689;201808;2761;8035;2287;7213;140;486;1699;5367;1839;5853
290690;201808;5454;14540;4488;13209;472;1405;3108;9132;3580;10537
290700;201808;2587;7273;2334;6927;95;344;1957;5804;2052;6148
290710;201808;8386;24000;7221;22396;198;745;6201;19174;6399;19919
290720;201808;18654;51338;17267;49385;940;2927;14359;40881;15299;43808
290730;201808;6898;17547;5996;16454;250;648;4735;13007;4985;13655
290740;201808;1033;2893;786;2453;45;186;581;1796;626;1982
290750;201808;10516;27658;9178;25303;948;2797;6358;17092;7306;19889
290755;201808;2118;5958;1678;5156;99;358;1202;3655;1301;4013
290760;201808;3762;11219;2988;9687;333;982;1847;6258;2180;7240
290770;201808;2449;8319;2288;8110;58;301;1935;6905;1993;7206
290780;201808;8198;20979;7129;19480;363;839;5685;15786;6048;16625
290790;201808;4358;12428;3925;11828;146;468;3389;10272;3535;10740
290800;201808;6979;14827;5262;12845;350;817;4030;10009;4380;10826
290810;201808;5568;15290;4500;13586;114;407;3422;10360;3536;10767
290820;201808;4893;13316;4395;12585;239;771;3315;9522;3554;10293
290830;201808;4474;10570;4029;9980;83;259;3466;8452;3549;8711
290840;201808;16308;45198;14389;42170;1649;4227;9783;29995;11432;34222
290850;201808;6127;15905;5580;15301;425;977;4564;12911;4989;13888
290860;201808;5560;17214;4896;16420;221;820;4151;14106;4372;14926
290870;201808;4666;13092;3643;11248;132;486;2644;8091;2776;8577
290880;201808;1387;3562;1092;3134;73;196;775;2260;848;2456
290890;201808;7606;17337;7062;16690;182;491;6564;15392;6746;15883
290900;201808;2312;6236;1744;5258;113;363;1148;3416;1261;3779
290910;201808;5052;12975;3995;11339;54;234;3329;9315;3383;9549
290920;201808;5025;12630;4672;12194;72;185;4392;11458;4464;11643
290930;201808;7846;22291;6510;19968;223;1005;5225;15547;5448;16552
290940;201808;3646;10516;3076;9692;174;642;2429;7681;2603;8323
290950;201808;1473;3854;1252;3523;74;203;910;2578;984;2781
290960;201808;5177;14337;4740;13755;144;470;4074;11814;4218;12284
290970;201808;3490;10256;2917;9298;173;593;2248;7164;2421;7757
290980;201808;10685;27386;9128;24841;972;2893;5407;14388;6379;17281
290990;201808;8804;24837;7788;23136;378;1445;6327;18286;6705;19731
291000;201808;3219;8920;2611;8140;235;678;2036;6465;2271;7143
291005;201808;14266;35316;12795;33476;644;1833;10828;28157;11472;29990
291010;201808;2953;9004;2415;7882;134;485;1643;5272;1777;5757
291020;201808;1263;3222;1022;2765;29;103;712;1824;741;1927
291030;201808;2376;6073;1655;4719;96;285;1068;2960;1164;3245
291040;201808;5199;14980;4552;14032;226;930;3652;11068;3878;11998
291050;201808;7199;20829;6346;19512;1008;3347;4134;12598;5142;15945
291060;201808;5636;18822;4953;17842;441;1954;3587;12759;4028;14713
291070;201808;15010;42176;13036;39082;584;2186;10597;31421;11181;33607
291072;201808;22969;62354;17087;51317;3693;11579;6760;20625;10453;32204
291075;201808;4919;13277;4398;12390;134;465;3624;9970;3758;10435
291077;201808;1547;4170;1233;3604;56;162;868;2549;924;2711
291080;201808;77982;220777;66288;201970;25918;80357;11751;38517;37669;118874
291085;201808;5613;14450;4716;13163;179;554;4010;11139;4189;11693
291090;201808;1822;3675;1425;3217;33;101;1237;2752;1270;2853
291100;201808;3046;6895;2128;5800;103;363;1638;4355;1741;4718
291110;201808;5628;17668;4884;16364;470;1867;3483;11288;3953;13155
291120;201808;7579;19141;6635;17853;423;1239;5061;13559;5484;14798
291125;201808;2109;3801;1551;3179;99;161;1198;2535;1297;2696
291130;201808;3007;9004;2356;7726;91;450;1693;5318;1784;5768
291140;201808;4546;12748;3441;10603;441;1232;2251;7000;2692;8232
291150;201808;2153;5065;1867;4726;28;72;1704;4295;1732;4367
291160;201808;4658;13862;4102;12967;397;1373;2857;8928;3254;10301
291165;201808;2167;6003;1692;5104;34;137;1262;3682;1296;3819
291170;201808;19949;51661;16973;46782;1017;3054;11165;30616;12182;33670
291180;201808;5700;14232;4497;12450;433;1195;3321;9225;3754;10420
291185;201808;3050;8624;2696;7974;95;328;2181;6354;2276;6682
291190;201808;7474;18968;6301;17364;383;1172;4945;13594;5328;14766
291200;201808;2824;8042;2137;6733;125;412;1331;4149;1456;4561
291210;201808;6626;15033;5202;13317;185;551;3938;10056;4123;10607
291220;201808;3886;11428;3515;10840;251;904;2707;8247;2958;9151
291230;201808;4303;9714;3350;8643;80;167;3046;7967;3126;8134
291240;201808;4113;10890;3633;10058;67;225;3164;8621;3231;8846
291250;201808;3268;9803;2631;8638;187;604;1791;5937;1978;6541
291260;201808;1322;3201;1140;2949;41;142;964;2480;1005;2622
291270;201808;5086;14323;4115;12718;752;2271;2486;7898;3238;10169
291280;201808;2320;6250;1787;5344;194;641;1057;3081;1251;3722
291290;201808;5789;15666;4699;13953;477;1460;3145;9321;3622;10781
291300;201808;3863;10684;2935;9117;142;483;2170;6656;2312;7139
291310;201808;5123;14077;4376;12677;153;533;3597;10246;3750;10779
291320;201808;5910;17411;4655;14903;1115;3336;2241;7514;3356;10850
291330;201808;1745;4512;1486;4097;67;204;1131;3037;1198;3241
291340;201808;4134;10894;3473;9803;80;301;2705;7474;2785;7775
291345;201808;2943;9200;2736;8897;140;502;2259;7358;2399;7860
291350;201808;6567;17136;5117;15184;124;384;4339;13056;4463;13440
291360;201808;33351;82753;27299;74906;4140;11602;15901;44833;20041;56435
291370;201808;7715;21466;7067;20558;435;1429;5492;15864;5927;17293
291380;201808;3206;9488;2917;9012;116;498;2427;7323;2543;7821
291390;201808;12488;28944;10110;26227;441;1291;8199;21181;8640;22472
291400;201808;13460;36316;11532;33393;1728;4513;7164;22058;8892;26571
291410;201808;2857;7577;2197;6453;59;261;1669;4773;1728;5034
291420;201808;1829;4763;1531;4369;48;194;1312;3704;1360;3898
291430;201808;2961;8347;2591;7786;100;448;2098;6127;2198;6575
291440;201808;6343;18566;5512;17146;357;1213;4379;13679;4736;14892
291450;201808;8193;22195;7101;20859;141;323;6249;18832;6390;19155
291460;201808;14440;40035;12858;37672;902;2915;9531;27833;10433;30748
291465;201808;8766;24074;7238;22233;275;1170;6094;18639;6369;19809
291470;201808;15185;37092;13033;34606;634;1633;9909;27009;10543;28642
291480;201808;38589;88912;29004;75816;3928;10751;15290;40184;19218;50935
291490;201808;4980;13451;4427;12756;222;724;3822;11008;4044;11732
291500;201808;4930;12354;4125;11252;65;289;3732;10114;3797;10403
291510;201808;3594;10167;2944;9194;103;500;2393;7381;2496;7881
291520;201808;4269;10344;3365;9126;200;558;2483;6751;2683;7309
291530;201808;2177;5358;1646;4624;324;782;955;2953;1279;3735
291535;201808;3131;9608;2897;9210;199;621;2246;7228;2445;7849
291540;201808;2198;4954;1562;4232;55;222;1355;3560;1410;3782
291550;201808;5254;12679;4176;11210;471;1187;2686;7333;3157;8520
291560;201808;19313;43943;13367;36802;944;2483;9124;26379;10068;28862
291570;201808;2252;5493;1845;4989;93;205;1538;4263;1631;4468
291580;201808;5967;16347;4805;14757;340;1250;3503;10571;3843;11821
291590;201808;1764;5053;1621;4848;139;437;1300;3879;1439;4316
291600;201808;5015;12870;3777;10882;511;1579;2294;6444;2805;8023
291610;201808;5292;15166;5017;14855;89;311;4712;13940;4801;14251
291620;201808;3139;7053;2283;6106;112;320;1752;4768;1864;5088
291630;201808;3143;7382;2416;6447;149;461;1915;5041;2064;5502
291640;201808;14763;38779;11529;33875;2023;5992;4810;14975;6833;20967
291650;201808;8524;23179;7638;22061;459;1109;6539;19194;6998;20303
291660;201808;2141;5231;1557;4314;118;423;1067;2794;1185;3217
291670;201808;1979;5254;1700;4865;103;265;1350;3916;1453;4181
291680;201808;3817;10083;3258;9167;283;838;2471;6910;2754;7748
291685;201808;4561;11182;3700;10057;280;619;2812;7950;3092;8569
291690;201808;4055;9380;2955;7788;108;252;2413;6297;2521;6549
291700;201808;8419;25088;7542;23492;464;1585;6141;18948;6605;20533
291710;201808;5024;12614;3850;10933;287;963;2729;7567;3016;8530
291720;201808;4421;13818;3672;12274;422;1568;2403;7826;2825;9394
291730;201808;6224;16829;5400;15725;276;942;4427;12828;4703;13770
291733;201808;2893;7605;2456;6994;72;236;1853;5462;1925;5698
291735;201808;2949;7755;2453;6996;82;272;2017;5721;2099;5993
291740;201808;3779;9908;2983;8609;117;366;2315;6579;2432;6945
291750;201808;19193;47470;15612;42045;1843;5048;10182;27606;12025;32654
291760;201808;10170;30615;8191;27303;2776;10376;2073;7007;4849;17383
291770;201808;6771;19086;5696;17102;546;1752;4089;12066;4635;13818
291780;201808;4809;13379;4383;12727;108;384;3837;11030;3945;11414
291790;201808;2587;7553;2403;7292;222;609;1848;5692;2070;6301
291800;201808;28877;75369;22683;66015;3309;9391;12879;38551;16188;47942
291810;201808;10332;25699;8687;23634;213;745;7603;20505;7816;21250
291820;201808;3680;10134;3255;9504;123;446;2579;7530;2702;7976
291830;201808;4193;10401;3581;9551;230;614;2875;7705;3105;8319
291835;201808;6189;18880;4976;16498;786;2687;2866;9770;3652;12457
291840;201808;43986;123826;38694;116603;4679;14664;27165;82864;31844;97528
291845;201808;2353;6640;2055;6245;127;380;1696;5208;1823;5588
291850;201808;4026;11614;3297;10351;288;827;2380;7703;2668;8530
291855;201808;2039;4320;1622;3818;56;153;1415;3310;1471;3463
291860;201808;2217;5883;1569;4635;43;158;1050;2991;1093;3149
291870;201808;1312;3361;879;2575;60;192;601;1707;661;1899
291875;201808;2609;8001;2342;7508;97;378;1796;5611;1893;5989
291880;201808;5353;15890;4707;14702;331;1055;3475;10811;3806;11866
291890;201808;1481;3252;1008;2671;177;397;642;1743;819;2140
291900;201808;1155;2994;904;2563;21;89;720;1978;741;2067
291905;201808;2651;6776;2051;5777;83;288;1537;4207;1620;4495
291910;201808;2781;7274;2396;6796;72;243;2081;5894;2153;6137
291915;201808;7104;20776;5899;18688;267;1003;4469;14130;4736;15133
291920;201808;24286;67508;21442;63492;2703;8579;14349;41987;17052;50566
291930;201808;2364;6796;2056;6283;214;725;1437;4288;1651;5013
291940;201808;3648;9766;2488;7720;248;785;1469;4452;1717;5237
291950;201808;8531;26812;7492;24791;644;2348;4898;16266;5542;18614
291955;201808;13393;35255;12182;33694;1359;3692;9174;25848;10533;29540
291960;201808;3043;8396;2506;7600;163;499;1896;5879;2059;6378
291970;201808;4045;11210;3521;10467;176;681;2641;7816;2817;8497
291980;201808;10088;28807;8070;25676;690;2162;5556;17895;6246;20057
291990;201808;2007;5644;1861;5480;12;46;1778;5261;1790;5307
291992;201808;4182;10250;3050;8677;297;791;2361;6799;2658;7590
291995;201808;2097;5838;1709;5242;55;264;1397;4166;1452;4430
292000;201808;2432;6187;2026;5610;150;496;1511;4143;1661;4639
292010;201808;5996;14111;4962;12660;240;660;4110;10380;4350;11040
292020;201808;4476;13407;3797;12183;280;1016;2794;8775;3074;9791
292030;201808;1676;5401;1621;5300;90;345;1040;3297;1130;3642
292040;201808;4167;11096;3437;10053;221;587;2764;8288;2985;8875
292045;201808;3971;10742;2992;9276;59;137;2643;8378;2702;8515
292050;201808;6282;18264;5148;16110;379;1316;3303;10210;3682;11526
292060;201808;12202;28306;11322;27226;665;1541;9758;23246;10423;24787
292070;201808;5614;15136;4948;14334;289;887;4239;12244;4528;13131
292080;201808;3132;8048;2579;7345;116;372;2272;6475;2388;6847
292090;201808;4443;9909;3305;8576;245;657;2569;6766;2814;7423
292100;201808;9971;25845;8575;23965;1433;4144;5101;14327;6534;18471
292105;201808;3211;8729;2853;8176;73;302;2393;6741;2466;7043
292110;201808;6054;15561;4406;12805;1071;3136;2007;5888;3078;9024
292120;201808;6651;17655;5442;15527;487;1443;3942;11123;4429;12566
292130;201808;3154;7974;2672;7365;171;536;2055;5616;2226;6152
292140;201808;5016;12168;4197;10977;219;569;3435;8908;3654;9477
292145;201808;2211;6685;1898;6113;91;318;1424;4590;1515;4908
292150;201808;12803;36556;11587;34694;311;1290;9800;28979;10111;30269
292160;201808;2712;7100;2207;6449;73;222;1847;5475;1920;5697
292170;201808;7998;22145;6695;19932;571;1824;4731;14015;5302;15839
292180;201808;2798;7731;2062;6439;300;893;1199;3750;1499;4643
292190;201808;2743;7579;2363;7036;194;613;1715;5168;1909;5781
292200;201808;7313;19702;5705;17244;977;3043;3132;9616;4109;12659
292205;201808;3735;10635;3295;9944;71;333;2927;8681;2998;9014
292210;201808;5952;14881;5006;13613;106;463;4458;11922;4564;12385
292220;201808;1985;5028;1765;4714;91;267;1358;3555;1449;3822
292225;201808;3159;9407;2833;8904;85;362;2373;7348;2458;7710
292230;201808;7887;19590;7154;18634;192;753;6088;15492;6280;16245
292240;201808;4875;14188;4198;12893;366;1105;2847;8718;3213;9823
292250;201808;5073;14289;4676;13649;619;1735;3143;9324;3762;11059
292260;201808;3217;8858;2894;8421;152;415;2501;7376;2653;7791
292265;201808;3236;9293;2762;8499;86;387;2182;6538;2268;6925
292270;201808;4000;9639;3299;8783;197;561;2724;7282;2921;7843
292273;201808;2500;5641;2055;5086;73;127;1617;4157;1690;4284
292275;201808;1773;4943;1425;4436;67;171;1133;3636;1200;3807
292280;201808;2510;6200;2090;5714;109;236;1719;4870;1828;5106
292285;201808;2490;6245;1975;5509;103;283;1549;4367;1652;4650
292290;201808;6779;19219;5681;17606;202;753;4646;14363;4848;15116
292300;201808;9677;25802;7730;23269;959;3079;5028;15247;5987;18326
292303;201808;2828;8286;2501;7771;63;183;2159;6730;2222;6913
292305;201808;2501;6712;2310;6432;47;218;2058;5616;2105;5834
292310;201808;6416;17134;5588;16094;219;732;4784;13666;5003;14398
292320;201808;6119;16770;5055;14817;286;938;3878;11083;4164;12021
292330;201808;2391;5739;2099;5378;104;259;1684;4365;1788;4624
292335;201808;4678;12334;4211;11652;292;757;3479;9712;3771;10469
292340;201808;5817;16225;4959;14605;248;785;3760;10901;4008;11686
292350;201808;2450;6657;2030;6104;80;308;1698;5117;1778;5425
292360;201808;4789;12945;4055;11649;305;991;2850;7959;3155;8950
292370;201808;10589;24652;9328;22952;159;503;8625;20863;8784;21366
292380;201808;6678;19022;6069;17975;453;1345;4677;13760;5130;15105
292390;201808;4197;8467;3043;7110;124;230;2645;6243;2769;6473
292400;201808;20783;61834;18603;58131;1909;6331;13154;40989;15063;47320
292405;201808;4356;10717;3602;9658;166;402;2931;7875;3097;8277
292410;201808;2033;5116;1796;4831;58;186;1580;4252;1638;4438
292420;201808;3577;11036;3330;10657;166;716;2796;8827;2962;9543
292430;201808;4705;14518;3691;12875;318;1139;2564;9115;2882;10254
292440;201808;7820;25889;7317;25179;107;543;6815;23504;6922;24047
292450;201808;3720;11123;3040;9770;132;490;2381;7627;2513;8117
292460;201808;4749;13498;3954;12119;351;1051;2854;8797;3205;9848
292465;201808;2453;6722;2047;6116;98;260;1464;4562;1562;4822
292467;201808;1729;5164;1589;4967;213;635;1114;3583;1327;4218
292470;201808;2956;7543;2338;6541;76;183;1852;5201;1928;5384
292480;201808;6367;15415;5150;13925;104;391;4599;12222;4703;12613
292490;201808;2054;5558;1731;5061;99;304;1345;3951;1444;4255
292500;201808;6336;17878;5216;15843;585;1760;3471;10545;4056;12305
292510;201808;12238;34010;10031;30636;607;2198;7456;22703;8063;24901
292520;201808;6469;16873;5695;15689;760;2075;3994;11109;4754;13184
292525;201808;5591;13616;4649;12514;119;357;4086;10980;4205;11337
292530;201808;25666;70178;20930;62566;5846;17570;7958;24968;13804;42538
292540;201808;3691;7821;3008;7068;143;320;2628;6184;2771;6504
292550;201808;7458;20968;5896;18937;393;1417;4450;14611;4843;16028
292560;201808;4204;10970;3609;10104;110;419;2972;8247;3082;8666
292570;201808;3874;10315;3359;9517;75;275;2985;8328;3060;8603
292575;201808;6696;20169;6243;19555;281;1004;5275;16471;5556;17475
292580;201808;7243;19152;6260;17691;190;661;5298;14836;5488;15497
292590;201808;7050;19075;6384;18090;290;995;5466;15132;5756;16127
292593;201808;2771;6963;2344;6241;74;200;1938;5119;2012;5319
292595;201808;5266;14245;4644;13459;176;635;3944;11310;4120;11945
292600;201808;10697;29610;9375;27676;498;1396;7362;21870;7860;23266
292610;201808;4276;11254;3593;10086;212;517;2609;7478;2821;7995
292620;201808;6193;17576;5339;16612;63;171;5093;15982;5156;16153
292630;201808;8422;21165;6969;18772;511;1389;4913;13302;5424;14691
292640;201808;8020;24225;7115;22755;260;1063;5232;16704;5492;17767
292650;201808;4539;11239;4139;10710;138;408;3763;9605;3901;10013
292660;201808;10762;30183;9389;28138;520;1720;7486;22409;8006;24129
292665;201808;2153;6541;1964;6296;56;205;1715;5551;1771;5756
292670;201808;3459;9477;2705;8071;132;487;1879;5509;2011;5996
292680;201808;3857;10631;3165;9337;175;526;2343;6751;2518;7277
292690;201808;2515;6792;1800;5612;159;466;1166;3783;1325;4249
292700;201808;9471;26514;8306;24750;867;2490;5696;17477;6563;19967
292710;201808;2308;7478;2138;7258;55;189;1949;6686;2004;6875
292720;201808;9146;22220;7727;20635;300;880;6377;17114;6677;17994
292730;201808;4173;10456;3943;10166;177;373;3475;9011;3652;9384
292740;201808;313148;796337;284241;752317;48178;130529;172629;454447;220807;584976
292750;201808;6130;16611;5311;15375;285;870;4031;11766;4316;12636
292760;201808;3757;11069;3360;10373;269;907;2470;7563;2739;8470
292770;201808;5628;15858;4762;14542;796;2525;2874;9117;3670;11642
292780;201808;1872;3937;1420;3381;52;143;1158;2653;1210;2796
292790;201808;4077;8791;3247;7875;118;338;2867;6923;2985;7261
292800;201808;10525;27019;9228;25017;393;1102;7652;20531;8045;21633
292805;201808;3362;8516;2677;7574;212;553;1989;5654;2201;6207
292810;201808;10067;27847;8057;24750;287;1146;6045;18238;6332;19384
292820;201808;7409;20393;5427;17324;475;1748;3834;12014;4309;13762
292830;201808;2767;6566;2399;6111;85;308;2122;5335;2207;5643
292840;201808;8844;23276;7829;21881;173;632;6869;18752;7042;19384
292850;201808;2525;6886;2114;6239;150;524;1471;4198;1621;4722
292860;201808;15834;37545;14290;35582;851;2089;11668;29039;12519;31128
292870;201808;16209;42812;14366;40116;1049;3370;9858;27202;10907;30572
292880;201808;11113;30602;9704;28558;386;1622;7612;21600;7998;23222
292890;201808;6040;17999;5439;17007;281;1052;4486;13897;4767;14949
292895;201808;2911;6500;2160;5382;94;232;1683;4173;1777;4405
292900;201808;2655;7437;2477;7150;67;306;2024;5639;2091;5945
292905;201808;4171;11476;3275;10109;207;737;2308;7089;2515;7826
292910;201808;4833;13655;4390;12926;312;1047;3258;9488;3570;10535
292920;201808;9673;26938;9099;26139;291;1151;7964;22429;8255;23580
292925;201808;5203;15051;4630;14050;264;817;3505;10515;3769;11332
292930;201808;5957;18443;5329;17197;470;1934;3474;10836;3944;12770
292935;201808;2159;5920;1763;5486;36;169;1570;4943;1606;5112
292937;201808;3047;7459;2671;7003;70;211;2379;6236;2449;6447
292940;201808;3040;7961;2460;7044;180;440;1819;5345;1999;5785
292950;201808;9487;24907;8472;23372;420;1213;6622;18024;7042;19237
292960;201808;5150;12533;4469;11599;95;279;3682;9390;3777;9669
292970;201808;3866;11379;3363;10656;122;532;2790;8847;2912;9379
292975;201808;4390;9690;3918;9144;187;354;3501;8287;3688;8641
292980;201808;3224;8040;2576;7032;111;356;2038;5459;2149;5815
292990;201808;11123;30901;9510;28107;722;2299;7149;21078;7871;23377
293000;201808;2541;6236;2266;5865;39;156;1816;4774;1855;4930
293010;201808;17651;46473;14527;41377;1928;5650;8973;25455;10901;31105
293015;201808;7534;24101;6109;21209;534;2237;4174;14333;4708;16570
293020;201808;9439;28609;8615;27460;159;752;7702;24651;7861;25403
293030;201808;5320;14686;4118;12798;123;441;2816;9006;2939;9447
293040;201808;3855;11075;3431;10491;97;345;3011;9194;3108;9539
293050;201808;20737;53014;18550;49874;1434;3989;13443;36251;14877;40240
293060;201808;3416;9089;2836;8138;177;571;2119;5948;2296;6519
293070;201808;23794;59835;20037;54759;3177;8703;12352;34613;15529;43316
293075;201808;3249;10636;2940;10131;233;1015;2317;7909;2550;8924
293076;201808;3532;9079;3178;8601;103;284;2716;7429;2819;7713
293077;201808;5368;15778;4555;14592;480;1560;3055;10070;3535;11630
293080;201808;4693;14235;4160;13327;159;699;3314;10376;3473;11075
293090;201808;3054;9206;2421;8143;291;1047;1538;5150;1829;6197
293100;201808;5562;15439;4578;13656;289;895;3545;10562;3834;11457
293105;201808;3614;11593;3187;10730;228;821;2346;7803;2574;8624
293110;201808;2363;5919;2017;5449;72;266;1697;4442;1769;4708
293120;201808;4130;11747;3728;11075;124;351;3137;9333;3261;9684
293130;201808;3692;10497;3316;10008;105;416;2854;8554;2959;8970
293135;201808;28327;69440;21221;59412;4144;12749;9244;26201;13388;38950
293140;201808;2211;5358;1973;5062;86;247;1653;4156;1739;4403
293150;201808;5179;16158;4377;14586;470;1599;2981;10056;3451;11655
293160;201808;3830;9499;3295;8866;262;528;2693;7565;2955;8093
293170;201808;4084;9656;3589;9004;128;338;2971;7401;3099;7739
293180;201808;4622;12705;3788;11298;125;554;3080;8937;3205;9491
293190;201808;13376;38003;12020;35988;275;1221;10490;31128;10765;32349
293200;201808;7847;20020;6528;18043;240;917;5142;13928;5382;14845
293210;201808;4984;13460;4293;12358;251;730;3425;9870;3676;10600
293220;201808;4812;13206;3697;11233;894;2724;1477;4705;2371;7429
293230;201808;3835;10315;2973;9045;298;967;1992;6164;2290;7131
293240;201808;4390;11782;3533;10369;108;319;2694;8057;2802;8376
293245;201808;3892;10619;3501;10072;169;574;2965;8424;3134;8998
293250;201808;5367;13399;4630;12369;281;753;3718;9904;3999;10657
293260;201808;4325;12239;3589;11091;116;400;2575;7892;2691;8292
293270;201808;6649;15702;5402;14334;517;961;4152;11738;4669;12699
293280;201808;4731;12764;4108;11895;253;698;3172;9242;3425;9940
293290;201808;12435;39348;11376;37565;2608;8481;6066;20942;8674;29423
293300;201808;5872;14172;5055;13070;323;767;3809;10029;4132;10796
293305;201808;3959;10052;3514;9451;53;163;3164;8492;3217;8655
293310;201808;2098;5482;1757;4886;71;223;1348;3686;1419;3909
293315;201808;4075;10103;3363;9002;163;442;2748;7297;2911;7739
293317;201808;2419;6156;2168;5771;135;318;1687;4504;1822;4822
293320;201808;9572;26272;8942;25526;525;1565;7687;21954;8212;23519
293325;201808;1650;4372;1332;3895;200;603;861;2522;1061;3125
293330;201808;41944;132536;36798;123150;8417;28627;17130;58669;25547;87296
293340;201808;2351;6661;1918;5903;134;473;1312;4002;1446;4475
293345;201808;3131;9003;2642;8303;270;622;1936;6484;2206;7106
293350;201808;6606;19051;5905;18259;66;209;5517;17360;5583;17569
293360;201808;14780;39065;12906;36722;480;1632;11372;32061;11852;33693
310010;201808;786;1921;569;1601;64;210;272;728;336;938
310020;201808;2091;6086;1622;5282;383;1369;276;872;659;2241
310030;201808;2095;6189;1694;5450;249;923;1091;3353;1340;4276
310040;201808;918;2397;764;2166;53;198;563;1523;616;1721
310050;201808;1508;4894;1363;4625;241;955;739;2424;980;3379
310060;201808;3182;9318;2809;8816;149;676;2328;7163;2477;7839
310070;201808;329;794;236;637;10;29;177;473;187;502
310080;201808;808;2237;551;1707;78;284;218;629;296;913
310090;201808;4332;12185;3666;11079;346;1168;2681;7950;3027;9118
310100;201808;3223;9336;2772;8581;114;504;2243;6736;2357;7240
310110;201808;4708;12821;3790;11181;731;2409;1797;5046;2528;7455
310120;201808;599;1526;394;1180;71;272;189;490;260;762
310130;201808;364;1035;309;939;47;183;187;514;234;697
310140;201808;209;652;153;550;38;167;45;132;83;299
310150;201808;4391;12657;3439;10784;685;2369;1333;4034;2018;6403
310160;201808;6750;18432;5089;15611;1285;4350;1534;4584;2819;8934
310163;201808;943;2830;777;2530;243;879;236;702;479;1581
310170;201808;8718;23250;7219;20944;717;2189;5117;14829;5834;17018
310180;201808;1610;4277;1294;3768;116;445;896;2488;1012;2933
310190;201808;2813;8771;2333;7829;591;2188;331;1028;922;3216
310200;201808;1618;5070;1264;4341;231;873;513;1719;744;2592
310205;201808;1040;2910;756;2442;177;606;251;800;428;1406
310210;201808;2648;7115;2208;6422;102;306;1707;4950;1809;5256
310220;201808;1062;2963;876;2654;99;325;613;1813;712;2138
310230;201808;2208;6412;1863;5725;205;777;1171;3363;1376;4140
310240;201808;856;2855;745;2650;63;283;520;1815;583;2098
310250;201808;988;2763;821;2485;65;257;577;1692;642;1949
310260;201808;2555;7196;1637;5510;468;1808;310;804;778;2612
310270;201808;2584;6728;2044;5980;123;488;1668;4773;1791;5261
310280;201808;2231;5414;1780;4760;258;777;1074;2721;1332;3498
310285;201808;1831;6182;1603;5783;173;735;1012;3629;1185;4364
310290;201808;1083;2995;950;2753;199;672;535;1405;734;2077
310300;201808;1399;4413;1273;4198;241;964;647;1953;888;2917
310310;201808;311;802;219;643;35;100;118;344;153;444
310320;201808;492;1317;320;1001;32;134;165;476;197;610
310330;201808;498;1187;300;824;38;126;133;326;171;452
310340;201808;7514;21256;6079;18811;1076;3252;3009;9661;4085;12913
310350;201808;11034;28343;7829;22989;1983;6222;2612;7454;4595;13676
310360;201808;453;1136;367;1025;14;46;282;773;296;819
310370;201808;1273;4109;1077;3721;221;810;376;1336;597;2146
310375;201808;862;2320;577;1853;103;341;236;756;339;1097
310380;201808;381;901;202;584;40;108;74;194;114;302
310390;201808;430;1359;359;1221;101;374;84;227;185;601
310400;201808;9174;23317;6464;19046;1068;3516;3202;9185;4270;12701
310410;201808;738;2221;464;1699;116;450;113;383;229;833
310420;201808;3702;9969;2398;7292;485;1667;634;1714;1119;3381
310430;201808;1312;3748;864;2888;191;696;247;779;438;1475
310440;201808;560;1446;388;1136;24;102;230;650;254;752
310445;201808;1338;3973;1005;3316;55;215;723;2351;778;2566
310450;201808;4615;12066;3497;10286;217;775;2662;7687;2879;8462
310460;201808;1598;4395;1099;3426;233;785;315;953;548;1738
310470;201808;3850;8530;3074;7508;273;790;2407;5735;2680;6525
310480;201808;1044;2845;779;2376;122;420;474;1388;596;1808
310490;201808;2792;8224;2252;7210;373;1418;1071;3185;1444;4603
310500;201808;1422;4178;1032;3427;208;751;479;1560;687;2311
310510;201808;1731;4824;1166;3743;267;943;336;1084;603;2027
310520;201808;1311;3327;953;2734;120;344;569;1631;689;1975
310530;201808;773;2109;420;1314;69;249;87;207;156;456
310540;201808;3245;9579;2702;8601;690;2309;1084;3329;1774;5638
310550;201808;1230;3238;878;2638;91;354;535;1513;626;1867
310560;201808;13046;35903;9900;30605;2229;7705;3598;10169;5827;17874
310570;201808;1047;2984;875;2707;93;366;595;1768;688;2134
310590;201808;4008;11065;3285;9799;321;1101;1892;5383;2213;6484
310600;201808;1361;4171;1122;3656;179;665;549;1662;728;2327
310610;201808;496;1374;324;1078;61;242;158;477;219;719
310620;201808;147674;398722;111769;332943;24295;81891;44633;119629;68928;201520
310630;201808;4327;12281;3642;11028;295;1050;2533;7463;2828;8513
310640;201808;982;3073;824;2753;202;745;280;880;482;1625
310650;201808;2404;7238;1790;6051;225;870;1016;3310;1241;4180
310660;201808;1220;3453;1058;3252;48;156;862;2609;910;2765
310665;201808;1243;3463;1038;3156;52;194;831;2503;883;2697
310670;201808;46142;126790;38981;113852;5951;19378;23295;64895;29246;84273
310680;201808;641;1645;554;1525;25;68;444;1205;469;1273
310690;201808;1629;4599;1235;3912;135;523;702;2101;837;2624
310700;201808;496;1135;373;990;47;143;252;645;299;788
310710;201808;5060;15304;3672;13250;914;3873;433;1501;1347;5374
310720;201808;855;2283;703;2066;63;224;496;1408;559;1632
310730;201808;8859;25465;7699;23572;573;2168;5463;16414;6036;18582
310740;201808;5022;14550;3487;11299;703;2497;996;3023;1699;5520
310750;201808;1199;3007;857;2511;149;493;378;1040;527;1533
310760;201808;520;1463;399;1247;36;118;185;595;221;713
310770;201808;1044;2953;708;2441;108;412;368;1248;476;1660
310780;201808;3932;10180;3185;8984;176;525;2258;6277;2434;6802
310790;201808;1790;5677;1585;5284;335;1137;694;2403;1029;3540
310800;201808;2231;6866;1641;5655;452;1842;112;346;564;2188
310810;201808;1087;2878;888;2515;64;222;586;1591;650;1813
310820;201808;1031;2878;662;2166;143;482;175;568;318;1050
310825;201808;2706;9063;2265;8288;103;584;1816;6456;1919;7040
310830;201808;1387;4138;1026;3423;234;895;411;1284;645;2179
310840;201808;1892;5372;1342;4374;346;1244;350;1024;696;2268
310850;201808;1477;4148;1272;3871;70;341;995;2887;1065;3228
310855;201808;3148;8646;2492;7618;237;866;1771;5277;2008;6143
310860;201808;6763;20028;5486;17501;550;1886;3421;10935;3971;12821
310870;201808;1045;2550;783;2154;86;246;554;1530;640;1776
310880;201808;984;3006;782;2592;100;344;464;1504;564;1848
310890;201808;2187;6293;1482;4985;365;1372;216;632;581;2004
310900;201808;4238;12072;3187;10066;551;1952;1462;4278;2013;6230
310910;201808;1606;4304;1008;3182;138;499;149;401;287;900
310920;201808;1760;4905;1393;4287;243;787;725;2209;968;2996
310925;201808;932;2741;780;2474;102;369;537;1661;639;2030
310930;201808;5688;15590;4206;13161;803;2639;2118;6768;2921;9407
310940;201808;6058;15785;4894;14022;342;1196;3438;9556;3780;10752
310945;201808;1220;3328;1028;3042;102;346;645;1857;747;2203
310950;201808;1792;5486;1262;4318;262;1021;434;1354;696;2375
310960;201808;738;1901;433;1331;60;210;155;483;215;693
310970;201808;1131;3441;795;2722;201;768;187;575;388;1343
310980;201808;358;840;229;633;24;69;148;389;172;458
310990;201808;1189;3523;920;2982;211;714;369;1170;580;1884
311000;201808;3937;11391;3003;9786;836;2910;1132;3557;1968;6467
311010;201808;751;2390;623;2104;244;880;191;623;435;1503
311020;201808;985;2646;665;2032;82;287;300;865;382;1152
311030;201808;1415;3771;973;2987;277;960;338;929;615;1889
311040;201808;319;1022;253;858;68;235;75;234;143;469
311050;201808;2221;6083;1754;5331;418;1409;713;2076;1131;3485
311060;201808;2564;7055;1765;5377;297;1061;704;1929;1001;2990
311070;201808;1793;5018;1329;4201;196;765;616;1828;812;2593
311080;201808;963;2424;793;2123;69;264;549;1345;618;1609
311090;201808;1958;6520;1552;5759;408;1700;452;1634;860;3334
311100;201808;1953;5891;1281;4508;354;1395;186;581;540;1976
311110;201808;3227;7273;2041;5520;466;1361;836;2277;1302;3638
311115;201808;1221;3202;998;2883;81;292;766;2150;847;2442
311120;201808;6361;17299;4747;14279;867;2984;1633;4359;2500;7343
311130;201808;1731;4904;1402;4408;155;624;769;2315;924;2939
311140;201808;1211;3113;923;2696;77;246;598;1787;675;2033
311150;201808;1449;4757;1213;4299;192;757;672;2311;864;3068
311160;201808;3565;10881;2585;9067;775;3030;714;2432;1489;5462
311170;201808;809;2246;638;1971;43;142;398;1252;441;1394
311180;201808;1231;2941;807;2289;207;630;329;937;536;1567
311190;201808;1035;2891;766;2359;123;451;312;862;435;1313
311200;201808;1634;4655;1198;3784;330;1131;288;820;618;1951
311205;201808;872;2733;734;2458;60;264;419;1347;479;1611
311210;201808;957;2950;857;2816;119;384;627;2097;746;2481
311220;201808;709;2109;596;1893;98;346;300;874;398;1220
311230;201808;7509;23347;5689;19590;1122;4089;1968;7031;3090;11120
311240;201808;875;2537;710;2284;148;544;392;1224;540;1768
311250;201808;818;2403;670;2152;157;543;310;966;467;1509
311260;201808;2237;5626;1466;4348;311;952;503;1428;814;2380
311265;201808;1187;3218;916;2770;62;229;646;1886;708;2115
311270;201808;3017;9326;2668;8796;213;987;1928;6041;2141;7028
311280;201808;1130;3090;563;1830;106;380;98;291;204;671
311290;201808;1837;5809;1719;5552;175;583;1188;3808;1363;4391
311300;201808;4427;13094;3745;11981;233;1056;2913;9081;3146;10137
311310;201808;556;1663;477;1512;83;294;209;616;292;910
311320;201808;2976;9460;2635;8694;425;1618;1244;3802;1669;5420
311330;201808;4534;12742;3881;11624;486;1614;2150;6503;2636;8117
311340;201808;9791;29649;7959;26114;2492;8648;2033;6807;4525;15455
311350;201808;2144;5658;1572;4596;173;612;828;2177;1001;2789
311360;201808;867;2390;689;2137;272;928;177;543;449;1471
311370;201808;4193;11058;3173;9297;213;863;1934;5352;2147;6215
311380;201808;389;1233;311;1070;80;277;114;400;194;677
311390;201808;1620;5331;1347;4944;588;2469;359;1134;947;3603
311400;201808;1311;3846;955;3122;158;601;397;1168;555;1769
311410;201808;1501;4762;1294;4474;266;1017;664;2315;930;3332
311420;201808;1571;4811;1066;3681;214;789;161;423;375;1212
311430;201808;3188;8884;2138;6767;421;1406;601;1904;1022;3310
311440;201808;2277;6828;1645;5663;412;1614;481;1594;893;3208
311450;201808;1693;5332;1267;4507;341;1356;282;872;623;2228
311455;201808;884;2158;624;1738;179;494;226;641;405;1135
311460;201808;478;1569;326;1248;81;397;94;320;175;717
311470;201808;416;1357;312;1106;74;295;55;183;129;478
311480;201808;1504;5282;1382;5119;50;141;1230;4717;1280;4858
311490;201808;209;663;178;593;53;203;74;220;127;423
311500;201808;398;1055;292;871;35;124;169;499;204;623
311510;201808;2595;7408;1821;5938;379;1396;607;1851;986;3247
311520;201808;541;1669;503;1586;123;437;271;809;394;1246
311530;201808;8439;20738;5593;15971;1433;4539;1573;4471;3006;9010
311535;201808;707;1975;483;1566;97;375;130;387;227;762
311540;201808;507;1656;456;1558;115;384;246;863;361;1247
311545;201808;2003;5735;1725;5362;101;424;1315;3993;1416;4417
311547;201808;1455;3846;1267;3541;47;163;949;2668;996;2831
311550;201808;2610;7655;2081;6630;361;1313;808;2445;1169;3758
311560;201808;246;576;187;503;34;95;103;250;137;345
311570;201808;1792;4310;1337;3688;62;177;1073;3030;1135;3207
311580;201808;2083;4058;1436;3289;178;354;929;2210;1107;2564
311590;201808;463;1320;382;1199;62;230;208;629;270;859
311600;201808;1528;3748;1274;3430;66;206;1077;2855;1143;3061
311610;201808;2321;8003;1989;7240;385;1443;961;3502;1346;4945
311615;201808;2848;8671;2364;7867;175;722;1782;5808;1957;6530
311620;201808;377;1084;335;1018;26;98;264;786;290;884
311630;201808;1316;3698;1063;3208;83;267;728;2128;811;2395
311640;201808;528;1635;441;1462;98;369;201;624;299;993
311650;201808;1856;5062;1607;4662;131;476;1108;3065;1239;3541
311660;201808;2670;7888;1936;6513;406;1490;412;1196;818;2686
311670;201808;1488;4005;1168;3485;207;691;513;1554;720;2245
311680;201808;2036;6067;1581;5243;265;938;968;3175;1233;4113
311690;201808;538;1211;427;1080;37;94;323;846;360;940
311700;201808;2202;5417;1720;4757;39;141;1428;3865;1467;4006
311710;201808;1410;4219;978;3374;255;949;333;1164;588;2113
311720;201808;403;1256;330;1112;34;147;179;574;213;721
311730;201808;4270;10844;2614;7836;891;2939;383;1126;1274;4065
311740;201808;755;2289;692;2199;38;110;622;1999;660;2109
311750;201808;3699;11607;3107;10605;442;1717;1767;5781;2209;7498
311760;201808;610;1821;510;1632;102;403;202;540;304;943
311770;201808;1852;5672;1447;4878;306;1142;540;1700;846;2842
311780;201808;1126;3515;828;2873;184;711;228;707;412;1418
311783;201808;2095;6093;1742;5488;60;277;1427;4379;1487;4656
311787;201808;693;2078;499;1625;68;256;193;541;261;797
311790;201808;1459;3895;958;3022;226;797;342;1069;568;1866
311800;201808;4465;13933;3723;12283;756;2747;629;1887;1385;4634
311810;201808;934;2985;756;2640;60;247;461;1598;521;1845
311820;201808;714;1934;562;1647;75;269;348;946;423;1215
311830;201808;7897;23647;5557;18408;1626;5770;653;2069;2279;7839
311840;201808;2932;8164;2547;7596;312;1033;1778;5261;2090;6294
311850;201808;302;872;256;798;25;83;164;499;189;582
311860;201808;51099;135351;40388;117450;6729;20706;22893;65119;29622;85825
311870;201808;1752;4964;1241;3994;244;893;471;1338;715;2231
311880;201808;5985;16436;5210;15317;379;1086;3986;11828;4365;12914
311890;201808;1450;3801;1161;3362;130;425;761;2141;891;2566
311900;201808;659;1797;513;1578;49;180;360;1082;409;1262
311910;201808;4069;10854;3144;9641;644;2011;1596;4979;2240;6990
311920;201808;1908;5600;1568;5024;173;579;927;2965;1100;3544
311930;201808;3022;7823;2384;6872;902;2782;738;1984;1640;4766
311940;201808;13034;36192;9834;30021;1599;5375;4439;12782;6038;18157
311950;201808;2095;6011;1599;5127;113;501;1084;3378;1197;3879
311960;201808;542;1341;448;1189;35;166;309;684;344;850
311970;201808;433;1436;292;1066;53;219;63;211;116;430
311980;201808;416;1182;238;808;36;130;72;232;108;362
311990;201808;519;1286;348;1042;87;305;146;405;233;710
311995;201808;940;2674;501;1654;20;72;51;114;71;186
312000;201808;543;1510;458;1380;30;95;340;1029;370;1124
312010;201808;826;2500;657;2149;76;280;394;1254;470;1534
312015;201808;1270;3909;1149;3682;70;303;884;2733;954;3036
312020;201808;1067;3385;923;3116;211;769;371;1220;582;1989
312030;201808;1969;5083;1739;4820;32;150;1608;4398;1640;4548
312040;201808;756;2471;571;2050;70;275;229;795;299;1070
312050;201808;1176;3876;939;3399;226;942;245;774;471;1716
312060;201808;775;2074;559;1781;135;446;265;841;400;1287
312070;201808;828;2502;596;2019;69;256;327;1069;396;1325
312080;201808;2683;6836;2001;5780;166;569;1258;3416;1424;3985
312083;201808;853;2326;658;2019;79;273;429;1258;508;1531
312087;201808;2214;6158;1881;5666;91;336;1449;4350;1540;4686
312090;201808;8986;25118;7000;21734;1456;4806;3082;9520;4538;14326
312100;201808;1503;4645;1079;3858;161;706;494;1669;655;2375
312110;201808;1009;3283;855;2952;241;937;234;718;475;1655
312120;201808;638;1857;477;1566;140;537;178;495;318;1032
312125;201808;1402;3970;1222;3689;141;465;881;2603;1022;3068
312130;201808;849;2191;647;1840;68;220;271;710;339;930
312140;201808;757;2341;629;2052;144;507;251;750;395;1257
312150;201808;448;1298;381;1138;12;53;267;744;279;797
312160;201808;7559;22618;5955;19601;980;3722;2623;8124;3603;11846
312170;201808;830;2311;665;2017;39;134;451;1326;490;1460
312180;201808;1319;3727;1086;3266;163;553;579;1630;742;2183
312190;201808;535;1629;388;1328;90;344;78;259;168;603
312200;201808;4527;12599;3719;11166;719;2217;2057;6140;2776;8357
312210;201808;1290;3148;949;2654;73;269;645;1739;718;2008
312220;201808;1851;5852;1623;5450;123;440;1049;3500;1172;3940
312230;201808;10806;29978;7386;23554;2266;7931;1178;3434;3444;11365
312235;201808;1582;4437;1330;4072;120;422;950;2856;1070;3278
312240;201808;665;2199;512;1868;126;499;147;501;273;1000
312245;201808;2448;6629;2074;6094;72;266;1697;4943;1769;5209
312247;201808;801;2143;589;1816;127;406;292;912;419;1318
312250;201808;931;2484;624;1901;117;374;245;726;362;1100
312260;201808;890;2597;729;2328;59;238;519;1597;578;1835
312270;201808;656;1886;525;1632;34;152;290;828;324;980
312280;201808;413;1270;326;1099;110;376;45;149;155;525
312290;201808;716;2256;599;2028;129;488;204;670;333;1158
312300;201808;845;2585;605;2007;164;600;101;265;265;865
312310;201808;722;2457;619;2244;95;414;294;1026;389;1440
312320;201808;1760;4751;1328;3965;398;1282;258;718;656;2000
312330;201808;836;2485;704;2259;78;287;481;1493;559;1780
312340;201808;232;632;177;540;27;92;96;288;123;380
312350;201808;253;571;210;525;25;74;148;356;173;430
312352;201808;1593;4799;1391;4439;128;422;899;2998;1027;3420
312360;201808;2449;7488;1858;6222;428;1559;465;1517;893;3076
312370;201808;1686;4808;1415;4317;281;973;678;1960;959;2933
312380;201808;2112;5052;1801;4654;22;51;1616;4173;1638;4224
312385;201808;1250;3556;1003;3097;147;528;543;1580;690;2108
312390;201808;1822;5483;1392;4678;260;969;458;1372;718;2341
312400;201808;2767;8412;2198;7301;765;2654;635;2166;1400;4820
312410;201808;10880;31858;9042;28564;1887;6258;4469;13946;6356;20204
312420;201808;3577;10452;3113;9597;554;1839;1708;5153;2262;6992
312430;201808;7782;21260;6343;18729;607;1945;4216;12290;4823;14235
312440;201808;868;2822;668;2344;341;1246;72;228;413;1474
312450;201808;1091;3374;832;2878;247;917;296;1042;543;1959
312460;201808;401;1063;285;890;41;143;167;540;208;683
312470;201808;465;1210;302;924;59;216;101;271;160;487
312480;201808;1119;2844;776;2372;118;381;441;1321;559;1702
312490;201808;1958;4934;1515;4242;226;651;817;2218;1043;2869
312500;201808;821;2158;660;1915;61;227;431;1209;492;1436
312510;201808;3340;9285;2593;7878;552;1681;1016;3027;1568;4708
312520;201808;176;531;147;481;43;142;68;221;111;363
312530;201808;570;1525;496;1430;21;68;437;1264;458;1332
312540;201808;1427;4237;929;3132;193;701;399;1318;592;2019
312550;201808;740;2073;567;1683;49;158;358;973;407;1131
312560;201808;1931;5103;1612;4653;80;300;1274;3621;1354;3921
312570;201808;2150;5743;1685;5095;523;1666;612;1891;1135;3557
312580;201808;549;1661;424;1377;58;222;185;569;243;791
312590;201808;1579;4833;1305;4283;145;613;744;2286;889;2899
312595;201808;1563;5028;1432;4775;265;836;883;3093;1148;3929
312600;201808;918;2348;547;1804;80;325;207;676;287;1001
312610;201808;6193;16112;3983;12021;709;2372;1202;3451;1911;5823
312620;201808;2389;6284;1752;5415;68;302;1360;4256;1428;4558
312630;201808;231;749;192;676;42;170;80;276;122;446
312640;201808;564;1556;373;1228;54;180;125;426;179;606
312650;201808;2029;5485;1386;4193;100;358;916;2622;1016;2980
312660;201808;1312;3269;1003;2790;96;317;686;1842;782;2159
312670;201808;4807;13324;3968;12059;315;1319;2734;7943;3049;9262
312675;201808;1221;3508;1004;3126;76;312;771;2323;847;2635
312680;201808;1345;3908;1145;3609;73;317;881;2705;954;3022
312690;201808;2272;5556;1811;4943;116;368;1427;3808;1543;4176
312695;201808;921;2806;795;2575;64;220;606;1960;670;2180
312700;201808;1971;5425;1446;4443;157;530;810;2401;967;2931
312705;201808;1290;3419;1075;3069;30;112;867;2432;897;2544
312707;201808;1358;4194;1048;3594;85;415;623;2021;708;2436
312710;201808;6055;14128;3580;10331;1092;3438;915;2731;2007;6169
312720;201808;972;2789;723;2362;98;371;389;1212;487;1583
312730;201808;1606;3952;1216;3413;72;231;791;2166;863;2397
312733;201808;1438;3851;1110;3239;42;154;763;2142;805;2296
312735;201808;665;1823;570;1641;77;277;383;995;460;1272
312737;201808;777;1891;546;1537;89;283;285;741;374;1024
312738;201808;549;1518;381;1199;66;255;172;501;238;756
312740;201808;369;918;208;668;52;175;46;123;98;298
312750;201808;1257;4126;1048;3713;170;673;472;1596;642;2269
312760;201808;1797;5567;1318;4554;269;992;411;1371;680;2363
312770;201808;38556;97828;25501;75458;6365;20015;7991;23235;14356;43250
312780;201808;2378;7665;2068;7111;245;971;1342;4568;1587;5539
312790;201808;270;688;168;547;15;66;69;202;84;268
312800;201808;4687;14147;3674;12057;738;2727;1588;5035;2326;7762
312810;201808;1706;4742;1127;3708;287;1048;351;1034;638;2082
312820;201808;1775;4931;1476;4378;67;263;1050;3004;1117;3267
312825;201808;1265;3155;1108;2951;36;115;928;2452;964;2567
312830;201808;2192;6501;1440;5005;382;1461;313;1050;695;2511
312840;201808;1094;3404;855;2894;144;579;328;1004;472;1583
312850;201808;781;2077;561;1714;65;255;283;792;348;1047
312860;201808;1358;3527;879;2732;232;774;237;715;469;1489
312870;201808;5905;16811;3647;12086;606;2206;925;2870;1531;5076
312880;201808;1345;3562;1089;3177;55;191;628;1857;683;2048
312890;201808;1946;5298;1315;4109;184;593;534;1703;718;2296
312900;201808;1147;3180;938;2901;79;269;585;1862;664;2131
312910;201808;1494;2818;831;1945;119;278;415;962;534;1240
312920;201808;956;2681;685;2221;119;458;352;1075;471;1533
312930;201808;2064;5553;1676;4942;381;1153;724;2112;1105;3265
312940;201808;884;2620;726;2354;113;413;349;1114;462;1527
312950;201808;2492;6681;1853;5659;555;1828;675;2003;1230;3831
312960;201808;1889;5134;1593;4699;121;360;1178;3553;1299;3913
312965;201808;1659;5041;1411;4561;125;431;911;2922;1036;3353
312970;201808;1010;3075;797;2705;182;714;339;1077;521;1791
312980;201808;20359;59867;17282;54250;3031;10665;9254;27717;12285;38382
312990;201808;417;1168;281;936;63;248;120;382;183;630
313000;201808;398;1231;323;1091;51;229;157;486;208;715
313005;201808;2516;7464;2187;6908;156;575;1614;4950;1770;5525
313010;201808;4367;12820;3591;11458;693;2441;2071;6429;2764;8870
313020;201808;866;2722;595;2097;115;461;81;222;196;683
313030;201808;1180;2952;802;2362;103;377;447;1241;550;1618
313040;201808;759;2430;626;2126;64;259;336;1077;400;1336
313050;201808;1691;4960;1212;4232;249;1024;351;1096;600;2120
313055;201808;1686;4903;1536;4681;44;140;1338;4078;1382;4218
313060;201808;938;2483;651;1993;212;721;142;384;354;1105
313065;201808;1680;5325;1465;4968;87;397;1115;3672;1202;4069
313070;201808;834;2330;664;2022;91;299;380;1127;471;1426
313080;201808;358;1004;263;825;73;258;69;171;142;429
313090;201808;4469;12714;3841;11605;824;2701;2085;6185;2909;8886
313100;201808;1408;3754;1074;3254;62;239;775;2307;837;2546
313110;201808;1453;4003;1022;3196;110;432;538;1527;648;1959
313115;201808;2311;7158;2037;6599;337;1210;1055;3212;1392;4422
313120;201808;3555;8690;2729;7588;284;880;1739;4794;2023;5674
313130;201808;25582;71527;20706;62137;3095;10533;10861;30868;13956;41401
313140;201808;502;1217;332;950;22;83;233;646;255;729
313150;201808;1289;3827;977;3177;284;972;252;776;536;1748
313160;201808;934;2470;723;2107;59;195;491;1392;550;1587
313170;201808;10894;33264;7876;27206;1582;5730;2878;9618;4460;15348
313180;201808;2190;5999;1528;4652;228;771;779;2300;1007;3071
313190;201808;3886;11762;2930;9724;599;2127;973;3037;1572;5164
313200;201808;1060;3095;913;2828;35;142;754;2260;789;2402
313210;201808;3804;11445;3113;10169;476;1739;1778;5616;2254;7355
313220;201808;1685;4615;1149;3580;200;709;431;1204;631;1913
313230;201808;2662;8075;2386;7705;79;233;2073;6753;2152;6986
313240;201808;8325;22035;5395;17045;1067;3856;2273;6642;3340;10498
313250;201808;5587;17098;4587;15218;608;2204;2514;8203;3122;10407
313260;201808;595;1626;411;1264;61;229;190;549;251;778
313270;201808;5339;15075;4298;13340;768;2526;2508;7791;3276;10317
313280;201808;371;1126;274;915;35;129;113;360;148;489
313290;201808;762;2531;596;2266;232;953;156;565;388;1518
313300;201808;1547;4587;1171;3844;352;1249;210;603;562;1852
313310;201808;982;3075;807;2699;146;568;199;560;345;1128
313320;201808;2073;5666;1476;4705;292;1059;695;2218;987;3277
313330;201808;3890;11015;3066;9694;225;981;2024;6181;2249;7162
313340;201808;1221;2887;870;2374;114;324;600;1627;714;1951
313350;201808;2118;6174;1477;4808;237;863;558;1675;795;2538
313360;201808;1203;3151;837;2538;158;572;434;1219;592;1791
313370;201808;1253;3781;1126;3538;150;568;668;1965;818;2533
313375;201808;1644;4394;1078;3405;216;800;273;829;489;1629
313380;201808;5306;14237;3924;11662;841;2739;1692;4584;2533;7323
313390;201808;854;2843;767;2697;60;263;502;1702;562;1965
313400;201808;3445;9099;2827;8288;184;562;2229;6438;2413;7000
313410;201808;1231;3333;972;2902;102;353;685;1999;787;2352
313420;201808;14538;33632;7720;21980;1768;5561;1072;3134;2840;8695
313430;201808;854;2534;637;2106;109;433;262;780;371;1213
313440;201808;5586;12574;3690;10059;352;1001;2348;6406;2700;7407
313450;201808;611;1766;450;1446;97;337;141;406;238;743
313460;201808;2028;6225;1667;5642;380;1499;780;2473;1160;3972
313470;201808;2996;7535;2426;6737;195;536;1790;5004;1985;5540
313480;201808;855;2503;489;1668;79;304;131;392;210;696
313490;201808;1358;3239;680;2241;245;961;51;175;296;1136
313500;201808;377;1174;297;985;28;110;120;363;148;473
313505;201808;9167;25423;7955;23890;326;1168;6665;19958;6991;21126
313507;201808;1427;3730;1199;3405;46;176;973;2743;1019;2919
313510;201808;12239;34723;10195;31021;1340;4480;5372;15973;6712;20453
313520;201808;12910;38521;10726;34599;841;3175;7676;24334;8517;27509
313530;201808;487;1426;392;1256;27;104;193;593;220;697
313535;201808;2341;6594;2060;6061;154;457;1473;4279;1627;4736
313540;201808;802;2532;606;2010;145;493;210;674;355;1167
313545;201808;1144;3953;987;3628;177;724;551;1944;728;2668
313550;201808;1690;5210;1434;4686;361;1282;694;2169;1055;3451
313560;201808;2494;5155;1879;4415;74;171;1576;3669;1650;3840
313570;201808;937;2967;762;2616;186;705;299;974;485;1679
313580;201808;5214;14525;4139;12738;618;2012;2250;7136;2868;9148
313590;201808;908;2676;705;2362;252;922;258;882;510;1804
313600;201808;3600;10243;3054;9352;167;666;2436;7306;2603;7972
313610;201808;966;2626;795;2310;119;357;492;1404;611;1761
313620;201808;5354;14902;4387;13205;849;2815;2222;6496;3071;9311
313630;201808;7933;20499;5572;16905;761;2631;2993;9034;3754;11665
313640;201808;994;2430;621;1900;193;646;204;594;397;1240
313650;201808;1762;5506;1485;5046;109;453;978;3330;1087;3783
313652;201808;749;2559;696;2445;125;494;435;1465;560;1959
313655;201808;1017;2886;837;2616;61;223;620;1915;681;2138
313657;201808;1264;3461;978;2985;52;217;713;2044;765;2261
313660;201808;835;2493;683;2182;117;453;357;1045;474;1498
313665;201808;4285;12245;3433;10707;544;1922;1907;5701;2451;7623
313670;201808;40037;106769;27225;83543;5243;17634;10797;31587;16040;49221
313680;201808;948;2657;810;2443;61;202;529;1551;590;1753
313690;201808;781;2624;631;2322;144;550;198;729;342;1279
313695;201808;1629;4721;1280;4127;101;370;893;2870;994;3240
313700;201808;3079;10296;2684;9772;244;927;2108;7712;2352;8639
313710;201808;1315;3316;961;2780;100;299;619;1799;719;2098
313720;201808;5076;14648;3736;11933;621;2232;1568;4673;2189;6905
313730;201808;1234;3015;951;2623;83;219;632;1693;715;1912
313740;201808;1646;5945;1356;5182;367;1552;183;627;550;2179
313750;201808;1842;5230;1443;4439;340;1149;545;1543;885;2692
313753;201808;2014;5004;1392;3995;174;553;789;2214;963;2767
313760;201808;4820;13833;3578;11389;878;3003;1324;4013;2202;7016
313770;201808;3572;10430;2872;9359;236;829;1989;6513;2225;7342
313780;201808;3822;10613;2887;9026;354;1269;822;2614;1176;3883
313790;201808;451;1453;406;1367;58;220;225;714;283;934
313800;201808;1289;3148;1025;2759;103;296;690;1834;793;2130
313810;201808;1542;4173;1241;3739;93;326;900;2698;993;3024
313820;201808;12484;30652;8779;24284;1489;4634;3472;9243;4961;13877
313830;201808;298;900;264;843;65;234;130;411;195;645
313835;201808;904;2762;753;2486;102;382;358;1112;460;1494
313840;201808;6144;16739;4490;13877;1181;3922;1038;3227;2219;7149
313850;201808;927;2385;767;2133;116;398;422;1044;538;1442
313860;201808;2491;7096;1845;5765;345;1165;680;1991;1025;3156
313862;201808;1455;3374;778;2311;73;239;411;1163;484;1402
313865;201808;2181;6209;1908;5781;139;451;1440;4299;1579;4750
313867;201808;1041;3461;896;3162;279;1038;402;1394;681;2432
313868;201808;1633;5283;1394;4805;101;444;1031;3478;1132;3922
313870;201808;776;2180;590;1849;118;404;209;592;327;996
313880;201808;1347;3722;1012;3164;216;754;425;1216;641;1970
313890;201808;1934;4578;1421;3913;126;378;935;2609;1061;2987
313900;201808;3425;10850;2675;9337;796;3053;661;2263;1457;5316
313910;201808;570;1789;432;1519;118;437;90;314;208;751
313920;201808;2946;9539;2457;8541;542;1877;1217;4302;1759;6179
313925;201808;1591;4219;1258;3605;252;696;738;2128;990;2824
313930;201808;5630;19492;4747;17900;403;1491;3337;13116;3740;14607
313940;201808;7881;24053;5734;20199;1231;4968;1471;5634;2702;10602
313950;201808;4518;10989;3343;9383;512;1819;1974;5376;2486;7195
313960;201808;5200;13336;3568;10557;820;2656;1220;3385;2040;6041
313970;201808;1267;3695;1131;3454;51;214;718;2195;769;2409
313980;201808;1284;3556;847;2804;135;518;305;965;440;1483
313990;201808;1690;5805;1293;4830;370;1508;388;1346;758;2854
314000;201808;8888;24751;7610;22480;526;2016;5215;15144;5741;17160
314010;201808;1265;3244;1032;2929;41;162;811;2238;852;2400
314015;201808;1998;5650;1567;4964;221;834;872;2692;1093;3526
314020;201808;498;1399;297;989;62;243;56;191;118;434
314030;201808;738;2264;584;1940;79;283;296;968;375;1251
314040;201808;677;1898;556;1665;104;337;275;796;379;1133
314050;201808;1503;4294;1127;3563;190;706;532;1536;722;2242
314053;201808;1687;5135;1391;4581;232;741;817;2812;1049;3553
314055;201808;2228;6228;1938;5801;54;227;1625;4864;1679;5091
314060;201808;1095;3121;867;2730;44;162;618;1903;662;2065
314070;201808;4144;11913;3277;10289;777;2513;1336;4107;2113;6620
314080;201808;1749;5153;1235;4021;214;833;403;1136;617;1969
314085;201808;2004;6265;1669;5735;349;1283;816;2805;1165;4088
314090;201808;3643;10950;3161;10179;256;1039;2132;6791;2388;7830
314100;201808;3114;7520;2497;6670;71;175;2017;5414;2088;5589
314110;201808;4075;12171;3414;10833;523;1885;1778;5263;2301;7148
314120;201808;752;1748;335;1040;83;308;57;166;140;474
314130;201808;710;1965;372;1250;52;205;161;521;213;726
314140;201808;4541;13483;3482;11343;624;2145;1553;4974;2177;7119
314150;201808;1396;3723;1081;3168;108;340;701;1981;809;2321
314160;201808;2199;6021;1642;5037;264;880;731;2280;995;3160
314170;201808;1009;2925;825;2549;89;312;494;1417;583;1729
314180;201808;5191;15054;4341;13661;506;1724;2535;8007;3041;9731
314190;201808;685;1950;507;1676;98;353;260;861;358;1214
314200;201808;2841;8262;2355;7381;142;574;1675;5045;1817;5619
314210;201808;1870;5095;1569;4583;145;473;948;2706;1093;3179
314220;201808;1184;3443;848;2829;241;911;247;757;488;1668
314225;201808;1129;3306;991;3102;71;233;741;2325;812;2558
314230;201808;724;2007;623;1877;94;317;390;1198;484;1515
314240;201808;1036;2887;806;2544;192;666;322;1022;514;1688
314250;201808;510;1477;332;1078;56;193;130;388;186;581
314260;201808;874;2773;721;2481;174;697;326;1024;500;1721
314270;201808;3108;9163;2521;8175;107;427;1878;5977;1985;6404
314280;201808;3206;7807;2018;5775;338;1079;850;2283;1188;3362
314290;201808;4342;11624;3630;10390;445;1287;2374;6699;2819;7986
314300;201808;1423;4335;1049;3529;278;997;312;1041;590;2038
314310;201808;4618;12628;3370;10443;1108;3708;780;2271;1888;5979
314315;201808;861;3149;756;2916;66;310;531;1986;597;2296
314320;201808;2601;7266;1768;5782;401;1412;664;2153;1065;3565
314330;201808;44554;128212;34982;111836;10758;36000;8614;28472;19372;64472
314340;201808;2256;5771;1224;3821;263;990;264;651;527;1641
314345;201808;1341;4173;1128;3779;144;504;694;2286;838;2790
314350;201808;920;2643;632;2078;138;503;167;514;305;1017
314360;201808;591;1786;375;1309;65;251;95;314;160;565
314370;201808;640;1866;530;1679;31;122;398;1217;429;1339
314380;201808;1088;3191;749;2516;205;767;127;423;332;1190
314390;201808;11163;30446;7563;23576;1749;5827;2054;5821;3803;11648
314400;201808;3905;11835;3162;10537;907;3137;1134;3891;2041;7028
314410;201808;2533;7359;1785;5909;319;1170;648;2284;967;3454
314420;201808;733;1913;578;1688;26;123;442;1232;468;1355
314430;201808;6061;16424;4581;13809;941;2983;1760;5283;2701;8266
314435;201808;1387;4200;1192;3866;44;199;911;2917;955;3116
314437;201808;857;2275;660;1992;37;135;375;1149;412;1284
314440;201808;506;1507;385;1280;106;392;119;358;225;750
314450;201808;1281;3598;1074;3262;121;453;667;1916;788;2369
314460;201808;3301;10428;2411;8436;644;2382;403;1413;1047;3795
314465;201808;2195;6518;1930;5994;61;265;1504;4521;1565;4786
314467;201808;855;2464;728;2236;21;62;586;1789;607;1851
314470;201808;2111;6324;1742;5545;369;1300;756;2246;1125;3546
314480;201808;5579;17064;3978;13399;761;2766;1037;3168;1798;5934
314490;201808;851;2414;646;1992;86;307;390;1147;476;1454
314500;201808;1545;4144;1155;3487;230;712;453;1349;683;2061
314505;201808;1884;4928;1580;4507;108;366;1148;3205;1256;3571
314510;201808;1683;4556;1162;3771;248;881;493;1580;741;2461
314520;201808;3811;12262;2661;9562;525;2108;297;919;822;3027
314530;201808;5339;17926;4882;17048;488;1936;3427;11885;3915;13821
314535;201808;2501;6753;2072;6123;141;534;1560;4518;1701;5052
314537;201808;1107;3254;848;2805;71;279;580;1865;651;2144
314540;201808;403;1074;281;840;28;106;139;394;167;500
314545;201808;1643;4397;1475;4168;46;121;1261;3706;1307;3827
314550;201808;621;1589;457;1347;43;168;228;603;271;771
314560;201808;3709;11869;2943;10181;557;2099;999;3284;1556;5383
314570;201808;283;806;222;694;35;116;111;347;146;463
314580;201808;437;1382;326;1145;89;320;67;250;156;570
314585;201808;656;2150;529;1852;73;324;242;788;315;1112
314587;201808;1933;5534;1500;4813;223;642;845;2781;1068;3423
314590;201808;2789;8427;2025;6819;389;1449;734;2365;1123;3814
314600;201808;1748;5099;1035;3634;235;909;115;360;350;1269
314610;201808;8017;22141;5828;18620;1228;4625;2408;7439;3636;12064
314620;201808;1826;4761;1490;4285;71;264;1224;3436;1295;3700
314625;201808;1420;4364;1253;4118;79;414;989;3113;1068;3527
314630;201808;4862;13361;4080;12196;145;609;3374;10006;3519;10615
314640;201808;589;1538;421;1244;83;288;196;519;279;807
314650;201808;851;2175;572;1726;57;216;264;702;321;918
314655;201808;1525;4368;1096;3548;233;762;468;1514;701;2276
314660;201808;319;776;203;552;16;35;115;295;131;330
314670;201808;1584;3878;1156;3211;54;211;740;2000;794;2211
314675;201808;1689;4710;1462;4309;115;416;1134;3256;1249;3672
314690;201808;2000;5999;1529;5210;501;1867;382;1282;883;3149
314700;201808;9296;27794;6056;21038;1410;5442;1442;4796;2852;10238
314710;201808;7283;21076;5197;16653;1159;4063;1217;3476;2376;7539
314720;201808;2009;6273;1477;5139;359;1377;367;1248;726;2625
314730;201808;1968;5688;1464;4696;402;1353;408;1243;810;2596
314740;201808;2696;7874;2172;6940;262;962;1212;3779;1474;4741
314750;201808;323;928;248;777;24;89;132;383;156;472
314760;201808;1813;5712;1248;4379;185;751;310;892;495;1643
314770;201808;1053;3173;516;1731;39;144;133;392;172;536
314780;201808;319;792;213;632;41;139;116;321;157;460
314790;201808;9089;25892;6570;21254;2140;7785;1441;4232;3581;12017
314795;201808;1411;3904;1206;3564;55;244;949;2681;1004;2925
314800;201808;10369;27339;6106;19138;1384;4673;1075;3032;2459;7705
314810;201808;8749;24916;6543;21012;1890;6255;1961;6659;3851;12914
314820;201808;908;2425;687;2069;80;290;411;1191;491;1481
314830;201808;1441;4568;1227;4157;285;1029;586;1972;871;3001
314840;201808;848;2831;684;2574;85;440;463;1643;548;2083
314850;201808;1818;4746;1517;4286;68;238;1287;3602;1355;3840
314860;201808;3062;9648;2584;8690;410;1527;1546;5060;1956;6587
314870;201808;5796;16028;4614;14368;378;1256;3394;10623;3772;11879
314875;201808;1681;5251;1516;5034;101;297;1271;4264;1372;4561
314880;201808;866;2158;684;1904;36;99;469;1350;505;1449
314890;201808;423;1237;301;962;51;189;118;341;169;530
314900;201808;649;1778;498;1512;117;385;178;533;295;918
314910;201808;1587;4789;1227;4215;283;1153;577;1844;860;2997
314915;201808;2196;6768;1867;6174;140;556;1280;4103;1420;4659
314920;201808;414;1067;281;890;14;51;188;589;202;640
314930;201808;5002;15097;3874;12845;858;3111;1366;4296;2224;7407
314940;201808;401;1068;343;963;35;93;209;552;244;645
314950;201808;407;1111;268;872;30;120;110;326;140;446
314960;201808;754;2024;584;1689;54;194;387;1057;441;1251
314970;201808;671;2033;548;1806;101;375;257;811;358;1186
314980;201808;1245;3486;936;3005;292;1053;240;744;532;1797
314990;201808;2121;6353;1455;4788;338;1234;314;906;652;2140
314995;201808;1486;4432;1251;4027;103;418;784;2400;887;2818
315000;201808;1020;2852;776;2433;86;311;483;1464;569;1775
315010;201808;364;1067;272;880;55;211;118;343;173;554
315015;201808;2059;6193;1871;5910;200;700;1221;3882;1421;4582
315020;201808;782;2360;574;1938;82;317;283;890;365;1207
315030;201808;507;1479;370;1199;112;402;87;245;199;647
315040;201808;803;2399;716;2203;104;349;456;1383;560;1732
315050;201808;1059;2889;840;2576;76;296;475;1421;551;1717
315053;201808;1107;3055;867;2604;88;290;502;1466;590;1756
315057;201808;1591;5236;1395;4834;181;626;874;3070;1055;3696
315060;201808;585;1860;404;1470;86;325;82;303;168;628
315070;201808;546;1529;400;1255;108;365;114;328;222;693
315080;201808;2512;7876;1990;6724;430;1438;930;3141;1360;4579
315090;201808;757;2429;579;2057;122;472;192;640;314;1112
315100;201808;1101;3508;717;2555;137;562;289;931;426;1493
315110;201808;1438;3850;1112;3301;152;459;533;1593;685;2052
315120;201808;11235;27093;8199;22718;1102;3047;4328;12533;5430;15580
315130;201808;1232;3735;1001;3252;172;652;382;1156;554;1808
315140;201808;2702;7790;2117;6705;425;1546;1010;2935;1435;4481
315150;201808;3912;10090;2818;8274;452;1469;1274;3641;1726;5110
315160;201808;1483;3812;971;2968;202;643;399;1183;601;1826
315170;201808;1366;4365;936;3352;244;908;174;609;418;1517
315180;201808;15494;39932;8273;25624;1361;4867;2145;5839;3506;10706
315190;201808;2010;4742;1609;4186;252;678;1153;2978;1405;3656
315200;201808;3467;10582;2617;8992;814;3011;609;2069;1423;5080
315210;201808;7600;20671;5602;16429;729;2401;2571;6900;3300;9301
315213;201808;1089;3000;945;2791;28;87;765;2251;793;2338
315217;201808;2415;7775;1951;6930;120;597;1320;4524;1440;5121
315220;201808;8116;22834;6529;20060;1853;5973;2308;7073;4161;13046
315230;201808;2995;7502;2619;7049;57;107;2327;6461;2384;6568
315240;201808;2359;7372;2095;6917;550;1989;1083;3470;1633;5459
315250;201808;9474;27224;7205;22969;1384;4857;3088;9510;4472;14367
315260;201808;867;2571;496;1697;92;320;45;128;137;448
315270;201808;734;2264;514;1805;92;383;148;442;240;825
315280;201808;2561;6682;1493;4590;391;1299;260;769;651;2068
315290;201808;1130;2942;680;2213;214;756;178;580;392;1336
315300;201808;681;1713;466;1431;196;655;115;362;311;1017
315310;201808;1277;3730;968;3122;93;332;535;1627;628;1959
315320;201808;660;1963;479;1625;61;286;214;673;275;959
315330;201808;733;2586;402;1638;76;338;111;401;187;739
315340;201808;2929;7571;2228;6564;198;649;1448;4220;1646;4869
315350;201808;1478;4180;1106;3526;149;531;547;1704;696;2235
315360;201808;1614;5057;1180;4093;200;751;440;1422;640;2173
315370;201808;421;1275;346;1115;62;205;159;494;221;699
315380;201808;188;592;145;493;39;155;28;73;67;228
315390;201808;1116;3402;844;2857;171;637;306;978;477;1615
315400;201808;3901;11249;3144;9845;477;1575;1655;5050;2132;6625
315410;201808;2231;5291;1751;4600;418;1198;523;1357;941;2555
315415;201808;1134;3343;924;2995;245;907;370;1172;615;2079
315420;201808;1051;3198;723;2523;158;574;97;314;255;888
315430;201808;3407;8699;2438;7135;555;1892;908;2456;1463;4348
315440;201808;945;2645;792;2378;99;373;436;1208;535;1581
315445;201808;1911;4838;1432;4118;136;448;999;2819;1135;3267
315450;201808;2125;6318;1830;5842;273;864;1155;3737;1428;4601
315460;201808;29405;88534;25092;80374;6867;23599;9726;29689;16593;53288
315470;201808;447;1306;356;1138;40;149;187;570;227;719
315480;201808;1304;3871;895;2985;196;696;250;822;446;1518
315490;201808;2801;7075;1955;5855;282;910;755;2223;1037;3133
315500;201808;480;1331;293;913;26;100;148;413;174;513
315510;201808;1184;3362;1031;3126;35;153;885;2622;920;2775
315520;201808;1041;2976;824;2624;58;222;571;1763;629;1985
315530;201808;599;1870;473;1581;178;643;171;545;349;1188
315540;201808;1180;3341;829;2664;117;453;349;1074;466;1527
315550;201808;1748;4803;1252;3978;298;1067;383;1151;681;2218
315560;201808;5908;19094;5252;17883;389;1375;3525;12072;3914;13447
315570;201808;1764;5217;1523;4773;112;467;900;2703;1012;3170
315580;201808;2092;5477;1655;4768;393;1287;550;1553;943;2840
315590;201808;881;2436;718;2166;108;385;346;988;454;1373
315600;201808;2334;7831;1740;6632;270;1033;950;3733;1220;4766
315610;201808;871;2302;685;1944;135;477;300;719;435;1196
315620;201808;299;981;271;936;55;189;153;562;208;751
315630;201808;799;2332;676;2110;169;580;215;601;384;1181
315640;201808;317;872;274;801;32;117;170;469;202;586
315645;201808;888;2383;603;1893;169;575;152;447;321;1022
315650;201808;1679;4441;1337;3945;60;252;1070;3044;1130;3296
315660;201808;2400;6063;1832;5082;128;381;1253;3383;1381;3764
315670;201808;11996;35115;9690;30825;2104;7114;4472;13854;6576;20968
315680;201808;2921;9204;2220;7811;427;1650;957;3282;1384;4932
315690;201808;2571;6829;1663;5224;392;1282;467;1594;859;2876
315700;201808;6976;20368;5467;17385;999;3418;2522;7771;3521;11189
315710;201808;1832;4797;1278;3899;72;325;881;2520;953;2845
315720;201808;4020;11861;3460;10827;187;873;2422;7231;2609;8104
315725;201808;1566;4470;1324;4138;161;508;926;2965;1087;3473
315727;201808;525;1465;394;1220;63;225;194;559;257;784
315730;201808;634;1980;560;1820;76;279;263;806;339;1085
315733;201808;1348;3574;954;2864;166;594;360;1010;526;1604
315737;201808;1053;3167;854;2791;46;201;606;1927;652;2128
315740;201808;897;2599;711;2216;132;488;357;1001;489;1489
315750;201808;1180;3316;994;3011;95;320;648;1961;743;2281
315760;201808;1168;2836;1080;2733;46;100;969;2476;1015;2576
315765;201808;1817;5057;1529;4683;42;165;1346;4113;1388;4278
315770;201808;1020;3168;874;2960;345;1284;290;924;635;2208
315780;201808;25227;73660;21750;67254;2246;8381;13475;39772;15721;48153
315790;201808;3498;11100;3019;10206;242;852;2026;7011;2268;7863
315800;201808;1173;4484;875;3618;176;812;200;770;376;1582
315810;201808;1263;3219;1107;2993;56;207;884;2268;940;2475
315820;201808;2338;7071;2029;6565;237;863;1390;4409;1627;5272
315830;201808;1068;3190;782;2656;73;307;335;1075;408;1382
315840;201808;777;1964;475;1384;56;190;205;541;261;731
315850;201808;1026;3254;879;3002;188;706;446;1437;634;2143
315860;201808;483;1494;339;1208;71;274;98;328;169;602
315870;201808;437;1182;354;1057;35;134;236;651;271;785
315880;201808;1092;2894;760;2319;60;242;251;706;311;948
315890;201808;1430;4539;1211;4163;358;1325;523;1723;881;3048
315895;201808;5635;15965;4455;13591;637;2249;2155;6054;2792;8303
315900;201808;826;2180;726;2042;62;200;562;1521;624;1721
315910;201808;469;1456;408;1353;71;254;264;845;335;1099
315920;201808;1542;4171;816;2580;157;528;230;671;387;1199
315930;201808;1004;2420;693;1936;131;371;310;854;441;1225
315935;201808;771;2453;644;2203;147;547;208;731;355;1278
315940;201808;562;1699;476;1539;59;203;252;806;311;1009
315950;201808;1148;3266;986;3002;117;347;738;2272;855;2619
315960;201808;3469;10097;2088;7365;717;2955;134;295;851;3250
315970;201808;594;1691;472;1516;51;165;343;1117;394;1282
315980;201808;3539;8110;2045;5623;435;1288;718;1844;1153;3132
315990;201808;3493;9154;2774;7945;330;1030;1623;4560;1953;5590
316000;201808;495;1409;393;1243;68;265;171;497;239;762
316010;201808;647;1950;515;1691;51;209;313;944;364;1153
316020;201808;968;3003;804;2691;78;358;509;1564;587;1922
316030;201808;2686;7755;2030;6568;239;815;1311;4290;1550;5105
316040;201808;2867;9417;2174;8038;313;1156;810;3235;1123;4391
316045;201808;1892;5342;1762;5158;127;296;1463;4428;1590;4724
316050;201808;342;1046;258;885;45;185;141;452;186;637
316060;201808;664;1839;507;1591;47;190;329;965;376;1155
316070;201808;5396;15708;4513;13990;829;2810;2115;6298;2944;9108
316080;201808;695;2272;569;2008;166;651;75;260;241;911
316090;201808;433;1324;304;1049;53;214;122;387;175;601
316095;201808;1269;3997;1076;3588;247;858;490;1618;737;2476
316100;201808;2468;7658;1794;6109;342;1265;567;1777;909;3042
316105;201808;830;2287;634;1979;85;275;403;1260;488;1535
316110;201808;12055;37383;10329;34375;1193;4244;6761;22551;7954;26795
316120;201808;997;3064;689;2289;140;485;170;476;310;961
316130;201808;1207;2780;733;2013;78;268;393;1033;471;1301
316140;201808;1029;2835;687;2230;129;446;347;1124;476;1570
316150;201808;1572;3841;1326;3461;252;758;593;1435;845;2193
316160;201808;1020;2918;831;2571;83;293;507;1513;590;1806
316165;201808;851;2185;663;1882;107;357;368;999;475;1356
316170;201808;1055;2860;799;2461;87;317;479;1408;566;1725
316180;201808;1232;3685;822;2799;182;685;130;370;312;1055
316190;201808;2513;7440;1475;4882;254;854;514;1506;768;2360
316200;201808;3039;9170;2239;7643;541;2094;557;1789;1098;3883
316210;201808;3825;11692;2798;9349;952;3380;317;1074;1269;4454
316220;201808;587;1821;398;1392;88;332;48;194;136;526
316225;201808;1369;3318;1045;2760;52;209;767;1873;819;2082
316230;201808;417;1124;315;972;35;102;164;524;199;626
316240;201808;5712;16950;5091;15965;496;1622;3867;12033;4363;13655
316245;201808;2935;10036;2663;9574;169;937;2060;7088;2229;8025
316250;201808;8822;22931;6369;18746;1703;5460;1744;4985;3447;10445
316255;201808;2683;7786;2339;7259;236;802;1666;5198;1902;6000
316257;201808;1172;2967;829;2419;118;377;425;1205;543;1582
316260;201808;1776;4738;1342;4051;46;156;777;2430;823;2586
316265;201808;1255;3382;913;2788;47;176;618;1846;665;2022
316270;201808;3357;10886;2923;9902;571;2082;1323;4291;1894;6373
316280;201808;2934;8991;2557;8284;381;1376;1403;4389;1784;5765
316290;201808;3104;9118;2441;7821;400;1497;896;2863;1296;4360
316292;201808;4445;12450;3678;11185;401;1411;2583;7671;2984;9082
316294;201808;736;2249;544;1912;113;453;97;318;210;771
316295;201808;2555;7461;2147;6705;122;521;1557;4647;1679;5168
316300;201808;928;2957;788;2689;60;241;517;1770;577;2011
316310;201808;940;2341;539;1685;84;288;205;623;289;911
316320;201808;552;1613;424;1386;60;226;182;584;242;810
316330;201808;1040;2946;776;2418;69;260;524;1562;593;1822
316340;201808;1038;3034;764;2482;83;354;409;1240;492;1594
316350;201808;1158;3542;1015;3318;135;487;664;2151;799;2638
316360;201808;653;1746;533;1547;61;201;377;1073;438;1274
316370;201808;4348;12518;3448;10765;788;2825;1095;3068;1883;5893
316380;201808;1584;4003;1235;3523;42;122;890;2525;932;2647
316390;201808;821;2249;619;1901;203;698;184;531;387;1229
316400;201808;1210;3563;823;2792;136;497;306;974;442;1471
316410;201808;1040;3179;873;2905;64;234;693;2257;757;2491
316420;201808;1639;5067;1475;4839;98;411;1177;3795;1275;4206
316430;201808;814;2312;525;1752;130;461;117;374;247;835
316440;201808;682;2169;519;1888;140;583;71;247;211;830
316443;201808;561;1650;435;1405;113;408;110;349;223;757
316447;201808;1738;4851;1520;4525;61;209;1236;3668;1297;3877
316450;201808;2148;6804;1683;5836;210;791;1063;3622;1273;4413
316460;201808;886;2438;742;2211;197;629;369;1052;566;1681
316470;201808;5829;17484;4423;14608;932;3498;1542;4705;2474;8203
316480;201808;194;579;166;523;34;119;76;222;110;341
316490;201808;303;831;224;670;29;99;97;259;126;358
316500;201808;1191;3939;767;2835;158;620;122;430;280;1050
316510;201808;594;2160;531;2021;129;530;221;857;350;1387
316520;201808;960;2705;766;2365;129;486;336;974;465;1460
316530;201808;981;2845;747;2403;121;512;323;905;444;1417
316540;201808;669;1993;576;1833;119;441;228;669;347;1110
316550;201808;1223;3843;1099;3594;99;394;808;2581;907;2975
316553;201808;3153;9789;2148;7346;537;1998;464;1432;1001;3430
316555;201808;2536;8526;2321;8211;139;554;1796;6464;1935;7018
316556;201808;585;1444;415;1156;25;73;243;608;268;681
316557;201808;872;2965;767;2768;313;1194;235;814;548;2008
316560;201808;268;828;204;737;51;222;52;167;103;389
316570;201808;1057;3322;950;3100;260;852;352;1149;612;2001
316580;201808;365;870;230;634;51;161;91;236;142;397
316590;201808;1276;3452;929;2789;173;548;504;1420;677;1968
316600;201808;957;3048;840;2803;148;548;450;1465;598;2013
316610;201808;578;1909;486;1752;63;307;308;1047;371;1354
316620;201808;1962;5687;1714;5318;107;406;1282;3981;1389;4387
316630;201808;1479;4557;1184;3974;336;1132;451;1662;787;2794
316640;201808;132;370;110;337;24;78;53;135;77;213
316650;201808;979;3268;795;2976;64;256;501;1933;565;2189
316660;201808;193;486;86;258;12;42;11;31;23;73
316670;201808;1877;5012;1426;4243;403;1265;445;1286;848;2551
316680;201808;2004;5281;1574;4577;148;494;1119;3169;1267;3663
316690;201808;1039;3255;861;2918;211;807;347;1152;558;1959
316695;201808;960;2900;819;2648;43;182;560;1777;603;1959
316700;201808;375;943;316;875;16;74;242;625;258;699
316710;201808;2620;9211;2071;8023;604;2411;725;2860;1329;5271
316720;201808;18357;53612;13994;44879;3035;10465;5486;16905;8521;27370
316730;201808;355;1060;300;937;60;215;133;371;193;586
316740;201808;646;2006;581;1907;64;283;421;1356;485;1639
316750;201808;394;1244;302;1050;65;240;115;386;180;626
316760;201808;3561;11438;2881;10114;1240;4654;815;2779;2055;7433
316770;201808;1464;3692;1191;3311;34;117;1017;2841;1051;2958
316780;201808;558;1737;436;1499;145;569;66;193;211;762
316790;201808;689;1906;509;1573;117;379;171;518;288;897
316800;201808;5564;16550;4552;14673;440;1684;2639;8227;3079;9911
316805;201808;942;2159;812;2014;18;28;734;1880;752;1908
316810;201808;524;1481;371;1195;89;330;165;520;254;850
316820;201808;322;803;166;516;20;70;46;144;66;214
316830;201808;634;1878;536;1719;93;369;329;1002;422;1371
316840;201808;2495;7231;2135;6546;366;1294;1159;3382;1525;4676
316850;201808;1991;5406;1440;4406;201;674;677;2018;878;2692
316860;201808;16611;46708;13022;41088;2614;9438;5865;18008;8479;27446
316870;201808;6191;18326;4725;15324;1035;3680;1677;5165;2712;8845
316880;201808;794;2208;660;2006;139;481;292;862;431;1343
316890;201808;1104;2568;710;2037;149;517;397;1002;546;1519
316900;201808;2159;6112;1747;5263;386;1292;613;1685;999;2977
316905;201808;480;1502;388;1305;84;305;163;544;247;849
316910;201808;846;2382;564;1893;156;612;55;167;211;779
316920;201808;1546;4086;1032;3255;188;641;458;1453;646;2094
316930;201808;7411;23159;5473;19268;1081;4166;1241;4204;2322;8370
316935;201808;3691;10675;2678;8744;641;2210;833;2681;1474;4891
316940;201808;6485;19956;4958;16546;945;3531;1633;5006;2578;8537
316950;201808;1696;4287;1330;3763;58;215;1054;2906;1112;3121
316960;201808;4745;11436;3562;9740;508;1541;2236;5958;2744;7499
316970;201808;3184;9652;2835;8962;707;2298;1037;3134;1744;5432
316980;201808;679;2089;486;1690;155;588;61;212;216;800
316990;201808;9648;28017;7196;22793;2066;6964;846;2474;2912;9438
317000;201808;2549;8090;2339;7785;171;572;1733;5834;1904;6406
317005;201808;2406;7135;2004;6361;361;1168;1045;3276;1406;4444
317010;201808;20623;50653;12733;38346;3354;11019;3334;10579;6688;21598
317020;201808;54475;137038;31769;94968;6594;21616;8531;23390;15125;45006
317030;201808;628;1793;507;1608;36;151;375;1163;411;1314
317040;201808;9914;26423;7182;21608;1789;5618;2746;8426;4535;14044
317043;201808;762;1880;602;1650;99;291;379;1045;478;1336
317047;201808;1138;2816;779;2232;125;340;429;1251;554;1591
317050;201808;1200;3854;868;3070;118;452;330;1057;448;1509
317052;201808;2280;6819;1893;6156;246;877;1240;3974;1486;4851
317057;201808;1583;4095;1152;3344;60;230;753;2123;813;2353
317060;201808;404;1113;227;728;38;126;83;241;121;367
317065;201808;1215;3541;992;3120;62;244;675;2004;737;2248
317070;201808;7506;21511;5008;16391;1139;4198;1084;3378;2223;7576
317075;201808;848;2484;597;1963;135;456;141;443;276;899
317080;201808;5487;13795;4254;11720;1472;4241;1197;3095;2669;7336
317090;201808;4257;13468;3902;12893;360;1225;2885;9505;3245;10730
317100;201808;2434;6015;1659;4806;503;1552;546;1547;1049;3099
317103;201808;1761;5695;1553;5313;204;938;984;3138;1188;4076
317107;201808;1279;3657;1042;3176;64;273;643;1754;707;2027
317110;201808;648;1438;312;940;49;189;105;317;154;506
317115;201808;1076;3188;909;2861;67;210;663;2080;730;2290
317120;201808;11354;33271;8950;29088;1450;5326;4656;14581;6106;19907
317130;201808;8647;21610;5632;16597;1214;3952;1882;5500;3096;9452
317140;201808;573;1745;496;1601;56;179;306;995;362;1174
317150;201808;988;2497;790;2248;42;162;626;1725;668;1887
317160;201808;3494;8704;2435;7112;246;739;1468;4317;1714;5056
317170;201808;1886;4883;1322;3863;226;779;502;1276;728;2055
317180;201808;1576;5218;1229;4397;296;1147;318;1067;614;2214
317190;201808;1204;3418;918;2947;115;385;557;1775;672;2160
317200;201808;4579;12605;3425;10502;881;2939;787;2257;1668;5196
317210;201808;1059;2792;840;2473;51;200;607;1808;658;2008
317220;201808;249;829;223;765;59;217;87;286;146;503
320010;201808;4360;13112;3611;11651;424;1520;2300;7229;2724;8749
320013;201808;1581;4823;1159;3843;191;615;529;1804;720;2419
320016;201808;2938;7819;2392;7025;120;358;1927;5639;2047;5997
320020;201808;3670;10448;2838;8929;762;2556;954;3092;1716;5648
320030;201808;1436;4365;1014;3447;255;948;321;1011;576;1959
320035;201808;1627;4693;1389;4293;408;1381;602;1805;1010;3186
320040;201808;3239;9899;2670;8818;445;1596;1356;4406;1801;6002
320050;201808;1693;4113;1482;3779;280;789;834;2078;1114;2867
320060;201808;9647;28630;7230;23718;1383;4972;2828;8901;4211;13873
320070;201808;1332;3967;986;3253;206;722;317;1013;523;1735
320080;201808;5214;14306;3845;11625;787;2514;1506;4526;2293;7040
320090;201808;6565;18448;4860;15000;1175;3836;2045;6076;3220;9912
320100;201808;2408;7231;1891;6225;491;1728;786;2505;1277;4233
320110;201808;1238;3368;985;2906;223;690;372;1096;595;1786
320115;201808;1736;5848;1509;5438;687;2556;469;1766;1156;4322
320120;201808;14639;40344;10629;32973;2223;7552;3870;11489;6093;19041
320130;201808;34719;103701;29776;94604;5012;17490;16564;51275;21576;68765
320140;201808;2783;8332;2050;6787;458;1728;720;2335;1178;4063
320150;201808;12818;35477;9271;28430;2728;8717;1962;6097;4690;14814
320160;201808;5155;15404;3998;13086;753;2655;1856;6021;2609;8676
320170;201808;1491;4527;1107;3711;314;1074;411;1365;725;2439
320180;201808;668;2210;546;1958;203;772;123;435;326;1207
320190;201808;2723;9116;2090;7612;557;2107;462;1670;1019;3777
320200;201808;983;2892;723;2403;204;764;223;740;427;1504
320210;201808;4364;11633;3445;10009;591;1889;1810;5051;2401;6940
320220;201808;2567;7262;1973;6213;372;1250;1020;3157;1392;4407
320225;201808;1276;4154;905;3214;344;1296;128;447;472;1743
320230;201808;4251;12606;3305;10947;841;3052;1358;4458;2199;7510
320240;201808;12936;35388;10089;30649;2163;7025;4392;13330;6555;20355
320245;201808;2725;8611;2281;7655;959;3312;567;1900;1526;5212
320250;201808;1789;5238;1227;3918;307;1087;290;861;597;1948
320255;201808;1596;5356;1420;5031;533;1918;592;2216;1125;4134
320260;201808;1029;3098;746;2418;220;778;193;530;413;1308
320265;201808;2327;7404;1969;6685;903;3218;486;1650;1389;4868
320270;201808;2164;6439;1654;5392;343;1192;772;2510;1115;3702
320280;201808;5107;14950;4232;13323;1191;3978;1480;4663;2671;8641
320290;201808;1208;3770;838;2859;262;986;186;589;448;1575
320300;201808;3481;11198;2855;9806;958;3517;618;2067;1576;5584
320305;201808;4451;13348;3589;11544;866;2940;1549;4852;2415;7792
320310;201808;1723;4982;1256;3987;264;890;531;1645;795;2535
320313;201808;2031;5448;1341;4057;334;1095;275;792;609;1887
320316;201808;1470;4268;1156;3650;219;740;612;1913;831;2653
320320;201808;19375;53373;13861;43696;3570;11837;5064;15997;8634;27834
320330;201808;2733;7883;2198;6890;593;1820;966;3184;1559;5004
320332;201808;5083;15403;4270;13916;1011;3511;2202;7066;3213;10577
320334;201808;1836;5628;1310;4469;321;1271;288;847;609;2118
320335;201808;1657;4908;1060;3507;293;1051;220;652;513;1703
320340;201808;4610;12291;3883;11153;656;1961;2141;6252;2797;8213
320350;201808;4797;12355;3389;9784;547;1734;1613;4443;2160;6177
320360;201808;1468;3840;1074;3077;159;446;532;1481;691;1927
320370;201808;2399;7856;1871;6586;562;2020;652;2291;1214;4311
320380;201808;2104;5972;1780;5432;338;1134;976;2866;1314;4000
320390;201808;6905;19552;5223;16054;1213;3967;2062;6136;3275;10103
320400;201808;3195;9510;2591;8219;678;2269;1058;3304;1736;5573
320405;201808;4332;11946;3381;10324;534;1717;1804;5479;2338;7196
320410;201808;4615;12692;3541;10969;609;1919;1786;5780;2395;7699
320420;201808;2538;7262;2014;6347;589;2039;540;1674;1129;3713
320425;201808;1935;4769;1492;4036;126;390;986;2554;1112;2944
320430;201808;2578;6766;2039;5695;311;939;1218;3240;1529;4179
320435;201808;2153;7027;1730;6160;642;2383;510;1868;1152;4251
320440;201808;1146;3408;874;2847;152;545;398;1268;550;1813
320450;201808;1514;4582;1214;3992;295;1081;566;1767;861;2848
320455;201808;3650;11536;2549;8894;759;2808;694;2367;1453;5175
320460;201808;2089;6472;1474;5077;371;1343;352;1144;723;2487
320465;201808;1178;3455;901;2885;118;412;526;1689;644;2101
320470;201808;3576;10224;2475;7898;691;2338;541;1619;1232;3957
320480;201808;1582;4695;1357;4248;254;883;701;2132;955;3015
320490;201808;16158;45413;12603;39049;2414;8327;5385;16706;7799;25033
320495;201808;1327;3801;901;2938;213;760;294;929;507;1689
320500;201808;43100;121831;36056;109188;6539;21312;19914;58535;26453;79847
320501;201808;4359;13055;3177;10927;917;3539;951;3163;1868;6702
320503;201808;1924;6114;1451;5088;469;1819;468;1494;937;3313
320506;201808;2758;8393;1885;6345;586;2144;136;428;722;2572
320510;201808;9040;25795;7392;22806;1211;4167;4159;12467;5370;16634
320515;201808;1692;4713;1315;3934;396;1252;364;1104;760;2356
320517;201808;1938;6182;1576;5385;564;2064;369;1242;933;3306
320520;201808;29750;83526;22948;71836;4808;16470;9582;29627;14390;46097
320530;201808;27008;75794;21279;65384;2888;10503;12502;36219;15390;46722
330010;201808;18596;53789;15709;48696;3148;10137;8715;26873;11863;37010
330015;201808;1248;3362;1042;2992;175;563;570;1569;745;2132
330020;201808;18412;48868;16297;45771;2432;7725;11380;31118;13812;38843
330022;201808;1790;5001;1423;4378;254;839;863;2614;1117;3453
330023;201808;3276;8874;2506;7702;592;1911;1103;3343;1695;5254
330025;201808;4532;11748;3170;9343;970;3088;1019;2968;1989;6056
330030;201808;8689;25763;7045;22735;1019;3752;4089;12545;5108;16297
330040;201808;11212;31773;9731;29144;1364;4549;6374;18465;7738;23014
330045;201808;76790;192103;65445;176844;7149;18895;49573;133190;56722;152085
330050;201808;2185;6037;1687;5192;399;1346;783;2275;1182;3621
330060;201808;4804;13351;4055;12126;918;3023;1817;5144;2735;8167
330070;201808;19228;53123;16280;48524;3184;10023;8687;25855;11871;35878
330080;201808;8210;22613;7284;21182;883;2659;4906;14227;5789;16886
330090;201808;2439;5856;1942;5183;209;596;1294;3383;1503;3979
330093;201808;1973;5449;1545;4758;184;572;1050;3270;1234;3842
330095;201808;972;3047;817;2735;103;412;436;1349;539;1761
330100;201808;59483;168539;51420;156225;4344;15556;37418;111851;41762;127407
330110;201808;1943;5914;1723;5532;331;1193;840;2585;1171;3778
330115;201808;1710;4659;1389;4168;228;754;857;2515;1085;3269
330120;201808;2942;7132;2343;6357;203;595;1773;4735;1976;5330
330130;201808;3257;9556;2774;8824;501;1729;1653;5272;2154;7001
330140;201808;3173;8923;2664;8140;446;1577;1609;4761;2055;6338
330150;201808;1948;5516;1558;4864;351;1163;675;2057;1026;3220
330160;201808;1113;3257;937;2995;209;727;478;1455;687;2182
330170;201808;87926;241592;76342;224973;12453;37304;48865;144902;61318;182206
330180;201808;1951;5240;1597;4675;122;442;1115;3152;1237;3594
330185;201808;8847;24505;7433;22090;881;2988;5148;14810;6029;17798
330187;201808;3422;9282;2859;8408;435;1395;1808;5254;2243;6649
330190;201808;27875;72364;24687;67879;2528;7275;18965;51697;21493;58972
330200;201808;13129;36837;11264;34325;2629;7626;6662;21029;9291;28655
330205;201808;1806;4837;1517;4357;112;392;1067;2954;1179;3346
330210;201808;3216;8600;2368;6989;487;1516;856;2367;1343;3883
330220;201808;9192;25511;7120;21591;1732;5707;2139;5986;3871;11693
330225;201808;3295;9124;2696;8178;251;971;1934;5682;2185;6653
330227;201808;15366;40666;13455;38105;1132;3544;10743;30066;11875;33610
330230;201808;1336;3521;1068;3116;87;281;735;2098;822;2379
330240;201808;17997;50576;14858;45252;3161;10458;7724;22894;10885;33352
330245;201808;1259;3464;855;2736;216;727;250;804;466;1531
330250;201808;32646;90115;28254;83246;7043;21020;13914;41897;20957;62917
330260;201808;4148;11534;3323;10227;542;1823;1851;5455;2393;7278
330270;201808;24030;50885;14638;37266;2827;7789;6133;15384;8960;23173
330280;201808;2134;5911;1679;5098;232;782;952;2779;1184;3561
330285;201808;19046;49165;15772;44416;1884;5995;10874;29739;12758;35734
330290;201808;3032;8429;2568;7644;395;1264;1494;4317;1889;5581
330300;201808;3523;10274;2987;9360;395;1420;1903;5781;2298;7201
330310;201808;2159;5822;1710;5053;125;362;1110;3289;1235;3651
330320;201808;12764;34084;11209;31927;1624;4670;8046;23092;9670;27762
330330;201808;27812;69085;23311;62559;2968;8898;16217;42416;19185;51314
330340;201808;12443;33927;9689;29269;2005;6641;4439;12813;6444;19454
330350;201808;93084;242923;80163;225673;8129;24336;60372;169182;68501;193518
330360;201808;7200;18370;6223;17213;392;1152;5111;14069;5503;15221
330370;201808;3437;11358;2950;10315;784;2920;1205;4202;1989;7122
330380;201808;4606;13517;3643;11783;861;3046;1482;4647;2343;7693
330385;201808;3657;11550;3146;10739;852;3170;1378;4733;2230;7903
330390;201808;21477;64351;17374;56352;3506;12373;8474;26523;11980;38896
330395;201808;2920;7926;2538;7398;221;740;1768;5054;1989;5794
330400;201808;2746;7862;2464;7349;203;756;1764;4947;1967;5703
330410;201808;2642;7633;1981;6426;402;1443;879;2700;1281;4143
330411;201808;2361;6800;1980;6047;194;697;1388;4053;1582;4750
330412;201808;1361;4234;1133;3796;177;652;613;1918;790;2570
330414;201808;22119;58508;18346;53235;2384;6870;12469;36231;14853;43101
330415;201808;3354;9587;2634;8337;445;1378;1387;4533;1832;5911
330420;201808;8400;22024;5616;17302;997;3308;2187;6456;3184;9764
330430;201808;7908;21105;6894;19502;690;2298;4835;13176;5525;15474
330440;201808;1548;4694;1320;4335;349;1303;602;1842;951;3145
330450;201808;1244;3841;1024;3429;172;612;514;1675;686;2287
330452;201808;13814;37504;10901;32664;2170;7028;5792;16917;7962;23945
330455;201808;503491;1273114;393616;1105079;68979;205499;232052;641875;301031;847374
330460;201808;1138;3367;899;2991;195;686;431;1393;626;2079
330470;201808;4059;11025;3145;9550;862;2713;1281;3869;2143;6582
330475;201808;8035;22434;6647;20466;1543;5180;3639;11004;5182;16184
330480;201808;5447;15277;4763;14190;613;2064;3073;8854;3686;10918
330490;201808;108969;265293;93107;242800;9935;28118;67605;173184;77540;201302
330500;201808;5145;14611;4686;13927;660;2124;3337;9776;3997;11900
330510;201808;35385;97157;28703;87269;7690;23859;14300;43636;21990;67495
330513;201808;1073;3116;937;2868;274;889;375;1126;649;2015
330515;201808;2450;6991;2035;6291;613;1994;842;2536;1455;4530
330520;201808;9779;28136;8296;25567;1526;5200;4360;12981;5886;18181
330530;201808;1505;3960;1169;3389;265;829;523;1446;788;2275
330540;201808;2577;7267;2072;6366;649;2054;757;2306;1406;4360
330550;201808;7336;22381;6229;20539;2329;8112;1728;5754;4057;13866
330555;201808;11646;29568;9932;27273;1414;4184;6790;18761;8204;22945
330560;201808;4075;11526;3441;10375;470;1499;2102;6150;2572;7649
330570;201808;2680;7771;2276;7060;435;1453;1339;4089;1774;5542
330575;201808;5109;13889;4521;12863;412;1339;3423;9412;3835;10751
330580;201808;10789;31745;8655;27731;2235;7645;3781;11834;6016;19479
330590;201808;1474;4206;1305;3991;157;477;936;2893;1093;3370
330600;201808;10379;29731;8432;26208;1344;4322;4557;14133;5901;18455
330610;201808;8361;24144;7244;22394;840;3060;4736;14196;5576;17256
330615;201808;1644;5101;1403;4765;352;1336;786;2638;1138;3974
330620;201808;3425;10853;2855;9798;908;3344;887;2898;1795;6242
330630;201808;22625;60874;18178;53462;1976;6835;12276;34653;14252;41488
350010;201808;1762;4902;908;2932;245;827;106;284;351;1111
350020;201808;640;1722;333;1093;39;138;134;410;173;548
350030;201808;3500;10397;2661;8762;739;2576;872;2788;1611;5364
350040;201808;576;1803;363;1309;79;321;101;309;180;630
350050;201808;795;2261;596;1868;142;514;183;459;325;973
350055;201808;699;1902;594;1747;51;179;462;1334;513;1513
350060;201808;99;288;75;246;15;47;38;129;53;176
350070;201808;3573;9720;2197;7030;445;1500;712;2084;1157;3584
350075;201808;584;1832;441;1529;188;681;58;177;246;858
350080;201808;602;1625;377;1176;41;135;174;502;215;637
350090;201808;605;1481;345;991;88;267;107;291;195;558
350100;201808;1906;5329;1275;4161;168;653;642;1956;810;2609
350110;201808;375;1086;287;908;23;84;184;569;207;653
350115;201808;1247;3747;1026;3252;183;637;524;1513;707;2150
350120;201808;737;1954;433;1328;55;160;257;798;312;958
350130;201808;2999;8450;2440;7337;372;1208;1325;3778;1697;4986
350140;201808;573;1828;456;1600;40;187;254;815;294;1002
350150;201808;507;1580;429;1419;126;430;124;387;250;817
350160;201808;10000;25581;6521;19319;864;3019;3772;10458;4636;13477
350170;201808;1507;4628;1172;3850;252;882;402;1257;654;2139
350180;201808;1052;2703;573;1737;120;397;211;599;331;996
350190;201808;2755;8067;1978;6412;451;1617;754;2045;1205;3662
350200;201808;379;1082;314;959;22;72;219;637;241;709
350210;201808;4887;11969;3276;9363;653;1950;1735;4826;2388;6776
350220;201808;2212;6566;1699;5447;380;1325;680;1974;1060;3299
350230;201808;842;2473;737;2288;149;497;380;1157;529;1654
350240;201808;652;1946;447;1468;85;279;158;510;243;789
350250;201808;2143;6913;1690;6051;615;2353;364;1386;979;3739
350260;201808;756;1929;503;1457;69;198;276;774;345;972
350270;201808;4333;12449;3514;10763;633;2125;1765;5062;2398;7187
350275;201808;2091;6102;1718;5423;342;1169;860;2569;1202;3738
350280;201808;18243;42164;11122;30534;2191;6402;4003;10718;6194;17120
350290;201808;2914;8493;2012;6631;384;1381;809;2603;1193;3984
350300;201808;609;1750;444;1396;95;312;163;475;258;787
350310;201808;703;2147;590;1898;91;357;272;814;363;1171
350315;201808;518;1466;364;1169;46;174;148;430;194;604
350320;201808;10926;30586;8767;26657;2457;7952;2347;7139;4804;15091
350330;201808;13443;34398;9486;26338;1329;3990;5419;14269;6748;18259
350335;201808;342;987;280;879;21;67;181;564;202;631
350340;201808;1003;2734;619;2001;120;428;222;698;342;1126
350350;201808;688;1936;551;1770;94;328;273;847;367;1175
350360;201808;912;2879;753;2508;225;736;270;920;495;1656
350370;201808;532;1477;367;1121;114;342;82;239;196;581
350380;201808;4273;11904;2921;9280;778;2554;836;2646;1614;5200
350390;201808;9020;25695;7394;22722;2000;6327;2942;8879;4942;15206
350395;201808;391;1012;191;626;23;75;52;157;75;232
350400;201808;7046;18825;5105;15423;1407;4609;1543;4447;2950;9056
350410;201808;8133;24218;6101;20198;1599;5901;1927;5924;3526;11825
350420;201808;555;1643;421;1384;91;343;91;262;182;605
350430;201808;671;1931;560;1729;70;272;352;1003;422;1275
350440;201808;1474;4157;1190;3656;172;598;726;2184;898;2782
350450;201808;5932;17701;4815;15533;1174;4021;1785;5474;2959;9495
350460;201808;1527;3936;797;2461;152;523;188;514;340;1037
350470;201808;223;578;180;500;7;29;118;298;125;327
350480;201808;796;2205;527;1660;107;383;74;189;181;572
350490;201808;1600;4604;1222;3886;296;978;425;1256;721;2234
350500;201808;596;1695;483;1482;85;290;250;743;335;1033
350510;201808;995;2809;737;2302;106;371;406;1194;512;1565
350520;201808;1730;5759;1354;4943;264;1071;549;1878;813;2949
350530;201808;2224;5978;1673;4848;353;1093;794;2175;1147;3268
350535;201808;1329;3919;1185;3705;143;523;801;2447;944;2970
350540;201808;1559;4184;1155;3487;208;666;579;1765;787;2431
350550;201808;8593;21429;5776;16820;728;2466;3035;8320;3763;10786
350560;201808;3480;10409;2831;9120;282;982;1763;5549;2045;6531
350570;201808;19125;56857;15883;50318;3852;13256;7171;21736;11023;34992
350580;201808;1536;4504;895;2964;210;724;121;333;331;1057
350590;201808;4029;11638;2966;9238;602;2130;1499;4296;2101;6426
350600;201808;35473;86404;22928;63249;3289;10073;11484;29207;14773;39280
350610;201808;6159;17590;4606;14544;972;3249;2012;6222;2984;9471
350620;201808;348;933;251;792;32;110;129;392;161;502
350630;201808;1407;3836;1020;3111;91;338;587;1673;678;2011
350635;201808;6812;18268;5246;15656;1042;3465;2746;7797;3788;11262
350640;201808;784;2278;463;1482;63;223;158;440;221;663
350650;201808;7590;21308;4966;15670;1025;3460;1488;4377;2513;7837
350660;201808;4314;11989;3411;10411;685;2151;1676;5167;2361;7318
350670;201808;1490;4421;1326;4149;223;716;775;2436;998;3152
350680;201808;1023;2877;695;2227;144;492;303;944;447;1436
350690;201808;1021;2977;772;2482;143;495;391;1206;534;1701
350700;201808;3865;10820;2899;9193;682;2389;1356;4053;2038;6442
350710;201808;2457;7168;2139;6612;291;1010;1271;3790;1562;4800
350715;201808;787;2284;669;2049;78;299;368;1019;446;1318
350720;201808;147;388;114;334;20;60;52;142;72;202
350730;201808;428;1348;326;1133;53;201;165;536;218;737
350740;201808;1483;4318;997;3227;178;594;269;811;447;1405
350745;201808;514;1423;316;998;35;127;139;389;174;516
350750;201808;8279;23664;6741;20724;1389;4875;2778;7652;4167;12527
350760;201808;12051;32020;8808;26446;2446;7960;2473;6687;4919;14647
350770;201808;696;1889;489;1484;59;189;302;896;361;1085
350775;201808;587;1513;436;1268;58;184;198;571;256;755
350780;201808;1740;4819;1316;4082;313;1064;379;1303;692;2367
350790;201808;1520;4383;968;3288;216;811;165;490;381;1301
350800;201808;2966;9263;2645;8637;445;1565;1375;4388;1820;5953
350810;201808;2036;5401;1726;4985;284;854;1012;3022;1296;3876
350820;201808;759;1903;432;1277;52;167;204;556;256;723
350830;201808;816;2363;469;1567;66;231;141;419;207;650
350840;201808;2530;7975;1922;6758;544;2075;661;2188;1205;4263
350850;201808;6045;18265;4719;15598;1302;4491;1482;4865;2784;9356
350860;201808;3022;8796;2766;8415;134;529;2148;6407;2282;6936
350870;201808;2562;7633;1938;6577;359;1378;994;3266;1353;4644
350880;201808;1157;3586;947;3094;245;827;312;998;557;1825
350890;201808;568;1531;357;1082;48;168;130;331;178;499
350900;201808;5980;17272;3908;12720;1255;4447;588;1774;1843;6221
350910;201808;801;2186;696;1983;118;396;450;1236;568;1632
350920;201808;11200;29462;9624;26773;574;1875;7614;20366;8188;22241
350925;201808;4230;12278;3094;10094;689;2356;1197;3572;1886;5928
350930;201808;1310;3526;905;2731;130;415;462;1320;592;1735
350940;201808;1820;5394;1504;4772;225;785;930;2870;1155;3655
350945;201808;841;2474;645;2077;123;442;288;854;411;1296
350950;201808;74041;204255;58894;173317;9381;30414;34127;95401;43508;125815
350960;201808;5071;14849;4052;12870;701;2544;2237;6733;2938;9277
350970;201808;3306;10456;2586;8857;901;3345;389;1175;1290;4520
350980;201808;556;1685;460;1477;165;550;168;536;333;1086
350990;201808;1623;5033;1265;4372;351;1354;428;1389;779;2743
350995;201808;749;2424;674;2259;53;220;445;1416;498;1636
351000;201808;2370;6507;1747;5319;378;1261;543;1568;921;2829
351010;201808;281;747;164;515;16;54;85;251;101;305
351015;201808;652;2070;539;1849;84;337;258;819;342;1156
351020;201808;8382;24104;6686;21280;1287;4304;3702;11592;4989;15896
351030;201808;2406;7552;1970;6590;320;1237;1009;3213;1329;4450
351040;201808;4159;11185;3575;10247;249;883;2799;7756;3048;8639
351050;201808;15185;38992;10399;31179;2435;7846;4042;11976;6477;19822
351060;201808;41493;109990;32640;94440;4800;15032;20217;56718;25017;71750
351070;201808;1295;3434;765;2454;249;855;94;293;343;1148
351080;201808;2449;6712;1837;5932;395;1434;930;2819;1325;4253
351090;201808;330;1002;229;816;48;180;52;196;100;376
351100;201808;2201;6232;1458;4615;389;1304;373;1217;762;2521
351110;201808;5343;14213;3545;10871;806;2715;1287;3617;2093;6332
351120;201808;668;1821;462;1428;80;255;198;580;278;835
351130;201808;981;2593;464;1541;94;330;88;273;182;603
351140;201808;1537;4833;1165;4047;323;1229;318;978;641;2207
351150;201808;1718;5250;1077;3735;232;857;266;824;498;1681
351160;201808;1040;3461;865;3055;192;727;302;960;494;1687
351170;201808;1302;3876;1146;3536;137;472;720;2105;857;2577
351190;201808;721;2179;546;1756;108;331;215;658;323;989
351200;201808;1540;3940;1191;3392;83;269;784;2149;867;2418
351210;201808;1330;3347;809;2341;90;306;445;1166;535;1472
351220;201808;2857;8689;2515;8061;373;1233;1562;4964;1935;6197
351230;201808;1651;4793;1250;4066;282;1050;540;1574;822;2624
351240;201808;1727;4684;1126;3378;224;721;506;1386;730;2107
351250;201808;949;2672;554;1804;76;270;198;636;274;906
351260;201808;828;2356;662;2026;178;533;212;650;390;1183
351270;201808;317;991;277;908;53;212;144;400;197;612
351280;201808;3826;10781;3061;9253;580;1956;1474;4232;2054;6188
351290;201808;895;2424;623;1909;119;363;288;863;407;1226
351300;201808;13551;39474;9537;31383;2177;7608;3489;11443;5666;19051
351310;201808;2858;7822;2222;6735;252;907;1389;3925;1641;4832
351320;201808;828;2601;634;2112;110;397;227;719;337;1116
351330;201808;1020;3739;961;3634;51;132;831;3244;882;3376
351340;201808;5906;17921;4799;15916;1368;4684;1893;6336;3261;11020
351350;201808;10395;28210;8936;25688;1087;3349;6514;18228;7601;21577
351360;201808;3626;10362;3081;9458;791;2685;1092;3097;1883;5782
351370;201808;2086;6121;1421;4655;366;1250;476;1395;842;2645
351380;201808;41134;106860;31249;88733;5526;16526;16475;45484;22001;62010
351385;201808;242;638;148;451;29;76;52;158;81;234
351390;201808;1267;3303;832;2646;147;553;466;1372;613;1925
351400;201808;838;2507;678;2164;158;510;328;1024;486;1534
351410;201808;2167;6357;1676;5389;314;1034;794;2501;1108;3535
351420;201808;311;789;171;521;40;116;62;182;102;298
351430;201808;702;2143;647;2032;66;231;483;1489;549;1720
351440;201808;2979;8205;2012;6133;408;1362;498;1296;906;2658
351450;201808;1544;4171;1097;3361;240;779;256;732;496;1511
351460;201808;689;1933;566;1715;170;499;270;825;440;1324
351470;201808;1055;2911;856;2542;79;276;534;1489;613;1765
351480;201808;2489;7741;2093;7042;314;1224;1051;3371;1365;4595
351490;201808;1667;5121;1474;4726;90;358;1093;3355;1183;3713
351492;201808;308;874;255;767;15;54;157;445;172;499
351495;201808;161;487;132;412;17;59;75;223;92;282
351500;201808;33046;86134;24420;70686;5109;15611;12173;33815;17282;49426
351510;201808;10656;28665;7985;23671;1289;4174;4656;13278;5945;17452
351512;201808;472;1318;317;965;62;194;113;317;175;511
351515;201808;2803;6713;1714;4894;364;1161;454;1310;818;2471
351518;201808;2113;5733;1433;4495;230;845;769;2186;999;3031
351519;201808;554;1631;386;1237;81;292;89;225;170;517
351520;201808;1044;2689;412;1295;69;242;151;400;220;642
351530;201808;330;953;182;598;34;112;58;155;92;267
351535;201808;1933;4852;1445;4037;173;579;888;2329;1061;2908
351540;201808;1777;4814;1239;3849;439;1499;218;556;657;2055
351550;201808;5409;14638;3728;11152;536;1818;1926;5338;2462;7156
351560;201808;348;1087;291;964;82;301;86;272;168;573
351565;201808;168;546;138;490;37;138;47;159;84;297
351570;201808;16106;45378;12552;37880;1735;5764;7834;22656;9569;28420
351580;201808;269;714;155;486;19;55;57;192;76;247
351590;201808;480;1149;265;734;31;111;150;373;181;484
351600;201808;1498;4024;1143;3368;137;442;666;1833;803;2275
351610;201808;588;1487;414;1192;31;128;236;601;267;729
351620;201808;18203;52561;13867;44292;2682;9797;5692;16340;8374;26137
351630;201808;24275;68718;20294;61520;3727;11809;12309;36585;16036;48394
351640;201808;14611;40906;11574;35079;1496;5133;7511;21886;9007;27019
351650;201808;352;1011;158;534;27;89;30;103;57;192
351660;201808;707;2131;438;1439;76;268;82;246;158;514
351670;201808;4644;13239;3443;10575;668;2114;1697;4931;2365;7045
351680;201808;400;1203;252;813;52;148;66;202;118;350
351685;201808;412;1263;332;1113;89;295;104;337;193;632
351690;201808;924;2543;579;1794;115;382;214;589;329;971
351700;201808;794;2277;680;2063;142;435;323;960;465;1395
351710;201808;632;1825;443;1449;51;199;199;603;250;802
351720;201808;1320;3652;884;2793;162;559;350;1054;512;1613
351730;201808;842;2380;704;2127;94;340;389;1084;483;1424
351740;201808;3651;9532;2834;7934;551;1628;1264;3279;1815;4907
351750;201808;1204;3488;744;2554;151;567;256;871;407;1438
351760;201808;3035;9004;2215;7227;522;1870;746;2245;1268;4115
351770;201808;1811;5545;1516;4967;394;1342;675;2180;1069;3522
351780;201808;1278;3435;661;2073;113;411;192;561;305;972
351790;201808;1157;3009;946;2694;170;458;576;1673;746;2131
351800;201808;556;1276;279;765;39;121;86;200;125;321
351810;201808;909;2502;750;2230;56;153;562;1636;618;1789
351820;201808;2207;6588;1558;5236;393;1400;307;1003;700;2403
351830;201808;4046;11453;3130;9757;407;1462;1768;5252;2175;6714
351840;201808;6700;20277;5304;17609;1003;3710;2401;7509;3404;11219
351850;201808;1786;4739;1129;3545;230;814;331;935;561;1749
351860;201808;2620;8049;2187;7199;449;1566;1143;3741;1592;5307
351870;201808;21027;57591;16898;50647;5615;17322;6349;19680;11964;37002
351880;201808;107211;302527;82719;256466;24804;82731;26006;76770;50810;159501
351885;201808;649;2042;575;1879;119;396;302;959;421;1355
351890;201808;565;1704;452;1492;102;342;74;205;176;547
351900;201808;952;2751;745;2406;147;479;332;1089;479;1568
351905;201808;350;997;244;778;29;101;100;282;129;383
351907;201808;19764;53927;15882;46833;1511;5016;11029;31567;12540;36583
351910;201808;1091;2997;792;2385;125;425;398;1086;523;1511
351920;201808;838;2270;637;1885;82;278;335;937;417;1215
351925;201808;929;2633;721;2225;111;367;348;1014;459;1381
351930;201808;2751;8266;2594;7963;283;1042;2071;6189;2354;7231
351940;201808;1016;2710;730;2194;97;330;410;1196;507;1526
351950;201808;1268;3193;988;2776;50;167;669;1838;719;2005
351960;201808;4558;12489;3484;10527;844;2753;1483;4217;2327;6970
351970;201808;5248;17603;4626;16413;925;3703;2485;8383;3410;12086
351980;201808;830;2250;600;1816;91;329;343;965;434;1294
351990;201808;1284;3232;912;2621;115;409;362;945;477;1354
352000;201808;2122;6558;1838;5973;219;840;1158;3510;1377;4350
352010;201808;1926;5608;1561;4896;412;1383;271;897;683;2280
352020;201808;1466;4162;1147;3593;207;693;545;1631;752;2324
352030;201808;5041;14101;4028;12496;837;2794;2116;6492;2953;9286
352040;201808;2103;5993;1352;4407;266;921;329;953;595;1874
352042;201808;2885;7383;1789;5413;364;1149;747;2275;1111;3424
352044;201808;1872;5383;1091;3793;202;756;217;696;419;1452
352050;201808;11347;31900;7439;23632;1963;7016;1182;3290;3145;10306
352060;201808;680;1971;514;1641;82;304;238;698;320;1002
352070;201808;745;1620;530;1327;85;236;266;631;351;867
352080;201808;433;1162;264;800;43;144;93;245;136;389
352090;201808;1303;4158;1038;3507;185;714;374;1132;559;1846
352100;201808;2834;8402;2381;7510;606;2040;1056;3187;1662;5227
352110;201808;537;1694;425;1446;94;345;166;526;260;871
352115;201808;486;1445;401;1294;84;299;218;694;302;993
352120;201808;821;2579;658;2223;73;294;359;1126;432;1420
352130;201808;1790;5232;1146;3585;232;724;401;1196;633;1920
352140;201808;1269;3500;817;2584;129;438;370;1116;499;1554
352150;201808;768;2153;596;1840;145;450;301;936;446;1386
352160;201808;934;2413;689;2025;107;369;333;907;440;1276
352170;201808;2662;7729;2181;6682;441;1471;1101;3133;1542;4604
352180;201808;2622;7273;2082;6236;514;1683;720;1946;1234;3629
352190;201808;1072;3014;808;2566;142;503;340;1043;482;1546
352200;201808;353;1107;232;839;32;128;75;264;107;392
352210;201808;16060;41060;13163;36817;1555;4664;9501;26373;11056;31037
352215;201808;515;1443;453;1360;57;185;304;885;361;1070
352220;201808;14987;40641;10392;31854;2968;9465;3086;9308;6054;18773
352230;201808;11583;36506;9059;31395;2503;9520;3059;9970;5562;19490
352240;201808;10779;29077;7991;24137;1906;6529;3124;8574;5030;15103
352250;201808;20572;60893;17079;54530;4153;14011;8758;27597;12911;41608
352260;201808;5119;14322;3573;11116;585;2006;1985;5946;2570;7952
352265;201808;871;2578;760;2378;47;192;559;1687;606;1879
352270;201808;1367;4392;1060;3683;254;952;339;1105;593;2057
352280;201808;2196;5942;1734;5232;185;685;954;2688;1139;3373
352290;201808;961;2951;822;2649;164;565;402;1194;566;1759
352300;201808;872;2457;634;1968;101;349;293;815;394;1164
352310;201808;41980;115530;31660;97142;8588;26726;13525;41948;22113;68674
352320;201808;5591;15967;4433;13538;793;2673;2107;5785;2900;8458
352330;201808;1823;5382;1498;4910;368;1357;691;2159;1059;3516
352340;201808;4463;12799;3361;10799;785;2742;1336;4029;2121;6771
352350;201808;1755;5387;1455;4703;226;866;710;2034;936;2900
352360;201808;1051;2976;926;2761;128;478;667;1873;795;2351
352370;201808;946;2918;850;2736;41;196;641;1981;682;2177
352380;201808;783;2269;616;1966;149;515;206;630;355;1145
352390;201808;15621;39247;10434;30250;1680;5376;5646;15549;7326;20925
352400;201808;3166;8976;2673;8088;557;2024;1553;4299;2110;6323
352410;201808;2711;7594;2200;6699;297;1039;1311;3844;1608;4883
352420;201808;859;2142;597;1718;110;341;218;603;328;944
352430;201808;6696;18324;5032;15339;1433;4716;1939;5704;3372;10420
352440;201808;16044;46467;12578;39575;2861;9518;5437;16639;8298;26157
352450;201808;761;2026;385;1271;63;217;113;342;176;559
352460;201808;2535;7503;1832;6053;399;1498;633;1954;1032;3452
352470;201808;3391;8788;2486;7260;292;985;1445;3932;1737;4917
352480;201808;3319;8362;2291;6499;415;1315;1092;2855;1507;4170
352490;201808;658;2085;511;1761;112;431;216;704;328;1135
352500;201808;9278;24855;6798;20209;3461;11201;935;1867;4396;13068
352510;201808;3113;8882;2364;7530;607;2103;864;2603;1471;4706
352520;201808;2195;6544;1776;5725;438;1533;808;2442;1246;3975
352530;201808;8268;23787;5433;17510;1343;4838;917;2293;2260;7131
352540;201808;521;1569;374;1229;79;271;80;241;159;512
352550;201808;903;2737;644;2199;127;470;182;590;309;1060
352560;201808;505;1462;349;1117;61;204;98;282;159;486
352570;201808;1927;5891;1247;4411;321;1219;211;653;532;1872
352580;201808;731;2113;576;1806;117;423;248;725;365;1148
352585;201808;230;702;177;592;21;85;90;281;111;366
352590;201808;12503;34533;9026;27553;2925;9590;3524;10015;6449;19605
352600;201808;1847;5490;1449;4667;257;837;735;2329;992;3166
352610;201808;2905;8552;2260;7395;529;1918;813;2519;1342;4437
352620;201808;5197;14491;4224;12924;1337;4141;1585;4914;2922;9055
352630;201808;764;1958;590;1689;103;359;292;761;395;1120
352640;201808;2682;7284;2024;6145;176;589;1322;3923;1498;4512
352650;201808;546;1613;396;1241;70;245;149;439;219;684
352660;201808;914;2996;774;2707;184;663;316;1081;500;1744
352670;201808;8296;23644;5150;16998;1442;5170;512;1675;1954;6845
352680;201808;2996;9295;2159;7289;401;1506;933;2926;1334;4432
352690;201808;27367;71408;20305;58394;2008;6661;12938;35413;14946;42074
352700;201808;524;1378;389;1176;156;513;101;252;257;765
352710;201808;4599;12642;3390;10334;926;3129;1381;3895;2307;7024
352720;201808;7672;22575;6120;19348;2798;8961;993;2887;3791;11848
352725;201808;401;1118;207;673;16;57;86;261;102;318
352730;201808;2537;7493;2214;6742;396;1368;1237;3426;1633;4794
352740;201808;2043;5120;1580;4403;243;733;857;2288;1100;3021
352750;201808;395;993;204;625;39;111;60;160;99;271
352760;201808;1356;4065;1082;3452;168;577;529;1643;697;2220
352770;201808;727;2137;550;1746;116;388;204;613;320;1001
352780;201808;555;1759;414;1431;91;336;140;461;231;797
352790;201808;512;1402;356;1094;43;142;135;362;178;504
352800;201808;1133;3665;830;2905;225;824;169;527;394;1351
352810;201808;1021;2526;621;1761;95;295;313;822;408;1117
352820;201808;494;1290;328;1009;78;251;70;202;148;453
352830;201808;555;1459;259;803;45;152;54;127;99;279
352840;201808;3619;11239;3108;10242;1082;3748;1025;3270;2107;7018
352850;201808;9760;25767;6685;20595;1922;6327;2021;6035;3943;12362
352860;201808;813;2479;677;2193;132;474;307;963;439;1437
352870;201808;815;2129;559;1559;50;172;343;899;393;1071
352880;201808;1748;4345;1239;3415;199;583;664;1659;863;2242
352885;201808;245;755;195;662;26;91;125;426;151;517
352890;201808;628;1573;403;1074;49;141;210;489;259;630
352900;201808;16043;43857;11400;34661;2157;7210;5134;14587;7291;21797
352910;201808;407;1131;195;637;24;73;43;133;67;206
352920;201808;2414;6511;1783;5369;205;689;1097;3131;1302;3820
352930;201808;5080;14719;3943;12398;793;2628;1705;5117;2498;7745
352940;201808;21257;62258;16390;51750;4788;16635;4563;13430;9351;30065
352950;201808;462;1243;258;832;59;206;22;59;81;265
352960;201808;617;1770;327;1093;49;185;62;194;111;379
352965;201808;263;731;149;499;42;150;27;85;69;235
352970;201808;2896;7152;2276;6163;246;686;1544;4179;1790;4865
352980;201808;1272;3708;1012;3248;213;723;481;1495;694;2218
352990;201808;3800;11146;3183;10110;686;2482;1655;4994;2341;7476
353000;201808;471;1284;230;741;38;133;57;161;95;294
353010;201808;2406;6365;1627;4887;413;1360;531;1472;944;2832
353020;201808;3605;9556;2106;6366;319;1072;772;2159;1091;3231
353030;201808;3872;10509;2723;8284;726;2290;595;1812;1321;4102
353040;201808;567;1434;426;1197;74;233;208;529;282;762
353050;201808;4709;14345;3589;12078;876;3206;1497;4754;2373;7960
353060;201808;43449;117737;36414;106073;3216;11262;26493;74217;29709;85479
353070;201808;8742;25684;6246;20506;1450;5078;2076;6510;3526;11588
353080;201808;3991;11805;2809;9375;669;2455;889;2726;1558;5181
353090;201808;498;1634;425;1470;38;149;250;817;288;966
353100;201808;290;795;108;360;22;80;28;74;50;154
353110;201808;6729;19772;5746;18238;997;3408;3490;11125;4487;14533
353120;201808;446;1201;311;927;60;201;127;325;187;526
353130;201808;2209;5780;1563;4749;471;1554;514;1494;985;3048
353140;201808;2073;5531;1576;4577;187;620;927;2530;1114;3150
353150;201808;1349;3626;991;3003;236;725;390;1131;626;1856
353160;201808;568;1543;394;1238;89;319;149;414;238;733
353170;201808;482;1435;395;1308;74;307;196;599;270;906
353180;201808;9085;23488;7276;20585;990;3115;4994;13773;5984;16888
353190;201808;3229;9055;2587;7734;321;1042;1607;4526;1928;5568
353200;201808;1541;4461;787;2591;151;532;202;588;353;1120
353205;201808;312;1028;267;914;65;252;125;410;190;662
353210;201808;869;2183;577;1664;29;108;360;1000;389;1108
353215;201808;395;1173;327;1029;44;151;137;381;181;532
353220;201808;625;1746;418;1323;110;354;82;251;192;605
353230;201808;741;2213;630;2035;178;650;249;701;427;1351
353240;201808;2014;5907;1693;5292;250;893;988;2941;1238;3834
353250;201808;1186;2778;699;1944;103;295;355;977;458;1272
353260;201808;953;2384;556;1678;117;384;185;520;302;904
353270;201808;603;1692;488;1457;51;157;289;823;340;980
353280;201808;692;1976;490;1531;87;272;166;502;253;774
353282;201808;1718;5123;1513;4713;203;714;886;2632;1089;3346
353284;201808;367;926;187;554;28;99;73;189;101;288
353286;201808;129;357;83;269;20;68;28;79;48;147
353290;201808;1142;3288;797;2552;94;361;416;1205;510;1566
353300;201808;1590;4467;1177;3610;203;713;504;1374;707;2087
353310;201808;338;896;236;693;29;108;132;352;161;460
353320;201808;556;1532;475;1380;23;68;368;1059;391;1127
353325;201808;543;1704;379;1312;89;316;118;401;207;717
353330;201808;497;1364;326;987;46;150;167;473;213;623
353340;201808;2568;7141;1788;5664;511;1723;613;1940;1124;3663
353350;201808;3016;8486;2033;6303;482;1636;388;1033;870;2669
353360;201808;485;1517;401;1336;59;216;205;655;264;871
353370;201808;505;1610;423;1457;44;164;283;946;327;1110
353380;201808;243;775;193;663;34;117;90;298;124;415
353390;201808;4929;13076;3814;11008;656;2015;1860;5110;2516;7125
353400;201808;372;1109;291;939;65;236;55;134;120;370
353410;201808;511;1442;409;1256;86;292;210;622;296;914
353420;201808;434;1197;258;805;52;151;33;87;85;238
353430;201808;1947;5846;1491;4931;396;1430;502;1560;898;2990
353440;201808;56200;162491;40657;130366;8666;29045;19154;59212;27820;88257
353450;201808;381;1014;260;788;37;132;119;335;156;467
353460;201808;3131;8772;2293;7080;215;749;1062;3247;1277;3996
353470;201808;6620;18430;4764;14847;1006;3420;1739;5049;2745;8469
353475;201808;1325;3634;953;2814;134;428;444;1224;578;1652
353480;201808;1452;4131;1226;3670;86;292;849;2441;935;2733
353490;201808;875;2439;620;1890;125;389;265;770;390;1159
353500;201808;940;2317;757;2036;185;493;420;1163;605;1656
353510;201808;742;2302;540;1784;155;538;113;336;268;874
353520;201808;1067;2919;709;2226;85;295;347;1044;432;1339
353530;201808;2351;6489;1846;5482;261;883;947;2620;1208;3503
353540;201808;1899;5555;1583;4998;313;1011;828;2560;1141;3571
353550;201808;5454;15072;4349;13108;948;3045;2072;5954;3020;8999
353560;201808;1892;5729;1449;4949;507;1861;369;1191;876;3052
353570;201808;500;1401;365;1147;78;245;181;548;259;793
353580;201808;1926;5349;1568;4671;367;1118;745;2139;1112;3257
353590;201808;653;1860;411;1302;100;333;131;428;231;761
353600;201808;1583;4205;1318;3675;159;461;728;1963;887;2424
353610;201808;535;1724;402;1432;98;397;101;324;199;721
353620;201808;2410;6937;1750;5676;400;1394;510;1503;910;2897
353625;201808;489;1276;298;896;29;103;174;503;203;606
353630;201808;1131;3691;882;3106;211;786;236;770;447;1556
353640;201808;1287;3471;1019;3004;119;392;629;1820;748;2212
353650;201808;8450;23762;6191;18924;903;3053;3326;9503;4229;12556
353657;201808;272;795;216;696;28;92;107;325;135;417
353660;201808;1099;2460;745;1917;317;830;183;425;500;1255
353670;201808;3331;9966;2768;8818;676;2369;1307;3863;1983;6232
353680;201808;704;2006;536;1741;108;377;268;838;376;1215
353690;201808;456;1195;183;590;19;69;21;56;40;125
353700;201808;1740;5049;1500;4563;204;671;951;2786;1155;3457
353710;201808;3538;8155;1945;5401;259;716;1044;2686;1303;3402
353715;201808;432;1184;285;896;19;83;101;287;120;370
353720;201808;1810;5151;1468;4623;233;825;913;2755;1146;3580
353730;201808;3953;11255;2978;9228;514;1725;1371;3967;1885;5692
353740;201808;1730;4754;1183;3694;302;1063;345;985;647;2048
353750;201808;790;2526;556;2034;141;549;99;355;240;904
353760;201808;11258;28166;8988;24898;1322;3978;5702;15482;7024;19460
353770;201808;678;2050;336;1156;63;209;35;81;98;290
353780;201808;4219;13005;3349;11196;947;3458;917;2840;1864;6298
353790;201808;2158;6908;1671;5868;531;2153;348;1021;879;3174
353800;201808;15546;44509;12227;38546;2347;7917;5930;18635;8277;26552
353810;201808;991;2797;660;2139;116;448;254;782;370;1230
353820;201808;1556;4662;1148;3759;245;873;410;1322;655;2195
353830;201808;571;1475;435;1249;56;168;239;655;295;823
353850;201808;1597;4632;1229;3907;343;1059;386;1277;729;2336
353860;201808;2396;7194;1908;6164;486;1701;774;2364;1260;4065
353870;201808;26006;71486;18188;55878;2983;10124;8514;24029;11497;34153
353880;201808;2778;8141;2215;7083;251;927;1262;3908;1513;4835
353890;201808;2224;5169;1560;4163;148;445;1028;2610;1176;3055
353900;201808;665;1919;494;1581;100;344;205;640;305;984
353910;201808;2001;6480;1759;6073;224;798;1268;4450;1492;5248
353920;201808;2090;5853;1419;4514;309;1138;346;934;655;2072
353930;201808;3822;10780;2656;8607;693;2444;715;2121;1408;4565
353940;201808;963;2976;678;2332;148;532;207;671;355;1203
353950;201808;2835;8334;2309;7280;466;1625;1233;3574;1699;5199
353960;201808;603;1804;416;1388;90;280;136;446;226;726
353970;201808;588;1591;480;1407;45;141;313;901;358;1042
353980;201808;13048;35421;10354;30473;1416;4418;6595;18928;8011;23346
353990;201808;794;2046;509;1500;53;175;283;789;336;964
354000;201808;2235;5728;1311;3942;278;888;261;801;539;1689
354010;201808;340;953;254;796;24;75;170;517;194;592
354020;201808;3392;10152;2724;8625;757;2570;952;2773;1709;5343
354025;201808;692;1965;462;1495;92;319;109;338;201;657
354030;201808;415;972;225;613;41;108;82;210;123;318
354040;201808;720;1792;459;1326;38;121;286;793;324;914
354050;201808;884;2686;634;2167;168;613;169;565;337;1178
354060;201808;3735;11010;2534;8384;679;2353;708;2158;1387;4511
354070;201808;2939;8632;2130;6995;518;1872;588;1659;1106;3531
354075;201808;2075;6652;1656;5827;253;1037;885;3016;1138;4053
354080;201808;1383;4010;889;2982;179;617;237;722;416;1339
354085;201808;401;863;321;764;2;11;216;478;218;489
354090;201808;1371;3984;1216;3662;109;376;897;2651;1006;3027
354100;201808;14737;43798;10987;36940;2723;9785;4561;15293;7284;25078
354105;201808;972;2717;822;2475;123;382;504;1493;627;1875
354110;201808;380;1042;301;926;81;265;101;301;182;566
354120;201808;1467;4090;980;3006;197;631;332;904;529;1535
354130;201808;5314;14522;3525;10956;1138;3854;188;389;1326;4243
354140;201808;19160;47507;12523;35592;2664;8091;4753;12645;7417;20736
354150;201808;3053;7721;2298;6422;491;1474;1017;2709;1508;4183
354160;201808;3070;9339;2297;7645;702;2449;707;2299;1409;4748
354165;201808;502;1558;410;1374;84;320;196;611;280;931
354170;201808;1402;4200;1137;3618;93;328;676;2038;769;2366
354180;201808;443;1277;320;998;59;210;123;338;182;548
354190;201808;1360;4046;1022;3349;131;462;389;1256;520;1718
354200;201808;851;2248;668;1950;86;257;352;966;438;1223
354210;201808;631;1856;512;1631;49;183;325;950;374;1133
354220;201808;2889;8172;2221;6844;424;1390;1086;3176;1510;4566
354230;201808;646;1777;510;1589;59;246;327;946;386;1192
354240;201808;1416;4149;934;3123;181;658;257;756;438;1414
354250;201808;490;1332;329;1067;100;326;100;326;200;652
354260;201808;7490;20991;5897;18179;1483;4779;2122;6548;3605;11327
354270;201808;1044;3235;831;2823;184;641;318;1084;502;1725
354280;201808;714;1949;610;1785;79;298;371;997;450;1295
354290;201808;794;2696;689;2439;132;475;311;1105;443;1580
354300;201808;3488;10723;3099;9991;1044;3493;1011;3089;2055;6582
354310;201808;673;2051;539;1764;109;388;208;627;317;1015
354320;201808;842;2211;531;1624;93;332;204;542;297;874
354323;201808;508;1297;334;956;41;113;135;373;176;486
354325;201808;1123;3496;823;2821;161;578;336;1105;497;1683
354330;201808;6740;18389;4929;14543;811;2833;2826;7705;3637;10538
354340;201808;23599;63792;16557;51272;4133;13842;6708;20042;10841;33884
354350;201808;1102;3047;903;2656;133;435;553;1518;686;1953
354360;201808;514;1456;303;1038;55;180;50;170;105;350
354370;201808;939;3011;799;2740;138;506;440;1473;578;1979
354380;201808;763;2070;514;1627;101;380;115;299;216;679
354390;201808;12338;31572;7896;23588;1701;5443;2511;7122;4212;12565
354400;201808;1486;4965;1169;4193;225;852;424;1517;649;2369
354410;201808;4865;14209;3824;12095;940;3197;1661;5070;2601;8267
354420;201808;1334;3725;961;2932;139;455;548;1594;687;2049
354425;201808;2119;5603;1632;4712;413;1181;612;1843;1025;3024
354430;201808;1393;3955;1112;3487;195;694;556;1644;751;2338
354440;201808;495;1402;320;1011;36;118;147;426;183;544
354450;201808;374;1006;203;666;29;99;52;157;81;256
354460;201808;811;2208;552;1692;95;311;256;761;351;1072
354470;201808;478;1242;318;904;31;97;156;398;187;495
354480;201808;994;2350;693;1878;61;181;460;1189;521;1370
354490;201808;751;2278;551;1841;122;441;205;629;327;1070
354500;201808;1987;5855;1670;5380;563;2000;415;1344;978;3344
354510;201808;737;2067;601;1778;88;282;321;857;409;1139
354515;201808;276;864;208;724;39;153;85;284;124;437
354520;201808;6288;18445;4122;13203;697;2490;2156;6443;2853;8933
354530;201808;3652;11343;2868;9678;739;2598;1085;3660;1824;6258
354540;201808;1245;3499;913;2856;220;728;288;926;508;1654
354550;201808;512;1389;389;1149;59;182;231;646;290;828
354560;201808;1852;4821;1018;3033;140;432;505;1452;645;1884
354570;201808;1073;2910;470;1436;99;326;71;201;170;527
354580;201808;9084;24578;5929;18467;1019;3495;2737;8052;3756;11547
354600;201808;1627;4770;1289;4108;202;699;717;2206;919;2905
354610;201808;363;976;186;578;35;118;56;163;91;281
354620;201808;442;1315;292;1012;54;208;103;297;157;505
354625;201808;305;875;181;617;24;78;51;151;75;229
354630;201808;1790;5573;1464;4910;639;2270;185;594;824;2864
354640;201808;2952;8987;2149;7234;418;1595;605;1863;1023;3458
354650;201808;857;2399;695;2091;73;227;408;1222;481;1449
354660;201808;2482;6470;1671;5099;126;476;1152;3445;1278;3921
354670;201808;998;2875;707;2237;136;473;271;791;407;1264
354680;201808;4211;12167;3538;11010;920;2939;1823;5738;2743;8677
354690;201808;562;1806;391;1403;99;379;107;369;206;748
354700;201808;909;2460;630;1882;113;375;292;766;405;1141
354710;201808;485;1359;335;1036;45;168;152;417;197;585
354720;201808;283;728;135;412;45;136;28;84;73;220
354730;201808;9147;26720;6754;22075;1055;3758;3663;11531;4718;15289
354740;201808;318;884;123;433;19;76;23;73;42;149
354750;201808;2325;6447;1576;5024;329;1202;599;1738;928;2940
354760;201808;1734;5003;1245;4037;375;1302;316;980;691;2282
354765;201808;235;654;112;368;21;83;24;66;45;149
354770;201808;2168;5615;1548;4531;333;1064;637;1773;970;2837
354780;201808;50181;132502;39118;109926;5953;18678;22306;58910;28259;77588
354790;201808;850;2554;709;2292;106;365;395;1238;501;1603
354800;201808;2455;6796;1912;5840;467;1498;787;2282;1254;3780
354805;201808;1000;2671;742;2188;101;325;341;901;442;1226
354810;201808;557;1689;323;1153;55;214;85;281;140;495
354820;201808;881;2756;649;2272;134;528;156;483;290;1011
354830;201808;455;1146;300;863;85;245;109;300;194;545
354840;201808;704;2009;455;1401;64;188;214;644;278;832
354850;201808;18948;52572;13548;42310;2130;7716;7526;22019;9656;29735
354860;201808;1301;3919;938;3179;192;705;310;933;502;1638
354870;201808;46113;121430;36920;104429;5659;17485;21694;58808;27353;76293
354880;201808;5391;13946;2533;7515;366;1216;869;2101;1235;3317
354890;201808;14493;38606;11699;33853;1871;5943;6652;18661;8523;24604
354900;201808;411;1125;256;819;34;121;76;223;110;344
354910;201808;4706;13236;2779;9387;605;2173;298;965;903;3138
354920;201808;416;1126;168;574;23;104;34;95;57;199
354925;201808;267;807;133;483;23;85;30;88;53;173
354930;201808;357;900;217;650;25;85;106;295;131;380
354940;201808;1647;5404;1271;4526;461;1761;165;557;626;2318
354950;201808;1410;4020;1137;3577;78;340;746;2217;824;2557
354960;201808;755;2116;585;1849;126;452;260;774;386;1226
354970;201808;3577;10908;2919;9621;472;1687;1696;5425;2168;7112
354980;201808;27202;68083;18390;52252;2455;8205;10022;26515;12477;34720
354990;201808;55508;148356;41338;121871;5131;16626;24233;68361;29364;84987
354995;201808;2315;5902;1750;5085;292;949;1056;2918;1348;3867
355000;201808;1330;3763;1067;3312;215;767;362;993;577;1760
355010;201808;2783;8276;1897;6208;715;2451;169;571;884;3022
355020;201808;3048;9135;2285;7699;757;2811;587;1912;1344;4723
355030;201808;1233244;3140278;907323;2484521;167796;500043;442230;1127296;610026;1627339
355040;201808;2674;7492;2247;6850;392;1239;1425;4346;1817;5585
355050;201808;903;2386;668;1988;219;650;172;488;391;1138
355060;201808;4900;14208;3711;11882;692;2518;1756;5067;2448;7585
355070;201808;7240;20281;5871;17942;839;2950;3440;9819;4279;12769
355080;201808;748;2313;481;1753;106;423;42;143;148;566
355090;201808;1108;3390;855;2880;221;730;257;891;478;1621
355100;201808;19221;53258;15392;47437;3053;10088;9071;27558;12124;37646
355110;201808;946;2800;724;2414;262;937;142;486;404;1423
355120;201808;590;1671;428;1376;71;253;157;477;228;730
355130;201808;612;1459;295;800;24;64;159;401;183;465
355140;201808;1368;3726;1227;3504;137;467;910;2529;1047;2996
355150;201808;3759;10536;3017;9191;470;1513;1654;4926;2124;6439
355160;201808;1711;4994;1299;4234;345;1268;325;1021;670;2289
355170;201808;8099;22103;6500;19367;1756;5550;3055;8972;4811;14522
355180;201808;2586;7536;1924;6328;458;1750;625;1810;1083;3560
355190;201808;1656;4658;1329;4085;373;1179;602;1936;975;3115
355200;201808;762;2511;665;2339;255;1003;193;605;448;1608
355210;201808;2802;8087;2377;7216;298;1065;1440;4122;1738;5187
355220;201808;40063;111842;32027;96024;8969;28405;11874;32857;20843;61262
355230;201808;1086;2802;588;1770;124;375;160;474;284;849
355240;201808;21054;56841;14383;43564;2508;8072;6652;19678;9160;27750
355250;201808;32702;91667;24514;75991;6550;21571;9031;27119;15581;48690
355255;201808;806;2111;416;1301;79;240;133;417;212;657
355260;201808;1178;3161;890;2667;121;439;542;1520;663;1959
355270;201808;1236;3836;958;3184;236;814;324;1031;560;1845
355280;201808;25649;69842;18714;56052;3434;10980;8467;24162;11901;35142
355290;201808;718;2153;559;1791;135;417;208;633;343;1050
355300;201808;1143;3434;915;2967;192;670;307;989;499;1659
355310;201808;984;2814;741;2376;82;290;408;1319;490;1609
355320;201808;499;1347;369;1087;68;233;145;369;213;602
355330;201808;2081;5828;1560;4842;182;637;1009;2998;1191;3635
355340;201808;3072;7146;2605;6479;303;745;1811;4506;2114;5251
355350;201808;1246;3816;918;3106;196;707;289;969;485;1676
355360;201808;1190;3333;1016;3011;95;305;731;2174;826;2479
355365;201808;355;985;181;627;40;123;26;92;66;215
355370;201808;5355;14141;4188;12420;1039;3111;1850;5841;2889;8952
355380;201808;2816;7917;2119;6503;411;1386;668;1763;1079;3149
355385;201808;1210;3558;1048;3280;143;546;598;1711;741;2257
355390;201808;714;2029;531;1639;120;380;211;605;331;985
355395;201808;1814;5317;1287;4153;195;679;561;1661;756;2340
355400;201808;8449;26267;6934;22994;2076;7604;2087;6300;4163;13904
355410;201808;20621;58890;13988;45974;3626;13006;3201;10579;6827;23585
355420;201808;647;2236;540;2000;159;675;123;431;282;1106
355430;201808;3498;9163;2708;7770;725;2055;1154;3360;1879;5415
355440;201808;808;2276;507;1604;106;348;163;488;269;836
355450;201808;3292;8991;2115;6614;446;1489;765;2211;1211;3700
355460;201808;522;1380;337;1042;48;162;151;414;199;576
355465;201808;352;1059;254;836;48;175;79;255;127;430
355470;201808;1152;3076;625;1944;189;609;184;537;373;1146
355475;201808;268;683;238;630;22;70;185;487;207;557
355480;201808;3330;10095;2849;9272;460;1719;1764;5558;2224;7277
355490;201808;896;2515;484;1584;55;196;206;640;261;836
355495;201808;733;2232;558;1892;82;288;184;613;266;901
355500;201808;6077;16920;3681;11732;615;2150;1092;3226;1707;5376
355510;201808;1251;3356;787;2414;127;425;273;746;400;1171
355520;201808;340;802;165;464;26;82;63;154;89;236
355530;201808;419;949;139;402;22;78;56;130;78;208
355535;201808;503;1430;394;1250;91;329;158;452;249;781
355540;201808;8620;23930;7229;21722;1387;4459;4271;12551;5658;17010
355550;201808;620;1889;490;1626;71;258;234;750;305;1008
355560;201808;1027;2908;561;1868;126;436;26;89;152;525
355570;201808;222;657;117;404;23;76;17;63;40;139
355580;201808;1176;2988;769;2301;100;354;382;1093;482;1447
355590;201808;169;428;128;369;15;45;83;231;98;276
355600;201808;1441;3729;962;2838;252;789;359;1009;611;1798
355610;201808;1576;4192;1092;3262;163;508;520;1476;683;1984
355620;201808;4207;12167;3218;10054;469;1734;1694;4843;2163;6577
355630;201808;2023;5935;1446;4770;298;994;651;2125;949;3119
355635;201808;899;2747;729;2439;122;450;406;1357;528;1807
355640;201808;2506;7538;1751;6012;462;1662;364;1268;826;2930
355645;201808;4022;12136;3189;10635;425;1600;1918;6278;2343;7878
355650;201808;6224;17501;5192;15567;1385;4408;2607;7317;3992;11725
355660;201808;1199;3326;859;2649;111;448;330;995;441;1443
355670;201808;3129;9198;2197;6907;360;1318;1028;2829;1388;4147
355680;201808;2974;8555;1173;3954;344;1218;124;411;468;1629
355690;201808;637;2032;427;1575;125;481;22;64;147;545
355695;201808;218;687;126;444;13;54;12;25;25;79
355700;201808;5961;18159;4945;15841;1177;3803;2228;6952;3405;10755
355710;201808;7625;18654;4824;13488;939;2828;1921;4898;2860;7726
355715;201808;332;1001;205;689;59;224;45;138;104;362
355720;201808;1346;4140;1060;3556;210;757;499;1547;709;2304
355730;201808;920;2762;725;2345;187;609;252;774;439;1383
410010;201808;1185;3401;913;2822;197;687;215;647;412;1334
410020;201808;963;3056;783;2624;282;908;229;780;511;1688
410030;201808;1318;3975;1137;3618;195;717;593;1849;788;2566
410040;201808;9798;29217;7713;25164;1760;6314;2640;8117;4400;14431
410045;201808;944;2548;630;1950;97;335;203;592;300;927
410050;201808;2416;6160;1487;4425;375;1237;291;741;666;1978
410060;201808;1994;5956;1570;5031;411;1365;492;1534;903;2899
410070;201808;1593;4334;1195;3553;244;777;427;1209;671;1986
410080;201808;1300;3569;961;2938;161;515;412;1270;573;1785
410090;201808;919;2652;843;2500;95;283;485;1522;580;1805
410100;201808;1866;5617;1317;4262;219;829;255;800;474;1629
410105;201808;431;1184;233;740;37;136;53;157;90;293
410110;201808;2937;7897;2066;6086;321;987;790;2269;1111;3256
410115;201808;503;1300;359;1031;67;214;123;325;190;539
410120;201808;2262;7199;1999;6731;717;2602;602;1993;1319;4595
410130;201808;1083;3107;970;2890;307;1024;370;982;677;2006
410140;201808;13645;34293;8434;24639;1832;5765;1851;4998;3683;10763
410150;201808;15469;38128;7367;21213;1492;4635;1459;4008;2951;8643
410160;201808;2731;7939;2317;7172;502;1719;885;2753;1387;4472
410165;201808;675;1924;565;1671;57;191;338;931;395;1122
410170;201808;2246;6137;1494;4458;424;1365;131;406;555;1771
410180;201808;12868;38203;10314;32527;1765;5994;5309;15840;7074;21834
410185;201808;462;1275;328;1012;56;180;107;311;163;491
410190;201808;2012;5351;1510;4408;345;1050;404;1137;749;2187
410200;201808;4345;10874;2487;7415;507;1784;545;1585;1052;3369
410210;201808;2397;6631;1640;5047;310;1103;508;1334;818;2437
410220;201808;532;1405;341;1015;47;168;71;215;118;383
410230;201808;1382;4038;1165;3598;213;785;612;1755;825;2540
410240;201808;3977;11431;3147;9756;973;3383;328;982;1301;4365
410250;201808;2410;6145;1740;4935;253;853;709;1901;962;2754
410260;201808;1672;4327;1117;3338;235;746;488;1431;723;2177
410270;201808;449;1190;333;965;32;111;166;457;198;568
410275;201808;660;1958;437;1440;67;229;200;614;267;843
410280;201808;2032;5696;1317;4159;262;896;450;1334;712;2230
410290;201808;2959;8667;2190;6993;509;1607;808;2608;1317;4215
410300;201808;623;1638;491;1386;78;246;224;581;302;827
410302;201808;353;944;175;582;30;101;90;288;120;389
410304;201808;1092;3194;927;2835;138;451;511;1520;649;1971
410305;201808;1583;4070;1148;3393;219;666;599;1757;818;2423
410310;201808;2218;6676;1829;5940;423;1519;632;2023;1055;3542
410315;201808;683;1730;334;1094;98;340;77;238;175;578
410320;201808;1073;3096;687;2226;106;395;108;349;214;744
410322;201808;484;1352;268;851;22;73;113;354;135;427
410330;201808;1372;3574;1005;2840;206;627;274;776;480;1403
410335;201808;808;2315;649;1981;98;333;292;830;390;1163
410337;201808;734;1855;521;1435;52;153;246;642;298;795
410340;201808;469;1275;310;877;35;117;141;337;176;454
410345;201808;2142;5758;1115;3456;255;806;268;783;523;1589
410347;201808;662;1705;477;1367;57;199;140;374;197;573
410350;201808;1189;3303;862;2649;113;388;351;1005;464;1393
410360;201808;3796;9547;3001;8200;237;781;1951;5096;2188;5877
410370;201808;10191;27866;7069;21039;1069;3554;2739;7289;3808;10843
410380;201808;1293;3567;978;2902;112;393;419;1155;531;1548
410390;201808;2426;6628;1600;4977;441;1502;354;1009;795;2511
410395;201808;854;2624;700;2283;138;499;314;1012;452;1511
410400;201808;4549;13008;3581;11125;695;2266;1475;4423;2170;6689
410405;201808;760;1972;611;1739;144;445;283;774;427;1219
410410;201808;1098;3182;1073;3147;175;654;679;2028;854;2682
410420;201808;7024;21372;5492;18009;1184;4298;1600;4760;2784;9058
410425;201808;2696;8038;1993;6596;371;1322;656;2015;1027;3337
410430;201808;12055;31308;8383;24424;1487;4668;2775;7813;4262;12481
410440;201808;2659;8859;2354;8258;373;1372;1360;4928;1733;6300
410442;201808;2166;6971;1856;6260;579;2000;621;2104;1200;4104
410445;201808;2132;6586;1711;5732;392;1468;503;1750;895;3218
410450;201808;1420;3918;1072;3203;225;736;276;723;501;1459
410460;201808;1656;4433;1295;3854;209;676;562;1603;771;2279
410465;201808;2378;7361;1880;6245;425;1416;581;1862;1006;3278
410470;201808;1706;5188;1238;4136;327;1207;257;893;584;2100
410480;201808;29900;76879;16782;51835;2976;10259;2716;7359;5692;17618
410490;201808;10302;29910;7342;23486;1525;5309;2503;7542;4028;12851
410500;201808;1580;4609;1152;3676;297;1048;259;735;556;1783
410510;201808;1982;5101;1290;3686;251;709;406;1164;657;1873
410520;201808;2905;9606;2666;9119;772;2709;1170;4041;1942;6750
410530;201808;1416;3831;718;2183;139;425;96;225;235;650
410540;201808;2407;6830;1768;5559;274;944;902;2803;1176;3747
410550;201808;6208;17131;3985;12184;805;2709;923;2471;1728;5180
410560;201808;1315;3586;1037;3045;233;725;433;1148;666;1873
410570;201808;2454;7268;1903;6198;565;2084;195;709;760;2793
410580;201808;22046;60533;16880;50716;3614;11913;7129;19947;10743;31860
410590;201808;1343;3993;887;2801;171;566;218;620;389;1186
410600;201808;1617;4575;1268;3844;290;870;468;1472;758;2342
410610;201808;706;1913;511;1535;61;198;223;640;284;838
410620;201808;1867;5864;1232;4290;319;1182;192;596;511;1778
410630;201808;2145;6077;1388;4386;295;998;200;533;495;1531
410640;201808;4121;10357;2777;8027;731;2378;429;1194;1160;3572
410645;201808;997;3197;871;2992;337;1190;312;1102;649;2292
410650;201808;1852;5410;1343;4303;344;1170;386;1112;730;2282
410655;201808;1252;3909;1003;3438;41;152;682;2451;723;2603
410657;201808;631;1724;394;1216;72;249;151;401;223;650
410660;201808;2978;7974;1602;4878;355;1110;292;850;647;1960
410670;201808;959;2418;580;1656;105;295;273;731;378;1026
410680;201808;2740;8532;1972;6618;504;1628;496;1751;1000;3379
410685;201808;548;1476;446;1296;89;284;221;604;310;888
410690;201808;111840;293434;74090;219502;14017;46445;24349;63868;38366;110313
410700;201808;2144;5775;1850;5273;356;1098;934;2500;1290;3598
410710;201808;787;2127;515;1586;58;191;268;796;326;987
410712;201808;652;1957;555;1762;146;497;204;605;350;1102
410715;201808;778;2435;502;1742;107;370;145;491;252;861
410720;201808;2903;7927;2122;6315;335;1197;456;1177;791;2374
410725;201808;1039;2687;634;1892;118;377;111;286;229;663
410730;201808;553;1493;397;1205;85;299;84;232;169;531
410740;201808;950;2740;670;2185;118;424;262;836;380;1260
410750;201808;1579;4348;1310;3819;230;744;520;1452;750;2196
410752;201808;342;889;154;471;26;92;62;167;88;259
410753;201808;193;583;136;458;20;68;20;57;40;125
410754;201808;1110;2972;926;2682;72;186;607;1886;679;2072
410755;201808;612;1575;438;1236;48;155;225;575;273;730
410760;201808;2879;7966;2213;6731;725;2401;527;1577;1252;3978
410765;201808;11655;34336;9108;29255;1643;5798;1399;4254;3042;10052
410770;201808;919;2283;643;1817;82;258;298;822;380;1080
410773;201808;1265;3476;1104;3208;136;455;752;2116;888;2571
410775;201808;1360;3625;1187;3350;136;429;620;1717;756;2146
410780;201808;560;1428;338;971;66;193;84;261;150;454
410785;201808;742;2176;588;1872;121;405;197;602;318;1007
410790;201808;547;1627;433;1386;121;413;47;95;168;508
410800;201808;2826;6640;2267;5783;130;380;1331;3298;1461;3678
410810;201808;335;952;253;790;39;141;117;338;156;479
410820;201808;699;2068;402;1263;91;302;76;215;167;517
410830;201808;26541;69752;19332;57110;4988;16487;6554;18409;11542;34896
410832;201808;944;2574;805;2303;106;377;456;1210;562;1587
410840;201808;6966;18836;4222;13259;961;3345;713;1972;1674;5317
410845;201808;1097;3067;895;2689;182;593;332;972;514;1565
410850;201808;2278;6846;2006;6341;399;1368;875;2747;1274;4115
410855;201808;620;1617;434;1265;45;142;191;521;236;663
410860;201808;3634;9771;2839;8238;591;1860;984;2700;1575;4560
410865;201808;1325;4245;1184;3926;224;800;659;2246;883;3046
410870;201808;1225;3438;1070;3186;59;190;780;2322;839;2512
410880;201808;3835;11098;2846;9157;566;2035;435;1474;1001;3509
410890;201808;881;2674;644;2137;165;600;180;588;345;1188
410895;201808;874;2974;754;2684;304;1152;128;431;432;1583
410900;201808;788;2186;545;1694;98;317;127;322;225;639
410910;201808;353;865;179;518;11;38;101;261;112;299
410920;201808;676;1806;513;1519;94;316;224;654;318;970
410930;201808;1338;3852;1057;3277;295;1041;259;797;554;1838
410940;201808;19796;58416;15092;49358;3898;13749;3743;12404;7641;26153
410950;201808;1863;5645;1694;5368;70;284;1404;4373;1474;4657
410960;201808;6776;18191;4379;13790;1162;4078;1434;4339;2596;8417
410965;201808;935;2600;700;2125;117;370;357;1060;474;1430
410970;201808;3526;9899;2542;7962;659;2458;389;1067;1048;3525
410975;201808;1248;3395;968;2882;185;613;338;1008;523;1621
410980;201808;6266;16790;4091;12580;582;2002;1640;4829;2222;6831
410990;201808;1099;2957;732;2273;237;838;151;378;388;1216
411000;201808;490;1393;343;1076;57;202;87;219;144;421
411005;201808;407;1137;268;837;64;209;43;130;107;339
411007;201808;2064;6201;1760;5621;421;1447;583;1860;1004;3307
411010;201808;3894;12242;3158;10604;885;3175;323;1010;1208;4185
411020;201808;2245;6696;1893;6067;573;1944;557;1724;1130;3668
411030;201808;697;1812;456;1272;59;188;196;491;255;679
411040;201808;737;1968;341;1042;53;178;81;217;134;395
411050;201808;1720;5679;1463;5069;416;1535;221;682;637;2217
411060;201808;1541;4234;1018;3146;182;704;204;556;386;1260
411065;201808;318;906;239;748;34;108;103;315;137;423
411070;201808;5993;16451;4787;14213;984;3197;1936;5566;2920;8763
411080;201808;2077;5787;1675;5037;450;1470;445;1312;895;2782
411090;201808;784;2124;512;1591;54;200;115;326;169;526
411095;201808;1406;3479;976;2744;135;431;359;957;494;1388
411100;201808;1058;2898;741;2285;91;328;209;643;300;971
411110;201808;532;1439;242;779;31;82;17;42;48;124
411120;201808;1233;3581;962;3035;345;1226;198;515;543;1741
411125;201808;4600;14009;4270;13402;930;3037;2109;6796;3039;9833
411130;201808;637;1809;449;1405;99;306;169;553;268;859
411140;201808;2123;6780;1754;5916;453;1637;647;2199;1100;3836
411150;201808;3485;9459;2472;7334;562;1903;211;483;773;2386
411155;201808;920;2450;562;1719;55;174;266;763;321;937
411160;201808;333;798;220;630;35;105;54;162;89;267
411170;201808;660;2046;491;1630;121;411;167;531;288;942
411180;201808;4995;13971;3936;11999;738;2465;1667;4853;2405;7318
411190;201808;1247;3389;971;2853;211;644;296;799;507;1443
411200;201808;4655;13139;3253;10320;937;3227;727;2210;1664;5437
411210;201808;2109;5168;1528;4210;451;1429;211;530;662;1959
411220;201808;825;2245;609;1791;137;434;194;563;331;997
411230;201808;801;2260;550;1755;118;384;202;662;320;1046
411240;201808;1396;3486;864;2462;82;262;436;1194;518;1456
411250;201808;1912;5351;1465;4518;355;1271;451;1360;806;2631
411260;201808;320;851;203;614;30;91;80;228;110;319
411270;201808;1703;4944;1359;4226;243;813;630;1892;873;2705
411275;201808;1240;3310;912;2701;165;537;402;1164;567;1701
411280;201808;1317;3645;815;2589;165;546;121;334;286;880
411290;201808;700;1954;475;1501;62;185;226;732;288;917
411295;201808;1059;2728;846;2334;83;268;425;1112;508;1380
411300;201808;940;2366;591;1653;68;211;231;557;299;768
411310;201808;808;2004;625;1723;38;107;279;762;317;869
411320;201808;5109;13988;3658;11207;834;2678;1169;3300;2003;5978
411325;201808;1510;4442;1283;4003;232;713;672;2166;904;2879
411330;201808;3013;8727;2318;7347;622;2137;647;2100;1269;4237
411340;201808;780;2235;476;1513;70;248;190;572;260;820
411342;201808;813;2086;549;1573;80;237;271;749;351;986
411345;201808;968;2718;762;2339;105;362;492;1510;597;1872
411350;201808;2332;6711;1665;5309;469;1651;179;558;648;2209
411360;201808;596;1485;415;1198;54;170;139;387;193;557
411370;201808;43741;113292;32405;93453;3372;11557;18329;49553;21701;61110
411373;201808;1268;3480;1046;3118;130;426;502;1524;632;1950
411375;201808;956;2536;714;2074;118;360;276;748;394;1108
411380;201808;1032;2542;708;1863;60;190;417;994;477;1184
411390;201808;1540;4428;1205;3624;214;725;452;1230;666;1955
411400;201808;1963;5189;1586;4478;250;845;736;1974;986;2819
411410;201808;1888;5436;1418;4421;345;1182;294;829;639;2011
411420;201808;3746;9762;2194;6649;353;1247;405;991;758;2238
411430;201808;3132;8851;2526;7765;566;1903;1026;2920;1592;4823
411435;201808;406;1183;260;856;43;140;104;306;147;446
411440;201808;2439;7387;2016;6510;474;1676;671;2176;1145;3852
411450;201808;2474;6841;1892;5818;300;904;971;3036;1271;3940
411460;201808;3489;9618;1955;6323;365;1361;309;921;674;2282
411470;201808;673;1908;481;1501;84;291;138;385;222;676
411480;201808;4047;11624;2884;9289;568;2080;785;2358;1353;4438
411490;201808;1445;4009;1122;3411;183;644;400;1079;583;1723
411500;201808;1360;3686;917;2775;146;515;292;833;438;1348
411510;201808;2007;5570;1649;4875;374;1239;390;1173;764;2412
411520;201808;25395;63900;14315;42099;2140;7019;4773;12637;6913;19656
411530;201808;866;2392;559;1779;120;432;112;318;232;750
411535;201808;448;1353;199;707;16;57;27;77;43;134
411540;201808;2635;6971;1859;5355;309;1000;707;1976;1016;2976
411545;201808;909;2761;772;2504;73;245;517;1679;590;1924
411550;201808;632;1701;454;1351;87;283;85;252;172;535
411560;201808;1795;4975;1087;3426;179;667;68;158;247;825
411570;201808;6643;16385;4598;13083;985;3120;1277;3612;2262;6732
411573;201808;741;2097;640;1925;73;244;384;1130;457;1374
411575;201808;1643;4716;1278;3957;282;924;353;1067;635;1991
411580;201808;3944;9728;2217;6887;265;1042;298;857;563;1899
411585;201808;668;2021;307;1041;84;290;56;169;140;459
411590;201808;351;1045;251;811;28;109;140;412;168;521
411600;201808;259;715;160;527;40;144;52;165;92;309
411605;201808;1299;3370;867;2480;127;443;411;1114;538;1557
411610;201808;2065;5516;1483;4271;180;566;797;2220;977;2786
411620;201808;2683;7606;2349;7068;407;1353;1386;4095;1793;5448
411630;201808;615;1637;411;1236;85;295;113;300;198;595
411640;201808;488;1378;332;998;40;133;131;346;171;479
411650;201808;182;536;124;404;28;89;23;81;51;170
411660;201808;857;2263;619;1789;55;151;325;913;380;1064
411670;201808;1058;2775;775;2157;120;334;306;798;426;1132
411680;201808;1489;4184;1210;3644;125;435;650;1938;775;2373
411690;201808;3204;8858;2497;7590;500;1562;813;2574;1313;4136
411695;201808;611;1904;449;1526;68;243;160;559;228;802
411700;201808;1451;3995;982;3081;237;817;129;356;366;1173
411705;201808;1600;5405;1413;5053;288;1014;816;3068;1104;4082
411710;201808;1717;4618;1244;3715;369;1166;157;483;526;1649
411720;201808;932;2387;655;1826;102;319;247;644;349;963
411721;201808;782;2134;597;1766;126;384;133;393;259;777
411722;201808;656;1874;385;1218;65;244;146;388;211;632
411725;201808;1183;3576;765;2593;189;664;152;523;341;1187
411727;201808;1422;4141;951;3081;309;1038;116;349;425;1387
411729;201808;634;1603;431;1215;79;255;133;334;212;589
411730;201808;5036;14170;3758;11487;1107;3489;1166;3558;2273;7047
411740;201808;520;1456;268;868;51;171;51;162;102;333
411745;201808;756;2223;499;1586;68;229;97;255;165;484
411750;201808;4432;12307;3278;9931;478;1591;1571;4508;2049;6099
411760;201808;6674;18602;5230;15898;1890;6031;1043;3431;2933;9462
411770;201808;2955;9033;2206;7260;622;2184;291;914;913;3098
411780;201808;2821;8269;2445;7528;675;2183;910;2804;1585;4987
411790;201808;2727;6978;1527;4610;405;1369;202;513;607;1882
411800;201808;911;2638;612;1935;103;326;114;357;217;683
411810;201808;1558;4121;1159;3358;197;631;558;1502;755;2133
411820;201808;10239;31684;8431;27988;2729;9451;2920;9653;5649;19104
411830;201808;585;1461;405;1151;88;277;81;245;169;522
411840;201808;10332;28379;6876;21026;1350;4466;1807;5150;3157;9616
411845;201808;397;1162;204;677;44;170;18;55;62;225
411850;201808;6986;19098;5137;15653;1577;5331;809;2274;2386;7605
411860;201808;734;2192;546;1778;100;364;152;458;252;822
411870;201808;625;1965;430;1452;93;345;90;278;183;623
411880;201808;1876;5140;1388;4249;346;1132;267;827;613;1959
411885;201808;911;2425;695;2035;110;386;254;707;364;1093
411890;201808;1042;2963;708;2221;128;465;53;138;181;603
411900;201808;808;2387;476;1593;123;429;56;191;179;620
411910;201808;970;3055;704;2432;208;756;180;589;388;1345
411915;201808;15183;38740;9429;27834;1760;5682;2832;7617;4592;13299
411920;201808;914;2927;770;2584;203;730;210;689;413;1419
411925;201808;512;1375;340;1043;85;277;102;294;187;571
411930;201808;4992;16258;4331;14895;2068;7636;296;1168;2364;8804
411940;201808;2987;9450;2339;7831;610;2113;581;1761;1191;3874
411950;201808;12526;35854;10341;32019;2079;7063;5225;15648;7304;22711
411960;201808;5296;14932;4464;13276;989;3262;1595;4432;2584;7694
411965;201808;420;1205;297;952;50;183;115;342;165;525
411970;201808;883;2245;711;1991;120;302;374;1173;494;1475
411980;201808;1362;3694;1057;3130;268;841;389;1090;657;1931
411990;201808;33223;94657;22951;73681;5095;18053;7558;23044;12653;41097
411995;201808;2592;6887;1994;5944;604;1990;570;1592;1174;3582
412000;201808;2027;4787;1473;3851;81;276;960;2346;1041;2622
412010;201808;621;1983;432;1522;68;273;102;308;170;581
412015;201808;547;1605;460;1437;66;226;255;789;321;1015
412020;201808;430;1238;253;828;39;146;98;308;137;454
412030;201808;642;1885;449;1494;86;306;146;467;232;773
412033;201808;832;2404;589;1867;78;255;228;742;306;997
412035;201808;755;2034;491;1566;66;241;248;749;314;990
412040;201808;533;1489;345;1082;66;215;65;193;131;408
412050;201808;1578;4238;1138;3393;223;748;288;844;511;1592
412060;201808;6722;21471;5839;19647;1833;6727;1479;4780;3312;11507
412065;201808;595;1703;443;1391;93;300;138;426;231;726
412070;201808;1107;2926;857;2379;130;382;357;967;487;1349
412080;201808;1727;5127;1083;3638;181;652;103;314;284;966
412085;201808;276;748;90;315;11;38;7;21;18;59
412090;201808;5233;14205;4345;12590;1190;3480;1864;5549;3054;9029
412100;201808;1689;4790;1293;4079;415;1402;254;847;669;2249
412110;201808;805;2261;599;1800;115;369;187;545;302;914
412120;201808;1705;5401;1377;4676;321;1214;405;1166;726;2380
412125;201808;607;1873;470;1537;118;394;153;489;271;883
412130;201808;610;1699;437;1312;68;230;113;349;181;579
412135;201808;588;1633;274;848;50;151;87;249;137;400
412140;201808;1484;3876;970;2910;231;817;164;444;395;1261
412150;201808;2784;7578;2346;6772;321;1038;1496;4162;1817;5200
412160;201808;1010;3234;623;2199;150;585;85;282;235;867
412170;201808;3969;11825;3356;10646;781;2657;1410;4160;2191;6817
412175;201808;1266;4026;1082;3658;280;927;415;1430;695;2357
412180;201808;1645;4706;1207;3875;188;721;509;1486;697;2207
412190;201808;3143;8282;2353;6804;344;1098;1036;3000;1380;4098
412200;201808;1745;5407;1231;4120;322;1131;227;746;549;1877
412210;201808;544;1422;328;985;68;234;92;230;160;464
412215;201808;3624;9912;2971;8644;828;2381;1199;3907;2027;6288
412217;201808;976;2676;836;2444;80;268;562;1577;642;1845
412220;201808;5381;15849;4510;14102;1174;3649;1566;5178;2740;8827
412230;201808;2579;8154;2088;7084;420;1623;585;1744;1005;3367
412240;201808;6405;17000;4085;12345;807;2711;1106;3105;1913;5816
412250;201808;1879;5084;1467;4278;390;1146;273;788;663;1934
412260;201808;1155;3261;812;2501;144;456;247;718;391;1174
412265;201808;798;2397;678;2140;154;531;287;871;441;1402
412270;201808;732;2177;497;1629;80;288;199;607;279;895
412280;201808;467;1393;375;1230;90;304;105;330;195;634
412290;201808;951;2478;633;1876;109;351;204;577;313;928
412300;201808;1396;4028;1135;3500;310;1003;252;782;562;1785
412310;201808;732;2101;606;1873;63;264;316;948;379;1212
412320;201808;793;2121;554;1648;75;301;205;584;280;885
412330;201808;1371;3782;939;2888;178;576;355;1114;533;1690
412340;201808;945;2767;599;1935;99;333;122;367;221;700
412350;201808;2586;7114;1694;5271;355;1128;326;1029;681;2157
412360;201808;228;624;140;422;16;56;63;176;79;232
412370;201808;730;2189;532;1793;114;432;45;171;159;603
412380;201808;1503;4316;1045;3299;295;941;160;535;455;1476
412382;201808;527;1393;354;1061;61;199;110;285;171;484
412385;201808;2095;6042;1753;5332;621;1876;516;1701;1137;3577
412390;201808;2241;5864;1833;5196;354;1056;825;2350;1179;3406
412395;201808;666;1914;468;1482;58;187;215;650;273;837
412400;201808;851;2439;626;1959;140;468;161;525;301;993
412402;201808;1654;4386;1234;3659;323;1031;144;427;467;1458
412405;201808;2922;8202;1886;5979;450;1598;64;221;514;1819
412410;201808;4894;13676;3664;11369;843;2972;974;2859;1817;5831
412420;201808;456;1214;267;796;27;86;105;276;132;362
412430;201808;488;1315;320;966;30;104;149;432;179;536
412440;201808;2640;7586;1782;5850;525;1856;302;1021;827;2877
412450;201808;324;1004;225;752;42;132;23;60;65;192
412460;201808;861;2448;711;2168;134;443;288;870;422;1313
412470;201808;1577;5228;1280;4502;350;1280;300;1129;650;2409
412480;201808;887;2526;569;1753;112;376;104;263;216;639
412490;201808;1047;2790;861;2419;127;358;438;1191;565;1549
412500;201808;1691;4551;1304;3783;317;936;274;729;591;1665
412510;201808;1874;5892;1345;4516;338;1198;135;417;473;1615
412520;201808;1292;3510;711;2190;174;518;69;201;243;719
412530;201808;614;1680;449;1334;66;220;122;351;188;571
412535;201808;729;2013;509;1545;123;412;98;264;221;676
412540;201808;1206;3294;830;2477;96;352;259;777;355;1129
412545;201808;664;1753;449;1305;85;264;129;339;214;603
412550;201808;28454;80500;19595;61583;4115;13899;6414;18752;10529;32651
412555;201808;224;619;152;461;22;73;46;114;68;187
412560;201808;4727;14202;3493;11235;734;2567;946;2976;1680;5543
412570;201808;3594;9826;2218;6976;516;1747;329;1131;845;2878
412575;201808;878;2439;726;2121;73;251;419;1133;492;1384
412580;201808;1259;3372;874;2621;148;485;397;1148;545;1633
412590;201808;417;1140;214;706;49;168;24;77;73;245
412600;201808;1323;3856;982;3100;173;619;392;1190;565;1809
412610;201808;730;2044;465;1394;60;189;215;577;275;766
412620;201808;1228;3507;932;2958;191;689;306;891;497;1580
412625;201808;7735;21698;5020;16062;855;2960;500;1708;1355;4668
412627;201808;934;2732;642;2116;167;614;177;565;344;1179
412630;201808;2772;8295;2025;6571;394;1272;672;2005;1066;3277
412635;201808;318;873;226;665;44;138;55;133;99;271
412640;201808;998;2814;560;1779;85;295;124;357;209;652
412650;201808;1434;4132;1176;3609;225;800;423;1134;648;1934
412660;201808;2445;6719;1740;5275;322;1070;517;1439;839;2509
412665;201808;532;1311;305;894;55;164;117;316;172;480
412667;201808;1649;4480;1233;3640;193;657;479;1342;672;1999
412670;201808;620;1691;468;1398;80;277;175;502;255;779
412680;201808;1356;3866;869;2873;136;533;330;935;466;1468
412690;201808;825;2359;597;1860;114;375;168;492;282;867
412700;201808;1994;5476;1596;4817;304;1100;721;2064;1025;3164
412710;201808;5541;16881;4425;14515;990;3556;1297;3977;2287;7533
412720;201808;1188;3580;875;2816;157;535;184;508;341;1043
412730;201808;1943;5578;1104;3636;241;835;179;574;420;1409
412740;201808;1598;4633;1056;3411;221;776;169;575;390;1351
412750;201808;3718;10623;3225;9821;399;1449;2086;6069;2485;7518
412760;201808;2700;7696;2321;7026;364;1220;1352;3964;1716;5184
412770;201808;9390;24692;4982;15461;788;2556;1037;2891;1825;5447
412780;201808;1190;3426;960;2974;207;686;363;1108;570;1794
412785;201808;1958;5180;1390;4115;272;837;664;1920;936;2757
412788;201808;1266;3761;1042;3294;249;833;451;1351;700;2184
412790;201808;1015;2904;618;2018;130;485;186;525;316;1010
412795;201808;1137;3133;642;1985;133;434;137;395;270;829
412796;201808;2290;7014;1912;6141;397;1335;636;1902;1033;3237
412800;201808;3177;8240;2180;6250;304;995;917;2382;1221;3377
412810;201808;10077;26390;6040;17813;901;3001;2007;5193;2908;8194
412820;201808;6239;17723;4572;14398;1075;3554;1438;4537;2513;8091
412830;201808;328;959;231;741;39;118;46;144;85;262
412840;201808;1702;4587;1249;3687;193;617;412;1159;605;1776
412850;201808;2816;7702;2119;6438;370;1213;778;2292;1148;3505
412853;201808;1682;4551;1395;3892;168;523;733;1862;901;2385
412855;201808;1111;3097;762;2315;161;544;199;554;360;1098
412860;201808;800;2258;595;1848;113;380;250;757;363;1137
412862;201808;673;1645;442;1237;65;208;197;540;262;748
412863;201808;1160;3665;1081;3530;110;366;813;2656;923;3022
412865;201808;694;2002;514;1654;98;326;182;593;280;919
412870;201808;848;2381;658;2061;212;743;139;456;351;1199
412880;201808;789;2241;519;1645;104;350;78;236;182;586
420005;201808;412;1246;229;808;38;138;94;334;132;472
420010;201808;3480;8856;2321;6775;215;701;1617;4722;1832;5423
420020;201808;471;1484;285;997;52;210;43;117;95;327
420030;201808;116;357;76;289;21;94;12;43;33;137
420040;201808;556;1743;314;1177;54;217;20;56;74;273
420050;201808;603;1521;396;1154;57;180;234;656;291;836
420055;201808;149;450;75;269;13;55;24;85;37;140
420060;201808;116;345;74;245;13;52;17;36;30;88
420070;201808;835;2675;630;2180;135;503;231;771;366;1274
420075;201808;83;226;46;146;10;32;10;22;20;54
420080;201808;361;1109;285;949;96;326;91;295;187;621
420090;201808;369;1243;242;905;60;232;48;188;108;420
420100;201808;1083;3099;950;2904;63;218;758;2283;821;2501
420110;201808;240;796;217;749;47;179;87;277;134;456
420120;201808;343;1041;242;814;55;204;94;291;149;495
420125;201808;310;1039;250;914;63;263;119;416;182;679
420127;201808;279;800;97;345;21;89;20;61;41;150
420130;201808;1850;5698;1388;4752;307;1211;546;1690;853;2901
420140;201808;3078;8762;2261;7255;655;2385;316;977;971;3362
420150;201808;521;1370;325;1041;63;210;143;444;206;654
420160;201808;224;585;104;336;16;56;39;123;55;179
420165;201808;146;439;92;309;23;79;30;94;53;173
420170;201808;240;746;146;517;30;114;25;79;55;193
420180;201808;195;601;113;400;14;49;35;109;49;158
420190;201808;145;489;87;335;33;131;15;56;48;187
420195;201808;1211;3384;921;2887;292;1046;110;286;402;1332
420200;201808;3055;8415;1774;5748;314;1251;574;1612;888;2863
420205;201808;1148;3348;852;2789;148;505;473;1591;621;2096
420207;201808;1468;4069;949;3060;219;804;326;1002;545;1806
420208;201808;373;1050;215;773;39;172;98;345;137;517
420209;201808;144;496;95;345;31;133;37;120;68;253
420210;201808;2183;5999;1405;4696;318;1180;588;1886;906;3066
420213;201808;755;2499;652;2282;170;655;299;1029;469;1684
420215;201808;222;690;155;540;51;185;29;91;80;276
420220;201808;167;543;117;435;34;139;43;145;77;284
420230;201808;3820;10938;2904;9232;444;1613;1481;4549;1925;6162
420240;201808;10114;28204;6599;20677;908;3386;3464;9666;4372;13052
420243;201808;375;1119;302;976;62;214;153;473;215;687
420245;201808;1157;3220;807;2566;91;366;450;1348;541;1714
420250;201808;409;1254;356;1142;82;308;187;562;269;870
420253;201808;496;1277;362;1076;28;91;190;543;218;634
420257;201808;183;485;109;348;19;65;57;180;76;245
420260;201808;993;2943;749;2547;125;485;406;1351;531;1836
420270;201808;438;1184;203;630;20;66;79;232;99;298
420280;201808;1295;3600;819;2702;179;661;217;686;396;1347
420285;201808;97;272;52;183;7;29;10;31;17;60
420287;201808;431;1104;293;887;87;280;96;288;183;568
420290;201808;3630;10819;2785;8899;503;1804;1275;3701;1778;5505
420300;201808;6044;17466;3560;11748;774;2871;921;2683;1695;5554
420310;201808;816;1973;393;1112;74;205;208;552;282;757
420315;201808;807;2483;576;1995;146;541;215;740;361;1281
420320;201808;3747;11187;2983;9778;1003;3597;693;2090;1696;5687
420325;201808;234;736;177;620;46;148;53;178;99;326
420330;201808;808;2551;554;1946;128;511;185;600;313;1111
420340;201808;944;2839;679;2280;167;577;61;197;228;774
420350;201808;1351;3716;942;2904;124;428;563;1711;687;2139
420360;201808;2377;6929;1285;4427;282;1049;131;451;413;1500
420370;201808;1142;3221;913;2827;129;492;614;1812;743;2304
420380;201808;4709;13094;3049;9805;743;2551;956;2967;1699;5518
420390;201808;983;2512;644;1791;115;367;276;577;391;944
420395;201808;943;2801;617;2088;110;404;74;223;184;627
420400;201808;875;2633;571;1932;127;486;157;514;284;1000
420410;201808;517;1468;391;1215;40;154;256;760;296;914
420415;201808;296;910;225;757;73;264;70;243;143;507
420417;201808;609;1903;497;1649;122;423;192;644;314;1067
420419;201808;154;572;123;485;53;231;5;14;58;245
420420;201808;9619;26835;6806;21596;2425;8360;1609;4812;4034;13172
420425;201808;696;1871;483;1475;53;201;226;658;279;859
420430;201808;3012;8691;1885;6110;465;1619;563;1636;1028;3255
420435;201808;266;715;116;396;23;97;47;148;70;245
420440;201808;685;2038;396;1322;127;469;105;304;232;773
420445;201808;306;838;183;572;38;132;56;158;94;290
420450;201808;608;1862;445;1490;87;344;145;440;232;784
420455;201808;1872;4958;1399;4165;201;683;713;2035;914;2718
420460;201808;7925;22224;5987;18657;1109;3894;2816;8329;3925;12223
420470;201808;588;1638;350;1151;72;280;93;268;165;548
420475;201808;36;110;28;91;12;37;5;17;17;54
420480;201808;4613;12260;3053;9505;657;2231;996;3050;1653;5281
420490;201808;399;1164;246;850;70;275;66;222;136;497
420500;201808;1225;3739;893;3059;195;689;329;1102;524;1791
420510;201808;127;392;76;252;11;36;26;86;37;122
420515;201808;48;132;32;97;5;15;12;33;17;48
420517;201808;744;2082;653;1922;58;168;492;1448;550;1616
420519;201808;307;777;198;605;28;100;78;244;106;344
420520;201808;376;1014;163;573;23;79;12;42;35;121
420530;201808;832;2490;580;1935;133;510;171;487;304;997
420535;201808;201;575;92;314;24;82;18;70;42;152
420540;201808;23875;60770;15613;45407;2979;9644;5637;14441;8616;24085
420543;201808;223;661;178;567;30;95;94;288;124;383
420545;201808;1084;3340;871;2881;212;733;324;1053;536;1786
420550;201808;3241;9497;2184;7482;467;1771;876;3054;1343;4825
420555;201808;277;840;193;658;42;163;86;270;128;433
420560;201808;400;1088;298;917;71;217;162;501;233;718
420570;201808;1981;5836;1512;4888;325;1168;569;1708;894;2876
420580;201808;1547;4174;1163;3559;261;866;568;1682;829;2548
420590;201808;2696;7596;1623;5163;349;1285;368;866;717;2151
420600;201808;897;2762;705;2363;131;502;326;1049;457;1551
420610;201808;321;991;190;673;52;192;45;156;97;348
420620;201808;460;1317;369;1152;114;368;127;402;241;770
420630;201808;794;2412;593;1913;127;449;278;814;405;1263
420640;201808;507;1481;243;872;64;243;26;79;90;322
420650;201808;2597;7368;1563;5092;278;965;597;1707;875;2672
420660;201808;338;966;235;754;59;209;62;192;121;401
420665;201808;498;1373;326;1056;63;233;134;389;197;622
420670;201808;1374;3868;925;3002;171;695;349;999;520;1694
420675;201808;130;390;83;292;27;113;18;47;45;160
420680;201808;317;780;182;577;33;118;88;264;121;382
420690;201808;749;2369;492;1711;80;293;113;328;193;621
420700;201808;2628;7381;2036;6303;347;1216;992;2941;1339;4157
420710;201808;601;1881;472;1604;81;336;240;744;321;1080
420720;201808;1258;3529;939;3061;259;844;410;1330;669;2174
420730;201808;2596;7198;2033;6294;370;1227;1096;3280;1466;4507
420740;201808;646;1984;405;1448;127;482;52;203;179;685
420750;201808;1621;4937;1104;3724;213;826;423;1289;636;2115
420757;201808;60;148;20;82;3;15;9;35;12;50
420760;201808;360;1105;155;519;41;142;20;64;61;206
420765;201808;387;1260;213;765;37;142;80;283;117;425
420768;201808;1135;3583;980;3283;198;677;639;2151;837;2828
420770;201808;481;1350;221;816;43;177;75;267;118;444
420775;201808;419;1249;252;872;60;235;48;135;108;370
420780;201808;963;2801;565;1910;118;421;136;412;254;833
420785;201808;174;483;128;380;23;66;40;107;63;173
420790;201808;927;3026;727;2617;179;716;336;1143;515;1859
420800;201808;700;1867;324;1072;79;271;79;253;158;524
420810;201808;1430;4853;1171;4260;396;1605;282;896;678;2501
420820;201808;8634;23191;5965;18726;1432;5030;2348;6712;3780;11742
420830;201808;2761;7991;2141;6852;547;1872;791;2481;1338;4353
420840;201808;578;1725;260;939;70;260;52;179;122;439
420845;201808;1673;4569;989;3320;216;806;338;1113;554;1919
420850;201808;1016;3442;648;2436;168;703;97;297;265;1000
420860;201808;259;701;157;513;44;165;32;93;76;258
420870;201808;793;2221;633;1951;201;712;256;737;457;1449
420880;201808;824;2629;643;2222;151;574;198;617;349;1191
420890;201808;7270;20101;3990;13150;718;2614;1099;3102;1817;5716
420895;201808;159;477;92;298;34;117;24;72;58;189
420900;201808;1340;3489;802;2505;132;507;325;881;457;1388
420910;201808;22154;62038;14500;46858;2634;9531;5329;15646;7963;25177
420915;201808;533;1988;362;1475;62;259;164;666;226;925
420917;201808;331;918;174;516;31;103;73;204;104;307
420920;201808;84;241;31;115;4;18;2;6;6;24
420930;201808;16309;44351;11835;36439;2218;7497;5490;16111;7708;23608
420940;201808;2126;5686;1359;4293;364;1270;142;353;506;1623
420945;201808;135;411;99;319;33;126;30;80;63;206
420950;201808;318;965;187;644;26;105;60;185;86;290
420960;201808;872;2342;611;1837;116;406;244;652;360;1058
420970;201808;2455;7312;1686;5739;498;1749;284;1036;782;2785
420980;201808;306;968;248;881;107;377;86;332;193;709
420985;201808;290;886;154;558;32;127;52;163;84;290
420990;201808;395;1191;210;753;47;176;42;132;89;308
421000;201808;435;1471;298;1103;80;326;64;185;144;511
421003;201808;446;1071;147;456;16;50;23;63;39;113
421005;201808;53;184;47;174;14;55;20;73;34;128
421010;201808;3495;9886;2495;8052;565;2010;589;1711;1154;3721
421020;201808;357;1085;281;955;22;90;196;670;218;760
421030;201808;701;2241;551;1905;176;663;147;472;323;1135
421040;201808;678;1631;416;1218;41;137;255;729;296;866
421050;201808;1121;3230;692;2235;136;472;234;679;370;1151
421055;201808;166;458;82;262;20;72;23;62;43;134
421060;201808;473;1460;326;1096;68;265;125;384;193;649
421070;201808;489;1536;282;1010;69;261;43;150;112;411
421080;201808;627;2591;591;2537;64;211;455;2110;519;2321
421085;201808;376;1125;159;593;24;93;27;93;51;186
421090;201808;297;802;166;521;21;69;51;155;72;224
421100;201808;829;2033;391;1179;96;329;48;137;144;466
421105;201808;1315;3750;1055;3362;171;535;604;1991;775;2526
421110;201808;958;2895;815;2657;55;166;571;1917;626;2083
421120;201808;879;2875;617;2229;94;392;191;614;285;1006
421125;201808;248;695;202;618;66;224;72;179;138;403
421130;201808;3541;10951;3030;9973;705;2557;1614;5165;2319;7722
421140;201808;261;744;173;562;37;120;54;152;91;272
421145;201808;449;1302;265;866;54;196;118;363;172;559
421150;201808;466;1311;287;991;61;256;106;342;167;598
421160;201808;686;1827;388;1232;55;194;207;639;262;833
421165;201808;186;584;133;460;31;102;58;203;89;305
421170;201808;1051;2886;834;2541;141;429;524;1614;665;2043
421175;201808;1017;2734;674;2161;144;529;260;759;404;1288
421180;201808;373;991;185;606;41;168;43;132;84;300
421185;201808;306;814;210;623;31;98;121;350;152;448
421187;201808;323;956;205;657;35;113;83;251;118;364
421189;201808;345;1071;262;885;49;178;85;268;134;446
421190;201808;9078;25198;5743;18857;1284;4677;1319;4117;2603;8794
421200;201808;651;2032;536;1789;104;371;259;827;363;1198
421205;201808;177;517;141;457;30;109;71;221;101;330
421210;201808;999;2773;653;2123;172;560;228;743;400;1303
421220;201808;1227;3979;1026;3538;266;1023;230;700;496;1723
421223;201808;362;1079;246;839;58;189;107;366;165;555
421225;201808;876;2761;763;2530;159;576;428;1428;587;2004
421227;201808;940;2584;573;1851;104;365;293;968;397;1333
421230;201808;530;1442;342;1098;100;348;118;381;218;729
421240;201808;313;966;131;492;13;67;18;67;31;134
421250;201808;1394;3765;908;2929;187;677;335;1032;522;1709
421260;201808;188;538;44;164;10;38;7;29;17;67
421265;201808;618;1853;567;1780;38;137;480;1503;518;1640
421270;201808;416;1095;187;669;40;145;72;254;112;399
421280;201808;1404;4314;1097;3724;260;992;468;1510;728;2502
421290;201808;731;2060;429;1367;88;280;90;281;178;561
421300;201808;200;575;129;425;29;108;41;130;70;238
421310;201808;159;506;129;430;19;74;56;182;75;256
421315;201808;202;623;128;442;36;124;21;80;57;204
421320;201808;609;1820;326;1093;57;203;52;127;109;330
421330;201808;582;1772;428;1456;101;378;117;372;218;750
421335;201808;327;1052;262;925;52;219;103;360;155;579
421340;201808;1233;3611;932;3049;204;728;411;1312;615;2040
421350;201808;1066;3116;784;2589;160;635;353;1088;513;1723
421360;201808;2108;5997;1315;4399;303;1199;465;1363;768;2562
421370;201808;438;1457;274;1022;65;259;58;210;123;469
421380;201808;735;2115;647;1942;101;331;391;1138;492;1469
421390;201808;170;462;62;208;11;35;17;52;28;87
421400;201808;251;848;170;650;42;191;78;270;120;461
421410;201808;245;685;104;379;14;55;39;142;53;197
421415;201808;269;834;134;454;38;133;26;75;64;208
421420;201808;498;1495;421;1344;71;257;250;760;321;1017
421430;201808;126;433;96;355;14;51;33;115;47;166
421440;201808;599;1640;395;1300;85;287;195;647;280;934
421450;201808;351;1066;224;765;35;141;41;158;76;299
421460;201808;348;1018;218;762;46;175;65;208;111;383
421470;201808;199;652;140;508;31;134;50;185;81;319
421480;201808;2501;6901;1627;5285;443;1602;460;1345;903;2947
421490;201808;118;353;71;241;10;41;20;55;30;96
421500;201808;1912;5975;1346;4745;393;1565;273;876;666;2441
421505;201808;300;921;261;853;38;135;158;502;196;637
421507;201808;368;1131;230;807;65;255;73;242;138;497
421510;201808;222;641;136;432;32;98;62;183;94;281
421520;201808;517;1416;326;985;46;164;175;481;221;645
421530;201808;296;957;178;648;37;167;40;120;77;287
421535;201808;399;1142;254;853;32;126;132;417;164;543
421540;201808;196;518;124;394;15;53;52;156;67;209
421545;201808;656;1991;480;1633;102;377;212;708;314;1085
421550;201808;1833;5424;1551;4976;378;1336;759;2340;1137;3676
421555;201808;198;597;69;244;12;46;10;22;22;68
421560;201808;93;300;53;201;13;56;14;50;27;106
421565;201808;808;2213;580;1835;134;464;206;679;340;1143
421567;201808;471;1677;313;1195;147;574;52;182;199;756
421568;201808;363;1102;252;843;35;132;111;352;146;484
421569;201808;182;551;66;243;20;71;20;79;40;150
421570;201808;935;2657;631;2050;178;644;135;395;313;1039
421575;201808;287;890;259;812;43;156;134;381;177;537
421580;201808;2663;7986;1871;6310;418;1635;618;1815;1036;3450
421590;201808;134;447;108;372;35;129;27;82;62;211
421600;201808;480;1359;328;1018;87;285;79;214;166;499
421605;201808;701;1923;475;1519;104;349;148;461;252;810
421610;201808;1073;2994;669;2186;152;534;142;438;294;972
421620;201808;3510;10060;2088;7263;575;2166;516;1748;1091;3914
421625;201808;212;580;84;279;22;69;11;29;33;98
421630;201808;2331;6566;1337;4327;251;952;325;919;576;1871
421635;201808;205;596;134;427;17;62;62;169;79;231
421640;201808;722;2009;489;1595;100;341;146;473;246;814
421650;201808;1994;5831;1283;4367;318;1249;269;738;587;1987
421660;201808;6489;19967;5214;17407;990;3783;2068;6413;3058;10196
421670;201808;766;2255;538;1720;130;495;232;695;362;1190
421680;201808;850;2642;667;2251;209;754;240;747;449;1501
421690;201808;1117;3478;804;2765;198;769;220;734;418;1503
421700;201808;435;1371;223;812;45;179;49;155;94;334
421710;201808;194;619;88;301;21;77;27;85;48;162
421715;201808;100;285;71;216;17;53;47;136;64;189
421720;201808;1795;5105;1033;3488;284;1026;271;833;555;1859
421725;201808;168;438;99;306;24;76;40;106;64;182
421730;201808;313;959;184;587;32;115;74;209;106;324
421740;201808;560;1681;381;1262;112;407;97;291;209;698
421750;201808;782;1902;408;1225;82;264;169;479;251;743
421755;201808;163;478;92;305;12;50;43;130;55;180
421760;201808;806;2307;470;1600;86;334;127;365;213;699
421770;201808;2066;5808;1535;4881;396;1257;567;1970;963;3227
421775;201808;222;610;139;448;23;85;67;194;90;279
421780;201808;730;2374;505;1870;116;458;174;622;290;1080
421790;201808;591;1534;350;1149;84;299;172;540;256;839
421795;201808;217;653;134;426;22;79;54;152;76;231
421800;201808;2213;6513;1674;5507;341;1231;828;2631;1169;3862
421810;201808;589;1663;413;1315;61;232;216;644;277;876
421820;201808;727;2155;396;1365;91;335;81;264;172;599
421825;201808;1243;3685;1139;3521;143;500;817;2458;960;2958
421830;201808;1957;6396;1688;5862;426;1610;601;1974;1027;3584
421835;201808;197;540;116;386;16;73;50;147;66;220
421840;201808;211;673;144;524;39;151;35;115;74;266
421850;201808;354;1087;207;729;39;160;56;155;95;315
421860;201808;257;788;170;593;28;126;52;139;80;265
421870;201808;2945;7911;2096;6289;495;1657;835;2312;1330;3969
421875;201808;214;657;106;383;22;92;21;55;43;147
421880;201808;439;1259;333;1076;105;401;62;205;167;606
421885;201808;195;569;142;485;46;160;29;84;75;244
421890;201808;724;2371;582;2088;147;602;245;791;392;1393
421895;201808;335;987;305;942;40;143;207;634;247;777
421900;201808;887;2350;630;1868;101;346;303;807;404;1153
421910;201808;307;947;216;742;51;201;44;121;95;322
421915;201808;379;1090;212;692;47;153;28;83;75;236
421917;201808;535;1467;345;1193;125;480;70;239;195;719
421920;201808;481;1420;320;1150;162;607;99;365;261;972
421930;201808;2094;5696;1024;3503;309;1148;145;468;454;1616
421935;201808;421;1397;340;1213;72;271;179;609;251;880
421940;201808;279;868;122;428;29;121;29;92;58;213
421950;201808;2853;7330;1389;4468;328;1161;291;851;619;2012
421960;201808;151;399;99;318;20;80;23;65;43;145
421970;201808;1902;5085;1040;3296;229;765;294;828;523;1593
421985;201808;276;724;160;488;17;58;56;182;73;240
422000;201808;1513;4342;1273;3894;192;678;757;2292;949;2970
430003;201808;489;1448;338;1162;75;286;129;431;204;717
430005;201808;259;731;165;549;46;152;68;227;114;379
430010;201808;1603;4299;1273;3710;189;601;801;2282;990;2883
430020;201808;577;1400;448;1222;77;237;260;663;337;900
430030;201808;1011;2503;585;1712;181;547;167;471;348;1018
430040;201808;9198;23602;5567;16706;1567;5202;363;1157;1930;6359
430045;201808;551;1450;370;1086;43;152;205;560;248;712
430047;201808;240;552;97;296;20;66;31;98;51;164
430050;201808;987;2624;542;1661;119;387;134;379;253;766
430055;201808;264;684;113;353;16;53;52;150;68;203
430057;201808;94;212;32;91;7;26;8;19;15;45
430060;201808;15057;44052;12248;39448;3247;11167;5156;16659;8403;27826
430063;201808;861;2459;676;2047;129;396;385;1156;514;1552
430064;201808;954;2788;712;2231;213;710;223;692;436;1402
430066;201808;111;259;77;204;4;15;57;137;61;152
430070;201808;697;1806;108;370;14;49;12;29;26;78
430080;201808;716;1900;424;1298;91;299;175;480;266;779
430085;201808;820;2020;494;1442;84;255;196;575;280;830
430087;201808;515;1518;430;1387;88;303;236;762;324;1065
430090;201808;584;1550;192;634;23;91;57;185;80;276
430100;201808;548;1417;302;935;70;233;111;313;181;546
430105;201808;940;2611;613;2042;116;453;283;947;399;1400
430107;201808;174;526;120;398;18;63;30;84;48;147
430110;201808;2005;5157;1465;4339;238;736;825;2392;1063;3128
430120;201808;1350;4187;848;2867;178;626;363;1260;541;1886
430130;201808;3670;9808;2917;8692;1024;2798;936;3463;1960;6261
430140;201808;874;2610;564;1902;156;521;215;724;371;1245
430150;201808;556;1455;307;958;71;234;94;280;165;514
430155;201808;259;669;126;400;19;62;32;94;51;156
430160;201808;16685;43746;13524;38869;3040;9165;5794;17230;8834;26395
430163;201808;2274;5922;1633;4898;176;613;1021;3027;1197;3640
430165;201808;393;923;73;235;10;26;8;20;18;46
430170;201808;875;2397;310;1088;65;226;64;205;129;431
430175;201808;660;2073;544;1798;140;460;265;876;405;1336
430180;201808;647;1715;515;1474;85;266;332;908;417;1174
430185;201808;429;1065;267;753;44;128;130;337;174;465
430187;201808;624;1636;445;1345;72;240;224;665;296;905
430190;201808;1334;3844;1114;3431;281;919;503;1519;784;2438
430192;201808;121;362;50;157;9;30;12;35;21;65
430195;201808;377;1135;63;224;9;31;6;19;15;50
430200;201808;1007;3221;865;2932;298;1070;257;881;555;1951
430205;201808;491;1357;392;1150;18;67;313;888;331;955
430210;201808;4880;12422;3382;9436;613;1905;1348;3068;1961;4973
430215;201808;299;819;192;585;36;116;74;222;110;338
430220;201808;650;1630;169;576;31;119;36;109;67;228
430222;201808;178;532;147;469;23;75;65;201;88;276
430223;201808;249;697;210;619;34;105;115;325;149;430
430225;201808;14;33;12;29;2;3;8;13;10;16
430230;201808;1553;4609;1439;4450;192;545;1098;3477;1290;4022
430235;201808;236;728;175;579;37;130;56;173;93;303
430237;201808;535;1324;361;1013;21;71;244;647;265;718
430240;201808;1115;2535;668;1841;65;222;401;1063;466;1285
430245;201808;684;2118;535;1795;172;575;249;858;421;1433
430250;201808;955;2609;765;2315;252;826;40;115;292;941
430258;201808;113;318;86;267;7;23;45;144;52;167
430260;201808;603;1670;434;1327;82;270;221;667;303;937
430265;201808;190;577;139;484;25;93;40;140;65;233
430270;201808;2664;7012;2165;6218;253;805;1486;4167;1739;4972
430280;201808;4596;11543;3348;9292;769;2197;1411;3923;2180;6120
430290;201808;2075;5201;1839;4874;71;225;1583;4134;1654;4359
430300;201808;8235;22866;6562;19714;1337;4294;3198;9505;4535;13799
430310;201808;8226;21911;5566;16721;912;3152;2599;7339;3511;10491
430320;201808;910;2526;504;1620;84;231;254;874;338;1105
430330;201808;576;1488;395;1117;89;281;185;464;274;745
430340;201808;637;1507;338;1013;71;222;181;529;252;751
430350;201808;5533;15949;4499;13802;1161;3638;1974;5959;3135;9597
430355;201808;317;824;106;352;27;90;13;42;40;132
430360;201808;721;1881;519;1515;120;395;177;465;297;860
430367;201808;317;795;159;488;46;154;50;154;96;308
430370;201808;482;1349;225;739;50;175;58;171;108;346
430380;201808;660;1688;346;1107;92;333;83;276;175;609
430390;201808;2911;7295;1570;4744;316;1050;130;313;446;1363
430400;201808;1069;2427;806;2022;99;255;563;1359;662;1614
430410;201808;556;1424;389;1129;55;187;227;631;282;818
430420;201808;2710;7738;2084;6306;656;2054;722;2107;1378;4161
430430;201808;645;1697;309;972;72;231;68;214;140;445
430435;201808;1471;3896;1104;3267;267;848;451;1331;718;2179
430440;201808;3482;10254;2626;8476;513;1784;1338;4309;1851;6093
430450;201808;5873;15996;4982;14320;749;2418;2896;8132;3645;10550
430460;201808;25804;69871;18672;57981;4292;14785;7920;23502;12212;38287
430461;201808;416;1073;127;402;25;82;29;81;54;163
430462;201808;239;656;147;483;23;77;47;169;70;246
430463;201808;4419;12899;3542;11337;696;2417;1818;5777;2514;8194
430465;201808;466;1270;386;1100;65;196;237;661;302;857
430466;201808;3658;9469;2946;8278;760;2225;1395;3743;2155;5968
430467;201808;469;1228;343;1009;53;175;166;480;219;655
430468;201808;1272;3279;1022;2896;152;477;619;1732;771;2209
430469;201808;609;1712;72;240;11;29;10;27;21;56
430470;201808;5413;14830;3868;12036;1336;4352;882;2775;2218;7127
430471;201808;470;1474;407;1327;82;260;198;636;280;896
430480;201808;822;2200;413;1320;66;226;76;207;142;433
430485;201808;156;436;58;195;9;28;12;41;21;69
430490;201808;394;1066;219;675;31;106;98;287;129;393
430495;201808;359;1014;228;742;32;110;93;272;125;382
430500;201808;1020;2718;736;2226;208;696;259;717;467;1413
430510;201808;21491;58464;15541;46335;3549;11633;6099;16814;9648;28447
430511;201808;316;938;113;395;17;58;14;42;31;100
430512;201808;839;2057;680;1803;179;497;226;614;405;1111
430513;201808;778;1996;373;1081;75;234;167;456;242;690
430515;201808;383;1085;271;856;41;115;133;435;174;550
430517;201808;864;2752;722;2464;133;456;381;1354;514;1810
430520;201808;1271;3414;672;2125;146;478;129;373;275;851
430530;201808;1043;2688;367;1136;82;243;78;236;160;479
430535;201808;2789;7688;1991;6128;354;1139;951;2888;1305;4027
430537;201808;327;1185;294;1073;35;118;222;820;257;938
430540;201808;562;1352;332;982;57;161;163;470;220;631
430543;201808;629;1263;396;988;60;132;236;621;296;753
430544;201808;616;1888;444;1471;96;339;216;691;312;1030
430545;201808;1705;4812;1309;4196;278;931;651;2155;929;3086
430550;201808;414;1196;247;799;50;168;71;212;121;380
430558;201808;114;265;55;155;12;37;19;47;31;84
430560;201808;346;793;147;449;19;63;42;122;61;185
430570;201808;825;1979;580;1567;84;271;352;878;436;1149
430580;201808;1033;2513;667;1933;130;425;309;852;439;1277
430583;201808;189;469;35;108;3;8;5;15;8;23
430585;201808;215;520;119;323;15;47;61;144;76;191
430587;201808;180;541;138;450;25;83;55;178;80;261
430590;201808;1380;3414;1197;3119;51;160;1056;2710;1107;2870
430593;201808;13;46;12;42;2;8;8;26;10;34
430595;201808;403;981;86;304;8;35;16;51;24;86
430597;201808;347;980;223;688;25;88;83;201;108;289
430600;201808;1710;4578;802;2459;150;474;218;634;368;1108
430605;201808;1054;3083;810;2572;114;439;331;1017;445;1456
430607;201808;614;1414;449;1160;30;85;313;818;343;903
430610;201808;5302;13651;3811;11269;1174;3720;659;2067;1833;5787
430613;201808;261;619;82;250;8;31;22;57;30;88
430620;201808;525;1425;423;1224;98;316;193;530;291;846
430630;201808;429;1241;120;393;18;63;26;72;44;135
430632;201808;537;1473;245;754;33;105;110;321;143;426
430635;201808;507;1409;381;1140;68;220;248;727;316;947
430637;201808;436;1146;345;987;44;138;206;562;250;700
430640;201808;1147;2984;634;1913;100;306;211;587;311;893
430642;201808;356;976;256;759;44;125;132;383;176;508
430645;201808;231;492;75;196;16;45;11;31;27;76
430650;201808;1500;4699;1268;4260;345;1192;611;2093;956;3285
430655;201808;209;503;128;355;21;62;63;160;84;222
430660;201808;4476;12275;3491;10504;814;2694;1616;4793;2430;7487
430670;201808;563;1473;432;1235;41;137;276;796;317;933
430673;201808;559;1328;221;674;46;149;79;232;125;381
430675;201808;211;631;58;208;16;68;13;42;29;110
430676;201808;4041;10745;3127;9215;559;1768;1676;4866;2235;6634
430680;201808;939;2555;569;1800;152;484;143;431;295;915
430690;201808;3034;8593;2480;7556;800;2535;706;2122;1506;4657
430692;201808;201;644;158;572;15;49;111;414;126;463
430693;201808;990;2628;561;1718;115;411;121;319;236;730
430695;201808;493;1218;296;856;36;109;164;448;200;557
430697;201808;380;989;276;810;56;160;144;447;200;607
430700;201808;6671;17157;3597;11397;935;3188;357;1171;1292;4359
430705;201808;353;916;179;567;28;101;72;216;100;317
430710;201808;1648;3770;1166;3051;201;605;625;1583;826;2188
430720;201808;695;1704;371;1138;66;194;150;453;216;647
430730;201808;1136;3074;762;2376;134;425;369;1157;503;1582
430740;201808;569;1607;292;985;49;182;85;308;134;490
430745;201808;439;1243;229;741;37;136;54;159;91;295
430750;201808;1312;3491;937;2845;193;623;498;1452;691;2075
430755;201808;459;1151;285;786;24;81;160;401;184;482
430760;201808;1903;4953;1460;4248;368;1117;640;1830;1008;2947
430770;201808;5722;15178;4318;12951;763;2534;2483;7278;3246;9812
430780;201808;1947;5045;1171;3697;248;792;365;1237;613;2029
430781;201808;369;1068;220;738;57;192;45;133;102;325
430783;201808;439;1045;251;730;24;78;139;391;163;469
430786;201808;40;139;24;94;5;21;2;9;7;30
430790;201808;4222;11070;2930;8623;494;1590;1552;4301;2046;5891
430800;201808;727;1878;536;1501;51;174;341;924;392;1098
430805;201808;457;1261;272;834;28;92;159;454;187;546
430807;201808;324;802;210;606;21;73;113;307;134;380
430810;201808;811;2026;264;863;42;150;74;221;116;371
430820;201808;1238;3367;665;2230;160;573;145;488;305;1061
430825;201808;274;719;88;247;18;52;23;53;41;105
430830;201808;1529;4644;1307;4228;83;319;914;2946;997;3265
430840;201808;811;2328;696;2119;138;435;419;1275;557;1710
430843;201808;113;277;37;114;4;11;15;40;19;51
430845;201808;332;851;229;672;82;256;55;137;137;393
430850;201808;2174;5991;1649;4958;325;1052;793;2361;1118;3413
430860;201808;837;1917;418;1210;74;248;186;487;260;735
430865;201808;496;1323;418;1189;98;284;195;528;293;812
430870;201808;646;1745;286;922;47;166;93;264;140;430
430880;201808;1183;2896;787;2266;201;611;337;954;538;1565
430885;201808;218;524;96;314;8;34;55;171;63;205
430890;201808;1033;2807;695;2137;61;283;117;328;178;611
430900;201808;2858;6721;1936;5301;229;749;1132;2903;1361;3652
430905;201808;778;2100;494;1517;104;354;168;487;272;841
430910;201808;1327;3667;908;2797;177;622;388;1089;565;1711
430912;201808;472;1331;323;1049;36;114;206;682;242;796
430915;201808;497;1563;367;1315;97;364;128;478;225;842
430920;201808;20974;55315;16386;47944;2536;8130;9641;27598;12177;35728
430925;201808;138;308;51;145;11;33;19;58;30;91
430930;201808;9461;22907;5709;16990;1431;4592;1849;5743;3280;10335
430940;201808;1125;3290;623;2031;211;730;84;224;295;954
430950;201808;682;1730;435;1255;66;228;239;625;305;853
430955;201808;192;510;61;184;14;37;12;32;26;69
430957;201808;182;637;168;606;37;141;87;310;124;451
430960;201808;1224;2961;792;2223;162;507;427;1170;589;1677
430965;201808;1671;4184;1269;3536;82;270;955;2608;1037;2878
430970;201808;363;960;185;584;30;106;95;285;125;391
430975;201808;438;1429;354;1210;85;306;152;517;237;823
430980;201808;404;1002;221;670;40;125;88;260;128;385
430990;201808;534;1586;318;1031;49;172;158;511;207;683
430995;201808;571;1527;412;1240;64;198;203;597;267;795
431000;201808;1296;3102;538;1587;104;352;35;85;139;437
431010;201808;2024;5488;1184;3888;213;795;129;369;342;1164
431020;201808;7997;18431;4953;13574;1211;3600;1579;3986;2790;7586
431030;201808;318;904;146;518;31;111;26;95;57;206
431033;201808;2926;7816;1964;6259;518;1674;695;2390;1213;4064
431036;201808;350;775;70;212;11;25;12;35;23;60
431040;201808;908;2431;590;1811;94;334;264;755;358;1089
431041;201808;450;1087;346;928;34;93;225;586;259;679
431043;201808;400;994;211;660;69;223;71;220;140;443
431046;201808;114;304;48;145;4;10;10;30;14;40
431050;201808;1413;3559;1015;2932;206;611;532;1541;738;2152
431053;201808;484;1417;319;1064;82;301;95;303;177;604
431055;201808;599;1523;516;1391;43;110;391;1038;434;1148
431057;201808;279;809;127;432;20;71;35;106;55;177
431060;201808;4638;13237;3532;11145;1086;3675;727;2442;1813;6117
431065;201808;478;1284;319;988;80;241;88;276;168;517
431070;201808;448;1334;256;864;75;279;37;108;112;387
431075;201808;211;655;143;497;28;104;44;153;72;257
431080;201808;593;1666;414;1302;97;329;124;376;221;705
431085;201808;671;1857;485;1420;77;216;272;790;349;1006
431087;201808;454;1322;365;1120;25;77;259;810;284;887
431090;201808;404;964;145;466;33;120;37;112;70;232
431100;201808;3018;7203;2232;6115;408;1225;1024;2782;1432;4007
431110;201808;1318;3150;947;2510;243;661;432;1071;675;1732
431112;201808;500;1569;431;1425;92;316;213;689;305;1005
431113;201808;352;1025;299;918;80;255;142;439;222;694
431115;201808;1086;3160;858;2727;144;512;483;1475;627;1987
431120;201808;2261;6645;1622;5297;593;2164;367;1101;960;3265
431123;201808;374;1078;238;792;52;155;119;418;171;573
431125;201808;1082;3287;798;2655;307;1003;232;828;539;1831
431127;201808;256;688;64;208;8;24;11;24;19;48
431130;201808;2970;8152;2084;6460;471;1580;847;2585;1318;4165
431140;201808;4731;11489;2627;7480;384;1246;1078;2693;1462;3939
431142;201808;477;1327;362;1123;52;160;224;702;276;862
431150;201808;989;2797;699;2207;152;500;277;853;429;1353
431160;201808;653;1887;486;1540;96;293;193;631;289;924
431162;201808;476;1163;206;648;35;134;56;158;91;292
431164;201808;203;477;41;135;12;43;3;12;15;55
431170;201808;524;1456;358;1115;96;293;102;321;198;614
431171;201808;607;1566;512;1436;67;194;339;940;406;1134
431173;201808;395;1107;295;928;104;355;85;262;189;617
431175;201808;982;2511;601;1820;160;484;120;380;280;864
431177;201808;669;2027;517;1767;156;567;225;762;381;1329
431179;201808;340;713;65;188;12;38;18;39;30;77
431180;201808;2070;5456;1271;3883;375;1165;238;731;613;1896
431190;201808;446;1217;233;749;33;103;50;138;83;241
431198;201808;285;917;253;852;92;322;80;287;172;609
431200;201808;376;1002;95;312;14;38;1;6;15;44
431205;201808;181;538;81;299;24;93;33;126;57;219
431210;201808;605;1624;497;1457;127;355;250;770;377;1125
431213;201808;236;698;176;590;15;60;95;315;110;375
431215;201808;386;1059;218;682;29;102;87;245;116;347
431217;201808;145;425;98;331;11;40;52;166;63;206
431220;201808;615;1650;353;1112;33;129;178;514;211;643
431225;201808;1394;3559;1070;2976;137;408;649;1817;786;2225
431230;201808;656;1954;488;1513;73;248;294;878;367;1126
431235;201808;134;348;22;68;4;11;2;6;6;17
431237;201808;353;1071;284;945;51;195;153;490;204;685
431238;201808;23;62;19;51;4;9;6;15;10;24
431240;201808;3665;9750;2933;8547;678;2199;1308;3663;1986;5862
431242;201808;312;896;255;783;63;199;120;369;183;568
431244;201808;319;782;148;422;26;99;51;106;77;205
431245;201808;1238;3039;789;2192;116;352;382;1016;498;1368
431247;201808;219;614;108;353;19;68;27;77;46;145
431250;201808;1353;3994;1096;3576;251;788;523;1816;774;2604
431260;201808;215;618;118;420;19;86;42;139;61;225
431261;201808;241;777;194;682;20;75;91;294;111;369
431262;201808;389;1106;171;579;18;61;103;349;121;410
431265;201808;1438;3430;583;1706;94;314;172;415;266;729
431267;201808;252;719;145;446;6;24;98;271;104;295
431270;201808;2524;6055;1364;4013;388;1251;388;1136;776;2387
431275;201808;139;396;73;238;18;61;12;34;30;95
431280;201808;248;700;71;256;9;30;7;19;16;49
431290;201808;289;823;201;644;28;94;68;197;96;291
431295;201808;72;194;25;81;3;13;7;21;10;34
431300;201808;378;950;54;187;5;24;11;30;16;54
431301;201808;222;660;54;194;6;14;4;11;10;25
431303;201808;556;1502;323;996;40;149;120;342;160;491
431306;201808;2000;4878;1190;3474;187;637;450;1187;637;1824
431308;201808;25;85;22;75;12;44;6;19;18;63
431310;201808;545;1573;338;1079;59;201;131;413;190;614
431320;201808;590;1601;273;913;58;201;40;126;98;327
431330;201808;1660;4074;792;2442;224;765;178;490;402;1255
431333;201808;225;629;115;353;14;33;37;114;51;147
431335;201808;34;103;21;75;6;16;2;3;8;19
431337;201808;2497;6928;1733;5535;498;1756;527;1580;1025;3336
431339;201808;433;1134;305;885;69;199;160;473;229;672
431340;201808;18999;48631;13425;38984;2942;9290;4816;13254;7758;22544
431342;201808;450;1067;341;899;30;97;279;712;309;809
431344;201808;373;991;233;708;16;51;148;436;164;487
431346;201808;262;660;95;297;14;41;21;64;35;105
431349;201808;618;1686;347;1064;68;218;134;383;202;601
431350;201808;3678;10063;2751;8424;565;1870;1229;3735;1794;5605
431360;201808;568;1393;330;964;71;215;127;352;198;567
431365;201808;1679;4455;1413;4034;151;494;1031;2916;1182;3410
431370;201808;3972;10558;2995;8859;789;2467;1285;3906;2074;6373
431380;201808;734;2141;629;1956;54;184;399;1239;453;1423
431390;201808;2313;5978;1349;4099;244;848;494;1342;738;2190
431395;201808;1189;3290;865;2771;224;717;346;1164;570;1881
431400;201808;361;1068;181;590;30;99;44;136;74;235
431402;201808;886;2121;607;1642;97;295;362;926;459;1221
431403;201808;174;481;145;437;21;84;95;257;116;341
431405;201808;4118;11147;3319;9914;403;1417;2076;6034;2479;7451
431406;201808;436;1360;359;1214;88;285;192;666;280;951
431407;201808;421;1183;281;878;66;217;122;369;188;586
431410;201808;13946;37801;9018;28262;1863;6538;3437;10178;5300;16716
431413;201808;176;450;52;168;6;18;7;22;13;40
431415;201808;664;1716;405;1277;65;252;162;455;227;707
431417;201808;566;1312;385;1030;67;186;208;538;275;724
431420;201808;1261;3247;1037;2892;212;610;451;1318;663;1928
431430;201808;505;1321;259;813;57;199;55;143;112;342
431440;201808;22316;56876;16681;47436;3897;11708;5667;16045;9564;27753
431442;201808;89;256;47;160;8;30;7;16;15;46
431445;201808;435;1234;145;494;24;75;20;65;44;140
431446;201808;320;932;213;698;66;221;68;214;134;435
431447;201808;596;1660;401;1248;93;293;160;502;253;795
431449;201808;692;1898;431;1293;70;216;191;568;261;784
431450;201808;2026;4464;1682;3998;118;311;1284;2940;1402;3251
431454;201808;40;128;38;124;6;23;16;61;22;84
431455;201808;589;1457;295;825;43;141;146;358;189;499
431460;201808;2794;7354;2125;6079;589;1748;670;1981;1259;3729
431470;201808;1451;4178;1069;3376;220;708;450;1413;670;2121
431475;201808;242;697;29;113;2;9;2;9;4;18
431477;201808;436;1145;276;818;40;114;138;382;178;496
431478;201808;239;612;60;185;19;60;4;11;23;71
431480;201808;2966;7702;2311;6662;369;1127;1353;3880;1722;5007
431490;201808;93309;237139;77360;212549;7489;23657;56653;151541;64142;175198
431500;201808;484;1293;356;1033;76;201;177;506;253;707
431505;201808;381;935;245;709;23;64;148;429;171;493
431507;201808;348;831;148;420;38;124;52;125;90;249
431510;201808;1465;4000;1051;3165;239;763;416;1259;655;2022
431513;201808;255;606;132;374;16;44;93;267;109;311
431514;201808;81;223;42;145;10;39;17;52;27;91
431515;201808;502;1328;339;1009;73;238;168;468;241;706
431517;201808;67;195;51;155;11;30;16;50;27;80
431520;201808;428;1055;159;522;32;115;54;154;86;269
431530;201808;3752;8453;2294;6307;682;1917;364;1021;1046;2938
431531;201808;188;526;128;398;17;54;55;165;72;219
431532;201808;448;1175;314;911;78;238;134;386;212;624
431535;201808;264;675;99;310;18;60;25;71;43;131
431540;201808;1713;5717;1606;5532;85;337;1289;4443;1374;4780
431545;201808;365;966;71;220;5;19;20;56;25;75
431550;201808;1858;5092;1525;4432;309;950;701;1991;1010;2941
431555;201808;671;1571;424;1146;35;108;251;666;286;774
431560;201808;18670;49745;12673;39665;2910;9756;3634;12255;6544;22011
431570;201808;4531;11345;3642;10106;595;1829;2259;6105;2854;7934
431575;201808;179;541;134;438;23;70;25;70;48;140
431580;201808;511;1369;271;864;42;159;117;349;159;508
431590;201808;692;1872;498;1470;97;288;195;588;292;876
431595;201808;323;936;221;704;42;135;99;304;141;439
431600;201808;1298;3338;956;2793;279;880;336;988;615;1868
431610;201808;1279;3518;903;2750;133;380;447;1418;580;1798
431620;201808;536;1480;232;709;46;145;104;294;150;439
431630;201808;1178;3147;565;1803;150;500;162;459;312;959
431640;201808;5692;15203;5132;14383;686;1982;3627;10232;4313;12214
431642;201808;463;1193;296;848;33;90;150;412;183;502
431643;201808;321;809;145;415;21;58;50;136;71;194
431645;201808;1627;4156;1315;3652;140;432;927;2573;1067;3005
431647;201808;185;472;102;296;14;50;25;59;39;109
431650;201808;167;495;121;399;25;90;39;120;64;210
431660;201808;822;2232;446;1460;83;309;103;286;186;595
431670;201808;1090;2711;753;2114;132;413;381;1004;513;1417
431673;201808;240;644;89;324;18;58;12;39;30;97
431675;201808;546;1376;129;419;10;40;40;113;50;153
431680;201808;7028;19122;5287;15714;1471;4516;1972;5883;3443;10399
431690;201808;18526;49358;13365;39693;3528;10942;4539;13885;8067;24827
431695;201808;148;383;90;274;16;59;40;93;56;152
431697;201808;446;1112;356;960;59;155;210;587;269;742
431700;201808;1363;3674;1163;3306;178;501;685;1936;863;2437
431710;201808;10805;28909;8353;25150;2137;6675;3369;10783;5506;17458
431720;201808;5602;14964;3650;10979;1013;3217;633;1779;1646;4996
431725;201808;26;76;18;58;4;13;5;15;9;28
431730;201808;3338;8827;2308;7057;626;2064;732;2346;1358;4410
431740;201808;4589;11769;3211;9337;997;3246;642;1611;1639;4857
431750;201808;6687;18566;5746;17082;1060;3398;3143;9481;4203;12879
431755;201808;316;854;62;221;11;43;13;48;24;91
431760;201808;5294;12428;3408;9339;381;1267;2072;5327;2453;6594
431770;201808;1720;4362;1395;3887;151;470;995;2713;1146;3183
431775;201808;200;544;95;304;25;89;13;33;38;122
431780;201808;1779;4730;1228;3653;258;810;437;1272;695;2082
431790;201808;871;2456;634;1968;131;423;263;785;394;1208
431795;201808;250;661;123;369;26;80;35;102;61;182
431800;201808;6876;18671;4998;15363;1630;5511;662;2132;2292;7643
431805;201808;283;657;88;280;8;30;34;94;42;124
431810;201808;3198;7941;2025;5711;378;1201;846;2233;1224;3434
431820;201808;2072;6055;1738;5449;447;1447;715;2287;1162;3734
431830;201808;8341;19648;6433;16813;1584;4594;2555;6678;4139;11272
431840;201808;2345;6653;1952;5965;392;1243;1100;3366;1492;4609
431842;201808;689;1726;235;729;35;118;70;195;105;313
431843;201808;307;862;242;725;36;117;114;323;150;440
431844;201808;221;570;65;212;17;65;17;43;34;108
431845;201808;495;1328;345;1015;23;71;216;633;239;704
431846;201808;237;695;212;657;16;59;176;532;192;591
431848;201808;148;381;73;229;8;29;14;30;22;59
431849;201808;404;968;56;168;5;14;8;20;13;34
431850;201808;3731;10567;2987;9003;727;2361;963;2819;1690;5180
431860;201808;647;1674;408;1189;84;249;206;572;290;821
431861;201808;115;315;52;176;10;36;18;51;28;87
431862;201808;415;1347;340;1205;86;329;166;573;252;902
431870;201808;16305;45005;13310;39783;2338;7892;6946;20006;9284;27898
431880;201808;3435;9517;2689;8164;533;1822;1195;3475;1728;5297
431890;201808;3936;10537;2521;7670;824;2712;371;1215;1195;3927
431900;201808;988;2632;607;1866;125;433;295;849;420;1282
431910;201808;777;1929;291;867;48;142;86;224;134;366
431912;201808;410;1203;338;1059;80;258;186;578;266;836
431915;201808;910;2503;745;2212;76;242;517;1505;593;1747
431920;201808;1135;2941;966;2677;47;148;826;2261;873;2409
431930;201808;733;2183;539;1824;125;367;292;1061;417;1428
431935;201808;72;204;46;147;12;40;11;31;23;71
431936;201808;290;885;167;581;42;148;37;132;79;280
431937;201808;171;431;103;288;28;94;36;80;64;174
431940;201808;2316;5945;1442;4237;267;891;599;1664;866;2555
431950;201808;1635;4606;1374;4171;342;1056;646;1975;988;3031
431960;201808;2544;6708;2008;5697;585;1727;580;1645;1165;3372
431970;201808;360;947;154;495;37;109;33;94;70;203
431971;201808;63;154;35;107;3;8;6;15;9;23
431973;201808;454;1486;369;1312;39;129;265;965;304;1094
431975;201808;101;215;21;68;4;14;3;6;7;20
431980;201808;1030;2833;797;2416;181;592;358;1041;539;1633
431990;201808;5477;13945;3564;10955;662;2251;1307;3923;1969;6174
432000;201808;9660;24931;7290;21041;1994;5960;3111;9065;5105;15025
432010;201808;1841;4965;1434;4218;222;701;802;2266;1024;2967
432020;201808;1782;4484;1264;3582;316;956;563;1507;879;2463
432023;201808;492;1234;258;756;44;147;125;327;169;474
432026;201808;978;2883;725;2360;166;535;341;1100;507;1635
432030;201808;329;880;197;602;36;116;104;310;140;426
432032;201808;393;1050;265;790;30;104;144;393;174;497
432035;201808;710;2111;639;1991;209;683;240;750;449;1433
432040;201808;1017;2419;376;1203;73;258;118;345;191;603
432045;201808;194;553;106;367;29;99;30;113;59;212
432050;201808;494;1331;383;1118;114;329;121;357;235;686
432055;201808;685;1854;452;1400;139;471;156;454;295;925
432057;201808;252;651;192;522;43;103;83;209;126;312
432060;201808;432;1049;134;434;26;100;53;144;79;244
432065;201808;216;604;156;472;31;91;60;181;91;272
432067;201808;721;2184;596;1875;83;269;379;1166;462;1435
432070;201808;1804;4903;1107;3457;265;888;251;703;516;1591
432080;201808;3545;9299;2854;8133;727;2303;1149;3173;1876;5476
432085;201808;382;987;242;762;88;267;81;278;169;545
432090;201808;1215;3320;883;2680;209;692;375;1078;584;1770
432100;201808;987;2704;427;1419;88;310;38;95;126;405
432110;201808;2094;5920;1406;4567;368;1375;95;311;463;1686
432120;201808;2679;7851;2217;7017;712;2421;550;1708;1262;4129
432130;201808;2435;6607;2070;6092;752;2322;764;2291;1516;4613
432132;201808;236;641;120;398;27;94;40;119;67;213
432135;201808;869;2270;589;1718;62;206;407;1154;469;1360
432140;201808;1516;4773;1144;4019;216;786;601;2157;817;2943
432143;201808;1271;3540;1004;3110;106;384;628;1937;734;2321
432145;201808;1235;3457;728;2326;130;446;167;468;297;914
432146;201808;98;290;67;225;22;79;14;41;36;120
432147;201808;409;1298;295;1035;87;315;57;196;144;511
432149;201808;362;976;212;631;25;80;98;276;123;356
432150;201808;2756;7638;2057;6287;530;1840;625;1862;1155;3702
432160;201808;4281;12402;3411;10938;1036;3527;1075;3447;2111;6974
432162;201808;277;630;36;106;5;12;6;18;11;30
432163;201808;158;435;31;100;1;3;2;5;3;8
432166;201808;500;1493;392;1260;73;249;128;372;201;621
432170;201808;1220;3461;791;2610;190;684;223;694;413;1378
432180;201808;2500;6467;1346;4119;270;884;391;1069;661;1953
432183;201808;343;1044;223;746;63;237;57;181;120;418
432185;201808;802;2155;480;1496;37;135;279;821;316;956
432190;201808;1948;5062;1261;3752;318;1082;478;1303;796;2385
432195;201808;925;2356;592;1763;191;528;212;674;403;1202
432200;201808;2870;8024;2095;6612;441;1433;990;3202;1431;4635
432210;201808;351;969;232;746;48;178;100;301;148;479
432215;201808;625;1915;561;1812;59;175;400;1317;459;1492
432218;201808;242;621;124;352;17;49;51;130;68;179
432220;201808;3711;9179;2787;7635;407;1275;1676;4382;2083;5657
432225;201808;88;264;65;214;18;57;26;86;44;143
432230;201808;667;1714;381;1129;67;217;158;417;225;634
432232;201808;464;1198;323;941;66;205;128;369;194;574
432234;201808;300;791;130;397;31;91;24;63;55;154
432235;201808;91;250;31;98;5;16;10;34;15;50
432237;201808;352;918;310;845;16;49;231;597;247;646
432240;201808;13117;36707;10289;32552;952;3428;6386;21093;7338;24521
432250;201808;3962;12982;3461;11983;1110;3975;1248;4451;2358;8426
432252;201808;427;1118;272;792;50;161;110;294;160;455
432253;201808;1076;3369;589;2074;155;614;36;111;191;725
432254;201808;865;2167;164;535;32;121;16;42;48;163
432255;201808;137;361;68;216;8;28;28;78;36;106
432260;201808;4916;12915;3624;10539;1011;3053;1129;3306;2140;6359
432270;201808;1856;5530;1536;4879;537;1810;265;819;802;2629
432280;201808;1085;2831;588;1808;98;331;219;618;317;949
432285;201808;185;580;17;60;0;0;2;5;2;5
432290;201808;351;1050;194;667;62;211;48;140;110;351
432300;201808;23908;64462;18840;56217;2955;9751;11314;32889;14269;42640
432310;201808;702;2004;522;1675;81;277;317;1000;398;1277
432320;201808;220;531;68;204;7;29;23;59;30;88
432330;201808;235;609;86;281;20;62;19;63;39;125
432335;201808;169;487;62;240;13;54;13;51;26;105
432340;201808;308;752;136;421;27;102;41;101;68;203
432345;201808;556;1411;512;1352;37;132;401;1019;438;1151
432350;201808;328;894;164;546;28;94;51;160;79;254
432360;201808;210;628;38;129;5;24;6;18;11;42
432370;201808;307;807;207;616;19;56;127;369;146;425
432375;201808;499;1286;386;1080;59;153;227;633;286;786
432377;201808;230;732;35;125;5;17;7;18;12;35
432380;201808;1411;4115;886;2998;187;724;396;1260;583;1984
500020;201808;2106;5776;1512;4709;339;1146;677;2073;1016;3219
500025;201808;1224;2830;765;2049;72;194;461;1226;533;1420
500060;201808;5991;17686;4590;15179;688;2311;2718;9459;3406;11770
500070;201808;3727;10202;2761;8532;597;1897;1240;4005;1837;5902
500080;201808;1122;3144;824;2608;188;675;353;1047;541;1722
500085;201808;1902;4767;1304;3838;269;866;677;1932;946;2798
500090;201808;1806;5087;1257;4063;248;834;511;1702;759;2536
500100;201808;3231;8553;2479;7304;370;1223;1289;3638;1659;4861
500110;201808;6586;18517;4490;15051;994;3547;1542;5879;2536;9426
500124;201808;1863;5918;1590;5446;337;1133;877;3184;1214;4317
500150;201808;1121;2663;714;2012;173;528;250;655;423;1183
500190;201808;4212;10395;3089;8892;666;1994;1393;4195;2059;6189
500200;201808;2064;5069;1550;4208;203;602;927;2371;1130;2973
500210;201808;4280;11905;3320;10458;875;2810;1475;4751;2350;7561
500215;201808;1334;3855;937;3084;100;362;478;1534;578;1896
500220;201808;2578;7441;1875;6180;327;1169;745;2452;1072;3621
500230;201808;2037;5063;1518;4278;204;596;945;2616;1149;3212
500240;201808;3228;10338;2303;8304;454;1874;628;2341;1082;4215
500260;201808;2997;6647;1816;4949;237;644;926;2466;1163;3110
500270;201808;121313;297426;71000;207538;14994;47573;22419;62841;37413;110414
500280;201808;1213;3171;878;2645;106;358;544;1590;650;1948
500290;201808;3528;8223;1939;5739;335;1098;709;1972;1044;3070
500295;201808;2754;7071;1593;4818;291;986;575;1531;866;2517
500310;201808;856;1996;622;1687;112;265;334;950;446;1215
500315;201808;3166;9563;2607;8635;335;1091;1713;5926;2048;7017
500320;201808;16764;49983;12169;41743;3357;12316;3864;14103;7221;26419
500325;201808;3861;9219;2617;7349;326;974;1469;4118;1795;5092
500330;201808;6484;15519;4167;11796;382;1235;2282;6596;2664;7831
500345;201808;1820;4575;1226;3662;332;1020;431;1273;763;2293
500348;201808;2526;6574;1967;5658;257;774;1190;3472;1447;4246
500350;201808;1215;3431;637;2104;76;278;237;788;313;1066
500370;201808;20190;56184;14143;45579;2503;9122;6469;20879;8972;30001
500375;201808;2291;6360;1607;4902;347;1167;544;1607;891;2774
500380;201808;3332;8446;2343;6864;648;1996;871;2609;1519;4605
500390;201808;480;1034;287;770;41;117;158;415;199;532
500400;201808;1059;2950;730;2247;179;614;235;677;414;1291
500410;201808;2213;5955;1688;5112;252;759;977;3032;1229;3791
500430;201808;2405;6327;1636;5122;286;1011;650;2145;936;3156
500440;201808;1146;2767;687;1999;107;315;268;829;375;1144
500450;201808;1215;3133;669;2097;154;498;116;328;270;826
500460;201808;3329;9453;2137;7087;460;1699;552;1880;1012;3579
500470;201808;2326;6502;1458;4650;469;1628;298;832;767;2460
500480;201808;2077;6222;1821;5876;129;401;1379;4718;1508;5119
500490;201808;860;2155;513;1611;144;521;161;506;305;1027
500500;201808;3905;10931;2711;9068;900;3437;659;2258;1559;5695
500510;201808;680;1734;424;1253;23;75;257;732;280;807
500515;201808;1811;4615;1493;4161;120;312;1099;3140;1219;3452
500520;201808;3002;10168;2461;9063;686;2691;1018;3770;1704;6461
500525;201808;872;2698;724;2460;91;353;430;1480;521;1833
500540;201808;4236;11338;2511;8194;734;2847;250;753;984;3600
500560;201808;4945;14862;4154;13723;308;1113;3165;10592;3473;11705
500568;201808;3957;9064;2446;6810;645;2015;728;2024;1373;4039
500570;201808;6666;16481;3805;11333;929;3017;901;2533;1830;5550
500580;201808;3019;8421;2358;7271;453;1463;1273;3920;1726;5383
500600;201808;3030;7757;2040;6174;422;1358;793;2417;1215;3775
500620;201808;7032;19546;4823;15178;997;3253;1969;6195;2966;9448
500625;201808;484;1372;264;865;56;202;99;303;155;505
500627;201808;718;1891;449;1379;80;249;123;382;203;631
500630;201808;5569;13996;3433;10328;820;2626;1045;3211;1865;5837
500635;201808;2517;8660;2043;7951;151;637;1495;6145;1646;6782
500640;201808;1661;3863;1083;2991;44;153;766;2030;810;2183
500660;201808;15707;45028;11313;37820;4012;14818;2583;8908;6595;23726
500690;201808;2193;6339;1556;5273;698;2610;106;316;804;2926
500710;201808;2769;8001;2147;6827;627;2080;592;1845;1219;3925
500720;201808;4618;12242;2932;9340;812;2850;665;2115;1477;4965
500730;201808;873;2361;563;1759;102;304;219;699;321;1003
500740;201808;4355;10909;3184;8906;328;1041;1796;5077;2124;6118
500750;201808;927;2459;679;2023;102;328;285;780;387;1108
500755;201808;841;2357;509;1696;111;384;77;235;188;619
500769;201808;4699;12084;2487;7600;527;1802;381;890;908;2692
500770;201808;1480;4118;927;3055;173;604;301;1004;474;1608
500780;201808;1197;3089;787;2344;187;590;209;593;396;1183
500790;201808;7669;20583;6245;18320;1188;3762;3476;10262;4664;14024
500793;201808;1765;4756;1244;3853;409;1310;261;714;670;2024
500795;201808;2323;6418;1932;5888;149;409;1576;5014;1725;5423
500797;201808;667;1824;455;1404;102;318;169;506;271;824
500800;201808;2616;6477;1768;5199;621;2064;309;999;930;3063
500830;201808;16486;42471;11359;33058;1835;5805;5473;15246;7308;21051
500840;201808;1022;2742;684;2094;97;314;287;829;384;1143
510010;201808;1734;4259;1175;3472;192;555;671;2024;863;2579
510020;201808;3494;9173;1856;5790;439;1430;354;989;793;2419
510025;201808;6361;17185;4024;12788;780;2771;1308;3957;2088;6728
510030;201808;2028;4710;1368;3773;350;973;497;1445;847;2418
510035;201808;1132;2985;687;2264;111;358;392;1384;503;1742
510040;201808;2099;4969;1516;4138;134;378;971;2646;1105;3024
510050;201808;1831;4508;1246;3580;232;745;725;1954;957;2699
510060;201808;1291;3405;966;2895;163;526;464;1361;627;1887
510080;201808;1111;3159;755;2499;222;789;210;617;432;1406
510100;201808;644;1574;418;1166;56;169;216;576;272;745
510120;201808;257;498;154;374;8;23;116;280;124;303
510125;201808;2165;5498;1655;4711;260;954;725;1889;985;2843
510130;201808;1355;3643;1009;3059;252;814;298;908;550;1722
510140;201808;2761;7809;1975;6755;745;2867;667;2130;1412;4997
510160;201808;1278;3916;1080;3642;200;691;727;2471;927;3162
510170;201808;4400;12371;3297;10506;775;2602;1458;4627;2233;7229
510180;201808;12296;30148;7655;22553;1976;6184;2326;7730;4302;13914
510185;201808;1677;4474;1120;3665;391;1261;406;1614;797;2875
510190;201808;2075;5901;1429;4845;459;1686;412;1470;871;3156
510250;201808;13398;37068;11173;33931;2381;7600;6281;19721;8662;27321
510260;201808;2037;8426;1659;7699;263;1240;980;5062;1243;6302
510263;201808;2953;8441;1854;6207;423;1529;245;770;668;2299
510267;201808;4517;13216;2846;9496;660;2303;529;1819;1189;4122
510268;201808;1367;3541;916;2699;132;401;476;1341;608;1742
510269;201808;1042;3001;667;2258;188;683;217;699;405;1382
510270;201808;2711;8398;2029;7124;431;1596;762;2675;1193;4271
510279;201808;1656;4706;1205;3860;238;847;616;1888;854;2735
510285;201808;1075;2979;763;2441;227;791;199;603;426;1394
510300;201808;3384;8968;2600;7892;319;911;1676;5333;1995;6244
510305;201808;1274;3830;875;3031;187;695;267;998;454;1693
510310;201808;876;2318;626;1892;207;649;188;600;395;1249
510320;201808;3518;9341;2605;7734;646;2087;744;2212;1390;4299
510325;201808;4468;13558;3527;12058;971;3421;1562;5579;2533;9000
510330;201808;2835;8770;1973;7194;444;1687;700;2828;1144;4515
510335;201808;4561;13385;3428;11766;440;1647;1999;7199;2439;8846
510336;201808;468;1383;338;1150;64;202;165;605;229;807
510337;201808;1590;4887;1090;3959;451;1765;191;718;642;2483
510340;201808;79963;187975;48961;140583;14969;49678;11531;31290;26500;80968
510343;201808;951;2767;665;2200;138;490;236;743;374;1233
510345;201808;1248;3706;935;3083;183;601;399;1276;582;1877
510350;201808;2745;7441;1806;5876;451;1528;717;2355;1168;3883
510360;201808;1753;3923;1132;3150;58;206;844;2379;902;2585
510370;201808;1600;4930;1183;4173;211;825;626;2260;837;3085
510380;201808;463;1232;246;809;78;285;34;110;112;395
510385;201808;999;3641;738;3078;92;429;444;1968;536;2397
510390;201808;1022;3188;808;2872;220;763;380;1496;600;2259
510395;201808;710;1661;472;1304;40;107;259;775;299;882
510410;201808;4043;12126;3109;10386;757;2596;1533;5349;2290;7945
510420;201808;2030;4698;1448;3876;150;466;877;2344;1027;2810
510450;201808;510;1314;301;922;79;248;53;173;132;421
510452;201808;638;1874;433;1454;88;302;212;722;300;1024
510454;201808;770;2276;576;1928;57;179;352;1250;409;1429
510455;201808;851;2522;615;1997;101;389;234;684;335;1073
510460;201808;1885;4790;1348;3985;143;495;820;2332;963;2827
510480;201808;4191;10700;2791;7928;549;1663;1176;3174;1725;4837
510490;201808;1576;4579;1206;4044;266;906;602;2063;868;2969
510500;201808;1368;3804;865;2852;164;601;350;1132;514;1733
510510;201808;3083;9724;2383;8313;785;2980;589;2210;1374;5190
510515;201808;5312;14593;3435;10909;823;2882;923;2696;1746;5578
510517;201808;1138;3351;880;2886;263;969;161;466;424;1435
510520;201808;1941;4130;1201;3218;76;221;696;1965;772;2186
510523;201808;927;2531;718;2168;114;320;434;1332;548;1652
510525;201808;5283;15338;4050;12837;729;2573;1763;5127;2492;7700
510530;201808;513;1324;380;1132;22;99;270;770;292;869
510550;201808;2578;7975;1892;6689;489;1793;720;2608;1209;4401
510558;201808;1923;5388;1533;4828;149;519;848;2851;997;3370
510560;201808;1542;4558;898;3300;212;844;232;931;444;1775
510562;201808;4806;13225;3533;10877;850;2833;1370;4318;2220;7151
510590;201808;2907;7627;2123;6594;345;1060;1322;4245;1667;5305
510600;201808;1459;3520;908;2645;208;592;342;1048;550;1640
510610;201808;2425;6286;1753;5346;174;627;1130;3408;1304;4035
510615;201808;1874;5387;1412;4556;268;890;800;2642;1068;3532
510617;201808;910;2669;694;2318;105;336;439;1573;544;1909
510618;201808;1257;3490;888;2806;186;672;445;1341;631;2013
510619;201808;699;1869;390;1294;67;240;77;252;144;492
510620;201808;1398;3251;667;2076;165;602;77;199;242;801
510621;201808;1208;3471;807;2687;177;630;243;796;420;1426
510622;201808;3708;10967;2632;8503;977;3434;443;1290;1420;4724
510623;201808;2599;6892;1886;5693;436;1561;572;1675;1008;3236
510624;201808;1498;4056;660;2306;94;365;117;351;211;716
510625;201808;2272;5775;1323;4035;311;1078;273;829;584;1907
510626;201808;1575;3806;935;2827;287;971;210;666;497;1637
510627;201808;624;1639;366;1120;94;301;88;280;182;581
510628;201808;1518;3504;1004;2816;171;466;620;1824;791;2290
510629;201808;1484;4564;1146;3877;289;1036;388;1351;677;2387
510630;201808;3080;9126;1850;6625;443;1734;296;1154;739;2888
510631;201808;466;1215;339;1020;20;58;238;724;258;782
510637;201808;3082;7945;2290;6648;693;2219;653;1845;1346;4064
510642;201808;4817;14838;3875;13380;1100;4083;1568;5633;2668;9716
510645;201808;828;1854;488;1388;145;413;152;431;297;844
510650;201808;6406;18504;5404;17370;726;2196;4005;13532;4731;15728
510665;201808;1745;4205;1019;2929;188;581;398;1189;586;1770
510670;201808;388;829;213;579;25;83;117;313;142;396
510675;201808;5552;16274;4076;13439;1252;4517;756;2462;2008;6979
510677;201808;2062;5479;1462;4554;224;760;758;2330;982;3090
510680;201808;602;1693;386;1274;101;357;55;171;156;528
510682;201808;1552;4951;1165;4222;380;1483;270;1006;650;2489
510685;201808;681;2000;518;1673;68;225;257;810;325;1035
510700;201808;3430;9101;2412;7555;443;1450;1392;4436;1835;5886
510704;201808;9254;23318;6158;17802;1280;3982;1943;5463;3223;9445
510706;201808;1760;5408;1245;4559;241;953;650;2515;891;3468
510710;201808;2411;6505;1685;5069;366;1156;622;1783;988;2939
510715;201808;654;1523;452;1211;54;144;205;561;259;705
510718;201808;2442;5399;1322;4044;570;1779;238;987;808;2766
510719;201808;389;858;237;652;39;114;127;340;166;454
510720;201808;942;2380;630;1874;167;525;199;573;366;1098
510724;201808;646;1803;451;1459;86;308;215;660;301;968
510726;201808;1022;1943;558;1343;65;162;324;786;389;948
510729;201808;610;1492;290;882;45;163;68;204;113;367
510730;201808;2875;7329;1961;5828;438;1395;776;2306;1214;3701
510735;201808;974;2949;739;2607;84;323;510;1818;594;2141
510740;201808;1158;3189;830;2595;84;225;533;1797;617;2022
510757;201808;569;1861;465;1673;181;694;148;508;329;1202
510760;201808;34863;80182;20748;58607;5876;18828;5041;13121;10917;31949
510770;201808;3968;9473;2918;8186;306;823;1996;5855;2302;6678
510774;201808;341;958;247;775;39;118;130;429;169;547
510775;201808;578;1658;406;1363;96;366;100;319;196;685
510776;201808;450;1241;314;952;85;262;99;304;184;566
510777;201808;1603;4480;1186;3902;138;531;830;2710;968;3241
510779;201808;561;1617;445;1423;63;168;270;914;333;1082
510780;201808;3541;9734;2668;8403;699;2238;1086;3767;1785;6005
510785;201808;1978;5316;1145;3768;281;1004;169;605;450;1609
510787;201808;2298;6586;1620;5252;716;2413;128;401;844;2814
510788;201808;686;1663;468;1328;81;220;181;616;262;836
510790;201808;13837;38019;8581;27622;2111;7747;1310;3715;3421;11462
510792;201808;8068;22159;5196;16736;1121;3928;1247;3914;2368;7842
510794;201808;1172;3321;765;2552;244;899;161;477;405;1376
510795;201808;6672;19081;4768;15549;1313;4672;1189;3915;2502;8587
510800;201808;1539;4063;1081;3346;266;843;372;1123;638;1966
510805;201808;1658;4593;1097;3533;250;878;406;1176;656;2054
510810;201808;637;1406;426;1117;108;307;209;537;317;844
510820;201808;789;1559;429;1096;50;159;195;490;245;649
510830;201808;716;1880;516;1590;88;273;305;986;393;1259
510835;201808;540;1428;365;1139;52;176;186;571;238;747
510840;201808;42888;99847;31319;85206;6251;16610;16624;48540;22875;65150
510850;201808;1734;4369;990;3124;330;1151;122;323;452;1474
510860;201808;2527;7116;1649;5559;562;2159;187;618;749;2777
510880;201808;618;1845;483;1593;120;417;218;744;338;1161
510885;201808;562;1482;391;1223;65;217;131;412;196;629
510890;201808;625;1901;499;1712;106;398;254;886;360;1284
510895;201808;1139;3075;780;2449;211;753;282;805;493;1558
520005;201808;1918;5364;1551;4893;419;1208;729;2648;1148;3856
520010;201808;2147;6525;1526;5211;446;1682;340;1045;786;2727
520013;201808;2531;6942;1826;5555;454;1452;500;1618;954;3070
520015;201808;527;1380;397;1199;115;363;117;392;232;755
520017;201808;1058;2921;813;2522;150;505;454;1385;604;1890
520020;201808;371;937;295;829;62;204;165;439;227;643
520025;201808;31266;90040;27568;85038;3288;10868;19663;60584;22951;71452
520030;201808;4882;13609;3954;12171;514;1716;2444;7540;2958;9256
520050;201808;426;1017;264;725;19;44;153;441;172;485
520055;201808;1094;3014;819;2467;60;183;483;1434;543;1617
520060;201808;1375;4058;1072;3481;276;994;296;942;572;1936
520080;201808;1789;4805;1384;4240;238;713;676;2253;914;2966
520082;201808;1015;2562;852;2284;104;226;488;1379;592;1605
520085;201808;689;1986;547;1743;131;410;179;543;310;953
520090;201808;782;1689;570;1445;90;196;387;1035;477;1231
520110;201808;36405;102364;26097;85388;9350;34462;1804;5450;11154;39912
520120;201808;189;475;105;329;12;44;34;107;46;151
520130;201808;3553;9322;2965;8354;574;1693;1434;4101;2008;5794
520140;201808;34258;99791;26097;85140;9892;34991;2941;10010;12833;45001
520145;201808;481;1222;339;997;74;229;137;381;211;610
520150;201808;540;1350;419;1191;73;204;231;679;304;883
520160;201808;795;1930;578;1595;100;278;286;796;386;1074
520170;201808;4856;10280;3509;8739;213;554;2839;7042;3052;7596
520180;201808;1856;5350;1553;4855;397;1323;665;2064;1062;3387
520215;201808;1912;4704;1394;3876;313;956;598;1606;911;2562
520235;201808;597;1455;392;1133;47;150;160;446;207;596
520250;201808;1441;3810;1037;3185;292;992;212;683;504;1675
520260;201808;824;1977;502;1407;100;304;189;531;289;835
520280;201808;611;1645;485;1407;144;418;185;575;329;993
520310;201808;1221;2825;816;2205;199;560;314;899;513;1459
520320;201808;1713;4882;1359;4294;151;517;744;2372;895;2889
520330;201808;3293;9567;2371;7950;468;1781;984;3246;1452;5027
520340;201808;2149;5064;1470;4087;140;351;985;2835;1125;3186
520350;201808;2750;7042;2022;5826;647;1996;671;1865;1318;3861
520355;201808;1734;4872;1322;4089;306;1037;525;1579;831;2616
520357;201808;791;2009;616;1729;32;93;452;1283;484;1376
520360;201808;677;1836;519;1561;160;493;141;455;301;948
520380;201808;1273;3294;756;2269;92;313;387;1074;479;1387
520390;201808;887;2035;514;1541;169;535;142;452;311;987
520393;201808;524;1263;366;1008;43;133;183;471;226;604
520396;201808;789;2221;665;1991;74;223;428;1261;502;1484
520400;201808;1521;4036;1237;3630;222;689;782;2304;1004;2993
520410;201808;1585;3538;1001;2710;121;355;588;1580;709;1935
520420;201808;374;932;279;743;31;94;190;477;221;571
520425;201808;1335;3271;901;2560;242;703;360;1043;602;1746
520430;201808;2114;5093;1124;3448;201;728;55;162;256;890
520440;201808;3098;7665;1957;5640;508;1559;530;1485;1038;3044
520450;201808;10654;26883;7043;20932;2401;7726;661;2068;3062;9794
520455;201808;649;1833;475;1553;149;526;125;400;274;926
520460;201808;876;2367;756;2198;99;259;576;1720;675;1979
520465;201808;804;2165;661;1938;105;337;421;1176;526;1513
520470;201808;1843;5423;1583;5066;364;1137;924;3158;1288;4295
520480;201808;800;2330;540;1849;155;562;111;403;266;965
520485;201808;1518;4289;1250;3918;176;574;817;2540;993;3114
520490;201808;3686;10819;2933;9647;864;2820;1326;4579;2190;7399
520495;201808;1426;3375;1124;2965;62;169;869;2336;931;2505
520500;201808;1391;3755;986;3020;229;783;373;1122;602;1905
520505;201808;701;1714;503;1444;97;284;269;764;366;1048
520510;201808;6540;17407;4646;14547;1149;3975;1259;4199;2408;8174
520520;201808;1084;2851;814;2425;223;654;247;800;470;1454
520530;201808;1937;5975;1453;5102;516;1869;387;1571;903;3440
520540;201808;2842;7620;1750;5399;406;1306;386;1199;792;2505
520545;201808;884;2436;679;2097;130;417;263;820;393;1237
520547;201808;696;2023;543;1724;147;477;241;765;388;1242
520549;201808;10968;31577;9060;28443;1976;6380;4887;15489;6863;21869
520551;201808;4120;11802;3527;10925;480;1748;2396;7247;2876;8995
520552;201808;768;2172;690;2069;101;282;493;1544;594;1826
520570;201808;581;1432;394;1148;102;292;137;420;239;712
520580;201808;2744;6258;1941;5245;182;513;1273;3460;1455;3973
520590;201808;1230;3410;880;2759;239;753;157;518;396;1271
520620;201808;7982;22172;6430;19891;1654;5285;2987;9452;4641;14737
520630;201808;917;2321;559;1702;103;319;152;453;255;772
520640;201808;2438;6228;1868;5252;490;1402;732;2140;1222;3542
520650;201808;888;2204;612;1745;113;323;312;915;425;1238
520660;201808;522;1264;244;751;47;157;48;161;95;318
520670;201808;937;2663;782;2437;80;254;531;1614;611;1868
520680;201808;700;1783;523;1510;106;296;253;754;359;1050
520690;201808;367;872;240;688;76;213;73;223;149;436
520710;201808;501;1249;335;956;11;34;217;603;228;637
520725;201808;1582;3866;1122;3104;128;393;725;1955;853;2348
520735;201808;762;1942;517;1516;106;306;183;562;289;868
520740;201808;1842;4506;1472;4028;260;679;894;2545;1154;3224
520750;201808;634;1609;465;1352;83;227;223;679;306;906
520753;201808;1388;3704;1114;3181;196;601;509;1381;705;1982
520760;201808;1143;2534;1028;2388;83;160;851;2065;934;2225
520780;201808;1508;3724;1139;3195;122;363;627;1720;749;2083
520790;201808;3376;8066;2372;6525;229;636;1449;4238;1678;4874
520800;201808;14384;38604;11657;34891;2241;6703;6955;21815;9196;28518
520810;201808;1302;2841;938;2418;169;469;532;1426;701;1895
520815;201808;609;1892;453;1577;115;409;92;390;207;799
520830;201808;1727;3978;1270;3444;63;142;1021;2758;1084;2900
520840;201808;2232;6252;1819;5684;772;2512;512;1730;1284;4242
520850;201808;636;1754;446;1455;164;604;92;298;256;902
520860;201808;5929;16820;4561;14618;1112;3861;1684;5444;2796;9305
520870;201808;83681;205844;58641;167948;16801;52284;17282;48864;34083;101148
520880;201808;5693;16668;4565;14765;1437;4949;1310;4206;2747;9155
520890;201808;3677;9476;2617;7739;594;1934;1129;3292;1723;5226
520910;201808;4062;10578;2636;8084;768;2557;506;1576;1274;4133
520915;201808;583;1681;419;1342;69;248;168;522;237;770
520920;201808;4316;10386;2921;8430;437;1338;1474;4296;1911;5634
520929;201808;702;1757;514;1427;85;202;246;746;331;948
520940;201808;1053;2871;837;2562;61;215;640;1945;701;2160
520945;201808;494;1146;387;967;22;47;280;692;302;739
520960;201808;1001;2655;794;2308;123;389;463;1289;586;1678
520970;201808;2354;6902;1947;6165;584;2001;479;1575;1063;3576
520980;201808;754;1984;595;1738;130;415;241;678;371;1093
520990;201808;2768;8443;2447;7917;318;1051;1585;5194;1903;6245
520993;201808;978;2384;669;1869;31;99;481;1320;512;1419
520995;201808;2163;5715;1732;5117;394;1155;756;2282;1150;3437
521000;201808;7451;20695;5469;17059;1430;4692;1540;4795;2970;9487
521010;201808;3682;9762;2769;8188;363;1051;1522;4526;1885;5577
521015;201808;639;1674;525;1491;61;192;346;948;407;1140
521020;201808;2798;7527;1727;5377;529;1759;181;570;710;2329
521030;201808;524;1223;374;1004;51;109;196;575;247;684
521040;201808;7243;17990;5446;15199;1410;4115;2106;6051;3516;10166
521056;201808;828;2290;645;1995;209;668;177;601;386;1269
521060;201808;1021;2629;756;2196;57;177;413;1215;470;1392
521080;201808;1064;2457;552;1593;81;249;177;435;258;684
521090;201808;3109;8225;2240;6770;658;2112;332;1046;990;3158
521100;201808;1711;4045;1258;3405;249;646;685;1921;934;2567
521120;201808;4772;11292;3341;9490;338;919;1594;5146;1932;6065
521130;201808;936;2313;630;1745;38;138;368;1011;406;1149
521140;201808;1190;3192;881;2653;154;496;357;1068;511;1564
521150;201808;11343;26062;7381;20472;1656;5159;3021;8573;4677;13732
521160;201808;655;1469;441;1138;64;180;243;590;307;770
521170;201808;1055;2525;756;2066;69;193;508;1340;577;1533
521180;201808;6387;19118;5377;17216;1126;3882;2276;7072;3402;10954
521190;201808;9997;26289;5771;18635;1522;5299;1110;3762;2632;9061
521200;201808;723;1855;508;1482;65;188;281;811;346;999
521205;201808;602;1580;457;1344;24;62;332;964;356;1026
521210;201808;702;1870;395;1227;97;333;54;124;151;457
521220;201808;3894;9652;2649;7705;583;1844;866;2403;1449;4247
521225;201808;326;753;255;672;28;64;175;480;203;544
521230;201808;1357;4167;1264;4024;434;1277;693;2399;1127;3676
521250;201808;29888;84572;24082;76170;9691;31754;7331;24875;17022;56629
521260;201808;589;1409;440;1172;65;182;259;685;324;867
521270;201808;1764;4610;1539;4348;108;267;1212;3472;1320;3739
521280;201808;1818;5131;1393;4359;412;1372;478;1532;890;2904
521290;201808;433;1138;326;991;56;199;178;522;234;721
521295;201808;1094;2459;880;2204;73;166;677;1785;750;1951
521300;201808;1840;4774;1492;4288;293;808;917;2732;1210;3540
521305;201808;691;1805;506;1499;72;206;274;814;346;1020
521308;201808;4533;12684;3333;10294;533;1670;1776;5441;2309;7111
521310;201808;7848;21067;5229;16318;1332;4451;1674;5105;3006;9556
521340;201808;399;968;304;824;24;64;223;596;247;660
521350;201808;2045;5314;1593;4629;189;611;1069;3005;1258;3616
521370;201808;1104;2900;680;2152;176;630;124;395;300;1025
521375;201808;1389;3586;995;3018;249;774;364;1170;613;1944
521377;201808;1347;3061;1049;2688;63;143;880;2288;943;2431
521380;201808;5529;15238;3837;12078;487;1607;985;3285;1472;4892
521385;201808;601;1505;478;1343;102;285;227;699;329;984
521390;201808;682;1771;499;1492;166;519;162;512;328;1031
521400;201808;2351;5540;1835;4938;203;574;1371;3751;1574;4325
521405;201808;1246;3276;953;2789;205;607;438;1289;643;1896
521410;201808;750;2064;607;1849;119;357;315;1029;434;1386
521440;201808;1319;3551;978;2949;283;918;258;761;541;1679
521450;201808;3730;11527;2849;9699;691;2399;800;2848;1491;5247
521460;201808;5733;15729;4310;13181;1557;5014;1109;3328;2666;8342
521470;201808;616;1742;374;1193;64;196;100;296;164;492
521480;201808;356;952;205;656;44;157;51;144;95;301
521483;201808;2365;5916;1711;4838;429;1296;595;1614;1024;2910
521486;201808;1627;3955;1265;3454;74;206;971;2634;1045;2840
521487;201808;437;1113;318;938;63;190;141;422;204;612
521490;201808;829;2315;630;1971;43;174;431;1305;474;1479
521500;201808;1615;4223;1158;3474;105;387;774;2232;879;2619
521520;201808;772;1793;526;1421;91;251;224;620;315;871
521523;201808;10913;36583;9584;34254;3491;13309;2510;9323;6001;22632
521525;201808;999;2399;774;2069;87;237;538;1426;625;1663
521530;201808;2179;5699;1283;3886;285;902;329;1062;614;1964
521540;201808;859;2218;550;1685;100;372;233;708;333;1080
521550;201808;1198;3078;751;2229;161;518;250;793;411;1311
521560;201808;3713;10779;2712;9402;615;2430;1329;4804;1944;7234
521565;201808;581;1471;473;1317;83;216;288;784;371;1000
521570;201808;3605;9695;2388;7407;533;1854;352;1146;885;3000
521580;201808;506;1252;282;846;41;133;66;170;107;303
521590;201808;583;1531;453;1322;122;402;192;527;314;929
521600;201808;395;1131;240;772;48;135;51;170;99;305
521630;201808;1553;3580;928;2619;202;627;286;771;488;1398
521640;201808;1953;4713;1430;3952;329;947;541;1475;870;2422
521645;201808;569;1561;371;1189;81;251;109;353;190;604
521680;201808;1111;3474;890;3015;273;982;112;423;385;1405
521690;201808;474;1293;407;1175;73;227;238;667;311;894
521710;201808;2914;7767;2000;6147;404;1370;438;1309;842;2679
521720;201808;1949;5073;1481;4295;200;638;841;2371;1041;3009
521730;201808;3576;10716;2827;9312;984;3610;515;1452;1499;5062
521740;201808;3652;10102;2876;8913;880;2987;1005;3242;1885;6229
521760;201808;13608;40642;11242;36846;3513;12530;3781;12874;7294;25404
521770;201808;2787;7253;1986;5849;641;2011;456;1320;1097;3331
521800;201808;5585;16207;4562;14485;1315;4315;1618;5542;2933;9857
521805;201808;565;1332;400;1104;139;361;162;476;301;837
521810;201808;702;1662;477;1321;80;230;233;662;313;892
521830;201808;5068;14794;4205;13509;428;1597;2852;9022;3280;10619
521839;201808;624;1671;460;1357;97;294;183;518;280;812
521850;201808;4951;12813;3483;10396;920;3014;467;1314;1387;4328
521860;201808;1729;4539;1202;3651;203;671;410;1222;613;1893
521870;201808;651;1904;463;1551;113;399;137;431;250;830
521878;201808;634;1746;457;1401;82;290;197;549;279;839
521880;201808;17471;43331;11897;34798;3312;10107;3769;11517;7081;21624
521890;201808;2986;8363;2047;6447;538;1818;275;812;813;2630
521900;201808;1591;3855;966;2903;256;742;233;742;489;1484
521910;201808;1194;2727;798;2250;82;246;488;1426;570;1672
521920;201808;410;1215;311;1010;62;218;103;355;165;573
521925;201808;678;1930;505;1623;117;373;172;531;289;904
521930;201808;4226;11149;3107;9462;944;2820;1059;3513;2003;6333
521935;201808;786;2033;582;1666;86;252;318;867;404;1119
521940;201808;1226;2893;837;2364;209;673;342;926;551;1599
521945;201808;523;1534;428;1354;82;263;208;695;290;958
521950;201808;592;1465;474;1322;35;105;376;1041;411;1146
521960;201808;688;1902;451;1412;69;234;215;647;284;881
521970;201808;2527;6607;2135;6137;116;308;1750;5160;1866;5468
521971;201808;738;1893;515;1537;140;441;129;385;269;826
521973;201808;1045;2890;861;2625;81;305;572;1694;653;1999
521975;201808;11878;32076;10092;29681;1693;5159;6347;18740;8040;23899
521980;201808;2496;6201;1980;5517;204;517;1462;4140;1666;4657
521990;201808;1118;3169;922;2850;122;385;502;1580;624;1965
522000;201808;3545;11750;2985;11020;255;809;2205;8702;2460;9511
522005;201808;330;837;248;720;59;154;108;329;167;483
522010;201808;3685;9425;2721;7876;812;2476;706;1992;1518;4468
522015;201808;931;2541;681;2136;144;480;266;829;410;1309
522020;201808;5025;12438;3427;9838;824;2441;1482;4363;2306;6804
522026;201808;650;1852;502;1605;83;276;226;740;309;1016
522028;201808;499;1355;358;1053;80;234;142;396;222;630
522040;201808;2835;6458;2002;5374;273;789;1337;3564;1610;4353
522045;201808;15725;46819;11966;39483;3104;10942;2804;9040;5908;19982
522050;201808;1034;2819;709;2235;157;529;255;765;412;1294
522060;201808;2409;6800;1953;6102;275;892;1130;3652;1405;4544
522068;201808;1677;4740;1388;4382;163;484;995;3237;1158;3721
522070;201808;564;1550;478;1416;46;181;352;987;398;1168
522100;201808;555;1499;403;1266;60;203;220;695;280;898
522108;201808;868;2449;681;2148;44;191;539;1644;583;1835
522119;201808;1525;4023;1185;3563;200;626;629;1955;829;2581
522130;201808;378;961;274;819;57;179;145;446;202;625
522140;201808;15554;42670;11444;35360;3572;11728;2086;6374;5658;18102
522145;201808;830;2107;609;1779;142;373;311;994;453;1367
522150;201808;905;2242;682;1916;212;567;242;726;454;1293
522155;201808;879;2362;688;2036;142;405;320;965;462;1370
522157;201808;528;1416;462;1318;26;103;353;977;379;1080
522160;201808;5718;15339;3843;11838;1131;3760;339;1172;1470;4932
522170;201808;2443;6595;1776;5473;490;1561;689;2144;1179;3705
522180;201808;436;1122;280;845;61;191;36;123;97;314
522185;201808;15570;40474;11866;35584;4987;15913;2998;9955;7985;25868
522190;201808;715;1743;535;1474;91;238;225;651;316;889
522200;201808;1680;5049;1101;3768;223;815;118;392;341;1207
522205;201808;1532;3748;1181;3245;110;332;834;2288;944;2620
522220;201808;1286;3389;995;2959;151;421;553;1682;704;2103
522230;201808;1159;3138;975;2865;174;562;570;1674;744;2236
530010;201808;154926;455132;133781;420254;28143;97744;69879;215329;98022;313073
110001;201809;3506;10453;2580;8710;697;2506;1019;3428;1716;5934
110002;201809;10720;29212;7848;24303;2430;7998;2611;8157;5041;16155
110003;201809;634;1902;461;1535;144;520;93;296;237;816
110004;201809;8756;25198;6279;20402;1764;6018;1583;5468;3347;11486
110005;201809;2312;6301;1444;4633;373;1266;435;1494;808;2760
110006;201809;1689;4818;1059;3497;257;931;159;527;416;1458
110007;201809;1053;3061;808;2637;303;998;261;957;564;1955
110008;201809;2502;7936;2182;7448;290;948;1596;5668;1886;6616
110009;201809;3838;11176;2573;8896;772;2736;881;3180;1653;5916
110010;201809;5945;20451;4863;18483;1266;4636;2283;9682;3549;14318
110011;201809;5981;17070;4467;14240;1630;5316;877;2918;2507;8234
110012;201809;12944;34472;8585;26681;2394;7731;1239;4082;3633;11813
110013;201809;5021;15352;4023;13377;1754;5962;659;2461;2413;8423
110014;201809;3562;9782;2546;7918;737;2333;1012;3133;1749;5466
110015;201809;4812;13369;2804;9252;790;2813;444;1402;1234;4215
110018;201809;3227;8602;2021;6501;514;1855;535;1654;1049;3509
110020;201809;67706;171760;47477;143246;10814;34023;19255;62215;30069;96238
110025;201809;4586;11798;3100;9170;671;2097;1491;4290;2162;6387
110026;201809;442;1322;366;1196;118;418;139;432;257;850
110028;201809;5678;15763;3816;12163;1145;3869;583;1843;1728;5712
110029;201809;1300;3234;776;2378;185;582;335;1036;520;1618
110030;201809;11518;28644;7858;23282;1573;5301;2824;8601;4397;13902
110032;201809;2880;8666;2052;6886;714;2402;527;1815;1241;4217
110033;201809;3792;12369;3083;11001;1145;4141;821;3258;1966;7399
110034;201809;3282;8315;2303;6912;708;2254;992;3055;1700;5309
110037;201809;1534;4991;1240;4403;312;1133;596;2108;908;3241
110040;201809;2816;8334;2112;7012;674;2381;558;1796;1232;4177
110045;201809;4714;14331;3800;12717;1113;4040;1478;4974;2591;9014
110050;201809;1613;4861;1226;4081;526;1812;278;940;804;2752
110060;201809;773;2411;549;1935;212;800;66;247;278;1047
110070;201809;1791;5800;1423;4949;508;1854;325;1051;833;2905
110080;201809;5481;13556;4115;11902;642;1781;2702;8247;3344;10028
110090;201809;582;1626;408;1303;121;402;160;506;281;908
110092;201809;1052;3268;838;2880;150;537;454;1620;604;2157
110094;201809;2805;8515;2200;7448;816;2862;599;2149;1415;5011
110100;201809;1705;5325;1443;4764;343;1205;715;2353;1058;3558
110110;201809;1605;4699;1155;3904;406;1409;254;931;660;2340
110120;201809;1260;3885;964;3262;270;951;280;945;550;1896
110130;201809;2528;6696;1592;4932;369;1270;544;1648;913;2918
110140;201809;2025;6486;1506;5399;432;1632;389;1431;821;3063
110143;201809;1282;3583;906;2840;318;1006;232;758;550;1764
110145;201809;928;2587;592;1930;153;527;189;626;342;1153
110146;201809;435;1209;306;1000;58;181;156;545;214;726
110147;201809;694;1872;446;1367;82;245;177;493;259;738
110148;201809;823;2461;496;1717;123;471;57;208;180;679
110149;201809;2760;8114;2045;6953;830;2778;531;1974;1361;4752
110150;201809;2205;5989;1555;5026;590;2070;466;1505;1056;3575
110155;201809;637;1991;504;1683;130;460;177;564;307;1024
110160;201809;1492;4762;1124;3930;391;1351;274;1023;665;2374
110170;201809;2142;5800;1385;4312;265;887;717;2155;982;3042
110175;201809;1364;4074;1051;3575;195;692;523;1863;718;2555
110180;201809;1200;3465;868;2779;222;709;374;1225;596;1934
120001;201809;3533;12255;3123;11655;461;1543;2188;8662;2649;10205
120005;201809;1822;7118;1639;6810;166;749;1271;5393;1437;6142
120010;201809;5168;16343;4434;15124;650;2139;2978;10489;3628;12628
120013;201809;2093;7978;1971;7804;543;2064;1124;4773;1667;6837
120017;201809;2065;7115;1876;6806;352;1320;1124;4288;1476;5608
120020;201809;13917;58726;13156;57172;1390;6490;9987;44219;11377;50709
120025;201809;2687;8337;2273;7806;462;1612;1464;5176;1926;6788
120030;201809;6395;25678;6152;25256;428;2209;5050;20751;5478;22960
120032;201809;1608;7487;1535;7306;102;627;1237;5839;1339;6466
120033;201809;3874;14861;3642;14447;140;765;3148;12423;3288;13188
120034;201809;2470;9365;2157;8766;135;777;1727;6903;1862;7680
120035;201809;3361;14389;3220;14118;298;1494;2581;11405;2879;12899
120038;201809;2544;8673;2283;8216;569;2156;1207;4414;1776;6570
120039;201809;1914;8660;1825;8483;168;1005;1396;6489;1564;7494
120040;201809;39618;133904;35402;126649;6418;24214;21234;77226;27652;101440
120042;201809;3205;12503;2971;11999;176;943;2349;9435;2525;10378
120043;201809;1248;5456;1181;5310;69;403;1019;4574;1088;4977
120045;201809;5498;15807;4949;15191;159;646;4522;13758;4681;14404
120050;201809;8545;32431;7988;31522;627;2993;6370;25331;6997;28324
120060;201809;8505;35295;8105;34632;450;2449;7021;30046;7471;32495
120070;201809;2839;9712;2586;9327;297;1121;1841;6859;2138;7980
120080;201809;4116;14306;3724;13644;585;2304;2526;9342;3111;11646
130002;201809;3081;12619;2837;12288;114;616;2532;11001;2646;11617
130006;201809;2240;8888;1903;8259;155;772;1446;6272;1601;7044
130008;201809;2470;8960;2228;8568;81;426;1862;7154;1943;7580
130010;201809;3849;11238;3340;10659;68;236;3122;10033;3190;10269
130014;201809;2866;9047;2350;8152;426;1492;1504;5333;1930;6825
130020;201809;2632;10544;2418;10186;153;905;1941;8135;2094;9040
130030;201809;9324;31700;8567;30864;165;624;8042;29309;8207;29933
130040;201809;3665;11239;3139;10525;175;630;2549;8628;2724;9258
130050;201809;7300;27228;6180;25788;253;1175;5521;23264;5774;24439
130060;201809;7048;29346;6158;28126;559;3260;4844;21997;5403;25257
130063;201809;5707;19896;5163;19258;129;572;4803;18020;4932;18592
130068;201809;3271;12962;2891;12224;220;1211;2207;9220;2427;10431
130070;201809;8191;25665;7088;24431;301;982;6196;21782;6497;22764
130080;201809;6366;25338;5764;24543;370;2153;4722;20159;5092;22312
130083;201809;2493;8939;2279;8661;195;912;1853;6959;2048;7871
130090;201809;3298;10654;3006;10259;66;281;2633;9203;2699;9484
130100;201809;7180;22923;6343;22023;97;277;5983;21198;6080;21475
130110;201809;7809;23054;6645;21621;657;1849;5448;18355;6105;20204
130115;201809;5273;17109;4669;16371;110;468;4117;14602;4227;15070
130120;201809;14356;53007;13191;51478;1216;5027;10887;43062;12103;48089
130130;201809;4986;16941;4013;15659;472;2080;3018;11732;3490;13812
130140;201809;6555;24704;6250;24351;262;1295;5604;21849;5866;23144
130150;201809;3563;13794;3402;13587;112;676;3096;12334;3208;13010
130160;201809;4822;18292;4273;17560;332;1602;3524;14687;3856;16289
130165;201809;2961;11883;2848;11690;110;613;2540;10390;2650;11003
130170;201809;11335;34741;9401;32380;678;2687;7816;27090;8494;29777
130180;201809;4361;14087;4124;13807;48;246;3970;13243;4018;13489
130185;201809;17069;43701;14024;40444;599;1167;12512;37343;13111;38510
130190;201809;17834;60441;15034;56306;1861;7060;10764;41622;12625;48682
130195;201809;2255;8678;1887;8186;80;424;1683;7324;1763;7748
130200;201809;2312;7062;1956;6565;133;516;1572;5313;1705;5829
130210;201809;1340;5133;1205;4972;114;679;952;3825;1066;4504
130220;201809;2018;7761;1856;7490;104;547;1533;6184;1637;6731
130230;201809;4134;18153;3746;17579;342;1944;3073;14468;3415;16412
130240;201809;10618;34562;8920;32185;254;1471;7792;28020;8046;29491
130250;201809;25048;77430;22158;74145;1549;4990;18357;63592;19906;68582
130255;201809;4158;14596;3742;13840;214;974;2992;11065;3206;12039
130260;201809;237415;712006;201346;656681;58931;204588;89727;297737;148658;502325
130270;201809;8460;32119;7298;30245;1013;4402;5132;21925;6145;26327
130280;201809;3457;14166;3250;13938;120;562;3008;13074;3128;13636
130290;201809;12615;43457;11277;41867;456;1704;10139;38273;10595;39977
130300;201809;4515;16658;4214;16194;208;1060;3617;13809;3825;14869
130310;201809;5508;20154;4991;19415;401;1651;4068;16085;4469;17736
130320;201809;3298;11125;2881;10588;268;961;2250;8489;2518;9450
130330;201809;4301;14329;3675;13543;182;823;3172;11698;3354;12521
130340;201809;20734;71310;18400;68572;1498;5363;15472;59252;16970;64615
130350;201809;3783;14286;3487;13900;160;927;3040;11988;3200;12915
130353;201809;6111;18285;5184;17082;848;2737;3571;12222;4419;14959
130356;201809;4789;16512;4199;15529;570;2185;2888;10941;3458;13126
130360;201809;3177;9522;2727;9021;69;206;2559;8551;2628;8757
130370;201809;5712;22210;5123;21426;193;1157;4508;18738;4701;19895
130380;201809;7390;31078;7001;30485;478;2687;5923;25484;6401;28171
130390;201809;5712;24474;5059;23309;581;3179;3648;16715;4229;19894
130395;201809;2323;7673;2031;7154;250;952;1449;5084;1699;6036
130400;201809;2612;8616;2277;8148;120;419;1999;7235;2119;7654
130406;201809;10731;40022;9485;38319;1718;7161;6553;27068;8271;34229
130410;201809;4010;14721;3506;13859;1047;4297;1733;7101;2780;11398
130420;201809;12348;46651;10880;44800;1086;5343;8665;35699;9751;41042
130423;201809;3912;13172;3515;12687;169;857;3112;11054;3281;11911
130426;201809;2805;11086;2691;10913;78;384;2510;10238;2588;10622
130430;201809;3921;12201;3532;11650;380;1328;2794;9190;3174;10518
130440;201809;4524;14589;4006;13971;87;354;3734;13104;3821;13458
140002;201809;2012;6068;1775;5745;116;473;1440;4560;1556;5033
140005;201809;3266;9035;3038;8777;157;458;2745;7934;2902;8392
140010;201809;51458;140187;40308;123714;10718;34599;15670;50657;26388;85256
140015;201809;3286;11560;2945;11141;240;837;2473;9660;2713;10497
140017;201809;3591;10988;3185;10446;353;1098;2325;7986;2678;9084
140020;201809;4986;15318;4279;14361;354;1493;3292;11024;3646;12517
140023;201809;2210;6941;1824;6376;235;910;1293;4564;1528;5474
140028;201809;2080;5438;1776;5041;154;500;1362;3769;1516;4269
140030;201809;4314;12215;3868;11657;336;902;3178;9832;3514;10734
140040;201809;2075;8877;1913;8637;127;753;1644;7323;1771;8076
140045;201809;2531;9578;2156;9034;416;1714;1399;6194;1815;7908
140047;201809;5851;17527;5018;16257;857;2927;3242;10663;4099;13590
140050;201809;1368;4135;1171;3840;130;447;830;2753;960;3200
140060;201809;1432;4082;1256;3812;99;304;1027;3132;1126;3436
140070;201809;1772;9600;1706;9414;156;1057;1340;7326;1496;8383
150010;201809;41822;109177;38599;104849;1199;3705;34263;92262;35462;95967
150013;201809;1864;5064;1555;4716;139;374;1192;3806;1331;4180
150020;201809;13550;42477;12827;41523;1151;2853;10867;36415;12018;39268
150030;201809;8732;33502;8010;32595;389;1768;7083;29026;7472;30794
150034;201809;4132;10931;3526;10123;247;729;2902;8408;3149;9137
150040;201809;14305;39850;12498;37787;1133;2304;10444;33665;11577;35969
150050;201809;6599;23953;6115;23240;155;751;5601;21391;5756;22142
150060;201809;19584;56239;16553;51733;3179;9846;10034;32441;13213;42287
150070;201809;6352;24908;5731;24153;178;953;5237;22327;5415;23280
150080;201809;78454;195598;65786;178546;15908;44103;27346;82892;43254;126995
150085;201809;6365;20071;5858;19441;202;633;5404;18117;5606;18750
150090;201809;9835;37333;9312;36389;694;3013;7557;29617;8251;32630
150095;201809;5434;16863;4895;16121;290;823;4067;13829;4357;14652
150100;201809;2992;10675;2671;10104;201;804;2074;7911;2275;8715
150110;201809;3937;17607;3832;17472;228;1112;3444;15805;3672;16917
150120;201809;7195;24249;6989;23950;307;861;6258;21996;6565;22857
150125;201809;718;2042;564;1836;118;431;332;1070;450;1501
150130;201809;22508;66687;19820;62708;2605;7400;14362;47141;16967;54541
150140;201809;201608;507393;175373;470919;28482;75174;107702;300391;136184;375565
150145;201809;4501;13657;3895;12818;752;2208;2669;9337;3421;11545
150150;201809;14332;38849;12837;36953;978;2961;10250;29749;11228;32710
150157;201809;3212;9226;2708;8558;289;1012;1929;6247;2218;7259
150160;201809;2867;8999;2699;8713;669;2158;1542;5134;2211;7292
150170;201809;24063;80199;20984;75194;3899;13281;12885;49223;16784;62504
150172;201809;4112;12133;3408;11112;289;861;2532;8565;2821;9426
150175;201809;1689;5255;1476;4888;195;718;1014;3403;1209;4121
150178;201809;9890;28493;8335;26647;396;1275;7059;22957;7455;24232
150180;201809;20367;76995;19017;75264;1049;4338;16624;66717;17673;71055
150190;201809;6884;23504;6507;23020;280;1200;5752;20297;6032;21497
150195;201809;5347;17228;5098;16845;95;396;4744;15631;4839;16027
150200;201809;5257;16181;4837;15718;56;172;4606;15086;4662;15258
150210;201809;24545;89496;23224;87709;1876;7102;19013;73802;20889;80904
150215;201809;6792;20668;5928;19387;1642;5254;2922;10170;4564;15424
150220;201809;11147;33544;9938;31713;1605;5016;6134;20186;7739;25202
150230;201809;12254;35847;10647;33673;1347;4036;7385;24382;8732;28418
150240;201809;31144;89699;25802;80211;8535;26944;7583;24277;16118;51221
150250;201809;4062;16588;3876;16326;563;2375;2968;12767;3531;15142
150260;201809;2434;8546;2263;8264;221;792;1715;6368;1936;7160
150270;201809;8044;23558;5918;20354;1985;7092;2100;7623;4085;14715
150275;201809;6388;21440;5950;20772;345;1361;5003;17417;5348;18778
150276;201809;2185;6197;1886;5832;244;693;1380;4527;1624;5220
150277;201809;4878;13493;4095;12560;421;1256;3194;10214;3615;11470
150280;201809;6226;26501;6079;26219;528;2270;5028;21956;5556;24226
150285;201809;3145;11399;2823;10918;342;1450;1986;7792;2328;9242
150290;201809;10729;29217;9932;28340;413;939;8941;26141;9354;27080
150293;201809;9638;24303;7055;20844;1523;4513;3480;11168;5003;15681
150295;201809;7510;20937;5725;18696;2002;7017;2191;7809;4193;14826
150300;201809;2111;6737;1916;6467;58;296;1674;5599;1732;5895
150304;201809;3854;12173;3322;11275;579;1896;2156;7540;2735;9436
150307;201809;6234;20362;5836;19747;431;1402;4803;16507;5234;17909
150309;201809;5982;19107;5004;17424;1128;3775;2621;9694;3749;13469
150310;201809;7065;28184;6722;27744;258;1413;5929;24619;6187;26032
150320;201809;9297;25296;8499;24232;464;1428;6814;19402;7278;20830
150330;201809;13792;45646;12848;44088;1647;5568;9512;33545;11159;39113
150340;201809;2626;7825;2366;7441;326;1001;1687;5379;2013;6380
150345;201809;7637;23101;6934;22185;448;1517;5870;18938;6318;20455
150350;201809;8682;23874;8018;23028;857;1794;6535;19545;7392;21339
150360;201809;22905;66105;18762;60805;2277;6795;13036;44181;15313;50976
150370;201809;9330;31710;8225;30184;896;3189;6152;23501;7048;26690
150375;201809;3183;13451;2892;13005;302;1461;2301;10461;2603;11922
150380;201809;10021;27384;8504;25319;306;988;7354;22009;7660;22997
150390;201809;7501;31643;6910;30644;1156;4879;4771;22188;5927;27067
150400;201809;6149;22880;5920;22432;301;1223;5061;19257;5362;20480
150405;201809;9039;24632;8082;23442;538;1228;6522;19614;7060;20842
150410;201809;1816;6100;1584;5682;218;756;1029;3798;1247;4554
150420;201809;33297;101632;25882;90066;8913;32118;7721;31143;16634;63261
150430;201809;8031;24726;7549;24043;795;2095;5995;19813;6790;21908
150440;201809;5487;18209;5180;17751;432;1395;4208;14625;4640;16020
150442;201809;23439;61283;19887;56368;2493;6864;13219;38656;15712;45520
150445;201809;5832;18861;5282;18004;269;958;4478;15364;4747;16322
150450;201809;4820;21518;4553;21129;389;1875;3815;17909;4204;19784
150460;201809;7991;27034;7464;26324;248;1051;6523;23673;6771;24724
150470;201809;18083;52221;17089;51042;917;2530;15212;45928;16129;48458
150475;201809;4241;14289;3835;13655;186;734;3229;11640;3415;12374
150480;201809;13573;45719;12223;43603;1986;6678;8580;32093;10566;38771
150490;201809;7898;28380;7448;27806;255;1216;6621;24787;6876;26003
150495;201809;5049;18088;4911;17903;106;485;4569;16668;4675;17153
150497;201809;2697;9045;2200;8121;589;2262;1060;4129;1649;6391
150500;201809;3254;8594;2909;8065;323;824;2246;6271;2569;7095
150503;201809;4283;12138;3166;10552;1023;3540;1108;4053;2131;7593
150506;201809;9568;31459;8544;30000;1796;5687;5612;21206;7408;26893
150510;201809;9762;36589;8574;34240;1262;4940;5692;23810;6954;28750
150520;201809;7242;27513;6950;27147;198;1038;6394;24988;6592;26026
150530;201809;12202;42104;10758;39866;1521;4714;7847;30662;9368;35376
150540;201809;4830;13761;4163;12761;169;528;3549;10859;3718;11387
150543;201809;6733;18841;5546;17277;864;2724;3806;12431;4670;15155
150548;201809;9715;30961;8847;29769;339;1142;7879;26650;8218;27792
150549;201809;1981;6147;1747;5858;49;203;1556;5209;1605;5412
150550;201809;18591;57502;15955;53064;4240;14247;7223;25339;11463;39586
150553;201809;22108;70396;17725;62115;6194;22249;5214;20146;11408;42395
150555;201809;1775;4984;1434;4434;132;382;998;3121;1130;3503
150560;201809;1793;5688;1599;5290;304;951;896;3067;1200;4018
150563;201809;2379;7660;2103;7161;478;1752;1145;3875;1623;5627
150565;201809;4166;13759;3706;12994;109;545;3103;10893;3212;11438
150570;201809;6079;20731;5835;20339;318;1272;4929;17132;5247;18404
150580;201809;10080;41607;9179;40595;649;3252;7651;34496;8300;37748
150590;201809;7053;26215;6498;25479;225;1201;5876;22952;6101;24153
150600;201809;8746;30854;8202;30150;261;1175;7474;27540;7735;28715
150610;201809;2542;8081;2291;7604;147;549;1837;6018;1984;6567
150611;201809;2797;8654;2584;8320;119;480;2229;7094;2348;7574
150613;201809;12772;36223;9764;31048;1987;6654;4639;15043;6626;21697
150616;201809;3153;8978;2356;7635;604;2081;872;2740;1476;4821
150618;201809;6540;20279;5459;18462;794;2654;3384;11969;4178;14623
150619;201809;5770;17459;4879;16094;293;1106;3844;12662;4137;13768
150620;201809;6298;21518;5560;20460;833;3027;3945;14889;4778;17916
150630;201809;6112;17069;5654;16508;353;1024;4839;14282;5192;15306
150635;201809;4280;12627;3731;11690;681;2172;2185;6967;2866;9139
150640;201809;2142;6273;1975;6080;33;107;1848;5760;1881;5867
150650;201809;11312;32813;10061;30641;3115;9026;4477;14686;7592;23712
150655;201809;5577;16583;5120;15870;240;747;4370;13567;4610;14314
150658;201809;4256;12456;3524;11373;669;2263;2131;7163;2800;9426
150660;201809;5623;16582;5105;15851;565;1730;3580;11287;4145;13017
150670;201809;7857;19326;6244;17437;628;1473;4943;14397;5571;15870
150680;201809;63662;198027;49472;175081;12909;45329;21959;86928;34868;132257
150690;201809;2359;6312;2093;5950;131;342;1771;5089;1902;5431
150700;201809;6150;18735;5594;18036;453;1373;4444;14667;4897;16040
150710;201809;3753;12743;3452;12260;249;968;2684;9583;2933;10551
150715;201809;5002;15426;4315;14316;351;1133;3465;11672;3816;12805
150720;201809;6350;24362;6034;23795;464;2116;4951;19553;5415;21669
150730;201809;11044;35444;9761;33424;1104;4014;7377;25687;8481;29701
150740;201809;3568;10636;3187;9968;406;1189;2224;7100;2630;8289
150745;201809;4912;14683;4144;13572;834;2892;2704;8922;3538;11814
150746;201809;1520;4907;1414;4722;85;275;1161;3913;1246;4188
150747;201809;4939;15988;4400;15141;822;2546;2829;10334;3651;12880
150750;201809;3554;11346;3065;10605;223;846;2375;8394;2598;9240
150760;201809;11607;34929;10664;33721;1341;4026;7967;25788;9308;29814
150770;201809;6066;22506;5806;22147;166;520;5408;21116;5574;21636
150775;201809;879;2626;721;2372;129;489;409;1334;538;1823
150780;201809;4316;13279;4017;12911;94;324;3742;12141;3836;12465
150790;201809;5361;16167;4733;15470;225;623;3917;13878;4142;14501
150795;201809;13572;44121;12314;42010;3196;10382;6962;25209;10158;35591
150796;201809;3418;9168;2996;8658;199;573;2505;7339;2704;7912
150797;201809;3883;12445;3372;11632;156;520;2814;9796;2970;10316
150800;201809;12816;41475;11864;40298;1669;5184;8933;31600;10602;36784
150803;201809;6534;22668;6165;22065;440;1658;5207;18699;5647;20357
150805;201809;3111;10280;2716;9642;291;1048;2069;7405;2360;8453
150808;201809;5628;17069;4250;14619;1669;6222;572;2184;2241;8406
150810;201809;19749;55782;15411;50314;2762;8895;8916;31509;11678;40404
150812;201809;5203;15276;4664;14313;479;1618;3451;10346;3930;11964
150815;201809;8711;27588;7588;26146;744;2580;5961;20885;6705;23465
150820;201809;11606;32290;9946;30306;920;2472;7879;24793;8799;27265
150830;201809;11429;43499;10886;42841;410;2154;9501;38052;9911;40206
150835;201809;2066;7263;1894;6936;402;1469;988;3687;1390;5156
150840;201809;7224;21559;5819;19035;1239;4267;2964;9686;4203;13953
160005;201809;1174;3269;1069;3114;22;106;1010;2895;1032;3001
160010;201809;2282;6020;2228;5964;10;36;2189;5838;2199;5874
160015;201809;2248;7368;2063;7116;97;350;1864;6463;1961;6813
160020;201809;1947;6739;1756;6462;229;856;1331;4966;1560;5822
160021;201809;1091;4370;1016;4256;86;479;815;3356;901;3835
160023;201809;1218;4475;1093;4277;109;395;791;3267;900;3662
160025;201809;1855;5221;1808;5164;10;31;1782;5096;1792;5127
160027;201809;8598;24159;7849;23281;605;1704;6514;19742;7119;21446
160030;201809;55687;171193;46542;158972;10853;35019;25167;94859;36020;129878
160040;201809;5135;18390;4676;17762;103;567;4296;16320;4399;16887
160050;201809;4067;13549;3405;12564;1443;5029;1209;5379;2652;10408
160053;201809;3418;11638;3210;11370;351;1153;2549;9292;2900;10445
160055;201809;692;2417;682;2405;30;118;630;2227;660;2345
160060;201809;22116;62582;18628;58579;1195;3679;15088;49184;16283;52863
160070;201809;2923;11158;2668;10734;196;862;2132;8753;2328;9615
160080;201809;2870;10018;2693;9805;69;309;2456;8998;2525;9307
170025;201809;593;1650;447;1445;104;328;220;731;324;1059
170030;201809;1160;3685;924;3204;168;587;437;1546;605;2133
170035;201809;1435;3786;1047;3140;116;382;595;1790;711;2172
170040;201809;1768;5321;1459;4891;129;476;831;2924;960;3400
170070;201809;1547;3830;1114;3267;124;395;658;1992;782;2387
170100;201809;2402;7024;2015;6371;222;676;1339;4296;1561;4972
170105;201809;722;2194;514;1736;132;400;174;602;306;1002
170110;201809;856;2747;678;2395;116;425;324;1157;440;1582
170130;201809;1310;4036;956;3339;176;637;489;1761;665;2398
170190;201809;1371;4018;962;3339;358;1190;193;893;551;2083
170200;201809;1696;4320;1031;3142;260;849;253;769;513;1618
170210;201809;24170;67775;18528;58294;6768;23006;2203;8028;8971;31034
170215;201809;1295;3643;1093;3356;76;303;801;2426;877;2729
170220;201809;5737;18207;4938;16678;1174;3774;2529;9146;3703;12920
170230;201809;1206;3745;941;3206;247;882;227;782;474;1664
170240;201809;2578;7431;2058;6577;191;746;1395;4340;1586;5086
170255;201809;3890;11669;2710;9367;533;1922;1252;4448;1785;6370
170270;201809;1030;2497;663;1985;34;102;424;1251;458;1353
170290;201809;2929;8494;2525;8026;135;362;2074;6869;2209;7231
170300;201809;1840;5340;1553;4879;186;606;1001;3214;1187;3820
170305;201809;720;2117;566;1809;82;309;279;865;361;1174
170307;201809;936;3320;762;2960;127;516;405;1600;532;2116
170310;201809;1618;4230;1116;3367;203;678;516;1567;719;2245
170320;201809;934;2557;712;2203;86;265;429;1347;515;1612
170330;201809;839;2663;763;2542;52;216;605;1968;657;2184
170360;201809;451;1303;335;1100;54;194;202;623;256;817
170370;201809;1279;3503;947;2949;197;623;422;1356;619;1979
170380;201809;1799;5440;1367;4733;136;532;782;2775;918;3307
170382;201809;534;1665;442;1500;61;235;288;961;349;1196
170384;201809;1440;5562;1230;5130;339;1499;521;2166;860;3665
170386;201809;779;2232;501;1673;71;295;139;424;210;719
170388;201809;625;1822;445;1480;63;240;205;679;268;919
170389;201809;1111;3801;967;3546;50;217;774;2878;824;3095
170390;201809;1604;3852;1185;3344;79;221;922;2674;1001;2895
170410;201809;540;1625;396;1365;23;105;251;834;274;939
170460;201809;360;1004;289;882;38;118;185;575;223;693
170510;201809;851;2657;640;2231;59;272;376;1240;435;1512
170550;201809;6292;17311;4460;14168;1388;4684;830;2851;2218;7535
170555;201809;1316;3719;1049;3289;73;253;570;1843;643;2096
170560;201809;1032;3024;785;2667;92;349;440;1644;532;1993
170600;201809;1335;3759;1089;3384;234;637;624;2084;858;2721
170610;201809;1669;4697;1246;3990;89;333;799;2497;888;2830
170625;201809;431;1201;271;855;35;103;84;253;119;356
170650;201809;1235;3807;962;3316;194;682;429;1572;623;2254
170700;201809;3371;10140;2613;8760;591;2101;1080;3732;1671;5833
170710;201809;1479;4159;1163;3590;209;722;644;1948;853;2670
170720;201809;1886;4875;1523;4338;69;136;1285;3776;1354;3912
170730;201809;997;2861;756;2461;176;578;337;1138;513;1716
170740;201809;1973;6942;1696;6388;221;868;1120;4247;1341;5115
170755;201809;874;2540;616;2035;69;257;309;1011;378;1268
170765;201809;1224;3252;843;2656;216;704;333;1118;549;1822
170770;201809;1730;5403;1490;4998;190;626;985;3377;1175;4003
170820;201809;3767;13036;3260;12056;483;1754;1910;7438;2393;9192
170825;201809;946;2256;754;1995;81;216;515;1366;596;1582
170830;201809;1364;3791;1133;3416;28;97;938;2831;966;2928
170900;201809;2587;8653;2246;8114;189;757;1769;6456;1958;7213
170930;201809;3585;10226;2845;8884;665;2238;1176;3682;1841;5920
170950;201809;10756;30738;7589;24965;2307;8624;1143;3927;3450;12551
170980;201809;430;1234;346;1094;29;134;229;677;258;811
171050;201809;1520;5000;1360;4705;67;332;1079;3662;1146;3994
171070;201809;1319;3959;1141;3690;216;650;688;2413;904;3063
171090;201809;1030;2600;855;2356;57;159;628;1720;685;1879
171110;201809;565;1595;405;1302;79;279;174;506;253;785
171150;201809;1047;2705;639;1973;74;267;404;1233;478;1500
171180;201809;729;2105;489;1610;87;299;196;670;283;969
171190;201809;1560;5613;1386;5284;236;916;847;3309;1083;4225
171195;201809;804;2724;684;2495;137;524;388;1439;525;1963
171200;201809;524;1539;398;1311;80;281;180;590;260;871
171215;201809;386;1117;298;958;58;205;162;502;220;707
171240;201809;736;2551;614;2303;48;244;389;1454;437;1698
171245;201809;616;1933;476;1627;69;265;242;796;311;1061
171250;201809;1045;2843;780;2415;206;679;358;1109;564;1788
171270;201809;363;1429;308;1293;80;328;140;651;220;979
171280;201809;819;2558;640;2238;133;447;302;1157;435;1604
171320;201809;3881;11126;3044;9631;565;1770;1388;4629;1953;6399
171330;201809;2620;7350;2034;6329;453;1398;988;3181;1441;4579
171360;201809;1376;4256;1177;3972;74;291;921;3127;995;3418
171370;201809;681;1798;534;1594;56;178;371;1122;427;1300
171380;201809;1394;4034;1145;3631;135;444;755;2424;890;2868
171395;201809;904;2683;631;2123;75;285;335;1100;410;1385
171420;201809;1824;5665;1356;4691;226;890;612;2113;838;3003
171430;201809;998;2998;812;2621;88;327;555;1737;643;2064
171488;201809;2346;7059;1860;6265;304;1085;979;3391;1283;4476
171500;201809;934;2491;715;2146;56;177;533;1608;589;1785
171510;201809;759;2640;688;2502;44;203;487;1764;531;1967
171515;201809;459;1279;342;1076;32;126;210;637;242;763
171525;201809;632;1933;523;1745;39;180;313;970;352;1150
171550;201809;333;1000;238;833;44;165;120;412;164;577
171570;201809;1111;3476;943;3158;159;495;555;1938;714;2433
171575;201809;1823;4943;1156;3695;191;660;482;1519;673;2179
171610;201809;5412;15639;4073;13351;1005;3593;1160;4070;2165;7663
171620;201809;2695;7657;2293;7100;165;623;1811;5603;1976;6226
171630;201809;950;2646;778;2401;136;439;490;1551;626;1990
171650;201809;2025;6019;1495;5012;379;1332;499;1789;878;3121
171660;201809;2326;6149;1628;4905;274;812;862;2620;1136;3432
171665;201809;1309;3750;1007;3265;185;660;477;1587;662;2247
171670;201809;1755;4850;1364;4205;203;709;760;2300;963;3009
171700;201809;1150;3404;862;2884;124;418;481;1616;605;2034
171720;201809;805;2184;623;1882;43;163;460;1369;503;1532
171750;201809;1200;3494;856;2851;228;781;144;573;372;1354
171780;201809;1219;3209;894;2744;72;272;621;1857;693;2129
171790;201809;1389;4817;1117;4193;271;1012;497;1964;768;2976
171800;201809;710;2056;544;1798;79;294;299;987;378;1281
171820;201809;10414;30288;7889;25786;1961;6684;2711;9441;4672;16125
171830;201809;1429;4974;1220;4536;156;669;758;2793;914;3462
171840;201809;734;1932;580;1698;39;130;419;1206;458;1336
171845;201809;643;1669;481;1435;70;253;267;802;337;1055
171850;201809;845;2970;727;2723;76;346;500;1831;576;2177
171855;201809;1066;3295;924;3040;81;279;598;1936;679;2215
171865;201809;366;1212;316;1127;64;247;158;536;222;783
171870;201809;746;2173;542;1781;71;246;286;993;357;1239
171875;201809;1199;3713;974;3334;63;266;718;2418;781;2684
171880;201809;1045;3385;942;3254;44;166;760;2694;804;2860
171884;201809;834;2257;605;1900;119;430;220;757;339;1187
171886;201809;1392;4027;980;3289;299;1075;187;657;486;1732
171888;201809;752;2163;518;1706;50;165;317;1056;367;1221
171889;201809;433;1365;372;1249;72;265;175;584;247;849
171890;201809;1095;3136;838;2700;181;533;473;1587;654;2120
171900;201809;503;1794;374;1478;101;397;134;569;235;966
172000;201809;558;1736;467;1566;70;276;257;822;327;1098
172010;201809;1047;3715;905;3405;82;408;583;2101;665;2509
172015;201809;328;1203;252;1046;60;241;110;486;170;727
172020;201809;2313;7237;2122;6947;180;704;1620;5323;1800;6027
172025;201809;733;2107;535;1772;54;210;340;1121;394;1331
172030;201809;1215;3681;1061;3440;26;118;872;2812;898;2930
172049;201809;1294;3226;862;2570;258;810;404;1206;662;2016
172065;201809;1470;3760;1184;3413;79;186;1020;3045;1099;3231
172080;201809;2283;6998;1872;6224;142;553;1269;4218;1411;4771
172085;201809;473;1333;309;990;55;163;92;288;147;451
172090;201809;3969;10376;3093;9165;132;484;2411;7076;2543;7560
172093;201809;490;1495;368;1272;54;233;191;625;245;858
172097;201809;577;1595;423;1347;67;228;201;664;268;892
172100;201809;45855;117525;30917;92993;6956;22733;9549;29877;16505;52610
172110;201809;1540;5846;1350;5552;143;614;1022;4372;1165;4986
172120;201809;4751;14698;3805;13117;645;2252;2010;7191;2655;9443
172125;201809;295;844;212;704;30;106;112;376;142;482
172130;201809;910;2892;784;2678;25;90;621;2155;646;2245
172208;201809;2385;6203;1923;5566;260;668;1235;3689;1495;4357
172210;201809;2672;7316;2080;6498;433;1406;1105;3505;1538;4911
210005;201809;19245;57545;15424;51274;4686;16115;6009;21008;10695;37123
210010;201809;1774;5852;1621;5610;52;239;1447;5001;1499;5240
210015;201809;3338;10137;2982;9643;139;375;2585;8518;2724;8893
210020;201809;7428;17029;6634;16131;96;251;6182;15016;6278;15267
210030;201809;4772;16001;4540;15673;216;1010;3997;13703;4213;14713
210040;201809;2147;5935;1946;5705;28;50;1832;5439;1860;5489
210043;201809;6436;17723;5313;16352;667;1954;3865;12435;4532;14389
210047;201809;6413;21438;5680;20424;241;1147;4959;17709;5200;18856
210050;201809;2131;7493;1707;6702;211;919;1123;4416;1334;5335
210055;201809;1791;6013;1651;5770;68;295;1368;4745;1436;5040
210060;201809;6832;26295;6124;24873;787;3308;4314;17996;5101;21304
210070;201809;7103;20514;6758;20104;33;103;6529;19543;6562;19646
210080;201809;3915;13910;3822;13792;24;124;3726;13455;3750;13579
210083;201809;5127;15924;4461;15200;86;497;4215;14236;4301;14733
210087;201809;2875;8205;2587;7811;132;345;2195;6792;2327;7137
210090;201809;9367;29688;8961;29005;279;1056;8106;26073;8385;27129
210095;201809;6006;20458;5623;19975;265;1050;4908;17688;5173;18738
210100;201809;6641;20200;6156;19484;235;901;5273;16657;5508;17558
210110;201809;2797;9031;2648;8828;29;136;2495;8315;2524;8451
210120;201809;23059;64860;19765;60673;2543;6621;13551;44380;16094;51001
210125;201809;3961;11526;3636;11110;734;1807;2635;8576;3369;10383
210130;201809;4076;11374;3520;10661;163;450;3020;9195;3183;9645
210135;201809;1406;4416;1259;4180;58;230;1052;3487;1110;3717
210140;201809;16711;48720;13648;44549;2894;9437;7703;26124;10597;35561
210150;201809;4442;11021;4013;10430;87;285;3616;9294;3703;9579
210160;201809;15800;48640;14427;46641;1408;4612;10738;35684;12146;40296
210170;201809;14146;46849;13481;45949;594;2119;12155;41548;12749;43667
210173;201809;2387;8913;2215;8639;57;327;2060;8027;2117;8354
210177;201809;3187;9301;2984;9055;90;168;2753;8621;2843;8789
210180;201809;1412;4037;1285;3858;31;113;1150;3433;1181;3546
210190;201809;4677;14136;4270;13410;110;556;3621;11081;3731;11637
210193;201809;1205;3710;1093;3534;42;148;893;2911;935;3059
210197;201809;1919;6499;1803;6337;160;587;1443;5167;1603;5754
210200;201809;7405;24685;6893;23896;622;2207;5582;19567;6204;21774
210203;201809;7007;21469;6335;20536;552;1743;5191;17145;5743;18888
210207;201809;3432;9923;3103;9492;137;372;2624;8190;2761;8562
210210;201809;8221;27170;7708;26477;100;566;7184;24619;7284;25185
210215;201809;2102;7065;1929;6825;64;323;1708;6019;1772;6342
210220;201809;5916;21135;5651;20664;213;1256;4995;17877;5208;19133
210230;201809;5116;15992;4704;15389;252;682;4146;13749;4398;14431
210232;201809;11137;36172;9292;33504;1468;5440;6150;23405;7618;28845
210235;201809;3535;10637;3123;10099;105;439;2768;8962;2873;9401
210237;201809;2465;8749;2280;8515;23;134;2166;8080;2189;8214
210240;201809;2664;8491;2456;8127;95;406;2146;7020;2241;7426
210250;201809;5404;16927;4992;16416;100;547;4494;14708;4594;15255
210255;201809;2564;7976;2231;7350;271;949;1541;5037;1812;5986
210260;201809;5115;16094;4571;15257;295;1113;3807;12664;4102;13777
210270;201809;4810;13638;4359;13035;106;504;3906;11569;4012;12073
210275;201809;3610;9173;3281;8770;55;106;3096;8376;3151;8482
210280;201809;5394;16066;4494;14660;252;1226;3316;10512;3568;11738
210290;201809;6420;18996;5935;18408;152;532;5391;16734;5543;17266
210300;201809;33173;91747;28148;85206;1879;5797;21556;67880;23435;73677
210310;201809;2990;7907;2709;7524;83;174;2435;6826;2518;7000
210312;201809;2575;7000;2307;6686;56;237;2134;6116;2190;6353
210315;201809;2876;8232;2464;7748;76;189;2205;7128;2281;7317
210317;201809;3970;12764;3683;12434;125;571;3369;11302;3494;11873
210320;201809;18795;60313;17604;58720;470;2206;15991;53150;16461;55356
210325;201809;3438;10306;3049;9756;89;315;2737;8862;2826;9177
210330;201809;26010;74539;21798;69063;5726;16987;11123;40239;16849;57226
210340;201809;10097;31000;9149;29569;907;2842;6904;22962;7811;25804
210350;201809;9104;27203;8243;26073;227;843;7237;22983;7464;23826
210355;201809;4277;14817;3797;14050;139;704;3233;12031;3372;12735
210360;201809;14262;43540;12863;41525;626;2611;10585;33850;11211;36461
210370;201809;10263;23525;8176;21285;282;545;7386;19678;7668;20223
210375;201809;2981;8522;2341;7639;628;2016;1161;4079;1789;6095
210380;201809;5410;14471;4854;13760;247;628;4225;12136;4472;12764
210390;201809;2576;9531;2421;9258;157;752;2011;7606;2168;8358
210400;201809;4536;14364;4181;13910;124;328;3853;12991;3977;13319
210405;201809;6969;19433;5693;17586;1084;3195;3252;10638;4336;13833
210407;201809;1932;6648;1623;6048;120;549;1285;4676;1405;5225
210408;201809;2343;9136;2237;8982;154;777;1845;7441;1999;8218
210409;201809;3641;12952;3351;12538;125;698;2809;10477;2934;11175
210410;201809;3399;10756;2957;10047;231;860;2228;7587;2459;8447
210420;201809;3966;12884;3601;12236;189;599;3054;10490;3243;11089
210430;201809;2194;6577;2064;6416;108;293;1818;5711;1926;6004
210440;201809;4111;11751;3838;11376;72;246;3624;10737;3696;10983
210450;201809;2471;7647;2224;7231;121;454;1847;5967;1968;6421
210455;201809;3763;10426;3078;9579;802;2434;1734;5591;2536;8025
210460;201809;3338;10334;3040;9900;106;430;2649;8593;2755;9023
210462;201809;1482;4938;1318;4627;49;226;1086;3778;1135;4004
210465;201809;2568;7789;2263;7359;89;329;1938;6313;2027;6642
210467;201809;5704;19107;5285;18600;261;1090;4670;16482;4931;17572
210470;201809;2115;5574;1462;4626;82;197;1106;3609;1188;3806
210480;201809;15001;46522;12818;43695;1394;4498;9412;33902;10806;38400
210490;201809;3679;9641;3061;8755;73;235;2691;7680;2764;7915
210500;201809;6033;24574;5687;23930;404;2079;4622;19251;5026;21330
210510;201809;5875;20420;5466;19938;112;543;4999;18406;5111;18949
210515;201809;3618;10944;3227;10519;119;401;2894;9555;3013;9956
210520;201809;2493;7299;2242;6982;93;322;2019;6308;2112;6630
210530;201809;45678;121139;37630;108792;6596;23581;11605;40964;18201;64545
210535;201809;3097;10636;2938;10385;103;392;2563;9168;2666;9560
210540;201809;14073;42959;11975;40127;1407;4548;8697;30275;10104;34823
210542;201809;6030;15428;5144;14435;269;454;4566;13393;4835;13847
210545;201809;2254;7100;2123;6890;56;249;1882;6017;1938;6266
210547;201809;3563;12837;3201;12118;326;1198;2330;9102;2656;10300
210550;201809;5661;17635;4909;16612;340;1210;3987;13758;4327;14968
210560;201809;3420;10764;3149;10283;111;393;2749;8911;2860;9304
210565;201809;1398;4948;1201;4635;67;346;952;3698;1019;4044
210570;201809;10993;30450;9956;29205;288;776;9125;27119;9413;27895
210580;201809;2973;8319;2603;7862;237;447;2102;6709;2339;7156
210590;201809;4211;12835;3715;12167;114;576;3291;10686;3405;11262
210592;201809;2525;7691;2380;7451;35;188;2133;6597;2168;6785
210594;201809;2545;7105;2018;6256;84;226;1567;4997;1651;5223
210596;201809;2340;8609;2181;8274;169;709;1742;6642;1911;7351
210598;201809;1803;5259;1679;5088;38;156;1558;4693;1596;4849
210600;201809;2896;8095;2389;7360;79;225;1985;6187;2064;6412
210610;201809;2441;7495;2212;7214;77;353;1957;6321;2034;6674
210620;201809;2355;6977;2044;6580;60;188;1867;6102;1927;6290
210630;201809;3052;10689;2799;10336;162;817;2319;8431;2481;9248
210632;201809;4086;13921;3730;13381;323;1367;2951;10499;3274;11866
210635;201809;1781;6332;1695;6177;136;451;1423;5323;1559;5774
210637;201809;2303;7980;2099;7666;168;758;1601;5863;1769;6621
210640;201809;5069;19492;5009;19429;26;96;4941;19218;4967;19314
210650;201809;7071;20564;6663;20024;81;322;6314;18908;6395;19230
210660;201809;8355;24407;7474;23049;331;1179;6465;19799;6796;20978
210663;201809;2523;7687;2391;7533;125;313;2113;6859;2238;7172
210667;201809;1856;6168;1752;6004;63;272;1579;5430;1642;5702
210670;201809;4356;15372;4074;14914;153;739;3571;12988;3724;13727
210675;201809;4989;13832;4422;13076;325;783;3675;11236;4000;12019
210680;201809;4037;10567;3426;9813;139;290;3029;8884;3168;9174
210690;201809;7383;24261;6767;23564;249;1031;6059;21315;6308;22346
210700;201809;2700;7550;2265;7010;150;368;1840;6096;1990;6464
210710;201809;4840;15462;4388;14811;123;584;3885;12996;4008;13580
210720;201809;2739;9333;2595;9144;58;318;2398;8364;2456;8682
210725;201809;1287;4521;1142;4272;49;234;806;3113;855;3347
210730;201809;1191;3258;1018;3025;83;221;804;2447;887;2668
210735;201809;4481;13845;3944;13061;302;1026;3294;11071;3596;12097
210740;201809;5133;14237;4593;13666;154;554;4033;11921;4187;12475
210745;201809;4500;12730;4252;12403;152;385;3869;11349;4021;11734
210750;201809;20117;52440;17536;49357;1513;4190;13342;38641;14855;42831
210760;201809;5546;15846;5042;15287;25;95;4900;14865;4925;14960
210770;201809;5884;15752;5153;14922;65;275;4814;13900;4879;14175
210780;201809;7062;23422;6369;22244;608;2027;4977;17724;5585;19751
210790;201809;4477;14375;4160;13964;188;586;3386;11959;3574;12545
210800;201809;4919;13353;4328;12581;73;292;3953;11374;4026;11666
210805;201809;3826;14485;3692;14278;111;642;3338;12796;3449;13438
210810;201809;4908;14802;4539;14327;206;476;3994;13006;4200;13482
210820;201809;6981;20300;6024;18734;760;2357;3933;12481;4693;14838
210825;201809;6430;20481;6040;19975;239;793;5330;17885;5569;18678
210830;201809;7584;22027;7221;21573;466;988;6317;19593;6783;20581
210840;201809;3267;8812;2955;8379;87;281;2624;7350;2711;7631
210845;201809;6123;17394;5815;17064;26;75;5753;16904;5779;16979
210850;201809;5568;19667;4972;18726;339;1618;3933;14746;4272;16364
210860;201809;18245;50747;15815;47544;811;2277;13197;40698;14008;42975
210870;201809;6483;18549;5773;17694;281;843;5055;15562;5336;16405
210880;201809;4318;13494;3935;13055;234;915;3310;10949;3544;11864
210890;201809;4144;12701;3795;12282;226;589;3223;10799;3449;11388
210900;201809;4668;13768;3576;11795;1425;5010;658;2433;2083;7443
210905;201809;1883;5470;1626;5113;43;104;1473;4697;1516;4801
210910;201809;7071;22191;6130;20620;821;2882;4227;14277;5048;17159
210920;201809;3155;10657;2797;10161;94;465;2475;8931;2569;9396
210923;201809;1405;4510;1278;4309;72;291;989;3317;1061;3608
210927;201809;5038;16076;4510;15495;114;428;4065;14127;4179;14555
210930;201809;2353;8404;2181;8102;118;597;1749;6406;1867;7003
210940;201809;3684;11210;3485;10948;113;529;3159;9731;3272;10260
210945;201809;5830;17667;5496;17266;242;691;4881;15529;5123;16220
210950;201809;5045;15017;3997;13422;597;1726;2677;9509;3274;11235
210955;201809;1614;5234;1444;4953;140;465;1061;3711;1201;4176
210960;201809;8529;26623;7699;25405;1482;4479;4862;17070;6344;21549
210970;201809;1235;4058;1046;3709;82;379;778;2651;860;3030
210975;201809;1595;5343;1496;5161;125;486;1171;4012;1296;4498
210980;201809;10348;23449;9254;22323;123;261;8873;21544;8996;21805
210990;201809;15902;46904;12944;43005;1315;4520;9219;31241;10534;35761
211000;201809;14141;43564;12270;41436;627;2592;10229;35179;10856;37771
211003;201809;5153;16721;4465;15885;181;723;3862;14021;4043;14744
211010;201809;6232;23065;5811;22472;72;432;5367;20865;5439;21297
211020;201809;7879;24932;7400;24323;318;1267;6401;21100;6719;22367
211023;201809;2019;6759;1914;6609;106;430;1621;5538;1727;5968
211027;201809;2654;9382;2610;9303;194;751;2253;8010;2447;8761
211030;201809;3773;10932;3445;10536;259;624;2891;9053;3150;9677
211040;201809;4461;16406;4237;16057;146;795;3767;14190;3913;14985
211050;201809;9446;24276;8691;23336;174;460;8111;21771;8285;22231
211060;201809;6581;21609;6155;21004;155;637;5714;19504;5869;20141
211065;201809;2081;6105;1800;5713;80;250;1530;4944;1610;5194
211070;201809;7355;24827;6591;23586;493;1833;5297;19107;5790;20940
211080;201809;1264;3656;1042;3294;52;293;804;2374;856;2667
211085;201809;1953;5991;1759;5722;102;297;1522;5028;1624;5325
211090;201809;3230;9017;2930;8622;48;234;2679;7787;2727;8021
211100;201809;6458;16974;6136;16535;42;137;5754;15527;5796;15664
211102;201809;2817;10430;2628;10153;169;815;2258;8645;2427;9460
211105;201809;2287;7518;1950;6878;209;760;1371;4808;1580;5568
211107;201809;4411;14095;3889;13349;163;639;3210;11280;3373;11919
211110;201809;5801;16608;4567;14678;560;1664;3175;10528;3735;12192
211120;201809;35632;98992;33007;95826;4271;11182;24352;73704;28623;84886
211125;201809;1995;6152;1729;5726;66;279;1474;4853;1540;5132
211130;201809;179835;458209;167728;442740;24852;65965;78909;235995;103761;301960
211140;201809;4836;15053;4407;14432;207;662;3808;12484;4015;13146
211150;201809;9093;26028;8047;24686;298;1045;6955;21353;7253;22398
211153;201809;2503;7573;2091;7059;326;1164;1402;4914;1728;6078
211157;201809;1076;3474;906;3189;46;258;646;2250;692;2508
211160;201809;3731;11572;3114;10555;197;874;2366;7850;2563;8724
211163;201809;1755;5795;1633;5612;18;86;1548;5373;1566;5459
211167;201809;1526;4986;1432;4836;28;132;1332;4475;1360;4607
211170;201809;5977;15360;5715;15044;55;192;5499;14414;5554;14606
211172;201809;2411;6836;2105;6337;89;314;1749;5088;1838;5402
211174;201809;2726;8243;2548;8008;67;326;2311;7188;2378;7514
211176;201809;3918;12098;3249;11127;222;947;2535;8600;2757;9547
211178;201809;4565;10788;4019;10163;34;150;3808;9517;3842;9667
211180;201809;3980;13601;3741;13241;212;856;3224;11419;3436;12275
211190;201809;3012;9125;2637;8541;47;231;2312;7417;2359;7648
211195;201809;1342;3953;1157;3692;78;203;960;3167;1038;3370
211200;201809;2010;6164;1679;5719;178;662;1183;4075;1361;4737
211210;201809;6302;19649;5862;19035;281;995;5111;16628;5392;17623
211220;201809;34023;91149;29100;85046;3140;9118;21420;64353;24560;73471
211223;201809;4787;14096;4281;13323;457;1314;3224;10278;3681;11592
211227;201809;1696;5845;1556;5628;55;261;1348;4919;1403;5180
211230;201809;6939;21880;6386;20967;465;1470;5167;17120;5632;18590
211240;201809;8019;26411;7613;25887;163;870;6988;23487;7151;24357
211245;201809;6402;17036;6144;16772;58;121;6038;16527;6096;16648
211250;201809;13393;40273;12333;38961;515;2110;10711;33391;11226;35501
211260;201809;7634;25204;7039;24405;204;876;6425;22366;6629;23242
211270;201809;10126;33351;8991;31804;374;1837;7521;26661;7895;28498
211280;201809;12886;37078;11683;35522;879;2162;9592;30331;10471;32493
211285;201809;1597;5781;1433;5491;245;982;775;3081;1020;4063
211290;201809;6947;22158;6511;21541;208;898;5643;18545;5851;19443
211300;201809;7964;22973;7287;22065;127;369;6814;20720;6941;21089
211400;201809;11001;33483;9261;30873;1531;5099;5736;20267;7267;25366
220005;201809;1811;4941;1637;4673;39;159;1351;3769;1390;3928
220010;201809;1470;4205;1238;3797;32;139;985;2979;1017;3118
220020;201809;3261;9831;2935;9283;303;1026;2214;6949;2517;7975
220025;201809;2153;5057;1854;4597;33;108;1568;3769;1601;3877
220027;201809;1205;3202;1058;3002;31;103;869;2435;900;2538
220030;201809;3317;8921;3163;8687;106;328;2785;7529;2891;7857
220040;201809;6786;20875;6142;19656;1161;3580;3894;12714;5055;16294
220045;201809;1437;4522;1227;4144;44;237;973;3204;1017;3441
220050;201809;4362;12698;3742;11767;122;539;3296;10254;3418;10793
220060;201809;2323;5086;1969;4673;32;84;1840;4349;1872;4433
220070;201809;2444;6469;2133;6002;84;197;1776;4996;1860;5193
220080;201809;660;1938;594;1837;29;120;511;1528;540;1648
220090;201809;1778;4357;1480;3933;18;70;1272;3436;1290;3506
220095;201809;642;1690;609;1650;15;32;560;1519;575;1551
220100;201809;1317;3799;1076;3374;50;226;865;2619;915;2845
220105;201809;1989;6323;1749;5817;152;520;1289;4291;1441;4811
220110;201809;3392;9471;3179;9092;54;258;2823;7942;2877;8200
220115;201809;2594;8056;2423;7788;75;323;2187;6909;2262;7232
220117;201809;1332;3362;1037;2923;20;75;873;2403;893;2478
220120;201809;11492;33373;10647;32278;124;521;10058;30394;10182;30915
220130;201809;1062;3044;905;2809;16;110;811;2461;827;2571
220140;201809;1856;4264;1610;3960;150;396;1372;3327;1522;3723
220150;201809;6411;19247;6014;18622;142;702;5177;15657;5319;16359
220155;201809;1100;3247;865;2808;24;103;612;1933;636;2036
220157;201809;1038;2606;871;2332;17;79;705;1815;722;1894
220160;201809;2659;7792;2317;7145;50;266;1913;5747;1963;6013
220170;201809;1369;3828;1178;3536;12;62;1049;3106;1061;3168
220173;201809;1981;5751;1602;5028;37;170;1315;3987;1352;4157
220177;201809;1894;5509;1843;5448;16;51;1796;5322;1812;5373
220180;201809;1128;2864;888;2411;11;54;668;1701;679;1755
220190;201809;5790;16137;5008;15030;440;1407;3733;11236;4173;12643
220191;201809;1378;4459;1276;4276;80;345;941;3081;1021;3426
220192;201809;1802;5007;1433;4344;32;120;1144;3389;1176;3509
220194;201809;1692;4958;1511;4650;76;314;1236;3702;1312;4016
220196;201809;1889;5237;1723;4960;42;193;1453;4066;1495;4259
220198;201809;1221;3507;1029;3244;6;15;970;3098;976;3113
220200;201809;4645;14235;4222;13679;301;1064;3441;11133;3742;12197
220202;201809;2156;6141;1859;5615;33;156;1574;4642;1607;4798
220205;201809;2515;7083;2247;6650;39;168;1944;5650;1983;5818
220207;201809;788;2404;672;2195;61;229;449;1451;510;1680
220208;201809;1692;5323;1374;4672;277;1013;664;2261;941;3274
220209;201809;1587;4634;1374;4267;27;128;1118;3428;1145;3556
220210;201809;1538;4060;1330;3706;21;96;1107;2985;1128;3081
220211;201809;1527;4065;1430;3939;20;76;1273;3516;1293;3592
220213;201809;1691;4644;1482;4237;28;112;1201;3302;1229;3414
220217;201809;1982;6178;1892;6067;32;121;1782;5751;1814;5872
220220;201809;10107;27103;8533;24612;568;1552;6189;18229;6757;19781
220225;201809;1098;2913;901;2657;12;47;812;2369;824;2416
220230;201809;5574;14095;4867;13148;196;521;4226;11446;4422;11967
220240;201809;2912;8696;2669;8218;90;320;2185;6702;2275;7022
220245;201809;1572;3995;1277;3613;10;42;1146;3285;1156;3327
220250;201809;2715;8100;2421;7706;32;154;2188;6932;2220;7086
220253;201809;1627;4514;1388;4096;77;247;1144;3286;1221;3533
220255;201809;1852;4633;1563;4185;37;178;1302;3322;1339;3500
220260;201809;4185;13233;3695;12378;205;750;2959;9884;3164;10634
220265;201809;1215;4042;1112;3880;57;243;877;3014;934;3257
220270;201809;6340;20176;5982;19528;287;1223;5055;16024;5342;17247
220271;201809;1465;3861;1269;3572;46;145;1102;3100;1148;3245
220272;201809;1695;4931;1511;4583;48;158;1169;3460;1217;3618
220273;201809;1190;3436;999;3080;42;165;762;2293;804;2458
220275;201809;2178;5374;1689;4691;45;176;1463;4014;1508;4190
220277;201809;2045;5383;1781;4964;32;110;1521;4155;1553;4265
220280;201809;1575;3958;1329;3584;39;133;1117;2926;1156;3059
220285;201809;1486;3890;1253;3585;21;104;1115;3134;1136;3238
220290;201809;5804;17756;4790;16317;378;1476;3577;12208;3955;13684
220300;201809;1854;5759;1566;5343;55;334;1295;4292;1350;4626
220310;201809;2756;7916;2277;7362;52;261;1972;6300;2024;6561
220320;201809;2893;8697;2319;7600;133;561;1754;5598;1887;6159
220323;201809;1560;4974;1278;4505;81;340;1017;3548;1098;3888
220325;201809;1241;3734;1058;3402;38;169;865;2745;903;2914
220327;201809;1405;4196;1248;3930;55;248;1016;3109;1071;3357
220330;201809;4024;10312;3404;9500;126;378;2885;7998;3011;8376
220335;201809;1762;5331;1574;5113;33;107;1434;4667;1467;4774
220340;201809;1798;4804;1435;4206;51;186;1023;2867;1074;3053
220342;201809;1159;3515;1037;3330;44;191;822;2597;866;2788
220345;201809;3059;7090;2474;6277;18;55;2326;5868;2344;5923
220350;201809;3338;8829;2701;7788;145;473;2016;5730;2161;6203
220360;201809;1227;3164;991;2792;21;67;796;2216;817;2283
220370;201809;8835;25272;8025;24101;208;877;7151;21214;7359;22091
220375;201809;1470;4474;1366;4328;9;32;1328;4211;1337;4243
220380;201809;1501;3665;1247;3296;27;82;1087;2832;1114;2914
220385;201809;783;1933;631;1653;11;37;548;1400;559;1437
220390;201809;8392;24054;7040;21707;1825;5520;3046;10039;4871;15559
220400;201809;1476;3630;1120;3065;29;97;859;2276;888;2373
220410;201809;1131;3220;941;2893;60;184;753;2275;813;2459
220415;201809;803;2142;685;1949;16;57;528;1466;544;1523
220420;201809;1962;5541;1599;4833;60;189;1240;3682;1300;3871
220430;201809;2460;6650;2384;6543;79;234;2136;5807;2215;6041
220435;201809;1659;4562;1481;4275;56;190;1166;3294;1222;3484
220440;201809;2369;7696;2078;7202;136;530;1704;5819;1840;6349
220450;201809;2258;6267;1873;5752;175;625;1440;4389;1615;5014
220455;201809;1296;4058;1229;3969;27;125;1106;3539;1133;3664
220460;201809;917;2365;827;2260;39;141;732;1951;771;2092
220465;201809;2264;7254;2038;6901;143;539;1594;5423;1737;5962
220470;201809;3402;9782;3066;9230;106;376;2520;7461;2626;7837
220480;201809;2460;6653;1990;5868;144;361;1448;4208;1592;4569
220490;201809;2321;6142;2130;5901;44;190;1907;5202;1951;5392
220500;201809;2511;6827;2311;6494;54;234;1924;5204;1978;5438
220510;201809;2585;7567;2109;6718;94;281;1664;5306;1758;5587
220515;201809;1675;4064;1498;3818;38;85;1327;3370;1365;3455
220520;201809;4947;12987;4470;12291;111;340;3968;10857;4079;11197
220525;201809;1246;3356;1129;3194;18;77;1017;2837;1035;2914
220527;201809;1302;3719;1152;3467;22;71;990;2999;1012;3070
220530;201809;1279;3415;1148;3232;28;111;1069;2958;1097;3069
220535;201809;759;2203;700;2126;44;156;572;1722;616;1878
220540;201809;3320;10487;3128;10141;107;433;2735;8801;2842;9234
220545;201809;1352;4310;1264;4142;89;355;1038;3339;1127;3694
220550;201809;8526;26646;7727;25253;621;2288;5833;18778;6454;21066
220551;201809;1406;4212;1235;3917;44;175;989;3073;1033;3248
220552;201809;1502;4470;1274;4028;40;192;1031;3163;1071;3355
220553;201809;1547;4308;1320;3955;51;129;1060;3253;1111;3382
220554;201809;842;2293;629;1929;31;81;450;1362;481;1443
220555;201809;1966;6471;1833;6238;70;332;1517;5101;1587;5433
220556;201809;1234;3700;1072;3353;66;266;751;2231;817;2497
220557;201809;1528;4742;1305;4274;87;331;934;2979;1021;3310
220558;201809;1373;3638;1068;3210;26;122;902;2668;928;2790
220559;201809;1603;4204;1381;3857;6;36;1141;3205;1147;3241
220560;201809;1720;3996;1397;3564;35;74;1235;3150;1270;3224
220570;201809;7081;21868;6516;20999;495;1686;5169;16646;5664;18332
220580;201809;6681;19081;6262;18402;131;500;5618;16316;5749;16816
220585;201809;1871;6217;1700;5883;69;288;1391;4787;1460;5075
220590;201809;1243;3559;1053;3266;102;323;769;2386;871;2709
220595;201809;2427;6744;2244;6501;14;79;2086;5979;2100;6058
220600;201809;1391;3125;1159;2829;134;212;932;2372;1066;2584
220605;201809;1652;4838;1426;4439;29;130;1130;3423;1159;3553
220610;201809;2790;8781;2628;8549;38;170;2429;7891;2467;8061
220620;201809;7812;24655;7285;23910;234;1118;6584;21335;6818;22453
220630;201809;368;1106;290;969;42;147;178;608;220;755
220635;201809;1634;5256;1447;4860;70;283;1069;3525;1139;3808
220640;201809;2636;7272;2243;6675;104;388;1850;5413;1954;5801
220650;201809;1983;5677;1692;5164;53;194;1355;4073;1408;4267
220660;201809;2622;8275;2286;7723;100;481;1881;6151;1981;6632
220665;201809;1266;3957;1110;3694;30;156;930;3037;960;3193
220667;201809;1614;5186;1444;4873;83;327;1136;3820;1219;4147
220669;201809;1657;5202;1597;5094;87;396;1345;4196;1432;4592
220670;201809;2159;5774;1765;5281;34;112;1553;4610;1587;4722
220672;201809;2978;7551;2439;6905;115;342;2131;6008;2246;6350
220675;201809;1199;3357;1102;3172;49;137;883;2521;932;2658
220680;201809;2596;7311;2491;7156;116;287;2244;6466;2360;6753
220690;201809;1480;4050;1315;3779;124;325;995;2887;1119;3212
220695;201809;890;2502;820;2369;18;68;706;2009;724;2077
220700;201809;8835;22993;7140;20547;354;1091;5525;15761;5879;16852
220710;201809;848;2424;642;2025;41;119;467;1450;508;1569
220720;201809;2043;5048;1843;4758;24;84;1591;4049;1615;4133
220730;201809;1241;3590;1065;3302;25;115;897;2711;922;2826
220735;201809;964;2312;742;1951;27;77;621;1586;648;1663
220740;201809;1400;3946;1131;3589;41;143;955;3043;996;3186
220750;201809;3618;9841;3276;9323;211;554;2843;8105;3054;8659
220755;201809;1182;3075;999;2783;36;132;789;2114;825;2246
220760;201809;2922;8737;2593;8283;115;387;2212;7167;2327;7554
220770;201809;19885;63017;17286;58267;6021;20915;6040;21210;12061;42125
220775;201809;1099;2960;1025;2865;14;53;994;2769;1008;2822
220777;201809;1607;4213;1248;3615;41;115;935;2702;976;2817
220779;201809;1329;3288;1182;3079;29;99;1024;2635;1053;2734
220780;201809;5618;14525;4840;13246;236;771;3909;10400;4145;11171
220785;201809;1420;3219;1280;3019;14;22;1225;2892;1239;2914
220790;201809;9979;29011;9020;27623;297;1364;7639;22956;7936;24320
220793;201809;841;2282;699;2033;24;74;581;1696;605;1770
220795;201809;1396;3700;1252;3512;25;101;1118;3100;1143;3201
220800;201809;16365;40098;13840;36439;822;2197;10031;26070;10853;28267
220810;201809;2915;8382;2536;7679;59;253;2113;6256;2172;6509
220820;201809;5116;13469;4423;12491;431;1120;3258;9222;3689;10342
220830;201809;6983;19137;6348;18206;258;829;5384;15307;5642;16136
220840;201809;12019;37514;10369;34113;2370;7484;5292;18017;7662;25501
220850;201809;2972;9573;2726;9257;68;377;2441;8187;2509;8564
220855;201809;582;1640;515;1527;15;73;438;1264;453;1337
220860;201809;996;2496;869;2294;17;57;783;2043;800;2100
220865;201809;2536;6833;1995;5887;62;224;1532;4396;1594;4620
220870;201809;2639;7928;2205;7334;40;211;2004;6600;2044;6811
220880;201809;5102;12586;4563;11924;70;228;4236;10990;4306;11218
220885;201809;1243;4195;1075;3896;59;300;841;3019;900;3319
220887;201809;1427;3218;1217;2937;8;30;1143;2719;1151;2749
220890;201809;1466;4770;1258;4372;90;338;971;3380;1061;3718
220900;201809;1960;4885;1645;4446;38;99;1440;3845;1478;3944
220910;201809;1473;4240;1253;3914;55;180;1040;3226;1095;3406
220915;201809;975;2640;773;2243;16;60;617;1732;633;1792
220920;201809;1339;4521;1155;4261;81;366;916;3347;997;3713
220930;201809;1553;4524;1371;4240;38;157;1224;3730;1262;3887
220935;201809;1032;2978;807;2506;33;131;541;1559;574;1690
220937;201809;1322;3643;1157;3381;33;133;947;2697;980;2830
220940;201809;1410;4144;1162;3652;36;164;875;2658;911;2822
220945;201809;411;1450;371;1372;28;144;266;947;294;1091
220950;201809;1386;3306;903;2518;17;61;712;1911;729;1972
220955;201809;1528;4050;1340;3725;38;100;1151;3199;1189;3299
220960;201809;838;2140;655;1847;15;60;500;1358;515;1418
220965;201809;1740;4841;1550;4558;21;132;1338;3832;1359;3964
220970;201809;1768;4601;1360;3942;46;138;1095;3153;1141;3291
220975;201809;695;2114;609;2001;22;142;544;1694;566;1836
220980;201809;1148;3324;1043;3159;38;160;871;2588;909;2748
220985;201809;1154;3231;1049;3074;47;192;816;2271;863;2463
220987;201809;1472;4408;1277;4072;60;265;1043;3246;1103;3511
220990;201809;1661;4736;1455;4408;34;177;1198;3524;1232;3701
220995;201809;1171;3504;921;3066;60;236;656;2177;716;2413
220997;201809;2384;7031;2230;6806;55;235;2018;6067;2073;6302
221000;201809;4003;11547;3714;11098;107;516;3173;9260;3280;9776
221005;201809;1395;3918;1270;3691;49;198;1061;2953;1110;3151
221010;201809;1195;2909;990;2652;26;62;858;2262;884;2324
221020;201809;1524;4746;1396;4486;38;177;1056;3314;1094;3491
221030;201809;1544;4169;1339;3876;40;169;1152;3289;1192;3458
221035;201809;1346;3676;1213;3497;24;52;1093;3220;1117;3272
221037;201809;595;1770;516;1625;12;63;343;1015;355;1078
221038;201809;521;1485;411;1275;17;57;295;905;312;962
221039;201809;862;2349;769;2201;18;82;643;1762;661;1844
221040;201809;4139;12625;3718;11872;170;620;2974;9464;3144;10084
221050;201809;3702;10069;3348;9614;58;230;3070;8748;3128;8978
221060;201809;8280;23114;6911;20955;281;903;5453;16802;5734;17705
221062;201809;1152;3891;1007;3609;51;253;804;2816;855;3069
221063;201809;1145;3345;980;3091;75;278;709;2165;784;2443
221065;201809;2600;6778;2299;6256;31;121;2028;5410;2059;5531
221070;201809;3288;10510;2767;9472;290;1009;1845;6375;2135;7384
221080;201809;3409;8421;2784;7480;58;233;2308;6102;2366;6335
221090;201809;1398;3732;1140;3271;20;82;986;2748;1006;2830
221093;201809;1349;3884;1249;3679;120;371;855;2459;975;2830
221095;201809;888;2343;751;2129;6;14;620;1727;626;1741
221097;201809;827;2188;639;1838;29;103;464;1272;493;1375
221100;201809;99703;277338;86964;255797;13937;42716;54005;156494;67942;199210
221110;201809;9782;29790;9099;28877;219;1135;8098;25232;8317;26367
221120;201809;4253;12528;3895;11924;220;763;3296;10017;3516;10780
221130;201809;4852;13034;3686;10701;910;2583;1635;4788;2545;7371
221135;201809;1583;4404;1429;4193;49;182;1254;3637;1303;3819
221140;201809;1279;3127;1124;2904;10;39;1007;2533;1017;2572
221150;201809;1084;2709;867;2329;23;100;685;1718;708;1818
221160;201809;784;1963;694;1839;30;61;562;1490;592;1551
221170;201809;996;2947;921;2819;24;81;778;2374;802;2455
230010;201809;3135;8448;2547;7392;136;462;1934;5488;2070;5950
230015;201809;2855;9530;2626;9092;257;1050;1820;6171;2077;7221
230020;201809;12753;40816;12225;39955;424;1777;10541;33997;10965;35774
230030;201809;12168;32046;10621;29832;233;750;9406;26359;9639;27109
230040;201809;4306;11419;3634;10308;106;427;2972;8282;3078;8709
230050;201809;2726;8718;2009;6902;390;1292;772;2626;1162;3918
230060;201809;2333;6495;1887;5625;46;204;1537;4475;1583;4679
230070;201809;3932;10881;3238;9485;166;548;2225;6521;2391;7069
230075;201809;8895;29243;8286;28148;386;1951;6851;22635;7237;24586
230080;201809;2779;6140;2170;5305;22;101;1953;4725;1975;4826
230090;201809;4034;10487;3496;9615;184;556;2723;7392;2907;7948
230100;201809;17266;46847;15500;44325;1533;4643;10669;30506;12202;35149
230110;201809;11530;35206;10206;32491;1838;5870;5727;18382;7565;24252
230120;201809;7299;20237;6435;18788;589;1559;4702;13995;5291;15554
230125;201809;3044;8296;2504;7399;91;323;1935;5673;2026;5996
230130;201809;5539;17538;4619;15517;430;1592;3057;10050;3487;11642
230140;201809;3430;10441;2918;9449;134;564;2168;6847;2302;7411
230150;201809;1571;4740;1334;4216;222;632;752;2478;974;3110
230160;201809;6288;16998;5499;15766;175;679;4625;13009;4800;13688
230170;201809;5854;17231;5073;15731;287;975;3745;11421;4032;12396
230180;201809;1614;4598;1379;4115;28;130;1083;3116;1111;3246
230185;201809;4070;12312;3540;11376;314;1105;2573;8274;2887;9379
230190;201809;12537;37563;10777;34221;1730;5669;5847;18696;7577;24365
230195;201809;5047;15070;4524;14161;310;1058;3567;11046;3877;12104
230200;201809;4862;13517;4214;12251;160;529;3320;9429;3480;9958
230205;201809;3932;12345;3555;11676;183;787;2715;8721;2898;9508
230210;201809;9773;24891;8353;22866;464;1493;6283;16994;6747;18487
230220;201809;12847;34074;11653;32157;489;1527;9777;26651;10266;28178
230230;201809;6759;20753;6099;19372;445;1493;4473;14092;4918;15585
230240;201809;12386;33567;11047;31386;391;1271;9171;25785;9562;27056
230250;201809;8680;25490;8546;25281;321;1186;6966;20152;7287;21338
230260;201809;13593;42999;12293;40425;1626;5565;7541;25063;9167;30628
230270;201809;7362;20606;5962;17930;555;1684;3981;12018;4536;13702
230280;201809;20049;55221;16811;49683;725;2900;13232;37775;13957;40675
230290;201809;4570;13120;3943;11839;382;1049;2932;8861;3314;9910
230300;201809;4348;12274;4113;11932;94;408;3648;10369;3742;10777
230310;201809;4609;13326;3941;12163;167;686;2835;8497;3002;9183
230320;201809;7520;21977;6561;20157;333;1281;5014;15091;5347;16372
230330;201809;4587;12808;3800;11292;193;617;2845;8311;3038;8928
230340;201809;3489;11198;2995;10171;294;1038;2057;6931;2351;7969
230350;201809;17850;50730;15999;47610;1087;3791;10587;31743;11674;35534
230360;201809;2767;7771;2251;6803;159;545;1551;4615;1710;5160
230365;201809;3039;7706;2551;6930;50;235;2146;5731;2196;5966
230370;201809;52067;153282;45146;142348;8818;28254;23975;78032;32793;106286
230380;201809;6331;17796;5061;15401;178;695;3727;11138;3905;11833
230390;201809;3225;9877;2840;9222;140;596;2162;6902;2302;7498
230393;201809;2924;9148;2459;8183;108;551;1902;6076;2010;6627
230395;201809;5576;15435;4891;14228;436;1242;3386;9933;3822;11175
230400;201809;5653;16086;5027;14997;166;764;3998;11495;4164;12259
230410;201809;14247;43148;11671;38079;1240;4237;7513;24594;8753;28831
230420;201809;25145;73601;21404;66455;2862;9378;12356;38051;15218;47429
230423;201809;4656;13969;4070;12771;113;498;3284;10101;3397;10599
230425;201809;5289;16810;4867;15898;464;1575;3491;11340;3955;12915
230426;201809;2570;6965;1942;5718;45;177;1490;4306;1535;4483
230427;201809;1833;5262;1257;3942;71;236;875;2640;946;2876
230428;201809;9480;26344;8421;24688;1226;3699;5083;14878;6309;18577
230430;201809;4460;13209;3748;11907;186;686;2849;8841;3035;9527
230435;201809;5411;15044;4664;13746;538;1615;3010;8875;3548;10490
230440;201809;382868;1002964;323212;909132;47860;140959;186333;522205;234193;663164
230445;201809;4260;11484;3567;10256;217;607;2517;7098;2734;7705
230450;201809;3394;10259;3012;9594;216;840;2225;6965;2441;7805
230460;201809;2034;5886;1780;5457;81;320;1469;4472;1550;4792
230465;201809;3900;11223;3331;10173;103;457;2476;7287;2579;7744
230470;201809;10935;37116;9983;35262;887;3770;7374;25604;8261;29374
230480;201809;1375;4132;1179;3753;112;437;857;2612;969;3049
230490;201809;2333;6753;2020;6166;207;683;1229;3619;1436;4302
230495;201809;5727;17416;5084;16226;411;1646;3362;10513;3773;12159
230500;201809;8404;28546;7869;27492;385;1622;6252;21792;6637;23414
230510;201809;1587;5118;1178;4140;217;817;504;1753;721;2570
230520;201809;4288;12650;3834;11757;318;1020;2733;8276;3051;9296
230523;201809;14456;43637;11888;38080;2870;9262;3230;10871;6100;20133
230526;201809;3806;11141;3251;10117;151;626;2494;7563;2645;8189
230530;201809;5185;16343;4473;14990;413;1510;3154;10569;3567;12079
230533;201809;4048;10458;3485;9429;115;318;2875;7709;2990;8027
230535;201809;5376;15176;4566;13733;290;883;3200;9763;3490;10646
230540;201809;15536;43826;13850;41236;306;1308;11979;35117;12285;36425
230550;201809;19542;54201;16309;48428;1878;5922;9880;29150;11758;35072
230560;201809;7595;19700;6290;17408;90;362;5273;14394;5363;14756
230565;201809;3065;8527;2548;7583;74;309;1963;5754;2037;6063
230570;201809;3485;8958;3041;8374;72;218;2578;7052;2650;7270
230580;201809;9777;27196;8733;25646;357;1266;7384;21484;7741;22750
230590;201809;8703;25642;7287;22925;547;1920;5187;15854;5734;17774
230600;201809;3603;9599;2729;7903;95;313;1829;5354;1924;5667
230610;201809;6395;18283;5745;17258;537;1535;4339;13128;4876;14663
230620;201809;2076;5746;1591;4746;135;436;969;2803;1104;3239
230625;201809;7733;23067;6742;21097;2095;6773;1888;6205;3983;12978
230630;201809;10056;31109;8958;28805;2209;6566;4176;14357;6385;20923
230640;201809;26576;82375;24380;78728;1680;6398;19244;61401;20924;67799
230650;201809;4880;13905;4217;12652;208;758;3284;9635;3492;10393
230655;201809;9101;31960;8690;31216;672;2730;6837;24634;7509;27364
230660;201809;6136;18332;5050;16278;187;1005;4116;12917;4303;13922
230670;201809;5999;14825;4457;12208;181;558;3507;9373;3688;9931
230680;201809;2509;7130;2161;6476;195;585;1485;4459;1680;5044
230690;201809;6597;20207;5923;18747;544;1923;3632;11276;4176;13199
230700;201809;9259;24589;7994;22219;357;1167;6102;16488;6459;17655
230710;201809;6829;21584;5967;19812;596;2153;4247;13905;4843;16058
230720;201809;1886;5687;1559;4983;122;389;1053;3295;1175;3684
230725;201809;3643;11597;3222;10657;562;1988;1520;4931;2082;6919
230730;201809;53057;150492;43874;135611;10771;35646;15672;50954;26443;86600
230740;201809;5884;16885;5213;15742;153;619;4214;12592;4367;13211
230750;201809;8200;22502;6900;20318;200;799;5470;15634;5670;16433
230760;201809;11080;30410;9912;28482;721;2384;7360;20642;8081;23026
230763;201809;4368;12633;3775;11501;158;658;2974;8758;3132;9416
230765;201809;38304;110059;32703;100272;6785;21781;13940;43048;20725;64829
230770;201809;25167;65795;21604;60832;2868;8446;13482;38069;16350;46515
230780;201809;5850;21158;5514;20465;888;3326;3253;12431;4141;15757
230790;201809;2883;8554;2592;8053;147;584;1954;5910;2101;6494
230800;201809;7464;24789;6768;23307;879;3399;4032;13646;4911;17045
230810;201809;11461;35149;10370;33301;479;1889;8004;25162;8483;27051
230820;201809;3092;10309;2661;9335;306;1260;1623;5465;1929;6725
230830;201809;7375;20905;6368;19089;173;745;5200;15220;5373;15965
230835;201809;4107;10023;3163;8510;107;319;2593;6853;2700;7172
230837;201809;3069;9809;2640;8968;141;691;2026;6648;2167;7339
230840;201809;8842;26737;7760;24913;556;1987;5923;18960;6479;20947
230850;201809;9003;27151;7954;25019;485;1739;5699;17734;6184;19473
230860;201809;5050;13421;4293;12272;121;430;3689;10402;3810;10832
230870;201809;16525;41337;14314;37851;521;1507;11530;30288;12051;31795
230880;201809;2007;6308;1864;6067;68;350;1483;4680;1551;5030
230890;201809;4322;14368;4029;13786;366;1379;2932;9906;3298;11285
230900;201809;2961;8975;2504;8030;244;835;1620;5064;1864;5899
230910;201809;2915;8237;2403;7338;80;383;1915;5714;1995;6097
230920;201809;4368;12588;3863;11799;166;658;3105;9311;3271;9969
230930;201809;6365;18489;5343;16473;399;1327;3678;11263;4077;12590
230940;201809;7663;20458;6779;19046;219;683;5662;15766;5881;16449
230945;201809;6491;18942;5645;17213;414;1411;3909;11860;4323;13271
230950;201809;6155;15793;5642;15151;142;323;5076;13841;5218;14164
230960;201809;13044;39026;11827;36687;1922;6073;6080;19144;8002;25217
230970;201809;12819;36215;11108;33409;2169;6742;5563;16901;7732;23643
230980;201809;2649;7952;2323;7351;468;1416;1325;4390;1793;5806
230990;201809;1669;4801;1397;4260;79;323;968;2819;1047;3142
231000;201809;2468;6668;2051;5802;85;244;1481;4098;1566;4342
231010;201809;3116;7888;2583;6979;110;364;2086;5474;2196;5838
231020;201809;7646;25027;7013;23649;1284;4139;4174;14566;5458;18705
231025;201809;7157;20747;6368;19400;899;2793;4291;13173;5190;15966
231030;201809;6898;21248;5591;18428;984;3266;3001;9919;3985;13185
231040;201809;3095;9093;2684;8317;106;426;2081;6297;2187;6723
231050;201809;11603;30975;9380;26935;667;1915;6975;19686;7642;21601
231060;201809;2521;7510;2289;7112;88;341;1866;5770;1954;6111
231070;201809;7805;23306;6709;21273;974;3163;3984;12657;4958;15820
231080;201809;3858;11347;3448;10617;136;662;2703;8041;2839;8703
231085;201809;5747;15412;5028;14496;318;908;3804;11071;4122;11979
231090;201809;4203;11322;3193;9260;111;412;2254;6346;2365;6758
231095;201809;2061;6390;1714;5583;156;565;1195;3848;1351;4413
231100;201809;2897;8704;2476;7915;150;512;1865;5962;2015;6474
231110;201809;3358;10411;3235;10186;159;623;2422;7500;2581;8123
231120;201809;2044;6324;1766;5807;112;438;1196;3885;1308;4323
231123;201809;1868;4977;1577;4433;74;222;1203;3340;1277;3562
231126;201809;5528;15575;4432;13414;218;737;3258;9655;3476;10392
231130;201809;19035;53185;16598;49724;1493;5236;11646;34635;13139;39871
231135;201809;4148;11813;3491;10578;160;590;2517;7477;2677;8067
231140;201809;16453;47919;13713;42879;857;3515;9549;28885;10406;32400
231150;201809;5269;15049;4315;13120;772;2328;2006;6229;2778;8557
231160;201809;5779;18250;5276;17261;1088;3375;2883;9789;3971;13164
231170;201809;4297;12978;3554;11447;243;921;2431;7561;2674;8482
231180;201809;13369;39086;11417;34836;2811;8629;4742;14554;7553;23183
231190;201809;3741;10793;3247;9844;132;549;2567;7514;2699;8063
231195;201809;4478;14294;3857;12965;204;919;2900;9486;3104;10405
231200;201809;7660;24723;6703;22684;304;1520;5134;16769;5438;18289
231210;201809;4600;14065;4012;12999;198;797;3084;9729;3282;10526
231220;201809;11654;31402;9348;26879;547;1644;6829;19001;7376;20645
231230;201809;9018;28965;8075;27364;558;2185;6007;20414;6565;22599
231240;201809;11300;33995;10155;31663;1743;5483;5883;18510;7626;23993
231250;201809;2015;5356;1350;3845;107;325;796;2205;903;2530
231260;201809;3167;9308;2794;8696;316;985;1861;5916;2177;6901
231270;201809;6292;16834;5368;15289;158;650;4149;11513;4307;12163
231280;201809;1596;5084;1506;4907;146;500;1116;3626;1262;4126
231290;201809;35705;110052;31153;100534;5637;18705;14855;47643;20492;66348
231300;201809;3892;11089;3145;9559;260;848;2028;6036;2288;6884
231310;201809;7088;19184;5805;16662;608;1734;3780;10720;4388;12454
231320;201809;7414;21055;5943;18249;130;593;4620;13979;4750;14572
231325;201809;2471;6929;2071;6249;369;1073;1189;3652;1558;4725
231330;201809;9813;30324;8219;27047;1654;5345;4267;14387;5921;19732
231335;201809;5614;14997;4762;13565;104;469;4116;11488;4220;11957
231340;201809;16928;53441;15354;50782;1203;4108;11550;38525;12753;42633
231350;201809;15387;42648;14019;40716;346;1236;12563;36165;12909;37401
231355;201809;4399;13471;3954;12675;214;806;3054;9694;3268;10500
231360;201809;7268;22548;6408;21029;447;1619;4790;15670;5237;17289
231370;201809;2262;6125;1802;5305;42;125;1392;4065;1434;4190
231375;201809;4301;13680;3933;13003;156;703;3263;10610;3419;11313
231380;201809;5714;15772;5289;15235;205;536;4439;12997;4644;13533
231390;201809;3266;9795;2947;9247;199;752;2143;6530;2342;7282
231395;201809;3880;11853;3272;10834;581;1931;1815;6106;2396;8037
231400;201809;8797;26070;7864;24313;360;1424;6109;18514;6469;19938
231410;201809;14886;46864;13266;44107;811;3038;10383;34088;11194;37126
240010;201809;2468;6802;1926;5757;194;653;1212;3519;1406;4172
240020;201809;11066;32658;9666;30065;899;3292;6263;19122;7162;22414
240030;201809;2638;6960;2480;6725;122;364;2156;5767;2278;6131
240040;201809;810;2315;667;2043;14;73;498;1468;512;1541
240050;201809;3154;8517;2650;7598;62;192;2102;5912;2164;6104
240060;201809;1371;3742;1166;3360;37;122;947;2679;984;2801
240070;201809;2140;6468;1979;6128;211;698;1480;4515;1691;5213
240080;201809;2668;7406;2345;6831;74;283;1840;5277;1914;5560
240090;201809;2196;5563;1816;4906;28;87;1507;4010;1535;4097
240100;201809;8959;23178;7413;20242;366;1112;5720;15181;6086;16293
240110;201809;4322;12845;3812;11885;265;979;2719;8305;2984;9284
240120;201809;3526;9638;2617;8578;234;932;1710;5738;1944;6670
240130;201809;3370;7427;2885;6728;60;194;2624;6005;2684;6199
240140;201809;2017;6082;1715;5497;184;683;1128;3529;1312;4212
240145;201809;6127;17823;5207;16213;737;2423;3287;10317;4024;12740
240150;201809;854;2565;781;2416;62;234;605;1802;667;2036
240160;201809;1409;4337;1207;3926;66;296;868;2814;934;3110
240165;201809;878;2485;755;2250;70;215;571;1694;641;1909
240170;201809;2325;6612;1989;5998;226;762;1267;3693;1493;4455
240180;201809;3033;8917;2443;7766;500;1547;1271;4195;1771;5742
240185;201809;1223;4046;1115;3867;59;264;910;3120;969;3384
240190;201809;991;2995;877;2806;27;119;720;2272;747;2391
240200;201809;10328;27734;8669;24849;1223;3662;4576;13067;5799;16729
240210;201809;2835;7449;2536;6961;53;217;2120;5627;2173;5844
240220;201809;7169;22560;6518;21542;481;2043;4897;15929;5378;17972
240230;201809;5729;14801;4698;13053;244;647;3734;10370;3978;11017
240240;201809;2175;7344;1486;5557;134;442;705;2908;839;3350
240250;201809;2785;7718;2548;7366;152;422;2051;5952;2203;6374
240260;201809;13084;40096;11532;37373;1738;5539;7095;23931;8833;29470
240270;201809;2212;6627;1995;6288;109;298;1605;5182;1714;5480
240280;201809;1613;4235;1382;3886;50;149;1127;3110;1177;3259
240290;201809;1194;3542;993;3109;40;193;682;1980;722;2173
240300;201809;2147;5637;1563;4498;87;269;991;2772;1078;3041
240310;201809;8714;23577;7218;20958;907;2753;3987;11491;4894;14244
240320;201809;1990;5518;1481;4506;29;136;1121;3239;1150;3375
240325;201809;28937;80651;22780;69674;5815;18582;7380;23507;13195;42089
240330;201809;1511;4347;1238;3791;47;165;870;2551;917;2716
240340;201809;1922;4658;1577;4125;65;164;1275;3279;1340;3443
240350;201809;2008;5407;1882;5256;33;118;1687;4727;1720;4845
240360;201809;7582;21988;6754;20642;1123;3406;4110;13080;5233;16486
240370;201809;1975;5343;1550;4479;100;306;1041;2945;1141;3251
240375;201809;885;2262;756;2015;29;116;601;1522;630;1638
240380;201809;2259;6483;1656;5127;153;486;976;2966;1129;3452
240390;201809;938;2467;690;1951;17;50;470;1246;487;1296
240400;201809;1360;3686;1096;3181;37;142;791;2223;828;2365
240410;201809;538;1710;467;1549;53;214;268;864;321;1078
240420;201809;4579;16690;4091;15579;614;2808;2219;8229;2833;11037
240430;201809;3248;8869;2804;8003;247;814;2028;5572;2275;6386
240440;201809;2515;5779;2135;5242;154;378;1640;3968;1794;4346
240450;201809;4164;11742;3388;10292;343;1181;2018;5935;2361;7116
240460;201809;2920;8513;2717;8194;246;765;2170;6549;2416;7314
240470;201809;3509;10787;2779;9273;356;1225;1586;5289;1942;6514
240480;201809;533;1468;385;1168;36;116;183;540;219;656
240485;201809;2061;6096;1717;5411;187;621;1085;3429;1272;4050
240490;201809;1745;4373;1399;3768;53;114;1134;3074;1187;3188
240500;201809;2165;5848;1901;5464;49;175;1629;4638;1678;4813
240510;201809;1631;4420;1488;4210;77;254;1256;3486;1333;3740
240520;201809;1272;3328;1065;3035;39;139;873;2433;912;2572
240530;201809;1918;5967;1770;5697;112;410;1407;4508;1519;4918
240540;201809;2161;5565;1923;5203;86;221;1637;4422;1723;4643
240550;201809;656;1857;602;1756;36;120;454;1291;490;1411
240560;201809;3231;8675;2778;8075;292;763;2036;6033;2328;6796
240570;201809;2841;7533;1942;5540;265;814;877;2278;1142;3092
240580;201809;7487;22342;6855;21235;521;1734;5567;17172;6088;18906
240590;201809;676;1834;585;1674;16;57;453;1271;469;1328
240600;201809;1711;4727;1268;3802;74;260;817;2346;891;2606
240610;201809;4329;11962;3676;10753;166;569;2750;7895;2916;8464
240615;201809;1055;2973;849;2538;71;249;570;1617;641;1866
240620;201809;1823;5212;1575;4756;115;299;1238;3753;1353;4052
240630;201809;2012;5898;1809;5542;144;369;1256;3975;1400;4344
240640;201809;893;2497;728;2216;38;158;527;1551;565;1709
240650;201809;3758;10686;3360;10014;220;663;2623;7780;2843;8443
240660;201809;2738;7447;2480;7115;64;253;2243;6335;2307;6588
240670;201809;2413;6973;2009;6140;155;518;1295;3847;1450;4365
240680;201809;1570;4317;1260;3765;68;258;926;2662;994;2920
240690;201809;872;2267;696;1955;16;61;568;1539;584;1600
240700;201809;2354;6876;1965;6170;75;313;1551;4764;1626;5077
240710;201809;15680;41665;13397;37666;2431;6659;7540;21624;9971;28283
240720;201809;5138;13458;4474;12401;567;1683;2965;8041;3532;9724
240725;201809;1038;3057;808;2545;37;128;555;1707;592;1835
240730;201809;2037;5892;1754;5318;92;302;1357;4040;1449;4342
240740;201809;1841;5043;1543;4481;64;263;1153;3162;1217;3425
240750;201809;2258;7621;1911;6871;321;1234;1018;3700;1339;4934
240760;201809;1493;3722;1062;3038;61;147;821;2373;882;2520
240770;201809;2970;8569;2651;8107;124;491;2167;6506;2291;6997
240780;201809;5414;14762;4269;12848;557;1659;2574;7973;3131;9632
240790;201809;829;2415;694;2147;19;80;514;1548;533;1628
240800;201809;37165;98429;31391;89135;4916;14570;15667;44574;20583;59144
240810;201809;79276;216769;70462;201478;14183;40696;38977;112026;53160;152722
240820;201809;5474;16910;4778;15669;867;2928;2709;9081;3576;12009
240830;201809;8457;25102;7810;24057;308;1308;6457;19532;6765;20840
240840;201809;1110;2873;902;2497;62;177;649;1733;711;1910
240850;201809;1227;3518;899;2780;49;172;534;1621;583;1793
240860;201809;1202;3331;932;2807;22;98;708;2030;730;2128
240870;201809;1152;2917;907;2499;76;225;634;1711;710;1936
240880;201809;1266;4040;1169;3863;96;352;920;3005;1016;3357
240890;201809;4512;12492;3515;10542;572;1818;1750;5126;2322;6944
240895;201809;2614;8526;2364;8152;188;692;1945;6715;2133;7407
240910;201809;3110;8808;2689;7971;73;265;2223;6487;2296;6752
240920;201809;810;2441;691;2208;73;235;375;1220;448;1455
240930;201809;3541;8430;3018;7779;159;246;2428;6457;2587;6703
240933;201809;1792;4315;1477;3835;40;148;1269;3224;1309;3372
240940;201809;6112;15303;4881;13214;269;772;3562;9339;3831;10111
240950;201809;911;2845;809;2638;43;186;630;1985;673;2171
240960;201809;710;2196;634;2043;46;170;469;1472;515;1642
240970;201809;1768;4748;1476;4205;61;241;1221;3345;1282;3586
240980;201809;2888;9114;2647;8661;202;797;2006;6438;2208;7235
240990;201809;2506;7379;2304;6954;291;951;1624;4788;1915;5739
241000;201809;910;2472;752;2161;42;118;526;1501;568;1619
241010;201809;2672;8767;2482;8368;224;944;1802;5910;2026;6854
241020;201809;2022;5509;1499;4416;144;426;954;2760;1098;3186
241025;201809;1704;4973;1392;4366;76;266;916;2837;992;3103
241030;201809;2423;7765;2015;6896;213;759;1331;4537;1544;5296
241040;201809;2245;7214;2020;6830;112;496;1600;5366;1712;5862
241050;201809;1251;3559;1034;3133;39;132;793;2346;832;2478
241060;201809;725;2049;642;1885;48;144;453;1310;501;1454
241070;201809;639;1793;566;1656;20;75;450;1260;470;1335
241080;201809;1101;3169;848;2656;10;43;638;1974;648;2017
241090;201809;2004;5859;1614;5181;62;300;1274;4015;1336;4315
241100;201809;1092;3162;899;2720;45;146;630;1836;675;1982
241105;201809;1040;3167;863;2826;283;945;289;983;572;1928
241110;201809;880;2585;679;2128;38;150;451;1350;489;1500
241120;201809;7147;20963;6252;19360;1146;3392;3466;11269;4612;14661
241140;201809;3226;8638;2637;7465;155;458;1943;5324;2098;5782
241142;201809;744;2049;556;1668;33;110;320;905;353;1015
241150;201809;5583;15297;4989;14279;192;727;4049;11317;4241;12044
241160;201809;1550;4638;1364;4328;149;420;998;3225;1147;3645
241170;201809;1261;3282;1110;3023;46;161;916;2390;962;2551
241180;201809;950;2550;701;2050;77;237;412;1174;489;1411
241190;201809;1107;2969;909;2567;26;98;666;1788;692;1886
241200;201809;18589;50037;16094;46227;3171;9297;8595;24968;11766;34265
241210;201809;1343;3745;1030;3107;103;336;628;1866;731;2202
241220;201809;8497;26182;7520;24446;2086;6768;3248;11142;5334;17910
241230;201809;2867;7844;2571;7345;104;383;2154;5996;2258;6379
241240;201809;1167;3389;689;2254;52;197;322;1046;374;1243
241250;201809;5454;16312;4561;14565;192;931;3449;10558;3641;11489
241255;201809;1900;6411;1682;5931;141;595;1182;4063;1323;4658
241260;201809;4797;12791;3784;11083;99;453;2937;8370;3036;8823
241270;201809;1728;5113;1458;4578;132;491;1038;3190;1170;3681
241280;201809;2023;5273;1795;4869;74;220;1522;4082;1596;4302
241290;201809;3329;8422;2598;7199;101;378;2005;5384;2106;5762
241300;201809;1420;3921;1173;3472;43;165;787;2254;830;2419
241310;201809;1952;5190;1690;4792;33;123;1427;4032;1460;4155
241320;201809;982;3209;818;2867;101;412;500;1731;601;2143
241330;201809;1728;4523;1376;4085;33;148;1181;3483;1214;3631
241335;201809;2980;8574;2702;8068;94;337;2289;6741;2383;7078
241340;201809;1644;4859;1313;4105;290;926;576;1775;866;2701
241350;201809;1934;5763;1729;5381;118;409;1311;3991;1429;4400
241355;201809;1274;3513;1060;3111;25;95;836;2419;861;2514
241360;201809;2048;5384;1603;4497;64;205;1156;3116;1220;3321
241370;201809;1329;3769;1054;3216;75;262;698;2037;773;2299
241380;201809;647;1807;515;1549;79;235;290;877;369;1112
241390;201809;2666;8192;2444;7822;212;670;1874;6034;2086;6704
241400;201809;3519;9926;3174;9419;197;687;2586;7574;2783;8261
241410;201809;2251;6897;1914;6217;372;1260;1051;3405;1423;4665
241415;201809;1601;4773;1340;4283;91;328;957;2989;1048;3317
241420;201809;2132;7136;1838;6580;498;1918;755;2708;1253;4626
241430;201809;504;1444;371;1139;25;86;229;680;254;766
241440;201809;6889;22624;6224;21387;475;1914;4779;16187;5254;18101
241445;201809;1044;2767;960;2665;18;43;888;2512;906;2555
241450;201809;2766;7076;2454;6592;299;739;1792;4845;2091;5584
241460;201809;3519;9801;2981;8654;186;618;2106;5922;2292;6540
241470;201809;1403;3720;1116;3295;39;147;935;2730;974;2877
241475;201809;1193;3475;935;2958;33;181;691;2060;724;2241
241480;201809;2671;8603;2317;7861;828;2784;670;2623;1498;5407
241490;201809;649;1605;512;1389;28;87;353;925;381;1012
241500;201809;796;2337;686;2190;16;76;604;1914;620;1990
250010;201809;2601;7894;2170;6975;78;327;1597;4994;1675;5321
250020;201809;1580;4346;1147;3478;57;154;817;2451;874;2605
250030;201809;6648;18654;6049;17740;474;1480;4717;13599;5191;15079
250040;201809;3787;12156;3427;11460;252;1002;2519;8240;2771;9242
250050;201809;3388;9508;3111;9090;187;637;2512;7220;2699;7857
250053;201809;1145;3355;1047;3204;83;273;780;2395;863;2668
250057;201809;639;2385;608;2341;13;73;562;2172;575;2245
250060;201809;5105;14090;4709;13583;418;1165;3748;10962;4166;12127
250070;201809;3752;10968;3416;10350;68;318;2713;7963;2781;8281
250073;201809;714;2003;598;1821;12;42;486;1432;498;1474
250077;201809;2166;5965;1631;5044;103;345;1186;3632;1289;3977
250080;201809;4347;11681;3948;11116;91;351;3410;9440;3501;9791
250090;201809;2838;7411;2584;7040;79;241;2213;5950;2292;6191
250100;201809;3651;11398;3395;10915;152;635;2796;8729;2948;9364
250110;201809;4653;13302;4294;12768;383;1355;3386;9791;3769;11146
250115;201809;522;1524;454;1408;10;52;342;1018;352;1070
250120;201809;1672;5126;1466;4781;48;224;1175;3778;1223;4002
250130;201809;5256;15198;4561;14105;105;548;3773;11444;3878;11992
250135;201809;1109;3098;1012;2945;16;59;915;2655;931;2714
250140;201809;2066;6377;1976;6246;96;437;1723;5353;1819;5790
250150;201809;4570;14940;4210;14251;186;893;3411;11264;3597;12157
250153;201809;1443;3756;1212;3422;32;121;995;2749;1027;2870
250157;201809;1707;5217;1541;4879;142;464;1152;3650;1294;4114
250160;201809;3772;9667;3070;8699;39;127;2814;7948;2853;8075
250170;201809;1690;4501;1520;4244;42;160;1311;3590;1353;3750
250180;201809;17234;45167;15442;42731;887;2825;12074;32760;12961;35585
250190;201809;3861;10858;3419;10135;418;1169;2346;6926;2764;8095
250200;201809;1780;5051;1521;4633;55;203;1304;3955;1359;4158
250205;201809;764;2517;697;2405;26;131;578;1959;604;2090
250210;201809;1493;4638;1365;4430;55;270;1092;3455;1147;3725
250215;201809;1495;4303;1258;3894;61;210;803;2474;864;2684
250220;201809;689;1971;570;1790;28;113;423;1290;451;1403
250230;201809;1568;3683;1153;3037;23;82;934;2381;957;2463
250240;201809;2110;6618;1946;6334;44;188;1676;5383;1720;5571
250250;201809;4352;12507;3871;11808;109;381;3302;10020;3411;10401
250260;201809;1661;4694;1417;4271;47;161;1134;3404;1181;3565
250270;201809;1186;3687;1066;3537;78;263;799;2745;877;3008
250280;201809;3194;9208;2787;8568;100;327;2243;6879;2343;7206
250290;201809;1587;4252;1377;3948;28;77;1153;3326;1181;3403
250300;201809;5250;14624;4955;14263;233;999;4174;11585;4407;12584
250310;201809;1104;3141;949;2864;33;108;734;2178;767;2286
250320;201809;10039;25823;9048;24587;486;1465;7684;20655;8170;22120
250330;201809;2289;6743;1964;6277;145;496;1551;4894;1696;5390
250340;201809;1052;2844;935;2675;7;26;821;2315;828;2341
250350;201809;4009;11137;3636;10617;148;375;3070;9153;3218;9528
250355;201809;1933;5986;1778;5777;34;181;1610;5199;1644;5380
250360;201809;1777;5011;1618;4771;42;141;1342;3932;1384;4073
250370;201809;11641;31979;10129;29807;428;1598;8426;24394;8854;25992
250375;201809;1016;2860;914;2721;15;57;843;2518;858;2575
250380;201809;1559;4191;1463;4067;42;176;1240;3309;1282;3485
250390;201809;1749;4577;1465;4113;177;463;1024;2937;1201;3400
250400;201809;63891;164152;47721;138296;13654;41473;15689;47384;29343;88857
250403;201809;1568;4711;1450;4557;116;524;1100;3303;1216;3827
250407;201809;1191;3096;1013;2832;75;149;751;2142;826;2291
250410;201809;558;1585;493;1470;4;24;426;1242;430;1266
250415;201809;1862;5349;1653;4997;59;222;1363;4081;1422;4303
250420;201809;1186;3418;1078;3269;18;70;1017;3080;1035;3150
250430;201809;6028;15283;5288;14229;172;566;4448;11746;4620;12312
250435;201809;1367;3983;1190;3672;34;150;932;2807;966;2957
250440;201809;4311;11946;3864;11330;93;337;3369;9784;3462;10121
250450;201809;1778;4903;1520;4554;33;141;1283;3806;1316;3947
250460;201809;6958;19287;6333;18421;378;1151;5280;15355;5658;16506
250470;201809;1497;3861;1246;3497;67;212;967;2652;1034;2864
250480;201809;3657;10520;3348;10149;32;139;3087;9396;3119;9535
250485;201809;706;1627;507;1343;30;76;372;940;402;1016
250490;201809;4505;11770;4119;11288;223;731;3497;9457;3720;10188
250500;201809;1877;5330;1681;5002;79;260;1383;4101;1462;4361
250510;201809;5254;13483;4617;12640;81;268;4163;11389;4244;11657
250520;201809;1755;4944;1537;4623;165;534;1064;3164;1229;3698
250523;201809;2132;5355;1938;5114;70;291;1685;4323;1755;4614
250527;201809;1644;4336;1517;4182;41;130;1361;3754;1402;3884
250530;201809;574;1619;505;1521;14;50;448;1344;462;1394
250535;201809;1295;3886;1199;3700;37;174;981;2946;1018;3120
250540;201809;2693;6634;2294;6177;59;167;2017;5446;2076;5613
250550;201809;799;2613;722;2484;26;122;579;1935;605;2057
250560;201809;1603;4569;1455;4363;48;173;1229;3602;1277;3775
250570;201809;2530;7724;2216;7147;79;348;1768;5558;1847;5906
250580;201809;1029;2705;942;2577;54;191;779;2076;833;2267
250590;201809;782;2286;710;2174;19;89;606;1826;625;1915
250600;201809;7357;20173;6615;19084;348;974;5571;16073;5919;17047
250610;201809;2910;8275;2676;7938;134;496;2228;6518;2362;7014
250620;201809;664;1863;587;1717;21;93;461;1302;482;1395
250625;201809;2489;7360;2293;7053;54;268;1946;5830;2000;6098
250630;201809;9271;26801;7957;24327;986;3182;5173;15467;6159;18649
250640;201809;3243;9484;3021;9172;107;488;2544;7502;2651;7990
250650;201809;864;2178;734;2003;36;104;615;1644;651;1748
250660;201809;1585;4057;1401;3805;42;112;1202;3210;1244;3322
250670;201809;2235;7161;2108;6942;56;279;1827;5878;1883;6157
250680;201809;5675;13505;5115;12857;124;451;4611;11285;4735;11736
250690;201809;6395;15160;5816;14413;145;359;5272;12964;5417;13323
250700;201809;4154;11945;3743;11306;358;1115;2865;8592;3223;9707
250710;201809;4281;12595;3763;11889;299;1037;2827;8954;3126;9991
250720;201809;2692;7184;2445;6825;47;217;2192;6031;2239;6248
250730;201809;3841;10512;3449;9985;149;543;2898;8163;3047;8706
250740;201809;1878;4913;1565;4471;109;362;1270;3551;1379;3913
250750;201809;94126;246826;83423;231327;8057;24501;59678;162393;67735;186894
250760;201809;2300;6070;2027;5641;127;367;1563;4246;1690;4613
250770;201809;3656;11623;3361;11241;274;1034;2514;8335;2788;9369
250780;201809;1660;4621;1401;4140;96;323;1028;2972;1124;3295
250790;201809;2292;7097;2078;6759;281;990;1367;4419;1648;5409
250800;201809;2388;6496;2091;6026;107;243;1737;5033;1844;5276
250810;201809;1211;3338;1008;3043;33;105;864;2620;897;2725
250820;201809;1760;5426;1705;5346;55;233;1566;4848;1621;5081
250830;201809;5155;16020;4600;14882;338;1305;3296;10406;3634;11711
250840;201809;802;2557;690;2319;20;86;501;1685;521;1771
250850;201809;1815;5496;1627;5175;47;240;1364;4213;1411;4453
250855;201809;956;2817;832;2612;69;250;617;1895;686;2145
250860;201809;3000;9269;2502;8402;437;1571;1354;4596;1791;6167
250870;201809;1042;2890;895;2626;46;169;725;2098;771;2267
250880;201809;1505;4035;1251;3650;153;461;843;2454;996;2915
250890;201809;9221;25877;8616;25033;564;2226;7030;19672;7594;21898
250900;201809;2698;7981;2337;7302;97;360;1930;5904;2027;6264
250905;201809;2174;6336;2058;6171;54;201;1865;5567;1919;5768
250910;201809;5371;14194;4635;13272;120;432;4034;11529;4154;11961
250915;201809;1869;4668;1444;4225;17;44;1333;3969;1350;4013
250920;201809;3132;8482;2882;8088;314;834;2136;5938;2450;6772
250930;201809;2096;5815;1941;5592;72;294;1661;4661;1733;4955
250933;201809;1090;3377;974;3155;27;145;738;2313;765;2458
250937;201809;683;1926;573;1726;30;105;446;1348;476;1453
250939;201809;1639;4583;1461;4298;55;196;1183;3418;1238;3614
250940;201809;3723;10410;3390;9907;68;279;2917;8440;2985;8719
250950;201809;1540;4092;1291;3771;31;137;1118;3217;1149;3354
250960;201809;1051;3174;955;3020;36;162;772;2357;808;2519
250970;201809;8034;21580;6978;19858;395;1288;5420;15180;5815;16468
250980;201809;2402;6642;2197;6274;59;241;1842;5118;1901;5359
250990;201809;1807;5851;1614;5440;82;380;1236;4075;1318;4455
251000;201809;2038;5776;1693;5224;30;129;1431;4370;1461;4499
251010;201809;2550;7334;2339;7009;37;156;2119;6329;2156;6485
251020;201809;1656;4464;1544;4327;36;124;1411;3922;1447;4046
251030;201809;953;2625;832;2395;40;125;592;1655;632;1780
251040;201809;1797;5299;1552;4877;57;276;1257;3835;1314;4111
251050;201809;1072;2950;893;2610;63;206;655;1848;718;2054
251060;201809;1027;2244;769;1909;12;53;646;1570;658;1623
251065;201809;415;1154;344;1055;15;50;252;735;267;785
251070;201809;732;2064;643;1950;12;45;559;1682;571;1727
251080;201809;18118;47894;15181;43514;2209;6678;9538;27511;11747;34189
251090;201809;2679;7866;2297;7152;66;256;1856;5723;1922;5979
251100;201809;801;2493;712;2341;36;162;530;1666;566;1828
251110;201809;1647;4565;1444;4185;54;150;1124;3223;1178;3373
251120;201809;6674;20270;5920;19190;278;1174;4676;15009;4954;16183
251130;201809;3655;8842;3326;8458;187;502;2947;7462;3134;7964
251140;201809;4122;11837;3780;11353;114;438;3134;9319;3248;9757
251150;201809;2565;7676;2358;7355;124;558;1931;5815;2055;6373
251160;201809;1969;6105;1790;5815;127;430;1465;4737;1592;5167
251170;201809;1497;4236;1352;4068;42;155;1195;3575;1237;3730
251180;201809;2472;6946;2126;6447;193;658;1444;4320;1637;4978
251190;201809;4319;11482;4069;11191;64;275;3740;10107;3804;10382
251200;201809;3937;12273;3648;11904;88;370;3263;10685;3351;11055
251203;201809;919;3037;881;2957;39;178;681;2211;720;2389
251207;201809;1006;2942;814;2592;25;129;581;1782;606;1911
251210;201809;6998;18883;5930;17506;267;762;4803;14317;5070;15079
251220;201809;1143;2845;909;2523;49;132;711;1985;760;2117
251230;201809;4520;12514;4004;11735;155;562;3292;9435;3447;9997
251240;201809;3356;9562;2896;8879;179;592;2213;6645;2392;7237
251250;201809;9519;26491;8603;25068;742;2338;6412;18079;7154;20417
251260;201809;461;1405;419;1325;14;63;326;1002;340;1065
251270;201809;3930;12650;3606;12214;116;524;3127;10617;3243;11141
251272;201809;1299;3611;1208;3479;35;133;1073;3047;1108;3180
251274;201809;872;2536;721;2260;49;206;500;1483;549;1689
251275;201809;1185;3354;1030;3094;46;197;769;2201;815;2398
251276;201809;1236;3384;1121;3238;39;172;950;2676;989;2848
251278;201809;532;1550;487;1465;36;87;370;1136;406;1223
251280;201809;2163;6101;1959;5776;53;216;1625;4677;1678;4893
251290;201809;5426;13921;5139;13540;242;873;4426;11221;4668;12094
251300;201809;783;2417;732;2341;15;64;624;1989;639;2053
251310;201809;2644;7745;2428;7399;73;325;2006;5992;2079;6317
251315;201809;1620;5215;1507;5019;74;283;1175;3847;1249;4130
251320;201809;1586;4267;1133;3494;39;139;834;2562;873;2701
251330;201809;1923;4655;1596;4263;24;86;1471;3940;1495;4026
251335;201809;1116;3732;1035;3610;33;138;895;3090;928;3228
251340;201809;3541;9352;2938;8547;125;415;2199;6345;2324;6760
251350;201809;1023;3118;943;2986;35;160;799;2455;834;2615
251360;201809;1759;5170;1477;4791;27;132;1288;4193;1315;4325
251365;201809;704;2023;566;1728;15;52;439;1339;454;1391
251370;201809;21340;61118;19829;59047;2233;7034;14182;42317;16415;49351
251380;201809;1171;3444;1043;3236;23;119;891;2673;914;2792
251385;201809;706;1846;558;1581;25;79;415;1124;440;1203
251390;201809;5958;18531;5231;17199;838;2913;3044;9874;3882;12787
251392;201809;916;2600;783;2378;25;115;616;1829;641;1944
251394;201809;618;1924;530;1772;25;101;406;1342;431;1443
251396;201809;683;1894;592;1739;27;75;413;1202;440;1277
251398;201809;854;2244;631;1849;16;68;492;1408;508;1476
251400;201809;1125;2926;931;2657;31;117;722;1991;753;2108
251410;201809;1535;3701;1296;3366;27;122;1115;2802;1142;2924
251420;201809;1811;4973;1519;4628;54;215;1213;3628;1267;3843
251430;201809;1501;4751;1349;4500;43;206;1174;3867;1217;4073
251440;201809;1088;3121;892;2749;20;74;721;2214;741;2288
251445;201809;1458;4262;1372;4136;66;279;1141;3318;1207;3597
251450;201809;4235;12875;3877;12354;96;423;3296;10384;3392;10807
251455;201809;911;2808;830;2658;37;157;639;2000;676;2157
251460;201809;869;2554;778;2406;32;120;644;1997;676;2117
251465;201809;416;1260;357;1129;13;59;281;867;294;926
251470;201809;1149;3237;878;2666;81;268;538;1571;619;1839
251480;201809;930;2515;790;2279;26;118;593;1641;619;1759
251490;201809;1802;4958;1470;4489;69;222;1078;3280;1147;3502
251500;201809;1793;5435;1696;5260;71;281;1462;4467;1533;4748
251510;201809;2380;7654;2108;7075;173;680;1416;4635;1589;5315
251520;201809;935;2522;716;2084;69;185;467;1342;536;1527
251530;201809;13079;33073;11456;30979;142;725;10299;27390;10441;28115
251540;201809;2714;8232;2512;7838;128;477;2017;6162;2145;6639
251550;201809;3526;8675;2827;7769;73;231;2430;6647;2503;6878
251560;201809;561;1719;507;1632;84;289;326;1000;410;1289
251570;201809;887;2581;742;2290;22;109;567;1669;589;1778
251580;201809;1849;4584;1656;4309;92;281;1415;3577;1507;3858
251590;201809;1532;4098;1348;3865;55;190;1102;3072;1157;3262
251593;201809;912;2723;840;2608;101;333;526;1589;627;1922
251597;201809;1948;5717;1847;5582;32;126;1650;4909;1682;5035
251600;201809;6198;17257;5588;16327;173;569;4720;13572;4893;14141
251610;201809;3203;9267;2784;8493;315;931;1922;5916;2237;6847
251615;201809;1160;3023;943;2660;28;105;750;2054;778;2159
251620;201809;16985;41083;13927;37499;188;457;12189;33772;12377;34229
251630;201809;4494;10950;3697;9854;196;573;2921;7723;3117;8296
251640;201809;2009;5842;1858;5557;55;253;1604;4677;1659;4930
251650;201809;3989;10740;3558;10190;154;492;3076;8769;3230;9261
251660;201809;3340;10184;2980;9537;104;495;2502;7800;2606;8295
251670;201809;4109;11668;3629;10996;42;207;3338;10039;3380;10246
251675;201809;622;1871;578;1812;87;303;382;1182;469;1485
251680;201809;2601;7134;2128;6445;55;213;1716;5153;1771;5366
251690;201809;3128;9003;2722;8244;82;288;2057;6099;2139;6387
251700;201809;1812;5668;1694;5509;60;301;1459;4627;1519;4928
251710;201809;803;2128;549;1585;57;204;313;873;370;1077
251720;201809;1300;3741;1093;3370;34;150;842;2499;876;2649
251740;201809;650;1802;506;1537;41;152;362;1056;403;1208
260005;201809;28088;61187;23246;54819;2037;4876;17362;40352;19399;45228
260010;201809;9579;25449;7976;23084;504;1539;5006;14719;5510;16258
260020;201809;6689;16223;5697;14788;147;625;4735;12027;4882;12652
260030;201809;6236;16877;5377;15523;213;743;4291;12297;4504;13040
260040;201809;7799;21620;6538;19642;634;1910;4445;13558;5079;15468
260050;201809;12340;34528;11318;33299;354;1118;9976;29822;10330;30940
260060;201809;3839;10122;3316;9234;223;626;2599;7239;2822;7865
260070;201809;9887;26321;8677;24467;534;1778;6684;18505;7218;20283
260080;201809;6459;15216;5660;14033;183;581;4716;11409;4899;11990
260090;201809;4951;12940;4461;12286;656;1784;3114;8666;3770;10450
260100;201809;3098;8375;2638;7684;97;384;2168;6233;2265;6617
260105;201809;5136;13818;4582;13036;166;628;3780;10507;3946;11135
260110;201809;22090;59836;20011;56963;1097;3441;16725;47034;17822;50475
260120;201809;13412;37599;11568;34631;1615;4900;7232;22135;8847;27035
260130;201809;2964;7984;2698;7574;195;601;2034;5574;2229;6175
260140;201809;12938;30236;11226;28064;624;1692;9314;23047;9938;24739
260150;201809;3418;8400;2964;7835;141;484;2491;6429;2632;6913
260160;201809;6412;17369;5487;16153;119;491;4809;14237;4928;14728
260170;201809;17185;44906;15263;42118;1655;4388;11253;31279;12908;35667
260180;201809;3206;9212;2901;8756;122;431;2462;7337;2584;7768
260190;201809;17032;36384;14957;33934;200;623;13220;29439;13420;30062
260200;201809;10890;26857;9547;25157;461;1249;8203;21609;8664;22858
260210;201809;11814;34036;10116;31262;377;1502;8142;24984;8519;26486
260220;201809;9891;24909;9263;24130;221;764;8297;21368;8518;22132
260230;201809;10101;26201;8865;24461;288;933;7305;19874;7593;20807
260240;201809;2756;8256;2421;7693;187;661;1851;5840;2038;6501
260250;201809;2131;5812;1848;5393;88;297;1455;4151;1543;4448
260260;201809;12575;33795;11079;31469;511;1804;8708;24235;9219;26039
260270;201809;3634;9743;3297;9275;154;665;2656;7221;2810;7886
260280;201809;12728;39447;11653;37904;574;2292;9962;32153;10536;34445
260290;201809;36190;97717;31868;91060;4038;11919;20905;59268;24943;71187
260300;201809;9185;25772;8089;24171;270;1163;6659;19755;6929;20918
260310;201809;4550;12417;4088;11773;426;1169;3045;8924;3471;10093
260320;201809;7263;21589;6464;20176;296;957;5294;16542;5590;17499
260330;201809;2512;7832;2261;7318;75;287;1818;5751;1893;6038
260340;201809;1986;5429;1735;5044;32;139;1494;4267;1526;4406
260345;201809;23239;64347;20159;59501;3967;12466;9726;28167;13693;40633
260350;201809;4997;12572;4488;11914;140;435;3941;10381;4081;10816
260360;201809;2422;6529;2215;6158;56;263;1549;4206;1605;4469
260370;201809;5335;15806;4675;14655;224;885;3602;11161;3826;12046
260380;201809;4791;14705;4186;13705;204;807;3143;10146;3347;10953
260390;201809;4172;12905;3597;11720;262;933;2480;7956;2742;8889
260392;201809;3375;10951;3023;10484;147;813;2453;8408;2600;9221
260400;201809;15225;38230;13574;35977;798;2434;10544;27158;11342;29592
260410;201809;61117;159920;49797;143392;10501;31845;22808;67228;33309;99073
260415;201809;4102;11576;3525;10514;108;491;2704;7781;2812;8272
260420;201809;12552;27226;10827;25252;209;611;9751;22531;9960;23142
260430;201809;2830;8813;2440;8066;134;530;1710;5583;1844;6113
260440;201809;3515;9669;3072;8869;131;484;2447;6875;2578;7359
260450;201809;5522;14412;5047;13817;284;693;4212;11655;4496;12348
260460;201809;5159;16199;4515;14922;567;2129;2707;8759;3274;10888
260470;201809;4915;13072;4215;12259;132;339;3769;11200;3901;11539
260480;201809;4060;10926;3445;10053;313;1098;2317;6812;2630;7910
260490;201809;5217;12538;4569;11479;85;318;4034;9876;4119;10194
260500;201809;5954;15587;5062;14254;484;1307;3527;10034;4011;11341
260510;201809;9234;23125;7911;21296;195;676;6955;18481;7150;19157
260515;201809;4297;12240;3301;10297;167;611;2181;6619;2348;7230
260520;201809;17190;41131;15397;38701;994;2569;12429;30904;13423;33473
260530;201809;9294;27530;8120;25654;224;999;6942;21697;7166;22696
260540;201809;6783;15238;6078;14394;442;924;5195;12421;5637;13345
260545;201809;36;108;16;68;6;26;4;19;10;45
260550;201809;2768;8224;2340;7391;183;797;1512;4643;1695;5440
260560;201809;5935;15414;5131;14270;153;646;4303;11704;4456;12350
260570;201809;7263;20935;6519;19873;515;1685;5092;15471;5607;17156
260580;201809;4258;10526;3815;9896;41;167;3485;8956;3526;9123
260590;201809;6656;15865;5702;14785;272;735;4739;12330;5011;13065
260600;201809;29263;78933;24372;71231;1500;4902;18008;51964;19508;56866
260610;201809;6738;18599;6211;17847;462;1477;4682;13295;5144;14772
260620;201809;14863;41513;13343;39194;1747;5573;8875;25639;10622;31212
260630;201809;2310;6344;1918;5716;44;197;1575;4616;1619;4813
260640;201809;19016;46210;16435;43124;990;2855;12888;33489;13878;36344
260650;201809;5456;15660;4660;14491;182;786;3900;11949;4082;12735
260660;201809;7225;19444;6288;18210;170;744;5347;15165;5517;15909
260670;201809;2191;5761;1814;5203;96;278;1319;3742;1415;4020
260680;201809;24344;61446;20705;55893;2166;6146;13248;35227;15414;41373
260690;201809;3581;9353;2966;8399;135;469;2371;6613;2506;7082
260700;201809;5856;17405;5602;17111;22;43;5453;16815;5475;16858
260710;201809;1308;3519;1207;3390;54;187;908;2583;962;2770
260720;201809;20148;55484;18014;52335;2867;8554;11334;32784;14201;41338
260730;201809;7090;21466;6331;20353;355;1350;5211;16468;5566;17818
260740;201809;1302;3703;1101;3378;25;130;868;2638;893;2768
260750;201809;6775;19313;5932;18208;142;437;5350;16651;5492;17088
260760;201809;5463;13357;4764;12468;230;665;3884;10211;4114;10876
260765;201809;7413;22892;6686;21814;617;2595;4638;14675;5255;17270
260770;201809;3734;9836;3219;8960;107;369;2552;7012;2659;7381
260775;201809;5089;13999;4635;13318;269;1040;3543;9823;3812;10863
260780;201809;3552;10802;3218;10251;351;1306;2051;6348;2402;7654
260790;201809;110374;258614;94314;236834;16040;39678;57362;144464;73402;184142
260795;201809;2987;8164;2599;7588;146;482;1974;5775;2120;6257
260800;201809;5373;12700;4869;11981;149;507;4315;10253;4464;10760
260805;201809;3543;10432;3022;9508;226;831;2129;6575;2355;7406
260810;201809;6488;17927;5864;16742;569;1630;4256;11916;4825;13546
260820;201809;4239;10526;3784;9880;222;775;2977;7515;3199;8290
260825;201809;2805;8687;2473;8077;143;555;1840;5964;1983;6519
260830;201809;4234;12541;3541;11247;498;1467;2281;7455;2779;8922
260840;201809;4063;11056;3615;10398;196;584;3000;8553;3196;9137
260845;201809;3957;10960;3645;10405;285;801;2707;7687;2992;8488
260850;201809;4750;14046;4110;12736;467;1535;2502;7586;2969;9121
260860;201809;3414;9940;2917;9017;109;412;2375;7201;2484;7613
260870;201809;4362;10807;3818;10121;107;412;3376;8762;3483;9174
260875;201809;6500;17271;5488;15650;687;1909;3639;10454;4326;12363
260880;201809;9557;27331;8458;25441;461;1395;6780;20510;7241;21905
260890;201809;13040;35004;11692;32978;960;3008;8369;23168;9329;26176
260900;201809;5127;15229;4392;13974;299;1109;3033;9505;3332;10614
260910;201809;3084;8681;2734;8109;123;442;2137;6263;2260;6705
260915;201809;5019;15085;4491;14439;85;330;4086;13195;4171;13525
260920;201809;3175;8714;2834;8280;122;417;2384;6935;2506;7352
260930;201809;3447;11305;3074;10617;193;789;2400;8200;2593;8989
260940;201809;14145;34970;12474;32488;952;2691;9304;23817;10256;26508
260950;201809;6290;17987;5106;15696;631;2167;2836;8283;3467;10450
260960;201809;61408;147629;50882;132921;7424;20543;30246;78045;37670;98588
260970;201809;5023;13988;4538;13335;176;509;3545;10484;3721;10993
260980;201809;4329;13099;3918;12565;72;285;3600;11576;3672;11861
260990;201809;17014;49662;14899;46725;891;3171;11607;36251;12498;39422
261000;201809;15317;38565;13196;35565;621;2180;10150;26897;10771;29077
261010;201809;2447;6452;2175;6094;76;212;1924;5390;2000;5602
261020;201809;6288;17672;5438;16059;331;1108;4247;12150;4578;13258
261030;201809;4022;11389;3528;10588;224;650;2789;8328;3013;8978
261040;201809;4999;15324;4161;13560;246;970;3002;9581;3248;10551
261050;201809;7528;20507;6842;19340;640;1565;4762;13617;5402;15182
261060;201809;13029;34452;11693;32592;554;1752;9530;26261;10084;28013
261070;201809;56401;127832;47515;115748;3587;8532;35433;85470;39020;94002
261080;201809;5885;15428;5530;14929;178;503;5057;13650;5235;14153
261090;201809;17256;43533;15686;41458;434;1469;13481;35226;13915;36695
261100;201809;7817;22898;6883;21431;663;2221;4902;15336;5565;17557
261110;201809;56912;165877;49282;153195;10324;33628;25210;79074;35534;112702
261120;201809;3683;9430;3208;8817;90;284;2849;7832;2939;8116
261130;201809;7357;17975;6530;16925;127;409;5844;15042;5971;15451
261140;201809;3429;8320;3089;7851;221;619;2457;6133;2678;6752
261150;201809;5174;14085;4598;13162;119;475;3954;11137;4073;11612
261153;201809;1928;5758;1663;5318;85;345;1143;3610;1228;3955
261160;201809;199361;485066;168274;440842;43646;117601;68821;185447;112467;303048
261170;201809;5812;15401;5269;14595;354;956;4207;11644;4561;12600
261180;201809;9636;25020;8616;23662;580;1763;6244;16963;6824;18726
261190;201809;4689;14164;4277;13493;309;1244;3159;9663;3468;10907
261200;201809;3334;7866;2974;7397;192;490;2444;6008;2636;6498
261210;201809;1888;4681;1612;4292;56;170;1385;3639;1441;3809
261220;201809;13378;39353;11181;35060;1567;5315;6319;19662;7886;24977
261230;201809;4471;13167;3759;12233;93;400;3176;10431;3269;10831
261240;201809;4955;13187;4379;12265;277;782;3569;9945;3846;10727
261245;201809;3452;10085;2968;9223;116;542;2349;7012;2465;7554
261247;201809;2888;8784;2463;7989;162;598;1733;5551;1895;6149
261250;201809;19647;47589;17243;44712;2166;5274;12366;33021;14532;38295
261255;201809;3933;11871;3397;10843;169;737;2552;7873;2721;8610
261260;201809;12711;34602;11016;32422;436;1748;9314;27136;9750;28884
261270;201809;3850;10534;3450;9925;233;802;2796;7880;3029;8682
261280;201809;2526;7311;2237;6796;96;410;1775;5238;1871;5648
261290;201809;2872;7838;2512;7375;113;449;2038;5982;2151;6431
261300;201809;11558;33878;9906;30913;691;2668;6989;21326;7680;23994
261310;201809;7463;20737;6647;19522;916;2903;4488;12872;5404;15775
261320;201809;5867;17009;5166;15767;106;428;4315;12949;4421;13377
261330;201809;5698;14719;5296;14174;203;723;4615;12119;4818;12842
261340;201809;4082;12228;3567;11483;211;880;2756;8764;2967;9644
261350;201809;8254;25026;7603;23946;154;765;6287;19391;6441;20156
261360;201809;8197;20474;7002;18779;306;956;5634;14723;5940;15679
261370;201809;19582;52906;17242;49482;2939;8450;10429;30221;13368;38671
261380;201809;3899;12394;3530;11680;493;1814;2300;7470;2793;9284
261390;201809;15740;46211;13607;42638;1398;4759;8783;27422;10181;32181
261400;201809;4583;14984;4025;13792;216;980;2959;9906;3175;10886
261410;201809;9002;23732;7698;21606;528;1494;6143;17145;6671;18639
261420;201809;6909;21992;6424;21345;964;3639;4275;14094;5239;17733
261430;201809;3332;9693;2838;8920;114;451;2329;7254;2443;7705
261440;201809;1448;4446;1253;4052;51;247;879;2740;930;2987
261450;201809;14000;38741;12901;37102;269;1050;11025;31608;11294;32658
261460;201809;7067;19909;6444;19017;240;854;5538;16246;5778;17100
261470;201809;4170;10643;3728;10054;50;238;3149;8487;3199;8725
261480;201809;4687;14964;4102;13972;257;1015;3113;10398;3370;11413
261485;201809;4891;14254;4271;13231;407;1493;2926;8830;3333;10323
261500;201809;5493;14784;4879;13924;494;1330;3380;9960;3874;11290
261510;201809;1804;5585;1559;5130;85;324;1150;3815;1235;4139
261520;201809;2416;7495;2258;7184;89;350;1560;5016;1649;5366
261530;201809;10514;32654;8900;29480;1341;5087;4166;13461;5507;18548
261540;201809;7478;22224;6801;21145;1148;3494;3962;12783;5110;16277
261550;201809;3540;9593;3134;8934;250;821;2231;6218;2481;7039
261560;201809;7451;22832;6588;21570;431;1750;4947;16081;5378;17831
261570;201809;3326;9306;2769;8368;224;812;1878;5557;2102;6369
261580;201809;6375;17329;5787;16485;141;632;5216;14649;5357;15281
261590;201809;2626;6900;2125;6154;87;280;1590;4564;1677;4844
261600;201809;5153;13347;4332;12140;447;1159;2900;8396;3347;9555
261610;201809;2408;6520;2031;5938;96;331;1538;4483;1634;4814
261618;201809;2462;6377;2221;6059;94;285;1793;4824;1887;5109
261620;201809;3871;11565;3623;11177;799;2267;2231;7194;3030;9461
261630;201809;6590;18639;5581;16772;491;1839;3588;10228;4079;12067
261640;201809;35978;83237;31521;77685;1829;4007;24890;62658;26719;66665
261650;201809;4055;10521;3626;9962;163;602;2701;7336;2864;7938
270010;201809;4223;14817;3786;14014;198;1099;2938;10578;3136;11677
270020;201809;3925;10193;3491;9613;227;752;2850;7640;3077;8392
270030;201809;34163;95961;29834;88988;4548;13454;19162;57612;23710;71066
270040;201809;11141;30423;9717;28702;449;1762;8077;23578;8526;25340
270050;201809;5454;12702;4664;11821;193;499;4144;10528;4337;11027
270060;201809;1987;5277;1744;4969;142;389;1375;3962;1517;4351
270070;201809;4504;13138;3985;12395;141;663;3365;10214;3506;10877
270080;201809;1424;4048;1185;3615;74;255;869;2544;943;2799
270090;201809;1871;5817;1662;5405;91;412;1288;4018;1379;4430
270100;201809;5432;15156;4800;14191;259;989;3856;11152;4115;12141
270110;201809;3231;8057;2600;7298;130;380;2065;5962;2195;6342
270120;201809;3017;8174;2644;7712;89;334;2314;6709;2403;7043
270130;201809;5233;14059;4602;13338;201;649;3840;11186;4041;11835
270135;201809;1988;4913;1737;4620;67;177;1561;4148;1628;4325
270140;201809;9849;22892;8076;20472;381;1426;6578;15781;6959;17207
270150;201809;2651;8056;2547;7918;10;23;2508;7806;2518;7829
270160;201809;5392;15954;4791;15215;79;470;4389;13751;4468;14221
270170;201809;3435;10274;3002;9685;255;1094;2179;6762;2434;7856
270180;201809;2221;6986;2053;6756;56;271;1797;5809;1853;6080
270190;201809;1640;5025;1506;4838;69;292;1268;4029;1337;4321
270200;201809;2459;7506;2132;7070;142;574;1595;5147;1737;5721
270210;201809;5573;13784;4906;13000;173;593;4415;11530;4588;12123
270220;201809;1391;3931;1177;3622;227;748;653;1998;880;2746
270230;201809;9176;27120;7830;24948;824;3059;5270;16383;6094;19442
270235;201809;5715;18144;5144;17166;219;946;4185;13786;4404;14732
270240;201809;10390;28771;8607;26475;1043;3491;6156;18910;7199;22401
270250;201809;2858;7449;2538;7005;251;658;1921;5364;2172;6022
270255;201809;4606;13338;3545;11367;197;821;2543;7960;2740;8781
270260;201809;5551;16809;5174;16207;135;656;4496;13658;4631;14314
270270;201809;991;2715;916;2617;131;378;638;1817;769;2195
270280;201809;3779;9452;3070;8550;454;843;2152;6393;2606;7236
270290;201809;7708;24973;7010;23829;310;1431;5902;19766;6212;21197
270300;201809;4028;11092;3199;10184;204;701;2392;7702;2596;8403
270310;201809;6971;20108;6118;18770;183;930;5183;15374;5366;16304
270320;201809;5660;16793;5048;15666;614;2042;3516;10640;4130;12682
270330;201809;3725;12569;3414;12122;279;1095;2680;9511;2959;10606
270340;201809;1604;4584;1380;4282;59;198;1133;3481;1192;3679
270350;201809;1895;4660;1598;4297;190;544;1094;2976;1284;3520
270360;201809;2360;6316;2147;6065;69;193;1973;5608;2042;5801
270370;201809;1386;4353;1265;4133;55;251;1011;3247;1066;3498
270375;201809;3055;7406;2611;6869;28;86;2419;6356;2447;6442
270380;201809;5612;16613;4873;15609;464;1557;3445;11264;3909;12821
270390;201809;1151;3056;967;2803;26;124;798;2267;824;2391
270400;201809;6084;16797;5250;15479;236;806;4047;11601;4283;12407
270410;201809;4472;13570;3969;12704;237;901;3135;9886;3372;10787
270420;201809;5536;16752;5099;16136;192;845;4305;13356;4497;14201
270430;201809;134075;340709;108945;307645;25226;75025;48295;139292;73521;214317
270440;201809;4771;13206;4119;12400;125;546;3468;10330;3593;10876
270450;201809;6588;18556;5963;17789;287;1098;5006;14783;5293;15881
270460;201809;3602;8390;3183;7888;51;215;2968;7208;3019;7423
270470;201809;10672;31539;9518;29849;943;3093;6900;21892;7843;24985
270480;201809;2822;7836;2428;7227;164;624;1916;5513;2080;6137
270490;201809;967;2822;859;2690;60;219;671;2071;731;2290
270500;201809;4798;15137;4409;14606;204;911;3630;11843;3834;12754
270510;201809;5632;15754;4910;14753;492;1857;3526;10122;4018;11979
270520;201809;3939;11601;3164;10217;787;2655;1165;3989;1952;6644
270530;201809;1101;3339;993;3162;63;187;763;2445;826;2632
270540;201809;2123;6442;1898;6143;77;378;1620;5121;1697;5499
270550;201809;6635;17965;5525;16724;526;1459;4189;13081;4715;14540
270560;201809;3108;8522;2782;8067;169;553;2172;6179;2341;6732
270570;201809;3995;11585;3447;10738;156;664;2816;8588;2972;9252
270580;201809;2205;6408;2048;6176;97;297;1791;5388;1888;5685
270590;201809;1588;4732;1479;4597;10;51;1428;4438;1438;4489
270600;201809;2764;8693;2498;8251;92;463;2160;6973;2252;7436
270610;201809;3611;9736;3074;9039;104;407;2702;7799;2806;8206
270620;201809;1267;3952;1160;3757;53;231;965;3040;1018;3271
270630;201809;15182;41348;13551;38775;919;3015;10868;30671;11787;33686
270640;201809;5494;15994;4783;14898;208;871;3828;11557;4036;12428
270642;201809;2306;7686;2117;7400;161;803;1659;5577;1820;6380
270644;201809;3359;8660;2791;7921;243;691;2098;6037;2341;6728
270650;201809;3238;9752;2918;9290;466;1695;1960;6004;2426;7699
270660;201809;2144;5371;1732;4795;79;272;1303;3538;1382;3810
270670;201809;15336;37922;13273;35419;723;2102;11034;29207;11757;31309
270680;201809;5127;13100;4647;12560;163;262;4312;11860;4475;12122
270690;201809;9253;23537;7834;21862;1139;2896;5585;15954;6724;18850
270700;201809;551;1680;476;1540;35;150;348;1111;383;1261
270710;201809;5695;17261;5251;16656;282;1219;4370;13551;4652;14770
270720;201809;3311;10263;2966;9678;88;527;2566;8132;2654;8659
270730;201809;7506;18200;6877;17497;364;890;5611;15229;5975;16119
270740;201809;2340;6326;2095;6008;103;365;1710;4781;1813;5146
270750;201809;5336;14851;4725;13998;217;824;3942;11569;4159;12393
270760;201809;3338;9571;2944;8990;78;389;2506;7506;2584;7895
270770;201809;20759;51587;16597;46428;3121;8149;9420;28283;12541;36432
270780;201809;1759;5268;1671;5145;101;358;1394;4250;1495;4608
270790;201809;1571;4633;1378;4352;124;396;939;2984;1063;3380
270800;201809;10508;29820;9517;28407;443;1887;8114;23522;8557;25409
270810;201809;3224;9758;2593;8627;195;794;1783;5842;1978;6636
270820;201809;1680;5129;1431;4708;84;338;1098;3538;1182;3876
270830;201809;5339;13116;4446;12002;207;728;3592;9579;3799;10307
270840;201809;8066;24304;7256;23140;230;1279;6363;19659;6593;20938
270850;201809;8581;21890;7780;20865;519;1746;6495;16871;7014;18617
270860;201809;11912;29912;9956;27539;554;1779;8029;21879;8583;23658
270870;201809;2021;5881;1769;5444;224;737;1226;3783;1450;4520
270880;201809;7998;24363;7229;23238;279;1220;5992;18931;6271;20151
270890;201809;2509;7044;2200;6609;164;559;1611;4752;1775;5311
270895;201809;2886;9592;2694;9336;91;503;2396;8100;2487;8603
270900;201809;1792;4685;1387;4043;62;225;1075;3058;1137;3283
270910;201809;3651;11050;3193;10253;135;567;2467;7776;2602;8343
270915;201809;8913;27345;7565;24918;866;3366;4953;15844;5819;19210
270920;201809;5457;17107;5099;16539;255;1201;4208;13150;4463;14351
270930;201809;17015;41361;13522;37217;2092;5338;9063;25826;11155;31164
270940;201809;5872;17164;5257;16378;281;1332;4105;12401;4386;13733
280010;201809;659;1824;560;1640;27;112;389;1043;416;1155
280020;201809;4616;12319;3992;11304;554;1493;2666;7620;3220;9113
280030;201809;70322;171751;56505;152127;14447;39558;23085;65133;37532;104691
280040;201809;3019;8602;2669;8051;283;895;1850;5561;2133;6456
280050;201809;3758;11028;3315;10293;564;1842;1986;6161;2550;8003
280060;201809;5189;14485;4229;12970;790;2553;2116;6695;2906;9248
280067;201809;6769;17676;5790;16133;465;1397;4090;11199;4555;12596
280070;201809;1881;5852;1801;5703;97;358;1515;4720;1612;5078
280100;201809;3595;10365;3180;9676;364;1197;2230;6744;2594;7941
280110;201809;1296;3717;1171;3499;33;143;1011;2920;1044;3063
280120;201809;7344;22116;6704;21029;697;2044;5069;16135;5766;18179
280130;201809;8540;21056;7660;19805;644;1748;5932;15343;6576;17091
280140;201809;5445;13624;4848;12801;260;731;4051;10630;4311;11361
280150;201809;3728;9916;3398;9455;225;659;2765;7647;2990;8306
280160;201809;1189;3512;1000;3175;137;454;627;1954;764;2408
280170;201809;5028;13588;4607;13019;263;719;3847;10909;4110;11628
280190;201809;1169;2746;1001;2503;59;172;808;1959;867;2131
280200;201809;1295;3471;1057;3071;96;358;750;2107;846;2465
280210;201809;14905;39662;13190;37244;2017;6037;7933;22501;9950;28538
280220;201809;1748;4771;1518;4464;39;208;1249;3639;1288;3847
280230;201809;3696;9814;3326;9290;263;749;2462;6797;2725;7546
280240;201809;3357;9083;3051;8605;78;356;2602;7143;2680;7499
280250;201809;806;2104;649;1866;75;261;378;1014;453;1275
280260;201809;2094;5268;1914;5037;41;117;1783;4705;1824;4822
280270;201809;2255;6553;2025;6171;127;459;1701;5080;1828;5539
280280;201809;3900;12489;3551;11958;534;1650;2374;8390;2908;10040
280290;201809;16949;46881;15062;44183;1661;5374;10039;29639;11700;35013
280300;201809;10505;27606;9227;26177;317;1059;7288;21784;7605;22843
280310;201809;1328;3566;1109;3177;34;121;836;2312;870;2433
280320;201809;8307;23549;7344;22059;902;2832;4877;14455;5779;17287
280330;201809;4775;12103;4086;11087;291;860;3063;8202;3354;9062
280340;201809;5329;11279;4598;10468;293;574;3951;9164;4244;9738
280350;201809;23094;58118;20290;54009;1636;4634;15276;40297;16912;44931
280360;201809;5677;16476;5096;15452;937;2862;2804;8628;3741;11490
280370;201809;2120;5271;1757;4648;82;217;1420;3708;1502;3925
280380;201809;962;2745;845;2575;96;327;563;1709;659;2036
280390;201809;3422;8935;2830;7950;129;415;2231;6149;2360;6564
280400;201809;3837;10304;3400;9646;548;1465;2082;6130;2630;7595
280410;201809;2073;6110;1702;5421;207;692;1021;3181;1228;3873
280420;201809;4203;11570;3840;11059;109;395;3452;9880;3561;10275
280430;201809;1993;5065;1760;4742;79;292;1412;3713;1491;4005
280440;201809;4374;11961;3881;11247;235;796;3161;8937;3396;9733
280445;201809;2287;5943;2054;5531;58;187;1511;3885;1569;4072
280450;201809;10157;23559;9076;22152;376;747;7837;19314;8213;20061
280460;201809;6564;16245;6022;15469;494;1229;4919;12594;5413;13823
280470;201809;1721;4943;1524;4596;80;292;1128;3346;1208;3638
280480;201809;36451;94190;32566;88622;3061;9201;23360;62370;26421;71571
280490;201809;3779;10899;3248;9999;109;506;2466;7304;2575;7810
280500;201809;927;2311;790;2117;45;165;650;1710;695;1875
280510;201809;2529;6871;2213;6401;114;422;1631;4669;1745;5091
280520;201809;1580;4154;1419;3929;81;218;1166;3214;1247;3432
280530;201809;2592;6362;2257;5965;150;385;1815;4804;1965;5189
280540;201809;8894;24269;8199;23251;245;1028;7221;20045;7466;21073
280550;201809;6535;15902;5454;14265;285;880;4333;11008;4618;11888
280560;201809;6919;19974;6571;19464;185;725;5801;16942;5986;17667
280570;201809;6179;15828;5137;14456;248;894;3826;10626;4074;11520
280580;201809;5334;15078;4629;13930;627;1809;3109;9498;3736;11307
280590;201809;2948;7105;2474;6510;152;593;1843;4608;1995;5201
280600;201809;3317;9361;2989;8888;209;714;2174;6415;2383;7129
280610;201809;2529;6366;2297;6049;198;519;1825;4769;2023;5288
280620;201809;5268;13725;4555;12687;446;1089;3262;9415;3708;10504
280630;201809;3651;11003;3318;10491;214;798;2641;8323;2855;9121
280640;201809;2411;6686;2201;6455;59;182;1997;5882;2056;6064
280650;201809;1240;3260;978;2871;76;264;711;2022;787;2286
280660;201809;3106;7488;2768;7087;111;316;2426;6167;2537;6483
280670;201809;18771;43682;16579;40837;1169;3006;13017;32038;14186;35044
280680;201809;2685;6743;2327;6182;187;427;1724;4574;1911;5001
280690;201809;946;2446;802;2233;38;100;604;1651;642;1751
280700;201809;1078;2810;938;2600;23;85;739;2008;762;2093
280710;201809;14560;33420;12645;31225;498;845;11108;28085;11606;28930
280720;201809;2719;6145;2204;5540;133;377;1470;3889;1603;4266
280730;201809;1081;2771;970;2604;73;237;739;1929;812;2166
280740;201809;13670;34492;11746;31468;1087;3033;8116;21418;9203;24451
280750;201809;3440;9950;3091;9321;178;655;2274;6724;2452;7379
280760;201809;5977;16858;5320;15807;618;1820;3549;10822;4167;12642
290010;201809;3028;6560;2100;5119;14;50;1737;4035;1751;4085
290020;201809;5242;14396;4902;13932;382;750;4195;12294;4577;13044
290030;201809;3969;10111;3464;9521;192;486;2915;8071;3107;8557
290035;201809;5122;11532;4133;10243;317;581;3270;8433;3587;9014
290040;201809;4281;10585;3627;9786;142;429;2841;7877;2983;8306
290050;201809;2112;6808;1792;6163;166;660;1217;4098;1383;4758
290060;201809;1278;3227;985;2737;100;357;660;1751;760;2108
290070;201809;33403;78590;29000;72884;2544;6583;20607;51936;23151;58519
290080;201809;5437;16316;4628;15113;556;1900;3122;10352;3678;12252
290090;201809;2205;4251;1649;3657;38;90;1502;3313;1540;3403
290100;201809;9415;25623;7986;23441;1028;2854;4895;14788;5923;17642
290110;201809;4992;13878;4558;13114;471;1407;3177;9048;3648;10455
290115;201809;4273;12429;3677;11505;233;798;2842;8873;3075;9671
290120;201809;6742;16703;5578;15251;156;574;4800;12890;4956;13464
290130;201809;4516;11283;3644;10189;123;497;2937;8057;3060;8554
290135;201809;4266;10171;3502;8939;237;655;2673;6629;2910;7284
290140;201809;4587;12454;3676;11285;130;482;3149;9612;3279;10094
290150;201809;2233;6358;2094;6142;194;627;1584;4539;1778;5166
290160;201809;3127;7629;2852;7276;330;742;2167;5599;2497;6341
290170;201809;3013;8320;2731;7980;97;354;2451;7137;2548;7491
290180;201809;2911;8044;2433;7275;92;339;1950;5747;2042;6086
290190;201809;3985;11892;3601;11353;172;715;2933;9071;3105;9786
290195;201809;2283;5907;1838;5240;51;234;1520;4291;1571;4525
290200;201809;3906;11233;3309;10268;245;841;2542;7829;2787;8670
290205;201809;3376;8800;2998;8261;136;521;2405;6422;2541;6943
290210;201809;13073;37527;11710;35501;1037;2905;8979;27956;10016;30861
290220;201809;2736;7137;2481;6810;175;523;2007;5421;2182;5944
290225;201809;3492;7468;2851;6790;28;71;2696;6429;2724;6500
290230;201809;2347;6582;2147;6347;54;209;1899;5586;1953;5795
290240;201809;3633;9411;3017;8622;125;427;2494;7049;2619;7476
290250;201809;4014;11816;3554;11197;166;512;2927;9520;3093;10032
290260;201809;5258;13551;4357;12230;226;777;3510;9714;3736;10491
290265;201809;3590;10566;2965;9405;158;619;2216;6921;2374;7540
290270;201809;11415;39267;10854;38291;747;3176;8609;29950;9356;33126
290280;201809;5789;17375;5128;16279;380;1388;3762;11812;4142;13200
290290;201809;9682;29028;8146;26183;845;2853;5561;17782;6406;20635
290300;201809;4275;11807;3165;9708;188;661;2229;6818;2417;7479
290310;201809;1506;3964;1269;3638;99;371;948;2645;1047;3016
290320;201809;23623;64529;19731;58709;4722;14153;9633;29898;14355;44051
290323;201809;3695;10133;3268;9509;74;258;2714;7795;2788;8053
290327;201809;4125;12119;3608;11133;292;895;2592;8006;2884;8901
290330;201809;2041;4526;1690;4137;51;117;1494;3658;1545;3775
290340;201809;5628;15184;4542;13796;590;1870;3208;9802;3798;11672
290350;201809;4580;13401;3896;12225;308;1025;2841;8978;3149;10003
290360;201809;4924;13404;4312;12579;137;443;3729;10861;3866;11304
290370;201809;5268;13088;3988;11392;214;536;3014;8754;3228;9290
290380;201809;5541;15136;4773;14057;116;397;4173;12325;4289;12722
290390;201809;14175;41068;12182;38049;1327;4261;8358;26515;9685;30776
290395;201809;2720;8229;2303;7493;69;325;1808;5825;1877;6150
290400;201809;3521;9870;2868;8798;117;474;2166;6475;2283;6949
290405;201809;4625;13684;3886;12377;284;963;2716;8774;3000;9737
290410;201809;5623;15774;4469;13870;150;681;3404;10151;3554;10832
290420;201809;2924;8347;2443;7574;123;401;1915;5932;2038;6333
290430;201809;3054;8815;2537;7967;313;1048;1654;5145;1967;6193
290440;201809;2733;7022;2049;5974;56;190;1507;4434;1563;4624
290450;201809;3192;8745;2655;7949;169;593;2046;6012;2215;6605
290460;201809;11651;32867;10110;29979;2496;7507;4469;13215;6965;20722
290470;201809;4224;11150;3195;9622;380;1297;1802;5456;2182;6753
290475;201809;6286;18659;5375;17001;129;644;4311;13289;4440;13933
290480;201809;1796;4729;1564;4382;119;365;1061;2860;1180;3225
290485;201809;4388;13285;3891;12536;140;747;3335;10475;3475;11222
290490;201809;8645;21083;7891;20065;518;1309;6268;16088;6786;17397
290500;201809;3921;11951;3017;10014;487;1705;1455;4713;1942;6418
290510;201809;3290;8615;2814;7978;89;322;2447;6846;2536;7168
290515;201809;3684;10012;3129;9299;71;207;2758;8365;2829;8572
290520;201809;11226;32973;8739;28030;435;1737;5684;17854;6119;19591
290530;201809;4941;14262;4279;13183;178;613;3534;10876;3712;11489
290540;201809;3635;9800;3281;9356;72;252;2981;8456;3053;8708
290550;201809;4310;11233;3806;10650;32;98;3562;10060;3594;10158
290560;201809;6507;17354;5168;15315;478;1686;3555;10264;4033;11950
290570;201809;42090;108149;38420;103415;2806;7880;30662;82119;33468;89999
290580;201809;7650;23397;6832;22156;660;2110;5100;16887;5760;18997
290590;201809;6879;21542;6002;19971;159;674;4951;16433;5110;17107
290600;201809;18036;51703;16391;49179;832;2665;13121;39519;13953;42184
290610;201809;2459;7987;1984;7006;117;518;1377;4773;1494;5291
290620;201809;6368;18035;5587;16755;207;676;4757;14134;4964;14810
290630;201809;8987;22199;7250;19926;627;1730;5607;15459;6234;17189
290640;201809;2690;7237;2030;6167;98;306;1557;4690;1655;4996
290650;201809;11819;31741;10823;30475;2774;7456;6134;18306;8908;25762
290660;201809;3596;9394;3054;8626;84;216;2291;6738;2375;6954
290670;201809;6657;19093;5796;17661;461;1371;4428;13630;4889;15001
290680;201809;10339;29511;8944;27441;257;1293;7272;21702;7529;22995
290682;201809;4545;12337;4011;11572;142;405;3409;9832;3551;10237
290685;201809;3540;8082;2365;6434;190;492;1535;4359;1725;4851
290687;201809;6691;18794;5391;16618;799;2438;3285;10438;4084;12876
290689;201809;2788;8071;2299;7227;142;487;1709;5382;1851;5869
290690;201809;5556;14730;4559;13347;484;1419;3144;9187;3628;10606
290700;201809;2607;7292;2345;6935;98;366;1949;5738;2047;6104
290710;201809;8452;24103;7250;22457;208;793;6172;19036;6380;19829
290720;201809;18816;51545;17358;49476;985;3077;14302;40526;15287;43603
290730;201809;6999;17634;6062;16499;253;636;4759;12968;5012;13604
290740;201809;1039;2903;794;2471;42;173;588;1812;630;1985
290750;201809;10650;27920;9276;25494;952;2795;6425;17223;7377;20018
290755;201809;2148;6018;1694;5196;102;360;1199;3641;1301;4001
290760;201809;3790;11266;2994;9686;326;962;1842;6224;2168;7186
290770;201809;2496;8392;2324;8170;59;298;1969;6972;2028;7270
290780;201809;8260;21061;7163;19531;356;810;5715;15842;6071;16652
290790;201809;4401;12498;3948;11873;156;501;3387;10244;3543;10745
290800;201809;7033;14923;5288;12888;354;814;4033;10005;4387;10819
290810;201809;5596;15298;4518;13585;119;430;3418;10284;3537;10714
290820;201809;4940;13382;4429;12629;264;859;3298;9414;3562;10273
290830;201809;4523;10603;4068;10002;79;241;3503;8478;3582;8719
290840;201809;16389;45280;14438;42212;1697;4367;9736;29759;11433;34126
290850;201809;6170;15937;5620;15329;428;984;4600;12934;5028;13918
290860;201809;5619;17284;4948;16481;230;854;4176;14094;4406;14948
290870;201809;4733;13196;3684;11307;135;505;2664;8088;2799;8593
290880;201809;1400;3597;1098;3163;77;203;769;2258;846;2461
290890;201809;7789;17485;7171;16762;211;532;6639;15409;6850;15941
290900;201809;2336;6268;1765;5289;117;366;1153;3410;1270;3776
290910;201809;5107;13040;4027;11375;52;221;3351;9339;3403;9560
290920;201809;5035;12627;4679;12187;74;212;4397;11423;4471;11635
290930;201809;7925;22433;6546;20027;231;1036;5227;15506;5458;16542
290940;201809;3681;10548;3096;9700;178;654;2428;7628;2606;8282
290950;201809;1481;3855;1253;3518;71;193;907;2563;978;2756
290960;201809;5234;14404;4782;13804;144;460;4108;11844;4252;12304
290970;201809;3512;10282;2932;9309;171;591;2252;7136;2423;7727
290980;201809;10852;27709;9274;25128;988;2901;5481;14488;6469;17389
290990;201809;8839;24832;7813;23121;381;1457;6330;18191;6711;19648
291000;201809;3236;8922;2617;8131;236;681;2030;6424;2266;7105
291005;201809;14477;35839;12966;33941;747;2093;10811;28099;11558;30192
291010;201809;2985;9074;2433;7917;133;469;1645;5256;1778;5725
291020;201809;1273;3229;1029;2769;27;89;721;1846;748;1935
291030;201809;2401;6101;1662;4720;93;279;1078;2970;1171;3249
291040;201809;5259;15085;4571;14075;225;919;3651;11051;3876;11970
291050;201809;7281;20930;6412;19588;1000;3291;4192;12702;5192;15993
291060;201809;5693;18895;4998;17891;440;1933;3615;12777;4055;14710
291070;201809;15248;42531;13148;39254;578;2156;10639;31403;11217;33559
291072;201809;23124;62534;17182;51426;3681;11467;6826;20717;10507;32184
291075;201809;4967;13346;4436;12446;133;457;3649;9990;3782;10447
291077;201809;1553;4175;1231;3590;58;175;861;2511;919;2686
291080;201809;79018;222879;67034;203646;26013;80321;11927;38975;37940;119296
291085;201809;5643;14485;4736;13186;182;570;4011;11077;4193;11647
291090;201809;1855;3686;1444;3214;36;107;1242;2716;1278;2823
291100;201809;3065;6908;2128;5784;107;369;1634;4327;1741;4696
291110;201809;5685;17752;4928;16429;469;1860;3513;11306;3982;13166
291120;201809;7622;19236;6664;17922;432;1273;5072;13563;5504;14836
291125;201809;2128;3815;1563;3187;116;184;1189;2508;1305;2692
291130;201809;3026;9040;2356;7719;98;470;1685;5286;1783;5756
291140;201809;4567;12803;3452;10644;442;1233;2250;6992;2692;8225
291150;201809;2165;5060;1868;4707;23;65;1714;4298;1737;4363
291160;201809;4746;13956;4141;12988;407;1382;2855;8863;3262;10245
291165;201809;2178;6027;1695;5112;33;130;1260;3675;1293;3805
291170;201809;20133;51990;17112;47051;1021;3076;11216;30615;12237;33691
291180;201809;5761;14303;4535;12494;447;1215;3329;9221;3776;10436
291185;201809;3095;8684;2729;8021;96;328;2172;6268;2268;6596
291190;201809;7483;18938;6301;17315;380;1163;4939;13519;5319;14682
291200;201809;2834;8042;2137;6707;116;383;1313;4067;1429;4450
291210;201809;6681;15083;5237;13343;185;560;3965;10071;4150;10631
291220;201809;3908;11460;3530;10862;258;921;2700;8198;2958;9119
291230;201809;4371;9753;3399;8659;82;165;3084;7972;3166;8137
291240;201809;4159;10965;3664;10112;66;221;3186;8658;3252;8879
291250;201809;3306;9895;2650;8689;184;601;1784;5898;1968;6499
291260;201809;1333;3205;1136;2937;35;118;968;2488;1003;2606
291270;201809;5172;14453;4183;12822;760;2270;2521;7969;3281;10239
291280;201809;2352;6321;1809;5392;200;658;1070;3100;1270;3758
291290;201809;5845;15782;4731;14034;480;1468;3160;9342;3640;10810
291300;201809;3909;10736;2965;9141;144;479;2183;6646;2327;7125
291310;201809;5139;14081;4382;12664;150;530;3605;10231;3755;10761
291320;201809;5946;17455;4672;14917;1120;3352;2237;7461;3357;10813
291330;201809;1766;4533;1500;4106;70;205;1129;3005;1199;3210
291340;201809;4162;10942;3482;9812;89;319;2700;7455;2789;7774
291345;201809;2966;9254;2751;8941;144;521;2258;7352;2402;7873
291350;201809;6651;17243;5175;15256;131;411;4366;13040;4497;13451
291360;201809;33841;83606;27666;75609;4075;11414;16221;45473;20296;56887
291370;201809;7797;21636;7109;20657;468;1517;5457;15743;5925;17260
291380;201809;3234;9533;2938;9052;118;508;2422;7284;2540;7792
291390;201809;12612;29038;10186;26265;462;1329;8217;21094;8679;22423
291400;201809;13580;36534;11614;33556;1734;4512;7139;21974;8873;26486
291410;201809;2877;7625;2203;6476;69;319;1642;4671;1711;4990
291420;201809;1848;4781;1531;4366;49;199;1308;3682;1357;3881
291430;201809;2971;8345;2594;7770;106;460;2083;6064;2189;6524
291440;201809;6375;18610;5533;17167;354;1207;4386;13665;4740;14872
291450;201809;8294;22280;7158;20886;142;314;6276;18826;6418;19140
291460;201809;14624;40308;12993;37866;881;2809;9653;28030;10534;30839
291465;201809;8816;24101;7270;22241;269;1139;6118;18639;6387;19778
291470;201809;15357;37327;13169;34797;662;1715;9957;27001;10619;28716
291480;201809;39032;89673;29298;76336;3997;10943;15376;40214;19373;51157
291490;201809;5081;13603;4513;12895;219;699;3901;11157;4120;11856
291500;201809;5015;12431;4195;11310;69;298;3790;10136;3859;10434
291510;201809;3605;10187;2948;9204;105;507;2388;7365;2493;7872
291520;201809;4324;10399;3400;9154;194;551;2534;6809;2728;7360
291530;201809;2195;5360;1658;4621;331;791;956;2927;1287;3718
291535;201809;3137;9603;2897;9189;200;628;2226;7152;2426;7780
291540;201809;2231;5007;1587;4275;56;227;1376;3589;1432;3816
291550;201809;5294;12720;4205;11243;462;1157;2720;7396;3182;8553
291560;201809;19441;44193;13458;36999;967;2547;9143;26347;10110;28894
291570;201809;2273;5538;1857;5020;93;206;1550;4295;1643;4501
291580;201809;6032;16412;4843;14790;336;1227;3520;10546;3856;11773
291590;201809;1790;5061;1645;4853;141;430;1314;3875;1455;4305
291600;201809;5070;12941;3821;10929;506;1568;2328;6475;2834;8043
291610;201809;5380;15218;5092;14894;90;309;4771;13945;4861;14254
291620;201809;3160;7074;2297;6119;120;346;1759;4768;1879;5114
291630;201809;3187;7435;2435;6460;174;514;1902;4988;2076;5502
291640;201809;14900;38999;11627;34030;1990;5838;4899;15179;6889;21017
291650;201809;8635;23298;7724;22152;467;1108;6614;19274;7081;20382
291660;201809;2150;5261;1564;4343;124;431;1052;2765;1176;3196
291670;201809;2003;5302;1713;4897;103;267;1363;3943;1466;4210
291680;201809;3854;10114;3278;9170;296;878;2461;6821;2757;7699
291685;201809;4587;11213;3713;10072;278;608;2816;7955;3094;8563
291690;201809;4079;9415;2969;7807;115;279;2414;6278;2529;6557
291700;201809;8504;25218;7611;23591;470;1623;6181;18940;6651;20563
291710;201809;5078;12682;3879;10962;322;1007;2694;7467;3016;8474
291720;201809;4443;13837;3687;12280;429;1574;2411;7828;2840;9402
291730;201809;6261;16821;5424;15698;268;919;4443;12785;4711;13704
291733;201809;2903;7599;2466;6992;74;249;1854;5441;1928;5690
291735;201809;2963;7770;2458;6996;83;272;2009;5683;2092;5955
291740;201809;3792;9923;2975;8582;116;355;2293;6504;2409;6859
291750;201809;19375;47773;15744;42281;1849;5079;10256;27683;12105;32762
291760;201809;10274;30836;8267;27476;2774;10352;2081;7007;4855;17359
291770;201809;6896;19370;5778;17293;532;1711;4126;12105;4658;13816
291780;201809;4855;13447;4417;12778;109;403;3864;11045;3973;11448
291790;201809;2611;7599;2421;7328;236;659;1845;5666;2081;6325
291800;201809;29157;75884;22822;66281;3383;9552;12801;38258;16184;47810
291810;201809;10364;25699;8701;23608;220;766;7602;20432;7822;21198
291820;201809;3712;10179;3282;9542;125;447;2588;7521;2713;7968
291830;201809;4248;10477;3615;9598;231;602;2890;7712;3121;8314
291835;201809;6207;18894;4970;16456;788;2696;2849;9688;3637;12384
291840;201809;44486;124774;39073;117342;4799;14972;27229;82736;32028;97708
291845;201809;2469;6766;2069;6265;125;372;1702;5210;1827;5582
291850;201809;4047;11627;3312;10360;290;824;2384;7688;2674;8512
291855;201809;2059;4326;1637;3819;54;147;1431;3319;1485;3466
291860;201809;2240;5938;1577;4656;41;147;1050;2988;1091;3135
291870;201809;1334;3408;897;2617;57;178;614;1735;671;1913
291875;201809;2625;8015;2355;7517;106;411;1787;5546;1893;5957
291880;201809;5375;15926;4722;14729;328;1035;3469;10782;3797;11817
291890;201809;1488;3256;1010;2669;172;396;646;1734;818;2130
291900;201809;1181;3052;921;2611;22;94;730;2003;752;2097
291905;201809;2664;6788;2059;5783;90;306;1533;4182;1623;4488
291910;201809;2801;7305;2395;6797;77;255;2051;5802;2128;6057
291915;201809;7170;20859;5932;18734;262;984;4452;14017;4714;15001
291920;201809;24598;68196;21693;64072;2754;8700;14433;42133;17187;50833
291930;201809;2383;6805;2065;6279;234;787;1408;4181;1642;4968
291940;201809;3662;9772;2491;7708;241;752;1465;4426;1706;5178
291950;201809;8624;26985;7564;24924;610;2235;4970;16385;5580;18620
291955;201809;13634;35674;12384;34063;1386;3798;9327;26067;10713;29865
291960;201809;3065;8413;2517;7607;164;501;1901;5875;2065;6376
291970;201809;4126;11284;3577;10516;197;734;2651;7747;2848;8481
291980;201809;10157;28886;8094;25683;690;2159;5536;17768;6226;19927
291990;201809;2044;5653;1885;5475;14;64;1799;5240;1813;5304
291992;201809;4222;10299;3075;8708;287;764;2378;6812;2665;7576
291995;201809;2114;5863;1722;5263;56;267;1399;4153;1455;4420
292000;201809;2451;6222;2037;5636;152;506;1517;4156;1669;4662
292010;201809;6019;14125;4979;12664;238;663;4112;10330;4350;10993
292020;201809;4510;13433;3812;12176;274;990;2792;8704;3066;9694
292030;201809;1679;5398;1625;5300;92;358;1037;3269;1129;3627
292040;201809;4195;11122;3454;10054;240;647;2746;8182;2986;8829
292045;201809;3989;10764;2995;9273;54;120;2650;8383;2704;8503
292050;201809;6333;18351;5159;16112;366;1275;3312;10181;3678;11456
292060;201809;12212;28267;11324;27176;656;1523;9757;23179;10413;24702
292070;201809;5656;15162;4985;14350;296;912;4258;12208;4554;13120
292080;201809;3174;8113;2613;7398;114;365;2296;6506;2410;6871
292090;201809;4472;9940;3319;8591;244;648;2579;6770;2823;7418
292100;201809;10121;26132;8709;24242;1408;4075;5241;14615;6649;18690
292105;201809;3259;8749;2890;8188;79;305;2418;6743;2497;7048
292110;201809;6114;15648;4439;12847;1088;3168;2001;5850;3089;9018
292120;201809;6744;17785;5506;15604;474;1400;4007;11220;4481;12620
292130;201809;3188;8001;2698;7383;172;526;2062;5601;2234;6127
292140;201809;5049;12195;4216;10986;238;612;3421;8842;3659;9454
292145;201809;2227;6714;1908;6124;94;324;1427;4588;1521;4912
292150;201809;12834;36619;11604;34739;307;1291;9793;28923;10100;30214
292160;201809;2738;7117;2202;6414;71;215;1844;5448;1915;5663
292170;201809;8097;22289;6774;20047;565;1777;4784;14076;5349;15853
292180;201809;2812;7742;2067;6433;300;899;1195;3716;1495;4615
292190;201809;2808;7682;2414;7115;190;581;1748;5215;1938;5796
292200;201809;7452;19983;5794;17453;970;2996;3186;9754;4156;12750
292205;201809;3779;10692;3299;9936;80;376;2919;8621;2999;8997
292210;201809;6018;14918;5054;13623;102;443;4505;11944;4607;12387
292220;201809;2003;5057;1778;4736;88;260;1373;3588;1461;3848
292225;201809;3196;9452;2856;8927;86;363;2387;7342;2473;7705
292230;201809;8013;19729;7241;18719;206;772;6134;15473;6340;16245
292240;201809;4886;14213;4204;12911;368;1100;2838;8700;3206;9800
292250;201809;5113;14357;4713;13712;642;1777;3136;9291;3778;11068
292260;201809;3239;8868;2909;8423;146;393;2518;7385;2664;7778
292265;201809;3254;9292;2773;8491;88;406;2184;6504;2272;6910
292270;201809;4046;9699;3319;8812;202;569;2712;7225;2914;7794
292273;201809;2526;5661;2063;5084;74;134;1616;4133;1690;4267
292275;201809;1782;4962;1430;4449;68;172;1135;3634;1203;3806
292280;201809;2528;6215;2103;5720;113;247;1720;4853;1833;5100
292285;201809;2512;6256;1982;5502;101;275;1547;4331;1648;4606
292290;201809;6832;19244;5706;17586;195;742;4667;14334;4862;15076
292300;201809;9839;26087;7837;23491;962;3114;5089;15328;6051;18442
292303;201809;2835;8277;2503;7752;63;181;2154;6691;2217;6872
292305;201809;2515;6736;2322;6453;47;218;2065;5619;2112;5837
292310;201809;6466;17184;5627;16125;214;712;4819;13697;5033;14409
292320;201809;6145;16809;5063;14825;293;940;3846;10976;4139;11916
292330;201809;2458;5814;2118;5404;113;270;1686;4367;1799;4637
292335;201809;4739;12454;4251;11743;296;762;3495;9739;3791;10501
292340;201809;5813;16206;4951;14572;258;828;3740;10832;3998;11660
292350;201809;2472;6691;2046;6133;84;322;1700;5099;1784;5421
292360;201809;4825;13022;4080;11703;317;1036;2846;7933;3163;8969
292370;201809;10702;24760;9415;23029;151;485;8712;20936;8863;21421
292380;201809;6725;19077;6097;17985;453;1335;4672;13684;5125;15019
292390;201809;4264;8531;3102;7164;127;241;2690;6262;2817;6503
292400;201809;20949;62192;18698;58357;1900;6332;13177;40968;15077;47300
292405;201809;4377;10750;3604;9655;163;402;2926;7842;3089;8244
292410;201809;2063;5125;1817;4829;62;187;1596;4249;1658;4436
292420;201809;3587;11045;3332;10657;169;731;2788;8786;2957;9517
292430;201809;4765;14678;3720;12957;316;1123;2548;9047;2864;10170
292440;201809;8045;26265;7532;25547;120;583;6977;23704;7097;24287
292450;201809;3753;11173;3058;9784;152;547;2367;7539;2519;8086
292460;201809;4781;13529;3973;12130;354;1061;2854;8747;3208;9808
292465;201809;2470;6751;2059;6139;101;270;1460;4530;1561;4800
292467;201809;1728;5141;1588;4945;217;650;1104;3536;1321;4186
292470;201809;2973;7577;2344;6561;71;174;1856;5203;1927;5377
292480;201809;6411;15442;5172;13925;99;376;4622;12230;4721;12606
292490;201809;2068;5573;1744;5075;109;336;1332;3888;1441;4224
292500;201809;6369;17945;5232;15876;610;1846;3439;10424;4049;12270
292510;201809;12295;34083;10072;30676;607;2184;7446;22609;8053;24793
292520;201809;6560;16973;5774;15770;733;1983;4087;11235;4820;13218
292525;201809;5629;13670;4676;12553;124;369;4093;10965;4217;11334
292530;201809;25893;70678;21022;62792;5887;17709;7863;24597;13750;42306
292540;201809;3752;7853;3055;7086;139;303;2671;6202;2810;6505
292550;201809;7589;21203;5979;19119;405;1457;4481;14648;4886;16105
292560;201809;4222;10974;3613;10091;119;453;2963;8190;3082;8643
292570;201809;3886;10251;3355;9432;75;278;2964;8194;3039;8472
292575;201809;6748;20217;6286;19586;287;1028;5292;16425;5579;17453
292580;201809;7282;19161;6279;17670;190;644;5293;14755;5483;15399
292590;201809;7127;19197;6426;18152;295;998;5472;15090;5767;16088
292593;201809;2797;7007;2361;6272;73;196;1952;5139;2025;5335
292595;201809;5291;14257;4651;13445;179;650;3929;11205;4108;11855
292600;201809;10774;29723;9424;27755;492;1375;7392;21911;7884;23286
292610;201809;4295;11298;3606;10116;213;515;2610;7481;2823;7996
292620;201809;6288;17714;5385;16681;68;174;5114;16006;5182;16180
292630;201809;8480;21222;7002;18806;521;1402;4912;13249;5433;14651
292640;201809;8069;24306;7152;22815;263;1084;5193;16527;5456;17611
292650;201809;4573;11264;4159;10714;143;411;3765;9568;3908;9979
292660;201809;10895;30386;9479;28271;541;1760;7491;22314;8032;24074
292665;201809;2160;6529;1966;6279;59;212;1701;5489;1760;5701
292670;201809;3491;9518;2715;8073;131;478;1882;5490;2013;5968
292680;201809;3879;10658;3164;9322;190;579;2319;6663;2509;7242
292690;201809;2544;6829;1817;5627;167;487;1161;3748;1328;4235
292700;201809;9552;26620;8381;24852;858;2464;5740;17501;6598;19965
292710;201809;2333;7551;2157;7314;52;180;1945;6656;1997;6836
292720;201809;9229;22319;7789;20712;308;904;6389;17051;6697;17955
292730;201809;4233;10471;4002;10179;195;395;3500;8966;3695;9361
292740;201809;316151;802384;286580;757301;48597;131147;173684;456343;222281;587490
292750;201809;6164;16670;5330;15414;295;885;4034;11773;4329;12658
292760;201809;3798;11133;3387;10417;270;903;2478;7554;2748;8457
292770;201809;5734;16071;4839;14711;818;2578;2907;9176;3725;11754
292780;201809;1881;3942;1425;3379;53;147;1161;2649;1214;2796
292790;201809;4089;8795;3241;7864;139;388;2836;6846;2975;7234
292800;201809;10620;27166;9294;25119;398;1122;7692;20573;8090;21695
292805;201809;3382;8521;2689;7565;210;546;2001;5651;2211;6197
292810;201809;10150;27928;8113;24787;285;1128;6081;18244;6366;19372
292820;201809;7433;20427;5430;17315;499;1785;3786;11886;4285;13671
292830;201809;2803;6617;2416;6141;91;307;2124;5338;2215;5645
292840;201809;8896;23339;7848;21901;172;634;6874;18729;7046;19363
292850;201809;2534;6898;2117;6241;150;527;1473;4192;1623;4719
292860;201809;16012;37735;14427;35726;836;2064;11811;29167;12647;31231
292870;201809;16461;43299;14555;40495;1090;3456;9873;27085;10963;30541
292880;201809;11234;30836;9780;28711;388;1630;7634;21579;8022;23209
292890;201809;6161;18210;5531;17179;296;1112;4555;14009;4851;15121
292895;201809;2940;6517;2182;5383;104;253;1687;4132;1791;4385
292900;201809;2679;7476;2495;7179;68;312;2027;5625;2095;5937
292905;201809;4209;11514;3304;10140;205;720;2321;7083;2526;7803
292910;201809;4893;13744;4445;13012;310;1034;3299;9533;3609;10567
292920;201809;9738;27062;9147;26240;304;1190;7966;22378;8270;23568
292925;201809;5242;15107;4631;14040;264;808;3485;10447;3749;11255
292930;201809;6073;18696;5385;17322;468;1878;3463;10770;3931;12648
292935;201809;2172;5929;1771;5490;37;175;1576;4935;1613;5110
292937;201809;3085;7462;2701;6996;77;234;2395;6188;2472;6422
292940;201809;3054;7949;2462;7019;185;452;1810;5289;1995;5741
292950;201809;9565;25039;8527;23468;441;1258;6594;17912;7035;19170
292960;201809;5206;12627;4496;11652;109;324;3673;9331;3782;9655
292970;201809;3895;11400;3372;10646;123;536;2781;8781;2904;9317
292975;201809;4397;9700;3925;9154;188;357;3504;8287;3692;8644
292980;201809;3255;8100;2600;7081;111;358;2055;5489;2166;5847
292990;201809;11229;31062;9552;28134;738;2336;7104;20856;7842;23192
293000;201809;2571;6268;2287;5886;38;153;1826;4769;1864;4922
293010;201809;17786;46692;14607;41501;1953;5721;8985;25412;10938;31133
293015;201809;7628;24309;6171;21353;528;2198;4177;14290;4705;16488
293020;201809;9507;28676;8656;27483;160;758;7735;24655;7895;25413
293030;201809;5328;14634;4113;12729;129;457;2794;8885;2923;9342
293040;201809;3880;11104;3440;10502;101;359;2997;9133;3098;9492
293050;201809;20914;53192;18705;50017;1416;3913;13597;36384;15013;40297
293060;201809;3429;9105;2836;8129;186;594;2103;5889;2289;6483
293070;201809;24178;60592;20385;55464;3134;8589;12680;35271;15814;43860
293075;201809;3287;10693;2960;10168;232;991;2323;7910;2555;8901
293076;201809;3552;9078;3185;8591;105;291;2709;7381;2814;7672
293077;201809;5514;16040;4652;14765;494;1609;3086;10085;3580;11694
293080;201809;4722;14251;4171;13317;161;701;3311;10326;3472;11027
293090;201809;3104;9288;2448;8194;291;1039;1548;5149;1839;6188
293100;201809;5615;15549;4610;13725;300;932;3541;10504;3841;11436
293105;201809;3645;11660;3210;10779;229;821;2342;7754;2571;8575
293110;201809;2387;5944;2034;5464;74;283;1711;4438;1785;4721
293120;201809;4176;11812;3765;11124;124;340;3151;9332;3275;9672
293130;201809;3741;10536;3350;10027;110;437;2876;8532;2986;8969
293135;201809;28686;70149;21474;59963;4127;12679;9355;26406;13482;39085
293140;201809;2230;5357;1987;5054;90;256;1662;4150;1752;4406
293150;201809;5193;16133;4380;14540;468;1590;2971;9959;3439;11549
293160;201809;3847;9542;3308;8906;263;518;2701;7606;2964;8124
293170;201809;4159;9753;3648;9074;128;366;3021;7412;3149;7778
293180;201809;4657;12753;3802;11309;127;554;3078;8898;3205;9452
293190;201809;13496;38133;12101;36051;279;1227;10547;31138;10826;32365
293200;201809;7920;20126;6573;18101;250;931;5156;13904;5406;14835
293210;201809;5030;13560;4316;12402;277;802;3408;9802;3685;10604
293220;201809;4852;13276;3717;11267;903;2752;1470;4668;2373;7420
293230;201809;3865;10342;2986;9045;297;966;2005;6169;2302;7135
293240;201809;4412;11799;3542;10366;107;313;2695;8062;2802;8375
293245;201809;3924;10680;3525;10120;185;615;2958;8389;3143;9004
293250;201809;5413;13473;4669;12435;280;768;3754;9950;4034;10718
293260;201809;4346;12251;3598;11084;117;402;2565;7831;2682;8233
293270;201809;6707;15769;5445;14389;515;949;4162;11720;4677;12669
293280;201809;4796;12824;4161;11940;268;714;3214;9282;3482;9996
293290;201809;12603;39718;11481;37821;2578;8315;6159;21222;8737;29537
293300;201809;5907;14266;5073;13137;338;818;3778;9944;4116;10762
293305;201809;4002;10118;3534;9486;50;151;3173;8491;3223;8642
293310;201809;2105;5488;1759;4884;73;226;1346;3676;1419;3902
293315;201809;4086;10093;3362;8972;176;471;2719;7194;2895;7665
293317;201809;2438;6184;2183;5793;134;304;1698;4523;1832;4827
293320;201809;9840;26557;9169;25762;493;1482;7923;22219;8416;23701
293325;201809;1667;4385;1345;3905;206;614;862;2514;1068;3128
293330;201809;42420;133647;37105;123948;8496;28840;17091;58392;25587;87232
293340;201809;2357;6651;1920;5886;129;449;1314;3991;1443;4440
293345;201809;3180;9069;2664;8327;296;682;1915;6396;2211;7078
293350;201809;6630;19055;5920;18256;66;213;5521;17329;5587;17542
293360;201809;14826;39075;12914;36676;487;1673;11326;31820;11813;33493
310010;201809;806;1961;575;1621;66;221;269;715;335;936
310020;201809;2167;6264;1663;5386;368;1291;282;881;650;2172
310030;201809;2110;6211;1706;5465;252;926;1087;3320;1339;4246
310040;201809;932;2437;771;2185;49;187;560;1515;609;1702
310050;201809;1533;4928;1382;4644;224;916;761;2463;985;3379
310060;201809;3229;9340;2832;8829;148;662;2344;7163;2492;7825
310070;201809;336;806;240;646;9;27;181;480;190;507
310080;201809;805;2221;548;1691;77;283;216;616;293;899
310090;201809;4382;12283;3686;11120;334;1114;2679;7942;3013;9056
310100;201809;3249;9361;2783;8585;116;505;2236;6675;2352;7180
310110;201809;4734;12908;3797;11229;746;2458;1787;5037;2533;7495
310120;201809;613;1564;396;1188;66;254;196;513;262;767
310130;201809;372;1056;314;957;46;180;192;534;238;714
310140;201809;213;661;156;556;39;167;46;136;85;303
310150;201809;4489;12879;3502;10952;676;2339;1372;4137;2048;6476
310160;201809;6903;18782;5173;15842;1298;4389;1555;4637;2853;9026
310163;201809;953;2851;777;2525;242;872;233;693;475;1565
310170;201809;8805;23353;7262;20977;726;2187;5138;14833;5864;17020
310180;201809;1650;4341;1315;3802;122;456;898;2477;1020;2933
310190;201809;2821;8796;2334;7846;589;2176;329;1028;918;3204
310200;201809;1655;5164;1283;4392;240;910;512;1705;752;2615
310205;201809;1056;2938;761;2458;174;604;256;819;430;1423
310210;201809;2662;7146;2219;6447;104;308;1712;4960;1816;5268
310220;201809;1071;2984;879;2665;105;347;605;1787;710;2134
310230;201809;2228;6447;1874;5744;212;797;1155;3298;1367;4095
310240;201809;862;2862;747;2650;63;279;517;1801;580;2080
310250;201809;1001;2766;831;2487;58;233;589;1711;647;1944
310260;201809;2586;7281;1650;5557;471;1810;305;793;776;2603
310270;201809;2623;6759;2061;5977;127;497;1678;4760;1805;5257
310280;201809;2250;5440;1787;4773;284;824;1024;2589;1308;3413
310285;201809;1844;6181;1615;5783;175;745;1008;3552;1183;4297
310290;201809;1094;3013;957;2765;207;690;527;1376;734;2066
310300;201809;1430;4489;1297;4259;236;937;654;1964;890;2901
310310;201809;315;814;222;653;35;107;119;344;154;451
310320;201809;494;1319;320;999;31;127;165;476;196;603
310330;201809;498;1188;300;824;40;137;134;326;174;463
310340;201809;7585;21353;6129;18883;1043;3121;3070;9795;4113;12916
310350;201809;11239;28727;7951;23213;1994;6226;2679;7611;4673;13837
310360;201809;454;1139;366;1027;14;46;279;770;293;816
310370;201809;1271;4096;1074;3702;220;808;366;1296;586;2104
310375;201809;870;2339;579;1860;101;334;237;763;338;1097
310380;201809;383;905;201;583;40;108;76;202;116;310
310390;201809;428;1342;357;1204;101;373;84;222;185;595
310400;201809;9315;23621;6570;19301;1058;3475;3283;9375;4341;12850
310410;201809;759;2269;473;1728;112;433;119;400;231;833
310420;201809;3762;10113;2438;7388;482;1648;651;1753;1133;3401
310430;201809;1366;3901;896;2987;200;724;258;814;458;1538
310440;201809;566;1456;390;1140;25;110;232;652;257;762
310445;201809;1362;4014;1020;3332;59;218;722;2323;781;2541
310450;201809;4647;12091;3516;10286;225;804;2651;7591;2876;8395
310460;201809;1627;4482;1115;3486;236;796;316;964;552;1760
310470;201809;3874;8544;3078;7500;275;787;2388;5688;2663;6475
310480;201809;1048;2836;781;2366;121;420;474;1368;595;1788
310490;201809;2850;8293;2263;7212;375;1429;1072;3146;1447;4575
310500;201809;1440;4212;1040;3439;213;763;477;1546;690;2309
310510;201809;1765;4914;1178;3774;264;930;348;1131;612;2061
310520;201809;1321;3348;960;2752;130;373;564;1610;694;1983
310530;201809;782;2117;426;1320;70;251;90;209;160;460
310540;201809;3270;9618;2719;8625;698;2320;1087;3331;1785;5651
310550;201809;1242;3259;882;2639;88;330;531;1495;619;1825
310560;201809;13443;36810;10104;31131;2245;7737;3590;10069;5835;17806
310570;201809;1063;3008;891;2732;94;367;605;1777;699;2144
310590;201809;4053;11157;3317;9861;318;1082;1903;5388;2221;6470
310600;201809;1382;4211;1140;3692;180;659;556;1682;736;2341
310610;201809;510;1395;327;1084;62;245;163;487;225;732
310620;201809;150697;405940;113606;337729;24296;81738;45524;121527;69820;203265
310630;201809;4364;12328;3665;11037;292;1039;2530;7401;2822;8440
310640;201809;991;3096;831;2772;208;767;275;858;483;1625
310650;201809;2403;7215;1790;6030;227;874;1014;3287;1241;4161
310660;201809;1244;3508;1079;3304;52;171;874;2632;926;2803
310665;201809;1257;3457;1046;3139;56;202;838;2485;894;2687
310670;201809;47083;128928;39769;115715;5878;19193;23952;66318;29830;85511
310680;201809;649;1656;559;1529;29;86;440;1176;469;1262
310690;201809;1652;4644;1250;3949;136;521;702;2101;838;2622
310700;201809;494;1122;371;977;43;135;253;637;296;772
310710;201809;5136;15423;3707;13313;908;3840;441;1511;1349;5351
310720;201809;880;2302;713;2072;62;218;505;1411;567;1629
310730;201809;8981;25631;7798;23691;556;2109;5527;16438;6083;18547
310740;201809;5119;14782;3527;11398;705;2470;997;3019;1702;5489
310750;201809;1213;3035;866;2531;151;493;380;1041;531;1534
310760;201809;531;1489;404;1264;37;126;190;605;227;731
310770;201809;1049;2956;713;2441;106;405;365;1214;471;1619
310780;201809;3944;10152;3192;8952;174;517;2269;6262;2443;6779
310790;201809;1799;5702;1591;5295;371;1286;653;2227;1024;3513
310800;201809;2265;6959;1652;5702;455;1853;110;349;565;2202
310810;201809;1102;2913;904;2553;59;208;595;1615;654;1823
310820;201809;1105;3039;685;2238;150;508;161;521;311;1029
310825;201809;2726;9067;2271;8268;97;549;1815;6422;1912;6971
310830;201809;1420;4217;1042;3462;232;881;416;1297;648;2178
310840;201809;1900;5380;1347;4378;349;1253;350;1016;699;2269
310850;201809;1509;4198;1291;3900;70;339;1007;2902;1077;3241
310855;201809;3184;8715;2509;7645;236;846;1760;5217;1996;6063
310860;201809;6834;20154;5512;17530;560;1890;3403;10841;3963;12731
310870;201809;1051;2553;790;2159;90;255;560;1535;650;1790
310880;201809;993;3030;782;2593;93;320;462;1496;555;1816
310890;201809;2209;6346;1478;4980;348;1284;193;564;541;1848
310900;201809;4268;12131;3197;10078;533;1891;1480;4304;2013;6195
310910;201809;1632;4345;1025;3225;124;450;147;400;271;850
310920;201809;1781;4940;1407;4315;245;778;732;2236;977;3014
310925;201809;933;2740;779;2471;97;345;533;1651;630;1996
310930;201809;5741;15665;4231;13195;817;2663;2110;6719;2927;9382
310940;201809;6139;15927;4948;14103;336;1182;3476;9599;3812;10781
310945;201809;1213;3285;1020;2998;103;351;635;1808;738;2159
310950;201809;1812;5545;1264;4331;258;1011;432;1348;690;2359
310960;201809;743;1920;435;1341;62;214;156;491;218;705
310970;201809;1136;3445;795;2716;196;738;186;574;382;1312
310980;201809;361;851;229;635;27;77;145;383;172;460
310990;201809;1210;3576;937;3022;217;720;374;1183;591;1903
311000;201809;3983;11523;3024;9866;831;2901;1135;3545;1966;6446
311010;201809;757;2394;625;2097;246;885;189;608;435;1493
311020;201809;996;2670;670;2048;83;288;301;872;384;1160
311030;201809;1445;3834;987;3027;272;937;350;966;622;1903
311040;201809;319;1022;253;858;68;235;75;234;143;469
311050;201809;2272;6230;1794;5459;426;1443;741;2160;1167;3603
311060;201809;2626;7209;1803;5473;312;1126;712;1927;1024;3053
311070;201809;1827;5094;1364;4280;198;761;634;1862;832;2623
311080;201809;979;2455;806;2146;67;252;566;1388;633;1640
311090;201809;1956;6517;1558;5761;403;1677;445;1595;848;3272
311100;201809;1956;5895;1283;4511;353;1389;186;580;539;1969
311110;201809;3413;7521;2070;5568;469;1371;818;2198;1287;3569
311115;201809;1243;3200;1012;2873;80;289;777;2139;857;2428
311120;201809;6437;17478;4805;14425;881;3011;1646;4390;2527;7401
311130;201809;1770;4968;1429;4461;158;638;762;2255;920;2893
311140;201809;1233;3146;937;2718;79;250;607;1793;686;2043
311150;201809;1455;4776;1215;4309;202;803;662;2277;864;3080
311160;201809;3596;10950;2595;9086;772;2995;710;2423;1482;5418
311170;201809;821;2265;650;1998;45;146;405;1269;450;1415
311180;201809;1262;3013;828;2341;207;624;339;957;546;1581
311190;201809;1045;2927;773;2385;126;458;312;866;438;1324
311200;201809;1670;4743;1217;3842;326;1118;301;862;627;1980
311205;201809;884;2772;738;2474;59;264;420;1348;479;1612
311210;201809;976;3002;873;2865;125;410;635;2115;760;2525
311220;201809;715;2114;602;1901;97;340;303;878;400;1218
311230;201809;7570;23416;5710;19640;1121;4072;1952;6956;3073;11028
311240;201809;904;2576;718;2302;160;581;381;1184;541;1765
311250;201809;834;2447;679;2184;157;538;313;985;470;1523
311260;201809;2270;5704;1483;4390;307;937;509;1440;816;2377
311265;201809;1194;3231;918;2775;64;236;642;1872;706;2108
311270;201809;3039;9371;2686;8834;217;999;1930;6029;2147;7028
311280;201809;1144;3118;571;1854;104;369;100;297;204;666
311290;201809;1841;5799;1723;5544;184;615;1182;3765;1366;4380
311300;201809;4467;13121;3772;11989;238;1063;2921;9055;3159;10118
311310;201809;557;1662;478;1511;81;286;211;624;292;910
311320;201809;3010;9568;2662;8776;439;1662;1238;3771;1677;5433
311330;201809;4617;12919;3927;11753;502;1678;2152;6496;2654;8174
311340;201809;9938;29967;8064;26357;2488;8603;2073;6873;4561;15476
311350;201809;2162;5678;1579;4600;172;601;828;2173;1000;2774
311360;201809;871;2384;689;2125;264;894;181;555;445;1449
311370;201809;4263;11161;3213;9348;211;839;1969;5413;2180;6252
311380;201809;400;1267;321;1101;80;274;117;412;197;686
311390;201809;1666;5418;1366;4998;588;2467;358;1130;946;3597
311400;201809;1317;3860;955;3120;160;604;389;1144;549;1748
311410;201809;1509;4760;1300;4470;257;969;677;2357;934;3326
311420;201809;1590;4865;1077;3721;214;796;165;444;379;1240
311430;201809;3244;9020;2163;6827;427;1409;606;1923;1033;3332
311440;201809;2336;6985;1682;5784;412;1619;506;1685;918;3304
311450;201809;1719;5402;1281;4550;341;1352;287;888;628;2240
311455;201809;930;2244;639;1774;174;479;244;699;418;1178
311460;201809;482;1584;329;1265;81;396;93;322;174;718
311470;201809;424;1382;314;1110;71;289;55;179;126;468
311480;201809;1516;5284;1386;5105;50;142;1231;4688;1281;4830
311490;201809;213;674;181;603;54;199;75;228;129;427
311500;201809;399;1060;293;876;34;118;168;498;202;616
311510;201809;2654;7501;1844;5962;374;1367;623;1878;997;3245
311520;201809;547;1673;507;1586;119;420;276;817;395;1237
311530;201809;8531;20929;5633;16054;1448;4562;1565;4433;3013;8995
311535;201809;724;2023;489;1577;99;372;134;400;233;772
311540;201809;511;1659;457;1558;115;384;240;837;355;1221
311545;201809;2022;5759;1741;5383;104;430;1325;3998;1429;4428
311547;201809;1469;3864;1278;3554;49;165;943;2641;992;2806
311550;201809;2652;7735;2106;6683;361;1308;808;2432;1169;3740
311560;201809;275;631;193;517;33;96;106;254;139;350
311570;201809;1815;4340;1340;3686;61;175;1071;3015;1132;3190
311580;201809;2103;4092;1446;3313;173;347;931;2212;1104;2559
311590;201809;474;1355;392;1231;64;242;211;637;275;879
311600;201809;1585;3815;1324;3491;64;199;1131;2931;1195;3130
311610;201809;2331;8003;1995;7231;386;1438;946;3424;1332;4862
311615;201809;2882;8708;2386;7888;181;726;1780;5759;1961;6485
311620;201809;381;1088;337;1020;27;101;264;783;291;884
311630;201809;1324;3705;1068;3211;88;277;723;2103;811;2380
311640;201809;524;1619;437;1445;96;362;200;617;296;979
311650;201809;1865;5070;1606;4657;125;457;1102;3041;1227;3498
311660;201809;2695;7976;1964;6600;403;1476;418;1213;821;2689
311670;201809;1496;4019;1174;3493;210;706;503;1517;713;2223
311680;201809;2053;6094;1585;5253;278;970;951;3125;1229;4095
311690;201809;547;1222;434;1089;37;94;329;856;366;950
311700;201809;2217;5436;1731;4769;39;145;1433;3857;1472;4002
311710;201809;1436;4277;996;3422;262;975;328;1141;590;2116
311720;201809;403;1249;327;1104;35;150;172;553;207;703
311730;201809;4325;10952;2654;7913;896;2946;397;1148;1293;4094
311740;201809;754;2286;691;2196;38;110;621;1996;659;2106
311750;201809;3743;11745;3127;10691;467;1816;1719;5587;2186;7403
311760;201809;613;1830;513;1641;104;408;202;543;306;951
311770;201809;1883;5718;1464;4904;305;1117;546;1711;851;2828
311780;201809;1146;3582;839;2913;185;724;229;693;414;1417
311783;201809;2126;6133;1762;5502;60;282;1429;4338;1489;4620
311787;201809;691;2072;491;1604;69;257;187;525;256;782
311790;201809;1465;3906;959;3020;226;799;334;1038;560;1837
311800;201809;4495;14046;3746;12380;764;2771;632;1916;1396;4687
311810;201809;929;2956;748;2607;62;257;448;1543;510;1800
311820;201809;729;1971;570;1669;74;252;353;968;427;1220
311830;201809;8008;23961;5615;18571;1642;5809;652;2051;2294;7860
311840;201809;3015;8339;2592;7713;313;1023;1805;5340;2118;6363
311850;201809;303;864;257;790;24;79;163;488;187;567
311860;201809;51952;137263;40965;118833;6872;21134;23006;65111;29878;86245
311870;201809;1780;5011;1249;4000;243;872;466;1321;709;2193
311880;201809;6069;16500;5241;15318;389;1105;3978;11726;4367;12831
311890;201809;1481;3853;1184;3403;125;410;784;2186;909;2596
311900;201809;676;1825;523;1598;55;198;359;1068;414;1266
311910;201809;4110;10912;3172;9686;645;2007;1609;5001;2254;7008
311920;201809;1913;5598;1569;5019;168;562;922;2948;1090;3510
311930;201809;3082;7964;2430;6993;917;2818;744;2006;1661;4824
311940;201809;13291;36798;9980;30391;1611;5402;4518;12959;6129;18361
311950;201809;2101;6005;1599;5110;118;517;1073;3327;1191;3844
311960;201809;537;1322;443;1170;34;156;303;669;337;825
311970;201809;434;1441;290;1064;54;219;64;219;118;438
311980;201809;427;1210;239;814;35;126;71;233;106;359
311990;201809;530;1310;351;1054;84;295;149;416;233;711
311995;201809;946;2693;506;1668;21;74;51;115;72;189
312000;201809;552;1523;463;1386;34;111;337;1010;371;1121
312010;201809;841;2521;665;2163;76;278;395;1244;471;1522
312015;201809;1281;3932;1159;3704;74;316;885;2725;959;3041
312020;201809;1081;3429;931;3151;218;785;360;1185;578;1970
312030;201809;1984;5073;1748;4800;35;166;1608;4349;1643;4515
312040;201809;764;2485;578;2063;70;271;233;806;303;1077
312050;201809;1176;3864;934;3368;223;920;243;764;466;1684
312060;201809;809;2117;561;1788;142;471;258;816;400;1287
312070;201809;831;2506;598;2023;71;274;323;1046;394;1320
312080;201809;2713;6896;2027;5835;161;544;1276;3463;1437;4007
312083;201809;877;2381;670;2055;84;287;426;1243;510;1530
312087;201809;2244;6200;1886;5670;87;319;1460;4376;1547;4695
312090;201809;9102;25391;7083;21937;1455;4828;3137;9634;4592;14462
312100;201809;1503;4636;1077;3845;165;712;484;1628;649;2340
312110;201809;1007;3273;850;2937;239;922;237;730;476;1652
312120;201809;646;1875;483;1579;142;541;174;481;316;1022
312125;201809;1531;4216;1291;3843;151;479;908;2626;1059;3105
312130;201809;861;2215;655;1860;70;229;272;710;342;939
312140;201809;763;2355;635;2065;145;510;250;742;395;1252
312150;201809;451;1307;383;1145;10;47;273;762;283;809
312160;201809;7608;22694;5987;19654;1002;3800;2611;8045;3613;11845
312170;201809;835;2320;669;2025;45;153;445;1308;490;1461
312180;201809;1329;3744;1082;3252;164;546;564;1594;728;2140
312190;201809;537;1632;389;1328;89;339;80;266;169;605
312200;201809;4555;12643;3733;11187;745;2295;2026;6028;2771;8323
312210;201809;1295;3136;947;2630;69;257;647;1730;716;1987
312220;201809;1860;5855;1622;5432;130;465;1033;3437;1163;3902
312230;201809;11062;30563;7522;23895;2283;7958;1219;3511;3502;11469
312235;201809;1628;4517;1352;4120;127;460;955;2837;1082;3297
312240;201809;677;2238;522;1902;131;519;149;509;280;1028
312245;201809;2473;6666;2085;6105;77;284;1687;4893;1764;5177
312247;201809;820;2178;603;1849;133;433;290;893;423;1326
312250;201809;940;2499;625;1899;115;366;241;715;356;1081
312260;201809;888;2587;727;2318;59;238;518;1591;577;1829
312270;201809;658;1889;529;1640;35;158;287;811;322;969
312280;201809;423;1289;333;1116;119;401;44;148;163;549
312290;201809;719;2259;597;2022;131;493;193;635;324;1128
312300;201809;880;2674;615;2051;170;618;101;268;271;886
312310;201809;726;2463;623;2250;102;436;289;1003;391;1439
312320;201809;1781;4805;1336;3994;398;1266;252;712;650;1978
312330;201809;845;2502;703;2254;81;292;472;1461;553;1753
312340;201809;233;629;179;539;32;110;88;255;120;365
312350;201809;262;588;217;540;26;76;151;364;177;440
312352;201809;1599;4803;1395;4441;123;409;894;2967;1017;3376
312360;201809;2481;7567;1868;6256;435;1579;457;1501;892;3080
312370;201809;1700;4841;1424;4342;282;972;677;1964;959;2936
312380;201809;2128;5041;1813;4636;24;57;1623;4141;1647;4198
312385;201809;1263;3592;1011;3122;154;550;532;1550;686;2100
312390;201809;1837;5541;1408;4735;250;922;470;1428;720;2350
312400;201809;2793;8477;2220;7357;767;2644;647;2211;1414;4855
312410;201809;11063;32267;9206;28938;1910;6312;4525;14043;6435;20355
312420;201809;3599;10455;3115;9554;567;1866;1675;5013;2242;6879
312430;201809;7836;21272;6369;18682;633;2021;4165;12032;4798;14053
312440;201809;874;2838;672;2357;343;1255;73;228;416;1483
312450;201809;1107;3391;839;2881;249;910;288;1006;537;1916
312460;201809;409;1073;289;894;42;153;166;529;208;682
312470;201809;472;1224;308;935;60;220;105;279;165;499
312480;201809;1143;2907;793;2421;127;404;427;1269;554;1673
312490;201809;1975;4969;1525;4265;233;665;802;2176;1035;2841
312500;201809;833;2188;673;1947;63;230;429;1197;492;1427
312510;201809;3414;9488;2638;8024;600;1822;980;2938;1580;4760
312520;201809;179;542;151;494;45;146;68;222;113;368
312530;201809;574;1516;495;1417;22;71;434;1245;456;1316
312540;201809;1429;4232;930;3125;188;675;403;1329;591;2004
312550;201809;760;2096;575;1695;46;148;364;977;410;1125
312560;201809;1945;5116;1617;4654;85;312;1266;3595;1351;3907
312570;201809;2170;5772;1698;5117;535;1693;605;1858;1140;3551
312580;201809;554;1678;429;1394;58;216;184;571;242;787
312590;201809;1591;4846;1311;4286;150;624;739;2266;889;2890
312595;201809;1569;5034;1434;4771;278;873;867;3046;1145;3919
312600;201809;935;2371;547;1799;78;317;204;660;282;977
312610;201809;6305;16400;4055;12227;699;2335;1240;3564;1939;5899
312620;201809;2424;6355;1765;5448;70;318;1371;4273;1441;4591
312630;201809;237;776;196;697;43;179;81;281;124;460
312640;201809;566;1561;372;1228;53;176;124;423;177;599
312650;201809;2044;5502;1398;4214;100;349;923;2621;1023;2970
312660;201809;1318;3267;1004;2783;98;330;679;1810;777;2140
312670;201809;4856;13396;4000;12096;310;1297;2756;7938;3066;9235
312675;201809;1231;3516;1009;3128;74;305;770;2307;844;2612
312680;201809;1354;3918;1146;3598;75;333;880;2674;955;3007
312690;201809;2305;5594;1828;4966;118;378;1436;3803;1554;4181
312695;201809;923;2799;797;2568;63;215;605;1947;668;2162
312700;201809;1999;5481;1461;4479;161;546;817;2411;978;2957
312705;201809;1308;3444;1092;3094;29;103;889;2477;918;2580
312707;201809;1371;4206;1057;3599;84;415;627;2004;711;2419
312710;201809;6147;14331;3635;10487;1098;3447;939;2817;2037;6264
312720;201809;976;2797;723;2361;102;391;384;1195;486;1586
312730;201809;1618;3964;1218;3413;82;255;779;2132;861;2387
312733;201809;1447;3856;1110;3222;45;163;759;2114;804;2277
312735;201809;670;1842;576;1662;80;287;385;999;465;1286
312737;201809;786;1912;550;1547;89;284;288;747;377;1031
312738;201809;557;1532;386;1210;66;259;172;491;238;750
312740;201809;382;946;217;682;56;179;49;128;105;307
312750;201809;1268;4133;1054;3720;175;697;471;1576;646;2273
312760;201809;1809;5564;1323;4537;264;965;413;1357;677;2322
312770;201809;39585;99785;25936;76478;6406;20077;8092;23420;14498;43497
312780;201809;2384;7632;2065;7060;245;957;1328;4497;1573;5454
312790;201809;271;683;166;536;14;60;62;174;76;234
312800;201809;4754;14254;3719;12126;751;2752;1603;5038;2354;7790
312810;201809;1722;4772;1134;3725;291;1060;351;1027;642;2087
312820;201809;1788;4975;1487;4400;64;245;1054;3015;1118;3260
312825;201809;1285;3166;1124;2957;35;109;944;2462;979;2571
312830;201809;2199;6513;1443;5012;372;1416;321;1087;693;2503
312840;201809;1103;3408;862;2897;148;595;329;995;477;1590
312850;201809;809;2113;580;1733;66;261;299;804;365;1065
312860;201809;1363;3537;881;2735;232;768;234;708;466;1476
312870;201809;6050;17111;3725;12278;612;2203;923;2830;1535;5033
312880;201809;1356;3584;1093;3182;58;207;629;1836;687;2043
312890;201809;1970;5350;1333;4149;185;592;543;1730;728;2322
312900;201809;1167;3209;947;2919;82;277;584;1854;666;2131
312910;201809;1502;2829;834;1951;127;295;407;943;534;1238
312920;201809;977;2730;696;2260;130;495;346;1055;476;1550
312930;201809;2078;5582;1686;4969;381;1153;718;2091;1099;3244
312940;201809;899;2651;734;2374;109;403;350;1114;459;1517
312950;201809;2545;6796;1879;5722;556;1835;675;1985;1231;3820
312960;201809;1899;5132;1602;4693;126;372;1179;3526;1305;3898
312965;201809;1667;5043;1419;4564;134;455;900;2869;1034;3324
312970;201809;1036;3143;822;2771;183;719;362;1136;545;1855
312980;201809;20765;60897;17568;55017;3086;10800;9296;27695;12382;38495
312990;201809;418;1161;280;927;61;235;118;372;179;607
313000;201809;399;1231;323;1088;49;218;158;492;207;710
313005;201809;2532;7474;2186;6888;158;567;1608;4931;1766;5498
313010;201809;4445;13049;3655;11664;712;2527;2089;6464;2801;8991
313020;201809;875;2742;599;2102;98;374;88;253;186;627
313030;201809;1188;2971;808;2377;103;376;451;1247;554;1623
313040;201809;769;2456;634;2150;62;249;339;1084;401;1333
313050;201809;1726;5038;1236;4298;244;986;354;1111;598;2097
313055;201809;1709;4938;1555;4711;49;156;1341;4056;1390;4212
313060;201809;938;2481;652;1994;217;736;141;379;358;1115
313065;201809;1691;5327;1472;4963;91;412;1107;3613;1198;4025
313070;201809;879;2395;679;2022;88;280;391;1141;479;1421
313080;201809;370;1040;267;841;72;254;69;167;141;421
313090;201809;4553;12892;3893;11720;776;2564;2162;6368;2938;8932
313100;201809;1412;3769;1079;3270;63;242;773;2300;836;2542
313110;201809;1470;4050;1036;3234;109;428;545;1550;654;1978
313115;201809;2342;7241;2057;6657;330;1178;1060;3217;1390;4395
313120;201809;3579;8741;2734;7609;291;908;1718;4730;2009;5638
313130;201809;25948;72299;20914;62608;3117;10574;10929;30951;14046;41525
313140;201809;503;1216;333;950;21;80;233;645;254;725
313150;201809;1326;3912;984;3200;281;966;251;770;532;1736
313160;201809;943;2501;728;2131;56;187;494;1408;550;1595
313170;201809;11133;33895;7987;27555;1572;5690;2918;9672;4490;15362
313180;201809;2186;5974;1523;4624;226;763;781;2297;1007;3060
313190;201809;3979;11959;2984;9843;606;2128;995;3071;1601;5199
313200;201809;1066;3097;918;2829;35;142;761;2269;796;2411
313210;201809;3813;11452;3116;10161;476;1701;1772;5610;2248;7311
313220;201809;1702;4660;1155;3599;204;722;426;1192;630;1914
313230;201809;2728;8119;2417;7715;79;245;2084;6711;2163;6956
313240;201809;8477;22334;5458;17206;1087;3921;2269;6589;3356;10510
313250;201809;5628;17192;4614;15276;610;2190;2510;8162;3120;10352
313260;201809;601;1645;416;1278;57;213;191;550;248;763
313270;201809;5383;15111;4325;13351;780;2574;2522;7760;3302;10334
313280;201809;398;1179;283;930;37;136;119;378;156;514
313290;201809;780;2591;612;2321;231;947;163;591;394;1538
313300;201809;1561;4606;1173;3840;352;1245;208;593;560;1838
313310;201809;1002;3147;818;2749;143;557;200;565;343;1122
313320;201809;2103;5728;1487;4741;302;1095;682;2167;984;3262
313330;201809;3927;11055;3082;9706;232;1008;2011;6096;2243;7104
313340;201809;1232;2898;875;2379;108;302;604;1629;712;1931
313350;201809;2141;6233;1489;4837;242;888;558;1660;800;2548
313360;201809;1224;3206;850;2579;165;588;432;1212;597;1800
313370;201809;1272;3824;1143;3583;158;586;663;1934;821;2520
313375;201809;1669;4455;1088;3429;225;826;264;801;489;1627
313380;201809;5383;14410;3970;11781;849;2765;1699;4594;2548;7359
313390;201809;852;2830;764;2682;60;265;498;1682;558;1947
313400;201809;3439;9071;2823;8263;183;556;2219;6399;2402;6955
313410;201809;1238;3346;973;2903;97;329;682;1994;779;2323
313420;201809;14727;34064;7770;22129;1765;5528;1073;3148;2838;8676
313430;201809;860;2559;642;2123;110;431;263;786;373;1217
313440;201809;5684;12697;3724;10095;360;1030;2369;6396;2729;7426
313450;201809;617;1781;452;1453;99;340;141;409;240;749
313460;201809;2041;6241;1679;5658;378;1471;783;2474;1161;3945
313470;201809;3009;7561;2428;6750;204;555;1769;4965;1973;5520
313480;201809;862;2527;490;1666;82;305;125;374;207;679
313490;201809;1405;3320;703;2290;249;960;53;179;302;1139
313500;201809;376;1170;296;981;28;110;120;364;148;474
313505;201809;9295;25567;8028;23961;327;1194;6711;19949;7038;21143
313507;201809;1446;3760;1204;3411;42;155;974;2748;1016;2903
313510;201809;12369;34978;10266;31168;1380;4575;5316;15742;6696;20317
313520;201809;13047;38748;10822;34748;853;3190;7709;24284;8562;27474
313530;201809;499;1458;402;1284;26;100;196;602;222;702
313535;201809;2357;6611;2069;6062;151;445;1480;4274;1631;4719
313540;201809;813;2559;611;2025;139;471;215;692;354;1163
313545;201809;1154;3972;993;3637;186;754;543;1903;729;2657
313550;201809;1702;5233;1444;4703;369;1311;684;2120;1053;3431
313560;201809;2517;5172;1891;4418;81;186;1583;3666;1664;3852
313570;201809;944;2979;767;2625;185;696;304;992;489;1688
313580;201809;5245;14537;4153;12719;618;2010;2253;7093;2871;9103
313590;201809;918;2696;711;2375;248;905;265;902;513;1807
313600;201809;3635;10273;3061;9341;160;638;2437;7300;2597;7938
313610;201809;971;2628;794;2298;122;364;484;1367;606;1731
313620;201809;5416;15023;4431;13290;835;2761;2263;6594;3098;9355
313630;201809;8002;20570;5606;16918;763;2636;2987;8937;3750;11573
313640;201809;996;2421;620;1888;189;619;202;591;391;1210
313650;201809;1779;5539;1498;5075;107;430;982;3344;1089;3774
313652;201809;755;2558;701;2441;126;492;429;1437;555;1929
313655;201809;1040;2917;852;2637;60;221;635;1936;695;2157
313657;201809;1264;3458;977;2981;53;219;709;2030;762;2249
313660;201809;838;2502;685;2191;116;445;358;1059;474;1504
313665;201809;4323;12308;3458;10744;549;1945;1898;5631;2447;7576
313670;201809;41176;109297;27781;85000;5316;17832;10958;31862;16274;49694
313680;201809;959;2671;817;2447;60;195;528;1532;588;1727
313690;201809;787;2627;633;2317;143;546;200;728;343;1274
313695;201809;1648;4743;1286;4130;99;358;890;2853;989;3211
313700;201809;3090;10293;2690;9758;252;953;2095;7631;2347;8584
313710;201809;1328;3341;968;2796;100;301;626;1814;726;2115
313720;201809;5123;14735;3770;11993;625;2238;1585;4687;2210;6925
313730;201809;1255;3028;959;2619;84;221;631;1678;715;1899
313740;201809;1660;5985;1361;5195;363;1543;192;653;555;2196
313750;201809;1857;5264;1453;4465;337;1129;545;1548;882;2677
313753;201809;2030;5047;1399;4019;176;565;787;2198;963;2763
313760;201809;4881;14013;3620;11531;883;3025;1341;4068;2224;7093
313770;201809;3605;10503;2890;9406;234;817;2004;6562;2238;7379
313780;201809;3895;10800;2922;9130;351;1266;836;2644;1187;3910
313790;201809;452;1454;404;1365;59;222;222;712;281;934
313800;201809;1300;3164;1018;2745;111;329;645;1686;756;2015
313810;201809;1562;4194;1255;3751;96;346;906;2677;1002;3023
313820;201809;13179;31814;9044;24795;1544;4744;3474;9215;5018;13959
313830;201809;300;902;264;838;64;226;127;394;191;620
313835;201809;909;2769;751;2463;104;393;346;1061;450;1454
313840;201809;6279;17054;4545;14034;1192;3950;1026;3193;2218;7143
313850;201809;945;2407;776;2151;124;416;419;1035;543;1451
313860;201809;2537;7195;1879;5841;348;1172;690;1989;1038;3161
313862;201809;1457;3371;778;2305;74;241;409;1155;483;1396
313865;201809;2213;6252;1929;5805;140;448;1460;4330;1600;4778
313867;201809;1058;3501;908;3192;284;1045;406;1410;690;2455
313868;201809;1651;5313;1403;4824;100;430;1037;3488;1137;3918
313870;201809;781;2192;593;1857;116;401;210;588;326;989
313880;201809;1367;3779;1024;3205;216;757;424;1215;640;1972
313890;201809;1949;4592;1438;3930;127;384;943;2597;1070;2981
313900;201809;3500;11062;2715;9465;802;3069;651;2206;1453;5275
313910;201809;577;1804;438;1533;115;422;91;309;206;731
313920;201809;2986;9599;2484;8577;548;1880;1220;4285;1768;6165
313925;201809;1599;4230;1267;3618;248;681;748;2149;996;2830
313930;201809;5630;19469;4726;17828;403;1495;3306;12990;3709;14485
313940;201809;7961;24255;5778;20328;1234;4985;1441;5507;2675;10492
313950;201809;4540;10984;3343;9351;498;1764;1990;5413;2488;7177
313960;201809;5279;13490;3619;10661;816;2643;1239;3411;2055;6054
313970;201809;1288;3753;1150;3505;51;208;721;2192;772;2400
313980;201809;1306;3586;857;2819;138;533;313;975;451;1508
313990;201809;1716;5887;1302;4856;371;1525;391;1342;762;2867
314000;201809;9029;25015;7696;22657;542;2077;5209;15025;5751;17102
314010;201809;1272;3239;1035;2916;38;152;817;2232;855;2384
314015;201809;2024;5717;1580;5000;231;871;865;2650;1096;3521
314020;201809;502;1413;302;1007;66;261;56;194;122;455
314030;201809;744;2274;587;1944;81;286;294;958;375;1244
314040;201809;682;1896;553;1647;106;348;271;773;377;1121
314050;201809;1570;4419;1161;3642;187;678;549;1575;736;2253
314053;201809;1700;5180;1403;4622;238;758;813;2802;1051;3560
314055;201809;2250;6262;1954;5827;56;231;1627;4856;1683;5087
314060;201809;1107;3135;868;2730;43;160;616;1892;659;2052
314070;201809;4203;12071;3334;10444;798;2578;1341;4102;2139;6680
314080;201809;1809;5264;1260;4082;214;815;410;1146;624;1961
314085;201809;2019;6282;1679;5742;357;1292;818;2799;1175;4091
314090;201809;3701;11035;3209;10248;252;1018;2148;6791;2400;7809
314100;201809;3142;7554;2506;6674;79;202;2010;5381;2089;5583
314110;201809;4103;12253;3433;10893;516;1859;1794;5317;2310;7176
314120;201809;755;1758;330;1033;83;306;58;175;141;481
314130;201809;720;1989;383;1280;50;197;169;543;219;740
314140;201809;4602;13579;3512;11376;629;2154;1556;4922;2185;7076
314150;201809;1402;3723;1082;3156;111;349;692;1935;803;2284
314160;201809;2224;6080;1650;5053;270;887;697;2166;967;3053
314170;201809;1017;2942;832;2568;86;296;495;1419;581;1715
314180;201809;5256;15189;4368;13737;490;1676;2528;7957;3018;9633
314190;201809;686;1957;508;1683;96;342;262;874;358;1216
314200;201809;2850;8270;2358;7379;147;597;1673;5013;1820;5610
314210;201809;1897;5158;1578;4605;158;514;910;2591;1068;3105
314220;201809;1211;3525;874;2906;241;907;267;821;508;1728
314225;201809;1127;3295;985;3081;75;240;729;2291;804;2531
314230;201809;730;2022;629;1892;97;326;384;1175;481;1501
314240;201809;1043;2903;811;2558;198;684;317;1007;515;1691
314250;201809;510;1478;331;1075;55;189;129;387;184;576
314260;201809;871;2760;718;2468;175;700;321;1004;496;1704
314270;201809;3150;9235;2549;8231;109;442;1900;6005;2009;6447
314280;201809;3241;7885;2049;5847;336;1067;873;2345;1209;3412
314290;201809;4387;11696;3664;10442;437;1255;2390;6720;2827;7975
314300;201809;1448;4403;1070;3587;285;1021;316;1039;601;2060
314310;201809;4644;12685;3374;10463;1100;3672;752;2192;1852;5864
314315;201809;870;3153;757;2901;62;292;527;1957;589;2249
314320;201809;2641;7366;1786;5831;408;1431;666;2164;1074;3595
314330;201809;45228;129834;35368;112899;10830;36092;8482;28039;19312;64131
314340;201809;2272;5814;1236;3854;271;1013;268;661;539;1674
314345;201809;1353;4182;1133;3773;152;545;687;2230;839;2775
314350;201809;936;2684;642;2112;137;500;168;521;305;1021
314360;201809;595;1790;377;1309;66;254;99;325;165;579
314370;201809;645;1873;532;1680;31;122;400;1219;431;1341
314380;201809;1094;3199;757;2526;207;766;127;427;334;1193
314390;201809;11297;30731;7598;23653;1752;5832;2042;5734;3794;11566
314400;201809;3932;11896;3175;10571;904;3130;1126;3859;2030;6989
314410;201809;2570;7421;1797;5935;314;1156;650;2279;964;3435
314420;201809;743;1909;576;1671;24;119;438;1211;462;1330
314430;201809;6227;16738;4679;13978;933;2912;1796;5325;2729;8237
314435;201809;1411;4247;1201;3885;48;213;910;2900;958;3113
314437;201809;881;2344;664;2009;38;138;365;1112;403;1250
314440;201809;514;1525;391;1294;107;394;115;341;222;735
314450;201809;1295;3635;1083;3290;123;458;659;1890;782;2348
314460;201809;3332;10510;2429;8485;649;2411;398;1371;1047;3782
314465;201809;2202;6525;1930;5987;63;275;1486;4443;1549;4718
314467;201809;851;2454;724;2226;21;62;581;1777;602;1839
314470;201809;2153;6430;1759;5582;357;1264;761;2242;1118;3506
314480;201809;5684;17342;4046;13579;759;2753;1077;3270;1836;6023
314490;201809;881;2494;662;2037;82;288;387;1137;469;1425
314500;201809;1584;4225;1185;3557;233;715;469;1394;702;2109
314505;201809;1900;4942;1594;4518;114;381;1145;3175;1259;3556
314510;201809;1710;4613;1180;3811;249;875;502;1596;751;2471
314520;201809;3964;12694;2771;9888;545;2139;314;976;859;3115
314530;201809;5376;17993;4907;17084;491;1942;3422;11814;3913;13756
314535;201809;2539;6800;2086;6134;141;530;1569;4524;1710;5054
314537;201809;1111;3254;852;2806;71;278;582;1865;653;2143
314540;201809;405;1069;283;834;26;100;143;395;169;495
314545;201809;1665;4388;1485;4147;45;114;1265;3674;1310;3788
314550;201809;625;1598;460;1355;43;168;228;602;271;770
314560;201809;3735;11956;2945;10201;553;2087;984;3232;1537;5319
314570;201809;286;812;223;698;33;109;113;354;146;463
314580;201809;444;1396;330;1153;91;328;73;268;164;596
314585;201809;655;2149;527;1850;75;326;239;782;314;1108
314587;201809;1943;5541;1502;4808;222;642;840;2751;1062;3393
314590;201809;2913;8655;2076;6927;389;1444;746;2378;1135;3822
314600;201809;1759;5116;1032;3618;236;903;116;364;352;1267
314610;201809;8167;22376;5874;18728;1251;4669;2378;7333;3629;12002
314620;201809;1849;4787;1501;4299;74;282;1228;3423;1302;3705
314625;201809;1436;4358;1262;4105;74;386;997;3118;1071;3504
314630;201809;4923;13425;4134;12252;141;590;3412;10039;3553;10629
314640;201809;599;1548;429;1252;83;278;204;536;287;814
314650;201809;851;2168;570;1717;58;218;260;687;318;905
314655;201809;1533;4389;1098;3558;231;751;468;1512;699;2263
314660;201809;323;784;205;556;15;33;118;303;133;336
314670;201809;1609;3884;1173;3210;53;199;741;1978;794;2177
314675;201809;1698;4717;1471;4317;116;411;1125;3214;1241;3625
314690;201809;2020;6023;1543;5221;500;1833;398;1342;898;3175
314700;201809;9483;28253;6155;21310;1409;5409;1481;4922;2890;10331
314710;201809;7461;21547;5336;17037;1207;4208;1230;3491;2437;7699
314720;201809;2029;6335;1485;5169;346;1329;362;1231;708;2560
314730;201809;1997;5754;1483;4738;403;1344;391;1186;794;2530
314740;201809;2742;7974;2204;7016;269;983;1216;3785;1485;4768
314750;201809;325;929;250;777;22;83;130;374;152;457
314760;201809;1833;5767;1259;4410;184;749;320;921;504;1670
314770;201809;1058;3188;518;1733;47;163;130;389;177;552
314780;201809;332;816;220;650;42;139;118;324;160;463
314790;201809;9204;26131;6625;21394;2083;7572;1506;4414;3589;11986
314795;201809;1432;3916;1216;3561;53;236;953;2656;1006;2892
314800;201809;10474;27578;6161;19277;1374;4639;1118;3123;2492;7762
314810;201809;8828;25085;6588;21107;1882;6219;1985;6684;3867;12903
314820;201809;930;2460;704;2098;78;281;423;1202;501;1483
314830;201809;1470;4629;1246;4198;289;1040;576;1917;865;2957
314840;201809;859;2877;690;2596;82;429;468;1661;550;2090
314850;201809;1828;4757;1518;4290;65;226;1291;3618;1356;3844
314860;201809;3076;9655;2594;8691;412;1553;1537;4990;1949;6543
314870;201809;5873;16105;4635;14370;403;1349;3371;10476;3774;11825
314875;201809;1690;5267;1517;5034;102;309;1264;4228;1366;4537
314880;201809;874;2173;689;1914;40;104;469;1352;509;1456
314890;201809;429;1256;302;968;50;186;117;339;167;525
314900;201809;644;1763;493;1497;117;384;177;530;294;914
314910;201809;1606;4824;1239;4237;290;1152;572;1831;862;2983
314915;201809;2206;6772;1874;6173;139;545;1270;4052;1409;4597
314920;201809;420;1076;286;897;13;47;194;599;207;646
314930;201809;5066;15249;3916;12955;855;3088;1381;4335;2236;7423
314940;201809;401;1070;344;966;36;96;207;548;243;644
314950;201809;417;1125;274;880;32;131;115;331;147;462
314960;201809;768;2045;595;1703;53;189;396;1065;449;1254
314970;201809;692;2096;567;1863;110;411;265;827;375;1238
314980;201809;1276;3559;948;3042;290;1043;249;771;539;1814
314990;201809;2152;6446;1469;4842;338;1233;319;924;657;2157
314995;201809;1536;4532;1266;4056;100;408;787;2397;887;2805
315000;201809;1028;2865;781;2443;85;304;486;1469;571;1773
315010;201809;371;1079;275;887;55;211;119;344;174;555
315015;201809;2067;6200;1871;5900;212;738;1209;3831;1421;4569
315020;201809;778;2349;571;1921;83;322;268;835;351;1157
315030;201809;522;1513;371;1213;108;388;85;241;193;629
315040;201809;813;2434;718;2214;105;347;453;1385;558;1732
315050;201809;1073;2922;848;2600;82;320;468;1396;550;1716
315053;201809;1119;3066;872;2606;82;270;512;1482;594;1752
315057;201809;1603;5250;1404;4843;181;627;878;3061;1059;3688
315060;201809;588;1862;408;1474;86;320;86;310;172;630
315070;201809;561;1563;413;1282;115;388;116;326;231;714
315080;201809;2541;7912;2011;6766;431;1441;932;3134;1363;4575
315090;201809;762;2444;579;2064;123;479;192;644;315;1123
315100;201809;1125;3567;728;2583;137;560;288;918;425;1478
315110;201809;1472;3929;1136;3359;156;463;541;1618;697;2081
315120;201809;11371;27411;8263;22871;1138;3142;4298;12411;5436;15553
315130;201809;1243;3754;1006;3258;171;656;380;1139;551;1795
315140;201809;2730;7873;2133;6767;424;1547;1018;2960;1442;4507
315150;201809;3966;10180;2851;8328;458;1482;1272;3614;1730;5096
315160;201809;1523;3919;993;3039;213;677;412;1214;625;1891
315170;201809;1379;4401;937;3348;235;879;169;581;404;1460
315180;201809;15749;40579;8371;25926;1349;4803;2179;5917;3528;10720
315190;201809;2030;4771;1621;4205;245;658;1165;3003;1410;3661
315200;201809;3503;10655;2635;9030;825;3055;606;2037;1431;5092
315210;201809;7673;20815;5637;16502;749;2435;2565;6869;3314;9304
315213;201809;1098;3005;950;2791;28;81;769;2250;797;2331
315217;201809;2443;7822;1962;6948;121;585;1315;4507;1436;5092
315220;201809;8191;22979;6573;20157;1838;5915;2314;7062;4152;12977
315230;201809;3024;7501;2641;7038;60;124;2328;6387;2388;6511
315240;201809;2378;7403;2101;6918;561;2025;1074;3426;1635;5451
315250;201809;9728;27870;7367;23434;1414;4983;3135;9628;4549;14611
315260;201809;883;2609;497;1699;95;331;45;127;140;458
315270;201809;746;2293;521;1822;89;368;155;464;244;832
315280;201809;2651;6859;1531;4692;389;1300;263;772;652;2072
315290;201809;1154;2997;695;2250;215;750;187;603;402;1353
315300;201809;682;1702;456;1396;186;614;117;371;303;985
315310;201809;1284;3738;969;3117;95;351;534;1612;629;1963
315320;201809;676;2009;481;1631;64;292;207;647;271;939
315330;201809;735;2590;401;1631;74;327;111;403;185;730
315340;201809;3021;7773;2284;6716;188;615;1471;4269;1659;4884
315350;201809;1489;4189;1122;3549;165;578;549;1701;714;2279
315360;201809;1624;5085;1177;4064;197;725;445;1445;642;2170
315370;201809;425;1279;347;1113;62;197;157;491;219;688
315380;201809;191;600;147;498;38;147;28;73;66;220
315390;201809;1135;3449;860;2902;175;643;308;974;483;1617
315400;201809;3927;11292;3158;9858;483;1590;1638;4970;2121;6560
315410;201809;2247;5312;1763;4612;426;1217;523;1346;949;2563
315415;201809;1151;3373;938;3024;244;909;377;1189;621;2098
315420;201809;1073;3269;739;2573;157;561;95;315;252;876
315430;201809;3444;8770;2455;7172;555;1889;920;2487;1475;4376
315440;201809;953;2654;794;2376;101;378;431;1190;532;1568
315445;201809;1965;4922;1459;4159;136;439;1009;2831;1145;3270
315450;201809;2142;6345;1836;5849;272;852;1149;3706;1421;4558
315460;201809;30226;90625;25710;82064;6724;23077;10273;31172;16997;54249
315470;201809;456;1329;363;1156;39;149;192;576;231;725
315480;201809;1312;3881;894;2977;194;687;254;828;448;1515
315490;201809;2887;7224;1988;5933;274;875;772;2271;1046;3146
315500;201809;481;1338;296;923;28;106;144;401;172;507
315510;201809;1204;3387;1046;3144;33;148;895;2624;928;2772
315520;201809;1055;2996;837;2641;59;227;583;1776;642;2003
315530;201809;603;1869;473;1574;179;644;171;539;350;1183
315540;201809;1210;3414;847;2713;117;453;358;1104;475;1557
315550;201809;1783;4883;1270;4036;298;1068;376;1130;674;2198
315560;201809;5995;19253;5295;17961;386;1355;3530;12060;3916;13415
315570;201809;1784;5266;1536;4806;107;449;893;2669;1000;3118
315580;201809;2138;5572;1679;4825;379;1241;567;1595;946;2836
315590;201809;890;2453;722;2176;110;394;346;973;456;1367
315600;201809;2352;7841;1743;6620;273;1035;948;3713;1221;4748
315610;201809;892;2347;694;1963;134;464;303;734;437;1198
315620;201809;308;1007;280;962;54;185;160;585;214;770
315630;201809;809;2351;683;2122;167;571;220;611;387;1182
315640;201809;323;891;281;821;33;120;172;474;205;594
315645;201809;913;2437;617;1931;168;568;158;466;326;1034
315650;201809;1684;4451;1339;3952;59;248;1069;3042;1128;3290
315660;201809;2423;6079;1836;5065;131;387;1266;3394;1397;3781
315670;201809;12330;35888;9818;31202;2123;7161;4451;13756;6574;20917
315680;201809;2952;9257;2231;7825;408;1591;994;3388;1402;4979
315690;201809;2623;6935;1690;5293;394;1274;478;1637;872;2911
315700;201809;7043;20511;5504;17455;1023;3476;2501;7664;3524;11140
315710;201809;1849;4812;1287;3904;74;328;886;2512;960;2840
315720;201809;4070;11975;3489;10901;193;907;2443;7270;2636;8177
315725;201809;1594;4535;1340;4187;169;534;918;2937;1087;3471
315727;201809;535;1486;394;1224;61;214;186;546;247;760
315730;201809;633;1982;558;1818;74;274;256;781;330;1055
315733;201809;1370;3617;962;2882;163;585;364;1019;527;1604
315737;201809;1072;3182;865;2790;50;203;608;1910;658;2113
315740;201809;904;2617;713;2223;133;484;359;1015;492;1499
315750;201809;1189;3331;998;3021;97;323;631;1904;728;2227
315760;201809;1176;2847;1085;2741;50;117;963;2452;1013;2569
315765;201809;1831;5051;1533;4661;45;178;1346;4072;1391;4250
315770;201809;1030;3195;883;2986;342;1271;293;927;635;2198
315780;201809;25610;74504;22021;67865;2232;8291;13679;40202;15911;48493
315790;201809;3518;11153;3031;10240;231;813;2033;7020;2264;7833
315800;201809;1187;4519;879;3633;177;826;201;757;378;1583
315810;201809;1270;3237;1109;2999;54;201;883;2266;937;2467
315820;201809;2358;7084;2043;6569;242;868;1391;4381;1633;5249
315830;201809;1072;3201;783;2657;72;304;336;1080;408;1384
315840;201809;786;1989;482;1400;61;205;211;556;272;761
315850;201809;1053;3316;884;3017;190;705;440;1416;630;2121
315860;201809;492;1516;345;1220;74;281;99;328;173;609
315870;201809;440;1184;356;1058;32;120;240;663;272;783
315880;201809;1100;2917;761;2322;63;257;241;667;304;924
315890;201809;1439;4545;1215;4162;356;1315;528;1729;884;3044
315895;201809;5758;16226;4513;13735;630;2204;2158;6028;2788;8232
315900;201809;831;2187;726;2044;60;193;559;1519;619;1712
315910;201809;478;1472;417;1369;72;256;266;846;338;1102
315920;201809;1556;4197;825;2588;158;525;234;680;392;1205
315930;201809;1005;2420;689;1923;134;380;301;825;435;1205
315935;201809;780;2470;650;2215;141;514;214;753;355;1267
315940;201809;565;1706;476;1537;61;210;249;791;310;1001
315950;201809;1159;3287;994;3019;118;345;740;2269;858;2614
315960;201809;3527;10240;2117;7452;719;2958;136;298;855;3256
315970;201809;598;1695;474;1518;54;180;333;1076;387;1256
315980;201809;3688;8410;2098;5735;448;1316;709;1801;1157;3117
315990;201809;3521;9219;2791;7986;330;1018;1628;4573;1958;5591
316000;201809;504;1430;397;1255;71;275;165;478;236;753
316010;201809;651;1958;518;1695;53;212;312;939;365;1151
316020;201809;970;3007;802;2689;79;355;499;1539;578;1894
316030;201809;2729;7820;2044;6585;238;795;1314;4289;1552;5084
316040;201809;2853;9281;2160;7901;319;1186;787;3083;1106;4269
316045;201809;1908;5330;1776;5141;128;292;1468;4400;1596;4692
316050;201809;345;1057;259;891;45;179;139;453;184;632
316060;201809;668;1850;509;1600;45;176;329;967;374;1143
316070;201809;5461;15867;4549;14083;855;2860;2085;6174;2940;9034
316080;201809;701;2279;572;2009;157;610;74;254;231;864
316090;201809;432;1313;302;1035;50;201;120;377;170;578
316095;201809;1273;4012;1072;3579;245;851;453;1503;698;2354
316100;201809;2482;7663;1800;6093;335;1230;570;1776;905;3006
316105;201809;837;2289;638;1978;82;265;411;1273;493;1538
316110;201809;12221;37645;10423;34529;1170;4177;6823;22598;7993;26775
316120;201809;1016;3118;679;2255;125;439;161;447;286;886
316130;201809;1223;2817;744;2037;77;266;401;1050;478;1316
316140;201809;1042;2859;676;2199;127;436;335;1074;462;1510
316150;201809;1608;3909;1355;3520;260;789;587;1393;847;2182
316160;201809;1030;2938;837;2585;82;288;512;1529;594;1817
316165;201809;866;2216;671;1901;112;372;364;983;476;1355
316170;201809;1068;2885;805;2474;91;320;475;1391;566;1711
316180;201809;1259;3757;834;2833;187;705;139;387;326;1092
316190;201809;2537;7476;1486;4889;254;854;526;1520;780;2374
316200;201809;3172;9498;2313;7840;550;2074;555;1795;1105;3869
316210;201809;3849;11768;2814;9412;957;3398;309;1049;1266;4447
316220;201809;596;1844;403;1403;87;329;50;197;137;526
316225;201809;1374;3316;1045;2747;51;202;765;1862;816;2064
316230;201809;423;1139;321;985;39;114;163;512;202;626
316240;201809;5779;17030;5123;15971;490;1607;3881;11976;4371;13583
316245;201809;2946;10037;2666;9553;170;946;2039;6965;2209;7911
316250;201809;8990;23303;6459;19000;1705;5447;1796;5128;3501;10575
316255;201809;2740;7902;2395;7373;227;778;1712;5299;1939;6077
316257;201809;1199;3020;852;2466;144;448;418;1175;562;1623
316260;201809;1801;4800;1360;4105;58;199;778;2421;836;2620
316265;201809;1258;3365;913;2768;52;195;618;1825;670;2020
316270;201809;3386;10956;2940;9941;571;2071;1335;4328;1906;6399
316280;201809;2945;9002;2558;8277;384;1382;1395;4360;1779;5742
316290;201809;3166;9244;2484;7907;406;1514;915;2875;1321;4389
316292;201809;4516;12645;3737;11351;426;1512;2610;7718;3036;9230
316294;201809;745;2283;548;1934;114;457;100;330;214;787
316295;201809;2602;7593;2175;6803;139;595;1536;4555;1675;5150
316300;201809;939;2978;795;2701;61;238;519;1767;580;2005
316310;201809;955;2389;550;1717;89;308;192;564;281;872
316320;201809;556;1633;426;1398;58;223;182;580;240;803
316330;201809;1045;2964;778;2433;68;259;527;1578;595;1837
316340;201809;1037;3029;763;2477;84;361;404;1219;488;1580
316350;201809;1164;3557;1014;3315;134;486;654;2111;788;2597
316360;201809;653;1734;529;1530;60;194;369;1049;429;1243
316370;201809;4422;12697;3486;10866;794;2844;1108;3084;1902;5928
316380;201809;1594;4004;1240;3517;39;110;894;2517;933;2627
316390;201809;833;2279;622;1909;208;715;169;483;377;1198
316400;201809;1217;3566;825;2787;143;527;297;928;440;1455
316410;201809;1053;3212;881;2927;66;243;692;2252;758;2495
316420;201809;1670;5129;1500;4891;100;420;1198;3826;1298;4246
316430;201809;834;2349;532;1767;130;462;120;378;250;840
316440;201809;691;2199;528;1920;141;582;74;258;215;840
316443;201809;566;1670;437;1417;114;410;111;357;225;767
316447;201809;1756;4876;1537;4550;70;243;1239;3651;1309;3894
316450;201809;2157;6811;1682;5812;212;799;1048;3554;1260;4353
316460;201809;912;2515;766;2282;203;651;377;1058;580;1709
316470;201809;5922;17722;4486;14774;929;3505;1567;4746;2496;8251
316480;201809;195;585;168;531;33;117;78;230;111;347
316490;201809;306;840;222;672;29;98;94;255;123;353
316500;201809;1194;3954;766;2837;159;624;118;418;277;1042
316510;201809;622;2226;539;2055;129;524;227;873;356;1397
316520;201809;975;2731;776;2385;129;483;343;989;472;1472
316530;201809;990;2855;752;2408;120;506;326;901;446;1407
316540;201809;689;2024;588;1855;116;430;237;683;353;1113
316550;201809;1233;3865;1106;3608;99;392;811;2583;910;2975
316553;201809;3267;10165;2219;7601;540;1997;485;1501;1025;3498
316555;201809;2546;8527;2322;8200;155;619;1773;6379;1928;6998
316556;201809;587;1439;414;1144;25;72;243;601;268;673
316557;201809;889;3005;780;2804;319;1208;231;803;550;2011
316560;201809;267;828;204;739;56;244;53;170;109;414
316570;201809;1068;3354;957;3123;266;871;347;1134;613;2005
316580;201809;373;888;233;643;50;156;92;243;142;399
316590;201809;1289;3473;936;2795;172;532;511;1443;683;1975
316600;201809;964;3070;845;2817;149;553;448;1453;597;2006
316610;201809;589;1921;490;1753;65;314;308;1036;373;1350
316620;201809;1976;5700;1728;5330;105;388;1288;3981;1393;4369
316630;201809;1491;4580;1192;3986;340;1140;450;1653;790;2793
316640;201809;135;376;113;343;24;78;57;144;81;222
316650;201809;988;3283;800;2981;70;277;494;1905;564;2182
316660;201809;193;484;86;256;12;42;10;26;22;68
316670;201809;1876;4989;1422;4217;398;1241;442;1270;840;2511
316680;201809;2021;5334;1583;4609;150;504;1128;3194;1278;3698
316690;201809;1052;3272;869;2928;202;764;363;1195;565;1959
316695;201809;969;2923;819;2646;42;179;559;1773;601;1952
316700;201809;378;948;318;879;16;74;244;631;260;705
316710;201809;2704;9448;2108;8143;594;2385;748;2942;1342;5327
316720;201809;18663;54332;14158;45315;3047;10471;5511;16935;8558;27406
316730;201809;374;1092;310;955;61;215;134;364;195;579
316740;201809;653;2033;586;1932;67;300;417;1340;484;1640
316750;201809;397;1250;303;1052;69;257;114;377;183;634
316760;201809;3596;11538;2889;10145;1242;4669;796;2711;2038;7380
316770;201809;1473;3718;1196;3332;37;129;1013;2839;1050;2968
316780;201809;563;1746;438;1505;144;564;66;198;210;762
316790;201809;704;1935;511;1575;118;377;160;478;278;855
316800;201809;5638;16674;4599;14746;442;1673;2645;8204;3087;9877
316805;201809;957;2168;823;2018;18;28;741;1879;759;1907
316810;201809;556;1566;394;1264;88;333;182;561;270;894
316820;201809;324;804;166;512;18;62;48;150;66;212
316830;201809;647;1897;545;1731;93;367;329;992;422;1359
316840;201809;2541;7312;2170;6609;362;1291;1197;3442;1559;4733
316850;201809;2002;5435;1446;4424;203;686;667;1987;870;2673
316860;201809;16883;47283;13177;41484;2612;9391;5921;18156;8533;27547
316870;201809;6349;18708;4829;15592;1051;3716;1734;5278;2785;8994
316880;201809;799;2208;662;2003;137;473;296;869;433;1342
316890;201809;1119;2593;716;2051;147;503;394;998;541;1501
316900;201809;2176;6154;1754;5275;383;1277;606;1656;989;2933
316905;201809;481;1506;390;1313;84;306;164;547;248;853
316910;201809;851;2385;566;1892;155;602;54;161;209;763
316920;201809;1569;4118;1042;3261;188;644;456;1429;644;2073
316930;201809;7480;23306;5502;19331;1089;4178;1251;4236;2340;8414
316935;201809;3705;10693;2681;8740;637;2192;841;2710;1478;4902
316940;201809;6541;20092;5001;16651;951;3547;1661;5052;2612;8599
316950;201809;1713;4286;1339;3754;55;206;1053;2865;1108;3071
316960;201809;4815;11562;3608;9819;510;1525;2266;6019;2776;7544
316970;201809;3211;9718;2856;9014;695;2262;1049;3157;1744;5419
316980;201809;694;2132;501;1735;158;606;65;229;223;835
316990;201809;9746;28232;7241;22875;2061;6898;856;2496;2917;9394
317000;201809;2572;8082;2354;7763;179;583;1734;5774;1913;6357
317005;201809;2467;7277;2036;6435;366;1187;1038;3225;1404;4412
317010;201809;20884;51232;12873;38731;3354;11019;3456;10931;6810;21950
317020;201809;56094;140554;32414;96689;6697;21811;8658;23666;15355;45477
317030;201809;640;1830;517;1643;35;145;382;1188;417;1333
317040;201809;10123;26896;7287;21891;1816;5690;2730;8376;4546;14066
317043;201809;772;1896;605;1655;103;299;378;1042;481;1341
317047;201809;1142;2815;777;2219;128;343;422;1228;550;1571
317050;201809;1221;3902;875;3094;123;468;325;1036;448;1504
317052;201809;2295;6815;1902;6140;248;879;1236;3927;1484;4806
317057;201809;1593;4093;1153;3326;62;236;750;2089;812;2325
317060;201809;405;1112;230;735;38;124;84;242;122;366
317065;201809;1220;3554;994;3131;65;248;655;1934;720;2182
317070;201809;7573;21709;5058;16556;1146;4211;1084;3376;2230;7587
317075;201809;875;2523;614;1986;131;440;157;479;288;919
317080;201809;5592;13985;4277;11781;1470;4228;1185;3069;2655;7297
317090;201809;4262;13473;3901;12883;362;1211;2860;9422;3222;10633
317100;201809;2461;6045;1669;4815;493;1521;553;1561;1046;3082
317103;201809;1779;5720;1567;5325;201;946;994;3120;1195;4066
317107;201809;1295;3674;1042;3158;67;282;631;1696;698;1978
317110;201809;670;1477;324;963;45;171;109;332;154;503
317115;201809;1086;3197;918;2869;68;213;673;2094;741;2307
317120;201809;11481;33647;9049;29412;1475;5389;4685;14699;6160;20088
317130;201809;8908;22051;5705;16745;1224;3969;1873;5440;3097;9409
317140;201809;587;1773;505;1618;57;182;316;1021;373;1203
317150;201809;1004;2515;799;2254;40;158;632;1719;672;1877
317160;201809;3513;8726;2439;7105;247;744;1456;4273;1703;5017
317170;201809;1901;4911;1326;3871;227;783;508;1284;735;2067
317180;201809;1623;5357;1259;4491;294;1111;325;1095;619;2206
317190;201809;1210;3416;917;2932;116;385;552;1754;668;2139
317200;201809;4653;12782;3472;10626;921;3055;764;2171;1685;5226
317210;201809;1081;2823;857;2497;51;200;618;1814;669;2014
317220;201809;254;847;228;783;61;222;88;292;149;514
320010;201809;4391;13208;3627;11711;432;1553;2294;7200;2726;8753
320013;201809;1593;4858;1166;3869;190;618;532;1805;722;2423
320016;201809;2955;7839;2402;7036;123;358;1926;5621;2049;5979
320020;201809;3822;10759;2909;9093;764;2543;981;3153;1745;5696
320030;201809;1452;4411;1022;3474;251;934;330;1049;581;1983
320035;201809;1635;4710;1392;4297;397;1331;603;1809;1000;3140
320040;201809;3322;10074;2734;8946;452;1583;1383;4440;1835;6023
320050;201809;1723;4160;1499;3801;275;773;852;2104;1127;2877
320060;201809;9888;29242;7420;24237;1406;5019;2947;9232;4353;14251
320070;201809;1345;3984;985;3242;206;725;317;1012;523;1737
320080;201809;5273;14419;3882;11687;809;2566;1500;4489;2309;7055
320090;201809;6697;18731;4927;15159;1183;3854;2050;6037;3233;9891
320100;201809;2462;7344;1937;6329;473;1664;853;2697;1326;4361
320110;201809;1267;3423;1005;2951;222;673;387;1138;609;1811
320115;201809;1748;5885;1522;5476;692;2565;472;1776;1164;4341
320120;201809;15151;41527;10897;33691;2202;7432;4008;11861;6210;19293
320130;201809;35468;105640;30336;96122;5093;17658;16796;51861;21889;69519
320140;201809;2857;8509;2101;6928;459;1734;756;2433;1215;4167
320150;201809;12771;35068;9163;27904;2726;8664;1779;5394;4505;14058
320160;201809;5214;15550;4020;13161;742;2601;1861;6032;2603;8633
320170;201809;1500;4544;1112;3717;321;1091;395;1316;716;2407
320180;201809;673;2240;549;1982;202;775;121;431;323;1206
320190;201809;2745;9170;2101;7630;555;2100;470;1682;1025;3782
320200;201809;997;2921;734;2429;206;772;230;757;436;1529
320210;201809;4389;11663;3453;10016;600;1898;1811;5056;2411;6954
320220;201809;2602;7337;1992;6248;379;1267;1010;3100;1389;4367
320225;201809;1295;4208;920;3260;349;1311;132;459;481;1770
320230;201809;4329;12748;3341;11012;845;3058;1370;4467;2215;7525
320240;201809;13123;35864;10221;31022;2212;7162;4390;13303;6602;20465
320245;201809;2744;8644;2288;7657;964;3313;552;1839;1516;5152
320250;201809;1813;5289;1244;3958;312;1108;298;886;610;1994
320255;201809;1601;5360;1420;5028;533;1920;586;2190;1119;4110
320260;201809;1039;3101;744;2391;219;770;189;507;408;1277
320265;201809;2331;7411;1970;6686;908;3219;465;1586;1373;4805
320270;201809;2173;6463;1656;5388;338;1174;769;2492;1107;3666
320280;201809;5235;15274;4326;13581;1208;4025;1516;4735;2724;8760
320290;201809;1215;3802;842;2879;259;969;190;601;449;1570
320300;201809;3513;11277;2874;9859;967;3547;605;2016;1572;5563
320305;201809;4516;13521;3626;11653;864;2954;1573;4899;2437;7853
320310;201809;1768;5090;1266;4009;265;882;528;1635;793;2517
320313;201809;2106;5651;1364;4118;331;1084;283;812;614;1896
320316;201809;1494;4334;1174;3705;215;713;629;1981;844;2694
320320;201809;19604;53914;14021;44101;3610;11911;5111;16107;8721;28018
320330;201809;2757;7926;2207;6901;585;1792;984;3225;1569;5017
320332;201809;5135;15533;4306;14023;1023;3544;2192;7032;3215;10576
320334;201809;1871;5693;1318;4485;325;1279;292;862;617;2141
320335;201809;1681;4974;1072;3547;300;1067;217;650;517;1717
320340;201809;4670;12396;3912;11206;635;1898;2150;6274;2785;8172
320350;201809;4864;12496;3434;9881;537;1690;1647;4519;2184;6209
320360;201809;1469;3843;1073;3074;162;455;521;1448;683;1903
320370;201809;2423;7930;1885;6638;574;2070;650;2282;1224;4352
320380;201809;2156;6079;1824;5526;341;1130;1012;2962;1353;4092
320390;201809;6995;19785;5271;16205;1215;3965;2064;6110;3279;10075
320400;201809;3223;9532;2602;8205;687;2274;1044;3236;1731;5510
320405;201809;4362;12006;3387;10327;535;1711;1763;5334;2298;7045
320410;201809;4657;12769;3566;11017;600;1882;1816;5848;2416;7730
320420;201809;2588;7389;2059;6469;607;2096;565;1755;1172;3851
320425;201809;1951;4791;1501;4047;129;396;986;2537;1115;2933
320430;201809;2637;6887;2068;5766;311;932;1233;3276;1544;4208
320435;201809;2186;7132;1759;6255;643;2381;508;1849;1151;4230
320440;201809;1178;3482;896;2908;153;550;407;1287;560;1837
320450;201809;1534;4635;1226;4031;303;1106;556;1724;859;2830
320455;201809;3709;11695;2586;8986;764;2809;707;2393;1471;5202
320460;201809;2112;6532;1477;5093;373;1345;359;1168;732;2513
320465;201809;1177;3445;899;2875;118;412;523;1677;641;2089
320470;201809;3643;10388;2504;7972;686;2329;558;1648;1244;3977
320480;201809;1593;4708;1363;4255;256;886;699;2116;955;3002
320490;201809;16514;46301;12817;39626;2468;8527;5395;16569;7863;25096
320495;201809;1355;3844;913;2955;209;740;304;942;513;1682
320500;201809;44131;124422;36811;111215;6583;21414;20345;59559;26928;80973
320501;201809;4452;13303;3245;11115;912;3495;1022;3412;1934;6907
320503;201809;1944;6167;1460;5114;473;1821;464;1490;937;3311
320506;201809;2718;8311;1862;6294;582;2139;134;418;716;2557
320510;201809;9211;26165;7509;23073;1213;4163;4227;12596;5440;16759
320515;201809;1699;4715;1320;3937;399;1262;372;1116;771;2378
320517;201809;1954;6226;1582;5398;557;2042;365;1227;922;3269
320520;201809;30624;85638;23504;73355;4895;16685;9725;29964;14620;46649
320530;201809;27634;77106;21695;66300;2894;10464;12731;36593;15625;47057
330010;201809;18942;54476;15923;49161;3158;10125;8842;27131;12000;37256
330015;201809;1272;3383;1050;2996;171;555;581;1580;752;2135
330020;201809;18695;49403;16534;46252;2461;7781;11545;31422;14006;39203
330022;201809;1836;5074;1442;4404;261;854;863;2597;1124;3451
330023;201809;3407;9162;2601;7937;593;1901;1168;3500;1761;5401
330025;201809;4707;12055;3252;9499;970;3061;1052;3048;2022;6109
330030;201809;8883;26150;7155;22966;1034;3810;4137;12573;5171;16383
330040;201809;11398;32188;9852;29450;1349;4485;6435;18594;7784;23079
330045;201809;78208;194964;66505;179167;7395;19407;50099;134197;57494;153604
330050;201809;2238;6196;1725;5317;408;1358;788;2305;1196;3663
330060;201809;4856;13489;4088;12215;933;3081;1803;5057;2736;8138
330070;201809;19817;54362;16716;49532;3259;10268;8924;26315;12183;36583
330080;201809;8362;22866;7395;21380;942;2815;4917;14158;5859;16973
330090;201809;2885;6508;2118;5483;218;610;1380;3518;1598;4128
330093;201809;2077;5672;1615;4929;179;563;1123;3448;1302;4011
330095;201809;1020;3170;850;2825;101;404;445;1354;546;1758
330100;201809;60556;170523;52272;157847;4344;15435;38071;113090;42415;128525
330110;201809;1979;5986;1757;5604;334;1195;866;2650;1200;3845
330115;201809;1780;4815;1428;4271;229;749;869;2540;1098;3289
330120;201809;3083;7391;2415;6528;208;622;1787;4728;1995;5350
330130;201809;3326;9736;2834;8992;506;1735;1686;5352;2192;7087
330140;201809;3196;8938;2672;8131;454;1590;1597;4701;2051;6291
330150;201809;1979;5576;1577;4907;351;1149;692;2105;1043;3254
330160;201809;1144;3299;954;3016;209;733;488;1467;697;2200
330170;201809;89590;245107;77699;228038;12434;36977;49983;147627;62417;184604
330180;201809;2005;5327;1630;4732;135;482;1120;3128;1255;3610
330185;201809;8991;24831;7556;22388;889;3022;5236;14990;6125;18012
330187;201809;3544;9536;2929;8583;438;1419;1852;5353;2290;6772
330190;201809;28414;73411;25129;68769;2561;7359;19254;52134;21815;59493
330200;201809;13473;37569;11562;34991;2642;7610;6858;21473;9500;29083
330205;201809;1880;4978;1549;4423;116;389;1077;2965;1193;3354
330210;201809;3223;8597;2354;6924;471;1478;861;2370;1332;3848
330220;201809;9564;26294;7346;22138;1785;5848;2210;6141;3995;11989
330225;201809;3325;9153;2714;8188;260;991;1932;5638;2192;6629
330227;201809;15698;41237;13741;38611;1122;3506;11016;30532;12138;34038
330230;201809;1419;3635;1095;3170;89;280;753;2135;842;2415
330240;201809;18706;52209;15410;46614;3160;10386;8164;24016;11324;34402
330245;201809;1358;3654;902;2842;228;750;254;808;482;1558
330250;201809;33197;91328;28661;84202;7072;21064;14150;42403;21222;63467
330260;201809;4186;11598;3345;10266;536;1793;1875;5513;2411;7306
330270;201809;24341;51565;14814;37717;2854;7866;6199;15551;9053;23417
330280;201809;2204;6051;1709;5164;231;770;950;2756;1181;3526
330285;201809;19281;49681;15934;44805;1866;5965;10992;29961;12858;35926
330290;201809;3069;8492;2593;7695;399;1263;1511;4365;1910;5628
330300;201809;3962;11009;3199;9780;392;1392;2073;6115;2465;7507
330310;201809;2177;5858;1722;5079;129;377;1110;3287;1239;3664
330320;201809;13070;34686;11411;32396;1653;4726;8143;23291;9796;28017
330330;201809;28349;70076;23706;63355;3016;8975;16450;42838;19466;51813
330340;201809;12982;34967;9964;29885;2034;6700;4550;13026;6584;19726
330350;201809;95018;246807;81809;229171;8286;24625;61675;171946;69961;196571
330360;201809;7322;18531;6311;17331;409;1201;5181;14150;5590;15351
330370;201809;3703;11908;3084;10634;803;2934;1235;4293;2038;7227
330380;201809;4736;13799;3733;11997;870;3070;1531;4757;2401;7827
330385;201809;3715;11653;3183;10808;848;3144;1404;4787;2252;7931
330390;201809;21900;65318;17674;57079;3473;12254;8696;27002;12169;39256
330395;201809;2969;8017;2562;7457;221;739;1774;5054;1995;5793
330400;201809;2798;7982;2492;7427;206;762;1779;4988;1985;5750
330410;201809;2635;7615;1973;6404;398;1431;873;2688;1271;4119
330411;201809;2462;7035;2041;6212;202;708;1415;4127;1617;4835
330412;201809;1409;4363;1168;3905;181;667;631;1965;812;2632
330414;201809;22355;59012;18512;53622;2405;6898;12516;36275;14921;43173
330415;201809;3391;9679;2659;8401;445;1397;1402;4560;1847;5957
330420;201809;8507;22257;5684;17456;996;3308;2218;6520;3214;9828
330430;201809;8139;21485;7077;19826;662;2199;5049;13621;5711;15820
330440;201809;1653;4896;1370;4446;357;1307;619;1886;976;3193
330450;201809;1291;3936;1048;3476;176;624;512;1650;688;2274
330452;201809;14238;38453;11210;33443;2139;6902;6070;17648;8209;24550
330455;201809;511693;1290642;399256;1117994;70035;207596;234355;646130;304390;853726
330460;201809;1148;3383;905;3003;199;697;426;1373;625;2070
330470;201809;4222;11366;3251;9789;898;2775;1303;3926;2201;6701
330475;201809;8120;22590;6710;20598;1498;5005;3738;11284;5236;16289
330480;201809;5606;15567;4884;14418;617;2074;3116;8897;3733;10971
330490;201809;110465;268329;94146;245135;10282;29004;67949;173691;78231;202695
330500;201809;5312;14931;4775;14124;676;2177;3382;9849;4058;12026
330510;201809;35625;97571;28837;87517;7668;23795;14397;43779;22065;67574
330513;201809;1098;3168;955;2906;292;943;366;1092;658;2035
330515;201809;2483;7062;2063;6351;609;1973;865;2586;1474;4559
330520;201809;9914;28384;8396;25756;1537;5194;4441;13162;5978;18356
330530;201809;1529;3992;1178;3390;260;817;521;1426;781;2243
330540;201809;2696;7522;2132;6517;656;2069;769;2315;1425;4384
330550;201809;7454;22617;6301;20699;2333;8102;1743;5740;4076;13842
330555;201809;12045;30207;10229;27770;1429;4189;7001;19123;8430;23312
330560;201809;4128;11629;3466;10429;490;1556;2086;6088;2576;7644
330570;201809;2728;7863;2309;7126;432;1453;1366;4144;1798;5597
330575;201809;5182;14053;4576;12986;410;1318;3467;9505;3877;10823
330580;201809;11684;34014;9269;29397;2332;7920;4024;12390;6356;20310
330590;201809;1494;4258;1320;4038;174;521;926;2876;1100;3397
330600;201809;10681;30314;8598;26570;1347;4303;4659;14364;6006;18667
330610;201809;8564;24463;7365;22590;840;3035;4792;14221;5632;17256
330615;201809;1751;5265;1443;4832;349;1304;818;2717;1167;4021
330620;201809;3527;11075;2930;9970;898;3301;962;3091;1860;6392
330630;201809;23110;61724;18424;53958;1984;6853;12418;34883;14402;41736
350010;201809;1786;4985;917;2967;246;833;108;291;354;1124
350020;201809;651;1744;343;1108;40;143;137;409;177;552
350030;201809;3613;10659;2721;8905;742;2576;888;2824;1630;5400
350040;201809;595;1855;376;1351;77;314;107;320;184;634
350050;201809;809;2288;598;1873;142;512;179;447;321;959
350055;201809;709;1919;602;1763;52;178;470;1356;522;1534
350060;201809;103;296;78;251;17;55;38;124;55;179
350070;201809;3594;9769;2215;7077;454;1530;701;2040;1155;3570
350075;201809;590;1846;444;1536;189;676;59;178;248;854
350080;201809;617;1666;385;1202;40;133;173;496;213;629
350090;201809;610;1500;351;1009;93;284;101;270;194;554
350100;201809;1953;5429;1300;4227;167;645;645;1956;812;2601
350110;201809;394;1135;303;954;25;94;194;591;219;685
350115;201809;1267;3794;1042;3292;189;665;535;1536;724;2201
350120;201809;742;1974;439;1351;56;171;258;801;314;972
350130;201809;3048;8526;2457;7361;381;1241;1323;3759;1704;5000
350140;201809;582;1860;461;1624;43;202;252;816;295;1018
350150;201809;511;1591;432;1429;125;433;124;384;249;817
350160;201809;10224;26108;6690;19733;893;3108;3868;10676;4761;13784
350170;201809;1590;4896;1240;4068;272;955;424;1317;696;2272
350180;201809;1074;2745;570;1728;117;392;203;566;320;958
350190;201809;2805;8232;2003;6516;464;1671;752;2040;1216;3711
350200;201809;390;1105;320;970;21;70;223;637;244;707
350210;201809;5023;12240;3354;9557;665;1983;1782;4930;2447;6913
350220;201809;2298;6779;1746;5598;399;1376;681;1985;1080;3361
350230;201809;889;2558;770;2354;152;499;397;1179;549;1678
350240;201809;660;1972;453;1492;87;292;158;506;245;798
350250;201809;2196;7059;1726;6154;630;2418;341;1285;971;3703
350260;201809;788;1993;508;1476;76;226;274;768;350;994
350270;201809;4401;12591;3558;10868;626;2083;1787;5112;2413;7195
350275;201809;2142;6225;1757;5510;342;1173;891;2627;1233;3800
350280;201809;18479;42686;11231;30820;2224;6481;3996;10686;6220;17167
350290;201809;2951;8570;2025;6666;388;1383;795;2563;1183;3946
350300;201809;626;1792;459;1434;95;312;171;496;266;808
350310;201809;751;2267;603;1942;98;384;258;751;356;1135
350315;201809;531;1487;367;1176;46;175;148;425;194;600
350320;201809;11345;31584;9057;27424;2490;8040;2478;7447;4968;15487
350330;201809;13621;34784;9592;26606;1369;4105;5444;14332;6813;18437
350335;201809;340;982;277;872;21;67;181;571;202;638
350340;201809;1029;2780;625;2014;119;417;219;684;338;1101
350350;201809;702;1954;557;1780;93;322;279;857;372;1179
350360;201809;923;2913;760;2534;237;788;252;849;489;1637
350370;201809;565;1536;379;1142;120;347;81;235;201;582
350380;201809;4328;12059;2947;9362;789;2589;829;2621;1618;5210
350390;201809;9147;25963;7459;22878;2026;6386;2957;8883;4983;15269
350395;201809;406;1044;190;623;22;69;55;163;77;232
350400;201809;7218;19135;5189;15615;1434;4665;1541;4435;2975;9100
350410;201809;8407;24927;6243;20600;1615;5947;1972;6030;3587;11977
350420;201809;584;1710;435;1423;91;344;92;262;183;606
350430;201809;678;1934;564;1727;70;268;357;1008;427;1276
350440;201809;1527;4250;1231;3732;170;592;763;2259;933;2851
350450;201809;6065;18009;4902;15760;1181;4043;1825;5589;3006;9632
350460;201809;1550;4010;807;2500;151;518;187;521;338;1039
350470;201809;237;612;188;525;8;35;123;312;131;347
350480;201809;801;2212;526;1656;111;392;72;186;183;578
350490;201809;1623;4657;1226;3900;309;1017;408;1204;717;2221
350500;201809;610;1714;484;1475;89;301;243;710;332;1011
350510;201809;1014;2854;744;2323;109;377;397;1171;506;1548
350520;201809;1757;5829;1360;4947;272;1098;546;1861;818;2959
350530;201809;2289;6094;1711;4929;345;1073;836;2261;1181;3334
350535;201809;1362;3961;1200;3724;142;512;810;2449;952;2961
350540;201809;1600;4267;1177;3545;217;691;593;1789;810;2480
350550;201809;8793;21914;5890;17117;735;2478;3085;8417;3820;10895
350560;201809;3530;10531;2863;9206;289;999;1755;5496;2044;6495
350570;201809;19724;58428;16262;51388;3908;13408;7321;22113;11229;35521
350580;201809;1609;4689;921;3041;223;770;122;333;345;1103
350590;201809;4135;11931;3041;9457;613;2161;1538;4387;2151;6548
350600;201809;36109;87743;23203;63868;3332;10209;11595;29372;14927;39581
350610;201809;6251;17798;4669;14691;1000;3324;2012;6166;3012;9490
350620;201809;370;963;255;795;31;107;134;398;165;505
350630;201809;1423;3865;1028;3122;89;332;593;1683;682;2015
350635;201809;7060;18819;5425;16099;1051;3469;2870;8088;3921;11557
350640;201809;816;2337;469;1488;67;234;156;427;223;661
350650;201809;7401;20789;4920;15536;1029;3473;1503;4401;2532;7874
350660;201809;4341;12030;3426;10434;690;2171;1676;5157;2366;7328
350670;201809;1521;4464;1351;4188;217;704;799;2477;1016;3181
350680;201809;1051;2945;703;2256;143;493;307;950;450;1443
350690;201809;1066;3093;808;2578;146;508;414;1253;560;1761
350700;201809;4007;11095;2953;9339;689;2400;1377;4122;2066;6522
350710;201809;2525;7344;2185;6744;312;1076;1268;3745;1580;4821
350715;201809;803;2329;683;2090;80;299;372;1036;452;1335
350720;201809;156;406;117;338;20;59;56;150;76;209
350730;201809;450;1411;345;1189;53;198;181;590;234;788
350740;201809;1503;4360;1009;3248;182;617;273;807;455;1424
350745;201809;513;1419;316;996;35;125;138;385;173;510
350750;201809;8508;24208;6882;21093;1394;4861;2844;7802;4238;12663
350760;201809;12373;32813;8989;26976;2477;8023;2531;6868;5008;14891
350770;201809;712;1909;498;1494;60;187;307;902;367;1089
350775;201809;624;1604;456;1323;63;196;207;586;270;782
350780;201809;1801;4948;1355;4173;316;1065;394;1345;710;2410
350790;201809;1583;4507;993;3334;219;820;182;531;401;1351
350800;201809;3003;9364;2666;8707;459;1606;1366;4353;1825;5959
350810;201809;2112;5561;1775;5108;279;828;1060;3157;1339;3985
350820;201809;776;1933;439;1286;50;161;212;567;262;728
350830;201809;818;2365;473;1573;66;241;143;413;209;654
350840;201809;2618;8195;1974;6898;549;2079;678;2220;1227;4299
350850;201809;6152;18517;4794;15788;1310;4498;1520;4951;2830;9449
350860;201809;3051;8855;2793;8469;147;577;2144;6358;2291;6935
350870;201809;2616;7724;1960;6615;367;1388;982;3196;1349;4584
350880;201809;1172;3617;952;3103;241;814;312;992;553;1806
350890;201809;568;1530;358;1083;48;168;131;332;179;500
350900;201809;6193;17928;4005;13024;1269;4482;622;1871;1891;6353
350910;201809;830;2249;715;2033;120;401;460;1265;580;1666
350920;201809;11358;29796;9714;26971;595;1952;7633;20328;8228;22280
350925;201809;4281;12373;3101;10094;680;2327;1216;3605;1896;5932
350930;201809;1366;3634;933;2795;128;403;476;1347;604;1750
350940;201809;1870;5483;1542;4830;228;776;954;2911;1182;3687
350945;201809;843;2470;642;2058;124;446;279;818;403;1264
350950;201809;75411;207377;59723;175287;9514;30820;34578;96291;44092;127111
350960;201809;5199;15194;4157;13160;703;2543;2295;6857;2998;9400
350970;201809;3362;10588;2609;8897;901;3336;388;1162;1289;4498
350980;201809;564;1711;467;1502;166;556;168;535;334;1091
350990;201809;1674;5136;1298;4456;348;1349;441;1408;789;2757
350995;201809;759;2453;679;2274;56;236;450;1420;506;1656
351000;201809;2451;6670;1788;5421;382;1251;560;1624;942;2875
351010;201809;300;787;177;544;19;61;92;272;111;333
351015;201809;679;2153;559;1917;96;388;261;815;357;1203
351020;201809;8543;24439;6752;21453;1316;4386;3651;11381;4967;15767
351030;201809;2437;7610;1980;6615;327;1256;1009;3215;1336;4471
351040;201809;4302;11457;3693;10480;254;879;2873;7866;3127;8745
351050;201809;15666;40111;10709;31973;2487;7952;4130;12196;6617;20148
351060;201809;42481;112331;33281;96027;4862;15187;20597;57539;25459;72726
351070;201809;1308;3469;775;2482;251;860;97;298;348;1158
351080;201809;2487;6763;1861;5956;387;1412;950;2837;1337;4249
351090;201809;336;1025;231;825;47;179;53;198;100;377
351100;201809;2248;6357;1488;4713;395;1322;386;1258;781;2580
351110;201809;5501;14610;3629;11121;811;2716;1330;3744;2141;6460
351120;201809;695;1876;476;1462;82;264;204;590;286;854
351130;201809;994;2627;471;1563;98;345;83;255;181;600
351140;201809;1609;5030;1204;4165;339;1287;321;967;660;2254
351150;201809;1773;5377;1109;3824;240;887;283;886;523;1773
351160;201809;1051;3492;874;3087;198;742;300;959;498;1701
351170;201809;1309;3893;1153;3553;139;472;721;2117;860;2589
351190;201809;770;2284;561;1782;110;343;221;651;331;994
351200;201809;1570;4001;1204;3427;81;255;795;2178;876;2433
351210;201809;1337;3363;808;2335;91;304;450;1175;541;1479
351220;201809;2902;8762;2546;8112;389;1276;1567;4947;1956;6223
351230;201809;1701;4913;1280;4149;291;1076;532;1535;823;2611
351240;201809;1778;4793;1171;3491;234;741;521;1417;755;2158
351250;201809;1007;2798;579;1866;78;271;211;669;289;940
351260;201809;890;2467;691;2084;175;511;230;702;405;1213
351270;201809;333;1030;290;943;55;215;153;424;208;639
351280;201809;3854;10827;3079;9283;586;1979;1482;4223;2068;6202
351290;201809;922;2480;634;1934;124;378;296;885;420;1263
351300;201809;13884;40321;9729;31962;2187;7631;3584;11704;5771;19335
351310;201809;2932;7975;2272;6842;248;890;1426;4002;1674;4892
351320;201809;840;2608;642;2106;114;402;231;715;345;1117
351330;201809;1024;3743;962;3634;52;137;831;3239;883;3376
351340;201809;6017;18191;4870;16081;1370;4674;1924;6403;3294;11077
351350;201809;10615;28696;9110;26085;1093;3376;6662;18543;7755;21919
351360;201809;3675;10463;3107;9509;803;2675;1084;3085;1887;5760
351370;201809;2123;6198;1441;4694;371;1246;479;1398;850;2644
351380;201809;42233;109141;31627;89615;5538;16484;16607;45683;22145;62167
351385;201809;254;658;148;452;28;75;50;152;78;227
351390;201809;1289;3336;836;2650;150;566;466;1364;616;1930
351400;201809;868;2573;694;2197;170;535;335;1041;505;1576
351410;201809;2199;6442;1688;5432;328;1076;780;2468;1108;3544
351420;201809;326;817;176;533;39;107;66;194;105;301
351430;201809;716;2191;655;2066;61;224;494;1522;555;1746
351440;201809;3095;8456;2080;6272;420;1377;522;1336;942;2713
351450;201809;1576;4263;1117;3426;247;813;249;699;496;1512
351460;201809;701;1955;573;1732;167;491;276;842;443;1333
351470;201809;1074;2953;864;2562;83;288;536;1495;619;1783
351480;201809;2515;7817;2106;7092;327;1260;1029;3302;1356;4562
351490;201809;1693;5166;1496;4774;94;373;1105;3364;1199;3737
351492;201809;314;887;258;771;17;60;158;445;175;505
351495;201809;170;514;139;435;19;70;77;225;96;295
351500;201809;33686;87604;24884;71783;5117;15617;12504;34544;17621;50161
351510;201809;10949;29331;8161;24123;1297;4195;4764;13508;6061;17703
351512;201809;477;1336;318;975;56;177;110;301;166;478
351515;201809;2933;6959;1781;5045;368;1166;471;1340;839;2506
351518;201809;2112;5726;1429;4485;229;843;765;2171;994;3014
351519;201809;561;1653;386;1241;74;265;87;224;161;489
351520;201809;1069;2754;418;1326;69;242;159;436;228;678
351530;201809;339;969;185;601;38;126;58;148;96;274
351535;201809;1971;4920;1455;4054;190;630;868;2265;1058;2895
351540;201809;1862;4992;1285;3961;448;1527;233;581;681;2108
351550;201809;5571;14950;3807;11337;535;1803;1986;5486;2521;7289
351560;201809;360;1120;299;990;80;302;90;280;170;582
351565;201809;170;546;138;486;37;136;45;147;82;283
351570;201809;16921;47563;12932;38929;1776;5883;7959;22955;9735;28838
351580;201809;276;734;157;492;20;58;58;196;78;254
351590;201809;497;1181;270;747;32;116;152;376;184;492
351600;201809;1509;4034;1154;3383;140;452;671;1827;811;2279
351610;201809;632;1575;430;1231;30;117;239;610;269;727
351620;201809;18535;53410;14090;44912;2711;9883;5782;16563;8493;26446
351630;201809;24780;69999;20557;62263;3800;11996;12342;36613;16142;48609
351640;201809;14879;41654;11763;35617;1519;5199;7619;22158;9138;27357
351650;201809;383;1082;170;573;29;95;31;106;60;201
351660;201809;712;2150;444;1458;80;285;80;238;160;523
351670;201809;4761;13506;3497;10706;703;2234;1703;4891;2406;7125
351680;201809;412;1240;261;839;57;164;65;195;122;359
351685;201809;410;1260;328;1103;82;275;105;338;187;613
351690;201809;963;2609;588;1807;113;380;219;596;332;976
351700;201809;855;2398;721;2148;140;423;359;1030;499;1453
351710;201809;655;1886;453;1485;51;198;203;611;254;809
351720;201809;1376;3791;912;2876;168;576;349;1035;517;1611
351730;201809;874;2450;724;2177;92;330;409;1142;501;1472
351740;201809;3704;9652;2876;8029;558;1629;1280;3314;1838;4943
351750;201809;1238;3567;761;2605;158;586;251;844;409;1430
351760;201809;3107;9182;2251;7329;522;1870;771;2314;1293;4184
351770;201809;1831;5583;1524;4986;398;1352;673;2170;1071;3522
351780;201809;1327;3542;686;2147;120;441;196;562;316;1003
351790;201809;1213;3096;980;2757;180;477;587;1686;767;2163
351800;201809;563;1287;282;769;41;126;85;194;126;320
351810;201809;940;2578;770;2289;55;151;570;1645;625;1796
351820;201809;2267;6723;1590;5313;407;1447;305;993;712;2440
351830;201809;4108;11599;3176;9872;411;1475;1799;5314;2210;6789
351840;201809;6862;20664;5401;17884;1011;3697;2435;7612;3446;11309
351850;201809;1801;4763;1129;3533;223;783;328;924;551;1707
351860;201809;2651;8117;2199;7231;443;1548;1149;3739;1592;5287
351870;201809;21365;58385;17106;51191;5717;17589;6308;19600;12025;37189
351880;201809;108977;306815;83840;259417;24931;82884;26457;77890;51388;160774
351885;201809;651;2047;575;1881;112;374;308;983;420;1357
351890;201809;593;1777;468;1545;109;363;74;211;183;574
351900;201809;962;2767;752;2420;148;481;341;1107;489;1588
351905;201809;360;1025;248;791;31;108;98;275;129;383
351907;201809;20168;54914;16126;47486;1609;5309;11025;31487;12634;36796
351910;201809;1120;3051;807;2408;121;410;414;1110;535;1520
351920;201809;851;2309;643;1910;82;282;333;930;415;1212
351925;201809;926;2628;717;2219;111;367;346;1014;457;1381
351930;201809;2798;8384;2631;8061;305;1119;2075;6180;2380;7299
351940;201809;1032;2745;740;2215;101;341;414;1199;515;1540
351950;201809;1304;3260;1005;2809;51;166;681;1858;732;2024
351960;201809;4707;12820;3576;10752;839;2721;1530;4323;2369;7044
351970;201809;5345;17847;4705;16616;920;3663;2537;8533;3457;12196
351980;201809;891;2387;634;1912;102;359;354;994;456;1353
351990;201809;1311;3292;928;2662;106;373;371;962;477;1335
352000;201809;2243;6882;1928;6219;237;900;1200;3594;1437;4494
352010;201809;1969;5707;1582;4960;415;1395;280;922;695;2317
352020;201809;1476;4188;1154;3614;210;716;545;1620;755;2336
352030;201809;5165;14334;4101;12632;855;2830;2138;6501;2993;9331
352040;201809;2208;6258;1418;4595;267;924;366;1043;633;1967
352042;201809;2958;7542;1819;5489;380;1192;738;2251;1118;3443
352044;201809;1926;5492;1120;3845;205;757;216;688;421;1445
352050;201809;11522;32382;7538;23953;2000;7127;1188;3315;3188;10442
352060;201809;679;1968;512;1637;82;304;238;698;320;1002
352070;201809;773;1669;543;1357;86;238;271;640;357;878
352080;201809;454;1207;275;835;43;147;95;247;138;394
352090;201809;1341;4236;1062;3567;186;729;386;1146;572;1875
352100;201809;2903;8572;2435;7659;617;2074;1077;3221;1694;5295
352110;201809;553;1736;435;1470;95;344;168;533;263;877
352115;201809;499;1479;410;1321;84;306;224;706;308;1012
352120;201809;836;2611;671;2248;79;306;363;1134;442;1440
352130;201809;1811;5273;1162;3608;243;759;398;1165;641;1924
352140;201809;1299;3582;840;2648;138;463;380;1142;518;1605
352150;201809;785;2198;600;1856;148;467;295;914;443;1381
352160;201809;939;2421;689;2025;103;354;337;921;440;1275
352170;201809;2737;7898;2223;6786;446;1484;1117;3180;1563;4664
352180;201809;2662;7373;2116;6320;525;1717;716;1917;1241;3634
352190;201809;1095;3076;825;2616;145;516;351;1083;496;1599
352200;201809;368;1155;248;891;33;134;81;280;114;414
352210;201809;16394;41773;13414;37408;1562;4674;9702;26817;11264;31491
352215;201809;519;1449;455;1364;58;190;305;893;363;1083
352220;201809;15451;41714;10674;32552;2988;9491;3217;9617;6205;19108
352230;201809;11829;36997;9207;31756;2520;9549;3088;10026;5608;19575
352240;201809;11003;29553;8161;24541;1948;6626;3189;8702;5137;15328
352250;201809;20981;61960;17317;55189;4124;13899;8920;27995;13044;41894
352260;201809;5224;14542;3642;11273;589;2008;2038;6071;2627;8079
352265;201809;874;2570;763;2374;51;205;557;1664;608;1869
352270;201809;1402;4482;1077;3736;253;966;349;1119;602;2085
352280;201809;2235;6007;1751;5269;188;697;962;2688;1150;3385
352290;201809;984;3019;834;2699;163;567;405;1200;568;1767
352300;201809;923;2562;658;2014;103;348;308;842;411;1190
352310;201809;42779;117511;32182;98513;8755;27166;13686;42294;22441;69460
352320;201809;5686;16117;4496;13631;800;2694;2158;5869;2958;8563
352330;201809;1925;5597;1555;5069;375;1368;716;2234;1091;3602
352340;201809;4569;13049;3442;10994;794;2773;1383;4141;2177;6914
352350;201809;1800;5500;1475;4757;217;813;748;2171;965;2984
352360;201809;1087;3068;954;2835;131;484;683;1900;814;2384
352370;201809;952;2941;854;2756;43;202;640;1988;683;2190
352380;201809;801;2315;628;1998;147;503;207;632;354;1135
352390;201809;15799;39639;10544;30502;1681;5361;5697;15638;7378;20999
352400;201809;3229;9125;2730;8227;552;2009;1591;4388;2143;6397
352410;201809;2776;7753;2233;6785;288;1020;1323;3855;1611;4875
352420;201809;873;2179;603;1741;111;345;214;595;325;940
352430;201809;6832;18580;5090;15451;1438;4727;1963;5710;3401;10437
352440;201809;16246;46969;12693;39897;2881;9559;5448;16668;8329;26227
352450;201809;769;2048;388;1282;61;213;113;341;174;554
352460;201809;2617;7675;1867;6128;410;1524;638;1968;1048;3492
352470;201809;3439;8909;2514;7340;306;1035;1432;3864;1738;4899
352480;201809;3372;8498;2319;6577;415;1317;1099;2865;1514;4182
352490;201809;683;2143;532;1815;114;440;224;716;338;1156
352500;201809;9496;25441;6891;20528;3468;11258;906;1756;4374;13014
352510;201809;3173;9036;2403;7644;615;2132;876;2631;1491;4763
352520;201809;2273;6734;1828;5871;445;1571;838;2518;1283;4089
352530;201809;8482;24253;5556;17810;1348;4844;945;2323;2293;7167
352540;201809;526;1578;374;1226;81;277;82;240;163;517
352550;201809;921;2784;656;2233;131;490;188;599;319;1089
352560;201809;532;1540;368;1177;65;215;113;330;178;545
352570;201809;1949;5926;1262;4432;324;1219;207;630;531;1849
352580;201809;749;2129;592;1819;115;414;265;753;380;1167
352585;201809;234;713;180;600;20;81;95;295;115;376
352590;201809;12772;35220;9192;28034;2971;9731;3574;10142;6545;19873
352600;201809;1843;5474;1440;4639;260;849;732;2324;992;3173
352610;201809;2940;8627;2282;7444;534;1916;822;2544;1356;4460
352620;201809;5326;14710;4302;13059;1361;4208;1569;4806;2930;9014
352630;201809;783;2002;603;1722;105;363;289;746;394;1109
352640;201809;2762;7469;2077;6285;184;615;1337;3934;1521;4549
352650;201809;556;1639;400;1257;69;253;147;420;216;673
352660;201809;931;3028;781;2715;185;671;318;1081;503;1752
352670;201809;8407;23955;5232;17254;1481;5298;530;1731;2011;7029
352680;201809;3018;9336;2160;7285;406;1536;931;2911;1337;4447
352690;201809;27625;71941;20468;58749;2036;6728;12962;35337;14998;42065
352700;201809;528;1388;392;1185;161;530;97;239;258;769
352710;201809;4699;12860;3446;10476;932;3148;1394;3904;2326;7052
352720;201809;7765;22754;6189;19487;2844;9067;1008;2890;3852;11957
352725;201809;421;1161;214;693;14;53;88;264;102;317
352730;201809;2590;7642;2257;6869;396;1359;1263;3503;1659;4862
352740;201809;2068;5170;1601;4447;243;739;867;2296;1110;3035
352750;201809;402;1014;208;639;40;122;59;155;99;277
352760;201809;1373;4086;1091;3460;169;580;528;1622;697;2202
352770;201809;816;2308;567;1787;120;398;205;612;325;1010
352780;201809;595;1848;438;1498;94;350;141;458;235;808
352790;201809;518;1413;356;1092;42;134;131;347;173;481
352800;201809;1166;3752;850;2965;219;807;168;517;387;1324
352810;201809;1059;2614;646;1825;95;298;336;880;431;1178
352820;201809;505;1318;330;1020;79;253;72;213;151;466
352830;201809;583;1536;256;808;45;155;51;129;96;284
352840;201809;3673;11380;3147;10348;1094;3783;1028;3266;2122;7049
352850;201809;9916;26130;6763;20802;1948;6374;2042;6064;3990;12438
352860;201809;838;2526;683;2206;133;473;299;932;432;1405
352870;201809;826;2143;563;1563;51;176;346;898;397;1074
352880;201809;1789;4465;1260;3485;202;588;676;1695;878;2283
352885;201809;242;745;193;656;26;91;123;420;149;511
352890;201809;673;1663;415;1103;52;144;215;499;267;643
352900;201809;16424;44738;11552;35065;2168;7212;5173;14660;7341;21872
352910;201809;423;1156;202;651;25;76;45;134;70;210
352920;201809;2441;6580;1795;5415;210;711;1095;3128;1305;3839
352930;201809;5192;14977;4028;12609;818;2695;1731;5155;2549;7850
352940;201809;21668;63416;16588;52320;4783;16588;4701;13820;9484;30408
352950;201809;470;1259;260;836;64;216;25;64;89;280
352960;201809;637;1817;337;1119;49;183;65;206;114;389
352965;201809;263;730;149;498;42;150;28;86;70;236
352970;201809;2925;7186;2279;6153;249;686;1535;4146;1784;4832
352980;201809;1298;3754;1030;3284;228;761;481;1486;709;2247
352990;201809;3874;11274;3234;10208;677;2424;1688;5083;2365;7507
353000;201809;467;1270;222;711;37;125;50;136;87;261
353010;201809;2454;6462;1652;4951;421;1395;530;1450;951;2845
353020;201809;3633;9626;2105;6372;311;1042;764;2127;1075;3169
353030;201809;3931;10645;2760;8387;745;2351;600;1824;1345;4175
353040;201809;572;1442;429;1201;72;225;216;550;288;775
353050;201809;4782;14532;3635;12204;881;3219;1502;4764;2383;7983
353060;201809;44106;119155;36886;107121;3292;11472;26734;74630;30026;86102
353070;201809;8901;26130;6319;20739;1457;5105;2095;6555;3552;11660
353080;201809;4039;11937;2836;9471;670;2463;900;2755;1570;5218
353090;201809;506;1659;428;1484;41;163;248;810;289;973
353100;201809;294;799;110;360;22;78;29;81;51;159
353110;201809;6826;19977;5812;18398;1034;3495;3500;11154;4534;14649
353120;201809;454;1211;314;929;57;192;128;324;185;516
353130;201809;2258;5871;1583;4798;474;1559;512;1478;986;3037
353140;201809;2123;5611;1612;4632;187;619;949;2545;1136;3164
353150;201809;1378;3683;1008;3038;243;741;390;1126;633;1867
353160;201809;568;1541;392;1234;88;316;150;420;238;736
353170;201809;481;1426;393;1298;72;300;197;597;269;897
353180;201809;9224;23790;7369;20801;1006;3159;5032;13836;6038;16995
353190;201809;3257;9129;2608;7790;325;1062;1604;4493;1929;5555
353200;201809;1859;5190;854;2804;137;485;218;630;355;1115
353205;201809;310;1022;265;908;65;252;123;404;188;656
353210;201809;910;2264;586;1683;28;104;363;1008;391;1112
353215;201809;408;1201;336;1052;48;157;137;386;185;543
353220;201809;653;1818;434;1364;117;380;82;243;199;623
353230;201809;738;2202;627;2024;176;646;249;701;425;1347
353240;201809;2081;6053;1726;5378;251;899;1002;2969;1253;3868
353250;201809;1196;2785;704;1945;101;290;358;975;459;1265
353260;201809;980;2446;570;1719;118;395;194;541;312;936
353270;201809;614;1712;494;1467;54;164;292;831;346;995
353280;201809;698;1976;491;1521;87;273;166;496;253;769
353282;201809;1754;5206;1531;4758;206;726;902;2656;1108;3382
353284;201809;369;926;188;553;30;107;71;179;101;286
353286;201809;136;370;86;279;21;71;26;77;47;148
353290;201809;1234;3492;835;2657;100;389;434;1249;534;1638
353300;201809;1623;4568;1199;3683;215;757;508;1382;723;2139
353310;201809;355;923;245;707;27;102;135;355;162;457
353320;201809;559;1534;477;1381;22;65;368;1056;390;1121
353325;201809;582;1813;407;1397;98;336;123;415;221;751
353330;201809;510;1383;326;985;44;140;164;465;208;605
353340;201809;2652;7375;1849;5833;523;1765;643;2010;1166;3775
353350;201809;3048;8548;2052;6330;479;1624;401;1054;880;2678
353360;201809;509;1565;413;1363;59;212;208;664;267;876
353370;201809;507;1597;421;1439;41;155;275;902;316;1057
353380;201809;258;822;206;707;36;120;95;314;131;434
353390;201809;5048;13319;3891;11166;649;2006;1935;5258;2584;7264
353400;201809;384;1147;296;962;66;242;53;127;119;369
353410;201809;521;1476;417;1285;87;301;213;630;300;931
353420;201809;453;1240;274;838;50;141;35;81;85;222
353430;201809;1998;5937;1523;4993;395;1426;517;1576;912;3002
353440;201809;57452;165643;41343;132198;8754;29332;19430;59797;28184;89129
353450;201809;387;1019;260;785;37;132;120;333;157;465
353460;201809;3157;8817;2306;7101;212;730;1053;3204;1265;3934
353470;201809;6820;18937;4876;15157;1029;3494;1758;5062;2787;8556
353475;201809;1354;3689;963;2828;137;445;449;1226;586;1671
353480;201809;1477;4178;1232;3679;82;288;855;2452;937;2740
353490;201809;908;2512;628;1903;125;396;272;784;397;1180
353500;201809;945;2327;759;2042;184;493;424;1169;608;1662
353510;201809;769;2379;557;1838;158;539;112;332;270;871
353520;201809;1071;2929;712;2234;84;288;339;1023;423;1311
353530;201809;2378;6542;1856;5503;256;862;937;2586;1193;3448
353540;201809;1929;5631;1597;5043;318;1035;830;2571;1148;3606
353550;201809;5549;15254;4411;13226;969;3088;2083;5941;3052;9029
353560;201809;1945;5836;1473;5013;509;1859;373;1194;882;3053
353570;201809;514;1432;377;1176;73;225;196;592;269;817
353580;201809;1939;5371;1567;4665;366;1108;740;2124;1106;3232
353590;201809;682;1921;421;1331;102;343;129;413;231;756
353600;201809;1593;4231;1325;3700;166;485;722;1946;888;2431
353610;201809;555;1772;411;1453;101;411;101;312;202;723
353620;201809;2461;7031;1778;5741;410;1447;519;1498;929;2945
353625;201809;500;1294;304;911;30;106;174;501;204;607
353630;201809;1160;3754;900;3143;220;816;242;768;462;1584
353640;201809;1309;3513;1033;3037;120;399;629;1811;749;2210
353650;201809;8604;24149;6266;19133;905;3062;3369;9589;4274;12651
353657;201809;283;822;226;722;29;96;111;332;140;428
353660;201809;1119;2498;756;1942;321;837;189;442;510;1279
353670;201809;3398;10157;2820;8963;698;2428;1315;3871;2013;6299
353680;201809;711;2019;539;1749;109;377;270;844;379;1221
353690;201809;464;1220;184;598;21;75;19;53;40;128
353700;201809;1791;5139;1536;4628;206;673;983;2850;1189;3523
353710;201809;3766;8694;2051;5657;257;701;1128;2872;1385;3573
353715;201809;439;1189;284;886;17;70;98;277;115;347
353720;201809;1845;5212;1485;4654;227;809;932;2802;1159;3611
353730;201809;3984;11316;2988;9246;513;1722;1377;3978;1890;5700
353740;201809;1758;4837;1197;3746;299;1056;355;1021;654;2077
353750;201809;815;2578;569;2059;151;582;95;341;246;923
353760;201809;11451;28549;9135;25212;1357;4057;5752;15555;7109;19612
353770;201809;708;2124;338;1157;62;209;35;84;97;293
353780;201809;4290;13183;3406;11339;939;3415;974;2986;1913;6401
353790;201809;2237;7144;1713;6016;542;2188;349;1034;891;3222
353800;201809;15815;45089;12408;38982;2359;7932;6032;18891;8391;26823
353810;201809;1009;2840;669;2153;112;428;260;800;372;1228
353820;201809;1614;4757;1178;3798;249;864;416;1314;665;2178
353830;201809;575;1485;436;1254;58;176;237;650;295;826
353850;201809;1613;4673;1243;3938;340;1051;387;1270;727;2321
353860;201809;2420;7252;1920;6197;494;1715;774;2371;1268;4086
353870;201809;26386;72432;18433;56541;3007;10199;8639;24330;11646;34529
353880;201809;2815;8198;2223;7075;245;904;1262;3896;1507;4800
353890;201809;2254;5238;1582;4208;151;456;1037;2615;1188;3071
353900;201809;661;1904;489;1564;99;342;202;628;301;970
353910;201809;2040;6615;1790;6187;237;848;1275;4483;1512;5331
353920;201809;2111;5909;1432;4555;315;1157;341;920;656;2077
353930;201809;3882;10937;2684;8697;688;2425;739;2195;1427;4620
353940;201809;1011;3078;700;2380;146;515;203;643;349;1158
353950;201809;2889;8431;2349;7355;473;1648;1253;3585;1726;5233
353960;201809;657;1905;443;1452;96;305;151;477;247;782
353970;201809;599;1616;487;1425;44;138;314;892;358;1030
353980;201809;13370;36203;10546;30938;1413;4417;6718;19130;8131;23547
353990;201809;832;2121;523;1529;57;189;282;771;339;960
354000;201809;2324;5923;1327;3993;282;898;250;778;532;1676
354010;201809;346;969;258;810;24;74;170;520;194;594
354020;201809;3416;10201;2739;8660;751;2553;949;2751;1700;5304
354025;201809;696;1956;457;1467;93;331;104;306;197;637
354030;201809;432;992;226;609;42;112;82;209;124;321
354040;201809;750;1848;463;1329;37;123;288;784;325;907
354050;201809;899;2721;642;2194;168;608;177;599;345;1207
354060;201809;3780;11120;2558;8458;686;2369;714;2174;1400;4543
354070;201809;3004;8781;2163;7078;509;1822;614;1748;1123;3570
354075;201809;2140;6803;1693;5917;251;1021;904;3064;1155;4085
354080;201809;1397;4041;898;3002;180;621;238;716;418;1337
354085;201809;407;873;321;767;2;11;216;478;218;489
354090;201809;1405;4069;1245;3738;113;387;911;2684;1024;3071
354100;201809;15123;44875;11233;37732;2775;9983;4623;15484;7398;25467
354105;201809;1046;2885;849;2542;123;379;516;1525;639;1904
354110;201809;391;1068;305;939;78;257;106;315;184;572
354120;201809;1493;4166;994;3049;208;661;333;913;541;1574
354130;201809;5471;14878;3590;11143;1136;3828;193;398;1329;4226
354140;201809;19455;48276;12680;36072;2682;8180;4804;12722;7486;20902
354150;201809;3113;7850;2325;6496;490;1477;1024;2740;1514;4217
354160;201809;3110;9426;2315;7684;699;2438;709;2282;1408;4720
354165;201809;527;1625;425;1422;85;325;201;627;286;952
354170;201809;1438;4292;1163;3694;96;343;693;2067;789;2410
354180;201809;443;1280;319;1000;66;229;114;314;180;543
354190;201809;1381;4099;1031;3374;127;447;397;1277;524;1724
354200;201809;860;2265;673;1962;90;269;353;963;443;1232
354210;201809;639;1879;519;1654;53;198;323;943;376;1141
354220;201809;2924;8276;2232;6889;437;1433;1056;3085;1493;4518
354230;201809;654;1788;515;1595;60;245;325;940;385;1185
354240;201809;1441;4208;943;3145;177;640;263;769;440;1409
354250;201809;522;1389;342;1093;108;355;100;322;208;677
354260;201809;7591;21240;5951;18328;1481;4763;2151;6611;3632;11374
354270;201809;1067;3288;846;2858;188;651;322;1081;510;1732
354280;201809;724;1959;615;1790;75;283;374;1001;449;1284
354290;201809;821;2768;702;2479;136;477;310;1100;446;1577
354300;201809;3534;10838;3119;10055;1036;3446;1008;3087;2044;6533
354310;201809;669;2036;533;1743;109;381;198;597;307;978
354320;201809;859;2256;545;1666;95;337;206;546;301;883
354323;201809;509;1303;333;959;48;127;131;366;179;493
354325;201809;1147;3565;832;2857;161;575;338;1123;499;1698
354330;201809;6997;19022;5036;14802;824;2877;2854;7712;3678;10589
354340;201809;24473;66017;17013;52560;4167;13931;6876;20440;11043;34371
354350;201809;1125;3087;917;2678;135;438;567;1542;702;1980
354360;201809;519;1456;306;1041;58;184;45;155;103;339
354370;201809;952;3033;808;2754;139;506;440;1463;579;1969
354380;201809;783;2131;534;1690;101;373;126;335;227;708
354390;201809;12667;32463;8055;24029;1715;5440;2578;7312;4293;12752
354400;201809;1519;5081;1187;4275;230;876;422;1511;652;2387
354410;201809;4977;14512;3885;12276;972;3298;1667;5068;2639;8366
354420;201809;1375;3829;997;3043;145;469;570;1669;715;2138
354425;201809;2182;5712;1656;4762;431;1239;609;1812;1040;3051
354430;201809;1423;4032;1134;3539;194;702;571;1662;765;2364
354440;201809;514;1449;327;1033;44;150;141;405;185;555
354450;201809;388;1049;210;689;31;107;54;160;85;267
354460;201809;863;2304;570;1739;97;322;266;776;363;1098
354470;201809;488;1257;323;906;30;96;159;395;189;491
354480;201809;999;2350;690;1865;63;185;456;1176;519;1361
354490;201809;764;2312;557;1856;125;445;201;606;326;1051
354500;201809;2005;5888;1683;5402;574;2040;414;1328;988;3368
354510;201809;744;2076;602;1770;84;256;318;848;402;1104
354515;201809;278;860;203;706;38;148;82;274;120;422
354520;201809;6399;18744;4170;13340;715;2543;2162;6447;2877;8990
354530;201809;3752;11594;2934;9849;747;2597;1085;3639;1832;6236
354540;201809;1279;3565;934;2900;226;748;292;922;518;1670
354550;201809;526;1423;396;1168;61;185;232;649;293;834
354560;201809;1892;4899;1030;3062;145;448;496;1424;641;1872
354570;201809;1106;2958;480;1445;95;306;76;218;171;524
354580;201809;9170;24840;5967;18588;1043;3574;2745;8111;3788;11685
354600;201809;1658;4834;1306;4143;203;697;729;2233;932;2930
354610;201809;375;1000;193;597;31;105;66;193;97;298
354620;201809;446;1323;291;1009;52;195;103;302;155;497
354625;201809;309;883;184;625;23;75;47;136;70;211
354630;201809;1818;5645;1485;4974;651;2309;177;567;828;2876
354640;201809;3021;9142;2195;7344;414;1567;633;1943;1047;3510
354650;201809;875;2421;709;2111;79;243;417;1231;496;1474
354660;201809;2538;6589;1688;5135;139;514;1120;3326;1259;3840
354670;201809;1025;2970;726;2308;141;488;270;787;411;1275
354680;201809;4272;12282;3569;11075;931;2954;1832;5752;2763;8706
354690;201809;563;1802;391;1396;99;382;106;355;205;737
354700;201809;917;2487;632;1896;112;378;288;759;400;1137
354710;201809;499;1390;347;1068;52;190;151;407;203;597
354720;201809;301;763;138;418;44;129;29;90;73;219
354730;201809;9342;27238;6900;22475;1071;3788;3724;11713;4795;15501
354740;201809;322;891;124;435;18;73;22;69;40;142
354750;201809;2352;6508;1590;5052;327;1193;600;1719;927;2912
354760;201809;1788;5138;1270;4107;381;1337;321;976;702;2313
354765;201809;238;662;116;379;21;84;24;67;45;151
354770;201809;2200;5674;1569;4571;329;1045;663;1824;992;2869
354780;201809;51208;135120;39674;111470;6056;18956;22419;59067;28475;78023
354790;201809;883;2620;725;2337;114;399;401;1241;515;1640
354800;201809;2478;6848;1926;5870;480;1530;778;2249;1258;3779
354805;201809;1100;2852;775;2265;109;350;351;914;460;1264
354810;201809;565;1715;327;1171;54;215;90;300;144;515
354820;201809;897;2756;652;2240;131;508;158;489;289;997
354830;201809;460;1161;303;875;86;247;107;298;193;545
354840;201809;825;2230;483;1464;64;187;225;665;289;852
354850;201809;19215;53074;13624;42450;2109;7639;7566;22044;9675;29683
354860;201809;1356;4068;963;3258;197;719;311;928;508;1647
354870;201809;47093;123813;37590;106191;5682;17572;22056;59573;27738;77145
354880;201809;5508;14262;2579;7653;373;1240;873;2093;1246;3333
354890;201809;14915;39568;12008;34630;1925;6084;6806;18991;8731;25075
354900;201809;421;1142;262;832;38;128;70;202;108;330
354910;201809;4789;13416;2817;9505;613;2197;307;975;920;3172
354920;201809;432;1163;173;594;23;102;37;111;60;213
354925;201809;275;826;140;504;23;90;33;93;56;183
354930;201809;372;932;220;659;26;90;105;290;131;380
354940;201809;1709;5567;1318;4659;472;1797;177;584;649;2381
354950;201809;1454;4071;1144;3587;79;347;742;2201;821;2548
354960;201809;780;2175;602;1891;118;426;286;842;404;1268
354970;201809;3700;11160;2992;9791;482;1695;1711;5436;2193;7131
354980;201809;27764;69260;18686;52966;2502;8357;10195;26872;12697;35229
354990;201809;56619;150957;42121;123808;5196;16839;24700;69309;29896;86148
354995;201809;2359;5988;1783;5149;289;939;1086;2970;1375;3909
355000;201809;1376;3867;1104;3400;209;750;400;1099;609;1849
355010;201809;2856;8462;1929;6302;733;2502;172;585;905;3087
355020;201809;3133;9316;2329;7811;771;2841;593;1919;1364;4760
355030;201809;1258454;3200331;920605;2517850;169771;505051;444981;1130269;614752;1635320
355040;201809;2709;7572;2273;6916;404;1283;1429;4346;1833;5629
355050;201809;923;2418;685;2020;221;652;176;490;397;1142
355060;201809;5012;14517;3794;12141;695;2520;1815;5248;2510;7768
355070;201809;7397;20553;5999;18175;835;2916;3554;10042;4389;12958
355080;201809;790;2424;500;1809;110;428;47;155;157;583
355090;201809;1122;3433;860;2906;221;744;254;878;475;1622
355100;201809;19642;54316;15712;48316;3107;10241;9247;28008;12354;38249
355110;201809;959;2836;733;2440;259;915;142;491;401;1406
355120;201809;606;1711;437;1405;68;241;160;482;228;723
355130;201809;667;1578;312;842;21;55;175;438;196;493
355140;201809;1418;3781;1250;3524;132;453;935;2557;1067;3010
355150;201809;3850;10768;3083;9376;465;1509;1703;5048;2168;6557
355160;201809;1744;5071;1313;4264;347;1264;323;1017;670;2281
355170;201809;8240;22394;6602;19589;1745;5487;3135;9159;4880;14646
355180;201809;2622;7605;1942;6379;463;1749;614;1770;1077;3519
355190;201809;1729;4809;1369;4185;379;1178;632;2034;1011;3212
355200;201809;768;2529;668;2351;245;965;198;628;443;1593
355210;201809;2844;8179;2410;7290;330;1150;1425;4056;1755;5206
355220;201809;40726;113438;32504;97252;9034;28503;12079;33315;21113;61818
355230;201809;1114;2864;607;1819;126;381;165;483;291;864
355240;201809;21456;57930;14593;44199;2508;8152;6927;20354;9435;28506
355250;201809;33418;93643;24870;77019;6615;21704;9090;27198;15705;48902
355255;201809;813;2132;420;1317;83;260;130;399;213;659
355260;201809;1211;3215;903;2689;125;453;545;1521;670;1974
355270;201809;1247;3846;964;3184;249;857;320;998;569;1855
355280;201809;26215;71238;19049;56926;3482;11120;8537;24293;12019;35413
355290;201809;756;2239;571;1832;131;411;220;669;351;1080
355300;201809;1170;3500;934;3014;186;644;307;975;493;1619
355310;201809;995;2837;745;2388;87;305;401;1300;488;1605
355320;201809;504;1363;371;1098;69;235;145;373;214;608
355330;201809;2115;5890;1584;4890;179;624;1031;3044;1210;3668
355340;201809;3136;7280;2655;6598;319;782;1830;4547;2149;5329
355350;201809;1272;3883;942;3167;199;714;307;1017;506;1731
355360;201809;1264;3453;1033;3058;112;346;710;2106;822;2452
355365;201809;358;996;183;636;39;120;28;98;67;218
355370;201809;5451;14376;4245;12580;1064;3160;1849;5855;2913;9015
355380;201809;2868;8001;2150;6540;409;1361;681;1774;1090;3135
355385;201809;1251;3624;1064;3315;143;551;606;1713;749;2264
355390;201809;716;2026;528;1626;118;372;209;599;327;971
355395;201809;1836;5372;1308;4207;205;714;566;1663;771;2377
355400;201809;8643;26763;7046;23299;2096;7649;2107;6320;4203;13969
355410;201809;20821;59415;14105;46324;3649;13077;3215;10595;6864;23672
355420;201809;655;2235;541;1981;156;659;118;403;274;1062
355430;201809;3563;9298;2749;7857;740;2090;1159;3351;1899;5441
355440;201809;837;2360;508;1615;106;351;150;450;256;801
355450;201809;3344;9116;2154;6715;447;1497;778;2244;1225;3741
355460;201809;542;1413;342;1054;52;189;153;410;205;599
355465;201809;362;1076;260;847;49;177;84;264;133;441
355470;201809;1158;3108;617;1940;191;627;173;511;364;1138
355475;201809;276;708;247;656;26;79;190;504;216;583
355480;201809;3414;10292;2887;9398;456;1722;1776;5591;2232;7313
355490;201809;911;2552;493;1605;53;186;212;656;265;842
355495;201809;762;2290;569;1916;81;285;197;652;278;937
355500;201809;6215;17244;3727;11849;623;2170;1085;3178;1708;5348
355510;201809;1288;3422;798;2434;123;415;286;779;409;1194
355520;201809;343;802;164;460;25;78;64;156;89;234
355530;201809;429;970;140;407;23;80;56;132;79;212
355535;201809;513;1464;404;1283;89;322;168;481;257;803
355540;201809;8836;24387;7390;22069;1460;4642;4274;12482;5734;17124
355550;201809;635;1932;505;1668;75;266;240;768;315;1034
355560;201809;1057;2982;580;1926;134;465;28;100;162;565
355570;201809;227;665;123;416;25;81;19;64;44;145
355580;201809;1193;3021;782;2327;100;359;398;1122;498;1481
355590;201809;177;452;133;386;15;42;83;230;98;272
355600;201809;1459;3775;969;2871;252;790;364;1026;616;1816
355610;201809;1602;4230;1102;3276;160;482;517;1465;677;1947
355620;201809;4265;12280;3254;10116;476;1740;1706;4844;2182;6584
355630;201809;2076;6070;1482;4870;301;1007;670;2166;971;3173
355635;201809;922;2816;727;2447;126;485;359;1177;485;1662
355640;201809;2548;7655;1769;6061;457;1646;369;1279;826;2925
355645;201809;4080;12271;3215;10719;426;1586;1910;6252;2336;7838
355650;201809;6335;17795;5281;15820;1423;4512;2604;7289;4027;11801
355660;201809;1231;3416;871;2692;118;481;322;957;440;1438
355670;201809;3187;9303;2231;6962;362;1337;1056;2859;1418;4196
355680;201809;3029;8697;1182;3988;339;1197;127;432;466;1629
355690;201809;675;2133;453;1656;133;508;26;79;159;587
355695;201809;221;677;122;423;14;56;13;25;27;81
355700;201809;6151;18640;5081;16189;1177;3767;2326;7193;3503;10960
355710;201809;7802;19061;4928;13751;946;2836;1981;5029;2927;7865
355715;201809;357;1048;210;703;62;231;44;131;106;362
355720;201809;1366;4213;1077;3629;210;765;508;1570;718;2335
355730;201809;933;2795;734;2374;192;619;253;778;445;1397
410010;201809;1199;3420;918;2826;193;663;217;651;410;1314
410020;201809;976;3086;791;2648;282;908;227;768;509;1676
410030;201809;1333;4007;1150;3649;198;723;590;1830;788;2553
410040;201809;10068;29948;7895;25702;1816;6464;2660;8093;4476;14557
410045;201809;951;2561;634;1960;97;335;203;588;300;923
410050;201809;2461;6274;1518;4509;373;1230;306;787;679;2017
410060;201809;2005;6004;1578;5067;410;1366;476;1484;886;2850
410070;201809;1626;4402;1207;3560;250;794;435;1228;685;2022
410080;201809;1323;3609;971;2944;164;520;418;1277;582;1797
410090;201809;955;2720;871;2559;106;313;485;1496;591;1809
410100;201809;1892;5678;1333;4304;219;836;255;784;474;1620
410105;201809;442;1206;237;746;37;139;55;161;92;300
410110;201809;2987;8022;2081;6120;325;998;797;2273;1122;3271
410115;201809;527;1354;370;1069;68;224;126;337;194;561
410120;201809;2331;7356;2056;6860;706;2525;644;2132;1350;4657
410130;201809;1093;3129;979;2907;306;1016;378;1005;684;2021
410140;201809;13908;34870;8541;24926;1845;5768;1846;4968;3691;10736
410150;201809;15798;38852;7489;21560;1497;4640;1500;4126;2997;8766
410160;201809;2752;7995;2321;7186;512;1743;874;2715;1386;4458
410165;201809;683;1942;569;1678;54;181;342;938;396;1119
410170;201809;2308;6289;1527;4549;424;1349;134;419;558;1768
410180;201809;13181;39008;10509;33062;1798;6131;5412;16070;7210;22201
410185;201809;468;1285;334;1022;57;184;109;316;166;500
410190;201809;2072;5466;1545;4483;351;1060;409;1145;760;2205
410200;201809;4420;11041;2510;7479;515;1808;552;1605;1067;3413
410210;201809;2430;6672;1665;5074;313;1091;516;1334;829;2425
410220;201809;540;1422;344;1022;44;159;71;215;115;374
410230;201809;1410;4098;1177;3617;208;771;623;1774;831;2545
410240;201809;4046;11609;3178;9859;964;3345;328;977;1292;4322
410250;201809;2436;6173;1758;4969;232;795;751;1994;983;2789
410260;201809;1692;4386;1124;3375;244;770;477;1409;721;2179
410270;201809;449;1194;331;965;33;113;163;451;196;564
410275;201809;663;1966;437;1439;70;242;198;604;268;846
410280;201809;2094;5847;1344;4229;270;915;453;1329;723;2244
410290;201809;2982;8694;2191;6989;511;1632;782;2500;1293;4132
410300;201809;627;1636;495;1385;74;230;230;597;304;827
410302;201809;357;951;176;580;31;105;88;276;119;381
410304;201809;1108;3221;939;2853;136;442;518;1527;654;1969
410305;201809;1604;4123;1158;3429;222;670;602;1767;824;2437
410310;201809;2255;6763;1853;5999;425;1521;649;2073;1074;3594
410315;201809;697;1765;344;1123;104;353;77;238;181;591
410320;201809;1086;3117;690;2219;107;402;108;347;215;749
410322;201809;495;1386;273;869;24;80;116;363;140;443
410330;201809;1412;3661;1031;2906;207;626;280;784;487;1410
410335;201809;815;2321;655;1983;94;310;294;828;388;1138
410337;201809;759;1917;534;1465;54;160;251;651;305;811
410340;201809;482;1311;321;909;37;127;148;354;185;481
410345;201809;2182;5852;1123;3479;258;813;263;773;521;1586
410347;201809;674;1740;484;1392;55;194;145;386;200;580
410350;201809;1217;3364;875;2686;112;386;364;1039;476;1425
410360;201809;3839;9638;3036;8269;231;763;1972;5130;2203;5893
410370;201809;10424;28483;7195;21394;1095;3635;2757;7314;3852;10949
410380;201809;1330;3653;999;2955;117;411;423;1155;540;1566
410390;201809;2452;6691;1616;5015;439;1496;358;1024;797;2520
410395;201809;863;2637;704;2282;137;495;310;990;447;1485
410400;201809;4706;13345;3646;11311;701;2270;1496;4486;2197;6756
410405;201809;780;2006;618;1748;142;435;276;743;418;1178
410410;201809;1117;3229;1090;3190;172;641;691;2069;863;2710
410420;201809;7186;21791;5615;18346;1198;4326;1652;4896;2850;9222
410425;201809;2745;8164;2009;6643;366;1302;652;1994;1018;3296
410430;201809;12327;31937;8525;24802;1497;4701;2827;7911;4324;12612
410440;201809;2679;8903;2365;8277;371;1357;1363;4926;1734;6283
410442;201809;2171;6974;1864;6267;581;1986;606;2050;1187;4036
410445;201809;2154;6633;1723;5759;389;1445;493;1721;882;3166
410450;201809;1448;3993;1095;3271;223;724;291;769;514;1493
410460;201809;1676;4452;1307;3858;207;663;581;1633;788;2296
410465;201809;2397;7397;1898;6280;432;1429;584;1859;1016;3288
410470;201809;1754;5313;1267;4221;330;1223;259;897;589;2120
410480;201809;30989;78947;17246;52940;3084;10543;2862;7651;5946;18194
410490;201809;10429;30252;7412;23685;1547;5371;2503;7521;4050;12892
410500;201809;1598;4630;1159;3682;295;1041;256;718;551;1759
410510;201809;2004;5157;1298;3712;256;717;404;1170;660;1887
410520;201809;2927;9684;2690;9194;781;2726;1165;4035;1946;6761
410530;201809;1422;3838;720;2186;131;397;106;241;237;638
410540;201809;2443;6893;1792;5599;272;923;917;2838;1189;3761
410550;201809;6382;17580;4091;12472;803;2684;962;2569;1765;5253
410560;201809;1338;3618;1052;3068;230;715;443;1160;673;1875
410570;201809;2484;7319;1921;6230;567;2093;185;666;752;2759
410580;201809;22419;61433;17114;51323;3642;11954;7189;20042;10831;31996
410590;201809;1357;4024;891;2815;173;578;223;628;396;1206
410600;201809;1668;4693;1285;3902;287;858;472;1488;759;2346
410610;201809;718;1942;518;1555;61;202;228;652;289;854
410620;201809;1902;5939;1255;4328;319;1172;208;645;527;1817
410630;201809;2188;6161;1412;4434;297;1002;217;574;514;1576
410640;201809;4236;10611;2841;8199;736;2388;430;1197;1166;3585
410645;201809;1011;3222;875;3000;338;1188;313;1099;651;2287
410650;201809;1895;5504;1370;4365;350;1185;394;1126;744;2311
410655;201809;1029;2793;763;2293;41;147;442;1310;483;1457
410657;201809;636;1732;395;1214;69;237;150;395;219;632
410660;201809;3058;8176;1654;5011;358;1119;312;919;670;2038
410670;201809;991;2497;593;1693;102;286;283;763;385;1049
410680;201809;2756;8574;1976;6629;503;1630;489;1719;992;3349
410685;201809;554;1487;452;1304;92;295;221;595;313;890
410690;201809;113776;297773;75159;222024;14147;46737;24659;64307;38806;111044
410700;201809;2178;5868;1876;5348;356;1089;948;2554;1304;3643
410710;201809;803;2151;527;1608;64;211;270;789;334;1000
410712;201809;659;1986;558;1776;146;490;203;606;349;1096
410715;201809;801;2481;507;1752;106;370;153;516;259;886
410720;201809;2928;8029;2140;6390;340;1216;442;1138;782;2354
410725;201809;1082;2775;646;1926;121;385;112;289;233;674
410730;201809;558;1506;402;1218;87;307;85;227;172;534
410740;201809;957;2750;677;2194;118;417;265;843;383;1260
410750;201809;1605;4383;1316;3818;228;743;526;1459;754;2202
410752;201809;344;897;155;475;26;92;62;167;88;259
410753;201809;197;591;140;466;19;64;25;72;44;136
410754;201809;1111;2980;929;2693;70;180;609;1893;679;2073
410755;201809;618;1590;441;1243;55;176;218;550;273;726
410760;201809;2982;8166;2271;6857;725;2387;544;1620;1269;4007
410765;201809;11844;34815;9234;29600;1655;5818;1424;4301;3079;10119
410770;201809;933;2304;652;1830;83;257;299;821;382;1078
410773;201809;1273;3477;1108;3204;131;431;747;2095;878;2526
410775;201809;1383;3668;1212;3403;132;418;648;1784;780;2202
410780;201809;569;1436;343;968;66;193;84;242;150;435
410785;201809;748;2178;595;1879;118;393;204;613;322;1006
410790;201809;554;1645;438;1400;122;415;49;101;171;516
410800;201809;2901;6765;2312;5863;129;381;1385;3393;1514;3774
410810;201809;346;981;259;812;41;142;119;349;160;491
410820;201809;715;2110;407;1275;90;297;78;219;168;516
410830;201809;27123;71077;19630;57926;4994;16511;6637;18583;11631;35094
410832;201809;958;2605;813;2319;106;383;459;1204;565;1587
410840;201809;7020;18962;4247;13324;955;3312;731;2010;1686;5322
410845;201809;1103;3077;898;2696;184;591;333;973;517;1564
410850;201809;2280;6848;2008;6341;393;1331;876;2749;1269;4080
410855;201809;677;1727;463;1327;48;144;201;535;249;679
410860;201809;3675;9849;2871;8301;600;1880;984;2678;1584;4558
410865;201809;1327;4246;1184;3927;222;795;659;2241;881;3036
410870;201809;1242;3469;1084;3215;59;186;794;2348;853;2534
410880;201809;3916;11236;2883;9216;570;2017;443;1500;1013;3517
410890;201809;920;2762;666;2191;161;582;190;614;351;1196
410895;201809;883;3008;762;2716;304;1153;131;442;435;1595
410900;201809;801;2218;554;1724;98;317;125;311;223;628
410910;201809;354;861;179;511;11;37;104;265;115;302
410920;201809;703;1855;521;1540;91;309;224;650;315;959
410930;201809;1377;3926;1069;3305;295;1040;250;767;545;1807
410940;201809;20144;59303;15279;49897;3884;13731;3836;12641;7720;26372
410950;201809;1881;5670;1708;5388;73;298;1411;4366;1484;4664
410960;201809;6893;18430;4431;13913;1171;4103;1454;4382;2625;8485
410965;201809;942;2620;705;2137;124;390;348;1030;472;1420
410970;201809;3584;10055;2577;8075;652;2447;388;1049;1040;3496
410975;201809;1269;3429;986;2914;182;600;341;1002;523;1602
410980;201809;6379;17042;4140;12695;574;1961;1656;4854;2230;6815
410990;201809;1124;3003;737;2291;240;857;149;372;389;1229
411000;201809;483;1362;336;1050;57;204;88;218;145;422
411005;201809;409;1136;269;833;63;204;45;133;108;337
411007;201809;2085;6236;1772;5639;435;1495;580;1830;1015;3325
411010;201809;3951;12359;3201;10692;887;3174;320;987;1207;4161
411020;201809;2283;6777;1926;6134;580;1960;566;1736;1146;3696
411030;201809;695;1811;456;1275;57;177;197;504;254;681
411040;201809;765;2035;356;1080;53;171;93;255;146;426
411050;201809;1737;5707;1471;5073;417;1539;213;644;630;2183
411060;201809;1575;4309;1032;3185;190;726;200;546;390;1272
411065;201809;317;898;238;740;34;108;103;314;137;422
411070;201809;6091;16650;4851;14349;982;3184;1973;5639;2955;8823
411080;201809;2090;5800;1684;5044;451;1468;440;1293;891;2761
411090;201809;806;2158;513;1574;52;192;121;339;173;531
411095;201809;1459;3603;1009;2836;132;422;363;967;495;1389
411100;201809;1066;2901;740;2274;86;308;212;643;298;951
411110;201809;563;1517;246;790;35;97;17;46;52;143
411120;201809;1256;3637;965;3040;343;1220;198;508;541;1728
411125;201809;4656;14161;4317;13544;933;3037;2100;6749;3033;9786
411130;201809;642;1812;454;1407;100;306;171;554;271;860
411140;201809;2139;6807;1766;5934;457;1642;632;2129;1089;3771
411150;201809;3534;9559;2496;7385;550;1851;207;479;757;2330
411155;201809;933;2487;565;1737;55;178;262;751;317;929
411160;201809;339;806;223;633;33;102;58;171;91;273
411170;201809;673;2079;500;1653;117;393;175;558;292;951
411180;201809;5067;14133;3981;12102;748;2487;1683;4864;2431;7351
411190;201809;1283;3486;989;2912;217;671;304;828;521;1499
411200;201809;4722;13298;3289;10426;944;3263;713;2144;1657;5407
411210;201809;2159;5285;1556;4282;443;1402;241;607;684;2009
411220;201809;837;2282;616;1814;139;437;192;557;331;994
411230;201809;805;2262;549;1747;122;398;197;642;319;1040
411240;201809;1468;3632;883;2506;81;273;441;1185;522;1458
411250;201809;1939;5418;1478;4552;360;1276;451;1366;811;2642
411260;201809;323;853;206;617;29;85;81;226;110;311
411270;201809;1719;4969;1365;4224;242;803;629;1880;871;2683
411275;201809;1304;3408;944;2753;166;542;428;1214;594;1756
411280;201809;1341;3713;833;2655;174;576;122;345;296;921
411290;201809;713;1992;485;1531;61;179;226;729;287;908
411295;201809;1067;2741;850;2345;84;269;429;1124;513;1393
411300;201809;959;2426;603;1698;70;219;235;573;305;792
411310;201809;823;2029;633;1736;40;113;281;771;321;884
411320;201809;5150;14074;3688;11268;826;2630;1201;3387;2027;6017
411325;201809;1516;4459;1286;4013;230;708;673;2166;903;2874
411330;201809;3111;8943;2358;7464;616;2114;659;2134;1275;4248
411340;201809;819;2328;490;1549;72;249;193;582;265;831
411342;201809;854;2183;563;1609;82;236;271;757;353;993
411345;201809;988;2756;771;2365;106;363;497;1524;603;1887
411350;201809;2373;6817;1690;5374;468;1643;176;545;644;2188
411360;201809;598;1485;418;1201;54;171;137;376;191;547
411370;201809;44917;116091;33116;95319;3424;11744;18639;50143;22063;61887
411373;201809;1294;3517;1062;3138;125;412;513;1543;638;1955
411375;201809;995;2604;732;2107;123;370;276;740;399;1110
411380;201809;1044;2560;718;1879;63;201;418;981;481;1182
411390;201809;1586;4531;1228;3685;218;725;465;1249;683;1974
411400;201809;1988;5248;1602;4530;249;843;739;1990;988;2833
411410;201809;1965;5673;1478;4601;357;1215;305;874;662;2089
411420;201809;3767;9783;2185;6616;354;1247;405;991;759;2238
411430;201809;3178;8968;2554;7833;577;1937;1028;2904;1605;4841
411435;201809;417;1229;267;885;48;157;103;301;151;458
411440;201809;2461;7391;2022;6490;469;1652;682;2184;1151;3836
411450;201809;2495;6884;1907;5850;299;894;975;3047;1274;3941
411460;201809;3556;9786;1990;6436;384;1420;309;912;693;2332
411470;201809;694;1958;496;1539;88;299;144;399;232;698
411480;201809;4168;11915;2956;9480;584;2114;814;2432;1398;4546
411490;201809;1474;4051;1141;3437;178;622;410;1091;588;1713
411500;201809;1382;3747;924;2792;150;532;283;802;433;1334
411510;201809;2045;5644;1674;4928;374;1245;389;1161;763;2406
411520;201809;26238;65799;14758;43208;2182;7157;4944;12987;7126;20144
411530;201809;877;2413;563;1781;119;427;107;302;226;729
411535;201809;456;1373;202;713;19;66;27;79;46;145
411540;201809;2696;7088;1890;5417;309;986;723;2007;1032;2993
411545;201809;918;2768;777;2503;75;250;518;1663;593;1913
411550;201809;642;1724;460;1367;85;273;87;259;172;532
411560;201809;1827;5037;1097;3447;179;669;70;163;249;832
411570;201809;6743;16569;4655;13185;997;3132;1274;3582;2271;6714
411573;201809;748;2114;645;1937;79;258;381;1125;460;1383
411575;201809;1685;4811;1307;4027;282;923;354;1055;636;1978
411580;201809;4017;9868;2264;6977;278;1076;308;872;586;1948
411585;201809;673;2039;308;1047;88;306;53;159;141;465
411590;201809;352;1044;250;810;28;108;140;419;168;527
411600;201809;257;709;157;519;39;139;49;157;88;296
411605;201809;1342;3453;891;2536;132;450;423;1147;555;1597
411610;201809;2147;5664;1529;4359;169;536;843;2315;1012;2851
411620;201809;2727;7702;2385;7149;421;1402;1384;4048;1805;5450
411630;201809;635;1682;423;1265;84;290;123;322;207;612
411640;201809;497;1387;337;1002;42;143;133;348;175;491
411650;201809;192;567;129;420;28;88;25;86;53;174
411660;201809;878;2305;627;1808;55;157;331;930;386;1087
411670;201809;1107;2899;806;2242;124;351;321;840;445;1191
411680;201809;1498;4192;1208;3629;124;431;643;1905;767;2336
411690;201809;3291;9058;2560;7758;525;1637;817;2576;1342;4213
411695;201809;615;1912;451;1530;69;251;157;548;226;799
411700;201809;1542;4204;1023;3186;237;821;136;378;373;1199
411705;201809;1676;5563;1465;5162;309;1078;819;3040;1128;4118
411710;201809;1764;4732;1277;3809;374;1175;160;489;534;1664
411720;201809;976;2465;687;1898;103;320;276;700;379;1020
411721;201809;809;2186;612;1798;131;400;140;410;271;810
411722;201809;665;1894;387;1220;62;241;145;385;207;626
411725;201809;1182;3571;764;2590;188;657;153;528;341;1185
411727;201809;1435;4179;958;3109;301;1021;122;373;423;1394
411729;201809;663;1650;442;1239;64;216;149;369;213;585
411730;201809;5085;14277;3800;11584;1108;3478;1187;3603;2295;7081
411740;201809;542;1505;278;892;47;155;56;171;103;326
411745;201809;767;2248;505;1598;64;212;101;267;165;479
411750;201809;4538;12540;3329;10028;491;1623;1575;4474;2066;6097
411760;201809;6740;18749;5283;16007;1908;6031;1039;3430;2947;9461
411770;201809;2975;9073;2215;7271;617;2160;282;878;899;3038
411780;201809;2855;8320;2464;7549;683;2205;900;2751;1583;4956
411790;201809;2785;7118;1551;4696;405;1372;206;519;611;1891
411800;201809;928;2683;624;1963;103;332;118;364;221;696
411810;201809;1586;4176;1169;3369;207;663;558;1478;765;2141
411820;201809;10431;32253;8575;28449;2751;9508;2972;9803;5723;19311
411830;201809;593;1486;409;1162;88;274;83;256;171;530
411840;201809;10552;28899;6991;21328;1357;4495;1821;5167;3178;9662
411845;201809;401;1165;204;672;42;165;16;45;58;210
411850;201809;7098;19338;5186;15760;1581;5309;794;2214;2375;7523
411860;201809;746;2229;554;1805;103;381;155;462;258;843
411870;201809;642;2014;437;1477;93;341;96;297;189;638
411880;201809;1944;5259;1434;4344;343;1122;295;898;638;2020
411885;201809;940;2481;708;2066;109;383;258;717;367;1100
411890;201809;1055;2993;719;2248;130;471;53;137;183;608
411900;201809;811;2396;476;1599;123;431;53;177;176;608
411910;201809;980;3088;713;2461;211;764;178;583;389;1347
411915;201809;15373;39165;9523;28030;1758;5661;2877;7671;4635;13332
411920;201809;930;2975;782;2618;201;725;223;730;424;1455
411925;201809;508;1361;336;1028;82;274;103;292;185;566
411930;201809;5023;16326;4342;14920;2071;7650;285;1113;2356;8763
411940;201809;3028;9576;2364;7910;629;2187;577;1740;1206;3927
411950;201809;12643;36116;10438;32238;2055;6986;5275;15724;7330;22710
411960;201809;5363;15084;4492;13331;1000;3269;1596;4426;2596;7695
411965;201809;424;1206;301;953;50;173;118;353;168;526
411970;201809;955;2367;754;2078;139;365;367;1131;506;1496
411980;201809;1395;3760;1066;3149;277;876;389;1074;666;1950
411990;201809;33708;95767;23204;74299;5135;18128;7635;23189;12770;41317
411995;201809;2661;7075;2037;6076;613;2026;576;1600;1189;3626
412000;201809;2049;4835;1491;3889;77;265;971;2369;1048;2634
412010;201809;621;1980;430;1513;69;277;98;291;167;568
412015;201809;548;1602;460;1433;64;222;254;781;318;1003
412020;201809;432;1242;254;830;40;147;98;311;138;458
412030;201809;646;1891;451;1490;87;309;142;449;229;758
412033;201809;852;2440;599;1882;82;258;230;736;312;994
412035;201809;768;2068;495;1580;75;274;242;731;317;1005
412040;201809;542;1525;351;1110;70;226;62;182;132;408
412050;201809;1653;4365;1160;3424;222;740;290;846;512;1586
412060;201809;6791;21581;5877;19718;1822;6674;1469;4719;3291;11393
412065;201809;601;1709;447;1395;92;293;139;429;231;722
412070;201809;1116;2950;862;2397;136;395;354;959;490;1354
412080;201809;1766;5222;1099;3674;183;659;109;324;292;983
412085;201809;277;746;92;316;12;39;7;21;19;60
412090;201809;5314;14368;4378;12654;1194;3476;1854;5511;3048;8987
412100;201809;1708;4835;1298;4097;417;1412;246;817;663;2229
412110;201809;814;2294;604;1825;109;351;193;569;302;920
412120;201809;1740;5481;1399;4729;313;1175;420;1222;733;2397
412125;201809;635;1946;487;1584;112;381;164;511;276;892
412130;201809;625;1718;440;1315;67;225;114;352;181;577
412135;201809;595;1640;271;827;50;155;87;236;137;391
412140;201809;1508;3948;982;2958;234;824;159;426;393;1250
412150;201809;2811;7619;2355;6779;335;1071;1479;4104;1814;5175
412160;201809;1020;3264;630;2221;152;587;86;291;238;878
412170;201809;4023;11894;3379;10678;786;2646;1395;4106;2181;6752
412175;201809;1289;4084;1095;3700;285;956;417;1430;702;2386
412180;201809;1673;4765;1220;3901;188;717;516;1499;704;2216
412190;201809;3185;8348;2381;6853;352;1131;1040;2979;1392;4110
412200;201809;1765;5460;1247;4167;325;1140;221;717;546;1857
412210;201809;572;1492;331;1002;67;227;94;244;161;471
412215;201809;3643;9939;2981;8653;823;2362;1208;3925;2031;6287
412217;201809;980;2670;836;2431;78;260;563;1571;641;1831
412220;201809;5490;16126;4569;14253;1220;3789;1530;5052;2750;8841
412230;201809;2611;8239;2111;7145;423;1625;583;1728;1006;3353
412240;201809;6522;17288;4132;12477;801;2684;1130;3158;1931;5842
412250;201809;1910;5137;1473;4282;385;1126;280;814;665;1940
412260;201809;1172;3293;826;2528;142;431;249;724;391;1155
412265;201809;803;2408;683;2151;152;521;286;871;438;1392
412270;201809;752;2222;510;1658;83;302;200;599;283;901
412280;201809;476;1424;378;1247;91;310;108;346;199;656
412290;201809;961;2497;641;1890;111;351;209;589;320;940
412300;201809;1410;4044;1142;3505;309;996;260;792;569;1788
412310;201809;739;2113;612;1884;63;263;320;957;383;1220
412320;201809;805;2150;557;1657;75;301;203;582;278;883
412330;201809;1391;3828;948;2915;173;562;364;1137;537;1699
412340;201809;963;2827;612;1978;106;363;120;356;226;719
412350;201809;2618;7200;1716;5321;363;1128;336;1067;699;2195
412360;201809;233;636;138;423;17;60;62;176;79;236
412370;201809;740;2211;534;1795;111;416;43;165;154;581
412380;201809;1522;4347;1058;3318;298;956;163;537;461;1493
412382;201809;528;1387;352;1054;63;206;107;278;170;484
412385;201809;2121;6090;1767;5359;622;1867;519;1710;1141;3577
412390;201809;2279;5921;1862;5240;356;1060;848;2377;1204;3437
412395;201809;661;1898;464;1466;59;189;210;633;269;822
412400;201809;862;2459;635;1975;145;475;158;519;303;994
412402;201809;1693;4472;1252;3707;327;1053;153;452;480;1505
412405;201809;2963;8297;1911;6049;460;1650;60;204;520;1854
412410;201809;4993;13894;3682;11423;827;2905;960;2789;1787;5694
412420;201809;458;1218;269;800;27;88;105;272;132;360
412430;201809;530;1406;345;1027;32;112;164;459;196;571
412440;201809;2671;7654;1797;5885;524;1838;303;1023;827;2861
412450;201809;337;1035;228;760;44;143;25;62;69;205
412460;201809;904;2553;738;2253;136;453;298;896;434;1349
412470;201809;1587;5254;1290;4526;348;1277;303;1125;651;2402
412480;201809;926;2617;584;1800;112;371;108;278;220;649
412490;201809;1063;2834;877;2466;121;335;448;1215;569;1550
412500;201809;1733;4635;1333;3841;319;945;294;778;613;1723
412510;201809;1906;5974;1352;4531;329;1163;125;377;454;1540
412520;201809;1305;3542;716;2202;179;541;61;177;240;718
412530;201809;628;1713;460;1363;66;222;119;344;185;566
412535;201809;744;2047;520;1569;127;422;103;274;230;696
412540;201809;1212;3304;824;2459;95;349;260;773;355;1122
412545;201809;677;1773;453;1307;81;254;133;348;214;602
412550;201809;28886;81536;19819;62176;4138;13924;6502;18930;10640;32854
412555;201809;227;625;152;461;24;81;41;99;65;180
412560;201809;4789;14382;3512;11313;731;2569;939;2945;1670;5514
412570;201809;3683;10010;2255;7069;527;1780;333;1121;860;2901
412575;201809;899;2473;738;2139;77;257;431;1150;508;1407
412580;201809;1286;3441;893;2672;155;514;402;1155;557;1669
412590;201809;417;1139;213;702;49;170;23;74;72;244
412600;201809;1335;3877;993;3120;171;609;398;1202;569;1811
412610;201809;746;2074;473;1413;60;188;224;594;284;782
412620;201809;1231;3505;928;2938;190;679;288;830;478;1509
412625;201809;7924;22217;5132;16402;869;3006;501;1701;1370;4707
412627;201809;975;2821;658;2150;167;609;176;559;343;1168
412630;201809;2799;8349;2030;6582;393;1279;665;1963;1058;3242
412635;201809;322;886;227;674;43;138;57;140;100;278
412640;201809;1012;2843;559;1769;85;293;125;354;210;647
412650;201809;1445;4142;1176;3590;221;781;421;1116;642;1897
412660;201809;2466;6771;1757;5320;328;1090;519;1429;847;2519
412665;201809;534;1316;304;892;55;162;116;315;171;477
412667;201809;1666;4532;1248;3683;192;644;488;1363;680;2007
412670;201809;693;1815;495;1454;81;277;189;532;270;809
412680;201809;1413;4004;906;2972;137;528;345;984;482;1512
412690;201809;847;2414;615;1907;116;378;173;513;289;891
412700;201809;2020;5541;1612;4863;305;1103;727;2079;1032;3182
412710;201809;5620;17120;4467;14660;995;3583;1329;4073;2324;7656
412720;201809;1208;3650;893;2883;158;532;190;522;348;1054
412730;201809;1994;5696;1130;3717;247;857;184;584;431;1441
412740;201809;1649;4764;1096;3521;220;761;172;582;392;1343
412750;201809;3745;10649;3240;9827;395;1421;2097;6057;2492;7478
412760;201809;2740;7768;2340;7050;363;1213;1348;3910;1711;5123
412770;201809;9534;25038;5024;15615;806;2616;1031;2865;1837;5481
412780;201809;1209;3456;963;2986;206;684;354;1074;560;1758
412785;201809;1980;5215;1394;4121;256;790;688;1979;944;2769
412788;201809;1282;3794;1051;3314;250;825;455;1367;705;2192
412790;201809;1076;3014;637;2048;128;477;198;537;326;1014
412795;201809;1197;3251;646;2001;137;449;127;369;264;818
412796;201809;2297;7031;1919;6160;397;1343;643;1918;1040;3261
412800;201809;3227;8357;2198;6297;307;985;915;2371;1222;3356
412810;201809;10312;26983;6161;18182;909;3029;2034;5259;2943;8288
412820;201809;6305;17860;4594;14464;1089;3581;1415;4493;2504;8074
412830;201809;333;970;231;740;41;124;45;139;86;263
412840;201809;1711;4582;1246;3659;187;598;415;1145;602;1743
412850;201809;2844;7759;2142;6493;370;1216;788;2316;1158;3532
412853;201809;1698;4584;1403;3903;172;541;732;1843;904;2384
412855;201809;1125;3128;765;2316;160;541;196;535;356;1076
412860;201809;804;2265;599;1858;111;371;256;774;367;1145
412862;201809;687;1680;453;1269;63;197;206;562;269;759
412863;201809;1158;3657;1074;3513;120;403;791;2588;911;2991
412865;201809;704;2025;517;1659;98;326;183;597;281;923
412870;201809;865;2413;667;2078;205;719;143;464;348;1183
412880;201809;812;2299;528;1675;99;335;82;240;181;575
420005;201809;422;1284;232;827;37;132;95;346;132;478
420010;201809;3498;8859;2330;6766;215;697;1620;4709;1835;5406
420020;201809;479;1503;288;1000;55;226;42;111;97;337
420030;201809;118;366;78;298;22;97;13;49;35;146
420040;201809;565;1767;322;1197;55;225;20;55;75;280
420050;201809;621;1543;403;1150;51;157;249;677;300;834
420055;201809;155;475;79;288;13;55;27;101;40;156
420060;201809;119;356;75;249;13;52;17;38;30;90
420070;201809;839;2684;629;2174;134;497;229;762;363;1259
420075;201809;83;225;45;139;9;25;11;25;20;50
420080;201809;364;1112;286;949;94;318;93;298;187;616
420090;201809;383;1284;247;923;63;241;48;188;111;429
420100;201809;1097;3120;959;2917;62;207;762;2290;824;2497
420110;201809;242;806;219;759;48;183;86;278;134;461
420120;201809;357;1077;247;827;56;212;95;283;151;495
420125;201809;315;1053;253;922;63;260;119;413;182;673
420127;201809;286;823;102;361;23;95;22;71;45;166
420130;201809;1889;5803;1418;4840;323;1265;560;1734;883;2999
420140;201809;3136;8904;2297;7361;662;2413;318;967;980;3380
420150;201809;542;1420;334;1059;62;208;148;449;210;657
420160;201809;237;610;107;340;16;56;39;118;55;174
420165;201809;151;454;92;313;24;84;29;91;53;175
420170;201809;244;750;149;520;30;108;25;79;55;187
420180;201809;196;606;114;405;14;51;36;114;50;165
420190;201809;149;498;88;335;34;137;13;48;47;185
420195;201809;1228;3410;927;2892;287;1022;115;309;402;1331
420200;201809;3140;8621;1814;5858;322;1281;589;1643;911;2924
420205;201809;1186;3434;876;2856;145;490;490;1639;635;2129
420207;201809;1511;4153;970;3103;221;811;341;1028;562;1839
420208;201809;375;1054;208;755;36;159;87;306;123;465
420209;201809;143;494;93;340;31;135;34;110;65;245
420210;201809;2243;6145;1445;4805;327;1216;602;1913;929;3129
420213;201809;758;2488;652;2268;167;638;295;1002;462;1640
420215;201809;222;686;155;536;51;185;29;87;80;272
420220;201809;184;599;123;457;35;147;45;147;80;294
420230;201809;3869;11055;2938;9316;445;1601;1498;4594;1943;6195
420240;201809;10448;29081;6737;21087;925;3429;3512;9800;4437;13229
420243;201809;380;1130;304;980;61;217;156;477;217;694
420245;201809;1179;3277;821;2599;93;371;456;1363;549;1734
420250;201809;414;1255;359;1143;83;310;188;556;271;866
420253;201809;501;1288;362;1077;27;89;189;545;216;634
420257;201809;188;496;112;356;20;67;58;180;78;247
420260;201809;1009;2963;757;2555;124;481;414;1363;538;1844
420270;201809;448;1227;211;657;21;69;81;240;102;309
420280;201809;1314;3646;834;2740;183;672;226;714;409;1386
420285;201809;100;278;55;189;9;39;8;19;17;58
420287;201809;436;1116;294;885;83;263;95;286;178;549
420290;201809;3750;11101;2862;9109;509;1820;1319;3819;1828;5639
420300;201809;6131;17712;3600;11859;771;2854;952;2783;1723;5637
420310;201809;847;2046;405;1140;81;233;204;534;285;767
420315;201809;811;2483;571;1975;151;569;200;673;351;1242
420320;201809;3871;11543;3073;10069;1013;3631;720;2188;1733;5819
420325;201809;236;733;177;614;45;143;53;179;98;322
420330;201809;823;2591;556;1959;133;534;183;586;316;1120
420340;201809;954;2860;681;2285;164;568;60;190;224;758
420350;201809;1356;3710;945;2897;118;403;572;1730;690;2133
420360;201809;2414;7030;1302;4471;282;1038;131;448;413;1486
420370;201809;1146;3224;915;2823;127;484;609;1796;736;2280
420380;201809;4739;13160;3063;9833;737;2510;955;2954;1692;5464
420390;201809;1010;2574;662;1838;119;376;281;580;400;956
420395;201809;956;2840;626;2117;107;386;74;228;181;614
420400;201809;881;2647;574;1937;124;470;160;530;284;1000
420410;201809;518;1473;392;1219;42;164;252;744;294;908
420415;201809;304;935;226;761;74;269;69;239;143;508
420417;201809;613;1905;501;1652;122;415;187;624;309;1039
420419;201809;155;569;124;482;50;212;8;25;58;237
420420;201809;9837;27339;6905;21874;2421;8326;1610;4803;4031;13129
420425;201809;705;1885;487;1480;52;194;225;656;277;850
420430;201809;3056;8793;1900;6129;465;1599;564;1633;1029;3232
420435;201809;276;742;123;418;25;100;51;164;76;264
420440;201809;689;2059;400;1344;129;475;105;310;234;785
420445;201809;309;842;186;576;42;142;56;158;98;300
420450;201809;626;1910;457;1527;89;353;149;449;238;802
420455;201809;1889;4986;1405;4174;207;705;709;2020;916;2725
420460;201809;8111;22692;6110;18977;1117;3936;2883;8483;4000;12419
420470;201809;592;1648;351;1157;72;272;91;267;163;539
420475;201809;36;109;28;90;11;34;5;17;16;51
420480;201809;4699;12463;3110;9662;677;2292;1005;3053;1682;5345
420490;201809;406;1177;251;863;68;266;68;226;136;492
420500;201809;1234;3752;893;3052;193;690;331;1099;524;1789
420510;201809;153;461;87;289;13;44;26;89;39;133
420515;201809;49;133;33;98;5;15;13;34;18;49
420517;201809;745;2076;653;1914;58;167;490;1436;548;1603
420519;201809;313;788;202;613;27;93;83;256;110;349
420520;201809;376;1015;161;567;21;70;12;42;33;112
420530;201809;848;2531;585;1949;136;521;165;465;301;986
420535;201809;201;570;92;309;23;79;21;78;44;157
420540;201809;24865;63032;16126;46851;3022;9764;5802;14866;8824;24630
420543;201809;229;675;178;557;28;86;91;272;119;358
420545;201809;1097;3362;868;2865;207;714;324;1043;531;1757
420550;201809;3300;9624;2214;7559;470;1757;889;3087;1359;4844
420555;201809;275;836;191;654;42;163;84;266;126;429
420560;201809;404;1089;297;911;70;214;159;489;229;703
420570;201809;2013;5936;1531;4952;322;1156;582;1748;904;2904
420580;201809;1572;4233;1175;3596;268;881;554;1645;822;2526
420590;201809;2772;7776;1657;5251;355;1297;375;879;730;2176
420600;201809;912;2814;711;2390;140;540;320;1023;460;1563
420610;201809;327;1001;196;684;50;180;49;171;99;351
420620;201809;468;1336;374;1163;113;363;131;413;244;776
420630;201809;828;2488;611;1952;129;459;284;813;413;1272
420640;201809;509;1482;243;871;64;238;24;70;88;308
420650;201809;2666;7540;1593;5164;280;975;595;1679;875;2654
420660;201809;341;978;236;760;60;211;62;196;122;407
420665;201809;506;1388;326;1056;64;237;131;380;195;617
420670;201809;1399;3951;938;3053;169;678;347;1003;516;1681
420675;201809;133;399;85;299;27;113;17;44;44;157
420680;201809;317;779;181;575;32;110;87;267;119;377
420690;201809;766;2419;500;1737;79;302;114;322;193;624
420700;201809;2642;7428;2045;6339;338;1176;1005;2986;1343;4162
420710;201809;628;1951;486;1642;84;351;242;736;326;1087
420720;201809;1270;3577;945;3090;257;840;408;1314;665;2154
420730;201809;2647;7328;2064;6382;372;1221;1116;3334;1488;4555
420740;201809;645;1975;405;1446;124;468;52;203;176;671
420750;201809;1662;5055;1117;3768;223;872;429;1301;652;2173
420757;201809;61;151;21;85;4;18;9;35;13;53
420760;201809;362;1108;153;509;41;142;18;58;59;200
420765;201809;405;1304;220;781;40;151;80;280;120;431
420768;201809;1151;3617;989;3300;205;680;638;2148;843;2828
420770;201809;486;1370;226;835;47;193;79;281;126;474
420775;201809;417;1245;251;869;59;230;46;131;105;361
420780;201809;965;2809;566;1921;117;416;135;413;252;829
420785;201809;184;509;134;400;22;66;46;122;68;188
420790;201809;937;3058;735;2646;180;720;341;1162;521;1882
420800;201809;710;1877;330;1073;89;294;74;236;163;530
420810;201809;1435;4855;1175;4261;393;1596;288;907;681;2503
420820;201809;8911;23808;6149;19185;1444;5040;2477;7021;3921;12061
420830;201809;2850;8230;2196;7013;557;1909;808;2520;1365;4429
420840;201809;589;1761;261;940;72;263;49;169;121;432
420845;201809;1722;4681;1012;3386;215;793;344;1143;559;1936
420850;201809;1032;3497;650;2454;167;688;94;305;261;993
420860;201809;260;705;158;517;44;165;34;100;78;265
420870;201809;803;2244;641;1969;192;684;270;772;462;1456
420880;201809;848;2698;667;2296;150;560;212;668;362;1228
420890;201809;7361;20240;4031;13221;715;2606;1107;3081;1822;5687
420895;201809;159;477;92;298;34;117;25;75;59;192
420900;201809;1368;3564;821;2563;130;500;336;911;466;1411
420910;201809;22747;63487;14761;47599;2676;9650;5421;15839;8097;25489
420915;201809;541;2019;368;1493;63;261;168;683;231;944
420917;201809;335;924;174;515;30;102;74;206;104;308
420920;201809;85;245;32;119;4;18;3;10;7;28
420930;201809;16583;44957;11989;36853;2250;7568;5473;16008;7723;23576
420940;201809;2204;5864;1391;4389;367;1262;161;414;528;1676
420945;201809;135;411;99;319;33;125;30;80;63;205
420950;201809;320;970;186;639;30;116;57;173;87;289
420960;201809;912;2426;630;1885;121;421;249;664;370;1085
420970;201809;2463;7339;1685;5738;499;1760;275;996;774;2756
420980;201809;308;971;247;878;110;385;81;321;191;706
420985;201809;295;895;154;554;34;138;50;153;84;291
420990;201809;398;1201;210;757;49;183;38;120;87;303
421000;201809;445;1491;305;1117;79;326;68;191;147;517
421003;201809;459;1114;152;474;16;50;27;77;43;127
421005;201809;54;188;48;178;14;55;20;73;34;128
421010;201809;3528;9949;2507;8076;569;2009;586;1707;1155;3716
421020;201809;357;1085;281;955;22;90;195;668;217;758
421030;201809;707;2258;553;1915;178;671;149;474;327;1145
421040;201809;686;1658;422;1244;44;145;256;737;300;882
421050;201809;1135;3265;701;2259;141;487;237;691;378;1178
421055;201809;168;467;84;271;18;63;27;76;45;139
421060;201809;486;1502;332;1111;68;264;125;383;193;647
421070;201809;494;1550;283;1013;68;257;43;148;111;405
421080;201809;644;2631;601;2561;65;214;454;2104;519;2318
421085;201809;378;1138;156;584;26;105;24;79;50;184
421090;201809;296;798;166;520;21;69;51;156;72;225
421100;201809;886;2121;392;1182;96;327;47;136;143;463
421105;201809;1334;3776;1074;3388;175;543;618;2009;793;2552
421110;201809;971;2915;828;2678;53;162;583;1945;636;2107
421120;201809;892;2914;623;2248;97;401;192;615;289;1016
421125;201809;247;694;201;618;67;229;70;174;137;403
421130;201809;3620;11149;3093;10144;713;2577;1659;5293;2372;7870
421140;201809;268;761;178;576;40;128;55;155;95;283
421145;201809;450;1299;264;859;56;200;118;363;174;563
421150;201809;472;1316;288;985;58;231;105;343;163;574
421160;201809;699;1856;397;1254;57;203;215;655;272;858
421165;201809;190;597;133;458;31;104;55;191;86;295
421170;201809;1054;2897;835;2550;142;433;524;1620;666;2053
421175;201809;1025;2749;679;2172;142;522;262;755;404;1277
421180;201809;375;993;188;611;41;166;49;155;90;321
421185;201809;313;832;213;632;30;91;121;353;151;444
421187;201809;328;967;208;663;37;123;82;243;119;366
421189;201809;346;1069;263;883;48;172;86;269;134;441
421190;201809;9268;25733;5873;19278;1323;4787;1372;4277;2695;9064
421200;201809;654;2031;538;1786;100;351;261;827;361;1178
421205;201809;179;517;142;456;30;109;70;214;100;323
421210;201809;1024;2808;659;2131;176;574;224;727;400;1301
421220;201809;1241;4021;1030;3545;260;991;233;716;493;1707
421223;201809;367;1086;244;833;57;188;105;358;162;546
421225;201809;884;2774;770;2546;162;578;427;1425;589;2003
421227;201809;942;2564;568;1816;103;362;278;898;381;1260
421230;201809;543;1487;348;1123;103;366;113;355;216;721
421240;201809;312;963;129;487;12;62;18;67;30;129
421250;201809;1430;3856;937;3007;186;670;359;1095;545;1765
421260;201809;189;540;45;166;10;38;7;29;17;67
421265;201809;630;1882;579;1809;37;134;493;1539;530;1673
421270;201809;415;1092;186;666;40;145;71;251;111;396
421280;201809;1434;4365;1110;3755;260;1001;474;1506;734;2507
421290;201809;744;2105;436;1392;91;295;90;282;181;577
421300;201809;206;590;131;430;27;101;42;132;69;233
421310;201809;165;524;133;443;18;71;61;198;79;269
421315;201809;202;618;128;439;35;121;24;87;59;208
421320;201809;616;1828;326;1084;57;200;48;111;105;311
421330;201809;590;1799;431;1475;100;370;115;367;215;737
421335;201809;337;1083;271;950;53;220;105;361;158;581
421340;201809;1247;3660;943;3088;204;731;408;1306;612;2037
421350;201809;1093;3164;794;2604;159;627;352;1059;511;1686
421360;201809;2138;6067;1335;4465;308;1210;465;1374;773;2584
421370;201809;457;1531;277;1040;69;274;62;229;131;503
421380;201809;746;2131;659;1961;107;353;393;1132;500;1485
421390;201809;173;474;63;212;10;29;18;54;28;83
421400;201809;251;853;170;656;39;175;77;270;116;445
421410;201809;247;688;106;384;13;51;43;153;56;204
421415;201809;269;831;134;451;38;133;26;75;64;208
421420;201809;502;1496;425;1344;71;252;248;746;319;998
421430;201809;126;431;97;357;13;49;31;108;44;157
421440;201809;609;1655;396;1299;82;276;198;653;280;929
421450;201809;352;1066;223;758;36;146;38;146;74;292
421460;201809;355;1027;223;769;46;170;62;187;108;357
421470;201809;207;674;140;510;33;143;48;177;81;320
421480;201809;2558;7039;1663;5366;439;1569;485;1421;924;2990
421490;201809;117;350;70;238;10;41;19;52;29;93
421500;201809;1955;6069;1374;4821;403;1596;286;916;689;2512
421505;201809;302;918;262;848;39;140;156;487;195;627
421507;201809;375;1150;229;804;69;268;70;234;139;502
421510;201809;223;638;137;429;32;98;61;174;93;272
421520;201809;520;1423;330;994;47;163;176;485;223;648
421530;201809;300;957;181;647;36;162;39;110;75;272
421535;201809;406;1157;259;867;33;125;134;422;167;547
421540;201809;199;524;126;398;16;60;51;148;67;208
421545;201809;666;2002;487;1639;100;372;211;688;311;1060
421550;201809;1860;5481;1563;5000;373;1289;754;2333;1127;3622
421555;201809;192;586;63;230;10;43;10;22;20;65
421560;201809;96;309;54;204;13;53;13;48;26;101
421565;201809;823;2253;587;1859;144;501;198;653;342;1154
421567;201809;473;1680;314;1193;148;577;53;183;201;760
421568;201809;362;1099;251;840;35;132;110;350;145;482
421569;201809;183;552;66;241;19;68;20;79;39;147
421570;201809;949;2690;638;2074;185;667;136;405;321;1072
421575;201809;290;890;256;790;43;157;127;347;170;504
421580;201809;2760;8307;1914;6470;428;1674;612;1785;1040;3459
421590;201809;134;447;108;372;35;129;27;82;62;211
421600;201809;488;1381;329;1028;86;286;76;202;162;488
421605;201809;704;1916;478;1512;107;346;153;477;260;823
421610;201809;1087;3031;677;2213;150;520;148;472;298;992
421620;201809;3591;10238;2126;7357;584;2196;544;1827;1128;4023
421625;201809;216;594;87;290;22;69;12;34;34;103
421630;201809;2390;6720;1374;4443;258;977;341;967;599;1944
421635;201809;210;603;138;433;16;57;68;188;84;245
421640;201809;716;1991;486;1583;101;338;142;457;243;795
421650;201809;2028;5905;1307;4430;327;1268;284;792;611;2060
421660;201809;6719;20510;5334;17770;1020;3886;2098;6451;3118;10337
421670;201809;775;2271;542;1727;130;491;234;702;364;1193
421680;201809;860;2677;675;2282;208;755;245;759;453;1514
421690;201809;1142;3532;817;2788;193;744;230;758;423;1502
421700;201809;436;1369;220;796;46;181;48;150;94;331
421710;201809;196;627;89;307;21;81;27;84;48;165
421715;201809;104;300;75;231;17;54;51;150;68;204
421720;201809;1823;5167;1056;3539;293;1046;273;829;566;1875
421725;201809;181;454;102;311;24;76;42;108;66;184
421730;201809;318;972;186;591;32;113;76;217;108;330
421740;201809;570;1708;389;1289;110;401;100;305;210;706
421750;201809;804;1955;422;1260;85;272;167;464;252;736
421755;201809;167;484;95;309;14;53;43;127;57;180
421760;201809;819;2342;478;1632;90;342;129;369;219;711
421770;201809;2105;5888;1553;4913;409;1296;561;1933;970;3229
421775;201809;229;628;143;454;24;85;68;194;92;279
421780;201809;743;2411;513;1894;123;489;172;611;295;1100
421790;201809;607;1577;359;1177;84;297;181;567;265;864
421795;201809;219;658;133;424;22;79;54;153;76;232
421800;201809;2253;6605;1698;5573;351;1257;828;2615;1179;3872
421810;201809;595;1672;414;1312;60;228;220;652;280;880
421820;201809;747;2219;407;1408;91;330;85;277;176;607
421825;201809;1267;3729;1162;3564;152;524;822;2456;974;2980
421830;201809;1987;6464;1709;5915;425;1611;632;2067;1057;3678
421835;201809;205;566;120;405;17;81;51;150;68;231
421840;201809;215;689;144;528;42;165;31;102;73;267
421850;201809;359;1089;206;723;38;155;55;150;93;305
421860;201809;261;804;173;607;25;119;54;148;79;267
421870;201809;3059;8184;2153;6441;492;1645;872;2412;1364;4057
421875;201809;214;657;106;383;21;88;22;59;43;147
421880;201809;452;1295;347;1114;111;421;66;215;177;636
421885;201809;178;522;130;448;40;141;28;81;68;222
421890;201809;738;2400;592;2107;147;587;253;817;400;1404
421895;201809;344;1010;313;964;41;147;211;644;252;791
421900;201809;904;2400;638;1895;103;350;301;805;404;1155
421910;201809;308;953;215;742;51;201;41;116;92;317
421915;201809;380;1092;210;687;46;145;27;85;73;230
421917;201809;539;1464;346;1186;126;482;70;237;196;719
421920;201809;493;1455;322;1161;158;591;102;380;260;971
421930;201809;2126;5775;1041;3553;311;1154;148;473;459;1627
421935;201809;421;1396;339;1209;72;269;177;603;249;872
421940;201809;286;900;123;441;30;130;29;93;59;223
421950;201809;2905;7451;1424;4559;336;1193;291;832;627;2025
421960;201809;151;399;99;318;20;80;23;65;43;145
421970;201809;1927;5142;1056;3331;235;780;291;798;526;1578
421985;201809;282;741;162;491;16;59;56;178;72;237
422000;201809;1537;4404;1294;3954;192;682;779;2353;971;3035
430003;201809;497;1473;344;1181;73;279;132;444;205;723
430005;201809;266;748;171;564;47;155;72;236;119;391
430010;201809;1627;4342;1293;3739;194;619;805;2254;999;2873
430020;201809;578;1405;448;1226;75;234;257;655;332;889
430030;201809;1010;2497;584;1706;177;532;169;467;346;999
430040;201809;9292;23771;5614;16796;1594;5255;365;1164;1959;6419
430045;201809;556;1447;371;1078;41;143;208;564;249;707
430047;201809;242;555;97;295;21;68;28;87;49;155
430050;201809;976;2609;527;1629;117;387;124;362;241;749
430055;201809;269;691;114;354;16;53;54;154;70;207
430057;201809;95;217;32;91;7;26;8;19;15;45
430060;201809;15267;44461;12357;39674;3257;11187;5189;16673;8446;27860
430063;201809;868;2475;681;2060;132;402;376;1126;508;1528
430064;201809;959;2803;717;2248;213;706;219;679;432;1385
430066;201809;111;256;77;201;4;15;56;131;60;146
430070;201809;705;1812;106;355;14;45;10;20;24;65
430080;201809;739;1956;440;1339;90;298;187;506;277;804
430085;201809;846;2059;498;1443;90;269;201;575;291;844
430087;201809;531;1553;443;1418;92;313;243;781;335;1094
430090;201809;588;1553;193;637;22;88;56;183;78;271
430100;201809;545;1407;298;926;70;233;108;308;178;541
430105;201809;959;2653;623;2067;118;450;287;952;405;1402
430107;201809;174;528;120;399;18;63;30;84;48;147
430110;201809;2016;5163;1473;4338;241;737;826;2370;1067;3107
430120;201809;1356;4194;849;2861;175;616;367;1264;542;1880
430130;201809;3712;9850;2934;8710;1050;2879;917;3384;1967;6263
430140;201809;901;2681;592;1977;169;558;221;752;390;1310
430150;201809;559;1463;310;966;71;232;93;278;164;510
430155;201809;260;667;128;403;19;62;34;97;53;159
430160;201809;16999;44158;13728;39141;3019;9060;5963;17482;8982;26542
430163;201809;2300;5971;1650;4931;173;598;1034;3058;1207;3656
430165;201809;390;921;75;243;10;26;8;20;18;46
430170;201809;885;2425;313;1103;65;221;63;207;128;428
430175;201809;666;2089;546;1807;135;430;271;899;406;1329
430180;201809;662;1736;524;1486;86;265;339;918;425;1183
430185;201809;443;1084;271;761;42;127;134;344;176;471
430187;201809;636;1665;455;1371;76;254;225;665;301;919
430190;201809;1365;3897;1138;3476;285;922;510;1523;795;2445
430192;201809;121;362;50;157;9;30;12;35;21;65
430195;201809;382;1151;63;226;10;35;7;22;17;57
430200;201809;1020;3260;875;2965;303;1080;260;894;563;1974
430205;201809;493;1349;394;1142;19;67;316;883;335;950
430210;201809;4897;12463;3381;9442;618;1914;1319;2988;1937;4902
430215;201809;304;826;194;586;37;119;76;222;113;341
430220;201809;648;1636;168;580;29;118;35;110;64;228
430222;201809;180;537;148;470;24;80;64;194;88;274
430223;201809;250;698;211;620;34;105;115;321;149;426
430225;201809;15;36;13;32;2;3;9;16;11;19
430230;201809;1592;4696;1473;4529;194;552;1123;3532;1317;4084
430235;201809;240;738;174;579;37;130;54;170;91;300
430237;201809;541;1332;363;1018;21;70;246;653;267;723
430240;201809;1132;2578;675;1862;69;237;397;1048;466;1285
430245;201809;698;2145;537;1795;174;573;241;829;415;1402
430250;201809;961;2594;765;2290;246;803;37;94;283;897
430258;201809;116;331;88;277;7;23;45;144;52;167
430260;201809;614;1683;442;1336;81;265;226;671;307;936
430265;201809;192;579;141;486;27;101;41;141;68;242
430270;201809;2679;7033;2176;6230;270;850;1474;4126;1744;4976
430280;201809;4649;11649;3366;9342;760;2197;1406;3882;2166;6079
430290;201809;2090;5199;1848;4863;71;226;1587;4107;1658;4333
430300;201809;8327;23043;6617;19821;1336;4290;3221;9508;4557;13798
430310;201809;8668;22990;5815;17345;932;3188;2719;7611;3651;10799
430320;201809;917;2535;507;1620;82;216;257;880;339;1096
430330;201809;591;1522;396;1116;89;279;187;467;276;746
430340;201809;653;1526;341;1014;72;229;179;514;251;743
430350;201809;5599;16069;4526;13860;1160;3626;1997;6010;3157;9636
430355;201809;318;825;107;353;29;92;11;37;40;129
430360;201809;730;1895;524;1523;118;390;182;476;300;866
430367;201809;319;795;162;492;46;152;50;151;96;303
430370;201809;484;1352;225;739;51;176;59;173;110;349
430380;201809;685;1744;358;1140;86;306;74;243;160;549
430390;201809;2939;7360;1587;4783;320;1064;130;314;450;1378
430400;201809;1085;2438;813;2024;98;252;570;1361;668;1613
430410;201809;558;1424;391;1128;61;202;223;612;284;814
430420;201809;2743;7817;2098;6346;658;2063;718;2090;1376;4153
430430;201809;652;1713;313;982;74;237;67;211;141;448
430435;201809;1482;3910;1115;3282;262;826;462;1360;724;2186
430440;201809;3524;10356;2644;8526;507;1749;1360;4384;1867;6133
430450;201809;6005;16241;5063;14490;727;2333;2982;8357;3709;10690
430460;201809;26407;71197;18983;58789;4291;14743;7993;23582;12284;38325
430461;201809;417;1069;124;392;22;74;29;79;51;153
430462;201809;242;664;147;483;22;75;50;178;72;253
430463;201809;4452;12970;3561;11377;702;2437;1821;5762;2523;8199
430465;201809;468;1271;386;1099;66;200;235;654;301;854
430466;201809;3713;9612;2987;8393;778;2277;1396;3741;2174;6018
430467;201809;471;1222;345;1006;53;177;170;479;223;656
430468;201809;1283;3300;1031;2914;147;461;630;1753;777;2214
430469;201809;632;1789;72;246;12;37;10;18;22;55
430470;201809;5490;15012;3901;12121;1352;4439;881;2726;2233;7165
430471;201809;477;1486;414;1340;82;261;202;639;284;900
430480;201809;826;2210;416;1329;67;233;77;209;144;442
430485;201809;156;434;57;192;9;28;12;41;21;69
430490;201809;401;1078;222;679;31;108;100;286;131;394
430495;201809;363;1027;228;745;38;127;89;265;127;392
430500;201809;1031;2749;740;2241;218;719;244;676;462;1395
430510;201809;21974;59655;15858;47141;3581;11713;6233;17097;9814;28810
430511;201809;319;945;115;402;17;57;15;44;32;101
430512;201809;867;2110;700;1841;177;475;228;624;405;1099
430513;201809;778;1989;373;1076;68;207;171;469;239;676
430515;201809;389;1107;275;869;43;125;131;424;174;549
430517;201809;866;2753;723;2464;130;437;378;1348;508;1785
430520;201809;1291;3462;675;2130;144;461;129;374;273;835
430530;201809;1049;2702;368;1135;80;238;80;241;160;479
430535;201809;2835;7786;2017;6189;352;1129;969;2930;1321;4059
430537;201809;327;1184;294;1073;34;114;223;824;257;938
430540;201809;563;1359;329;981;60;180;158;456;218;636
430543;201809;633;1266;395;985;62;139;230;606;292;745
430544;201809;623;1903;449;1483;99;355;216;679;315;1034
430545;201809;1745;4901;1347;4286;289;948;665;2188;954;3136
430550;201809;421;1217;250;813;48;163;70;211;118;374
430558;201809;112;259;53;149;11;32;18;46;29;78
430560;201809;346;795;144;438;17;59;42;119;59;178
430570;201809;827;1989;579;1569;87;278;350;876;437;1154
430580;201809;1038;2533;671;1953;132;434;307;847;439;1281
430583;201809;189;469;35;108;3;8;5;15;8;23
430585;201809;218;533;122;335;16;46;60;144;76;190
430587;201809;184;554;142;463;26;86;57;186;83;272
430590;201809;1393;3418;1205;3116;51;157;1051;2668;1102;2825
430593;201809;13;46;12;42;2;8;8;26;10;34
430595;201809;405;982;88;305;8;35;18;52;26;87
430597;201809;348;977;220;675;26;89;80;188;106;277
430600;201809;1732;4618;809;2473;150;470;221;645;371;1115
430605;201809;1076;3139;821;2605;124;471;320;962;444;1433
430607;201809;617;1415;451;1160;31;87;314;818;345;905
430610;201809;5383;13806;3819;11297;1170;3702;658;2065;1828;5767
430613;201809;265;633;81;248;9;33;19;47;28;80
430620;201809;533;1447;428;1239;99;318;194;531;293;849
430630;201809;431;1244;121;395;18;60;26;69;44;129
430632;201809;538;1480;245;758;34;112;110;322;144;434
430635;201809;513;1418;385;1144;70;225;249;724;319;949
430637;201809;442;1159;350;1000;44;138;203;551;247;689
430640;201809;1150;2989;632;1905;103;317;207;575;310;892
430642;201809;360;985;259;765;45;128;133;386;178;514
430645;201809;237;505;81;209;18;48;14;38;32;86
430650;201809;1515;4719;1276;4277;340;1173;619;2110;959;3283
430655;201809;221;545;130;367;17;50;68;179;85;229
430660;201809;4498;12313;3497;10514;828;2733;1613;4780;2441;7513
430670;201809;566;1474;432;1231;39;129;280;805;319;934
430673;201809;568;1348;224;685;47;149;76;226;123;375
430675;201809;211;630;58;207;17;70;12;39;29;109
430676;201809;4100;10873;3175;9327;552;1726;1720;4977;2272;6703
430680;201809;954;2596;574;1814;159;501;143;439;302;940
430690;201809;3051;8619;2481;7550;812;2557;697;2084;1509;4641
430692;201809;198;634;156;565;14;46;108;404;122;450
430693;201809;1001;2661;568;1736;120;428;117;301;237;729
430695;201809;505;1258;301;870;38;113;166;459;204;572
430697;201809;386;1005;284;834;59;172;143;440;202;612
430700;201809;6761;17338;3653;11533;943;3204;368;1190;1311;4394
430705;201809;359;930;181;572;30;109;70;209;100;318
430710;201809;1664;3799;1175;3075;195;589;628;1598;823;2187
430720;201809;701;1719;374;1141;66;195;153;458;219;653
430730;201809;1150;3106;769;2384;127;389;374;1175;501;1564
430740;201809;581;1639;302;1010;50;182;90;317;140;499
430745;201809;447;1264;233;757;37;134;59;172;96;306
430750;201809;1316;3500;938;2842;192;617;508;1483;700;2100
430755;201809;464;1160;289;793;26;84;161;403;187;487
430760;201809;1932;5016;1481;4297;376;1126;649;1854;1025;2980
430770;201809;5938;15483;4508;13211;751;2479;2666;7521;3417;10000
430780;201809;1976;5102;1173;3705;250;803;366;1244;616;2047
430781;201809;378;1092;220;730;56;188;47;135;103;323
430783;201809;435;1039;247;723;23;76;137;389;160;465
430786;201809;40;139;24;94;5;21;2;9;7;30
430790;201809;4283;11194;2953;8680;494;1604;1547;4257;2041;5861
430800;201809;738;1902;544;1520;51;172;346;937;397;1109
430805;201809;454;1252;268;822;28;94;154;437;182;531
430807;201809;323;796;209;600;21;73;112;301;133;374
430810;201809;822;2049;265;865;44;161;70;205;114;366
430820;201809;1260;3439;675;2274;161;573;152;521;313;1094
430825;201809;284;742;90;254;20;58;20;45;40;103
430830;201809;1547;4685;1319;4254;86;332;914;2942;1000;3274
430840;201809;827;2355;705;2131;139;437;426;1285;565;1722
430843;201809;108;260;33;101;4;11;15;40;19;51
430845;201809;344;872;236;683;82;257;61;147;143;404
430850;201809;2186;6009;1658;4973;325;1050;787;2333;1112;3383
430860;201809;838;1918;421;1217;73;242;189;498;262;740
430865;201809;504;1336;420;1190;97;281;196;529;293;810
430870;201809;650;1742;287;914;44;150;93;261;137;411
430880;201809;1186;2899;789;2267;199;602;340;959;539;1561
430885;201809;217;520;95;310;8;34;52;160;60;194
430890;201809;1046;2839;702;2156;59;275;123;343;182;618
430900;201809;2909;6799;1967;5351;230;751;1158;2950;1388;3701
430905;201809;787;2124;499;1528;106;358;167;485;273;843
430910;201809;1349;3729;918;2831;180;633;384;1072;564;1705
430912;201809;475;1336;324;1048;37;117;206;679;243;796
430915;201809;499;1568;369;1320;96;358;129;481;225;839
430920;201809;21367;56240;16626;48498;2589;8295;9709;27602;12298;35897
430925;201809;135;302;48;139;10;31;18;55;28;86
430930;201809;9613;23262;5783;17213;1438;4615;1885;5842;3323;10457
430940;201809;1139;3324;628;2037;216;741;79;203;295;944
430950;201809;700;1769;440;1270;64;223;244;638;308;861
430955;201809;206;560;61;187;16;47;13;34;29;81
430957;201809;186;648;172;617;37;141;90;318;127;459
430960;201809;1241;2997;790;2219;161;505;404;1103;565;1608
430965;201809;1676;4191;1273;3539;81;263;960;2618;1041;2881
430970;201809;364;959;185;582;30;106;94;281;124;387
430975;201809;453;1460;357;1217;88;321;149;502;237;823
430980;201809;406;1003;222;670;42;132;86;250;128;382
430990;201809;538;1591;320;1031;47;166;158;503;205;669
430995;201809;570;1528;407;1234;63;195;201;595;264;790
431000;201809;1308;3127;537;1580;98;331;36;90;134;421
431010;201809;2043;5526;1195;3912;214;772;126;359;340;1131
431020;201809;8162;18721;5032;13717;1233;3653;1589;3951;2822;7604
431030;201809;316;896;145;514;32;118;25;92;57;210
431033;201809;2988;7959;1997;6351;515;1631;700;2439;1215;4070
431036;201809;351;772;71;209;11;25;14;39;25;64
431040;201809;916;2445;594;1819;95;344;264;750;359;1094
431041;201809;449;1078;345;919;36;100;222;572;258;672
431043;201809;410;1018;220;686;70;227;75;231;145;458
431046;201809;114;303;48;144;4;10;10;29;14;39
431050;201809;1426;3592;1022;2949;199;586;539;1560;738;2146
431053;201809;495;1439;320;1058;78;281;101;319;179;600
431055;201809;602;1528;518;1395;44;109;390;1036;434;1145
431057;201809;281;817;128;438;18;63;36;112;54;175
431060;201809;4709;13402;3566;11249;1088;3684;725;2416;1813;6100
431065;201809;483;1297;320;994;78;235;92;291;170;526
431070;201809;449;1341;253;860;73;274;38;113;111;387
431075;201809;215;661;145;494;28;99;42;146;70;245
431080;201809;598;1683;416;1312;97;333;124;377;221;710
431085;201809;672;1848;481;1400;79;216;265;763;344;979
431087;201809;453;1317;363;1114;26;78;254;797;280;875
431090;201809;405;968;144;466;31;112;37;112;68;224
431100;201809;3056;7254;2253;6136;401;1194;1053;2845;1454;4039
431110;201809;1335;3188;961;2546;239;649;443;1091;682;1740
431112;201809;505;1574;435;1429;91;313;213;677;304;990
431113;201809;355;1028;302;921;79;251;142;434;221;685
431115;201809;1093;3168;863;2736;145;503;483;1471;628;1974
431120;201809;2281;6666;1627;5297;580;2103;370;1107;950;3210
431123;201809;377;1085;237;785;56;169;118;411;174;580
431125;201809;1087;3294;800;2656;314;1026;222;790;536;1816
431127;201809;257;695;63;208;9;29;10;24;19;53
431130;201809;3008;8244;2116;6548;473;1585;859;2609;1332;4194
431140;201809;4792;11624;2667;7559;395;1275;1094;2709;1489;3984
431142;201809;480;1334;360;1122;52;160;224;704;276;864
431150;201809;989;2782;696;2187;154;505;273;841;427;1346
431160;201809;659;1902;482;1526;101;312;175;575;276;887
431162;201809;473;1168;210;662;30;117;64;181;94;298
431164;201809;203;477;41;135;12;43;3;12;15;55
431170;201809;529;1461;361;1122;103;307;96;300;199;607
431171;201809;615;1586;518;1450;69;194;340;945;409;1139
431173;201809;396;1101;295;921;101;346;89;268;190;614
431175;201809;982;2504;601;1812;157;472;124;388;281;860
431177;201809;674;2024;519;1755;153;551;232;776;385;1327
431179;201809;343;726;67;197;13;43;18;39;31;82
431180;201809;2104;5544;1290;3933;382;1184;240;729;622;1913
431190;201809;455;1238;237;757;33;101;49;134;82;235
431198;201809;286;918;253;849;94;330;76;275;170;605
431200;201809;377;997;91;298;11;27;1;6;12;33
431205;201809;187;547;83;299;20;72;36;131;56;203
431210;201809;608;1625;501;1461;134;374;245;747;379;1121
431213;201809;240;708;178;596;16;64;95;315;111;379
431215;201809;433;1138;223;696;28;99;92;259;120;358
431217;201809;149;433;101;337;11;40;54;167;65;207
431220;201809;614;1646;351;1105;33;128;178;510;211;638
431225;201809;1405;3581;1078;2994;129;385;668;1852;797;2237
431230;201809;678;2017;489;1512;76;261;280;820;356;1081
431235;201809;134;348;22;68;3;8;2;6;5;14
431237;201809;363;1105;288;959;52;196;153;492;205;688
431238;201809;22;58;18;48;4;9;6;15;10;24
431240;201809;3702;9814;2958;8585;684;2206;1316;3681;2000;5887
431242;201809;313;891;256;778;68;217;116;349;184;566
431244;201809;324;790;150;425;27;104;52;107;79;211
431245;201809;1273;3095;809;2230;113;339;389;1019;502;1358
431247;201809;218;609;106;346;18;65;26;77;44;142
431250;201809;1383;4033;1114;3598;260;805;525;1799;785;2604
431260;201809;215;615;116;413;19;85;41;133;60;218
431261;201809;247;789;196;685;21;77;95;308;116;385
431262;201809;391;1109;171;577;18;61;105;353;123;414
431265;201809;1452;3461;588;1718;94;319;178;424;272;743
431267;201809;255;722;147;448;6;24;100;274;106;298
431270;201809;2554;6112;1374;4034;374;1193;382;1115;756;2308
431275;201809;145;410;76;245;18;61;12;33;30;94
431280;201809;252;706;70;250;7;22;6;17;13;39
431290;201809;294;849;206;671;28;95;68;198;96;293
431295;201809;72;194;25;81;3;13;7;21;10;34
431300;201809;378;947;53;183;5;24;10;26;15;50
431301;201809;221;657;53;191;6;14;4;11;10;25
431303;201809;564;1527;325;999;40;147;116;327;156;474
431306;201809;2038;4950;1215;3525;195;656;459;1190;654;1846
431308;201809;25;85;22;75;12;44;6;19;18;63
431310;201809;553;1590;345;1093;58;194;137;428;195;622
431320;201809;593;1605;270;905;53;186;41;127;94;313
431330;201809;1682;4121;799;2466;227;774;186;515;413;1289
431333;201809;225;630;115;349;15;37;35;100;50;137
431335;201809;34;103;21;75;5;12;3;7;8;19
431337;201809;2516;6963;1750;5568;494;1737;538;1610;1032;3347
431339;201809;437;1135;305;877;71;204;154;449;225;653
431340;201809;19266;49276;13579;39402;2964;9339;4883;13408;7847;22747
431342;201809;453;1068;344;900;28;90;283;719;311;809
431344;201809;377;992;226;681;15;47;150;436;165;483
431346;201809;262;666;93;298;14;44;21;65;35;109
431349;201809;627;1711;352;1082;67;219;137;393;204;612
431350;201809;3685;10067;2753;8423;559;1840;1236;3759;1795;5599
431360;201809;581;1416;331;959;74;222;123;334;197;556
431365;201809;1691;4477;1424;4057;152;505;1043;2930;1195;3435
431370;201809;4008;10632;3021;8916;794;2504;1292;3901;2086;6405
431380;201809;738;2138;630;1948;54;186;403;1238;457;1424
431390;201809;2356;6041;1372;4136;245;851;511;1370;756;2221
431395;201809;1203;3315;877;2791;232;741;341;1135;573;1876
431400;201809;368;1089;186;606;29;98;48;147;77;245
431402;201809;894;2143;612;1656;98;291;368;947;466;1238
431403;201809;171;469;143;427;21;85;92;244;113;329
431405;201809;4202;11345;3380;10076;435;1525;2081;6007;2516;7532
431406;201809;440;1365;360;1211;92;291;186;645;278;936
431407;201809;437;1225;285;890;67;218;123;370;190;588
431410;201809;14238;38413;9145;28586;1878;6605;3496;10279;5374;16884
431413;201809;176;452;52;170;6;18;8;27;14;45
431415;201809;668;1727;405;1281;66;252;160;454;226;706
431417;201809;571;1326;389;1041;72;205;203;519;275;724
431420;201809;1302;3310;1056;2928;217;613;459;1334;676;1947
431430;201809;514;1343;260;814;52;176;57;152;109;328
431440;201809;22893;58065;17078;48353;3932;11787;5832;16349;9764;28136
431442;201809;89;257;47;161;7;25;7;16;14;41
431445;201809;434;1235;143;490;23;71;18;59;41;130
431446;201809;323;932;214;695;62;208;73;226;135;434
431447;201809;602;1676;405;1258;91;285;161;504;252;789
431449;201809;703;1906;433;1282;69;203;189;548;258;751
431450;201809;2048;4511;1694;4028;128;335;1287;2942;1415;3277
431454;201809;40;128;38;124;6;23;15;57;21;80
431455;201809;601;1485;300;841;42;137;147;362;189;499
431460;201809;2835;7401;2137;6075;593;1746;654;1920;1247;3666
431470;201809;1455;4177;1062;3351;214;692;454;1418;668;2110
431475;201809;244;707;30;120;2;9;2;10;4;19
431477;201809;437;1142;277;816;41;117;136;369;177;486
431478;201809;241;618;59;184;19;61;4;11;23;72
431480;201809;3014;7780;2345;6723;385;1170;1365;3886;1750;5056
431490;201809;94915;240578;78484;215078;7610;23941;57295;152672;64905;176613
431500;201809;485;1286;355;1023;74;196;179;501;253;697
431505;201809;385;942;247;712;28;79;145;416;173;495
431507;201809;349;835;148;420;36;119;53;128;89;247
431510;201809;1467;4002;1052;3163;244;775;409;1233;653;2008
431513;201809;255;603;131;368;16;42;93;267;109;309
431514;201809;84;232;45;154;11;42;18;57;29;99
431515;201809;508;1335;339;1001;74;242;167;457;241;699
431517;201809;69;201;54;164;12;33;18;56;30;89
431520;201809;429;1057;159;520;32;113;53;150;85;263
431530;201809;3781;8493;2312;6335;683;1902;378;1068;1061;2970
431531;201809;190;532;127;395;15;46;56;169;71;215
431532;201809;457;1187;319;915;77;230;137;392;214;622
431535;201809;271;695;101;323;22;79;21;57;43;136
431540;201809;1708;5684;1602;5501;82;322;1285;4414;1367;4736
431545;201809;365;969;71;224;5;19;19;52;24;71
431550;201809;1877;5149;1535;4470;311;960;703;1993;1014;2953
431555;201809;675;1579;422;1141;32;100;251;666;283;766
431560;201809;19166;50715;12877;40154;2955;9834;3652;12238;6607;22072
431570;201809;4576;11453;3669;10178;606;1868;2267;6108;2873;7976
431575;201809;183;548;137;443;25;74;25;69;50;143
431580;201809;534;1433;287;909;47;179;123;358;170;537
431590;201809;696;1888;499;1477;96;287;197;591;293;878
431595;201809;327;947;223;712;44;139;93;287;137;426
431600;201809;1327;3400;984;2856;285;894;356;1037;641;1931
431610;201809;1295;3558;909;2754;134;386;450;1411;584;1797
431620;201809;552;1516;234;714;47;150;105;296;152;446
431630;201809;1189;3172;572;1818;149;498;173;485;322;983
431640;201809;5763;15296;5181;14444;673;1936;3682;10332;4355;12268
431642;201809;462;1194;296;849;34;87;150;416;184;503
431643;201809;323;818;143;415;20;59;47;129;67;188
431645;201809;1651;4188;1329;3672;140;427;936;2581;1076;3008
431647;201809;193;491;101;291;14;47;25;60;39;107
431650;201809;170;501;122;400;25;91;40;122;65;213
431660;201809;828;2249;452;1478;85;312;101;284;186;596
431670;201809;1107;2750;760;2129;131;406;387;1026;518;1432
431673;201809;243;653;89;325;18;60;13;41;31;101
431675;201809;546;1380;127;416;11;44;38;108;49;152
431680;201809;7123;19313;5329;15796;1484;4581;1958;5798;3442;10379
431690;201809;18957;50208;13568;40136;3560;11062;4611;13984;8171;25046
431695;201809;151;389;94;282;19;66;41;94;60;160
431697;201809;454;1132;361;976;59;159;208;575;267;734
431700;201809;1373;3690;1174;3324;179;494;680;1912;859;2406
431710;201809;10939;29130;8415;25246;2130;6630;3381;10753;5511;17383
431720;201809;5649;15049;3669;11000;1024;3248;614;1696;1638;4944
431725;201809;26;76;18;58;4;13;5;15;9;28
431730;201809;3406;8968;2320;7085;634;2100;724;2311;1358;4411
431740;201809;4629;11843;3217;9341;990;3209;639;1601;1629;4810
431750;201809;6777;18737;5795;17183;1093;3503;3121;9371;4214;12874
431755;201809;319;864;62;219;11;43;13;47;24;90
431760;201809;5331;12519;3440;9422;401;1335;2051;5245;2452;6580
431770;201809;1729;4372;1402;3896;148;459;999;2715;1147;3174
431775;201809;204;549;97;306;25;90;17;41;42;131
431780;201809;1812;4779;1244;3687;256;811;442;1272;698;2083
431790;201809;886;2478;646;1986;137;427;267;792;404;1219
431795;201809;250;659;121;363;27;82;32;94;59;176
431800;201809;6945;18841;5030;15443;1636;5531;657;2106;2293;7637
431805;201809;287;667;89;285;7;26;35;99;42;125
431810;201809;3205;7938;2030;5701;380;1202;838;2194;1218;3396
431820;201809;2088;6083;1753;5482;451;1462;722;2298;1173;3760
431830;201809;8452;19848;6491;16939;1635;4755;2492;6493;4127;11248
431840;201809;2369;6706;1968;6001;394;1258;1108;3371;1502;4629
431842;201809;684;1707;230;711;33;111;70;198;103;309
431843;201809;310;858;245;721;37;118;115;318;152;436
431844;201809;221;575;65;215;17;66;17;45;34;111
431845;201809;500;1341;346;1019;26;84;214;621;240;705
431846;201809;244;713;218;673;20;69;177;535;197;604
431848;201809;152;388;77;240;10;35;13;28;23;63
431849;201809;408;978;58;171;7;17;7;16;14;33
431850;201809;3837;10834;3049;9187;754;2456;950;2777;1704;5233
431860;201809;657;1706;410;1197;87;262;204;565;291;827
431861;201809;115;305;51;160;9;30;18;51;27;81
431862;201809;419;1353;342;1212;86;332;167;574;253;906
431870;201809;16514;45432;13473;40139;2321;7842;7059;20219;9380;28061
431880;201809;3539;9708;2738;8262;538;1826;1193;3444;1731;5270
431890;201809;3972;10614;2530;7699;823;2691;366;1213;1189;3904
431900;201809;991;2628;609;1860;122;426;294;839;416;1265
431910;201809;777;1926;292;868;51;149;83;214;134;363
431912;201809;425;1238;346;1079;78;249;194;600;272;849
431915;201809;924;2524;756;2228;71;224;530;1529;601;1753
431920;201809;1140;2940;968;2672;51;154;823;2248;874;2402
431930;201809;737;2191;543;1831;125;368;294;1059;419;1427
431935;201809;74;209;47;151;13;44;10;27;23;71
431936;201809;288;872;166;570;40;141;38;129;78;270
431937;201809;174;437;104;290;27;90;37;82;64;172
431940;201809;2400;6091;1476;4301;264;878;623;1706;887;2584
431950;201809;1658;4637;1390;4191;360;1105;630;1906;990;3011
431960;201809;2586;6805;2024;5735;592;1744;566;1608;1158;3352
431970;201809;367;966;154;498;37;110;33;94;70;204
431971;201809;62;153;35;107;3;8;6;15;9;23
431973;201809;455;1489;369;1313;40;139;261;942;301;1081
431975;201809;101;215;21;68;4;14;3;6;7;20
431980;201809;1044;2860;805;2429;190;624;355;1024;545;1648
431990;201809;5609;14239;3647;11171;653;2202;1348;4031;2001;6233
432000;201809;9795;25220;7368;21230;2008;6001;3132;9095;5140;15096
432010;201809;1865;5010;1445;4241;228;718;807;2275;1035;2993
432020;201809;1787;4500;1258;3569;318;970;551;1467;869;2437
432023;201809;494;1240;258;760;44;146;125;332;169;478
432026;201809;984;2897;725;2359;166;542;329;1054;495;1596
432030;201809;333;893;200;614;38;123;105;314;143;437
432032;201809;396;1054;267;795;31;108;142;388;173;496
432035;201809;719;2123;643;1994;219;706;236;736;455;1442
432040;201809;1042;2466;384;1222;79;283;117;332;196;615
432045;201809;195;555;106;366;28;96;30;113;58;209
432050;201809;495;1332;381;1114;116;337;116;345;232;682
432055;201809;689;1867;451;1399;139;469;150;438;289;907
432057;201809;256;662;195;530;46;107;83;213;129;320
432060;201809;433;1052;135;437;26;101;52;142;78;243
432065;201809;222;626;157;479;32;96;60;184;92;280
432067;201809;730;2199;604;1891;87;281;378;1153;465;1434
432070;201809;1819;4926;1125;3487;266;886;261;723;527;1609
432080;201809;3644;9531;2909;8284;738;2344;1167;3205;1905;5549
432085;201809;386;1011;246;785;88;267;83;292;171;559
432090;201809;1246;3389;903;2724;212;687;382;1094;594;1781
432100;201809;1003;2744;439;1455;91;318;46;119;137;437
432110;201809;2097;5933;1402;4570;364;1365;97;324;461;1689
432120;201809;2726;7963;2244;7080;712;2412;552;1698;1264;4110
432130;201809;2472;6660;2095;6126;744;2280;787;2333;1531;4613
432132;201809;236;642;120;399;24;85;40;118;64;203
432135;201809;884;2296;598;1732;61;203;414;1164;475;1367
432140;201809;1532;4812;1161;4060;220;788;604;2154;824;2942
432143;201809;1292;3591;1017;3142;108;394;632;1934;740;2328
432145;201809;1259;3516;733;2335;135;473;170;475;305;948
432146;201809;102;300;68;225;20;73;17;50;37;123
432147;201809;420;1317;294;1033;88;318;59;200;147;518
432149;201809;365;982;214;636;26;82;99;279;125;361
432150;201809;2798;7710;2086;6338;530;1824;635;1865;1165;3689
432160;201809;4387;12675;3466;11118;1042;3559;1089;3497;2131;7056
432162;201809;276;627;34;100;5;12;5;15;10;27
432163;201809;159;439;31;100;1;3;2;5;3;8
432166;201809;508;1515;397;1274;72;243;133;387;205;630
432170;201809;1244;3530;811;2680;196;720;227;699;423;1419
432180;201809;2525;6504;1346;4107;272;891;393;1071;665;1962
432183;201809;344;1043;224;745;64;239;59;186;123;425
432185;201809;802;2154;476;1487;37;136;272;801;309;937
432190;201809;1971;5109;1276;3782;318;1073;473;1271;791;2344
432195;201809;939;2384;601;1774;192;529;216;671;408;1200
432200;201809;2917;8124;2124;6680;448;1445;1005;3224;1453;4669
432210;201809;354;978;235;755;50;183;100;301;150;484
432215;201809;627;1918;563;1815;61;182;400;1313;461;1495
432218;201809;248;634;124;348;17;52;54;136;71;188
432220;201809;3732;9220;2791;7644;409;1283;1677;4382;2086;5665
432225;201809;91;278;68;228;18;57;30;103;48;160
432230;201809;674;1734;384;1141;63;201;166;451;229;652
432232;201809;472;1216;325;946;68;210;125;358;193;568
432234;201809;299;787;129;393;30;87;23;59;53;146
432235;201809;91;250;31;98;5;16;9;30;14;46
432237;201809;354;918;310;841;17;52;230;590;247;642
432240;201809;13254;36921;10389;32704;959;3437;6423;21068;7382;24505
432250;201809;4000;13063;3484;12034;1110;3969;1265;4485;2375;8454
432252;201809;430;1131;273;797;51;163;108;291;159;454
432253;201809;1072;3352;589;2070;148;573;34;106;182;679
432254;201809;871;2181;167;540;33;121;16;43;49;164
432255;201809;136;357;67;212;8;28;27;74;35;102
432260;201809;4973;13040;3652;10607;1016;3043;1106;3236;2122;6279
432270;201809;1873;5587;1545;4911;533;1801;261;811;794;2612
432280;201809;1097;2863;594;1829;100;334;219;623;319;957
432285;201809;186;582;17;60;0;0;2;5;2;5
432290;201809;353;1053;195;665;63;212;47;134;110;346
432300;201809;24287;65429;19080;56827;3039;10010;11324;32773;14363;42783
432310;201809;714;2024;531;1689;76;259;331;1035;407;1294
432320;201809;220;530;68;203;7;28;23;59;30;87
432330;201809;237;616;87;286;21;68;17;55;38;123
432335;201809;169;483;58;218;11;43;13;51;24;94
432340;201809;311;752;136;419;26;96;42;105;68;201
432345;201809;563;1421;515;1358;37;133;404;1024;441;1157
432350;201809;330;900;165;550;29;97;52;165;81;262
432360;201809;209;620;38;127;5;24;7;22;12;46
432370;201809;307;804;206;612;20;59;126;367;146;426
432375;201809;504;1303;389;1093;60;153;223;623;283;776
432377;201809;230;732;35;123;6;19;5;9;11;28
432380;201809;1441;4186;909;3050;187;714;415;1313;602;2027
500020;201809;2118;5798;1521;4732;338;1154;682;2080;1020;3234
500025;201809;1227;2829;767;2048;72;204;465;1224;537;1428
500060;201809;6076;17841;4641;15284;708;2398;2732;9441;3440;11839
500070;201809;3718;10158;2752;8491;592;1878;1236;3987;1828;5865
500080;201809;1149;3181;839;2626;191;677;361;1051;552;1728
500085;201809;1932;4852;1318;3894;276;900;676;1928;952;2828
500090;201809;1816;5109;1255;4058;241;803;501;1674;742;2477
500100;201809;3286;8677;2518;7400;374;1229;1306;3670;1680;4899
500110;201809;6682;18700;4534;15154;1006;3596;1515;5784;2521;9380
500124;201809;1877;5942;1595;5458;344;1153;868;3154;1212;4307
500150;201809;1147;2713;723;2033;175;532;248;649;423;1181
500190;201809;4196;10332;3070;8819;680;2042;1356;4066;2036;6108
500200;201809;2074;5096;1556;4225;203;607;940;2403;1143;3010
500210;201809;4342;11978;3335;10464;893;2859;1448;4628;2341;7487
500215;201809;1337;3845;935;3067;94;346;481;1537;575;1883
500220;201809;2583;7436;1877;6170;330;1183;741;2419;1071;3602
500230;201809;2041;5057;1521;4272;209;609;937;2584;1146;3193
500240;201809;3269;10406;2317;8320;446;1831;636;2355;1082;4186
500260;201809;3029;6725;1836;5006;242;658;932;2482;1174;3140
500270;201809;123627;302264;72197;210416;15084;47690;22856;63654;37940;111344
500280;201809;1219;3191;879;2656;114;388;534;1559;648;1947
500290;201809;3565;8306;1962;5800;353;1153;704;1953;1057;3106
500295;201809;2790;7151;1610;4854;294;994;586;1548;880;2542
500310;201809;865;2015;627;1700;114;271;331;935;445;1206
500315;201809;3198;9622;2637;8689;332;1092;1738;5960;2070;7052
500320;201809;16986;50378;12288;41981;3374;12267;3923;14244;7297;26511
500325;201809;3952;9373;2676;7455;326;964;1514;4223;1840;5187
500330;201809;6561;15650;4206;11881;387;1254;2302;6632;2689;7886
500345;201809;1838;4615;1235;3682;333;1032;425;1252;758;2284
500348;201809;2540;6597;1972;5658;257;773;1183;3441;1440;4214
500350;201809;1241;3493;649;2133;77;279;245;811;322;1090
500370;201809;20627;57137;14425;46283;2537;9178;6651;21331;9188;30509
500375;201809;2312;6420;1623;4953;355;1201;541;1594;896;2795
500380;201809;3402;8588;2369;6924;665;2028;860;2558;1525;4586
500390;201809;489;1058;293;791;44;124;158;421;202;545
500400;201809;1084;3009;737;2265;181;622;235;672;416;1294
500410;201809;2234;5988;1701;5130;243;735;996;3075;1239;3810
500430;201809;2433;6366;1650;5133;282;983;652;2129;934;3112
500440;201809;1165;2821;699;2040;117;348;265;815;382;1163
500450;201809;1257;3268;707;2222;155;505;125;362;280;867
500460;201809;3336;9424;2133;7035;454;1661;559;1902;1013;3563
500470;201809;2358;6613;1472;4724;471;1652;298;844;769;2496
500480;201809;2106;6310;1840;5941;164;544;1339;4577;1503;5121
500490;201809;874;2201;524;1653;146;526;159;509;305;1035
500500;201809;3953;11055;2732;9141;914;3504;642;2195;1556;5699
500510;201809;677;1728;421;1247;23;75;254;726;277;801
500515;201809;1837;4693;1501;4202;129;354;1068;3028;1197;3382
500520;201809;3023;10205;2471;9083;694;2701;1008;3744;1702;6445
500525;201809;885;2713;732;2465;95;356;429;1467;524;1823
500540;201809;4280;11448;2523;8221;741;2867;245;723;986;3590
500560;201809;4991;14963;4181;13798;329;1192;3155;10519;3484;11711
500568;201809;4009;9152;2472;6863;652;2027;742;2055;1394;4082
500570;201809;6841;16838;3897;11546;943;3027;944;2636;1887;5663
500580;201809;3037;8437;2372;7285;483;1551;1228;3761;1711;5312
500600;201809;3071;7844;2067;6248;419;1338;816;2490;1235;3828
500620;201809;7110;19692;4857;15230;1013;3307;1959;6106;2972;9413
500625;201809;490;1391;264;867;54;198;102;312;156;510
500627;201809;721;1897;444;1369;77;240;122;384;199;624
500630;201809;5646;14149;3477;10433;819;2635;1056;3234;1875;5869
500635;201809;2542;8727;2061;8009;148;616;1510;6207;1658;6823
500640;201809;1678;3887;1090;3001;45;156;773;2036;818;2192
500660;201809;15825;45243;11375;37939;4052;14936;2553;8760;6605;23696
500690;201809;2200;6345;1554;5264;697;2611;98;283;795;2894
500710;201809;2794;8047;2158;6839;639;2114;584;1797;1223;3911
500720;201809;4682;12388;2962;9431;816;2855;685;2190;1501;5045
500730;201809;884;2393;573;1789;103;307;223;713;326;1020
500740;201809;4416;10985;3207;8936;339;1069;1806;5068;2145;6137
500750;201809;952;2514;680;2023;107;337;272;741;379;1078
500755;201809;857;2395;518;1721;114;384;79;240;193;624
500769;201809;4743;12170;2487;7618;524;1795;372;863;896;2658
500770;201809;1480;4112;926;3051;170;591;295;992;465;1583
500780;201809;1201;3091;791;2349;191;603;207;584;398;1187
500790;201809;7730;20714;6266;18360;1227;3892;3399;10009;4626;13901
500793;201809;1784;4798;1249;3877;407;1299;266;729;673;2028
500795;201809;2364;6484;1966;5946;157;441;1599;5033;1756;5474
500797;201809;681;1854;461;1421;104;322;174;526;278;848
500800;201809;2684;6626;1800;5286;633;2096;300;969;933;3065
500830;201809;16831;43213;11571;33567;1878;5955;5548;15379;7426;21334
500840;201809;1069;2865;712;2177;97;310;292;847;389;1157
510010;201809;1758;4279;1184;3473;194;563;678;2014;872;2577
510020;201809;3542;9288;1886;5865;450;1470;355;985;805;2455
510025;201809;6441;17347;4061;12866;778;2760;1332;4002;2110;6762
510030;201809;2053;4767;1383;3810;354;988;503;1460;857;2448
510035;201809;1149;3010;691;2264;109;352;396;1385;505;1737
510040;201809;2120;5020;1534;4189;137;389;986;2686;1123;3075
510050;201809;1852;4541;1258;3601;233;760;736;1968;969;2728
510060;201809;1317;3464;985;2941;170;556;465;1345;635;1901
510080;201809;1151;3262;782;2576;235;830;216;624;451;1454
510100;201809;645;1578;417;1175;55;168;213;570;268;738
510120;201809;255;495;152;371;9;29;113;271;122;300
510125;201809;2190;5542;1674;4745;258;954;738;1907;996;2861
510130;201809;1375;3667;1018;3066;257;835;296;887;553;1722
510140;201809;2810;7870;1993;6775;735;2814;683;2192;1418;5006
510160;201809;1313;3946;1101;3660;201;678;747;2501;948;3179
510170;201809;4452;12490;3338;10606;800;2680;1446;4576;2246;7256
510180;201809;12494;30563;7746;22781;2006;6284;2314;7692;4320;13976
510185;201809;1695;4517;1129;3693;397;1281;401;1607;798;2888
510190;201809;2092;5932;1433;4850;468;1714;390;1382;858;3096
510250;201809;13602;37470;11334;34278;2416;7664;6328;19787;8744;27451
510260;201809;2059;8494;1673;7750;274;1297;972;5017;1246;6314
510263;201809;2993;8530;1867;6228;413;1476;251;787;664;2263
510267;201809;4568;13354;2878;9609;680;2372;517;1770;1197;4142
510268;201809;1388;3580;926;2729;135;406;474;1337;609;1743
510269;201809;1045;2995;663;2242;180;649;220;710;400;1359
510270;201809;2725;8411;2032;7111;421;1572;777;2694;1198;4266
510279;201809;1677;4735;1206;3855;241;847;608;1863;849;2710
510285;201809;1089;3008;771;2459;225;788;201;611;426;1399
510300;201809;3420;9004;2612;7895;349;995;1636;5201;1985;6196
510305;201809;1314;3921;892;3073;192;708;269;995;461;1703
510310;201809;889;2355;638;1928;210;658;192;613;402;1271
510320;201809;3579;9473;2643;7819;643;2084;755;2224;1398;4308
510325;201809;4504;13654;3550;12123;1011;3556;1490;5316;2501;8872
510330;201809;2876;8859;1990;7234;428;1609;710;2865;1138;4474
510335;201809;4615;13519;3464;11858;462;1729;2001;7183;2463;8912
510336;201809;474;1395;340;1154;66;205;166;607;232;812
510337;201809;1593;4880;1085;3937;448;1762;186;696;634;2458
510340;201809;81631;191330;49789;142474;15023;49749;11865;31956;26888;81705
510343;201809;959;2784;669;2209;139;498;233;732;372;1230
510345;201809;1252;3716;939;3087;183;598;392;1238;575;1836
510350;201809;2796;7561;1827;5928;442;1481;738;2415;1180;3896
510360;201809;1772;3948;1149;3173;61;205;856;2399;917;2604
510370;201809;1615;4972;1185;4181;206;803;626;2259;832;3062
510380;201809;476;1271;253;831;81;296;40;127;121;423
510385;201809;1023;3703;749;3109;93;431;450;1980;543;2411
510390;201809;1024;3191;807;2872;221;769;380;1495;601;2264
510395;201809;719;1667;475;1303;40;110;259;765;299;875
510410;201809;4106;12245;3145;10453;773;2646;1553;5381;2326;8027
510420;201809;2057;4744;1470;3908;154;471;880;2331;1034;2802
510450;201809;512;1322;301;923;80;248;51;171;131;419
510452;201809;653;1897;438;1462;88;302;211;707;299;1009
510454;201809;771;2283;579;1938;57;179;356;1264;413;1443
510455;201809;864;2558;622;2020;94;365;235;688;329;1053
510460;201809;1895;4813;1356;4008;142;493;823;2335;965;2828
510480;201809;4255;10843;2817;8002;565;1706;1166;3152;1731;4858
510490;201809;1587;4604;1209;4058;270;915;595;2054;865;2969
510500;201809;1450;3939;889;2899;165;592;345;1104;510;1696
510510;201809;3138;9863;2408;8386;775;2945;595;2226;1370;5171
510515;201809;5417;14828;3488;11041;824;2881;932;2706;1756;5587
510517;201809;1148;3372;893;2921;258;947;172;507;430;1454
510520;201809;1961;4167;1210;3236;77;224;696;1961;773;2185
510523;201809;937;2548;721;2175;122;348;426;1297;548;1645
510525;201809;5443;15771;4140;13114;738;2593;1797;5226;2535;7819
510530;201809;539;1383;397;1173;27;110;274;771;301;881
510550;201809;2597;7994;1892;6675;488;1785;719;2597;1207;4382
510558;201809;1957;5457;1550;4875;166;575;834;2804;1000;3379
510560;201809;1560;4613;905;3332;217;886;230;910;447;1796
510562;201809;4856;13326;3573;10963;860;2842;1392;4367;2252;7209
510590;201809;2924;7644;2140;6614;344;1052;1330;4241;1674;5293
510600;201809;1519;3614;950;2712;204;575;376;1110;580;1685
510610;201809;2447;6341;1768;5392;171;608;1125;3397;1296;4005
510615;201809;1927;5495;1442;4622;275;891;811;2663;1086;3554
510617;201809;916;2683;691;2311;106;368;425;1495;531;1863
510618;201809;1259;3486;885;2797;185;669;446;1341;631;2010
510619;201809;704;1867;390;1286;69;258;75;233;144;491
510620;201809;1408;3266;667;2080;163;588;78;204;241;792
510621;201809;1246;3559;822;2733;180;645;248;807;428;1452
510622;201809;3777;11160;2672;8625;995;3482;446;1306;1441;4788
510623;201809;2652;7032;1922;5799;442;1582;572;1666;1014;3248
510624;201809;1541;4170;687;2383;97;371;125;367;222;738
510625;201809;2331;5909;1348;4119;316;1098;283;849;599;1947
510626;201809;1592;3824;942;2833;289;982;213;665;502;1647
510627;201809;638;1660;368;1116;96;302;81;261;177;563
510628;201809;1545;3547;1018;2846;178;483;620;1822;798;2305
510629;201809;1501;4581;1151;3867;289;1034;381;1309;670;2343
510630;201809;3125;9239;1875;6696;451;1761;297;1149;748;2910
510631;201809;482;1252;351;1054;19;61;251;759;270;820
510637;201809;3117;8033;2321;6733;704;2263;662;1865;1366;4128
510642;201809;4871;14928;3922;13455;1105;4075;1582;5632;2687;9707
510645;201809;843;1886;497;1412;145;413;161;449;306;862
510650;201809;6473;18575;5455;17426;741;2201;4025;13553;4766;15754
510665;201809;1758;4220;1027;2940;187;575;403;1203;590;1778
510670;201809;392;835;213;575;28;93;114;302;142;395
510675;201809;5607;16411;4119;13551;1262;4526;743;2414;2005;6940
510677;201809;2073;5526;1468;4590;224;759;767;2375;991;3134
510680;201809;606;1697;380;1253;100;354;54;167;154;521
510682;201809;1570;4997;1174;4259;382;1490;266;993;648;2483
510685;201809;680;1994;512;1657;75;251;243;766;318;1017
510700;201809;3466;9146;2436;7578;436;1412;1423;4495;1859;5907
510704;201809;9393;23595;6240;17962;1276;3982;1924;5367;3200;9349
510706;201809;1785;5478;1262;4615;234;922;663;2567;897;3489
510710;201809;2442;6569;1699;5095;369;1160;616;1759;985;2919
510715;201809;664;1549;466;1244;53;142;209;579;262;721
510718;201809;2473;5463;1337;4088;576;1798;237;988;813;2786
510719;201809;390;854;237;649;39;114;127;337;166;451
510720;201809;946;2388;632;1879;163;509;205;586;368;1095
510724;201809;658;1833;457;1480;89;324;217;660;306;984
510726;201809;1070;1999;574;1364;67;169;329;786;396;955
510729;201809;623;1526;295;899;46;162;68;206;114;368
510730;201809;2907;7381;1968;5844;436;1394;780;2299;1216;3693
510735;201809;986;2993;748;2646;82;318;521;1866;603;2184
510740;201809;1166;3204;830;2588;84;229;532;1784;616;2013
510757;201809;577;1881;470;1690;186;717;146;498;332;1215
510760;201809;35816;82001;21211;59671;5856;18701;5329;13791;11185;32492
510770;201809;4024;9570;2938;8230;310;836;1994;5828;2304;6664
510774;201809;346;972;246;762;41;129;124;409;165;538
510775;201809;579;1654;407;1363;100;380;96;298;196;678
510776;201809;454;1241;317;952;86;261;100;303;186;564
510777;201809;1609;4486;1187;3902;135;519;826;2698;961;3217
510779;201809;569;1630;451;1431;67;177;270;908;337;1085
510780;201809;3566;9791;2680;8433;707;2256;1083;3748;1790;6004
510785;201809;2016;5409;1161;3811;288;1037;175;618;463;1655
510787;201809;2351;6739;1634;5300;722;2433;119;369;841;2802
510788;201809;697;1678;477;1339;83;223;182;616;265;839
510790;201809;14108;38701;8736;28078;2145;7863;1337;3746;3482;11609
510792;201809;8177;22433;5241;16868;1112;3896;1267;3960;2379;7856
510794;201809;1189;3358;774;2571;252;927;157;461;409;1388
510795;201809;6761;19254;4828;15687;1319;4683;1198;3923;2517;8606
510800;201809;1546;4065;1079;3322;267;844;360;1071;627;1915
510805;201809;1663;4606;1095;3532;241;835;393;1141;634;1976
510810;201809;644;1415;425;1114;111;315;202;515;313;830
510820;201809;786;1543;425;1079;50;159;192;477;242;636
510830;201809;748;1934;532;1620;90;271;314;1008;404;1279
510835;201809;536;1413;361;1124;53;182;181;549;234;731
510840;201809;43647;101229;31819;86238;6319;16726;16852;49054;23171;65780
510850;201809;1757;4427;1005;3168;334;1181;121;307;455;1488
510860;201809;2560;7184;1660;5588;563;2168;182;593;745;2761
510880;201809;632;1882;487;1616;120;415;220;752;340;1167
510885;201809;561;1471;390;1212;69;236;129;398;198;634
510890;201809;636;1936;511;1750;111;407;255;893;366;1300
510895;201809;1164;3119;787;2460;211;744;286;815;497;1559
520005;201809;1992;5534;1606;5042;417;1194;770;2772;1187;3966
520010;201809;2196;6665;1555;5290;441;1649;346;1059;787;2708
520013;201809;2564;7014;1847;5594;464;1477;487;1574;951;3051
520015;201809;532;1394;401;1212;115;365;119;396;234;761
520017;201809;1066;2931;815;2520;145;486;459;1387;604;1873
520020;201809;369;926;293;818;62;204;163;428;225;632
520025;201809;31710;90987;27923;85835;3393;11193;19765;60600;23158;71793
520030;201809;4948;13726;4010;12272;522;1730;2474;7553;2996;9283
520050;201809;428;1020;265;727;20;46;152;438;172;484
520055;201809;1124;3052;831;2471;61;180;484;1417;545;1597
520060;201809;1388;4087;1079;3499;278;1005;297;945;575;1950
520080;201809;1799;4813;1389;4242;241;723;672;2244;913;2967
520082;201809;1020;2565;846;2265;109;244;468;1326;577;1570
520085;201809;693;1995;549;1748;129;411;186;558;315;969
520090;201809;795;1704;578;1454;95;205;389;1030;484;1235
520110;201809;36945;103744;26428;86379;9347;34297;1830;5501;11177;39798
520120;201809;190;485;107;339;14;52;34;109;48;161
520130;201809;3601;9428;2995;8423;581;1718;1427;4054;2008;5772
520140;201809;34933;101492;26484;86273;9982;35216;2966;10041;12948;45257
520145;201809;484;1219;341;998;73;231;134;366;207;597
520150;201809;546;1362;423;1199;77;216;234;684;311;900
520160;201809;803;1950;584;1613;97;269;292;813;389;1082
520170;201809;4925;10355;3539;8770;224;585;2829;6971;3053;7556
520180;201809;1888;5436;1570;4917;415;1392;650;2024;1065;3416
520215;201809;1921;4723;1396;3887;320;975;582;1553;902;2528
520235;201809;601;1458;389;1124;43;133;156;435;199;568
520250;201809;1434;3788;1031;3164;292;989;207;668;499;1657
520260;201809;833;1992;503;1408;102;305;190;537;292;842
520280;201809;615;1650;486;1410;140;403;189;587;329;990
520310;201809;1226;2828;819;2204;201;570;311;883;512;1453
520320;201809;1723;4884;1361;4282;151;515;734;2326;885;2841
520330;201809;3355;9726;2425;8093;483;1832;1011;3313;1494;5145
520340;201809;2177;5109;1484;4114;149;367;969;2785;1118;3152
520350;201809;2795;7154;2059;5928;671;2051;656;1843;1327;3894
520355;201809;1761;4937;1339;4124;310;1050;519;1534;829;2584
520357;201809;789;2001;613;1717;33;97;450;1274;483;1371
520360;201809;694;1881;531;1598;163;508;140;447;303;955
520380;201809;1293;3344;768;2301;93;323;392;1091;485;1414
520390;201809;903;2071;527;1574;175;552;141;450;316;1002
520393;201809;523;1256;363;996;42;130;178;452;220;582
520396;201809;799;2228;668;1983;73;217;426;1240;499;1457
520400;201809;1514;4008;1230;3604;221;684;778;2289;999;2973
520410;201809;1600;3559;1007;2720;122;349;585;1557;707;1906
520420;201809;377;935;283;747;28;80;195;483;223;563
520425;201809;1355;3311;907;2573;246;715;336;971;582;1686
520430;201809;2143;5148;1141;3482;203;736;47;132;250;868
520440;201809;3132;7727;1976;5675;508;1565;523;1443;1031;3008
520450;201809;10820;27287;7161;21265;2443;7848;693;2159;3136;10007
520455;201809;649;1832;478;1557;147;518;128;412;275;930
520460;201809;890;2392;763;2212;103;272;579;1721;682;1993
520465;201809;810;2178;664;1947;103;328;423;1187;526;1515
520470;201809;1858;5439;1588;5066;363;1153;891;3012;1254;4165
520480;201809;816;2376;554;1891;160;579;116;418;276;997
520485;201809;1548;4369;1277;3991;206;665;817;2533;1023;3198
520490;201809;3750;10896;2972;9687;886;2866;1322;4528;2208;7394
520495;201809;1434;3383;1131;2972;59;166;874;2332;933;2498
520500;201809;1411;3811;995;3050;226;776;370;1114;596;1890
520505;201809;709;1737;506;1453;102;296;264;753;366;1049
520510;201809;6684;17774;4728;14781;1164;4025;1267;4235;2431;8260
520520;201809;1094;2885;823;2454;221;658;250;797;471;1455
520530;201809;1953;5985;1458;5091;524;1885;386;1533;910;3418
520540;201809;2871;7695;1763;5432;399;1279;386;1189;785;2468
520545;201809;876;2414;671;2075;127;407;260;812;387;1219
520547;201809;704;2048;552;1751;151;483;242;769;393;1252
520549;201809;11211;32123;9243;28881;2012;6497;4943;15518;6955;22015
520551;201809;4182;11916;3572;11013;486;1748;2411;7256;2897;9004
520552;201809;782;2195;698;2085;106;298;492;1533;598;1831
520570;201809;607;1467;401;1161;106;299;135;416;241;715
520580;201809;2743;6244;1935;5226;177;499;1271;3449;1448;3948
520590;201809;1245;3427;882;2753;246;768;148;476;394;1244
520620;201809;8072;22435;6500;20125;1679;5347;3004;9521;4683;14868
520630;201809;916;2319;556;1695;104;323;148;443;252;766
520640;201809;2482;6312;1890;5293;494;1403;736;2140;1230;3543
520650;201809;905;2240;624;1776;114;321;309;913;423;1234
520660;201809;523;1264;245;752;47;153;50;167;97;320
520670;201809;944;2684;788;2455;82;262;518;1571;600;1833
520680;201809;704;1798;526;1518;103;290;257;763;360;1053
520690;201809;375;888;245;699;77;211;77;237;154;448
520710;201809;510;1262;340;964;11;34;221;608;232;642
520725;201809;1584;3864;1120;3093;135;416;715;1915;850;2331
520735;201809;761;1932;513;1502;101;289;182;558;283;847
520740;201809;1861;4541;1482;4053;271;716;881;2502;1152;3218
520750;201809;647;1639;468;1358;86;236;227;689;313;925
520753;201809;1389;3702;1107;3166;205;627;491;1332;696;1959
520760;201809;1150;2547;1036;2402;84;161;858;2079;942;2240
520780;201809;1533;3772;1159;3237;122;365;622;1701;744;2066
520790;201809;3385;8086;2374;6524;235;662;1434;4180;1669;4842
520800;201809;14525;38906;11763;35142;2267;6779;6973;21798;9240;28577
520810;201809;1311;2837;942;2405;173;472;525;1397;698;1869
520815;201809;608;1866;450;1548;115;412;91;363;206;775
520830;201809;1766;4015;1276;3441;68;160;1013;2711;1081;2871
520840;201809;2256;6310;1841;5738;783;2546;514;1728;1297;4274
520850;201809;642;1771;452;1473;169;627;90;289;259;916
520860;201809;6007;16999;4620;14761;1143;3948;1697;5455;2840;9403
520870;201809;85537;210002;59843;171047;16873;52425;17815;50175;34688;102600
520880;201809;5807;16964;4639;14994;1436;4938;1343;4316;2779;9254
520890;201809;3728;9547;2639;7767;599;1920;1123;3261;1722;5181
520910;201809;4129;10747;2663;8153;756;2515;489;1520;1245;4035
520915;201809;592;1697;415;1318;71;252;158;486;229;738
520920;201809;4363;10470;2953;8487;437;1334;1507;4357;1944;5691
520929;201809;708;1782;517;1444;87;216;246;746;333;962
520940;201809;1055;2871;839;2562;59;206;642;1950;701;2156
520945;201809;497;1154;391;979;22;47;278;688;300;735
520960;201809;1010;2664;803;2317;121;375;476;1323;597;1698
520970;201809;2393;7003;1974;6240;591;2022;485;1590;1076;3612
520980;201809;760;1983;597;1732;132;415;241;672;373;1087
520990;201809;2818;8464;2465;7906;311;1017;1617;5244;1928;6261
520993;201809;1005;2443;685;1907;38;122;485;1316;523;1438
520995;201809;2181;5764;1744;5157;388;1152;761;2284;1149;3436
521000;201809;7577;20944;5539;17212;1427;4647;1565;4862;2992;9509
521010;201809;3708;9814;2780;8220;367;1073;1515;4490;1882;5563
521015;201809;659;1713;527;1504;60;184;342;946;402;1130
521020;201809;2856;7647;1746;5418;538;1776;175;554;713;2330
521030;201809;528;1228;376;1005;52;110;196;574;248;684
521040;201809;7383;18286;5550;15435;1446;4219;2160;6145;3606;10364
521056;201809;835;2303;653;2010;209;663;180;603;389;1266
521060;201809;1034;2656;765;2214;62;192;407;1192;469;1384
521080;201809;1074;2467;555;1594;79;239;186;458;265;697
521090;201809;3181;8363;2269;6843;658;2115;322;1007;980;3122
521100;201809;1723;4081;1266;3436;243;640;692;1937;935;2577
521120;201809;4802;11352;3356;9532;326;880;1604;5173;1930;6053
521130;201809;950;2334;640;1765;38;139;374;1028;412;1167
521140;201809;1201;3220;890;2680;156;497;355;1064;511;1561
521150;201809;11520;26447;7489;20744;1651;5138;3100;8767;4751;13905
521160;201809;662;1478;444;1139;65;175;243;589;308;764
521170;201809;1063;2539;758;2070;70;194;501;1328;571;1522
521180;201809;6473;19304;5435;17353;1132;3909;2311;7130;3443;11039
521190;201809;10132;26605;5842;18828;1524;5264;1140;3848;2664;9112
521200;201809;729;1847;507;1462;62;178;284;805;346;983
521205;201809;606;1589;455;1338;25;71;327;944;352;1015
521210;201809;719;1905;406;1250;105;354;55;124;160;478
521220;201809;3941;9784;2658;7751;591;1866;829;2290;1420;4156
521225;201809;331;756;258;673;32;75;172;465;204;540
521230;201809;1370;4169;1270;4022;444;1308;691;2374;1135;3682
521250;201809;30226;85289;24319;76739;9789;32032;7294;24648;17083;56680
521260;201809;589;1395;432;1143;62;169;255;668;317;837
521270;201809;1775;4612;1547;4346;107;270;1218;3459;1325;3729
521280;201809;1848;5199;1419;4426;421;1415;489;1542;910;2957
521290;201809;437;1144;327;993;55;193;172;505;227;698
521295;201809;1131;2497;895;2222;75;162;691;1813;766;1975
521300;201809;1870;4821;1509;4313;303;821;908;2688;1211;3509
521305;201809;695;1794;504;1483;70;202;275;802;345;1004
521308;201809;4600;12787;3372;10363;519;1618;1800;5472;2319;7090
521310;201809;8030;21451;5331;16562;1325;4428;1728;5209;3053;9637
521340;201809;401;966;303;817;24;64;222;590;246;654
521350;201809;2046;5311;1592;4624;191;621;1065;2979;1256;3600
521370;201809;1142;2982;699;2208;173;615;143;460;316;1075
521375;201809;1389;3583;994;3016;253;782;360;1160;613;1942
521377;201809;1399;3124;1073;2724;69;153;893;2305;962;2458
521380;201809;5583;15345;3864;12132;491;1619;974;3242;1465;4861
521385;201809;604;1511;479;1347;101;279;226;697;327;976
521390;201809;684;1770;501;1492;166;518;163;514;329;1032
521400;201809;2387;5594;1861;4980;201;570;1395;3795;1596;4365
521405;201809;1271;3309;963;2802;200;589;440;1279;640;1868
521410;201809;759;2076;614;1858;120;355;314;1021;434;1376
521440;201809;1340;3581;991;2972;283;916;270;793;553;1709
521450;201809;3782;11661;2892;9822;689;2368;817;2903;1506;5271
521460;201809;5780;15812;4324;13190;1590;5118;1035;3082;2625;8200
521470;201809;620;1746;374;1190;61;182;103;306;164;488
521480;201809;355;947;205;652;44;157;48;133;92;290
521483;201809;2403;5993;1733;4899;433;1309;606;1656;1039;2965
521486;201809;1636;3953;1268;3444;72;198;971;2619;1043;2817
521487;201809;444;1126;321;944;63;191;142;423;205;614
521490;201809;846;2356;638;1994;45;192;434;1306;479;1498
521500;201809;1645;4286;1187;3535;103;379;794;2277;897;2656
521520;201809;781;1813;533;1440;92;255;227;627;319;882
521523;201809;11043;36832;9670;34439;3489;13269;2511;9261;6000;22530
521525;201809;1015;2446;786;2109;93;264;543;1437;636;1701
521530;201809;2191;5741;1284;3890;283;902;328;1056;611;1958
521540;201809;858;2215;547;1680;98;369;227;695;325;1064
521550;201809;1210;3109;756;2252;161;514;252;799;413;1313
521560;201809;3883;11140;2801;9638;618;2429;1341;4823;1959;7252
521565;201809;595;1503;482;1343;88;230;289;789;377;1019
521570;201809;3671;9862;2417;7500;528;1829;364;1196;892;3025
521580;201809;508;1257;285;851;39;129;67;169;106;298
521590;201809;596;1556;463;1343;123;404;196;530;319;934
521600;201809;395;1134;241;778;47;134;51;171;98;305
521630;201809;1571;3618;940;2647;199;613;293;792;492;1405
521640;201809;1955;4704;1426;3934;327;943;532;1443;859;2386
521645;201809;564;1531;370;1168;85;262;107;339;192;601
521680;201809;1125;3514;904;3052;278;996;112;420;390;1416
521690;201809;493;1344;419;1212;75;236;244;678;319;914
521710;201809;2937;7799;2006;6154;402;1362;439;1302;841;2664
521720;201809;1967;5094;1490;4302;200;619;839;2353;1039;2972
521730;201809;3620;10815;2853;9375;974;3559;521;1453;1495;5012
521740;201809;3731;10273;2936;9053;907;3044;997;3199;1904;6243
521760;201809;13812;41038;11363;37089;3536;12541;3812;12917;7348;25458
521770;201809;2818;7304;2007;5888;643;2007;461;1326;1104;3333
521800;201809;5571;16113;4542;14377;1319;4317;1576;5391;2895;9708
521805;201809;572;1353;404;1118;144;374;161;471;305;845
521810;201809;706;1655;479;1316;83;239;229;640;312;879
521830;201809;5128;14876;4229;13523;422;1578;2847;8943;3269;10521
521839;201809;631;1675;463;1353;96;290;186;517;282;807
521850;201809;5043;13031;3527;10519;880;2883;446;1230;1326;4113
521860;201809;1744;4583;1211;3677;207;682;405;1204;612;1886
521870;201809;660;1917;468;1558;113;397;138;431;251;828
521878;201809;644;1768;461;1414;83;297;197;545;280;842
521880;201809;17838;44201;12156;35473;3321;10104;3839;11684;7160;21788
521890;201809;3028;8443;2067;6490;543;1815;273;802;816;2617
521900;201809;1608;3889;975;2924;261;757;228;722;489;1479
521910;201809;1198;2718;799;2239;83;250;480;1391;563;1641
521920;201809;414;1222;312;1011;59;209;107;366;166;575
521925;201809;689;1950;516;1646;119;374;180;555;299;929
521930;201809;4321;11370;3172;9633;962;2870;1080;3577;2042;6447
521935;201809;805;2074;586;1682;85;251;322;882;407;1133
521940;201809;1245;2942;848;2402;206;664;342;919;548;1583
521945;201809;533;1548;435;1362;91;284;203;670;294;954
521950;201809;600;1478;473;1318;53;172;350;948;403;1120
521960;201809;701;1941;460;1441;71;244;219;657;290;901
521970;201809;2540;6623;2144;6149;117;306;1749;5146;1866;5452
521971;201809;753;1913;522;1540;144;445;134;396;278;841
521973;201809;1071;2959;882;2680;82;302;580;1712;662;2014
521975;201809;12013;32387;10186;29919;1734;5274;6340;18689;8074;23963
521980;201809;2513;6211;1987;5515;204;517;1462;4114;1666;4631
521990;201809;1122;3164;925;2844;127;404;489;1527;616;1931
522000;201809;3553;11717;2990;10982;260;825;2193;8619;2453;9444
522005;201809;337;861;253;740;58;152;112;344;170;496
522010;201809;3737;9545;2747;7941;806;2457;720;2028;1526;4485
522015;201809;932;2554;674;2128;145;474;259;826;404;1300
522020;201809;5077;12571;3446;9923;828;2472;1486;4389;2314;6861
522026;201809;659;1861;507;1601;85;287;222;705;307;992
522028;201809;501;1363;358;1058;78;229;139;386;217;615
522040;201809;2897;6618;2049;5509;279;814;1363;3618;1642;4432
522045;201809;16099;47696;12189;40101;3116;10919;2910;9372;6026;20291
522050;201809;1046;2867;719;2280;161;549;261;782;422;1331
522060;201809;2443;6867;1976;6157;268;874;1140;3683;1408;4557
522068;201809;1686;4718;1386;4343;167;499;987;3179;1154;3678
522070;201809;576;1577;487;1434;41;157;361;1006;402;1163
522100;201809;580;1563;417;1301;66;224;225;698;291;922
522108;201809;883;2474;694;2168;46;205;551;1656;597;1861
522119;201809;1534;4040;1195;3583;196;613;635;1968;831;2581
522130;201809;383;978;277;833;58;183;146;455;204;638
522140;201809;15813;43281;11631;35847;3598;11774;2150;6526;5748;18300
522145;201809;842;2128;617;1794;148;390;317;1003;465;1393
522150;201809;920;2268;696;1935;218;578;238;708;456;1286
522155;201809;890;2383;693;2044;145;415;320;954;465;1369
522157;201809;538;1438;467;1334;26;97;357;996;383;1093
522160;201809;5807;15587;3910;12026;1142;3786;338;1150;1480;4936
522170;201809;2471;6641;1798;5511;476;1512;720;2235;1196;3747
522180;201809;445;1135;286;851;63;195;37;126;100;321
522185;201809;15825;41071;12047;36079;5154;16474;2889;9572;8043;26046
522190;201809;725;1762;538;1483;93;248;222;636;315;884
522200;201809;1682;5063;1093;3758;218;802;118;387;336;1189
522205;201809;1554;3786;1198;3279;116;342;839;2296;955;2638
522220;201809;1296;3409;996;2959;157;431;537;1646;694;2077
522230;201809;1161;3125;976;2851;183;598;562;1625;745;2223
530010;201809;156875;459443;135314;423759;28297;97937;70602;216720;98899;314657
110001;201810;3562;10562;2595;8735;680;2437;997;3318;1677;5755
110002;201810;10953;29767;7973;24646;2434;7992;2557;7927;4991;15919
110003;201810;640;1918;465;1544;127;455;93;294;220;749
110004;201810;8991;25715;6393;20703;1730;5866;1566;5336;3296;11202
110005;201810;2356;6379;1465;4673;375;1273;427;1457;802;2730
110006;201810;1714;4877;1074;3537;254;916;156;509;410;1425
110007;201810;1073;3101;816;2663;319;1072;236;869;555;1941
110008;201810;2574;8073;2218;7519;310;1001;1583;5608;1893;6609
110009;201810;3914;11346;2592;8932;775;2753;842;3028;1617;5781
110010;201810;6071;20771;4913;18643;1266;4670;2246;9497;3512;14167
110011;201810;6138;17396;4540;14420;1596;5202;837;2761;2433;7963
110012;201810;13306;35389;8745;27180;2298;7399;1163;3792;3461;11191
110013;201810;5080;15492;4053;13436;1701;5805;608;2245;2309;8050
110014;201810;3627;9939;2573;7981;738;2345;987;3029;1725;5374
110015;201810;4898;13570;2831;9317;744;2627;441;1368;1185;3995
110018;201810;3271;8728;2037;6562;503;1818;513;1570;1016;3388
110020;201810;69212;174896;48412;145472;10905;34094;19276;61932;30181;96026
110025;201810;4657;11928;3130;9231;708;2215;1439;4095;2147;6310
110026;201810;470;1352;364;1189;111;385;137;430;248;815
110028;201810;5755;15943;3860;12279;1101;3724;570;1777;1671;5501
110029;201810;1322;3290;785;2410;190;590;326;1008;516;1598
110030;201810;11733;29037;7948;23476;1601;5406;2712;8202;4313;13608
110032;201810;2911;8737;2061;6895;715;2425;494;1673;1209;4098
110033;201810;3871;12571;3133;11140;1128;4049;797;3146;1925;7195
110034;201810;3332;8390;2323;6952;734;2348;947;2897;1681;5245
110037;201810;1575;5092;1272;4485;325;1167;584;2039;909;3206
110040;201810;2846;8396;2127;7049;646;2282;544;1741;1190;4023
110045;201810;4782;14484;3830;12798;1113;4052;1423;4750;2536;8802
110050;201810;1643;4923;1238;4108;521;1802;255;842;776;2644
110060;201810;776;2410;553;1934;209;766;56;202;265;968
110070;201810;1810;5835;1426;4946;494;1816;302;954;796;2770
110080;201810;5574;13737;4165;12036;623;1727;2745;8370;3368;10097
110090;201810;592;1647;411;1313;114;375;155;493;269;868
110092;201810;1106;3404;861;2938;145;508;456;1621;601;2129
110094;201810;2855;8630;2220;7495;780;2741;576;2066;1356;4807
110100;201810;1734;5383;1457;4791;358;1243;677;2213;1035;3456
110110;201810;1635;4778;1171;3942;399;1398;242;874;641;2272
110120;201810;1277;3902;973;3264;280;976;264;873;544;1849
110130;201810;2553;6758;1603;4966;364;1250;541;1639;905;2889
110140;201810;2055;6533;1519;5396;414;1536;378;1367;792;2903
110143;201810;1306;3651;912;2861;322;1027;213;681;535;1708
110145;201810;938;2616;598;1953;158;549;186;614;344;1163
110146;201810;437;1214;306;1004;63;197;150;526;213;723
110147;201810;730;1954;460;1396;80;241;176;479;256;720
110148;201810;830;2474;504;1739;111;421;49;174;160;595
110149;201810;2797;8178;2066;6996;837;2802;488;1813;1325;4615
110150;201810;2252;6079;1578;5081;610;2159;441;1397;1051;3556
110155;201810;650;2024;513;1708;127;446;173;546;300;992
110160;201810;1506;4791;1126;3938;394;1378;244;897;638;2275
110170;201810;2178;5883;1392;4325;267;886;697;2084;964;2970
110175;201810;1421;4206;1083;3661;201;708;518;1834;719;2542
110180;201810;1228;3533;879;2813;217;694;370;1197;587;1891
120001;201810;3556;12289;3140;11680;457;1542;2178;8577;2635;10119
120005;201810;1860;7220;1672;6904;171;767;1285;5419;1456;6186
120010;201810;5201;16387;4459;15159;630;2054;2996;10509;3626;12563
120013;201810;2104;7980;1978;7801;529;2007;1121;4717;1650;6724
120017;201810;2076;7127;1883;6812;335;1250;1127;4285;1462;5535
120020;201810;14086;59012;13267;57331;1332;6236;10021;44048;11353;50284
120025;201810;2725;8401;2302;7855;457;1582;1473;5151;1930;6733
120030;201810;6400;25673;6155;25247;416;2164;5029;20631;5445;22795
120032;201810;1646;7601;1570;7417;94;586;1259;5906;1353;6492
120033;201810;3917;14945;3682;14523;144;776;3172;12449;3316;13225
120034;201810;2479;9378;2163;8777;130;749;1727;6899;1857;7648
120035;201810;3401;14399;3248;14106;306;1498;2581;11337;2887;12835
120038;201810;2618;8840;2312;8304;596;2244;1159;4215;1755;6459
120039;201810;1926;8681;1827;8479;170;1029;1392;6446;1562;7475
120040;201810;40975;137322;36571;129733;6471;24157;21782;78365;28253;102522
120042;201810;3247;12600;3002;12079;182;956;2361;9456;2543;10412
120043;201810;1266;5497;1195;5344;68;400;1033;4604;1101;5004
120045;201810;5580;15921;5010;15282;159;645;4577;13825;4736;14470
120050;201810;8621;32556;8039;31605;594;2839;6434;25467;7028;28306
120060;201810;8580;35466;8164;34772;437;2431;7079;30147;7516;32578
120070;201810;2917;9851;2618;9417;299;1112;1840;6865;2139;7977
120080;201810;4152;14352;3754;13681;590;2298;2514;9247;3104;11545
130002;201810;3142;12691;2871;12314;120;637;2556;10983;2676;11620
130006;201810;2254;8895;1913;8259;161;793;1444;6217;1605;7010
130008;201810;2501;9037;2253;8638;74;383;1882;7213;1956;7596
130010;201810;3874;11295;3345;10693;66;217;3127;10080;3193;10297
130014;201810;2921;9151;2388;8230;448;1566;1486;5231;1934;6797
130020;201810;2656;10597;2439;10233;146;879;1952;8126;2098;9005
130030;201810;9329;31579;8549;30705;198;793;7828;28385;8026;29178
130040;201810;3712;11398;3156;10639;173;624;2536;8622;2709;9246
130050;201810;7355;27373;6234;25932;234;1083;5584;23455;5818;24538
130060;201810;7115;29523;6216;28294;523;3075;4888;22107;5411;25182
130063;201810;5839;20081;5282;19429;124;570;4920;18159;5044;18729
130068;201810;3312;13049;2914;12270;216;1187;2207;9184;2423;10371
130070;201810;8239;25725;7108;24460;313;1035;6170;21665;6483;22700
130080;201810;6547;25755;5904;24912;347;2023;4837;20488;5184;22511
130083;201810;2520;8983;2297;8698;193;883;1866;6997;2059;7880
130090;201810;3347;10758;3035;10335;57;250;2649;9233;2706;9483
130100;201810;7210;22927;6355;22008;95;274;5991;21175;6086;21449
130110;201810;7970;23408;6753;21908;742;2068;5397;18223;6139;20291
130115;201810;5342;17245;4713;16483;105;416;4146;14692;4251;15108
130120;201810;14394;53007;13209;51450;1291;5341;10760;42430;12051;47771
130130;201810;5019;17017;4032;15718;461;2061;3012;11699;3473;13760
130140;201810;6661;24880;6317;24486;269;1326;5632;21832;5901;23158
130150;201810;3571;13833;3410;13626;110;681;3097;12313;3207;12994
130160;201810;4908;18405;4334;17644;332;1577;3562;14715;3894;16292
130165;201810;3012;11969;2883;11760;107;604;2556;10392;2663;10996
130170;201810;11506;34987;9533;32588;684;2703;7924;27220;8608;29923
130180;201810;4464;14311;4224;14025;49;243;4072;13477;4121;13720
130185;201810;17374;44123;14252;40771;676;1346;12598;37350;13274;38696
130190;201810;18157;61266;15227;56903;1912;7233;10757;41477;12669;48710
130195;201810;2281;8741;1900;8229;77;416;1690;7335;1767;7751
130200;201810;2381;7176;2014;6666;134;507;1612;5368;1746;5875
130210;201810;1349;5146;1212;4983;104;635;958;3827;1062;4462
130220;201810;2054;7820;1887;7542;94;498;1567;6249;1661;6747
130230;201810;4154;18222;3757;17633;331;1933;3060;14374;3391;16307
130240;201810;10781;34805;9044;32382;242;1367;7905;28218;8147;29585
130250;201810;25240;77816;22282;74459;1610;5181;18377;63536;19987;68717
130255;201810;4187;14661;3760;13887;213;962;2995;11039;3208;12001
130260;201810;242607;723929;205450;666844;59564;206333;89650;294568;149214;500901
130270;201810;8530;32295;7351;30402;1164;4953;4964;21241;6128;26194
130280;201810;3477;14204;3262;13965;123;577;3006;13053;3129;13630
130290;201810;12823;43838;11455;42209;473;1756;10259;38453;10732;40209
130300;201810;4552;16721;4231;16230;201;1037;3629;13801;3830;14838
130310;201810;5613;20390;5080;19627;403;1641;4129;16215;4532;17856
130320;201810;3326;11176;2906;10636;279;972;2240;8443;2519;9415
130330;201810;4368;14499;3731;13700;190;857;3204;11771;3394;12628
130340;201810;21210;72053;18778;69207;1539;5296;15662;59477;17201;64773
130350;201810;3817;14344;3508;13930;159;904;3042;11953;3201;12857
130353;201810;6385;18900;5414;17640;847;2678;3729;12580;4576;15258
130356;201810;4891;16794;4265;15757;596;2239;2869;10906;3465;13145
130360;201810;3201;9569;2750;9069;68;201;2573;8567;2641;8768
130370;201810;5724;22247;5116;21438;261;1391;4402;18381;4663;19772
130380;201810;7402;31081;7008;30482;471;2646;5912;25388;6383;28034
130390;201810;5821;24786;5158;23600;569;3093;3698;16794;4267;19887
130395;201810;2349;7705;2047;7169;253;946;1449;5045;1702;5991
130400;201810;2645;8698;2304;8220;125;428;2017;7293;2142;7721
130406;201810;10830;40149;9516;38349;1888;7924;6322;25966;8210;33890
130410;201810;4043;14784;3533;13911;1065;4355;1676;6819;2741;11174
130420;201810;12540;47119;11043;45237;1096;5417;8744;35747;9840;41164
130423;201810;3980;13270;3568;12763;173;887;3153;11063;3326;11950
130426;201810;2843;11175;2728;11001;92;448;2525;10225;2617;10673
130430;201810;3978;12257;3563;11661;374;1328;2809;9119;3183;10447
130440;201810;4529;14581;4014;13973;87;343;3734;13090;3821;13433
140002;201810;2018;6115;1780;5792;109;455;1441;4581;1550;5036
140005;201810;3279;9061;3044;8793;136;447;2735;7899;2871;8346
140010;201810;52441;142289;41109;125482;10696;34394;15642;49853;26338;84247
140015;201810;3315;11376;2972;10954;239;848;2499;9451;2738;10299
140017;201810;3684;11147;3262;10585;353;1086;2378;8060;2731;9146
140020;201810;5055;15446;4336;14467;341;1437;3336;11091;3677;12528
140023;201810;2253;7010;1854;6427;244;906;1288;4520;1532;5426
140028;201810;2106;5486;1797;5086;156;509;1366;3765;1522;4274
140030;201810;4411;12382;3947;11802;353;912;3219;9904;3572;10816
140040;201810;2129;9052;1960;8795;128;763;1670;7366;1798;8129
140045;201810;2560;9670;2175;9106;416;1711;1391;6143;1807;7854
140047;201810;5961;17782;5107;16472;831;2867;3302;10748;4133;13615
140050;201810;1367;4096;1167;3799;130;438;821;2695;951;3133
140060;201810;1527;4262;1311;3936;106;318;1042;3179;1148;3497
140070;201810;1793;9686;1725;9497;149;1024;1346;7334;1495;8358
150010;201810;42462;110135;39143;105678;1170;3504;34723;92914;35893;96418
150013;201810;1886;5091;1570;4730;145;374;1192;3788;1337;4162
150020;201810;13756;42825;12994;41821;1191;2967;10963;36501;12154;39468
150030;201810;8745;33489;8020;32578;396;1835;7067;28868;7463;30703
150034;201810;4194;11010;3555;10165;259;755;2905;8384;3164;9139
150040;201810;14833;40400;12946;38248;1326;2578;10592;33745;11918;36323
150050;201810;6646;24010;6149;23281;147;719;5632;21424;5779;22143
150060;201810;19910;56904;16775;52227;3120;9676;10086;32387;13206;42063
150070;201810;6390;24974;5766;24213;190;1023;5234;22222;5424;23245
150080;201810;80392;199349;67248;181612;15985;44411;27115;81901;43100;126312
150085;201810;6550;20461;6023;19799;210;649;5552;18422;5762;19071
150090;201810;9936;37560;9393;36577;671;2874;7574;29558;8245;32432
150095;201810;5508;16945;4927;16157;294;799;4064;13793;4358;14592
150100;201810;2992;10655;2669;10082;198;761;2057;7838;2255;8599
150110;201810;3982;17728;3874;17589;227;1105;3476;15879;3703;16984
150120;201810;7311;24487;7090;24170;319;872;6332;22162;6651;23034
150125;201810;736;2088;575;1870;120;444;336;1072;456;1516
150130;201810;22851;67390;20097;63307;2749;7775;14331;46867;17080;54642
150140;201810;208533;520100;181470;482393;30078;78722;108499;299888;138577;378610
150145;201810;4569;13751;3935;12875;797;2330;2622;9150;3419;11480
150150;201810;14587;39338;13037;37344;952;2833;10416;30061;11368;32894
150157;201810;3279;9321;2748;8622;296;1034;1938;6210;2234;7244
150160;201810;2908;9044;2735;8747;687;2156;1489;4948;2176;7104
150170;201810;24244;80643;21113;75522;3857;13124;12808;48804;16665;61928
150172;201810;4185;12256;3451;11197;306;898;2530;8528;2836;9426
150175;201810;1700;5263;1477;4867;210;728;970;3270;1180;3998
150178;201810;10059;28805;8464;26910;397;1262;7157;23145;7554;24407
150180;201810;20413;76885;19049;75141;1053;4271;16586;66397;17639;70668
150190;201810;6910;23532;6520;23028;291;1265;5730;20153;6021;21418
150195;201810;5402;17379;5132;16965;100;449;4752;15620;4852;16069
150200;201810;5269;16194;4850;15732;55;166;4614;15083;4669;15249
150210;201810;24796;90085;23429;88230;1903;7142;19079;73879;20982;81021
150215;201810;6892;20806;5986;19465;1603;5164;2925;10097;4528;15261
150220;201810;11393;34100;10158;32229;1603;5012;6247;20359;7850;25371
150230;201810;12381;36109;10746;33894;1380;4175;7337;24119;8717;28294
150240;201810;31645;90952;26184;81222;8376;26437;7460;23643;15836;50080
150250;201810;4092;16615;3905;16353;585;2482;2952;12595;3537;15077
150260;201810;2468;8625;2292;8336;221;772;1722;6374;1943;7146
150270;201810;8193;23940;6012;20598;2011;7157;2010;7212;4021;14369
150275;201810;6506;21707;6045;21012;324;1228;5089;17649;5413;18877
150276;201810;2220;6257;1917;5886;255;730;1375;4495;1630;5225
150277;201810;4945;13591;4146;12650;1407;4375;2227;7116;3634;11491
150280;201810;6302;26644;6150;26348;530;2244;5047;21879;5577;24123
150285;201810;3168;11446;2837;10953;331;1401;1987;7780;2318;9181
150290;201810;10763;29281;9952;28388;415;952;8949;26140;9364;27092
150293;201810;9701;24428;7104;20953;1520;4552;3494;11121;5014;15673
150295;201810;7648;21176;5784;18808;2052;7293;2064;7261;4116;14554
150300;201810;2139;6810;1937;6532;55;275;1700;5688;1755;5963
150304;201810;3991;12418;3369;11371;610;1986;2106;7364;2716;9350
150307;201810;6273;20425;5868;19803;444;1380;4768;16370;5212;17750
150309;201810;6053;19242;5045;17511;1108;3728;2627;9619;3735;13347
150310;201810;7088;28366;6741;27923;254;1430;5928;24688;6182;26118
150320;201810;9374;25521;8561;24412;485;1472;6786;19317;7271;20789
150330;201810;13911;45902;12924;44255;1666;5652;9443;33180;11109;38832
150340;201810;2643;7842;2373;7439;339;1031;1670;5321;2009;6352
150345;201810;7690;23180;6978;22250;444;1495;5894;18944;6338;20439
150350;201810;8807;23976;8122;23099;909;1906;6560;19437;7469;21343
150360;201810;23172;66700;18932;61255;2303;6765;13069;44279;15372;51044
150370;201810;9696;32254;8397;30441;950;3208;6138;23327;7088;26535
150375;201810;3206;13549;2913;13098;299;1449;2309;10486;2608;11935
150380;201810;10234;27744;8636;25570;298;981;7461;22157;7759;23138
150390;201810;7609;31880;6991;30839;1154;4735;4768;22130;5922;26865
150400;201810;6194;22992;5956;22529;281;1133;5081;19296;5362;20429
150405;201810;9088;24688;8103;23459;541;1207;6511;19583;7052;20790
150410;201810;1827;6112;1588;5680;226;781;1012;3716;1238;4497
150420;201810;34587;104553;26764;92346;8971;32189;7780;30993;16751;63182
150430;201810;8152;24848;7625;24110;856;2179;5974;19689;6830;21868
150440;201810;5574;18433;5257;17953;480;1528;4181;14521;4661;16049
150442;201810;23819;61859;20139;56789;2469;6779;13326;38679;15795;45458
150445;201810;5939;19098;5363;18195;254;898;4531;15464;4785;16362
150450;201810;4852;21582;4574;21178;388;1895;3822;17863;4210;19758
150460;201810;8072;27230;7527;26497;234;994;6569;23805;6803;24799
150470;201810;18395;52664;17393;51474;904;2372;15514;46474;16418;48846
150475;201810;4282;14375;3866;13727;193;742;3236;11623;3429;12365
150480;201810;13668;45813;12286;43642;2193;7364;8329;31092;10522;38456
150490;201810;8038;28650;7567;28041;251;1158;6710;24967;6961;26125
150495;201810;5052;18106;4912;17917;108;505;4541;16561;4649;17066
150497;201810;2724;9091;2222;8159;595;2272;1042;4036;1637;6308
150500;201810;3270;8635;2916;8089;326;823;2235;6252;2561;7075
150503;201810;4384;12333;3201;10665;1032;3591;1082;3947;2114;7538
150506;201810;9675;31626;8601;30100;1859;5888;5518;20832;7377;26720
150510;201810;9865;36796;8650;34401;1266;4897;5696;23748;6962;28645
150520;201810;7309;27657;7008;27279;206;1093;6430;25015;6636;26108
150530;201810;12274;42351;10833;40176;1633;5095;7754;30387;9387;35482
150540;201810;4844;13792;4167;12776;166;503;3546;10850;3712;11353
150543;201810;6858;19065;5639;17453;890;2831;3822;12365;4712;15196
150548;201810;9867;31329;8972;30108;339;1133;7962;26848;8301;27981
150549;201810;2004;6210;1757;5897;50;213;1553;5197;1603;5410
150550;201810;18826;57958;16125;53404;4251;14298;7151;24924;11402;39222
150553;201810;22641;71816;18136;63289;6334;22747;5130;19664;11464;42411
150555;201810;1783;5013;1436;4445;134;384;988;3103;1122;3487
150560;201810;1807;5707;1612;5312;297;939;896;3044;1193;3983
150563;201810;2423;7758;2128;7219;463;1679;1151;3897;1614;5576
150565;201810;4192;13811;3731;13046;101;503;3120;10919;3221;11422
150570;201810;6147;20815;5894;20412;313;1218;4973;17169;5286;18387
150580;201810;10127;41755;9206;40719;673;3326;7618;34394;8291;37720
150590;201810;7123;26369;6549;25610;215;1155;5922;23074;6137;24229
150600;201810;9006;31229;8422;30480;248;1085;7673;27829;7921;28914
150610;201810;2600;8134;2333;7638;140;525;1871;6039;2011;6564
150611;201810;2892;8791;2637;8392;124;493;2273;7146;2397;7639
150613;201810;13040;36851;9950;31536;2019;6712;4649;15003;6668;21715
150616;201810;3228;9150;2397;7754;590;2018;883;2788;1473;4806
150618;201810;6656;20482;5533;18610;751;2473;3415;11992;4166;14465
150619;201810;5888;17698;4951;16256;276;1039;3908;12795;4184;13834
150620;201810;6399;21727;5638;20614;861;3080;3908;14679;4769;17759
150630;201810;6151;17139;5675;16554;397;1146;4793;14134;5190;15280
150635;201810;4393;12879;3815;11896;652;2059;2243;7095;2895;9154
150640;201810;2178;6345;2003;6141;35;112;1868;5800;1903;5912
150650;201810;11532;33277;10220;31011;3190;9249;4377;14274;7567;23523
150655;201810;5673;16798;5195;16059;239;740;4437;13722;4676;14462
150658;201810;4282;12496;3540;11397;697;2357;2094;7033;2791;9390
150660;201810;5695;16731;5162;15978;566;1711;3580;11281;4146;12992
150670;201810;7987;19528;6318;17570;690;1603;4927;14335;5617;15938
150680;201810;64390;199497;49949;176092;12898;45291;21638;85246;34536;130537
150690;201810;2414;6463;2144;6096;126;318;1810;5206;1936;5524
150700;201810;6238;18910;5644;18159;446;1325;4461;14703;4907;16028
150710;201810;3777;12777;3461;12264;261;997;2662;9481;2923;10478
150715;201810;5078;15553;4353;14385;371;1158;3460;11624;3831;12782
150720;201810;6424;24482;6090;23881;464;2100;4975;19531;5439;21631
150730;201810;11222;35861;9905;33801;1127;4032;7420;25745;8547;29777
150740;201810;3647;10815;3256;10132;416;1210;2250;7131;2666;8341
150745;201810;5029;14905;4200;13684;871;3009;2671;8745;3542;11754
150746;201810;1540;4948;1429;4758;89;286;1163;3908;1252;4194
150747;201810;4982;16091;4436;15222;839;2577;2809;10231;3648;12808
150750;201810;3580;11403;3074;10619;227;849;2365;8356;2592;9205
150760;201810;11777;35244;10806;33997;1367;4055;7992;25749;9359;29804
150770;201810;6153;22687;5873;22315;188;564;5422;21169;5610;21733
150775;201810;913;2677;733;2403;131;494;405;1308;536;1802
150780;201810;4409;13519;4076;13108;92;303;3770;12239;3862;12542
150790;201810;5429;16260;4789;15549;242;689;3933;13847;4175;14536
150795;201810;13682;44337;12394;42178;3249;10619;6799;24532;10048;35151
150796;201810;3465;9220;3028;8690;195;559;2531;7348;2726;7907
150797;201810;3900;12477;3386;11661;157;514;2804;9740;2961;10254
150800;201810;13023;41958;12047;40748;1726;5412;8959;31480;10685;36892
150803;201810;6655;22838;6272;22220;419;1530;5300;18818;5719;20348
150805;201810;3219;10493;2772;9771;323;1172;2065;7327;2388;8499
150808;201810;5701;17261;4295;14765;1610;6019;556;2093;2166;8112
150810;201810;20073;56254;15613;50650;2789;8933;8913;31248;11702;40181
150812;201810;5328;15557;4766;14547;479;1557;3492;10443;3971;12000
150815;201810;8843;27810;7675;26317;760;2614;5994;20866;6754;23480
150820;201810;11933;32806;10105;30624;977;2563;7910;24813;8887;27376
150830;201810;11533;43668;10972;42986;388;2066;9537;38046;9925;40112
150835;201810;2119;7430;1925;7069;404;1469;976;3665;1380;5134
150840;201810;7254;21597;5849;19073;1240;4251;2948;9564;4188;13815
160005;201810;1170;3254;1066;3104;23;111;1004;2876;1027;2987
160010;201810;2331;6116;2271;6054;13;51;2225;5902;2238;5953
160015;201810;2310;7500;2116;7236;99;360;1910;6560;2009;6920
160020;201810;1968;6767;1776;6488;232;840;1332;4942;1564;5782
160021;201810;1089;4359;1016;4247;83;472;812;3330;895;3802
160023;201810;1216;4487;1089;4284;132;473;757;3166;889;3639
160025;201810;1875;5300;1829;5244;14;53;1800;5156;1814;5209
160027;201810;8673;24409;7907;23504;611;1707;6534;19831;7145;21538
160030;201810;56499;172766;47104;160175;10810;34847;25036;93894;35846;128741
160040;201810;5160;18498;4695;17865;100;554;4311;16427;4411;16981
160050;201810;4343;14116;3559;12960;1529;5400;1140;5070;2669;10470
160053;201810;3439;11652;3229;11380;346;1152;2563;9278;2909;10430
160055;201810;696;2425;686;2413;29;118;633;2224;662;2342
160060;201810;22306;63006;18787;58966;1194;3671;15165;49339;16359;53010
160070;201810;2942;11228;2681;10786;202;887;2124;8742;2326;9629
160080;201810;2909;10107;2721;9880;67;309;2473;9017;2540;9326
170025;201810;602;1672;453;1460;104;320;220;735;324;1055
170030;201810;1170;3714;936;3243;171;595;440;1561;611;2156
170035;201810;1446;3805;1048;3143;114;374;592;1783;706;2157
170040;201810;1790;5358;1469;4912;114;416;841;2954;955;3370
170070;201810;1605;3964;1171;3398;125;385;687;2059;812;2444
170100;201810;2442;7098;2026;6379;210;621;1331;4243;1541;4864
170105;201810;725;2178;512;1711;132;398;168;576;300;974
170110;201810;887;2859;700;2494;117;419;337;1202;454;1621
170130;201810;1327;4079;958;3345;177;647;482;1736;659;2383
170190;201810;1380;4022;966;3341;341;1136;182;844;523;1980
170200;201810;1715;4356;1041;3164;267;875;240;715;507;1590
170210;201810;24602;68765;18797;58980;6639;22664;2005;7251;8644;29915
170215;201810;1309;3668;1103;3376;65;257;815;2463;880;2720
170220;201810;5819;18384;4988;16800;1208;3865;2456;8885;3664;12750
170230;201810;1221;3778;949;3219;243;864;217;740;460;1604
170240;201810;2592;7463;2065;6598;187;734;1380;4284;1567;5018
170255;201810;3910;11696;2728;9403;543;1960;1224;4327;1767;6287
170270;201810;1043;2528;672;2011;35;100;424;1251;459;1351
170290;201810;2990;8651;2558;8149;136;363;2081;6925;2217;7288
170300;201810;1858;5364;1563;4889;181;571;1002;3195;1183;3766
170305;201810;729;2135;575;1829;83;305;277;846;360;1151
170307;201810;945;3324;765;2955;119;466;404;1583;523;2049
170310;201810;1629;4246;1120;3373;205;674;502;1526;707;2200
170320;201810;953;2589;727;2232;87;265;436;1350;523;1615
170330;201810;846;2679;768;2553;52;224;607;1960;659;2184
170360;201810;462;1325;338;1111;52;186;204;630;256;816
170370;201810;1296;3561;956;2989;199;622;416;1353;615;1975
170380;201810;1814;5473;1376;4758;178;639;741;2674;919;3313
170382;201810;542;1685;448;1517;58;222;294;973;352;1195
170384;201810;1468;5649;1250;5189;331;1448;538;2227;869;3675
170386;201810;782;2231;499;1657;73;294;136;413;209;707
170388;201810;625;1821;446;1480;62;235;201;662;263;897
170389;201810;1118;3813;969;3549;44;193;777;2884;821;3077
170390;201810;1613;3861;1188;3345;78;206;922;2676;1000;2882
170410;201810;549;1647;399;1366;23;105;250;819;273;924
170460;201810;363;1008;292;886;41;126;181;557;222;683
170510;201810;852;2658;638;2220;60;279;374;1226;434;1505
170550;201810;6384;17483;4510;14269;1351;4553;817;2772;2168;7325
170555;201810;1333;3752;1059;3310;84;281;562;1819;646;2100
170560;201810;1032;3013;784;2655;91;341;440;1635;531;1976
170600;201810;1349;3797;1097;3408;233;626;626;2092;859;2718
170610;201810;1730;4805;1279;4071;84;303;796;2482;880;2785
170625;201810;434;1211;275;866;31;94;85;259;116;353
170650;201810;1251;3837;977;3343;194;667;432;1565;626;2232
170700;201810;3413;10225;2633;8805;603;2131;1051;3598;1654;5729
170710;201810;1492;4185;1168;3603;198;683;631;1903;829;2586
170720;201810;1890;4855;1515;4305;64;120;1278;3755;1342;3875
170730;201810;1008;2893;766;2492;180;584;328;1108;508;1692
170740;201810;2016;7009;1725;6415;222;858;1124;4188;1346;5046
170755;201810;872;2530;611;2021;69;259;299;973;368;1232
170765;201810;1235;3268;846;2657;212;685;325;1086;537;1771
170770;201810;1754;5445;1507;5033;202;653;973;3330;1175;3983
170820;201810;3812;13106;3282;12087;496;1772;1885;7330;2381;9102
170825;201810;959;2283;758;2005;82;220;509;1351;591;1571
170830;201810;1372;3802;1141;3425;23;75;951;2863;974;2938
170900;201810;2602;8697;2253;8139;185;731;1766;6446;1951;7177
170930;201810;3641;10354;2870;8947;676;2272;1138;3538;1814;5810
170950;201810;10912;31085;7680;25183;2277;8462;1094;3758;3371;12220
170980;201810;434;1246;350;1104;26;120;233;689;259;809
171050;201810;1531;5036;1365;4732;65;320;1081;3681;1146;4001
171070;201810;1327;3982;1146;3702;269;815;628;2220;897;3035
171090;201810;1032;2606;850;2348;60;160;618;1698;678;1858
171110;201810;574;1611;413;1312;82;286;175;500;257;786
171150;201810;1053;2728;646;1999;78;279;406;1241;484;1520
171180;201810;732;2099;491;1605;85;279;190;651;275;930
171190;201810;1577;5655;1402;5325;230;898;842;3269;1072;4167
171195;201810;815;2743;690;2504;134;520;388;1424;522;1944
171200;201810;530;1561;404;1334;83;301;176;571;259;872
171215;201810;398;1141;307;977;56;188;170;522;226;710
171240;201810;738;2555;615;2304;47;239;385;1437;432;1676
171245;201810;626;1946;481;1625;68;250;253;830;321;1080
171250;201810;1069;2871;790;2424;201;669;366;1105;567;1774
171270;201810;361;1422;306;1286;77;313;137;636;214;949
171280;201810;826;2572;643;2247;131;439;301;1143;432;1582
171320;201810;3938;11264;3080;9734;580;1815;1360;4529;1940;6344
171330;201810;2640;7399;2046;6366;478;1471;943;3049;1421;4520
171360;201810;1399;4299;1186;3993;80;303;916;3101;996;3404
171370;201810;690;1812;537;1602;57;182;371;1117;428;1299
171380;201810;1414;4075;1164;3674;132;437;775;2469;907;2906
171395;201810;911;2705;633;2131;72;277;337;1101;409;1378
171420;201810;1845;5701;1365;4711;227;872;602;2083;829;2955
171430;201810;1015;3049;816;2638;84;305;547;1701;631;2006
171488;201810;2359;7102;1860;6282;302;1048;956;3321;1258;4369
171500;201810;943;2502;722;2149;53;165;541;1618;594;1783
171510;201810;764;2660;690;2517;43;191;486;1772;529;1963
171515;201810;465;1293;346;1086;27;110;211;635;238;745
171525;201810;643;1952;524;1745;37;173;311;959;348;1132
171550;201810;334;1001;238;831;40;155;119;409;159;564
171570;201810;1131;3521;954;3192;170;538;546;1894;716;2432
171575;201810;1826;4938;1152;3677;182;621;462;1448;644;2069
171610;201810;5534;15970;4162;13619;995;3513;1137;3976;2132;7489
171620;201810;2714;7692;2305;7125;164;613;1811;5586;1975;6199
171630;201810;948;2633;775;2381;138;446;483;1522;621;1968
171650;201810;2071;6133;1532;5114;389;1349;493;1760;882;3109
171660;201810;2348;6186;1633;4921;268;776;852;2601;1120;3377
171665;201810;1318;3758;1004;3251;182;647;466;1541;648;2188
171670;201810;1781;4933;1385;4276;205;724;764;2302;969;3026
171700;201810;1176;3451;873;2904;120;393;479;1595;599;1988
171720;201810;811;2190;625;1884;44;162;456;1357;500;1519
171750;201810;1220;3537;869;2882;225;776;129;521;354;1297
171780;201810;1226;3226;897;2756;69;256;618;1843;687;2099
171790;201810;1398;4837;1122;4205;264;975;481;1901;745;2876
171800;201810;718;2057;541;1784;72;270;292;954;364;1224
171820;201810;10585;30605;7988;25974;1940;6633;2643;9109;4583;15742
171830;201810;1437;4975;1224;4529;128;568;779;2836;907;3404
171840;201810;739;1954;580;1712;42;135;413;1200;455;1335
171845;201810;641;1667;479;1431;69;245;263;791;332;1036
171850;201810;850;2977;735;2739;66;301;508;1849;574;2150
171855;201810;1075;3316;924;3041;88;299;585;1896;673;2195
171865;201810;365;1207;315;1124;57;217;153;521;210;738
171870;201810;755;2178;545;1776;61;212;287;977;348;1189
171875;201810;1215;3733;986;3352;62;254;724;2424;786;2678
171880;201810;1057;3404;950;3269;49;183;761;2681;810;2864
171884;201810;839;2257;606;1896;121;443;210;711;331;1154
171886;201810;1412;4086;994;3335;296;1074;183;634;479;1708
171888;201810;748;2143;514;1686;47;148;311;1028;358;1176
171889;201810;441;1382;379;1266;73;266;173;570;246;836
171890;201810;1118;3179;846;2720;175;509;473;1581;648;2090
171900;201810;505;1793;368;1450;91;355;130;548;221;903
172000;201810;563;1752;471;1579;68;264;256;820;324;1084
172010;201810;1066;3757;920;3443;84;405;588;2117;672;2522
172015;201810;336;1228;256;1058;52;202;105;459;157;661
172020;201810;2338;7274;2132;6968;182;702;1610;5276;1792;5978
172025;201810;729;2083;532;1750;50;199;329;1065;379;1264
172030;201810;1227;3705;1069;3459;23;105;877;2825;900;2930
172049;201810;1309;3237;863;2561;272;856;384;1135;656;1991
172065;201810;1483;3756;1187;3399;86;193;1011;3016;1097;3209
172080;201810;2298;7023;1875;6232;132;503;1264;4197;1396;4700
172085;201810;483;1355;311;992;47;130;96;298;143;428
172090;201810;4005;10455;3110;9220;131;475;2407;7082;2538;7557
172093;201810;492;1508;367;1280;51;226;192;634;243;860
172097;201810;574;1581;421;1334;65;218;196;646;261;864
172100;201810;46756;119374;31507;94269;6833;22253;9687;30054;16520;52307
172110;201810;1551;5875;1355;5573;146;633;1009;4312;1155;4945
172120;201810;4760;14699;3806;13113;623;2163;1991;7101;2614;9264
172125;201810;305;874;218;725;33;114;114;379;147;493
172130;201810;915;2903;784;2677;25;87;623;2160;648;2247
172208;201810;2412;6256;1944;5614;257;666;1255;3716;1512;4382
172210;201810;2703;7384;2098;6553;433;1422;1100;3462;1533;4884
210005;201810;19482;57993;15544;51517;4702;16218;5845;20310;10547;36528
210010;201810;1790;5879;1633;5631;49;225;1461;5030;1510;5255
210015;201810;3361;10164;3004;9671;140;362;2594;8511;2734;8873
210020;201810;7488;17136;6670;16209;97;244;6215;15107;6312;15351
210030;201810;4815;16099;4574;15758;289;1088;3930;13586;4219;14674
210040;201810;2156;5938;1954;5706;28;53;1840;5441;1868;5494
210043;201810;6458;17774;5325;16390;675;1987;3832;12316;4507;14303
210047;201810;6497;21548;5709;20453;228;1094;4970;17679;5198;18773
210050;201810;2157;7544;1725;6740;219;948;1120;4383;1339;5331
210055;201810;1805;6029;1661;5776;71;286;1367;4714;1438;5000
210060;201810;6884;26391;6152;24928;800;3325;4279;17814;5079;21139
210070;201810;7118;20559;6761;20137;35;116;6521;19532;6556;19648
210080;201810;3980;14048;3872;13911;29;158;3754;13490;3783;13648
210083;201810;5266;16032;4531;15231;77;422;4284;14294;4361;14716
210087;201810;2922;8275;2604;7850;145;359;2187;6785;2332;7144
210090;201810;9428;29840;9003;29115;284;1020;8097;26038;8381;27058
210095;201810;6283;20841;5857;20303;273;1053;4909;17665;5182;18718
210100;201810;6687;20283;6183;19531;256;948;5256;16565;5512;17513
210110;201810;2824;9071;2673;8867;31;148;2515;8327;2546;8475
210120;201810;23299;65317;19953;61068;2589;6668;13546;44292;16135;50960
210125;201810;4034;11665;3696;11235;767;1899;2653;8581;3420;10480
210130;201810;4127;11434;3568;10718;158;421;3060;9234;3218;9655
210135;201810;1422;4446;1271;4204;54;214;1055;3482;1109;3696
210140;201810;16983;49200;13836;44911;2887;9320;7710;25983;10597;35303
210150;201810;4520;11134;4063;10501;112;311;3632;9306;3744;9617
210160;201810;16044;49143;14598;47032;2478;8147;9678;32060;12156;40207
210170;201810;14342;47148;13653;46213;607;2096;12263;41617;12870;43713
210173;201810;2383;8927;2203;8634;56;325;2047;8017;2103;8342
210177;201810;3260;9411;3003;9087;98;196;2744;8572;2842;8768
210180;201810;1416;4032;1287;3851;33;109;1146;3415;1179;3524
210190;201810;4689;14126;4278;13393;97;484;3621;11043;3718;11527
210193;201810;1224;3749;1108;3566;53;174;890;2900;943;3074
210197;201810;1988;6580;1862;6406;171;610;1481;5193;1652;5803
210200;201810;7467;24770;6926;23932;637;2232;5557;19407;6194;21639
210203;201810;7115;21649;6365;20606;599;1902;5123;16914;5722;18816
210207;201810;3438;9921;3104;9483;149;401;2614;8157;2763;8558
210210;201810;8311;27361;7772;26640;107;625;7220;24676;7327;25301
210215;201810;2161;7202;1982;6951;64;317;1755;6126;1819;6443
210220;201810;5981;21252;5707;20767;224;1306;5015;17850;5239;19156
210230;201810;5174;16087;4742;15446;262;697;4147;13701;4409;14398
210232;201810;11311;36448;9419;33698;1497;5523;6119;23148;7616;28671
210235;201810;3550;10658;3132;10110;100;430;2776;8969;2876;9399
210237;201810;2499;8786;2302;8537;24;135;2181;8081;2205;8216
210240;201810;2697;8565;2471;8166;88;354;2155;7045;2243;7399
210250;201810;5437;16986;5013;16459;98;541;4508;14739;4606;15280
210255;201810;2575;8023;2235;7372;276;966;1516;4948;1792;5914
210260;201810;5244;16283;4664;15404;285;1041;3886;12787;4171;13828
210270;201810;4832;13619;4362;12994;98;463;3909;11545;4007;12008
210275;201810;3635;9216;3290;8792;54;110;3098;8374;3152;8484
210280;201810;5438;16178;4517;14734;243;1172;3327;10537;3570;11709
210290;201810;6613;19208;6097;18577;160;489;5520;16870;5680;17359
210300;201810;33627;92424;28303;85462;2159;6408;21193;66816;23352;73224
210310;201810;3044;8009;2735;7588;112;227;2405;6756;2517;6983
210312;201810;2624;7026;2338;6692;50;215;2165;6122;2215;6337
210315;201810;2907;8267;2486;7772;75;194;2226;7146;2301;7340
210317;201810;4007;12869;3709;12526;133;614;3378;11317;3511;11931
210320;201810;18931;60504;17705;58872;459;2172;16040;53115;16499;55287
210325;201810;3452;10316;3059;9756;91;312;2730;8825;2821;9137
210330;201810;26211;74942;21904;69306;5956;17816;10673;38696;16629;56512
210340;201810;10156;31110;9193;29659;918;2910;6871;22800;7789;25710
210350;201810;9246;27403;8310;26189;217;775;7295;23091;7512;23866
210355;201810;4326;15149;3841;14368;140;728;3261;12245;3401;12973
210360;201810;14344;43778;12911;41704;609;2533;10571;33831;11180;36364
210370;201810;10411;23725;8286;21447;290;562;7477;19818;7767;20380
210375;201810;3113;8786;2412;7827;700;2256;1094;3822;1794;6078
210380;201810;5429;14475;4860;13749;246;623;4218;12081;4464;12704
210390;201810;2598;9583;2431;9281;151;724;1998;7543;2149;8267
210400;201810;4569;14426;4185;13932;125;327;3837;12946;3962;13273
210405;201810;7040;19546;5739;17660;1115;3242;3200;10464;4315;13706
210407;201810;1949;6684;1632;6066;124;562;1285;4668;1409;5230
210408;201810;2381;9238;2260;9057;151;757;1832;7371;1983;8128
210409;201810;3676;13020;3375;12592;120;689;2821;10483;2941;11172
210410;201810;3433;10802;2965;10054;242;912;2207;7479;2449;8391
210420;201810;3964;12866;3583;12190;187;597;3022;10381;3209;10978
210430;201810;2209;6584;2070;6409;119;319;1806;5647;1925;5966
210440;201810;4145;11803;3860;11413;78;260;3635;10734;3713;10994
210450;201810;2470;7624;2220;7205;116;430;1838;5919;1954;6349
210455;201810;3914;10722;3143;9757;848;2568;1680;5411;2528;7979
210460;201810;3365;10358;3054;9903;103;403;2658;8590;2761;8993
210462;201810;1506;4967;1335;4644;47;215;1093;3767;1140;3982
210465;201810;2579;7783;2270;7349;89;303;1937;6288;2026;6591
210467;201810;5692;19023;5266;18508;265;1117;4641;16344;4906;17461
210470;201810;2125;5596;1471;4649;82;197;1112;3624;1194;3821
210480;201810;15273;47025;13000;44079;1430;4623;9431;33813;10861;38436
210490;201810;3733;9693;3079;8762;90;275;2675;7602;2765;7877
210500;201810;6045;24577;5697;23931;402;2067;4610;19169;5012;21236
210510;201810;5929;20479;5496;19970;108;538;5012;18382;5120;18920
210515;201810;3668;10990;3260;10544;113;405;2919;9551;3032;9956
210520;201810;2526;7356;2266;7027;94;317;2035;6330;2129;6647
210530;201810;46674;122928;38256;110015;6764;24076;11348;39778;18112;63854
210535;201810;3138;10731;2969;10468;105;394;2569;9164;2674;9558
210540;201810;14429;43620;12228;40621;1488;4699;8738;30238;10226;34937
210542;201810;6142;15583;5199;14523;284;483;4588;13410;4872;13893
210545;201810;2266;7133;2134;6922;51;216;1886;6027;1937;6243
210547;201810;3590;12906;3206;12131;315;1150;2313;9019;2628;10169
210550;201810;5840;17997;4966;16748;351;1234;3961;13655;4312;14889
210560;201810;3444;10800;3162;10302;112;368;2736;8853;2848;9221
210565;201810;1445;5052;1231;4717;75;396;965;3696;1040;4092
210570;201810;11093;30605;10015;29308;291;773;9116;27073;9407;27846
210580;201810;2998;8346;2616;7880;229;431;2107;6704;2336;7135
210590;201810;4249;12894;3743;12211;109;536;3311;10710;3420;11246
210592;201810;2554;7723;2401;7472;31;169;2154;6616;2185;6785
210594;201810;2556;7109;2023;6252;84;216;1566;4983;1650;5199
210596;201810;2359;8642;2198;8305;153;639;1754;6649;1907;7288
210598;201810;1833;5331;1704;5151;37;152;1584;4760;1621;4912
210600;201810;2922;8128;2403;7373;78;212;1985;6166;2063;6378
210610;201810;2472;7532;2232;7237;70;325;1979;6349;2049;6674
210620;201810;2394;7036;2076;6633;63;203;1890;6119;1953;6322
210630;201810;3084;10760;2815;10380;165;823;2312;8384;2477;9207
210632;201810;4180;14088;3806;13517;318;1313;2984;10518;3302;11831
210635;201810;1782;6335;1692;6174;134;444;1411;5278;1545;5722
210637;201810;2332;8061;2120;7733;163;715;1610;5901;1773;6616
210640;201810;5124;19611;5057;19538;31;119;4984;19300;5015;19419
210650;201810;7175;20826;6732;20243;87;337;6377;19126;6464;19463
210660;201810;8386;24489;7486;23099;334;1145;6448;19754;6782;20899
210663;201810;2543;7758;2402;7594;125;323;2121;6897;2246;7220
210667;201810;1872;6219;1766;6053;66;281;1588;5467;1654;5748
210670;201810;4385;15420;4087;14934;157;757;3566;12935;3723;13692
210675;201810;5025;13909;4436;13124;322;777;3670;11206;3992;11983
210680;201810;4071;10610;3453;9848;137;280;3051;8907;3188;9187
210690;201810;7460;24360;6823;23633;255;1041;6094;21316;6349;22357
210700;201810;2725;7612;2264;7028;141;333;1839;6112;1980;6445
210710;201810;4926;15596;4416;14852;130;601;3884;12947;4014;13548
210720;201810;2761;9378;2614;9184;52;284;2410;8384;2462;8668
210725;201810;1298;4544;1150;4290;44;203;813;3135;857;3338
210730;201810;1195;3252;1021;3017;82;220;804;2427;886;2647
210735;201810;4504;13888;3957;13094;308;1048;3299;11064;3607;12112
210740;201810;5222;14395;4632;13761;154;562;3975;11699;4129;12261
210745;201810;4519;12754;4255;12398;153;378;3858;11302;4011;11680
210750;201810;20433;53118;17775;49921;1564;4156;13386;38824;14950;42980
210760;201810;5655;15950;5106;15328;25;95;4958;14886;4983;14981
210770;201810;5992;15869;5224;14996;60;261;4894;14002;4954;14263
210780;201810;7192;23732;6473;22500;622;1988;5015;17812;5637;19800
210790;201810;4520;14463;4185;14025;212;636;3359;11886;3571;12522
210800;201810;4971;13400;4357;12597;72;282;3977;11376;4049;11658
210805;201810;3868;14563;3727;14346;112;633;3355;12808;3467;13441
210810;201810;4951;14837;4571;14349;210;483;4012;12989;4222;13472
210820;201810;7066;20503;6074;18871;819;2584;3854;12197;4673;14781
210825;201810;6473;20529;6067;20000;253;844;5326;17807;5579;18651
210830;201810;7658;22134;7267;21644;498;1044;6306;19557;6804;20601
210840;201810;3290;8838;2971;8395;84;244;2632;7355;2716;7599
210845;201810;6274;17519;5897;17104;23;62;5826;16936;5849;16998
210850;201810;5615;19810;4997;18828;317;1523;3935;14718;4252;16241
210860;201810;18528;51270;16031;47981;808;2240;13311;40942;14119;43182
210870;201810;6595;18682;5830;17766;280;850;5101;15593;5381;16443
210880;201810;4374;13596;3985;13150;241;899;3323;10964;3564;11863
210890;201810;4217;12804;3858;12373;261;679;3220;10689;3481;11368
210900;201810;4734;13908;3615;11897;1395;4920;640;2344;2035;7264
210905;201810;1909;5501;1637;5127;43;95;1480;4706;1523;4801
210910;201810;7169;22396;6210;20804;849;2958;4213;14171;5062;17129
210920;201810;3192;10730;2828;10224;87;436;2506;8998;2593;9434
210923;201810;1413;4523;1280;4309;69;275;987;3308;1056;3583
210927;201810;5110;16182;4570;15584;122;458;4103;14141;4225;14599
210930;201810;2373;8457;2189;8134;121;593;1737;6376;1858;6969
210940;201810;3803;11322;3590;11045;106;481;3256;9827;3362;10308
210945;201810;5913;17849;5566;17432;246;696;4933;15646;5179;16342
210950;201810;5112;15130;4033;13490;629;1816;2657;9403;3286;11219
210955;201810;1631;5260;1454;4968;136;442;1060;3695;1196;4137
210960;201810;8623;26804;7758;25529;1587;4791;4756;16686;6343;21477
210970;201810;1268;4131;1064;3754;72;325;790;2689;862;3014
210975;201810;1656;5435;1519;5192;123;442;1174;4008;1297;4450
210980;201810;10409;23537;9288;22384;131;262;8887;21583;9018;21845
210990;201810;16207;47512;13146;43466;1261;4273;9363;31537;10624;35810
211000;201810;14322;43751;12369;41520;625;2559;10238;35046;10863;37605
211003;201810;5292;16935;4561;16041;182;683;3932;14129;4114;14812
211010;201810;6265;23127;5830;22517;71;441;5375;20858;5446;21299
211020;201810;7894;24952;7407;24336;313;1246;6394;21069;6707;22315
211023;201810;2032;6810;1927;6660;100;396;1628;5577;1728;5973
211027;201810;2659;9368;2612;9283;194;738;2245;7959;2439;8697
211030;201810;3827;11028;3487;10617;273;646;2900;9061;3173;9707
211040;201810;4510;16506;4268;16133;134;746;3787;14221;3921;14967
211050;201810;9501;24339;8732;23377;174;453;8133;21766;8307;22219
211060;201810;6680;21730;6237;21103;155;612;5778;19567;5933;20179
211065;201810;2105;6149;1808;5731;75;242;1530;4927;1605;5169
211070;201810;7406;24864;6586;23526;491;1800;5246;18864;5737;20664
211080;201810;1271;3663;1042;3289;42;235;805;2379;847;2614
211085;201810;1965;6001;1764;5722;101;295;1522;5017;1623;5312
211090;201810;3244;9034;2940;8635;46;223;2686;7792;2732;8015
211100;201810;6501;17035;6167;16580;41;136;5783;15572;5824;15708
211102;201810;2866;10518;2671;10229;164;789;2286;8668;2450;9457
211105;201810;2311;7555;1965;6900;202;724;1366;4771;1568;5495
211107;201810;4432;14163;3905;13404;157;622;3208;11294;3365;11916
211110;201810;5872;16749;4605;14751;571;1699;3172;10481;3743;12180
211120;201810;37327;102340;34584;99036;4597;12027;24263;73221;28860;85248
211125;201810;1986;6097;1712;5661;61;243;1458;4811;1519;5054
211130;201810;181715;461374;169017;445064;25304;66840;78195;232965;103499;299805
211140;201810;4872;15122;4418;14466;220;657;3795;12463;4015;13120
211150;201810;9157;26090;8088;24714;315;1045;6945;21263;7260;22308
211153;201810;2530;7591;2102;7052;319;1122;1400;4886;1719;6008
211157;201810;1080;3480;907;3188;38;222;645;2243;683;2465
211160;201810;3787;11675;3154;10637;179;785;2377;7820;2556;8605
211163;201810;1781;5826;1654;5640;16;79;1556;5363;1572;5442
211167;201810;1545;5030;1447;4876;28;136;1346;4508;1374;4644
211170;201810;6116;15543;5831;15198;52;174;5609;14555;5661;14729
211172;201810;2434;6869;2114;6353;89;301;1748;5074;1837;5375
211174;201810;2729;8240;2549;8003;64;315;2308;7161;2372;7476
211176;201810;4074;12323;3296;11195;219;900;2554;8610;2773;9510
211178;201810;4624;10862;4058;10215;34;150;3839;9549;3873;9699
211180;201810;4005;13639;3753;13257;207;822;3224;11397;3431;12219
211190;201810;3029;9149;2640;8543;45;225;2312;7409;2357;7634
211195;201810;1378;4029;1183;3753;88;220;968;3185;1056;3405
211200;201810;2050;6215;1697;5741;187;662;1175;4035;1362;4697
211210;201810;6396;19837;5928;19188;293;1020;5144;16668;5437;17688
211220;201810;34708;92332;29584;85977;3202;9160;21509;64171;24711;73331
211223;201810;4836;14176;4310;13374;511;1448;3155;10069;3666;11517
211227;201810;1707;5857;1565;5642;47;240;1360;4927;1407;5167
211230;201810;7044;22028;6456;21061;472;1499;5185;17039;5657;18538
211240;201810;8093;26501;7677;25962;149;791;7042;23537;7191;24328
211245;201810;6489;17077;6188;16767;66;159;6062;16452;6128;16611
211250;201810;13483;40554;12386;39197;512;2094;10692;33371;11204;35465
211260;201810;7719;25415;7114;24599;209;889;6486;22514;6695;23403
211270;201810;10220;33512;9033;31890;361;1754;7528;26645;7889;28399
211280;201810;13052;37295;11818;35699;948;2311;9577;30162;10525;32473
211285;201810;1607;5798;1437;5495;226;910;787;3108;1013;4018
211290;201810;7027;22335;6574;21693;209;900;5685;18624;5894;19524
211300;201810;7974;22927;7290;22008;141;423;6784;20535;6925;20958
211400;201810;11126;33659;9344;31002;1568;5187;5712;20095;7280;25282
220005;201810;1826;4980;1647;4706;40;162;1359;3790;1399;3952
220010;201810;1480;4234;1245;3820;31;137;977;2952;1008;3089
220020;201810;3295;9904;2961;9348;292;977;2238;6999;2530;7976
220025;201810;2196;5115;1885;4635;29;84;1591;3797;1620;3881
220027;201810;1212;3211;1061;3006;31;105;871;2431;902;2536
220030;201810;3347;8943;3189;8703;113;331;2793;7503;2906;7834
220040;201810;6871;21099;6206;19837;1230;3818;3804;12374;5034;16192
220045;201810;1449;4550;1238;4172;41;224;985;3236;1026;3460
220050;201810;4469;12830;3828;11874;116;501;3384;10383;3500;10884
220060;201810;2356;5106;1999;4690;32;84;1869;4363;1901;4447
220070;201810;2476;6506;2151;6021;95;216;1773;4967;1868;5183
220080;201810;688;1987;603;1855;32;127;510;1518;542;1645
220090;201810;1789;4371;1490;3946;16;59;1278;3443;1294;3502
220095;201810;649;1705;615;1664;15;33;565;1531;580;1564
220100;201810;1329;3820;1084;3385;49;209;869;2624;918;2833
220105;201810;2008;6360;1764;5848;153;510;1286;4272;1439;4782
220110;201810;3404;9479;3188;9094;48;230;2829;7926;2877;8156
220115;201810;2622;8096;2441;7817;74;315;2202;6933;2276;7248
220117;201810;1357;3383;1051;2926;19;72;890;2420;909;2492
220120;201810;11664;33595;10778;32435;115;483;10186;30545;10301;31028
220130;201810;1068;3055;911;2820;17;118;815;2460;832;2578
220140;201810;1895;4302;1638;3983;157;413;1383;3318;1540;3731
220150;201810;6430;19294;6032;18668;139;695;5191;15680;5330;16375
220155;201810;1106;3253;869;2813;23;97;615;1936;638;2033
220157;201810;1042;2614;871;2333;18;78;702;1806;720;1884
220160;201810;2678;7819;2334;7165;50;263;1928;5759;1978;6022
220170;201810;1404;3862;1199;3558;12;60;1069;3127;1081;3187
220173;201810;1996;5771;1610;5041;37;166;1320;3997;1357;4163
220177;201810;1910;5528;1856;5464;13;40;1810;5340;1823;5380
220180;201810;1135;2884;893;2426;9;45;672;1712;681;1757
220190;201810;5854;16232;5059;15110;425;1369;3776;11274;4201;12643
220191;201810;1387;4475;1279;4284;76;325;942;3081;1018;3406
220192;201810;1814;5016;1441;4347;31;115;1153;3404;1184;3519
220194;201810;1707;4982;1520;4662;65;259;1242;3699;1307;3958
220196;201810;1905;5245;1735;4964;40;183;1464;4072;1504;4255
220198;201810;1242;3538;1045;3272;8;20;981;3113;989;3133
220200;201810;4748;14393;4297;13794;274;969;3519;11278;3793;12247
220202;201810;2160;6156;1859;5620;32;151;1577;4657;1609;4808
220205;201810;2526;7120;2255;6680;40;171;1940;5644;1980;5815
220207;201810;799;2427;676;2204;60;219;446;1439;506;1658
220208;201810;1698;5320;1372;4660;260;945;664;2244;924;3189
220209;201810;1595;4641;1379;4270;28;127;1118;3417;1146;3544
220210;201810;1570;4111;1354;3746;21;95;1128;3011;1149;3106
220211;201810;1544;4078;1445;3950;16;62;1285;3523;1301;3585
220213;201810;1717;4711;1499;4287;31;123;1206;3317;1237;3440
220217;201810;2024;6238;1925;6119;43;142;1805;5788;1848;5930
220220;201810;10166;27202;8571;24683;570;1530;6177;18174;6747;19704
220225;201810;1111;2928;907;2665;8;26;823;2391;831;2417
220230;201810;5659;14224;4927;13243;214;561;4243;11435;4457;11996
220240;201810;2930;8742;2682;8251;93;334;2182;6686;2275;7020
220245;201810;1585;4008;1289;3624;12;54;1157;3289;1169;3343
220250;201810;2735;8126;2433;7722;27;143;2196;6920;2223;7063
220253;201810;1647;4537;1401;4100;74;227;1159;3304;1233;3531
220255;201810;1857;4632;1563;4173;34;158;1302;3315;1336;3473
220260;201810;4214;13259;3716;12392;180;650;2979;9907;3159;10557
220265;201810;1230;4064;1121;3896;53;226;888;3044;941;3270
220270;201810;6386;20249;6017;19584;295;1204;5062;16006;5357;17210
220271;201810;1473;3878;1274;3585;44;144;1107;3114;1151;3258
220272;201810;1708;4954;1517;4594;54;185;1159;3409;1213;3594
220273;201810;1200;3465;1000;3090;40;152;761;2296;801;2448
220275;201810;2219;5444;1712;4735;44;161;1484;4064;1528;4225
220277;201810;2072;5429;1805;5003;30;106;1545;4196;1575;4302
220280;201810;1584;3961;1334;3584;38;126;1125;2932;1163;3058
220285;201810;1503;3912;1262;3599;19;93;1125;3158;1144;3251
220290;201810;5874;17903;4831;16421;362;1380;3592;12243;3954;13623
220300;201810;1903;5814;1574;5351;48;295;1301;4297;1349;4592
220310;201810;2813;7990;2304;7402;47;238;1986;6301;2033;6539
220320;201810;2923;8782;2340;7669;130;554;1768;5641;1898;6195
220323;201810;1585;4982;1296;4504;85;333;1028;3545;1113;3878
220325;201810;1263;3791;1076;3455;36;161;881;2791;917;2952
220327;201810;1416;4212;1257;3943;53;236;1022;3117;1075;3353
220330;201810;4060;10336;3429;9512;128;385;2915;8024;3043;8409
220335;201810;1779;5345;1583;5116;28;92;1436;4642;1464;4734
220340;201810;1824;4858;1447;4235;52;186;1022;2863;1074;3049
220342;201810;1166;3528;1040;3339;44;197;822;2599;866;2796
220345;201810;3078;7100;2485;6275;15;39;2332;5861;2347;5900
220350;201810;3358;8858;2712;7808;150;478;2001;5672;2151;6150
220360;201810;1239;3194;995;2807;19;59;795;2213;814;2272
220370;201810;8878;25396;8056;24193;199;835;7165;21251;7364;22086
220375;201810;1498;4504;1383;4344;9;31;1344;4228;1353;4259
220380;201810;1524;3703;1258;3315;26;80;1094;2839;1120;2919
220385;201810;792;1938;638;1655;10;35;553;1408;563;1443
220390;201810;8525;24347;7113;21901;1857;5691;2956;9680;4813;15371
220400;201810;1484;3659;1126;3090;31;94;856;2278;887;2372
220410;201810;1161;3257;961;2912;54;153;769;2288;823;2441
220415;201810;803;2142;683;1946;18;56;523;1460;541;1516
220420;201810;1968;5552;1606;4849;58;163;1240;3690;1298;3853
220430;201810;2504;6740;2405;6599;73;218;2137;5798;2210;6016
220435;201810;1685;4598;1500;4306;59;204;1179;3305;1238;3509
220440;201810;2402;7752;2095;7226;126;488;1718;5832;1844;6320
220450;201810;2307;6351;1912;5827;173;614;1477;4459;1650;5073
220455;201810;1301;4062;1233;3972;27;125;1109;3541;1136;3666
220460;201810;935;2377;842;2267;34;114;740;1937;774;2051
220465;201810;2274;7288;2045;6931;157;578;1578;5376;1735;5954
220470;201810;3427;9814;3089;9260;95;316;2534;7475;2629;7791
220480;201810;2484;6687;2004;5889;142;358;1448;4185;1590;4543
220490;201810;2332;6161;2138;5917;37;163;1909;5199;1946;5362
220500;201810;2528;6859;2323;6518;50;210;1931;5215;1981;5425
220510;201810;2594;7580;2111;6716;96;283;1661;5290;1757;5573
220515;201810;1685;4077;1506;3827;42;90;1328;3361;1370;3451
220520;201810;4977;13049;4490;12330;105;321;3982;10874;4087;11195
220525;201810;1271;3379;1152;3212;13;51;1042;2859;1055;2910
220527;201810;1307;3717;1154;3462;20;66;986;2974;1006;3040
220530;201810;1287;3427;1152;3239;26;98;1071;2960;1097;3058
220535;201810;785;2250;723;2169;42;145;589;1746;631;1891
220540;201810;3320;10480;3128;10134;103;398;2731;8796;2834;9194
220545;201810;1362;4325;1270;4148;88;353;1042;3332;1130;3685
220550;201810;8584;26726;7763;25308;606;2137;5820;18712;6426;20849
220551;201810;1418;4228;1244;3930;38;148;998;3090;1036;3238
220552;201810;1529;4530;1283;4044;38;173;1030;3146;1068;3319
220553;201810;1571;4339;1342;3982;55;127;1074;3274;1129;3401
220554;201810;848;2301;628;1928;37;102;439;1328;476;1430
220555;201810;1985;6505;1850;6267;61;288;1532;5138;1593;5426
220556;201810;1264;3766;1089;3395;62;243;765;2262;827;2505
220557;201810;1554;4799;1319;4306;88;340;944;2993;1032;3333
220558;201810;1381;3646;1080;3224;22;102;915;2687;937;2789
220559;201810;1617;4224;1392;3872;5;31;1142;3206;1147;3237
220560;201810;1742;4009;1408;3562;36;77;1248;3156;1284;3233
220570;201810;7165;22014;6572;21100;507;1707;5174;16578;5681;18285
220580;201810;6775;19204;6321;18463;125;452;5675;16396;5800;16848
220585;201810;1896;6259;1714;5913;62;254;1406;4824;1468;5078
220590;201810;1273;3591;1066;3278;107;328;768;2370;875;2698
220595;201810;2444;6771;2254;6518;12;66;2093;5994;2105;6060
220600;201810;1406;3154;1174;2857;125;195;950;2395;1075;2590
220605;201810;1656;4838;1427;4436;25;113;1131;3424;1156;3537
220610;201810;2815;8804;2649;8570;35;169;2448;7897;2483;8066
220620;201810;7860;24766;7325;24011;213;1016;6606;21362;6819;22378
220630;201810;367;1096;289;959;38;128;179;609;217;737
220635;201810;1637;5260;1447;4857;67;275;1074;3532;1141;3807
220640;201810;2647;7288;2249;6685;99;368;1860;5430;1959;5798
220650;201810;2026;5753;1720;5218;50;170;1379;4130;1429;4300
220660;201810;2638;8316;2293;7744;94;466;1892;6182;1986;6648
220665;201810;1267;3955;1109;3691;28;152;925;3020;953;3172
220667;201810;1619;5174;1447;4856;78;304;1136;3803;1214;4107
220669;201810;1676;5219;1614;5107;81;365;1355;4189;1436;4554
220670;201810;2181;5837;1763;5276;33;113;1538;4560;1571;4673
220672;201810;3047;7678;2500;7017;127;357;2171;6077;2298;6434
220675;201810;1202;3361;1105;3176;48;134;883;2514;931;2648
220680;201810;2624;7333;2517;7176;122;282;2256;6470;2378;6752
220690;201810;1489;4072;1322;3799;119;294;998;2911;1117;3205
220695;201810;893;2510;822;2376;13;47;708;2016;721;2063
220700;201810;8996;23229;7237;20701;350;1059;5579;15803;5929;16862
220710;201810;855;2434;646;2028;39;109;471;1455;510;1564
220720;201810;2060;5061;1856;4769;25;87;1602;4064;1627;4151
220730;201810;1241;3591;1061;3294;22;102;895;2714;917;2816
220735;201810;977;2333;751;1967;26;74;628;1594;654;1668
220740;201810;1404;3937;1135;3580;38;125;956;3034;994;3159
220750;201810;3673;9881;3309;9337;219;566;2853;8066;3072;8632
220755;201810;1199;3086;1009;2783;30;104;800;2120;830;2224
220760;201810;2976;8771;2631;8294;119;380;2246;7179;2365;7559
220770;201810;20191;63747;17517;58857;6121;21282;5867;20425;11988;41707
220775;201810;1109;2949;1031;2850;14;53;998;2749;1012;2802
220777;201810;1622;4229;1260;3629;45;118;931;2670;976;2788
220779;201810;1333;3293;1182;3080;27;87;1022;2632;1049;2719
220780;201810;5649;14569;4861;13273;244;781;3907;10367;4151;11148
220785;201810;1432;3232;1289;3027;14;19;1234;2901;1248;2920
220790;201810;10064;29172;9089;27758;298;1370;7698;23055;7996;24425
220793;201810;849;2301;707;2051;24;74;581;1689;605;1763
220795;201810;1404;3704;1256;3509;25;106;1120;3088;1145;3194
220800;201810;16576;40362;13993;36626;835;2188;10104;26079;10939;28267
220810;201810;2946;8424;2552;7698;55;219;2118;6252;2173;6471
220820;201810;5191;13581;4462;12550;428;1079;3259;9179;3687;10258
220830;201810;7023;19176;6375;18226;260;838;5395;15283;5655;16121
220840;201810;12113;37735;10404;34199;2369;7472;5138;17445;7507;24917
220850;201810;2988;9585;2735;9260;66;372;2445;8170;2511;8542
220855;201810;589;1655;520;1539;13;63;444;1278;457;1341
220860;201810;1009;2512;871;2296;15;49;783;2041;798;2090
220865;201810;2548;6847;1993;5873;64;220;1519;4366;1583;4586
220870;201810;2720;8079;2267;7459;40;208;2058;6710;2098;6918
220880;201810;5098;12539;4556;11874;69;221;4225;10927;4294;11148
220885;201810;1290;4256;1108;3940;56;274;872;3079;928;3353
220887;201810;1444;3242;1227;2953;8;30;1153;2738;1161;2768
220890;201810;1474;4790;1265;4388;86;320;975;3380;1061;3700
220900;201810;1983;4922;1662;4475;40;94;1446;3845;1486;3939
220910;201810;1478;4246;1256;3917;53;178;1037;3203;1090;3381
220915;201810;973;2635;769;2235;14;55;611;1710;625;1765
220920;201810;1348;4526;1157;4254;80;371;921;3345;1001;3716
220930;201810;1570;4548;1381;4255;32;127;1239;3766;1271;3893
220935;201810;1033;2983;808;2513;34;129;540;1561;574;1690
220937;201810;1336;3670;1164;3395;29;115;949;2696;978;2811
220940;201810;1425;4173;1173;3675;32;141;888;2698;920;2839
220945;201810;413;1453;371;1370;26;139;265;936;291;1075
220950;201810;1392;3317;901;2516;16;60;712;1911;728;1971
220955;201810;1557;4088;1361;3752;38;95;1169;3228;1207;3323
220960;201810;840;2135;651;1835;15;60;495;1341;510;1401
220965;201810;1752;4859;1555;4569;20;126;1342;3840;1362;3966
220970;201810;1801;4636;1386;3969;43;115;1105;3156;1148;3271
220975;201810;700;2115;610;1997;19;127;543;1683;562;1810
220980;201810;1152;3327;1046;3160;36;150;871;2580;907;2730
220985;201810;1161;3238;1052;3074;44;166;819;2276;863;2442
220987;201810;1485;4430;1286;4087;59;253;1050;3263;1109;3516
220990;201810;1691;4788;1480;4450;31;163;1221;3564;1252;3727
220995;201810;1175;3510;922;3068;56;215;655;2171;711;2386
220997;201810;2412;7078;2250;6842;56;238;2034;6092;2090;6330
221000;201810;4024;11589;3730;11133;104;500;3177;9257;3281;9757
221005;201810;1404;3930;1279;3703;47;182;1067;2959;1114;3141
221010;201810;1201;2911;988;2642;28;60;854;2254;882;2314
221020;201810;1531;4752;1400;4485;30;137;1058;3308;1088;3445
221030;201810;1555;4177;1346;3881;35;145;1159;3296;1194;3441
221035;201810;1396;3755;1243;3547;27;51;1106;3233;1133;3284
221037;201810;598;1772;515;1623;10;53;342;1011;352;1064
221038;201810;524;1486;413;1275;19;63;293;894;312;957
221039;201810;867;2360;771;2205;19;84;642;1758;661;1842
221040;201810;4145;12624;3715;11856;169;602;2956;9406;3125;10008
221050;201810;3732;10097;3364;9627;57;227;3082;8743;3139;8970
221060;201810;8360;23247;6962;21037;272;849;5497;16881;5769;17730
221062;201810;1162;3908;1013;3620;49;243;808;2818;857;3061
221063;201810;1154;3366;987;3110;75;275;708;2156;783;2431
221065;201810;2621;6814;2304;6264;30;119;2035;5427;2065;5546
221070;201810;3298;10524;2764;9448;314;1084;1790;6175;2104;7259
221080;201810;3463;8506;2805;7522;56;220;2328;6135;2384;6355
221090;201810;1413;3746;1148;3273;16;65;992;2746;1008;2811
221093;201810;1359;3907;1258;3700;127;377;848;2437;975;2814
221095;201810;891;2352;751;2135;5;13;624;1745;629;1758
221097;201810;828;2186;637;1831;29;96;457;1254;486;1350
221100;201810;101681;281601;88462;259236;13640;41643;54732;157312;68372;198955
221110;201810;9866;29940;9169;29008;212;1105;8158;25323;8370;26428
221120;201810;4323;12669;3944;12029;225;782;3327;10057;3552;10839
221130;201810;4912;13156;3702;10748;890;2562;1625;4723;2515;7285
221135;201810;1589;4403;1433;4190;44;156;1258;3631;1302;3787
221140;201810;1286;3137;1127;2909;10;36;1007;2532;1017;2568
221150;201810;1102;2739;877;2343;21;93;697;1738;718;1831
221160;201810;791;1973;699;1848;31;61;566;1499;597;1560
221170;201810;999;2954;922;2823;18;55;780;2384;798;2439
230010;201810;3172;8501;2566;7412;126;431;1952;5498;2078;5929
230015;201810;2884;9617;2645;9148;245;979;1830;6209;2075;7188
230020;201810;12819;40941;12279;40061;412;1711;10565;34016;10977;35727
230030;201810;12389;32307;10790;30024;243;697;9534;26489;9777;27186
230040;201810;4352;11477;3670;10350;97;391;3002;8317;3099;8708
230050;201810;2734;8711;2004;6878;370;1236;773;2617;1143;3853
230060;201810;2348;6512;1884;5605;46;203;1532;4450;1578;4653
230070;201810;3952;10916;3246;9505;184;615;2199;6418;2383;7033
230075;201810;8964;29377;8345;28265;373;1860;6873;22622;7246;24482
230080;201810;2888;6240;2221;5367;19;80;1977;4748;1996;4828
230090;201810;4092;10567;3533;9662;172;530;2745;7394;2917;7924
230100;201810;17489;47235;15678;44637;1534;4610;10734;30525;12268;35135
230110;201810;12046;36501;10553;33465;1880;5945;5746;18315;7626;24260
230120;201810;7360;20362;6481;18879;599;1574;4707;13983;5306;15557
230125;201810;3065;8340;2515;7427;89;322;1940;5670;2029;5992
230130;201810;5579;17621;4635;15544;578;2045;2878;9433;3456;11478
230140;201810;3463;10498;2943;9492;125;510;2187;6874;2312;7384
230150;201810;1605;4816;1352;4253;234;663;741;2425;975;3088
230160;201810;6394;17124;5584;15867;155;594;4693;13087;4848;13681
230170;201810;5888;17266;5086;15722;302;1013;3729;11314;4031;12327
230180;201810;1636;4630;1394;4137;26;120;1094;3122;1120;3242
230185;201810;4108;12358;3550;11360;312;1090;2574;8216;2886;9306
230190;201810;12709;37907;10898;34463;1737;5619;5827;18527;7564;24146
230195;201810;5088;15138;4544;14174;349;1152;3523;10887;3872;12039
230200;201810;4916;13623;4245;12320;156;481;3318;9420;3474;9901
230205;201810;3958;12400;3577;11723;175;750;2729;8739;2904;9489
230210;201810;9916;25074;8464;23006;467;1484;6363;17080;6830;18564
230220;201810;13025;34339;11796;32375;486;1472;9848;26655;10334;28127
230230;201810;6797;20806;6132;19421;454;1493;4466;14035;4920;15528
230240;201810;12553;33871;11176;31632;372;1206;9275;25939;9647;27145
230250;201810;8783;25663;8639;25439;318;1146;7008;20147;7326;21293
230260;201810;13815;43440;12477;40785;1620;5456;7509;24688;9129;30144
230270;201810;7403;20653;5965;17893;553;1661;3944;11864;4497;13525
230280;201810;20192;55383;16902;49747;697;2767;13272;37670;13969;40437
230290;201810;4668;13288;3977;11908;366;984;2942;8867;3308;9851
230300;201810;4469;12489;4206;12102;92;389;3729;10510;3821;10899
230310;201810;4648;13386;3957;12185;151;612;2838;8494;2989;9106
230320;201810;7576;22069;6603;20215;318;1209;5040;15107;5358;16316
230330;201810;4639;12867;3825;11298;177;549;2854;8287;3031;8836
230340;201810;3512;11244;3013;10211;296;1046;2039;6843;2335;7889
230350;201810;17991;50952;16093;47771;1081;3698;10561;31561;11642;35259
230360;201810;2828;7887;2278;6840;154;510;1558;4618;1712;5128
230365;201810;3061;7738;2565;6949;53;250;2153;5729;2206;5979
230370;201810;52908;155103;45806;143874;8765;28018;24145;77961;32910;105979
230380;201810;6393;17903;5099;15450;167;626;3733;11113;3900;11739
230390;201810;3268;9950;2877;9286;130;537;2192;6958;2322;7495
230393;201810;2960;9235;2472;8224;99;520;1914;6101;2013;6621
230395;201810;5615;15515;4915;14278;426;1183;3400;9948;3826;11131
230400;201810;5683;16090;5048;14985;151;708;4022;11498;4173;12206
230410;201810;14377;43416;11757;38257;1195;4063;7554;24626;8749;28689
230420;201810;25685;74607;21812;67234;2818;9083;12542;38314;15360;47397
230423;201810;4696;14059;4099;12840;109;487;3301;10122;3410;10609
230425;201810;5334;16920;4905;15991;474;1597;3490;11306;3964;12903
230426;201810;2596;7021;1949;5740;42;165;1491;4312;1533;4477
230427;201810;1848;5287;1267;3958;68;221;880;2646;948;2867
230428;201810;9597;26544;8511;24836;1205;3597;5121;14908;6326;18505
230430;201810;4511;13297;3747;11905;183;672;2851;8848;3034;9520
230435;201810;5461;15090;4698;13762;546;1632;3005;8764;3551;10396
230440;201810;388325;1012982;327429;917260;46856;137370;188742;524995;235598;662365
230445;201810;4305;11559;3588;10293;213;564;2515;7076;2728;7640
230450;201810;3469;10414;3069;9720;244;957;2253;6984;2497;7941
230460;201810;2062;5920;1803;5483;79;310;1481;4460;1560;4770
230465;201810;3957;11316;3372;10234;102;447;2489;7264;2591;7711
230470;201810;11080;37427;10099;35514;921;3864;7346;25352;8267;29216
230480;201810;1394;4176;1193;3794;107;424;866;2633;973;3057
230490;201810;2366;6823;2042;6218;190;616;1247;3647;1437;4263
230495;201810;5795;17542;5131;16316;452;1755;3326;10336;3778;12091
230500;201810;8587;28890;8028;27786;366;1504;6388;22031;6754;23535
230510;201810;1591;5104;1180;4132;212;784;501;1740;713;2524
230520;201810;4364;12759;3865;11794;319;984;2742;8288;3061;9272
230523;201810;14647;44072;12007;38351;2812;9006;3182;10685;5994;19691
230526;201810;3847;11224;3281;10174;150;607;2498;7562;2648;8169
230530;201810;5232;16418;4497;15028;406;1476;3136;10476;3542;11952
230533;201810;4080;10510;3510;9469;113;305;2898;7749;3011;8054
230535;201810;5396;15189;4576;13732;281;834;3196;9733;3477;10567
230540;201810;15676;43998;13929;41313;292;1208;12001;35026;12293;36234
230550;201810;19759;54596;16465;48730;1866;5809;9890;29013;11756;34822
230560;201810;7701;19816;6360;17484;91;353;5336;14470;5427;14823
230565;201810;3097;8595;2573;7642;73;301;1966;5742;2039;6043
230570;201810;3543;9041;3066;8414;70;203;2597;7084;2667;7287
230580;201810;9944;27409;8856;25798;357;1223;7453;21516;7810;22739
230590;201810;8801;25806;7340;23016;526;1854;5206;15827;5732;17681
230600;201810;3641;9656;2762;7952;93;298;1848;5369;1941;5667
230610;201810;6440;18333;5782;17290;533;1497;4359;13106;4892;14603
230620;201810;2092;5769;1591;4742;133;433;960;2769;1093;3202
230625;201810;7836;23308;6800;21256;2090;6786;1800;5902;3890;12688
230630;201810;10155;31275;9040;28932;2212;6619;4160;14147;6372;20766
230640;201810;26827;82877;24566;79122;1632;6188;19365;61570;20997;67758
230650;201810;4914;13945;4213;12621;184;685;3282;9597;3466;10282
230655;201810;9167;32101;8743;31331;681;2714;6824;24534;7505;27248
230660;201810;6166;18398;5066;16323;182;970;4079;12782;4261;13752
230670;201810;6044;14867;4476;12216;176;540;3536;9415;3712;9955
230680;201810;2527;7163;2174;6498;185;563;1491;4463;1676;5026
230690;201810;6653;20300;5952;18801;520;1835;3659;11325;4179;13160
230700;201810;9372;24794;8060;22327;349;1087;6143;16548;6492;17635
230710;201810;6898;21753;5999;19895;579;2026;4214;13764;4793;15790
230720;201810;1909;5720;1578;5011;122;380;1061;3299;1183;3679
230725;201810;3721;11766;3281;10801;547;1928;1555;5011;2102;6939
230730;201810;53814;152123;44363;136750;10578;35077;15448;49845;26026;84922
230740;201810;5985;17100;5255;15860;145;579;4215;12611;4360;13190
230750;201810;8349;22756;6977;20451;191;729;5521;15707;5712;16436
230760;201810;11222;30642;9997;28635;704;2314;7386;20635;8090;22949
230763;201810;4403;12698;3799;11544;157;643;2986;8776;3143;9419
230765;201810;38989;111533;33220;101472;6605;21033;14039;43003;20644;64036
230770;201810;25342;66042;21737;61016;2861;8371;13471;37879;16332;46250
230780;201810;5874;21214;5528;20496;866;3239;3252;12399;4118;15638
230790;201810;2905;8591;2601;8069;143;554;1949;5897;2092;6451
230800;201810;7599;25096;6872;23565;838;3215;4083;13727;4921;16942
230810;201810;11557;35316;10431;33400;462;1796;8030;25153;8492;26949
230820;201810;3143;10449;2692;9430;306;1227;1624;5448;1930;6675
230830;201810;7446;20977;6409;19119;166;696;5226;15214;5392;15910
230835;201810;4147;10074;3172;8514;109;332;2586;6805;2695;7137
230837;201810;3109;9862;2673;9014;134;650;2054;6690;2188;7340
230840;201810;8930;26875;7825;25008;573;1967;5897;18819;6470;20786
230850;201810;9093;27256;7988;25007;487;1666;5686;17649;6173;19315
230860;201810;5154;13543;4337;12325;113;392;3713;10405;3826;10797
230870;201810;16681;41526;14425;37962;505;1437;11615;30315;12120;31752
230880;201810;2020;6331;1873;6082;67;341;1488;4688;1555;5029
230890;201810;4363;14456;4053;13837;354;1331;2941;9898;3295;11229
230900;201810;3020;9060;2547;8082;258;880;1625;5007;1883;5887
230910;201810;2941;8273;2419;7356;79;372;1923;5718;2002;6090
230920;201810;4425;12691;3857;11780;160;625;3042;9087;3202;9712
230930;201810;6438;18629;5396;16578;406;1322;3687;11240;4093;12562
230940;201810;7691;20464;6791;19033;211;643;5653;15700;5864;16343
230945;201810;6535;19024;5662;17232;404;1358;3911;11833;4315;13191
230950;201810;6218;15880;5671;15190;140;315;5094;13851;5234;14166
230960;201810;13143;39224;11879;36809;1928;6079;5975;18758;7903;24837
230970;201810;13106;36817;11307;33857;2208;6823;5516;16622;7724;23445
230980;201810;2676;7993;2342;7378;494;1482;1303;4283;1797;5765
230990;201810;1677;4809;1403;4265;82;327;965;2800;1047;3127
231000;201810;2509;6747;2064;5837;83;231;1478;4087;1561;4318
231010;201810;3174;7926;2628;7001;100;323;2142;5539;2242;5862
231020;201810;7677;25065;7017;23617;1261;4006;4125;14400;5386;18406
231025;201810;7237;20892;6433;19525;894;2712;4279;13100;5173;15812
231030;201810;6980;21419;5644;18526;968;3179;2992;9828;3960;13007
231040;201810;3106;9122;2691;8331;98;395;2086;6311;2184;6706
231050;201810;11727;31097;9452;26966;668;1875;6991;19584;7659;21459
231060;201810;2549;7555;2311;7149;83;313;1886;5813;1969;6126
231070;201810;7874;23445;6771;21410;928;2989;4012;12691;4940;15680
231080;201810;3921;11449;3481;10687;131;627;2708;8034;2839;8661
231085;201810;5858;15618;5091;14632;311;880;3833;11095;4144;11975
231090;201810;4228;11382;3203;9290;115;430;2262;6339;2377;6769
231095;201810;2101;6488;1741;5653;154;552;1197;3841;1351;4393
231100;201810;2918;8754;2480;7933;145;492;1857;5927;2002;6419
231110;201810;3393;10473;3261;10227;190;692;2395;7400;2585;8092
231120;201810;2077;6366;1788;5833;109;406;1208;3889;1317;4295
231123;201810;1891;5001;1588;4442;75;208;1198;3313;1273;3521
231126;201810;5550;15606;4439;13423;219;722;3241;9592;3460;10314
231130;201810;19308;53644;16825;50118;1506;5232;11749;34664;13255;39896
231135;201810;4174;11850;3510;10607;157;557;2536;7526;2693;8083
231140;201810;16611;48181;13789;42999;810;3316;9596;28933;10406;32249
231150;201810;5327;15196;4349;13213;808;2454;1947;6008;2755;8462
231160;201810;5825;18325;5301;17292;1100;3411;2864;9689;3964;13100
231170;201810;4333;13063;3573;11491;226;822;2446;7603;2672;8425
231180;201810;13492;39423;11479;35042;2850;8734;4527;13900;7377;22634
231190;201810;3789;10895;3252;9844;121;498;2575;7535;2696;8033
231195;201810;4532;14392;3892;13025;191;845;2915;9489;3106;10334
231200;201810;7735;24863;6751;22772;264;1320;5163;16824;5427;18144
231210;201810;4636;14140;4027;13041;187;736;3082;9714;3269;10450
231220;201810;11765;31619;9395;26978;541;1607;6835;18948;7376;20555
231230;201810;9097;29159;8133;27521;556;2167;6033;20446;6589;22613
231240;201810;11475;34429;10289;32028;1738;5382;5850;18358;7588;23740
231250;201810;2035;5389;1354;3827;107;315;799;2198;906;2513
231260;201810;3192;9358;2805;8722;314;969;1845;5859;2159;6828
231270;201810;6349;16890;5380;15267;142;579;4156;11488;4298;12067
231280;201810;1611;5124;1516;4936;141;481;1120;3631;1261;4112
231290;201810;36108;110931;31407;101098;5566;18141;14670;46896;20236;65037
231300;201810;3944;11189;3155;9572;260;842;2018;5988;2278;6830
231310;201810;7161;19335;5865;16804;586;1658;3819;10816;4405;12474
231320;201810;7495;21189;5985;18323;118;533;4650;14031;4768;14564
231325;201810;2485;6935;2076;6241;353;1026;1177;3586;1530;4612
231330;201810;9894;30483;8274;27157;1664;5374;4194;14108;5858;19482
231335;201810;5669;15108;4793;13640;99;452;4140;11554;4239;12006
231340;201810;17154;53933;15510;51148;1266;4261;11503;38291;12769;42552
231350;201810;15474;42767;14084;40800;341;1195;12615;36225;12956;37420
231355;201810;4441;13570;3990;12759;209;768;3066;9705;3275;10473
231360;201810;7357;22740;6471;21160;429;1542;4839;15755;5268;17297
231370;201810;2277;6164;1811;5333;39;116;1397;4079;1436;4195
231375;201810;4322;13718;3956;13044;148;670;3278;10621;3426;11291
231380;201810;5775;15870;5336;15315;210;558;4454;12980;4664;13538
231390;201810;3288;9817;2965;9264;193;710;2149;6522;2342;7232
231395;201810;3900;11896;3289;10885;582;1942;1797;6052;2379;7994
231400;201810;8915;26335;7917;24440;347;1371;6113;18492;6460;19863
231410;201810;14964;46964;13321;44165;792;2966;10432;34104;11224;37070
240010;201810;2481;6834;1933;5775;200;682;1203;3466;1403;4148
240020;201810;11188;32899;9758;30257;887;3225;6278;19085;7165;22310
240030;201810;2664;7002;2502;6762;119;354;2174;5793;2293;6147
240040;201810;813;2315;669;2042;16;78;497;1457;513;1535
240050;201810;3162;8563;2660;7643;57;175;2114;5951;2171;6126
240060;201810;1377;3750;1170;3365;36;119;947;2669;983;2788
240070;201810;2151;6496;1989;6153;212;696;1482;4514;1694;5210
240080;201810;2683;7423;2348;6823;72;275;1836;5253;1908;5528
240090;201810;2242;5638;1841;4941;24;71;1526;4040;1550;4111
240100;201810;9085;23396;7488;20374;356;1071;5778;15274;6134;16345
240110;201810;4371;12916;3844;11927;260;953;2739;8316;2999;9269
240120;201810;3554;9702;2639;8635;219;868;1731;5797;1950;6665
240130;201810;3409;7476;2918;6770;58;182;2656;6045;2714;6227
240140;201810;2028;6085;1721;5493;187;668;1122;3500;1309;4168
240145;201810;6210;17988;5260;16316;755;2449;3275;10249;4030;12698
240150;201810;869;2588;792;2436;53;198;616;1828;669;2026
240160;201810;1433;4393;1225;3969;64;287;875;2824;939;3111
240165;201810;900;2528;772;2287;67;200;575;1685;642;1885
240170;201810;2345;6630;2000;6000;226;743;1260;3643;1486;4386
240180;201810;3040;8950;2447;7785;500;1550;1238;4096;1738;5646
240185;201810;1233;4072;1123;3890;63;279;912;3112;975;3391
240190;201810;995;2992;881;2803;25;111;724;2271;749;2382
240200;201810;10487;28067;8791;25095;1205;3582;4603;13049;5808;16631
240210;201810;2871;7484;2557;6978;50;206;2135;5637;2185;5843
240220;201810;7229;22624;6554;21565;439;1884;4956;16025;5395;17909
240230;201810;5766;14840;4717;13067;253;678;3733;10330;3986;11008
240240;201810;2170;7275;1471;5463;135;441;693;2826;828;3267
240250;201810;2798;7728;2551;7357;152;418;2046;5916;2198;6334
240260;201810;13230;40432;11622;37599;1785;5670;7025;23651;8810;29321
240270;201810;2219;6644;1998;6296;114;300;1592;5137;1706;5437
240280;201810;1632;4246;1393;3882;48;137;1128;3083;1176;3220
240290;201810;1206;3568;1005;3136;39;188;689;1994;728;2182
240300;201810;2171;5699;1583;4551;89;276;997;2778;1086;3054
240310;201810;8788;23753;7235;21021;916;2767;3918;11281;4834;14048
240320;201810;1999;5538;1485;4520;28;137;1120;3228;1148;3365
240325;201810;29315;81479;23035;70244;5698;18221;7328;23117;13026;41338
240330;201810;1564;4451;1279;3875;46;163;902;2611;948;2774
240340;201810;1929;4669;1581;4131;61;144;1279;3285;1340;3429
240350;201810;2028;5428;1898;5274;34;124;1691;4709;1725;4833
240360;201810;7719;22316;6891;20968;1140;3420;4182;13225;5322;16645
240370;201810;1994;5385;1557;4487;89;269;1048;2954;1137;3223
240375;201810;890;2277;760;2028;34;137;595;1496;629;1633
240380;201810;2271;6515;1659;5138;168;516;958;2921;1126;3437
240390;201810;949;2486;692;1955;19;55;469;1244;488;1299
240400;201810;1367;3694;1096;3181;34;133;793;2234;827;2367
240410;201810;546;1717;470;1545;52;206;265;843;317;1049
240420;201810;4643;16825;4140;15689;590;2656;2214;8157;2804;10813
240430;201810;3287;8923;2827;8031;230;742;2033;5568;2263;6310
240440;201810;2541;5815;2150;5261;156;376;1651;3976;1807;4352
240450;201810;4193;11818;3414;10356;343;1180;2034;5952;2377;7132
240460;201810;2949;8565;2743;8242;258;825;2156;6453;2414;7278
240470;201810;3528;10843;2786;9296;394;1363;1520;5057;1914;6420
240480;201810;535;1476;385;1169;35;115;183;543;218;658
240485;201810;2073;6103;1726;5412;181;593;1092;3428;1273;4021
240490;201810;1750;4376;1402;3764;54;116;1133;3064;1187;3180
240500;201810;2180;5875;1915;5490;44;159;1643;4659;1687;4818
240510;201810;1641;4436;1498;4226;90;289;1243;3431;1333;3720
240520;201810;1275;3326;1065;3027;41;139;866;2414;907;2553
240530;201810;1938;5989;1787;5718;104;353;1418;4514;1522;4867
240540;201810;2178;5580;1933;5207;86;214;1645;4430;1731;4644
240550;201810;663;1877;609;1776;38;116;452;1290;490;1406
240560;201810;3246;8702;2787;8095;294;771;2037;6024;2331;6795
240570;201810;2858;7575;1947;5545;267;805;870;2261;1137;3066
240580;201810;7591;22554;6926;21371;523;1686;5592;17202;6115;18888
240590;201810;677;1834;584;1671;16;57;451;1262;467;1319
240600;201810;1730;4759;1282;3832;74;261;828;2372;902;2633
240610;201810;4342;11983;3678;10754;160;542;2757;7908;2917;8450
240615;201810;1074;3007;863;2570;68;232;580;1642;648;1874
240620;201810;1842;5257;1587;4789;98;260;1261;3795;1359;4055
240630;201810;2027;5916;1821;5554;143;359;1255;3957;1398;4316
240640;201810;899;2498;732;2214;32;138;532;1555;564;1693
240650;201810;3808;10784;3395;10078;218;646;2639;7788;2857;8434
240660;201810;2784;7529;2516;7178;62;246;2281;6404;2343;6650
240670;201810;2438;7015;2025;6175;150;498;1292;3818;1442;4316
240680;201810;1590;4367;1273;3800;65;243;931;2669;996;2912
240690;201810;900;2322;715;1994;19;71;583;1566;602;1637
240700;201810;2363;6897;1971;6193;69;285;1544;4746;1613;5031
240710;201810;15983;42288;13613;38127;2381;6490;7635;21724;10016;28214
240720;201810;5198;13576;4522;12497;569;1693;2962;7967;3531;9660
240725;201810;1049;3084;819;2575;37;125;558;1713;595;1838
240730;201810;2051;5910;1758;5316;88;278;1362;4049;1450;4327
240740;201810;1855;5054;1553;4485;57;225;1154;3148;1211;3373
240750;201810;2269;7643;1920;6891;307;1204;1016;3663;1323;4867
240760;201810;1514;3752;1080;3065;62;152;837;2396;899;2548
240770;201810;2995;8599;2668;8120;129;502;2168;6470;2297;6972
240780;201810;5433;14818;4282;12893;562;1681;2565;7926;3127;9607
240790;201810;841;2434;701;2157;18;71;519;1554;537;1625
240800;201810;39068;101971;32482;91441;4993;14629;15854;44678;20847;59307
240810;201810;80906;220314;71667;204269;13935;39974;39459;112447;53394;152421
240820;201810;5500;16986;4793;15726;864;2911;2686;8982;3550;11893
240830;201810;8530;25242;7856;24143;298;1247;6476;19551;6774;20798
240840;201810;1113;2877;905;2497;63;168;642;1715;705;1883
240850;201810;1231;3514;899;2765;43;154;536;1614;579;1768
240860;201810;1216;3367;935;2822;25;106;706;2035;731;2141
240870;201810;1162;2940;910;2509;80;248;627;1684;707;1932
240880;201810;1276;4048;1173;3859;101;383;916;2966;1017;3349
240890;201810;4551;12595;3525;10591;569;1817;1715;5010;2284;6827
240895;201810;2647;8558;2392;8177;188;691;1961;6687;2149;7378
240910;201810;3131;8841;2705;7997;70;239;2235;6513;2305;6752
240920;201810;814;2441;694;2206;78;256;369;1195;447;1451
240930;201810;3586;8490;3040;7810;167;245;2429;6451;2596;6696
240933;201810;1802;4341;1487;3862;45;177;1274;3226;1319;3403
240940;201810;6201;15481;4938;13328;298;862;3567;9314;3865;10176
240950;201810;920;2858;816;2648;42;181;640;2013;682;2194
240960;201810;713;2209;637;2056;44;165;471;1479;515;1644
240970;201810;1799;4807;1496;4245;62;246;1233;3370;1295;3616
240980;201810;2897;9127;2650;8658;194;762;2011;6440;2205;7202
240990;201810;2529;7430;2322;6995;280;903;1626;4783;1906;5686
241000;201810;918;2486;754;2163;40;109;526;1502;566;1611
241010;201810;2696;8796;2502;8391;216;878;1817;5930;2033;6808
241020;201810;2033;5523;1508;4427;148;430;954;2744;1102;3174
241025;201810;1706;4963;1388;4334;60;227;927;2842;987;3069
241030;201810;2442;7799;2028;6918;221;781;1321;4475;1542;5256
241040;201810;2263;7252;2025;6845;99;436;1609;5399;1708;5835
241050;201810;1262;3579;1038;3139;39;133;795;2342;834;2475
241060;201810;727;2055;641;1883;46;133;450;1297;496;1430
241070;201810;635;1781;559;1639;21;79;441;1235;462;1314
241080;201810;1111;3186;850;2657;9;41;638;1974;647;2015
241090;201810;2014;5871;1619;5185;62;304;1279;4016;1341;4320
241100;201810;1108;3192;903;2725;50;160;627;1829;677;1989
241105;201810;1050;3193;867;2839;272;901;286;975;558;1876
241110;201810;882;2586;677;2113;43;174;446;1327;489;1501
241120;201810;7242;21164;6307;19475;1184;3495;3419;11067;4603;14562
241140;201810;3253;8697;2651;7498;157;469;1937;5295;2094;5764
241142;201810;747;2055;558;1669;34;116;318;889;352;1005
241150;201810;5652;15403;5043;14366;187;689;4093;11392;4280;12081
241160;201810;1558;4643;1367;4322;147;412;995;3202;1142;3614
241170;201810;1272;3298;1116;3035;47;173;921;2391;968;2564
241180;201810;954;2556;699;2038;69;198;407;1159;476;1357
241190;201810;1118;2984;915;2571;26;98;670;1795;696;1893
241200;201810;18796;50411;16255;46521;3095;9042;8647;24901;11742;33943
241210;201810;1348;3756;1028;3100;111;354;612;1810;723;2164
241220;201810;8590;26349;7599;24590;2097;6804;3209;10909;5306;17713
241230;201810;2894;7896;2583;7370;112;395;2142;5960;2254;6355
241240;201810;1173;3400;692;2259;47;175;326;1057;373;1232
241250;201810;5432;16272;4552;14546;185;906;3442;10519;3627;11425
241255;201810;1953;6536;1717;6013;143;600;1201;4099;1344;4699
241260;201810;4841;12851;3810;11106;91;417;2950;8354;3041;8771
241270;201810;1738;5129;1461;4582;129;468;1022;3132;1151;3600
241280;201810;2055;5333;1817;4911;78;233;1537;4098;1615;4331
241290;201810;3363;8448;2608;7181;97;355;2019;5379;2116;5734
241300;201810;1422;3927;1172;3475;43;162;783;2249;826;2411
241310;201810;1971;5221;1700;4815;26;104;1428;4024;1454;4128
241320;201810;984;3204;816;2854;96;389;501;1733;597;2122
241330;201810;1738;4532;1380;4086;35;154;1181;3472;1216;3626
241335;201810;3019;8643;2729;8111;92;320;2314;6782;2406;7102
241340;201810;1658;4884;1310;4104;285;902;549;1688;834;2590
241350;201810;1944;5771;1738;5391;110;365;1313;3983;1423;4348
241355;201810;1286;3535;1063;3115;23;85;840;2428;863;2513
241360;201810;2067;5414;1611;4505;65;196;1159;3116;1224;3312
241370;201810;1341;3790;1067;3242;70;239;704;2034;774;2273
241380;201810;647;1814;512;1546;85;242;271;833;356;1075
241390;201810;2692;8234;2459;7850;219;697;1866;5972;2085;6669
241400;201810;3541;9963;3185;9438;197;671;2580;7549;2777;8220
241410;201810;2263;6927;1902;6180;367;1243;1023;3301;1390;4544
241415;201810;1610;4790;1345;4291;90;328;957;2977;1047;3305
241420;201810;2158;7200;1858;6631;493;1883;753;2687;1246;4570
241430;201810;528;1514;375;1143;27;94;229;678;256;772
241440;201810;7060;22947;6371;21668;465;1834;4887;16375;5352;18209
241445;201810;1059;2794;975;2691;22;57;897;2521;919;2578
241450;201810;2795;7099;2461;6586;301;732;1785;4802;2086;5534
241460;201810;3545;9842;2995;8674;187;626;2103;5885;2290;6511
241470;201810;1417;3757;1126;3322;38;144;935;2724;973;2868
241475;201810;1197;3475;937;2956;30;164;693;2063;723;2227
241480;201810;2695;8674;2328;7901;843;2845;639;2506;1482;5351
241490;201810;659;1615;519;1396;29;95;354;912;383;1007
241500;201810;803;2339;692;2190;12;57;615;1931;627;1988
250010;201810;2622;7930;2178;6990;79;324;1598;4981;1677;5305
250020;201810;1576;4334;1137;3452;60;164;810;2432;870;2596
250030;201810;6700;18748;6079;17796;480;1486;4701;13506;5181;14992
250040;201810;3891;12400;3487;11630;252;978;2523;8241;2775;9219
250050;201810;3418;9551;3138;9134;175;610;2550;7283;2725;7893
250053;201810;1156;3367;1057;3215;87;271;774;2382;861;2653
250057;201810;640;2379;608;2333;11;64;561;2161;572;2225
250060;201810;5141;14162;4740;13648;421;1148;3753;10965;4174;12113
250070;201810;3808;11057;3433;10369;56;253;2728;7987;2784;8240
250073;201810;723;2019;601;1828;10;28;487;1433;497;1461
250077;201810;2185;6014;1639;5069;100;338;1192;3644;1292;3982
250080;201810;4376;11733;3971;11157;95;355;3426;9470;3521;9825
250090;201810;2871;7480;2613;7104;95;248;2220;5970;2315;6218
250100;201810;3689;11485;3423;10980;147;603;2805;8738;2952;9341
250110;201810;4708;13431;4336;12877;372;1326;3404;9825;3776;11151
250115;201810;525;1531;455;1409;9;48;344;1021;353;1069
250120;201810;1736;5236;1488;4823;46;214;1186;3791;1232;4005
250130;201810;5308;15276;4591;14154;99;527;3798;11482;3897;12009
250135;201810;1121;3119;1022;2964;17;62;923;2673;940;2735
250140;201810;2081;6416;1986;6278;89;414;1730;5364;1819;5778
250150;201810;4630;15041;4260;14333;175;841;3446;11281;3621;12122
250153;201810;1458;3774;1218;3426;31;114;1003;2764;1034;2878
250157;201810;1717;5233;1545;4881;128;413;1163;3657;1291;4070
250160;201810;3786;9689;3081;8715;36;131;2822;7940;2858;8071
250170;201810;1714;4518;1540;4256;42;150;1332;3619;1374;3769
250180;201810;17475;45549;15638;43050;946;2914;12133;32736;13079;35650
250190;201810;3911;10919;3431;10144;430;1171;2318;6837;2748;8008
250200;201810;1804;5076;1538;4642;50;173;1315;3949;1365;4122
250205;201810;781;2550;705;2423;22;118;578;1945;600;2063
250210;201810;1512;4673;1381;4457;47;233;1109;3485;1156;3718
250215;201810;1513;4346;1269;3928;61;195;795;2449;856;2644
250220;201810;690;1974;569;1790;28;111;421;1286;449;1397
250230;201810;1576;3696;1154;3043;22;81;938;2391;960;2472
250240;201810;2119;6616;1953;6327;41;170;1680;5373;1721;5543
250250;201810;4398;12582;3908;11873;106;357;3329;10069;3435;10426
250260;201810;1676;4729;1430;4305;45;156;1152;3449;1197;3605
250270;201810;1202;3707;1075;3551;78;272;799;2720;877;2992
250280;201810;3217;9247;2806;8604;100;336;2250;6867;2350;7203
250290;201810;1601;4274;1386;3965;24;57;1155;3320;1179;3377
250300;201810;5294;14685;4983;14305;240;1014;4182;11569;4422;12583
250310;201810;1124;3181;970;2906;40;135;740;2167;780;2302
250320;201810;10233;26082;9202;24791;481;1436;7820;20828;8301;22264
250330;201810;2296;6736;1970;6269;136;443;1551;4886;1687;5329
250340;201810;1060;2844;942;2674;7;25;827;2313;834;2338
250350;201810;4039;11202;3655;10666;147;380;3071;9150;3218;9530
250355;201810;1958;6019;1793;5800;28;149;1617;5202;1645;5351
250360;201810;1788;5031;1625;4785;40;134;1345;3940;1385;4074
250370;201810;11940;32510;10341;30190;414;1535;8585;24619;8999;26154
250375;201810;1064;2916;934;2748;12;49;864;2549;876;2598
250380;201810;1569;4208;1469;4076;42;170;1244;3312;1286;3482
250390;201810;1766;4614;1472;4131;182;494;1022;2902;1204;3396
250400;201810;66041;168247;48869;140903;14142;43015;14992;44712;29134;87727
250403;201810;1595;4741;1474;4584;109;497;1128;3336;1237;3833
250407;201810;1199;3105;1016;2835;74;143;752;2140;826;2283
250410;201810;572;1607;505;1491;4;24;435;1256;439;1280
250415;201810;1872;5380;1656;5019;57;220;1363;4093;1420;4313
250420;201810;1197;3448;1089;3299;18;69;1025;3103;1043;3172
250430;201810;6099;15388;5337;14303;180;584;4475;11758;4655;12342
250435;201810;1471;4180;1240;3788;29;123;957;2851;986;2974
250440;201810;4354;12025;3901;11404;87;300;3407;9877;3494;10177
250450;201810;1788;4919;1527;4565;30;120;1285;3807;1315;3927
250460;201810;7054;19432;6417;18552;385;1165;5313;15322;5698;16487
250470;201810;1504;3871;1249;3502;67;210;966;2647;1033;2857
250480;201810;3745;10655;3398;10233;28;117;3110;9421;3138;9538
250485;201810;708;1628;509;1344;27;66;375;944;402;1010
250490;201810;4589;11873;4194;11379;225;706;3570;9558;3795;10264
250500;201810;1894;5334;1694;5001;76;244;1387;4081;1463;4325
250510;201810;5327;13582;4651;12691;82;237;4165;11382;4247;11619
250520;201810;1766;4956;1546;4631;156;491;1067;3165;1223;3656
250523;201810;2156;5378;1961;5134;81;322;1693;4302;1774;4624
250527;201810;1649;4331;1520;4175;39;115;1364;3751;1403;3866
250530;201810;579;1619;509;1520;14;50;448;1332;462;1382
250535;201810;1311;3919;1213;3727;32;148;991;2958;1023;3106
250540;201810;2741;6681;2325;6207;61;152;2037;5469;2098;5621
250550;201810;803;2623;726;2494;25;116;581;1938;606;2054
250560;201810;1613;4584;1463;4371;47;166;1237;3616;1284;3782
250570;201810;2560;7791;2236;7195;78;344;1786;5599;1864;5943
250580;201810;1048;2737;960;2608;58;193;787;2088;845;2281
250590;201810;795;2301;721;2189;16;75;613;1839;629;1914
250600;201810;7657;20579;6718;19257;344;967;5619;16092;5963;17059
250610;201810;2944;8343;2692;7979;138;518;2228;6494;2366;7012
250620;201810;665;1866;587;1719;16;69;459;1304;475;1373
250625;201810;2526;7420;2315;7088;48;235;1956;5832;2004;6067
250630;201810;9361;26984;8026;24460;964;3072;5189;15424;6153;18496
250640;201810;3267;9521;3043;9208;97;453;2568;7540;2665;7993
250650;201810;882;2207;749;2027;34;96;627;1657;661;1753
250660;201810;1591;4059;1401;3793;40;102;1200;3192;1240;3294
250670;201810;2266;7204;2122;6963;55;286;1831;5856;1886;6142
250680;201810;5775;13619;5176;12924;117;440;4666;11332;4783;11772
250690;201810;6425;15202;5842;14450;146;373;5287;12967;5433;13340
250700;201810;4186;12021;3764;11364;348;1063;2853;8532;3201;9595
250710;201810;4344;12693;3802;11958;304;1024;2829;8940;3133;9964
250720;201810;2729;7248;2477;6881;41;192;2214;6055;2255;6247
250730;201810;3886;10593;3470;10029;145;531;2906;8158;3051;8689
250740;201810;1886;4922;1569;4476;111;354;1263;3534;1374;3888
250750;201810;95478;249310;84480;233393;8161;24554;59931;162067;68092;186621
250760;201810;2310;6096;2032;5660;116;332;1566;4251;1682;4583
250770;201810;3742;11746;3437;11349;322;1160;2520;8274;2842;9434
250780;201810;1680;4660;1418;4171;91;309;1036;2973;1127;3282
250790;201810;2306;7121;2090;6776;260;928;1379;4413;1639;5341
250800;201810;2414;6528;2111;6046;102;227;1757;5054;1859;5281
250810;201810;1233;3383;1023;3077;32;100;875;2641;907;2741
250820;201810;1784;5468;1724;5380;55;231;1585;4885;1640;5116
250830;201810;5297;16323;4666;15045;345;1326;3285;10313;3630;11639
250840;201810;803;2556;688;2313;21;91;500;1682;521;1773
250850;201810;1814;5483;1626;5162;40;213;1362;4189;1402;4402
250855;201810;954;2817;830;2612;68;244;608;1872;676;2116
250860;201810;3044;9349;2538;8462;441;1561;1368;4608;1809;6169
250870;201810;1049;2888;901;2626;34;120;735;2112;769;2232
250880;201810;1530;4079;1268;3685;156;459;850;2472;1006;2931
250890;201810;9406;26289;8733;25342;547;2204;7058;19631;7605;21835
250900;201810;2730;8015;2361;7318;91;331;1955;5937;2046;6268
250905;201810;2214;6422;2087;6231;52;202;1887;5608;1939;5810
250910;201810;5427;14238;4675;13301;118;419;4065;11540;4183;11959
250915;201810;1875;4678;1448;4233;18;46;1329;3954;1347;4000
250920;201810;3213;8605;2936;8165;338;899;2138;5872;2476;6771
250930;201810;2106;5836;1948;5610;80;314;1657;4650;1737;4964
250933;201810;1110;3417;991;3189;25;133;752;2339;777;2472
250937;201810;688;1928;577;1730;26;88;446;1343;472;1431
250939;201810;1655;4608;1472;4317;53;177;1191;3440;1244;3617
250940;201810;3746;10426;3398;9909;61;246;2930;8468;2991;8714
250950;201810;1595;4180;1319;3824;29;128;1133;3240;1162;3368
250960;201810;1063;3194;962;3033;38;167;772;2353;810;2520
250970;201810;8108;21692;7048;19963;375;1186;5495;15312;5870;16498
250980;201810;2421;6663;2210;6286;52;201;1855;5133;1907;5334
250990;201810;1834;5921;1634;5498;81;356;1239;4091;1320;4447
251000;201810;2052;5793;1697;5226;29;125;1433;4368;1462;4493
251010;201810;2578;7377;2362;7044;39;166;2141;6362;2180;6528
251020;201810;1673;4485;1553;4336;39;141;1412;3904;1451;4045
251030;201810;962;2638;839;2405;37;111;600;1672;637;1783
251040;201810;1817;5342;1565;4905;53;254;1259;3837;1312;4091
251050;201810;1078;2964;895;2615;54;165;657;1857;711;2022
251060;201810;1032;2252;771;1913;10;43;648;1574;658;1617
251065;201810;423;1170;347;1059;14;46;251;730;265;776
251070;201810;751;2112;656;1986;9;35;570;1708;579;1743
251080;201810;18268;48154;15289;43700;2257;6779;9445;27113;11702;33892
251090;201810;2676;7864;2300;7138;61;236;1864;5725;1925;5961
251100;201810;810;2518;721;2365;31;143;545;1714;576;1857
251110;201810;1662;4600;1456;4214;52;134;1128;3227;1180;3361
251120;201810;6726;20357;5963;19261;271;1122;4704;15044;4975;16166
251130;201810;3705;8902;3352;8494;191;514;2959;7465;3150;7979
251140;201810;4133;11845;3783;11349;106;412;3133;9304;3239;9716
251150;201810;2593;7720;2380;7392;113;498;1945;5844;2058;6342
251160;201810;1987;6145;1799;5843;134;454;1456;4710;1590;5164
251170;201810;1501;4233;1356;4065;36;135;1203;3584;1239;3719
251180;201810;2484;6964;2132;6458;201;679;1436;4293;1637;4972
251190;201810;4340;11525;4090;11234;61;260;3758;10145;3819;10405
251200;201810;3957;12267;3662;11891;85;347;3268;10654;3353;11001
251203;201810;930;3060;890;2976;34;155;686;2219;720;2374
251207;201810;1018;2960;817;2598;25;125;578;1771;603;1896
251210;201810;7072;18980;5980;17568;275;789;4797;14232;5072;15021
251220;201810;1170;2897;917;2539;51;137;712;1988;763;2125
251230;201810;4557;12605;4025;11802;148;549;3303;9459;3451;10008
251240;201810;3440;9735;2953;8992;176;576;2243;6680;2419;7256
251250;201810;9638;26747;8689;25264;824;2485;6382;18008;7206;20493
251260;201810;471;1414;428;1333;16;72;332;998;348;1070
251270;201810;3990;12748;3645;12281;111;486;3140;10631;3251;11117
251272;201810;1314;3646;1219;3508;36;140;1077;3043;1113;3183
251274;201810;877;2538;723;2257;46;181;499;1479;545;1660
251275;201810;1196;3380;1039;3123;44;189;768;2201;812;2390
251276;201810;1276;3435;1151;3279;37;172;976;2700;1013;2872
251278;201810;534;1559;485;1464;36;89;368;1134;404;1223
251280;201810;2174;6125;1965;5793;48;196;1633;4700;1681;4896
251290;201810;5558;14071;5259;13673;260;918;4509;11236;4769;12154
251300;201810;787;2420;735;2343;13;55;624;1980;637;2035
251310;201810;2658;7772;2433;7412;64;280;2007;5994;2071;6274
251315;201810;1646;5267;1527;5063;75;273;1182;3857;1257;4130
251320;201810;1612;4324;1145;3524;36;126;844;2585;880;2711
251330;201810;1962;4700;1621;4288;23;84;1496;3961;1519;4045
251335;201810;1123;3726;1040;3602;33;137;901;3091;934;3228
251340;201810;3587;9420;2955;8566;127;421;2205;6337;2332;6758
251350;201810;1039;3137;958;3004;32;147;813;2467;845;2614
251360;201810;1777;5191;1486;4799;24;120;1293;4179;1317;4299
251365;201810;703;2018;565;1723;15;52;438;1334;453;1386
251370;201810;21806;61985;20083;59594;2731;8309;13675;40832;16406;49141
251380;201810;1183;3459;1054;3248;25;128;896;2660;921;2788
251385;201810;707;1847;556;1577;24;73;416;1130;440;1203
251390;201810;6021;18622;5267;17243;821;2845;3058;9848;3879;12693
251392;201810;920;2614;785;2390;25;113;614;1830;639;1943
251394;201810;624;1938;535;1779;25;100;408;1341;433;1441
251396;201810;693;1915;598;1755;26;65;412;1200;438;1265
251398;201810;887;2318;643;1878;19;76;495;1409;514;1485
251400;201810;1146;2953;948;2678;28;110;735;1998;763;2108
251410;201810;1546;3728;1301;3378;24;113;1117;2802;1141;2915
251420;201810;1826;5004;1523;4644;52;209;1224;3667;1276;3876
251430;201810;1513;4762;1355;4500;45;217;1175;3849;1220;4066
251440;201810;1098;3130;899;2754;19;74;722;2204;741;2278
251445;201810;1478;4295;1392;4169;64;266;1160;3351;1224;3617
251450;201810;4273;12944;3908;12413;93;398;3308;10389;3401;10787
251455;201810;914;2808;832;2656;35;144;640;2001;675;2145
251460;201810;879;2570;784;2416;26;97;649;2005;675;2102
251465;201810;420;1256;359;1121;9;36;285;874;294;910
251470;201810;1152;3247;871;2653;79;249;530;1554;609;1803
251480;201810;937;2525;793;2284;20;92;595;1646;615;1738
251490;201810;1826;5000;1480;4515;63;207;1091;3313;1154;3520
251500;201810;1815;5458;1717;5282;69;270;1484;4499;1553;4769
251510;201810;2493;7878;2166;7200;164;624;1443;4684;1607;5308
251520;201810;944;2532;721;2083;72;194;467;1327;539;1521
251530;201810;13202;33365;11548;31227;135;687;10385;27619;10520;28306
251540;201810;2733;8280;2525;7879;121;455;2031;6212;2152;6667
251550;201810;3567;8732;2849;7801;70;212;2445;6662;2515;6874
251560;201810;566;1724;512;1637;84;276;323;987;407;1263
251570;201810;892;2590;744;2294;20;95;574;1695;594;1790
251580;201810;1880;4625;1681;4340;92;277;1434;3591;1526;3868
251590;201810;1556;4116;1357;3869;57;193;1102;3066;1159;3259
251593;201810;919;2733;844;2613;95;316;533;1602;628;1918
251597;201810;1962;5738;1854;5595;31;114;1646;4894;1677;5008
251600;201810;6247;17335;5631;16397;174;561;4751;13615;4925;14176
251610;201810;3231;9320;2798;8521;313;916;1913;5878;2226;6794
251615;201810;1180;3043;958;2673;27;83;758;2066;785;2149
251620;201810;17210;41385;14076;37709;176;415;12315;33919;12491;34334
251630;201810;4563;11070;3740;9939;210;604;2939;7742;3149;8346
251640;201810;2021;5871;1866;5580;58;263;1601;4661;1659;4924
251650;201810;4035;10807;3588;10237;149;473;3104;8812;3253;9285
251660;201810;3372;10237;3007;9584;94;439;2516;7806;2610;8245
251670;201810;4147;11739;3644;11036;44;207;3346;10058;3390;10265
251675;201810;638;1891;584;1821;89;310;383;1177;472;1487
251680;201810;2622;7154;2133;6442;50;192;1723;5169;1773;5361
251690;201810;3155;9042;2738;8260;82;272;2068;6111;2150;6383
251700;201810;1836;5702;1699;5521;51;250;1458;4627;1509;4877
251710;201810;813;2144;555;1597;51;182;319;886;370;1068
251720;201810;1306;3751;1093;3370;30;131;839;2493;869;2624
251740;201810;653;1810;508;1544;35;118;363;1060;398;1178
260005;201810;28686;62044;23739;55537;2008;4770;17818;40972;19826;45742
260010;201810;9675;25603;8035;23181;476;1427;5011;14673;5487;16100
260020;201810;6738;16266;5733;14807;144;616;4760;12047;4904;12663
260030;201810;6325;17000;5430;15577;209;711;4331;12326;4540;13037
260040;201810;7857;21626;6570;19605;664;2055;4388;13207;5052;15262
260050;201810;12475;34707;11415;33436;337;1079;10072;29944;10409;31023
260060;201810;3890;10203;3345;9287;226;614;2610;7245;2836;7859
260070;201810;10034;26492;8770;24561;542;1803;6738;18458;7280;20261
260080;201810;6509;15250;5705;14065;173;522;4755;11452;4928;11974
260090;201810;4970;12972;4471;12303;720;1966;3008;8352;3728;10318
260100;201810;3151;8480;2668;7759;88;341;2180;6254;2268;6595
260105;201810;5155;13892;4595;13098;163;605;3783;10539;3946;11144
260110;201810;22333;60356;20194;57386;1131;3531;16767;47011;17898;50542
260120;201810;13591;37958;11705;34925;1654;5021;7228;21975;8882;26996
260130;201810;2988;8021;2719;7606;220;672;2019;5502;2239;6174
260140;201810;13024;30359;11299;28170;622;1678;9350;23048;9972;24726
260150;201810;3444;8403;2984;7831;139;450;2510;6443;2649;6893
260160;201810;6491;17426;5543;16185;110;435;4859;14291;4969;14726
260170;201810;17619;45555;15478;42422;1700;4465;11300;31092;13000;35557
260180;201810;3235;9265;2911;8785;125;444;2443;7251;2568;7695
260190;201810;17590;37058;15255;34318;203;589;13439;29670;13642;30259
260200;201810;11052;27073;9681;25345;521;1257;8225;21640;8746;22897
260210;201810;11885;34196;10179;31412;376;1435;8145;24981;8521;26416
260220;201810;10009;25073;9327;24221;204;689;8311;21341;8515;22030
260230;201810;10238;26385;8985;24626;287;896;7417;20033;7704;20929
260240;201810;2769;8274;2429;7701;186;644;1851;5817;2037;6461
260250;201810;2165;5862;1874;5431;94;302;1448;4115;1542;4417
260260;201810;12721;34020;11187;31628;527;1809;8744;24185;9271;25994
260270;201810;3712;9846;3367;9365;149;640;2717;7296;2866;7936
260280;201810;12791;39474;11692;37899;553;2190;9967;31971;10520;34161
260290;201810;37229;99867;32730;92906;4243;12423;21163;59472;25406;71895
260300;201810;9283;25889;8145;24233;264;1147;6707;19785;6971;20932
260310;201810;4627;12511;4153;11860;413;1117;3092;8971;3505;10088
260320;201810;7333;21703;6514;20263;294;914;5311;16547;5605;17461
260330;201810;2526;7854;2265;7319;75;273;1815;5737;1890;6010
260340;201810;2009;5443;1746;5039;31;134;1493;4218;1524;4352
260345;201810;23645;65179;20488;60214;3997;12541;9714;27815;13711;40356
260350;201810;5045;12607;4518;11927;127;391;3984;10435;4111;10826
260360;201810;2445;6565;2240;6197;53;247;1562;4228;1615;4475
260370;201810;5369;15837;4696;14667;222;814;3594;11128;3816;11942
260380;201810;4832;14792;4217;13780;198;732;3140;10129;3338;10861
260390;201810;4212;13010;3619;11778;246;865;2486;7939;2732;8804
260392;201810;3437;11023;3069;10540;139;760;2464;8405;2603;9165
260400;201810;15533;38706;13828;36382;779;2335;10724;27346;11503;29681
260410;201810;63470;164215;51363;146528;10844;32712;22862;66492;33706;99204
260415;201810;4148;11643;3562;10569;101;462;2737;7831;2838;8293
260420;201810;12617;27227;10855;25210;209;596;9769;22466;9978;23062
260430;201810;2849;8864;2449;8087;124;481;1704;5557;1828;6038
260440;201810;3541;9711;3093;8899;126;475;2465;6894;2591;7369
260450;201810;5601;14515;5108;13899;296;705;4229;11651;4525;12356
260460;201810;5207;16286;4544;14971;579;2104;2678;8660;3257;10764
260470;201810;4960;13114;4247;12287;120;304;3803;11232;3923;11536
260480;201810;4082;10963;3456;10078;313;1104;2306;6758;2619;7862
260490;201810;5272;12599;4610;11526;74;267;4077;9944;4151;10211
260500;201810;6033;15706;5133;14355;499;1324;3541;10017;4040;11341
260510;201810;9346;23328;7982;21445;189;644;7014;18602;7203;19246
260515;201810;4353;12315;3337;10330;167;572;2180;6597;2347;7169
260520;201810;17311;41276;15482;38791;1028;2660;12427;30777;13455;33437
260530;201810;9456;27763;8253;25841;217;956;7037;21777;7254;22733
260540;201810;6907;15389;6178;14509;436;903;5290;12519;5726;13422
260545;201810;42;133;19;83;5;19;5;23;10;42
260550;201810;2808;8293;2370;7447;170;725;1538;4693;1708;5418
260560;201810;5997;15494;5177;14324;142;600;4336;11715;4478;12315
260570;201810;7356;21070;6582;19964;512;1647;5108;15437;5620;17084
260580;201810;4328;10580;3876;9943;38;148;3547;9029;3585;9177
260590;201810;6687;15878;5724;14789;284;736;4717;12268;5001;13004
260600;201810;29656;79648;24614;71678;1496;4763;18072;51939;19568;56702
260610;201810;6854;18783;6305;17999;458;1454;4733;13335;5191;14789
260620;201810;15246;42174;13671;39779;1718;5459;9064;25880;10782;31339
260630;201810;2323;6345;1927;5709;43;193;1577;4587;1620;4780
260640;201810;19560;46975;16885;43775;994;2820;13263;33970;14257;36790
260650;201810;5513;15741;4707;14565;179;769;3924;11984;4103;12753
260660;201810;7267;19488;6316;18235;173;744;5349;15100;5522;15844
260670;201810;2211;5805;1822;5225;87;231;1324;3756;1411;3987
260680;201810;24703;62057;21008;56417;2102;5915;13471;35559;15573;41474
260690;201810;3609;9413;2978;8440;127;439;2378;6633;2505;7072
260700;201810;5966;17589;5683;17253;24;59;5521;16909;5545;16968
260710;201810;1310;3522;1208;3394;52;175;907;2582;959;2757
260720;201810;20450;56051;18273;52834;2856;8487;11412;32754;14268;41241
260730;201810;7225;21719;6425;20545;354;1323;5262;16546;5616;17869
260740;201810;1310;3710;1108;3384;24;122;871;2637;895;2759
260750;201810;6836;19423;5974;18292;135;423;5382;16707;5517;17130
260760;201810;5508;13413;4798;12511;230;659;3894;10193;4124;10852
260765;201810;7478;23014;6738;21916;616;2586;4634;14581;5250;17167
260770;201810;3763;9874;3234;8974;96;323;2566;7016;2662;7339
260775;201810;5118;14043;4651;13343;259;986;3548;9826;3807;10812
260780;201810;3571;10842;3229;10277;355;1319;2033;6278;2388;7597
260790;201810;112647;262777;96059;240227;16218;39985;57876;144600;74094;184585
260795;201810;3025;8205;2632;7627;136;451;1994;5781;2130;6232
260800;201810;5489;12821;4956;12065;174;529;4363;10285;4537;10814
260805;201810;3565;10471;3036;9529;207;749;2146;6604;2353;7353
260810;201810;6545;18025;5895;16793;576;1615;4246;11850;4822;13465
260820;201810;4310;10626;3843;9964;210;730;3042;7616;3252;8346
260825;201810;2839;8753;2492;8128;134;499;1842;5968;1976;6467
260830;201810;4277;12647;3565;11327;502;1472;2268;7422;2770;8894
260840;201810;4069;11063;3617;10395;184;541;3003;8559;3187;9100
260845;201810;4013;11073;3678;10475;283;811;2717;7668;3000;8479
260850;201810;4816;14130;4153;12777;451;1459;2519;7539;2970;8998
260860;201810;3421;9933;2922;9011;108;383;2362;7148;2470;7531
260870;201810;4422;10873;3866;10174;107;404;3419;8810;3526;9214
260875;201810;6625;17436;5563;15746;677;1882;3661;10401;4338;12283
260880;201810;9648;27488;8511;25516;468;1392;6754;20363;7222;21755
260890;201810;13169;35168;11759;33036;946;2907;8360;22999;9306;25906
260900;201810;5179;15327;4423;14041;320;1175;3003;9369;3323;10544
260910;201810;3136;8764;2758;8154;106;375;2162;6310;2268;6685
260915;201810;5047;15124;4512;14469;86;360;4106;13190;4192;13550
260920;201810;3246;8743;2868;8271;115;368;2421;6958;2536;7326
260930;201810;3460;11321;3071;10598;188;750;2384;8143;2572;8893
260940;201810;14347;35343;12613;32747;977;2768;9365;23836;10342;26604
260950;201810;6402;18219;5191;15856;604;2101;2891;8312;3495;10413
260960;201810;62429;149403;51677;134401;7410;20366;30540;78142;37950;98508
260970;201810;5101;14097;4596;13418;165;463;3594;10561;3759;11024
260980;201810;4385;13184;3956;12629;70;272;3604;11547;3674;11819
260990;201810;17260;50018;15041;46924;889;3125;11665;36181;12554;39306
261000;201810;15561;38852;13381;35770;600;2103;10327;27109;10927;29212
261010;201810;2464;6468;2188;6102;78;217;1930;5380;2008;5597
261020;201810;6352;17780;5466;16098;318;1060;4272;12177;4590;13237
261030;201810;4085;11494;3563;10633;211;598;2805;8310;3016;8908
261040;201810;5070;15448;4197;13623;223;867;3025;9616;3248;10483
261050;201810;7616;20650;6905;19433;653;1589;4763;13539;5416;15128
261060;201810;13156;34669;11794;32769;530;1654;9619;26423;10149;28077
261070;201810;57681;130215;48549;117778;3734;8650;35992;86477;39726;95127
261080;201810;5917;15460;5551;14944;182;506;5062;13625;5244;14131
261090;201810;17555;43966;15942;41826;435;1426;13682;35463;14117;36889
261100;201810;8012;23221;7015;21683;642;2134;4953;15350;5595;17484
261110;201810;57879;168023;49885;154641;10277;33391;25183;78416;35460;111807
261120;201810;3746;9489;3240;8833;89;277;2866;7813;2955;8090
261130;201810;7481;18166;6624;17069;118;376;5930;15148;6048;15524
261140;201810;3468;8342;3113;7852;223;611;2469;6106;2692;6717
261150;201810;5201;14144;4610;13196;110;428;3957;11146;4067;11574
261153;201810;1941;5763;1673;5318;80;319;1148;3609;1228;3928
261160;201810;201985;490116;170220;444810;44143;119561;67502;179663;111645;299224
261170;201810;5901;15562;5324;14686;348;929;4212;11592;4560;12521
261180;201810;9735;25179;8700;23801;567;1698;6279;16994;6846;18692
261190;201810;4713;14198;4281;13489;299;1211;3152;9611;3451;10822
261200;201810;3373;7905;2997;7413;186;481;2464;6014;2650;6495
261210;201810;1901;4689;1618;4292;62;194;1379;3606;1441;3800
261220;201810;13495;39550;11274;35230;1556;5229;6306;19532;7862;24761
261230;201810;4475;13159;3757;12209;81;347;3169;10406;3250;10753
261240;201810;5021;13271;4430;12330;268;736;3603;9962;3871;10698
261245;201810;3480;10118;2990;9247;104;486;2360;7006;2464;7492
261247;201810;2922;8833;2470;7995;169;625;1705;5443;1874;6068
261250;201810;20064;48123;17595;45179;2191;5287;12621;33317;14812;38604
261255;201810;3965;11923;3415;10865;169;744;2547;7816;2716;8560
261260;201810;12915;34922;11163;32668;431;1672;9429;27324;9860;28996
261270;201810;3897;10566;3484;9944;217;723;2816;7851;3033;8574
261280;201810;2561;7347;2265;6822;88;355;1782;5217;1870;5572
261290;201810;2878;7824;2511;7356;107;420;2029;5941;2136;6361
261300;201810;11652;33989;9961;30967;662;2501;7005;21279;7667;23780
261310;201810;7815;21400;6891;20017;936;2922;4623;13082;5559;16004
261320;201810;5920;17086;5206;15829;97;392;4351;13005;4448;13397
261330;201810;5786;14825;5374;14266;194;681;4682;12209;4876;12890
261340;201810;4138;12316;3612;11556;202;829;2790;8809;2992;9638
261350;201810;8324;25162;7644;24025;142;704;6304;19410;6446;20114
261360;201810;8315;20633;7072;18883;298;927;5659;14695;5957;15622
261370;201810;20176;54023;17714;50429;2917;8276;10664;30545;13581;38821
261380;201810;3946;12462;3563;11732;498;1814;2300;7423;2798;9237
261390;201810;15917;46618;13724;42947;1392;4706;8794;27397;10186;32103
261400;201810;4598;14972;4038;13781;192;874;2957;9845;3149;10719
261410;201810;9130;23926;7781;21727;547;1530;6151;17044;6698;18574
261420;201810;7023;22240;6527;21582;990;3711;4289;14061;5279;17772
261430;201810;3343;9674;2836;8879;105;394;2323;7202;2428;7596
261440;201810;1467;4483;1268;4085;48;240;890;2759;938;2999
261450;201810;14184;39113;13038;37402;240;935;11127;31810;11367;32745
261460;201810;7207;20175;6512;19179;222;789;5567;16307;5789;17096
261470;201810;4216;10723;3737;10079;51;237;3167;8519;3218;8756
261480;201810;4756;15133;4157;14105;251;1002;3147;10436;3398;11438
261485;201810;4930;14328;4297;13283;397;1428;2926;8814;3323;10242
261500;201810;5586;14965;4942;14060;516;1364;3369;9907;3885;11271
261510;201810;1823;5612;1574;5149;76;279;1163;3842;1239;4121
261520;201810;2430;7503;2267;7183;85;318;1565;5014;1650;5332
261530;201810;10813;33371;9092;29991;1362;5066;4122;13241;5484;18307
261540;201810;7580;22442;6867;21307;1171;3601;3901;12558;5072;16159
261550;201810;3575;9651;3153;8970;243;769;2231;6212;2474;6981
261560;201810;7502;22916;6619;21624;415;1646;4950;16091;5365;17737
261570;201810;3362;9351;2780;8381;223;807;1875;5527;2098;6334
261580;201810;6476;17490;5828;16584;133;592;5239;14687;5372;15279
261590;201810;2651;6948;2133;6179;91;287;1584;4559;1675;4846
261600;201810;5184;13413;4350;12183;439;1140;2893;8374;3332;9514
261610;201810;2440;6599;2045;5986;103;358;1523;4442;1626;4800
261618;201810;2474;6373;2230;6052;88;258;1785;4786;1873;5044
261620;201810;3930;11663;3670;11256;853;2412;2190;7038;3043;9450
261630;201810;6656;18764;5622;16850;463;1735;3592;10181;4055;11916
261640;201810;36537;84036;31971;78326;1893;4088;25058;62765;26951;66853
261650;201810;4071;10510;3637;9946;161;579;2698;7289;2859;7868
270010;201810;4265;14909;3813;14077;195;1091;2953;10583;3148;11674
270020;201810;3943;10213;3507;9626;229;739;2858;7637;3087;8376
270030;201810;34464;96530;30050;89419;4557;13399;19147;57353;23704;70752
270040;201810;11210;30546;9756;28789;460;1785;8065;23487;8525;25272
270050;201810;5490;12751;4698;11866;187;477;4161;10539;4348;11016
270060;201810;2001;5296;1756;4987;143;395;1374;3935;1517;4330
270070;201810;4537;13171;4005;12410;145;645;3372;10217;3517;10862
270080;201810;1431;4049;1188;3609;67;220;870;2525;937;2745
270090;201810;1892;5868;1681;5455;80;357;1309;4087;1389;4444
270100;201810;5510;15265;4858;14261;254;967;3882;11120;4136;12087
270110;201810;3263;8082;2617;7308;144;399;2050;5903;2194;6302
270120;201810;3023;8163;2647;7697;86;327;2316;6691;2402;7018
270130;201810;5260;14078;4619;13343;201;644;3848;11168;4049;11812
270135;201810;2010;4951;1751;4648;68;184;1576;4170;1644;4354
270140;201810;9922;23039;8132;20591;505;1607;6471;15609;6976;17216
270150;201810;2666;8099;2560;7957;11;32;2520;7836;2531;7868
270160;201810;5474;16071;4854;15313;70;429;4447;13832;4517;14261
270170;201810;3453;10313;3015;9716;243;1036;2190;6800;2433;7836
270180;201810;2244;7010;2070;6773;52;245;1809;5813;1861;6058
270190;201810;1665;5065;1523;4870;67;279;1288;4077;1355;4356
270200;201810;2475;7532;2135;7067;142;559;1572;5068;1714;5627
270210;201810;5587;13813;4906;13014;165;566;4412;11524;4577;12090
270220;201810;1405;3943;1183;3623;234;769;639;1933;873;2702
270230;201810;9285;27304;7918;25109;807;2930;5317;16449;6124;19379
270235;201810;5774;18270;5187;17265;200;853;4202;13791;4402;14644
270240;201810;10504;28979;8670;26625;1050;3518;6158;18835;7208;22353
270250;201810;2873;7458;2548;7008;291;718;1890;5304;2181;6022
270255;201810;4650;13435;3566;11414;184;765;2552;7968;2736;8733
270260;201810;5598;16897;5210;16281;130;621;4529;13731;4659;14352
270270;201810;1001;2734;924;2632;136;383;629;1785;765;2168
270280;201810;3805;9480;3088;8573;448;809;2157;6378;2605;7187
270290;201810;7756;25061;7042;23887;295;1338;5934;19831;6229;21169
270300;201810;4059;11123;3222;10204;201;648;2415;7762;2616;8410
270310;201810;7075;20216;6166;18832;164;828;5192;15342;5356;16170
270320;201810;5705;16845;5061;15650;619;2047;3491;10497;4110;12544
270330;201810;3751;12613;3428;12146;273;1063;2681;9473;2954;10536
270340;201810;1625;4635;1397;4325;64;199;1135;3492;1199;3691
270350;201810;1903;4658;1596;4286;205;591;1067;2887;1272;3478
270360;201810;2381;6332;2165;6077;77;213;1982;5598;2059;5811
270370;201810;1393;4366;1272;4146;54;235;1013;3252;1067;3487
270375;201810;3104;7459;2647;6916;29;84;2445;6386;2474;6470
270380;201810;5607;16552;4863;15541;451;1510;3409;11133;3860;12643
270390;201810;1168;3084;982;2829;25;122;813;2291;838;2413
270400;201810;6159;16924;5304;15574;242;793;4063;11613;4305;12406
270410;201810;4529;13665;4017;12782;230;833;3171;9945;3401;10778
270420;201810;5580;16808;5123;16155;188;816;4313;13310;4501;14126
270430;201810;136394;344941;110681;311094;24699;73004;48555;138667;73254;211671
270440;201810;4794;13239;4133;12423;123;533;3472;10304;3595;10837
270450;201810;6676;18731;6029;17931;276;1047;5036;14821;5312;15868
270460;201810;3649;8454;3221;7941;50;212;3004;7246;3054;7458
270470;201810;10821;31729;9637;29996;931;3027;6945;21815;7876;24842
270480;201810;2839;7870;2443;7260;151;575;1930;5536;2081;6111
270490;201810;970;2813;860;2679;59;216;668;2053;727;2269
270500;201810;4825;15177;4418;14610;205;878;3612;11778;3817;12656
270510;201810;5693;15839;4949;14807;472;1761;3550;10123;4022;11884
270520;201810;3948;11621;3167;10229;755;2543;1153;3926;1908;6469
270530;201810;1124;3424;1016;3247;64;197;759;2442;823;2639
270540;201810;2143;6476;1913;6172;76;368;1629;5134;1705;5502
270550;201810;6689;18041;5567;16786;541;1467;4191;13039;4732;14506
270560;201810;3116;8513;2779;8040;171;549;2161;6138;2332;6687
270570;201810;4032;11614;3458;10718;140;591;2818;8535;2958;9126
270580;201810;2230;6466;2068;6224;106;316;1792;5376;1898;5692
270590;201810;1597;4760;1482;4618;11;54;1428;4449;1439;4503
270600;201810;2769;8683;2502;8238;80;406;2171;6995;2251;7401
270610;201810;3636;9781;3093;9074;97;379;2713;7824;2810;8203
270620;201810;1267;3955;1159;3758;50;217;966;3040;1016;3257
270630;201810;15546;41879;13826;39192;929;3001;11070;30904;11999;33905
270640;201810;5549;16094;4829;14989;201;838;3847;11554;4048;12392
270642;201810;2329;7735;2133;7435;154;757;1665;5563;1819;6320
270644;201810;3417;8754;2837;7993;235;636;2128;6097;2363;6733
270650;201810;3245;9748;2920;9278;454;1643;1950;5948;2404;7591
270660;201810;2152;5354;1738;4776;73;262;1312;3531;1385;3793
270670;201810;15549;38230;13440;35676;711;2047;11161;29364;11872;31411
270680;201810;5179;13154;4680;12591;164;269;4337;11874;4501;12143
270690;201810;9345;23716;7880;21982;1145;2917;5571;15842;6716;18759
270700;201810;552;1681;477;1541;34;141;347;1107;381;1248
270710;201810;5713;17312;5259;16691;274;1168;4352;13479;4626;14647
270720;201810;3340;10308;2983;9703;83;500;2586;8170;2669;8670
270730;201810;7642;18305;6993;17580;382;954;5622;15136;6004;16090
270740;201810;2358;6365;2110;6045;111;389;1708;4768;1819;5157
270750;201810;5401;14951;4776;14081;204;758;4004;11700;4208;12458
270760;201810;3347;9574;2948;8988;73;367;2497;7458;2570;7825
270770;201810;21031;52026;16780;46751;3207;8369;9349;27922;12556;36291
270780;201810;1778;5293;1688;5168;103;365;1404;4257;1507;4622
270790;201810;1575;4644;1378;4355;128;411;930;2947;1058;3358
270800;201810;10643;29974;9616;28514;430;1786;8198;23613;8628;25399
270810;201810;3250;9787;2608;8638;187;771;1796;5849;1983;6620
270820;201810;1694;5134;1437;4703;92;351;1090;3499;1182;3850
270830;201810;5385;13185;4470;12043;221;745;3590;9567;3811;10312
270840;201810;8131;24406;7311;23228;208;1170;6416;19744;6624;20914
270850;201810;8711;22019;7904;20990;535;1741;6571;16913;7106;18654
270860;201810;12077;30114;10085;27701;539;1737;8136;21968;8675;23705
270870;201810;2058;5952;1796;5498;228;736;1224;3779;1452;4515
270880;201810;8056;24454;7271;23301;262;1154;6026;18936;6288;20090
270890;201810;2564;7173;2242;6719;160;541;1629;4794;1789;5335
270895;201810;2907;9619;2711;9355;88;487;2404;8089;2492;8576
270900;201810;1799;4709;1391;4064;57;204;1078;3080;1135;3284
270910;201810;3715;11200;3234;10369;117;478;2485;7818;2602;8296
270915;201810;9020;27543;7637;25065;865;3324;4974;15813;5839;19137
270920;201810;5462;17101;5095;16518;248;1158;4180;13052;4428;14210
270930;201810;17180;41603;13647;37402;2139;5449;9067;25660;11206;31109
270940;201810;5991;17330;5366;16530;271;1236;4193;12529;4464;13765
280010;201810;666;1840;560;1640;24;103;385;1022;409;1125
280020;201810;4661;12385;4026;11357;574;1542;2652;7539;3226;9081
280030;201810;71223;173473;57092;153332;14594;40036;22628;63352;37222;103388
280040;201810;3026;8607;2669;8043;297;914;1820;5466;2117;6380
280050;201810;3824;11143;3351;10346;561;1814;1975;6101;2536;7915
280060;201810;5290;14653;4296;13087;797;2540;2117;6656;2914;9196
280067;201810;6888;17793;5877;16213;439;1304;4177;11302;4616;12606
280070;201810;1891;5851;1807;5694;106;383;1508;4673;1614;5056
280100;201810;3668;10496;3216;9746;371;1195;2223;6699;2594;7894
280110;201810;1315;3741;1182;3515;30;130;1029;2960;1059;3090
280120;201810;7426;22232;6764;21113;721;2107;5073;16055;5794;18162
280130;201810;8626;21211;7736;19947;633;1710;5980;15418;6613;17128
280140;201810;5496;13689;4885;12848;255;715;4077;10637;4332;11352
280150;201810;3800;10056;3435;9551;219;616;2781;7677;3000;8293
280160;201810;1202;3541;1007;3192;134;432;629;1959;763;2391
280170;201810;5097;13671;4650;13069;260;718;3867;10900;4127;11618
280190;201810;1186;2768;1017;2524;55;155;823;1986;878;2141
280200;201810;1299;3473;1062;3078;98;362;743;2078;841;2440
280210;201810;15114;39998;13355;37511;2049;6082;7955;22379;10004;28461
280220;201810;1755;4770;1521;4459;42;215;1250;3632;1292;3847
280230;201810;3731;9874;3357;9345;271;752;2463;6781;2734;7533
280240;201810;3386;9122;3065;8625;73;327;2606;7137;2679;7464
280250;201810;816;2116;658;1879;69;232;384;1020;453;1252
280260;201810;2109;5278;1926;5043;43;122;1792;4706;1835;4828
280270;201810;2278;6571;2042;6181;131;462;1703;5045;1834;5507
280280;201810;3908;12452;3553;11911;504;1529;2358;8273;2862;9802
280290;201810;17101;47201;15179;44438;2012;6225;9703;28655;11715;34880
280300;201810;10661;27782;9360;26329;327;1060;7392;21909;7719;22969
280310;201810;1352;3604;1120;3195;34;120;844;2326;878;2446
280320;201810;8426;23746;7419;22193;898;2774;4888;14420;5786;17194
280330;201810;4795;12100;4092;11069;298;821;3040;8122;3338;8943
280340;201810;5445;11380;4664;10518;285;550;3997;9171;4282;9721
280350;201810;23548;58746;20664;54536;1628;4557;15573;40621;17201;45178
280360;201810;5802;16708;5177;15614;931;2797;2809;8580;3740;11377
280370;201810;2142;5311;1772;4676;85;224;1427;3709;1512;3933
280380;201810;972;2760;856;2593;98;330;564;1697;662;2027
280390;201810;3483;9025;2875;8013;166;518;2225;6085;2391;6603
280400;201810;3875;10357;3428;9684;550;1464;2062;6031;2612;7495
280410;201810;2097;6158;1721;5462;202;675;1023;3155;1225;3830
280420;201810;4284;11678;3892;11135;104;367;3488;9907;3592;10274
280430;201810;2016;5116;1779;4789;72;269;1421;3708;1493;3977
280440;201810;4435;12100;3899;11302;251;831;3126;8811;3377;9642
280445;201810;2309;5976;2073;5562;50;153;1530;3920;1580;4073
280450;201810;10229;23658;9123;22209;383;763;7856;19304;8239;20067
280460;201810;6637;16330;6078;15539;510;1269;4941;12581;5451;13850
280470;201810;1728;4967;1528;4614;78;285;1123;3334;1201;3619
280480;201810;37222;95534;33197;89753;3053;9060;23769;62941;26822;72001
280490;201810;3794;10938;3257;10030;104;474;2464;7295;2568;7769
280500;201810;943;2320;797;2116;40;145;657;1715;697;1860
280510;201810;2553;6888;2230;6404;109;401;1650;4684;1759;5085
280520;201810;1619;4192;1439;3951;80;210;1173;3197;1253;3407
280530;201810;2636;6438;2280;6004;191;483;1761;4653;1952;5136
280540;201810;8940;24296;8228;23250;241;970;7233;20007;7474;20977
280550;201810;6611;15977;5486;14286;274;850;4354;10987;4628;11837
280560;201810;6962;20059;6604;19535;174;665;5828;16995;6002;17660
280570;201810;6285;16018;5203;14600;257;899;3832;10601;4089;11500
280580;201810;5383;15127;4666;13964;632;1791;3110;9447;3742;11238
280590;201810;2977;7123;2501;6526;168;601;1844;4578;2012;5179
280600;201810;3347;9408;3016;8932;216;726;2165;6355;2381;7081
280610;201810;2573;6438;2333;6109;203;504;1844;4793;2047;5297
280620;201810;5333;13785;4583;12707;455;1125;3260;9357;3715;10482
280630;201810;3723;11061;3366;10510;205;723;2676;8353;2881;9076
280640;201810;2450;6716;2222;6466;58;168;2012;5888;2070;6056
280650;201810;1251;3267;988;2876;76;259;719;2027;795;2286
280660;201810;3135;7535;2794;7132;112;313;2445;6195;2557;6508
280670;201810;19033;44077;16792;41167;1188;3046;13146;32153;14334;35199
280680;201810;2725;6823;2352;6239;188;419;1730;4582;1918;5001
280690;201810;955;2454;800;2226;37;100;602;1646;639;1746
280700;201810;1085;2819;942;2604;20;76;742;2011;762;2087
280710;201810;14700;33565;12761;31342;496;836;11191;28164;11687;29000
280720;201810;2738;6159;2215;5547;130;376;1480;3877;1610;4253
280730;201810;1091;2789;976;2615;75;239;741;1922;816;2161
280740;201810;13907;34810;11913;31689;1393;3626;7905;20798;9298;24424
280750;201810;3484;10030;3109;9354;187;661;2269;6693;2456;7354
280760;201810;6068;17018;5389;15937;620;1799;3561;10812;4181;12611
290010;201810;3091;6652;2138;5172;14;51;1762;4063;1776;4114
290020;201810;5287;14441;4936;13965;384;736;4199;12283;4583;13019
290030;201810;4036;10195;3518;9588;195;481;2959;8122;3154;8603
290035;201810;5166;11574;4170;10278;315;558;3301;8468;3616;9026
290040;201810;4309;10591;3643;9783;134;391;2849;7869;2983;8260
290050;201810;2123;6818;1795;6150;159;641;1204;4024;1363;4665
290060;201810;1288;3244;992;2748;97;344;662;1743;759;2087
290070;201810;34069;79514;29511;73618;2485;6366;21026;52472;23511;58838
290080;201810;5495;16442;4680;15221;563;1906;3125;10293;3688;12199
290090;201810;2211;4269;1651;3672;37;85;1500;3317;1537;3402
290100;201810;9519;25791;8041;23527;1053;2898;4852;14629;5905;17527
290110;201810;5085;14007;4621;13192;473;1392;3188;9005;3661;10397
290115;201810;4289;12456;3672;11486;240;808;2798;8727;3038;9535
290120;201810;6820;16804;5619;15298;157;546;4831;12931;4988;13477
290130;201810;4535;11305;3653;10190;120;460;2932;8034;3052;8494
290135;201810;4301;10236;3516;8967;245;649;2651;6564;2896;7213
290140;201810;4641;12507;3703;11309;129;483;3159;9602;3288;10085
290150;201810;2278;6401;2114;6157;179;571;1589;4524;1768;5095
290160;201810;3138;7638;2863;7283;328;712;2173;5613;2501;6325
290170;201810;3069;8411;2765;8048;100;345;2469;7165;2569;7510
290180;201810;2922;8059;2442;7288;90;324;1955;5750;2045;6074
290190;201810;4028;11953;3623;11386;164;668;2948;9099;3112;9767
290195;201810;2322;5974;1863;5289;47;215;1537;4320;1584;4535
290200;201810;3946;11302;3334;10309;248;829;2541;7808;2789;8637
290205;201810;3422;8920;3036;8365;147;541;2401;6402;2548;6943
290210;201810;13207;37661;11793;35553;1062;2906;8957;27751;10019;30657
290220;201810;2753;7146;2490;6811;177;517;1995;5381;2172;5898
290225;201810;3524;7519;2882;6840;25;64;2727;6480;2752;6544
290230;201810;2406;6676;2199;6432;54;215;1946;5656;2000;5871
290240;201810;3640;9394;3015;8589;122;416;2492;7019;2614;7435
290250;201810;4072;11917;3586;11254;167;515;2938;9498;3105;10013
290260;201810;5331;13605;4403;12252;231;805;3542;9660;3773;10465
290265;201810;3621;10576;2984;9392;153;587;2224;6887;2377;7474
290270;201810;11437;39255;10863;38257;702;2968;8608;29888;9310;32856
290280;201810;5829;17464;5149;16327;369;1332;3762;11773;4131;13105
290290;201810;9908;29521;8217;26354;848;2863;5536;17606;6384;20469
290300;201810;4288;11809;3168;9693;182;630;2225;6795;2407;7425
290310;201810;1528;3996;1287;3666;94;341;959;2656;1053;2997
290320;201810;23981;65277;19925;59159;4828;14455;9430;29149;14258;43604
290323;201810;3725;10197;3287;9559;76;266;2719;7802;2795;8068
290327;201810;4147;12170;3612;11150;293;896;2572;7935;2865;8831
290330;201810;2070;4543;1698;4131;53;113;1499;3651;1552;3764
290340;201810;5667;15210;4570;13811;607;1941;3190;9666;3797;11607
290350;201810;4643;13528;3937;12315;297;967;2855;8992;3152;9959
290360;201810;4971;13411;4342;12563;136;413;3746;10837;3882;11250
290370;201810;5294;13105;3994;11390;216;532;3003;8716;3219;9248
290380;201810;5561;15170;4779;14068;114;375;4174;12327;4288;12702
290390;201810;14385;41447;12318;38323;1358;4274;8338;26345;9696;30619
290395;201810;2759;8289;2331;7535;67;312;1825;5827;1892;6139
290400;201810;3561;9930;2894;8833;104;417;2195;6535;2299;6952
290405;201810;4655;13721;3908;12401;265;873;2734;8791;2999;9664
290410;201810;5670;15850;4488;13890;145;667;3417;10158;3562;10825
290420;201810;2949;8388;2454;7596;121;392;1916;5922;2037;6314
290430;201810;3083;8838;2556;7968;317;1032;1639;5066;1956;6098
290440;201810;2756;7075;2051;5986;52;170;1502;4425;1554;4595
290450;201810;3221;8754;2669;7941;157;528;2050;6001;2207;6529
290460;201810;11793;33236;10185;30218;2502;7593;4368;12857;6870;20450
290470;201810;4293;11273;3234;9705;375;1284;1825;5502;2200;6786
290475;201810;6359;18757;5427;17065;112;555;4365;13380;4477;13935
290480;201810;1801;4711;1564;4354;120;354;1055;2822;1175;3176
290485;201810;4464;13395;3941;12611;134;700;3362;10498;3496;11198
290490;201810;8828;21441;8032;20342;521;1285;6309;16120;6830;17405
290500;201810;3959;12057;3044;10099;509;1770;1391;4468;1900;6238
290510;201810;3321;8642;2828;7981;88;318;2452;6825;2540;7143
290515;201810;3725;10103;3160;9377;70;201;2773;8407;2843;8608
290520;201810;11262;33019;8740;27994;458;1767;5610;17569;6068;19336
290530;201810;4975;14327;4305;13234;171;592;3544;10884;3715;11476
290540;201810;3657;9804;3298;9355;81;290;2991;8423;3072;8713
290550;201810;4348;11311;3829;10710;31;97;3578;10101;3609;10198
290560;201810;6545;17412;5190;15352;487;1712;3507;10077;3994;11789
290570;201810;42589;108988;38785;104051;2896;8018;30695;81831;33591;89849
290580;201810;7698;23455;6857;22182;693;2215;5044;16657;5737;18872
290590;201810;6939;21682;6043;20074;155;638;4971;16492;5126;17130
290600;201810;18200;51903;16524;49319;843;2643;13173;39448;14016;42091
290610;201810;2487;8034;2000;7029;103;444;1387;4781;1490;5225
290620;201810;6432;18159;5629;16842;205;640;4772;14143;4977;14783
290630;201810;9034;22280;7280;19977;630;1718;5596;15398;6226;17116
290640;201810;2716;7260;2040;6164;101;312;1554;4651;1655;4963
290650;201810;11998;32049;10980;30756;2888;7802;6041;17905;8929;25707
290660;201810;3639;9460;3079;8659;82;213;2312;6767;2394;6980
290670;201810;6710;19166;5828;17700;474;1386;4418;13568;4892;14954
290680;201810;10432;29681;9003;27553;237;1198;7300;21739;7537;22937
290682;201810;4585;12375;4039;11587;133;336;3417;9827;3550;10163
290685;201810;3575;8149;2385;6478;207;533;1524;4340;1731;4873
290687;201810;6824;19021;5496;16799;817;2441;3310;10422;4127;12863
290689;201810;2807;8092;2307;7229;138;475;1713;5375;1851;5850
290690;201810;5627;14848;4606;13432;479;1369;3160;9195;3639;10564
290700;201810;2629;7331;2360;6966;90;343;1954;5749;2044;6092
290710;201810;8537;24231;7295;22522;204;786;6207;19062;6411;19848
290720;201810;18995;51842;17476;49680;1018;3135;14299;40370;15317;43505
290730;201810;7118;17740;6148;16564;263;629;4811;12986;5074;13615
290740;201810;1042;2910;794;2471;40;168;589;1816;629;1984
290750;201810;10514;27611;9236;25328;938;2746;6435;17138;7373;19884
290755;201810;2165;6060;1705;5225;95;323;1199;3645;1294;3968
290760;201810;3863;11387;3053;9784;311;903;1886;6294;2197;7197
290770;201810;2528;8416;2347;8185;56;273;1987;6978;2043;7251
290780;201810;8349;21160;7227;19593;361;802;5752;15856;6113;16658
290790;201810;4435;12513;3960;11862;152;475;3386;10200;3538;10675
290800;201810;7077;15016;5305;12930;357;795;4020;9989;4377;10784
290810;201810;5630;15360;4538;13627;117;430;3418;10261;3535;10691
290820;201810;5011;13511;4488;12734;262;845;3325;9452;3587;10297
290830;201810;4587;10701;4118;10082;72;196;3541;8542;3613;8738
290840;201810;16588;45617;14579;42470;1822;4669;9644;29408;11466;34077
290850;201810;6239;16044;5682;15425;441;1002;4638;12983;5079;13985
290860;201810;5719;17408;5024;16563;239;844;4213;14110;4452;14954
290870;201810;4802;13310;3713;11349;128;455;2675;8080;2803;8535
290880;201810;1411;3621;1110;3188;79;196;770;2257;849;2453
290890;201810;8157;17825;7422;16969;209;486;6870;15606;7079;16092
290900;201810;2354;6301;1777;5318;114;332;1147;3386;1261;3718
290910;201810;5156;13098;4042;11377;47;191;3363;9342;3410;9533
290920;201810;5103;12710;4731;12254;70;185;4447;11510;4517;11695
290930;201810;8003;22563;6581;20075;218;958;5224;15436;5442;16394
290940;201810;3722;10625;3120;9755;180;651;2426;7596;2606;8247
290950;201810;1497;3873;1258;3522;67;178;909;2559;976;2737
290960;201810;5298;14495;4833;13880;143;446;4154;11909;4297;12355
290970;201810;3538;10327;2942;9324;169;566;2244;7085;2413;7651
290980;201810;11017;28005;9405;25372;1058;3024;5458;14399;6516;17423
290990;201810;8960;25030;7908;23273;357;1336;6390;18246;6747;19582
291000;201810;3327;9067;2686;8251;244;684;2072;6489;2316;7173
291005;201810;14689;36323;13144;34380;778;2133;10877;28252;11655;30385
291010;201810;3004;9116;2442;7944;137;475;1630;5206;1767;5681
291020;201810;1273;3233;1026;2763;26;86;718;1835;744;1921
291030;201810;2415;6111;1669;4721;90;265;1081;2959;1171;3224
291040;201810;5313;15180;4593;14124;206;828;3656;11063;3862;11891
291050;201810;7425;21186;6520;19787;1031;3337;4207;12649;5238;15986
291060;201810;5766;19021;5056;17996;409;1785;3671;12880;4080;14665
291070;201810;15508;42942;13292;39466;544;1968;10704;31436;11248;33404
291072;201810;23418;63137;17381;51840;3622;11292;6819;20472;10441;31764
291075;201810;5020;13390;4470;12474;130;441;3657;9953;3787;10394
291077;201810;1570;4194;1246;3606;55;159;871;2515;926;2674
291080;201810;81476;227427;68622;207010;25727;79546;11782;37790;37509;117336
291085;201810;5705;14561;4773;13216;182;570;4034;11072;4216;11642
291090;201810;1901;3724;1470;3232;156;222;1140;2599;1296;2821
291100;201810;3090;6951;2140;5807;114;388;1636;4321;1750;4709
291110;201810;5756;17903;4984;16538;453;1783;3554;11377;4007;13160
291120;201810;7675;19298;6702;17966;424;1221;5091;13565;5515;14786
291125;201810;2146;3825;1573;3185;125;196;1187;2488;1312;2684
291130;201810;3056;9076;2367;7722;96;456;1695;5289;1791;5745
291140;201810;4615;12885;3467;10665;480;1322;2194;6838;2674;8160
291150;201810;2182;5091;1875;4731;20;54;1725;4333;1745;4387
291160;201810;4926;14243;4218;13147;410;1372;2862;8811;3272;10183
291165;201810;2197;6068;1707;5139;33;130;1264;3681;1297;3811
291170;201810;20320;52393;17255;47368;1029;3060;11246;30600;12275;33660
291180;201810;5875;14476;4615;12628;450;1223;3384;9288;3834;10511
291185;201810;3141;8775;2767;8098;89;303;2200;6322;2289;6625
291190;201810;7586;19114;6380;17460;391;1154;4982;13595;5373;14749
291200;201810;2855;8074;2145;6718;121;391;1298;4006;1419;4397
291210;201810;6748;15193;5291;13435;178;537;3998;10120;4176;10657
291220;201810;3953;11573;3571;10969;267;946;2708;8201;2975;9147
291230;201810;4411;9792;3428;8688;80;157;3107;7990;3187;8147
291240;201810;4185;11022;3680;10155;62;202;3186;8649;3248;8851
291250;201810;3350;9972;2668;8719;185;598;1775;5833;1960;6431
291260;201810;1358;3242;1157;2971;33;112;983;2508;1016;2620
291270;201810;5124;14325;4142;12706;831;2512;2410;7601;3241;10113
291280;201810;2365;6341;1807;5385;187;615;1074;3107;1261;3722
291290;201810;5918;15900;4765;14092;466;1418;3181;9390;3647;10808
291300;201810;3943;10773;2986;9154;139;452;2202;6677;2341;7129
291310;201810;5169;14120;4401;12677;140;477;3616;10222;3756;10699
291320;201810;6023;17600;4721;15004;1120;3356;2224;7381;3344;10737
291330;201810;1788;4557;1514;4118;75;210;1133;2997;1208;3207
291340;201810;4185;10981;3492;9840;93;323;2693;7447;2786;7770
291345;201810;3007;9305;2780;8974;139;478;2271;7348;2410;7826
291350;201810;6714;17364;5232;15371;121;380;4419;13147;4540;13527
291360;201810;34412;84551;28084;76367;4010;11161;16549;46043;20559;57204
291370;201810;7871;21779;7143;20739;524;1668;5392;15503;5916;17171
291380;201810;3304;9633;2985;9121;108;464;2446;7288;2554;7752
291390;201810;12736;29181;10266;26352;481;1341;8238;21060;8719;22401
291400;201810;13727;36789;11699;33721;1759;4609;7050;21642;8809;26251
291410;201810;2889;7633;2212;6478;67;306;1648;4666;1715;4972
291420;201810;1858;4774;1534;4353;44;175;1310;3673;1354;3848
291430;201810;2969;8336;2580;7735;102;434;2062;6003;2164;6437
291440;201810;6431;18703;5558;17202;343;1171;4391;13641;4734;14812
291450;201810;8475;22473;7228;20956;137;285;6325;18886;6462;19171
291460;201810;14784;40606;13129;38110;865;2738;9766;28224;10631;30962
291465;201810;8930;24212;7359;22323;247;1052;6209;18751;6456;19803
291470;201810;15532;37489;13300;34907;666;1685;10012;26989;10678;28674
291480;201810;39488;90571;29610;77019;4064;11088;15358;40013;19422;51101
291490;201810;5161;13725;4579;12999;217;691;3966;11260;4183;11951
291500;201810;5053;12489;4226;11358;68;296;3815;10170;3883;10466
291510;201810;3675;10271;2988;9246;98;470;2413;7377;2511;7847
291520;201810;4374;10427;3432;9158;496;1207;2252;6126;2748;7333
291530;201810;2208;5380;1668;4637;336;820;949;2886;1285;3706
291535;201810;3172;9651;2931;9236;194;583;2233;7132;2427;7715
291540;201810;2243;5015;1581;4260;56;224;1365;3553;1421;3777
291550;201810;5357;12796;4252;11300;437;1051;2768;7468;3205;8519
291560;201810;19594;44477;13555;37185;976;2506;9134;26268;10110;28774
291570;201810;2303;5590;1880;5063;91;199;1566;4317;1657;4516
291580;201810;6105;16499;4882;14833;332;1174;3529;10526;3861;11700
291590;201810;1828;5095;1668;4869;134;418;1332;3856;1466;4274
291600;201810;5109;12981;3849;10957;516;1575;2311;6375;2827;7950
291610;201810;5469;15345;5171;15009;85;307;4849;14051;4934;14358
291620;201810;3185;7080;2314;6116;120;325;1773;4779;1893;5104
291630;201810;3229;7494;2461;6503;224;643;1857;4848;2081;5491
291640;201810;15056;39220;11737;34177;1967;5731;4914;15108;6881;20839
291650;201810;8766;23423;7833;22253;496;1114;6655;19260;7151;20374
291660;201810;2157;5274;1561;4332;132;439;1032;2708;1164;3147
291670;201810;2019;5347;1726;4939;107;282;1369;3952;1476;4234
291680;201810;3925;10240;3317;9254;312;894;2441;6751;2753;7645
291685;201810;4628;11266;3744;10118;268;565;2822;7969;3090;8534
291690;201810;4103;9444;2978;7818;121;290;2416;6275;2537;6565
291700;201810;8589;25385;7682;23733;467;1594;6224;18992;6691;20586
291710;201810;5151;12794;3920;11022;338;1035;2688;7401;3026;8436
291720;201810;4469;13892;3696;12304;473;1687;2339;7590;2812;9277
291730;201810;6342;16880;5479;15723;271;944;4488;12777;4759;13721
291733;201810;2917;7611;2475;7001;75;246;1851;5432;1926;5678
291735;201810;2991;7810;2475;7014;82;255;2010;5661;2092;5916
291740;201810;3817;9975;2978;8578;115;349;2277;6441;2392;6790
291750;201810;19631;48232;15928;42616;1839;5034;10320;27679;12159;32713
291760;201810;10378;31060;8318;27596;2710;10134;2033;6767;4743;16901
291770;201810;6990;19561;5845;17441;556;1768;4121;12036;4677;13804
291780;201810;4913;13529;4466;12855;107;390;3897;11067;4004;11457
291790;201810;2626;7617;2434;7345;243;665;1838;5629;2081;6294
291800;201810;29608;76755;23064;66802;3516;9965;12526;37262;16042;47227
291810;201810;10445;25795;8762;23680;243;801;7613;20379;7856;21180
291820;201810;3754;10250;3305;9592;116;407;2610;7574;2726;7981
291830;201810;4275;10505;3641;9622;236;623;2909;7707;3145;8330
291835;201810;6279;19047;4949;16390;835;2846;2763;9393;3598;12239
291840;201810;45553;127021;39841;119063;5005;15501;27263;82276;32268;97777
291845;201810;2489;6781;2075;6262;121;367;1698;5173;1819;5540
291850;201810;4070;11658;3322;10376;312;869;2355;7589;2667;8458
291855;201810;2075;4329;1644;3815;58;150;1436;3312;1494;3462
291860;201810;2247;5952;1568;4630;40;140;1041;2968;1081;3108
291870;201810;1349;3448;904;2639;55;166;613;1728;668;1894
291875;201810;2647;8065;2368;7547;103;395;1785;5528;1888;5923
291880;201810;5402;15972;4720;14698;324;1016;3430;10664;3754;11680
291890;201810;1488;3256;1008;2668;185;440;626;1669;811;2109
291900;201810;1182;3050;921;2610;20;83;729;2005;749;2088
291905;201810;2692;6813;2077;5800;90;305;1541;4178;1631;4483
291910;201810;2827;7347;2417;6835;77;267;2064;5816;2141;6083
291915;201810;7257;21006;5989;18823;284;1031;4433;13874;4717;14905
291920;201810;24971;68955;21986;64706;2798;8743;14486;42072;17284;50815
291930;201810;2417;6876;2081;6323;244;819;1392;4123;1636;4942
291940;201810;3680;9798;2497;7705;239;728;1440;4346;1679;5074
291950;201810;8804;27393;7671;25187;579;2075;4999;16411;5578;18486
291955;201810;13957;36311;12682;34673;1366;3699;9553;26512;10919;30211
291960;201810;3101;8473;2546;7657;163;497;1917;5907;2080;6404
291970;201810;4174;11338;3618;10559;190;705;2680;7767;2870;8472
291980;201810;10244;29039;8138;25780;687;2125;5538;17739;6225;19864
291990;201810;2083;5693;1914;5504;14;66;1826;5263;1840;5329
291992;201810;4356;10551;3167;8893;298;756;2418;6902;2716;7658
291995;201810;2129;5879;1731;5276;56;262;1399;4137;1455;4399
292000;201810;2474;6275;2055;5682;156;546;1522;4138;1678;4684
292010;201810;6054;14148;4984;12647;233;643;4107;10277;4340;10920
292020;201810;4532;13472;3821;12198;277;996;2780;8647;3057;9643
292030;201810;1697;5427;1636;5315;178;602;948;2993;1126;3595
292040;201810;4239;11221;3481;10123;255;697;2730;8123;2985;8820
292045;201810;4023;10809;3025;9318;54;109;2673;8430;2727;8539
292050;201810;6384;18411;5171;16108;358;1241;3294;10086;3652;11327
292060;201810;12277;28323;11374;27217;656;1500;9778;23132;10434;24632
292070;201810;5704;15230;5028;14409;290;888;4293;12248;4583;13136
292080;201810;3218;8180;2654;7462;109;339;2327;6555;2436;6894
292090;201810;4510;9964;3340;8592;256;654;2567;6706;2823;7360
292100;201810;10249;26327;8821;24420;1386;3994;5287;14627;6673;18621
292105;201810;3302;8770;2924;8202;75;284;2437;6731;2512;7015
292110;201810;6193;15771;4491;12919;1083;3134;2003;5783;3086;8917
292120;201810;6826;17944;5576;15752;459;1361;4056;11259;4515;12620
292130;201810;3230;8071;2718;7430;175;534;2065;5603;2240;6137
292140;201810;5097;12240;4243;11004;269;685;3402;8766;3671;9451
292145;201810;2251;6763;1927;6167;88;306;1438;4611;1526;4917
292150;201810;12937;36797;11652;34821;283;1203;9807;28878;10090;30081
292160;201810;2773;7143;2203;6403;67;200;1844;5429;1911;5629
292170;201810;8238;22479;6879;20179;567;1752;4833;14051;5400;15803
292180;201810;2840;7806;2080;6470;310;911;1180;3665;1490;4576
292190;201810;2883;7791;2468;7186;175;528;1795;5279;1970;5807
292200;201810;7582;20244;5877;17644;978;3023;3188;9695;4166;12718
292205;201810;3808;10730;3319;9959;71;349;2938;8648;3009;8997
292210;201810;6107;14967;5087;13614;98;435;4540;11931;4638;12366
292220;201810;2039;5103;1799;4759;98;284;1373;3554;1471;3838
292225;201810;3216;9469;2873;8941;85;348;2397;7328;2482;7676
292230;201810;8147;19947;7346;18903;188;686;6219;15612;6407;16298
292240;201810;4895;14200;4204;12879;367;1078;2825;8644;3192;9722
292250;201810;5144;14433;4733;13769;656;1806;3111;9233;3767;11039
292260;201810;3305;8983;2965;8524;151;407;2563;7442;2714;7849
292265;201810;3287;9322;2794;8502;84;397;2202;6500;2286;6897
292270;201810;4108;9789;3356;8868;199;553;2732;7240;2931;7793
292273;201810;2547;5681;2076;5095;71;127;1612;4119;1683;4246
292275;201810;1802;4991;1440;4468;71;173;1134;3632;1205;3805
292280;201810;2544;6237;2116;5741;114;257;1726;4857;1840;5114
292285;201810;2549;6298;2008;5533;91;238;1563;4353;1654;4591
292290;201810;6961;19438;5797;17732;197;733;4746;14451;4943;15184
292300;201810;10016;26338;7943;23656;990;3210;5103;15212;6093;18422
292303;201810;2858;8319;2519;7782;65;188;2164;6709;2229;6897
292305;201810;2526;6745;2331;6462;49;226;2070;5618;2119;5844
292310;201810;6523;17257;5669;16176;200;656;4850;13719;5050;14375
292320;201810;6197;16951;5075;14881;304;954;3826;10938;4130;11892
292330;201810;2662;6046;2161;5470;116;275;1691;4373;1807;4648
292335;201810;4785;12521;4275;11782;304;779;3493;9708;3797;10487
292340;201810;5824;16230;4948;14577;240;749;3732;10815;3972;11564
292350;201810;2489;6721;2057;6155;86;326;1701;5089;1787;5415
292360;201810;4851;13080;4102;11758;326;1054;2845;7921;3171;8975
292370;201810;10906;24968;9570;23180;147;446;8862;21076;9009;21522
292380;201810;6777;19182;6134;18063;449;1321;4682;13683;5131;15004
292390;201810;4342;8620;3157;7221;397;506;2464;6028;2861;6534
292400;201810;21218;62759;18866;58742;1913;6288;13173;40870;15086;47158
292405;201810;4418;10827;3631;9708;167;404;2940;7859;3107;8263
292410;201810;2105;5163;1839;4843;68;197;1614;4268;1682;4465
292420;201810;3603;11055;3344;10662;168;747;2793;8748;2961;9495
292430;201810;4833;14950;3767;13117;304;1073;2518;8901;2822;9974
292440;201810;8233;26573;7696;25822;117;562;7102;23845;7219;24407
292450;201810;3795;11253;3077;9813;149;548;2369;7501;2518;8049
292460;201810;4808;13579;3991;12167;356;1051;2858;8739;3214;9790
292465;201810;2503;6806;2081;6185;98;266;1466;4549;1564;4815
292467;201810;1749;5147;1598;4940;238;693;1087;3469;1325;4162
292470;201810;3004;7637;2358;6596;77;181;1853;5206;1930;5387
292480;201810;6438;15446;5184;13910;90;336;4638;12234;4728;12570
292490;201810;2096;5626;1761;5114;108;315;1344;3922;1452;4237
292500;201810;6417;18013;5249;15890;613;1878;3429;10323;4042;12201
292510;201810;12413;34260;10151;30795;605;2166;7471;22563;8076;24729
292520;201810;6632;17085;5839;15873;717;1946;4144;11300;4861;13246
292525;201810;5671;13722;4702;12586;127;378;4105;10972;4232;11350
292530;201810;26194;71275;21164;63099;5863;17653;7565;23469;13428;41122
292540;201810;3862;7934;3126;7128;142;302;2723;6209;2865;6511
292550;201810;7729;21499;6068;19340;429;1487;4492;14670;4921;16157
292560;201810;4273;11038;3646;10137;108;401;2992;8247;3100;8648
292570;201810;3904;10264;3360;9417;75;272;2960;8156;3035;8428
292575;201810;6856;20387;6376;19729;298;1034;5345;16467;5643;17501
292580;201810;7358;19241;6322;17697;179;566;5304;14717;5483;15283
292590;201810;7216;19348;6478;18228;303;987;5486;15068;5789;16055
292593;201810;2815;7035;2373;6295;76;195;1955;5149;2031;5344
292595;201810;5347;14333;4673;13475;171;589;3929;11180;4100;11769
292600;201810;10870;29899;9474;27866;487;1335;7407;21893;7894;23228
292610;201810;4317;11351;3625;10165;212;491;2606;7485;2818;7976
292620;201810;6382;17830;5427;16732;74;176;5132;15999;5206;16175
292630;201810;8594;21375;7084;18916;534;1425;4928;13201;5462;14626
292640;201810;8140;24446;7189;22899;239;987;5187;16480;5426;17467
292650;201810;4618;11345;4195;10783;135;377;3801;9638;3936;10015
292660;201810;11008;30576;9545;28376;554;1762;7494;22233;8048;23995
292665;201810;2185;6569;1982;6309;77;228;1690;5475;1767;5703
292670;201810;3533;9603;2730;8109;117;418;1872;5449;1989;5867
292680;201810;3902;10684;3177;9326;194;581;2310;6608;2504;7189
292690;201810;2572;6881;1836;5660;162;465;1157;3722;1319;4187
292700;201810;9688;26816;8483;24986;858;2417;5773;17486;6631;19903
292710;201810;2365;7608;2184;7364;56;196;1958;6649;2014;6845
292720;201810;9293;22422;7840;20796;306;859;6395;17061;6701;17920
292730;201810;4318;10547;4077;10241;214;415;3536;8962;3750;9377
292740;201810;321119;812230;290278;765217;49396;132571;173036;452460;222432;585031
292750;201810;6225;16788;5377;15512;292;841;4061;11835;4353;12676
292760;201810;3833;11200;3404;10451;268;901;2464;7492;2732;8393
292770;201810;5837;16320;4903;14888;834;2649;2901;9105;3735;11754
292780;201810;1913;3999;1453;3434;87;195;1150;2646;1237;2841
292790;201810;4102;8810;3245;7872;203;454;2769;6763;2972;7217
292800;201810;10720;27348;9366;25255;386;1047;7745;20684;8131;21731
292805;201810;3429;8590;2718;7616;196;505;2023;5679;2219;6184
292810;201810;10352;28215;8245;24964;274;1084;6152;18230;6426;19314
292820;201810;7550;20647;5493;17442;546;1861;3750;11736;4296;13597
292830;201810;2860;6714;2433;6186;81;273;2141;5398;2222;5671
292840;201810;8932;23431;7849;21940;168;608;6858;18725;7026;19333
292850;201810;2550;6932;2132;6274;142;481;1473;4190;1615;4671
292860;201810;16221;37944;14592;35876;834;2048;11937;29188;12771;31236
292870;201810;16698;43799;14743;40918;1100;3359;9856;26992;10956;30351
292880;201810;11433;31214;9899;28968;368;1524;7707;21723;8075;23247
292890;201810;6272;18404;5613;17333;287;1060;4620;14119;4907;15179
292895;201810;2968;6552;2195;5398;109;267;1691;4121;1800;4388
292900;201810;2697;7509;2502;7194;70;322;2024;5602;2094;5924
292905;201810;4268;11620;3348;10227;199;687;2346;7097;2545;7784
292910;201810;4928;13780;4475;13046;313;1025;3307;9511;3620;10536
292920;201810;9815;27229;9211;26386;291;1119;8007;22463;8298;23582
292925;201810;5282;15193;4648;14079;270;826;3472;10392;3742;11218
292930;201810;6277;19138;5506;17617;464;1803;3475;10755;3939;12558
292935;201810;2201;5961;1794;5515;35;171;1594;4950;1629;5121
292937;201810;3120;7510;2723;7032;72;213;2415;6215;2487;6428
292940;201810;3069;7967;2470;7030;185;437;1792;5241;1977;5678
292950;201810;9642;25199;8572;23574;425;1182;6573;17838;6998;19020
292960;201810;5250;12704;4512;11691;129;381;3633;9206;3762;9587
292970;201810;3943;11502;3398;10711;124;556;2782;8760;2906;9316
292975;201810;4442;9767;3960;9211;202;379;3520;8311;3722;8690
292980;201810;3291;8149;2624;7115;109;345;2072;5506;2181;5851
292990;201810;11351;31328;9619;28285;732;2334;7131;20851;7863;23185
293000;201810;2591;6299;2294;5897;35;136;1820;4747;1855;4883
293010;201810;17946;46984;14716;41717;2107;6061;8829;24924;10936;30985
293015;201810;7711;24490;6226;21478;495;2041;4207;14362;4702;16403
293020;201810;9575;28717;8704;27495;147;683;7779;24676;7926;25359
293030;201810;5413;14734;4172;12795;530;1534;2402;7741;2932;9275
293040;201810;3923;11175;3457;10519;93;325;3017;9181;3110;9506
293050;201810;21291;53736;19036;50492;1424;3900;13852;36682;15276;40582
293060;201810;3469;9163;2848;8144;204;634;2087;5827;2291;6461
293070;201810;24627;61466;20771;56228;3110;8549;12949;35733;16059;44282
293075;201810;3291;10690;2953;10149;222;929;2320;7925;2542;8854
293076;201810;3589;9142;3199;8625;103;282;2701;7350;2804;7632
293077;201810;5762;16501;4781;15035;517;1670;3089;9997;3606;11667
293080;201810;4768;14300;4197;13335;144;628;3332;10334;3476;10962
293090;201810;3140;9360;2468;8238;277;984;1554;5166;1831;6150
293100;201810;5702;15665;4668;13790;324;997;3553;10447;3877;11444
293105;201810;3673;11743;3227;10839;226;783;2337;7750;2563;8533
293110;201810;2413;5991;2055;5506;70;272;1728;4467;1798;4739
293120;201810;4217;11855;3803;11165;139;366;3160;9302;3299;9668
293130;201810;3751;10531;3352;10014;108;447;2879;8509;2987;8956
293135;201810;29161;71030;21738;60539;4111;12606;9282;25925;13393;38531
293140;201810;2259;5386;2009;5076;90;251;1680;4164;1770;4415
293150;201810;5265;16270;4430;14631;447;1503;3011;10007;3458;11510
293160;201810;3869;9583;3326;8945;272;523;2707;7627;2979;8150
293170;201810;4249;9873;3723;9169;121;349;3095;7506;3216;7855
293180;201810;4677;12779;3812;11317;115;494;3079;8882;3194;9376
293190;201810;13649;38344;12213;36202;262;1139;10645;31252;10907;32391
293200;201810;8015;20252;6636;18182;246;892;5203;13965;5449;14857
293210;201810;5081;13640;4341;12432;297;815;3386;9710;3683;10525
293220;201810;4906;13372;3753;11322;906;2768;1447;4546;2353;7314
293230;201810;3902;10389;3013;9081;296;963;2015;6151;2311;7114
293240;201810;4439;11845;3560;10400;102;288;2705;8081;2807;8369
293245;201810;3937;10700;3533;10130;182;583;2955;8364;3137;8947
293250;201810;5481;13598;4720;12525;271;730;3810;10068;4081;10798
293260;201810;4385;12322;3630;11145;122;396;2576;7854;2698;8250
293270;201810;6760;15857;5473;14445;524;969;4149;11671;4673;12640
293280;201810;4853;12891;4197;11981;268;702;3235;9289;3503;9991
293290;201810;13187;40965;11951;38888;2575;8336;6440;21704;9015;30040
293300;201810;5963;14360;5117;13212;333;776;3776;9887;4109;10663
293305;201810;4033;10148;3554;9498;48;139;3191;8498;3239;8637
293310;201810;2132;5545;1775;4923;74;225;1354;3693;1428;3918
293315;201810;4146;10193;3396;9030;188;477;2709;7154;2897;7631
293317;201810;2455;6210;2196;5813;178;412;1661;4423;1839;4835
293320;201810;10162;27001;9460;26161;473;1419;8212;22623;8685;24042
293325;201810;1686;4413;1364;3935;200;585;872;2525;1072;3110
293330;201810;43061;135156;37537;125079;8408;28384;16851;57309;25259;85693
293340;201810;2365;6664;1923;5887;125;432;1312;3977;1437;4409
293345;201810;3224;9152;2686;8381;301;697;1910;6364;2211;7061
293350;201810;6689;19162;5954;18335;60;195;5551;17406;5611;17601
293360;201810;14958;39310;12968;36792;498;1743;11304;31657;11802;33400
310010;201810;816;1979;581;1635;73;245;262;689;335;934
310020;201810;2253;6497;1708;5530;365;1286;274;840;639;2126
310030;201810;2128;6238;1713;5478;259;938;1076;3277;1335;4215
310040;201810;943;2461;774;2191;44;164;556;1491;600;1655
310050;201810;1556;4966;1400;4670;207;840;782;2503;989;3343
310060;201810;3270;9376;2861;8851;134;574;2360;7178;2494;7752
310070;201810;358;844;248;667;7;17;188;500;195;517
310080;201810;810;2232;550;1694;72;259;222;642;294;901
310090;201810;4446;12382;3724;11183;334;1090;2679;7898;3013;8988
310100;201810;3276;9385;2794;8576;105;457;2233;6622;2338;7079
310110;201810;4803;13049;3830;11304;753;2470;1752;4894;2505;7364
310120;201810;620;1583;398;1193;66;251;198;518;264;769
310130;201810;374;1058;315;958;44;170;194;540;238;710
310140;201810;224;699;164;585;37;157;51;152;88;309
310150;201810;4598;13080;3561;11070;657;2248;1397;4177;2054;6425
310160;201810;7087;19158;5284;16102;1267;4236;1580;4685;2847;8921
310163;201810;965;2886;782;2545;242;872;220;648;462;1520
310170;201810;8914;23565;7334;21109;745;2197;5143;14797;5888;16994
310180;201810;1675;4404;1323;3828;111;394;900;2490;1011;2884
310190;201810;2841;8837;2344;7862;559;2053;313;968;872;3021
310200;201810;1697;5276;1303;4451;247;928;507;1679;754;2607
310205;201810;1061;2949;769;2477;179;622;252;799;431;1421
310210;201810;2665;7107;2218;6402;114;339;1699;4874;1813;5213
310220;201810;1096;3050;894;2713;110;359;601;1777;711;2136
310230;201810;2255;6516;1886;5788;222;837;1136;3214;1358;4051
310240;201810;880;2885;760;2665;61;274;526;1796;587;2070
310250;201810;1009;2784;835;2500;56;220;593;1720;649;1940
310260;201810;2694;7491;1711;5700;482;1846;308;759;790;2605
310270;201810;2646;6773;2068;5973;116;441;1674;4744;1790;5185
310280;201810;2281;5508;1805;4821;307;876;1002;2529;1309;3405
310285;201810;1859;6220;1623;5807;171;725;1007;3560;1178;4285
310290;201810;1120;3063;963;2779;217;710;510;1329;727;2039
310300;201810;1450;4536;1309;4296;218;865;660;1968;878;2833
310310;201810;317;818;223;653;37;115;117;336;154;451
310320;201810;504;1336;319;1005;29;113;160;470;189;583
310330;201810;496;1180;299;817;40;129;130;314;170;443
310340;201810;7669;21497;6172;18941;1047;3137;3041;9654;4088;12791
310350;201810;11686;29584;8170;23727;1984;6127;2723;7645;4707;13772
310360;201810;461;1153;370;1038;13;41;280;774;293;815
310370;201810;1276;4110;1078;3714;235;850;339;1203;574;2053
310375;201810;878;2355;587;1875;103;340;230;733;333;1073
310380;201810;385;912;204;592;42;115;75;198;117;313
310390;201810;434;1359;358;1212;92;338;85;228;177;566
310400;201810;9463;23926;6679;19543;1041;3406;3326;9415;4367;12821
310410;201810;772;2288;479;1734;110;416;120;398;230;814
310420;201810;3858;10345;2489;7530;476;1630;668;1770;1144;3400
310430;201810;1403;4003;913;3046;196;712;256;794;452;1506
310440;201810;571;1457;390;1132;25;110;232;646;257;756
310445;201810;1381;4041;1026;3334;63;214;710;2278;773;2492
310450;201810;4686;12138;3535;10295;210;737;2646;7511;2856;8248
310460;201810;1648;4529;1120;3502;233;782;308;931;541;1713
310470;201810;3905;8583;3087;7507;303;858;2349;5596;2652;6454
310480;201810;1061;2861;792;2385;124;419;471;1356;595;1775
310490;201810;2874;8328;2279;7227;366;1370;1079;3144;1445;4514
310500;201810;1449;4235;1049;3459;217;770;471;1525;688;2295
310510;201810;1839;5060;1202;3834;256;902;359;1144;615;2046
310520;201810;1326;3350;955;2737;133;366;549;1567;682;1933
310530;201810;796;2150;436;1345;66;231;94;215;160;446
310540;201810;3290;9663;2729;8652;703;2332;1069;3265;1772;5597
310550;201810;1253;3276;886;2645;84;315;529;1470;613;1785
310560;201810;13846;37854;10363;31830;2232;7642;3616;10030;5848;17672
310570;201810;1074;3017;896;2734;94;372;606;1768;700;2140
310590;201810;4094;11237;3343;9916;314;1066;1904;5360;2218;6426
310600;201810;1399;4257;1156;3736;177;641;560;1691;737;2332
310610;201810;519;1413;333;1098;63;240;163;491;226;731
310620;201810;154230;414252;115793;343332;23614;78917;46122;121980;69736;200897
310630;201810;4407;12407;3695;11095;281;989;2522;7341;2803;8330
310640;201810;999;3120;837;2787;207;754;273;851;480;1605
310650;201810;2426;7244;1806;6050;218;811;1016;3266;1234;4077
310660;201810;1263;3531;1083;3300;52;172;876;2627;928;2799
310665;201810;1311;3525;1067;3165;60;216;852;2494;912;2710
310670;201810;48112;131067;40640;117578;5683;18466;24630;67606;30313;86072
310680;201810;657;1667;565;1536;29;85;444;1176;473;1261
310690;201810;1684;4695;1266;3981;137;512;701;2092;838;2604
310700;201810;496;1121;374;977;42;133;254;631;296;764
310710;201810;5217;15629;3753;13458;859;3605;440;1498;1299;5103
310720;201810;898;2318;721;2076;59;205;512;1420;571;1625
310730;201810;9104;25858;7884;23864;536;2004;5576;16505;6112;18509
310740;201810;5227;15019;3586;11523;693;2381;1003;3003;1696;5384
310750;201810;1223;3037;869;2518;147;490;380;1010;527;1500
310760;201810;540;1509;411;1283;41;143;188;590;229;733
310770;201810;1060;2978;720;2456;102;379;352;1158;454;1537
310780;201810;3982;10231;3222;9020;170;503;2290;6291;2460;6794
310790;201810;1822;5767;1608;5340;390;1341;621;2108;1011;3449
310800;201810;2298;7041;1670;5750;431;1768;104;322;535;2090
310810;201810;1118;2940;910;2563;58;201;598;1620;656;1821
310820;201810;1148;3111;697;2255;159;544;142;454;301;998
310825;201810;2747;9085;2277;8263;94;533;1816;6391;1910;6924
310830;201810;1485;4388;1065;3539;238;890;408;1273;646;2163
310840;201810;1929;5425;1370;4406;329;1160;341;967;670;2127
310850;201810;1522;4216;1299;3910;70;327;1010;2898;1080;3225
310855;201810;3248;8856;2554;7757;231;797;1771;5249;2002;6046
310860;201810;6902;20313;5555;17631;609;1978;3341;10656;3950;12634
310870;201810;1057;2558;796;2166;90;255;563;1534;653;1789
310880;201810;999;3042;789;2613;91;310;463;1497;554;1807
310890;201810;2239;6430;1472;4968;314;1159;180;520;494;1679
310900;201810;4290;12213;3219;10146;521;1806;1448;4195;1969;6001
310910;201810;1682;4437;1079;3336;128;464;152;408;280;872
310920;201810;1828;5002;1419;4343;258;807;714;2177;972;2984
310925;201810;938;2745;784;2476;101;354;527;1620;628;1974
310930;201810;5805;15770;4262;13248;815;2659;2103;6669;2918;9328
310940;201810;6236;16050;5024;14191;313;1082;3558;9726;3871;10808
310945;201810;1223;3304;1028;3015;104;354;630;1785;734;2139
310950;201810;1843;5611;1272;4336;254;983;431;1323;685;2306
310960;201810;745;1925;434;1341;58;198;155;489;213;687
310970;201810;1156;3486;805;2732;192;708;180;546;372;1254
310980;201810;360;849;228;633;22;61;143;377;165;438
310990;201810;1223;3617;955;3058;218;715;375;1168;593;1883
311000;201810;4031;11644;3053;9942;921;3138;1030;3227;1951;6365
311010;201810;770;2412;625;2088;249;890;181;571;430;1461
311020;201810;1003;2696;673;2061;83;288;304;884;387;1172
311030;201810;1475;3918;1012;3099;265;914;362;998;627;1912
311040;201810;323;1038;257;874;70;239;70;211;140;450
311050;201810;2313;6306;1834;5546;430;1432;754;2182;1184;3614
311060;201810;2716;7425;1866;5644;306;1084;730;1960;1036;3044
311070;201810;1884;5203;1396;4353;193;728;653;1905;846;2633
311080;201810;982;2459;808;2150;67;250;563;1378;630;1628
311090;201810;1968;6538;1564;5771;394;1624;432;1526;826;3150
311100;201810;1998;5985;1290;4531;319;1250;189;582;508;1832
311110;201810;3482;7618;2084;5588;467;1374;801;2130;1268;3504
311115;201810;1257;3188;1026;2861;77;264;787;2131;864;2395
311120;201810;6515;17662;4862;14555;870;2951;1631;4318;2501;7269
311130;201810;1851;5091;1453;4520;153;623;768;2255;921;2878
311140;201810;1292;3246;969;2776;79;255;628;1814;707;2069
311150;201810;1470;4807;1227;4337;205;819;655;2228;860;3047
311160;201810;3636;11048;2608;9123;760;2920;679;2311;1439;5231
311170;201810;833;2283;661;2015;43;137;409;1279;452;1416
311180;201810;1294;3070;842;2373;209;632;339;946;548;1578
311190;201810;1049;2934;772;2380;119;439;308;855;427;1294
311200;201810;1709;4841;1240;3902;316;1078;315;883;631;1961
311205;201810;895;2802;747;2501;58;259;422;1354;480;1613
311210;201810;1009;3060;891;2906;133;430;639;2125;772;2555
311220;201810;735;2159;613;1930;93;322;305;882;398;1204
311230;201810;7653;23587;5749;19753;1097;3962;1929;6846;3026;10808
311240;201810;942;2618;732;2320;178;629;369;1132;547;1761
311250;201810;860;2517;695;2230;158;541;317;983;475;1524
311260;201810;2322;5833;1513;4466;304;934;517;1442;821;2376
311265;201810;1208;3260;927;2794;63;228;647;1885;710;2113
311270;201810;3055;9388;2697;8836;205;968;1922;5948;2127;6916
311280;201810;1160;3156;573;1866;96;340;94;279;190;619
311290;201810;1864;5849;1740;5587;194;642;1173;3729;1367;4371
311300;201810;4554;13263;3838;12098;230;1008;2960;9097;3190;10105
311310;201810;561;1670;481;1518;76;262;217;643;293;905
311320;201810;3027;9614;2672;8806;433;1632;1215;3679;1648;5311
311330;201810;4656;13012;3953;11832;496;1647;2148;6477;2644;8124
311340;201810;10179;30477;8224;26747;2396;8302;2060;6724;4456;15026
311350;201810;2188;5715;1586;4600;160;538;834;2169;994;2707
311360;201810;923;2485;672;2093;238;808;175;525;413;1333
311370;201810;4317;11238;3258;9419;200;792;1995;5458;2195;6250
311380;201810;403;1273;322;1102;82;288;108;371;190;659
311390;201810;1687;5463;1380;5035;581;2424;342;1062;923;3486
311400;201810;1380;4026;985;3215;151;567;389;1127;540;1694
311410;201810;1548;4830;1327;4524;246;919;679;2342;925;3261
311420;201810;1607;4895;1088;3741;188;681;165;438;353;1119
311430;201810;3320;9203;2198;6937;421;1365;617;1964;1038;3329
311440;201810;2410;7140;1717;5882;409;1604;511;1695;920;3299
311450;201810;1741;5467;1294;4593;334;1316;285;866;619;2182
311455;201810;965;2309;667;1834;181;500;248;694;429;1194
311460;201810;492;1604;335;1279;80;384;91;310;171;694
311470;201810;435;1412;322;1133;70;282;56;182;126;464
311480;201810;1533;5282;1394;5089;51;149;1232;4641;1283;4790
311490;201810;216;677;179;598;51;193;73;222;124;415
311500;201810;407;1075;299;888;29;96;174;510;203;606
311510;201810;2771;7716;1870;6034;355;1283;615;1827;970;3110
311520;201810;550;1678;509;1587;118;415;272;800;390;1215
311530;201810;8667;21213;5662;16175;1432;4514;1515;4271;2947;8785
311535;201810;737;2067;501;1617;103;379;130;390;233;769
311540;201810;512;1661;458;1560;102;345;246;847;348;1192
311545;201810;2043;5821;1760;5443;106;410;1331;4021;1437;4431
311547;201810;1471;3860;1277;3545;42;141;935;2615;977;2756
311550;201810;2682;7798;2132;6745;354;1261;810;2423;1164;3684
311560;201810;278;629;193;512;31;85;106;252;137;337
311570;201810;1848;4397;1355;3712;65;190;1068;2995;1133;3185
311580;201810;2117;4107;1446;3311;177;352;922;2188;1099;2540
311590;201810;477;1367;397;1246;64;243;209;636;273;879
311600;201810;1649;3886;1368;3531;60;182;1159;2921;1219;3103
311610;201810;2362;8060;2001;7238;371;1364;935;3368;1306;4732
311615;201810;2928;8801;2419;7959;174;677;1786;5767;1960;6444
311620;201810;393;1104;343;1030;24;86;271;795;295;881
311630;201810;1338;3721;1079;3221;98;311;708;2036;806;2347
311640;201810;538;1640;448;1459;88;331;203;606;291;937
311650;201810;1878;5082;1612;4655;129;469;1098;3014;1227;3483
311660;201810;2737;8080;1996;6670;393;1434;419;1195;812;2629
311670;201810;1537;4105;1178;3508;204;684;495;1495;699;2179
311680;201810;2082;6148;1600;5284;302;1044;916;2996;1218;4040
311690;201810;563;1263;449;1129;35;84;339;887;374;971
311700;201810;2243;5463;1751;4787;36;127;1448;3855;1484;3982
311710;201810;1464;4337;1015;3463;266;975;329;1121;595;2096
311720;201810;405;1259;329;1110;38;159;172;553;210;712
311730;201810;4364;11038;2681;7975;855;2816;392;1118;1247;3934
311740;201810;779;2336;699;2225;41;119;619;1989;660;2108
311750;201810;3784;11847;3142;10756;465;1781;1672;5450;2137;7231
311760;201810;614;1829;515;1643;93;367;203;536;296;903
311770;201810;1930;5831;1497;4994;296;1077;562;1761;858;2838
311780;201810;1183;3666;850;2939;176;687;224;671;400;1358
311783;201810;2157;6170;1784;5525;53;240;1443;4342;1496;4582
311787;201810;689;2045;488;1570;68;236;188;522;256;758
311790;201810;1491;3965;964;3033;230;800;323;988;553;1788
311800;201810;4548;14202;3783;12495;738;2689;625;1876;1363;4565
311810;201810;944;2990;755;2632;68;275;446;1536;514;1811
311820;201810;746;2003;585;1699;78;266;351;950;429;1216
311830;201810;8111;24226;5663;18725;1554;5488;616;1911;2170;7399
311840;201810;3070;8414;2637;7773;314;1016;1842;5385;2156;6401
311850;201810;304;868;255;790;23;77;161;485;184;562
311860;201810;53158;140156;41760;120910;6912;21202;23095;65037;30007;86239
311870;201810;1806;5056;1257;4022;244;874;460;1296;704;2170
311880;201810;6134;16585;5281;15373;383;1043;3995;11723;4378;12766
311890;201810;1510;3925;1205;3457;125;416;793;2195;918;2611
311900;201810;680;1822;525;1590;61;216;350;1028;411;1244
311910;201810;4164;11006;3185;9720;641;1976;1592;4949;2233;6925
311920;201810;1927;5616;1578;5035;162;528;917;2930;1079;3458
311930;201810;3145;8089;2474;7091;929;2840;752;1988;1681;4828
311940;201810;13575;37461;10163;30835;1572;5229;4566;12977;6138;18206
311950;201810;2121;6044;1608;5129;108;471;1080;3344;1188;3815
311960;201810;552;1353;451;1188;30;140;309;685;339;825
311970;201810;436;1448;291;1070;53;217;60;204;113;421
311980;201810;433;1226;239;810;32;111;70;231;102;342
311990;201810;536;1330;357;1074;82;289;151;422;233;711
311995;201810;952;2712;509;1679;20;72;52;119;72;191
312000;201810;564;1538;472;1398;37;125;337;993;374;1118
312010;201810;856;2544;674;2185;70;247;403;1267;473;1514
312015;201810;1291;3948;1163;3709;66;282;891;2740;957;3022
312020;201810;1106;3480;936;3172;224;806;343;1133;567;1939
312030;201810;2020;5103;1771;4815;32;144;1627;4365;1659;4509
312040;201810;769;2492;583;2070;67;274;237;801;304;1075
312050;201810;1209;3932;952;3400;212;871;242;760;454;1631
312060;201810;813;2130;564;1795;140;467;255;800;395;1267
312070;201810;846;2545;611;2058;73;286;321;1026;394;1312
312080;201810;2733;6927;2043;5861;163;538;1279;3456;1442;3994
312083;201810;882;2389;674;2062;83;280;421;1228;504;1508
312087;201810;2257;6203;1892;5662;79;285;1459;4366;1538;4651
312090;201810;9237;25695;7200;22216;1446;4794;3148;9586;4594;14380
312100;201810;1519;4683;1093;3885;161;681;487;1636;648;2317
312110;201810;1010;3282;850;2939;228;887;237;720;465;1607
312120;201810;669;1936;493;1618;147;559;168;457;315;1016
312125;201810;1548;4243;1304;3860;145;465;914;2625;1059;3090
312130;201810;872;2243;667;1886;76;242;267;694;343;936
312140;201810;776;2389;646;2097;144;502;251;739;395;1241
312150;201810;454;1310;384;1143;10;50;275;761;285;811
312160;201810;7724;22904;6050;19787;993;3714;2586;7927;3579;11641
312170;201810;841;2334;671;2032;43;133;441;1298;484;1431
312180;201810;1341;3756;1087;3249;164;526;554;1563;718;2089
312190;201810;545;1655;392;1341;83;313;77;259;160;572
312200;201810;4601;12731;3763;11236;805;2483;1954;5793;2759;8276
312210;201810;1323;3183;961;2657;68;246;657;1747;725;1993
312220;201810;1880;5877;1634;5445;127;448;1039;3449;1166;3897
312230;201810;11439;31481;7740;24504;2253;7853;1204;3339;3457;11192
312235;201810;1685;4640;1387;4205;124;446;975;2881;1099;3327
312240;201810;690;2271;526;1918;118;456;147;510;265;966
312245;201810;2498;6709;2096;6120;79;287;1682;4864;1761;5151
312247;201810;852;2242;616;1882;139;458;288;875;427;1333
312250;201810;957;2549;631;1922;109;335;240;719;349;1054
312260;201810;891;2583;728;2312;55;216;515;1572;570;1788
312270;201810;669;1906;534;1642;30;133;293;822;323;955
312280;201810;432;1308;336;1126;118;403;39;126;157;529
312290;201810;727;2271;602;2027;126;470;192;625;318;1095
312300;201810;900;2725;619;2061;167;601;101;269;268;870
312310;201810;737;2492;628;2267;96;403;288;1009;384;1412
312320;201810;1787;4817;1335;3991;394;1243;233;656;627;1899
312330;201810;851;2522;702;2250;81;287;470;1456;551;1743
312340;201810;234;631;181;543;33;110;75;209;108;319
312350;201810;271;601;219;544;26;76;150;359;176;435
312352;201810;1606;4812;1399;4446;138;456;874;2907;1012;3363
312360;201810;2515;7636;1889;6294;399;1425;466;1517;865;2942
312370;201810;1730;4895;1435;4357;283;976;671;1918;954;2894
312380;201810;2153;5071;1827;4652;23;57;1635;4151;1658;4208
312385;201810;1273;3622;1009;3123;201;703;469;1345;670;2048
312390;201810;1856;5569;1414;4740;243;890;469;1415;712;2305
312400;201810;2824;8551;2249;7429;773;2653;626;2107;1399;4760
312410;201810;11213;32617;9334;29244;1878;6131;4542;13988;6420;20119
312420;201810;3660;10565;3135;9616;586;1924;1644;4899;2230;6823
312430;201810;7923;21447;6417;18771;632;2029;4164;11951;4796;13980
312440;201810;889;2878;679;2373;352;1291;66;202;418;1493
312450;201810;1128;3453;853;2924;251;908;284;996;535;1904
312460;201810;415;1085;292;902;43;158;165;523;208;681
312470;201810;483;1239;319;949;59;216;114;291;173;507
312480;201810;1173;2976;807;2456;125;400;425;1249;550;1649
312490;201810;1993;5012;1536;4295;243;693;785;2137;1028;2830
312500;201810;848;2212;684;1967;59;210;441;1227;500;1437
312510;201810;3518;9741;2705;8201;629;1875;953;2856;1582;4731
312520;201810;186;566;156;514;45;146;70;230;115;376
312530;201810;579;1516;496;1411;21;65;436;1242;457;1307
312540;201810;1441;4270;940;3156;188;660;407;1347;595;2007
312550;201810;761;2099;575;1695;43;131;364;985;407;1116
312560;201810;1950;5128;1616;4652;90;326;1258;3585;1348;3911
312570;201810;2192;5819;1712;5154;530;1669;588;1809;1118;3478
312580;201810;563;1688;433;1393;55;210;185;556;240;766
312590;201810;1608;4886;1320;4308;155;625;717;2185;872;2810
312595;201810;1601;5109;1454;4821;300;944;846;2965;1146;3909
312600;201810;949;2402;550;1812;72;279;199;650;271;929
312610;201810;6403;16639;4110;12383;696;2318;1239;3532;1935;5850
312620;201810;2445;6396;1785;5490;66;297;1380;4291;1446;4588
312630;201810;263;827;204;710;41;171;80;270;121;441
312640;201810;574;1585;378;1248;52;175;126;430;178;605
312650;201810;2061;5534;1402;4216;95;335;925;2621;1020;2956
312660;201810;1332;3290;1014;2795;99;331;682;1801;781;2132
312670;201810;4902;13470;4036;12156;286;1202;2782;7965;3068;9167
312675;201810;1235;3521;1007;3125;76;315;765;2296;841;2611
312680;201810;1367;3945;1157;3623;69;299;892;2710;961;3009
312690;201810;2337;5619;1847;4970;121;389;1448;3785;1569;4174
312695;201810;922;2787;795;2555;62;194;600;1937;662;2131
312700;201810;2030;5536;1482;4520;163;558;829;2415;992;2973
312705;201810;1326;3473;1104;3113;29;99;902;2501;931;2600
312707;201810;1384;4209;1068;3596;82;398;632;1989;714;2387
312710;201810;6258;14589;3713;10681;1108;3489;926;2761;2034;6250
312720;201810;987;2839;734;2410;98;385;381;1188;479;1573
312730;201810;1619;3950;1212;3390;79;247;764;2083;843;2330
312733;201810;1452;3867;1107;3217;41;144;748;2082;789;2226
312735;201810;675;1854;582;1679;90;305;373;960;463;1265
312737;201810;795;1924;554;1556;86;274;293;756;379;1030
312738;201810;564;1553;389;1222;63;237;173;497;236;734
312740;201810;393;980;223;706;57;195;49;120;106;315
312750;201810;1275;4147;1055;3714;174;691;442;1476;616;2167
312760;201810;1825;5601;1330;4554;258;922;407;1339;665;2261
312770;201810;41057;102502;26483;77685;6311;19664;8075;23120;14386;42784
312780;201810;2402;7652;2072;7062;236;905;1317;4436;1553;5341
312790;201810;272;677;166;530;12;52;58;156;70;208
312800;201810;4858;14490;3781;12280;786;2804;1574;4934;2360;7738
312810;201810;1739;4810;1144;3747;283;1021;351;1021;634;2042
312820;201810;1796;5004;1489;4415;59;227;1050;3008;1109;3235
312825;201810;1303;3195;1140;2984;34;107;959;2488;993;2595
312830;201810;2229;6586;1461;5066;372;1417;304;1009;676;2426
312840;201810;1121;3446;877;2926;140;563;335;1004;475;1567
312850;201810;831;2145;591;1751;62;248;303;806;365;1054
312860;201810;1372;3552;889;2749;239;780;224;674;463;1454
312870;201810;6173;17372;3764;12377;602;2161;895;2745;1497;4906
312880;201810;1377;3635;1108;3213;52;191;636;1843;688;2034
312890;201810;1995;5385;1350;4170;183;579;550;1739;733;2318
312900;201810;1176;3216;953;2923;83;271;583;1845;666;2116
312910;201810;1521;2857;836;1956;123;276;408;953;531;1229
312920;201810;986;2749;694;2255;137;509;325;988;462;1497
312930;201810;2085;5574;1686;4950;375;1127;712;2045;1087;3172
312940;201810;904;2650;736;2370;107;395;345;1081;452;1476
312950;201810;2585;6878;1893;5753;547;1785;667;1953;1214;3738
312960;201810;1909;5137;1607;4689;118;331;1181;3525;1299;3856
312965;201810;1675;5038;1427;4561;137;455;891;2808;1028;3263
312970;201810;1058;3167;817;2752;176;686;355;1114;531;1800
312980;201810;21155;61869;17834;55720;3100;10819;9262;27411;12362;38230
312990;201810;425;1172;281;928;57;222;116;364;173;586
313000;201810;402;1233;324;1088;44;189;159;492;203;681
313005;201810;2568;7559;2203;6927;166;572;1595;4895;1761;5467
313010;201810;4518;13220;3710;11796;707;2499;2109;6480;2816;8979
313020;201810;897;2812;611;2138;95;356;90;262;185;618
313030;201810;1205;2995;819;2389;105;380;456;1240;561;1620
313040;201810;785;2496;649;2187;58;238;346;1097;404;1335
313050;201810;1740;5072;1245;4320;238;967;345;1059;583;2026
313055;201810;1745;5010;1588;4778;53;165;1358;4074;1411;4239
313060;201810;964;2538;658;2017;212;718;135;358;347;1076
313065;201810;1695;5317;1476;4952;93;415;1095;3552;1188;3967
313070;201810;908;2478;697;2082;93;303;387;1125;480;1428
313080;201810;375;1051;269;844;73;261;69;167;142;428
313090;201810;4601;13003;3919;11781;761;2536;2189;6416;2950;8952
313100;201810;1412;3764;1075;3259;63;247;770;2286;833;2533
313110;201810;1477;4057;1038;3218;105;405;547;1544;652;1949
313115;201810;2382;7372;2083;6751;333;1182;1043;3155;1376;4337
313120;201810;3609;8792;2741;7623;292;896;1698;4661;1990;5557
313130;201810;26723;73968;21378;63657;3079;10330;11060;31066;14139;41396
313140;201810;511;1217;333;942;23;85;231;634;254;719
313150;201810;1369;3995;1000;3245;277;949;252;761;529;1710
313160;201810;956;2529;736;2151;52;178;500;1419;552;1597
313170;201810;11310;34359;8067;27816;1527;5500;2903;9596;4430;15096
313180;201810;2218;6049;1542;4677;221;743;797;2342;1018;3085
313190;201810;4099;12282;3049;10057;586;2061;1007;3093;1593;5154
313200;201810;1076;3119;928;2852;33;133;768;2276;801;2409
313210;201810;3829;11464;3125;10160;462;1625;1758;5545;2220;7170
313220;201810;1732;4719;1171;3633;202;714;416;1131;618;1845
313230;201810;2786;8167;2442;7720;73;228;2094;6666;2167;6894
313240;201810;8680;22726;5544;17403;1065;3798;2248;6463;3313;10261
313250;201810;5664;17306;4644;15386;635;2208;2442;7944;3077;10152
313260;201810;604;1648;420;1283;55;199;190;543;245;742
313270;201810;5420;15144;4354;13373;778;2537;2517;7723;3295;10260
313280;201810;405;1186;282;917;36;129;118;370;154;499
313290;201810;797;2630;622;2345;227;923;170;613;397;1536
313300;201810;1570;4614;1171;3823;336;1171;201;569;537;1740
313310;201810;1017;3188;830;2779;141;550;196;547;337;1097
313320;201810;2127;5782;1503;4785;312;1133;665;2089;977;3222
313330;201810;3953;11080;3092;9700;229;1003;2006;6038;2235;7041
313340;201810;1261;2973;893;2434;106;293;621;1679;727;1972
313350;201810;2167;6307;1508;4904;237;872;557;1643;794;2515
313360;201810;1250;3261;862;2616;152;543;440;1243;592;1786
313370;201810;1277;3834;1145;3584;149;550;660;1917;809;2467
313375;201810;1689;4505;1089;3437;220;799;259;775;479;1574
313380;201810;5554;14688;4035;11904;837;2717;1688;4484;2525;7201
313390;201810;856;2835;768;2687;59;265;497;1665;556;1930
313400;201810;3497;9186;2827;8299;180;558;2190;6306;2370;6864
313410;201810;1242;3367;974;2910;97;339;675;1968;772;2307
313420;201810;15026;34700;7854;22355;1710;5362;1039;3031;2749;8393
313430;201810;872;2595;653;2154;105;403;266;793;371;1196
313440;201810;5855;12974;3795;10236;344;986;2415;6476;2759;7462
313450;201810;618;1782;451;1449;98;350;139;381;237;731
313460;201810;2078;6322;1702;5711;368;1438;779;2429;1147;3867
313470;201810;3007;7585;2420;6764;201;544;1737;4895;1938;5439
313480;201810;880;2577;498;1701;83;306;120;360;203;666
313490;201810;1482;3481;741;2401;262;988;55;188;317;1176
313500;201810;377;1176;295;978;29;106;116;354;145;460
313505;201810;9412;25724;8116;24079;330;1181;6777;20020;7107;21201
313507;201810;1461;3797;1209;3434;38;144;972;2736;1010;2880
313510;201810;12594;35487;10429;31542;1386;4513;5280;15542;6666;20055
313520;201810;13210;39077;10932;34971;821;3009;7763;24365;8584;27374
313530;201810;506;1477;408;1302;23;87;198;609;221;696
313535;201810;2377;6633;2078;6063;149;426;1468;4216;1617;4642
313540;201810;818;2557;613;2017;127;428;216;680;343;1108
313545;201810;1165;3988;999;3644;183;722;529;1840;712;2562
313550;201810;1722;5298;1460;4758;378;1335;663;2059;1041;3394
313560;201810;2538;5194;1903;4430;82;182;1590;3674;1672;3856
313570;201810;947;2971;769;2617;187;699;301;974;488;1673
313580;201810;5296;14636;4181;12753;621;2000;2250;7023;2871;9023
313590;201810;944;2749;726;2415;249;913;259;875;508;1788
313600;201810;3684;10369;3097;9412;147;576;2482;7421;2629;7997
313610;201810;990;2656;807;2315;121;359;484;1348;605;1707
313620;201810;5488;15162;4484;13394;806;2645;2285;6597;3091;9242
313630;201810;8132;20808;5657;17021;755;2590;3007;8968;3762;11558
313640;201810;1009;2448;630;1912;187;617;202;596;389;1213
313650;201810;1809;5586;1504;5076;106;426;969;3275;1075;3701
313652;201810;770;2593;702;2436;129;499;407;1353;536;1852
313655;201810;1058;2943;865;2657;61;205;640;1945;701;2150
313657;201810;1262;3445;973;2964;51;215;702;2003;753;2218
313660;201810;850;2512;688;2188;113;434;361;1056;474;1490
313665;201810;4373;12418;3490;10806;552;1957;1902;5596;2454;7553
313670;201810;42962;112940;28552;86926;5241;17347;11128;32014;16369;49361
313680;201810;976;2696;829;2462;68;221;529;1519;597;1740
313690;201810;806;2678;650;2361;136;519;205;725;341;1244
313695;201810;1666;4778;1296;4153;99;347;885;2840;984;3187
313700;201810;3121;10330;2710;9777;254;955;2093;7569;2347;8524
313710;201810;1342;3364;976;2806;93;273;632;1824;725;2097
313720;201810;5187;14853;3822;12103;606;2153;1601;4679;2207;6832
313730;201810;1265;3043;963;2622;82;206;628;1668;710;1874
313740;201810;1683;6042;1363;5207;330;1394;188;624;518;2018
313750;201810;1886;5319;1472;4489;333;1126;542;1516;875;2642
313753;201810;2093;5157;1425;4060;172;543;797;2210;969;2753
313760;201810;4944;14171;3673;11669;883;3038;1333;3977;2216;7015
313770;201810;3662;10616;2931;9485;258;905;2002;6516;2260;7421
313780;201810;3939;10872;2957;9192;348;1244;832;2604;1180;3848
313790;201810;459;1470;410;1379;57;202;218;695;275;897
313800;201810;1307;3181;1019;2751;112;342;637;1652;749;1994
313810;201810;1572;4202;1258;3747;95;348;901;2646;996;2994
313820;201810;13529;32630;9228;25317;1532;4687;3450;9110;4982;13797
313830;201810;314;953;271;871;62;213;112;342;174;555
313835;201810;912;2789;750;2470;94;355;344;1059;438;1414
313840;201810;6370;17249;4605;14161;1159;3793;1013;3130;2172;6923
313850;201810;951;2410;779;2150;130;439;413;1006;543;1445
313860;201810;2585;7317;1897;5895;336;1119;690;1993;1026;3112
313862;201810;1483;3393;787;2314;70;221;403;1126;473;1347
313865;201810;2242;6285;1950;5823;136;404;1473;4335;1609;4739
313867;201810;1077;3544;919;3221;295;1080;390;1350;685;2430
313868;201810;1661;5327;1405;4820;95;414;1044;3501;1139;3915
313870;201810;787;2209;598;1870;120;409;201;562;321;971
313880;201810;1403;3870;1042;3262;207;702;418;1182;625;1884
313890;201810;1966;4617;1445;3938;135;411;936;2558;1071;2969
313900;201810;3598;11316;2772;9632;782;2948;642;2158;1424;5106
313910;201810;584;1807;438;1522;107;377;87;297;194;674
313920;201810;3007;9633;2493;8582;546;1840;1197;4188;1743;6028
313925;201810;1599;4228;1267;3616;251;685;738;2113;989;2798
313930;201810;5646;19483;4725;17816;376;1405;3292;12911;3668;14316
313940;201810;8081;24568;5841;20538;1294;5198;1270;4832;2564;10030
313950;201810;4609;11077;3396;9427;520;1875;1991;5312;2511;7187
313960;201810;5337;13610;3649;10721;801;2575;1217;3316;2018;5891
313970;201810;1295;3763;1152;3503;48;198;720;2178;768;2376
313980;201810;1343;3655;870;2856;140;537;307;950;447;1487
313990;201810;1732;5934;1310;4883;369;1515;384;1314;753;2829
314000;201810;9216;25371;7810;22878;525;1986;5243;15027;5768;17013
314010;201810;1289;3274;1045;2941;33;135;819;2239;852;2374
314015;201810;2029;5723;1580;4999;229;851;840;2572;1069;3423
314020;201810;505;1416;304;1009;61;233;52;181;113;414
314030;201810;766;2324;603;1981;82;285;298;953;380;1238
314040;201810;685;1899;555;1648;105;344;267;754;372;1098
314050;201810;1618;4530;1190;3718;188;674;560;1586;748;2260
314053;201810;1709;5211;1410;4646;250;799;780;2689;1030;3488
314055;201810;2267;6282;1961;5833;55;221;1623;4840;1678;5061
314060;201810;1148;3203;880;2754;50;184;614;1878;664;2062
314070;201810;4283;12279;3382;10600;786;2522;1333;4057;2119;6579
314080;201810;1902;5410;1284;4130;209;797;418;1148;627;1945
314085;201810;2030;6263;1685;5716;359;1261;799;2734;1158;3995
314090;201810;3769;11142;3253;10318;263;1060;2166;6779;2429;7839
314100;201810;3161;7595;2508;6688;100;267;1981;5307;2081;5574
314110;201810;4133;12336;3445;10936;506;1801;1780;5281;2286;7082
314120;201810;772;1801;335;1045;82;299;60;181;142;480
314130;201810;724;1999;387;1292;47;180;169;547;216;727
314140;201810;4628;13607;3523;11367;620;2124;1541;4846;2161;6970
314150;201810;1416;3747;1090;3167;111;353;692;1912;803;2265
314160;201810;2250;6144;1657;5073;267;867;676;2095;943;2962
314170;201810;1021;2936;829;2551;85;294;488;1389;573;1683
314180;201810;5299;15274;4395;13792;464;1592;2536;7963;3000;9555
314190;201810;696;1980;515;1702;98;343;264;879;362;1222
314200;201810;2869;8310;2377;7427;144;585;1678;5012;1822;5597
314210;201810;1911;5181;1571;4581;160;498;884;2524;1044;3022
314220;201810;1237;3576;894;2944;232;862;277;845;509;1707
314225;201810;1132;3297;985;3071;74;231;720;2257;794;2488
314230;201810;738;2034;631;1899;98;328;382;1172;480;1500
314240;201810;1054;2925;822;2581;194;668;318;1000;512;1668
314250;201810;511;1481;329;1073;57;200;120;360;177;560
314260;201810;898;2816;742;2521;170;654;343;1071;513;1725
314270;201810;3193;9285;2581;8276;102;395;1914;6027;2016;6422
314280;201810;3283;7943;2084;5913;332;1044;874;2320;1206;3364
314290;201810;4423;11773;3688;10491;438;1258;2399;6717;2837;7975
314300;201810;1501;4542;1098;3657;282;996;315;1021;597;2017
314310;201810;4688;12815;3396;10546;1079;3608;716;2067;1795;5675
314315;201810;878;3169;759;2906;62;293;525;1942;587;2235
314320;201810;2704;7483;1801;5848;401;1374;647;2097;1048;3471
314330;201810;46102;132007;35897;114423;10768;35887;8189;26879;18957;62766
314340;201810;2300;5892;1252;3902;280;1032;261;631;541;1663
314345;201810;1365;4202;1141;3790;157;551;680;2192;837;2743
314350;201810;947;2712;648;2133;133;484;162;497;295;981
314360;201810;594;1788;374;1303;61;235;97;316;158;551
314370;201810;657;1895;543;1701;27;109;412;1246;439;1355
314380;201810;1106;3224;763;2544;202;748;125;413;327;1161
314390;201810;11562;31297;7680;23854;1673;5530;2042;5692;3715;11222
314400;201810;3982;11992;3194;10601;904;3098;1114;3805;2018;6903
314410;201810;2603;7494;1814;5971;325;1179;624;2161;949;3340
314420;201810;767;1936;587;1685;20;102;442;1208;462;1310
314430;201810;6505;17370;4836;14387;916;2832;1870;5460;2786;8292
314435;201810;1435;4271;1212;3888;42;178;921;2916;963;3094
314437;201810;931;2446;655;1982;50;183;343;1025;393;1208
314440;201810;540;1593;400;1314;112;417;88;237;200;654
314450;201810;1318;3678;1100;3329;124;466;657;1867;781;2333
314460;201810;3366;10588;2443;8523;617;2279;392;1329;1009;3608
314465;201810;2215;6545;1940;6005;62;272;1493;4441;1555;4713
314467;201810;854;2457;727;2230;20;61;584;1779;604;1840
314470;201810;2182;6514;1774;5642;347;1246;762;2230;1109;3476
314480;201810;5820;17690;4138;13811;748;2685;1089;3259;1837;5944
314490;201810;931;2631;691;2117;82;276;398;1168;480;1444
314500;201810;1611;4276;1193;3582;229;701;465;1371;694;2072
314505;201810;1930;4985;1612;4540;110;354;1159;3197;1269;3551
314510;201810;1726;4645;1192;3833;252;883;500;1580;752;2463
314520;201810;4056;12971;2838;10107;522;2041;314;957;836;2998
314530;201810;5482;18205;4964;17193;480;1866;3427;11771;3907;13637
314535;201810;2570;6828;2106;6144;129;467;1588;4536;1717;5003
314537;201810;1128;3293;863;2833;71;272;588;1873;659;2145
314540;201810;406;1071;284;835;25;95;142;388;167;483
314545;201810;1710;4441;1523;4191;49;127;1278;3667;1327;3794
314550;201810;628;1607;463;1364;42;167;232;612;274;779
314560;201810;3792;12110;2978;10304;523;1926;980;3215;1503;5141
314570;201810;289;822;224;701;33;112;107;336;140;448
314580;201810;449;1405;336;1167;91;336;71;249;162;585
314585;201810;660;2162;529;1857;73;309;240;773;313;1082
314587;201810;1947;5541;1504;4805;232;679;820;2676;1052;3355
314590;201810;3110;9122;2191;7252;379;1383;773;2433;1152;3816
314600;201810;1760;5083;1025;3577;217;825;108;336;325;1161
314610;201810;8351;22702;5966;18947;1202;4445;2382;7285;3584;11730
314620;201810;1892;4853;1536;4358;66;245;1253;3464;1319;3709
314625;201810;1454;4368;1272;4100;72;377;1015;3159;1087;3536
314630;201810;4967;13483;4161;12294;132;555;3431;10059;3563;10614
314640;201810;625;1578;437;1257;78;254;208;539;286;793
314650;201810;874;2224;581;1753;58;223;261;687;319;910
314655;201810;1545;4419;1109;3586;236;761;464;1493;700;2254
314660;201810;328;792;208;560;10;20;124;315;134;335
314670;201810;1621;3900;1181;3228;50;183;746;1995;796;2178
314675;201810;1720;4758;1483;4335;112;384;1126;3193;1238;3577
314690;201810;2055;6081;1558;5254;484;1769;392;1312;876;3081
314700;201810;9661;28669;6231;21502;1363;5226;1479;4882;2842;10108
314710;201810;7548;21794;5408;17244;1186;4159;1216;3392;2402;7551
314720;201810;2075;6429;1499;5197;343;1286;343;1155;686;2441
314730;201810;2017;5785;1489;4736;384;1264;377;1136;761;2400
314740;201810;2795;8109;2241;7112;272;979;1208;3746;1480;4725
314750;201810;325;924;250;772;21;79;128;359;149;438
314760;201810;1831;5760;1257;4406;176;713;318;910;494;1623
314770;201810;1066;3215;527;1763;45;158;130;386;175;544
314780;201810;340;825;220;648;44;143;114;309;158;452
314790;201810;9476;26808;6781;21838;2012;7270;1593;4636;3605;11906
314795;201810;1445;3955;1222;3578;49;213;952;2659;1001;2872
314800;201810;10612;27899;6209;19403;1306;4414;1126;3131;2432;7545
314810;201810;8909;25250;6644;21219;1870;6154;1904;6377;3774;12531
314820;201810;936;2456;708;2089;72;263;424;1188;496;1451
314830;201810;1497;4705;1264;4250;292;1037;568;1894;860;2931
314840;201810;898;2973;699;2634;70;366;462;1639;532;2005
314850;201810;1852;4793;1540;4323;64;219;1312;3651;1376;3870
314860;201810;3109;9710;2616;8728;406;1505;1553;5011;1959;6516
314870;201810;5974;16271;4683;14464;403;1352;3367;10405;3770;11757
314875;201810;1700;5268;1520;5027;106;307;1253;4184;1359;4491
314880;201810;881;2181;696;1922;37;95;474;1358;511;1453
314890;201810;435;1275;308;987;46;170;118;342;164;512
314900;201810;657;1789;503;1520;115;374;177;519;292;893
314910;201810;1630;4877;1255;4271;289;1134;571;1800;860;2934
314915;201810;2217;6783;1879;6167;138;536;1271;4043;1409;4579
314920;201810;438;1120;291;919;12;42;197;615;209;657
314930;201810;5123;15429;3950;13080;836;2995;1363;4271;2199;7266
314940;201810;405;1075;345;965;38;99;205;540;243;639
314950;201810;426;1146;275;888;31;127;115;336;146;463
314960;201810;782;2082;603;1727;47;158;402;1087;449;1245
314970;201810;712;2152;582;1911;103;381;264;817;367;1198
314980;201810;1303;3603;964;3068;275;979;256;784;531;1763
314990;201810;2189;6535;1496;4902;335;1222;314;884;649;2106
314995;201810;1561;4576;1281;4082;94;383;784;2368;878;2751
315000;201810;1056;2883;781;2428;80;277;486;1459;566;1736
315010;201810;378;1094;281;901;57;220;119;339;176;559
315015;201810;2096;6258;1893;5950;210;728;1225;3856;1435;4584
315020;201810;804;2408;592;1969;82;313;265;818;347;1131
315030;201810;530;1526;372;1208;97;335;85;247;182;582
315040;201810;826;2464;723;2224;116;383;438;1335;554;1718
315050;201810;1099;2978;862;2640;81;313;470;1404;551;1717
315053;201810;1132;3080;878;2611;75;240;519;1497;594;1737
315057;201810;1613;5262;1406;4835;191;662;863;3003;1054;3665
315060;201810;597;1879;413;1485;80;296;88;315;168;611
315070;201810;571;1585;414;1285;116;396;110;303;226;699
315080;201810;2581;8016;2038;6838;421;1409;943;3150;1364;4559
315090;201810;767;2459;580;2070;113;441;191;642;304;1083
315100;201810;1153;3632;744;2627;136;547;286;898;422;1445
315110;201810;1504;4007;1160;3421;150;447;553;1647;703;2094
315120;201810;11530;27770;8329;23009;1128;3077;4278;12260;5406;15337
315130;201810;1250;3779;1011;3283;167;640;381;1145;548;1785
315140;201810;2768;7990;2156;6847;420;1516;1023;2980;1443;4496
315150;201810;4042;10305;2888;8389;455;1463;1273;3583;1728;5046
315160;201810;1538;3952;999;3057;221;687;405;1200;626;1887
315170;201810;1391;4432;945;3373;231;867;158;543;389;1410
315180;201810;16136;41397;8521;26258;1314;4606;2211;5909;3525;10515
315190;201810;2038;4770;1624;4199;245;670;1161;2957;1406;3627
315200;201810;3571;10813;2664;9114;811;2994;592;1965;1403;4959
315210;201810;7763;20978;5676;16564;714;2299;2580;6846;3294;9145
315213;201810;1105;3001;952;2779;24;64;765;2219;789;2283
315217;201810;2462;7849;1973;6961;116;574;1323;4501;1439;5075
315220;201810;8269;23135;6619;20242;1815;5883;2255;6798;4070;12681
315230;201810;3066;7529;2669;7038;64;145;2330;6315;2394;6460
315240;201810;2406;7439;2115;6931;554;1975;1054;3352;1608;5327
315250;201810;10000;28535;7524;23868;1368;4763;3172;9676;4540;14439
315260;201810;906;2657;506;1717;90;314;45;124;135;438
315270;201810;768;2342;528;1841;83;342;156;463;239;805
315280;201810;2767;7097;1585;4832;353;1175;249;735;602;1910
315290;201810;1184;3051;707;2281;216;755;182;589;398;1344
315300;201810;693;1723;454;1392;169;566;127;401;296;967
315310;201810;1290;3753;973;3128;91;326;532;1609;623;1935
315320;201810;685;2023;487;1643;58;261;207;640;265;901
315330;201810;737;2593;406;1647;74;324;112;407;186;731
315340;201810;3108;7972;2353;6882;186;603;1519;4382;1705;4985
315350;201810;1507;4224;1136;3579;180;629;553;1692;733;2321
315360;201810;1638;5118;1182;4077;197;730;435;1396;632;2126
315370;201810;432;1290;349;1113;68;211;149;470;217;681
315380;201810;190;594;147;494;37;140;25;63;62;203
315390;201810;1156;3509;878;2954;167;601;311;977;478;1578
315400;201810;3955;11339;3184;9898;491;1594;1620;4886;2111;6480
315410;201810;2278;5362;1792;4656;424;1191;525;1353;949;2544
315415;201810;1170;3408;951;3048;244;909;376;1175;620;2084
315420;201810;1098;3320;746;2605;146;513;90;301;236;814
315430;201810;3498;8874;2481;7240;535;1833;926;2477;1461;4310
315440;201810;968;2683;796;2381;95;350;424;1168;519;1518
315445;201810;2013;4985;1470;4176;140;433;1000;2796;1140;3229
315450;201810;2155;6360;1844;5857;284;866;1119;3611;1403;4477
315460;201810;31079;92705;26325;83723;6588;22639;10530;31518;17118;54157
315470;201810;458;1333;366;1161;40;156;192;570;232;726
315480;201810;1341;3937;910;2998;191;667;253;813;444;1480
315490;201810;2923;7300;2003;5973;291;915;744;2184;1035;3099
315500;201810;491;1361;298;927;30;118;140;378;170;496
315510;201810;1230;3428;1059;3161;31;136;898;2609;929;2745
315520;201810;1057;2991;834;2630;58;221;579;1762;637;1983
315530;201810;611;1894;482;1600;172;620;171;534;343;1154
315540;201810;1249;3519;869;2774;113;432;360;1105;473;1537
315550;201810;1814;4952;1283;4067;291;1042;359;1074;650;2116
315560;201810;6086;19407;5342;18044;380;1315;3514;11957;3894;13272
315570;201810;1795;5270;1540;4798;121;486;870;2567;991;3053
315580;201810;2169;5644;1694;4868;382;1261;556;1547;938;2808
315590;201810;896;2461;725;2180;103;365;346;968;449;1333
315600;201810;2369;7877;1747;6627;286;1071;919;3598;1205;4669
315610;201810;904;2368;699;1972;130;445;300;725;430;1170
315620;201810;309;1011;281;966;51;172;161;588;212;760
315630;201810;837;2410;696;2160;160;546;228;631;388;1177
315640;201810;325;896;284;829;32;112;172;477;204;589
315645;201810;926;2473;619;1939;165;556;156;452;321;1008
315650;201810;1697;4470;1349;3968;55;228;1077;3053;1132;3281
315660;201810;2436;6080;1837;5049;122;357;1260;3358;1382;3715
315670;201810;12722;36864;10026;31815;2150;7235;4393;13438;6543;20673
315680;201810;2975;9300;2238;7827;400;1537;980;3319;1380;4856
315690;201810;2669;7030;1723;5366;400;1300;471;1596;871;2896
315700;201810;7131;20696;5546;17534;1006;3363;2468;7501;3474;10864
315710;201810;1862;4829;1290;3902;72;320;887;2495;959;2815
315720;201810;4129;12071;3528;10963;194;895;2470;7310;2664;8205
315725;201810;1612;4574;1352;4217;179;565;905;2887;1084;3452
315727;201810;541;1492;398;1225;61;213;178;516;239;729
315730;201810;635;1981;558;1817;71;261;252;771;323;1032
315733;201810;1402;3694;978;2929;176;637;356;985;532;1622
315737;201810;1080;3203;872;2803;54;219;604;1882;658;2101
315740;201810;930;2684;728;2263;143;509;355;987;498;1496
315750;201810;1200;3345;1005;3026;94;309;629;1893;723;2202
315760;201810;1197;2884;1102;2773;51;120;974;2461;1025;2581
315765;201810;1851;5078;1533;4666;42;160;1337;4057;1379;4217
315770;201810;1030;3184;881;2973;339;1255;284;889;623;2144
315780;201810;26098;75685;22414;68838;2101;7748;13935;40723;16036;48471
315790;201810;3551;11213;3061;10297;721;2524;1530;5241;2251;7765
315800;201810;1189;4518;872;3596;168;778;198;742;366;1520
315810;201810;1280;3246;1112;2994;59;210;887;2270;946;2480
315820;201810;2366;7093;2046;6561;235;843;1395;4380;1630;5223
315830;201810;1083;3223;788;2663;62;257;344;1098;406;1355
315840;201810;789;1993;484;1403;65;224;216;566;281;790
315850;201810;1080;3374;903;3062;193;712;432;1380;625;2092
315860;201810;497;1519;346;1217;73;288;99;320;172;608
315870;201810;444;1188;358;1059;26;95;239;656;265;751
315880;201810;1104;2918;756;2308;61;245;233;641;294;886
315890;201810;1483;4623;1231;4207;375;1376;521;1704;896;3080
315895;201810;5867;16495;4578;13917;590;2065;2200;6138;2790;8203
315900;201810;834;2201;730;2059;67;201;548;1496;615;1697
315910;201810;488;1492;419;1372;72;257;264;835;336;1092
315920;201810;1584;4231;828;2598;154;513;231;672;385;1185
315930;201810;1018;2442;697;1940;141;404;293;796;434;1200
315935;201810;791;2491;658;2231;137;500;210;736;347;1236
315940;201810;583;1733;486;1554;63;214;245;765;308;979
315950;201810;1178;3333;1007;3055;132;395;741;2262;873;2657
315960;201810;3675;10667;2172;7614;706;2876;145;312;851;3188
315970;201810;615;1710;479;1519;58;192;328;1050;386;1242
315980;201810;3906;8753;2189;5917;452;1323;713;1790;1165;3113
315990;201810;3555;9260;2809;8008;334;1043;1624;4521;1958;5564
316000;201810;507;1432;401;1259;69;265;169;486;238;751
316010;201810;667;1970;534;1708;43;164;326;959;369;1123
316020;201810;976;3009;804;2682;82;352;491;1503;573;1855
316030;201810;2782;7923;2079;6660;253;851;1301;4190;1554;5041
316040;201810;2871;9328;2173;7938;304;1147;777;3025;1081;4172
316045;201810;1943;5368;1802;5168;124;274;1483;4408;1607;4682
316050;201810;353;1077;267;911;50;189;135;440;185;629
316060;201810;670;1860;512;1611;45;181;334;970;379;1151
316070;201810;5552;16057;4596;14186;850;2794;2042;6032;2892;8826
316080;201810;720;2314;581;2026;153;586;73;242;226;828
316090;201810;436;1322;306;1044;43;171;122;388;165;559
316095;201810;1272;4008;1064;3552;243;843;432;1422;675;2265
316100;201810;2505;7702;1806;6096;329;1200;559;1720;888;2920
316105;201810;843;2298;641;1984;79;254;413;1275;492;1529
316110;201810;12412;38013;10536;34749;1176;4199;6853;22540;8029;26739
316120;201810;1029;3153;665;2216;118;416;156;423;274;839
316130;201810;1235;2837;753;2057;67;223;407;1072;474;1295
316140;201810;1053;2892;681;2212;130;441;329;1055;459;1496
316150;201810;1657;3999;1398;3605;259;793;592;1385;851;2178
316160;201810;1038;2951;841;2593;79;289;516;1528;595;1817
316165;201810;872;2226;673;1902;110;369;356;947;466;1316
316170;201810;1080;2887;812;2468;83;288;486;1406;569;1694
316180;201810;1283;3798;841;2844;174;660;135;371;309;1031
316190;201810;2581;7546;1499;4910;247;841;521;1486;768;2327
316200;201810;3236;9640;2344;7912;517;1935;534;1677;1051;3612
316210;201810;3887;11819;2835;9434;899;3150;275;910;1174;4060
316220;201810;598;1836;399;1378;83;310;48;188;131;498
316225;201810;1383;3334;1052;2764;50;196;769;1865;819;2061
316230;201810;427;1154;326;1002;44;135;162;502;206;637
316240;201810;5812;17071;5144;15991;482;1559;3877;11901;4359;13460
316245;201810;2959;10062;2674;9575;164;932;2031;6905;2195;7837
316250;201810;9240;23807;6592;19317;1696;5421;1826;5171;3522;10592
316255;201810;2775;7991;2424;7455;228;775;1730;5347;1958;6122
316257;201810;1219;3064;868;2503;159;485;413;1154;572;1639
316260;201810;1807;4800;1365;4105;220;728;613;1884;833;2612
316265;201810;1270;3381;921;2780;53;205;620;1821;673;2026
316270;201810;3435;11083;2972;10034;553;1984;1332;4295;1885;6279
316280;201810;2978;9064;2582;8315;382;1354;1393;4322;1775;5676
316290;201810;3272;9479;2558;8065;379;1383;965;2986;1344;4369
316292;201810;4561;12706;3773;11403;429;1524;2606;7625;3035;9149
316294;201810;753;2297;554;1948;111;447;98;314;209;761
316295;201810;2641;7672;2202;6862;142;578;1531;4516;1673;5094
316300;201810;948;2995;802;2715;56;222;524;1771;580;1993
316310;201810;957;2389;551;1716;82;275;174;505;256;780
316320;201810;567;1650;433;1406;55;209;189;595;244;804
316330;201810;1048;2962;780;2430;68;257;528;1571;596;1828
316340;201810;1045;3049;768;2489;82;348;401;1203;483;1551
316350;201810;1172;3560;1017;3310;138;484;643;2060;781;2544
316360;201810;655;1735;530;1526;71;223;354;995;425;1218
316370;201810;4527;12899;3537;10968;761;2693;1112;3046;1873;5739
316380;201810;1600;4003;1244;3512;38;110;897;2512;935;2622
316390;201810;845;2303;626;1918;211;725;157;437;368;1162
316400;201810;1224;3568;829;2782;134;484;296;918;430;1402
316410;201810;1059;3222;886;2935;66;239;695;2256;761;2495
316420;201810;1696;5180;1526;4942;79;337;1223;3866;1302;4203
316430;201810;845;2369;540;1781;129;448;120;376;249;824
316440;201810;699;2216;536;1937;134;555;74;246;208;801
316443;201810;573;1690;443;1433;103;365;111;352;214;717
316447;201810;1796;4960;1567;4607;66;228;1253;3647;1319;3875
316450;201810;2186;6860;1694;5825;220;807;1031;3482;1251;4289
316460;201810;923;2527;774;2284;202;642;377;1046;579;1688
316470;201810;6037;18011;4560;14972;888;3314;1581;4757;2469;8071
316480;201810;195;584;168;530;31;112;80;233;111;345
316490;201810;307;843;223;674;26;90;97;260;123;350
316500;201810;1193;3945;764;2826;150;578;114;397;264;975
316510;201810;684;2352;550;2079;125;501;227;865;352;1366
316520;201810;1022;2813;808;2444;127;477;364;1013;491;1490
316530;201810;1012;2877;759;2408;122;488;323;883;445;1371
316540;201810;711;2078;601;1897;106;393;252;729;358;1122
316550;201810;1242;3880;1110;3610;93;358;813;2584;906;2942
316553;201810;3322;10321;2253;7706;531;1951;493;1520;1024;3471
316555;201810;2564;8552;2323;8206;152;626;1765;6333;1917;6959
316556;201810;589;1441;412;1139;22;63;239;594;261;657
316557;201810;909;3046;794;2831;307;1163;224;767;531;1930
316560;201810;270;837;207;748;54;232;53;172;107;404
316570;201810;1087;3393;965;3147;279;931;332;1062;611;1993
316580;201810;377;892;235;643;47;140;96;251;143;391
316590;201810;1306;3505;951;2823;176;526;513;1448;689;1974
316600;201810;974;3105;849;2838;158;581;432;1403;590;1984
316610;201810;598;1929;497;1757;67;317;310;1026;377;1343
316620;201810;2000;5737;1750;5367;100;360;1298;4010;1398;4370
316630;201810;1504;4622;1205;4024;354;1173;439;1618;793;2791
316640;201810;138;383;115;348;24;78;58;147;82;225
316650;201810;991;3288;801;2981;68;275;496;1894;564;2169
316660;201810;195;493;88;265;11;40;11;31;22;71
316670;201810;1880;4990;1422;4210;401;1266;426;1201;827;2467
316680;201810;2050;5422;1604;4679;147;497;1141;3235;1288;3732
316690;201810;1063;3303;874;2942;192;717;367;1208;559;1925
316695;201810;973;2932;821;2652;39;169;563;1786;602;1955
316700;201810;378;948;317;878;16;73;243;629;259;702
316710;201810;2746;9549;2134;8211;575;2308;741;2884;1316;5192
316720;201810;19118;55416;14424;45989;2985;10229;5529;16790;8514;27019
316730;201810;383;1118;313;966;62;222;134;359;196;581
316740;201810;669;2071;607;1977;65;287;427;1357;492;1644
316750;201810;402;1265;307;1065;69;260;111;359;180;619
316760;201810;3646;11678;2913;10215;1239;4656;744;2500;1983;7156
316770;201810;1482;3725;1202;3336;38;133;1018;2840;1056;2973
316780;201810;572;1777;441;1516;141;566;60;168;201;734
316790;201810;706;1948;506;1572;120;391;147;434;267;825
316800;201810;5727;16872;4663;14907;444;1665;2644;8141;3088;9806
316805;201810;965;2183;828;2031;17;24;746;1892;763;1916
316810;201810;573;1606;407;1296;86;325;193;592;279;917
316820;201810;329;818;167;513;16;54;49;152;65;206
316830;201810;659;1926;554;1757;91;351;326;981;417;1332
316840;201810;2626;7422;2207;6663;348;1230;1233;3509;1581;4739
316850;201810;2017;5445;1459;4436;203;682;658;1933;861;2615
316860;201810;17210;47988;13382;42002;2583;9198;5906;17946;8489;27144
316870;201810;6528;19106;4940;15869;1034;3669;1777;5321;2811;8990
316880;201810;806;2215;662;2002;137;472;291;858;428;1330
316890;201810;1128;2607;717;2054;143;483;389;979;532;1462
316900;201810;2226;6270;1773;5338;380;1270;598;1617;978;2887
316905;201810;488;1532;398;1341;99;358;153;507;252;865
316910;201810;849;2378;564;1883;151;578;51;154;202;732
316920;201810;1578;4141;1048;3277;196;675;449;1398;645;2073
316930;201810;7585;23560;5565;19513;1067;4044;1198;3996;2265;8040
316935;201810;3808;10889;2738;8849;637;2139;850;2696;1487;4835
316940;201810;6560;20113;5013;16652;948;3523;1647;4979;2595;8502
316950;201810;1738;4324;1359;3780;56;201;1061;2866;1117;3067
316960;201810;4865;11631;3627;9840;501;1501;2265;5970;2766;7471
316970;201810;3271;9836;2894;9088;684;2237;1047;3103;1731;5340
316980;201810;706;2159;509;1752;157;600;67;235;224;835
316990;201810;9969;28736;7253;22879;1993;6622;841;2448;2834;9070
317000;201810;2613;8141;2365;7770;180;568;1727;5744;1907;6312
317005;201810;2508;7398;2056;6500;373;1219;1026;3182;1399;4401
317010;201810;22018;53756;13557;40569;3447;11258;3671;11428;7118;22686
317020;201810;58026;144554;33275;98875;6579;21293;8764;23619;15343;44912
317030;201810;645;1833;520;1643;29;120;389;1203;418;1323
317040;201810;10251;27177;7347;22037;1845;5793;2626;7990;4471;13783
317043;201810;801;1948;610;1676;93;267;379;1056;472;1323
317047;201810;1153;2843;787;2243;125;331;423;1226;548;1557
317050;201810;1241;3958;876;3092;120;440;312;988;432;1428
317052;201810;2327;6866;1920;6168;254;894;1224;3856;1478;4750
317057;201810;1603;4101;1156;3325;59;214;751;2093;810;2307
317060;201810;411;1116;235;735;38;126;82;227;120;353
317065;201810;1227;3571;999;3143;62;238;650;1912;712;2150
317070;201810;7731;22099;5169;16877;1118;4131;1084;3323;2202;7454
317075;201810;902;2584;629;2031;116;390;167;503;283;893
317080;201810;5767;14333;4339;11928;1428;4125;1172;2972;2600;7097
317090;201810;4297;13518;3932;12929;388;1274;2829;9280;3217;10554
317100;201810;2500;6121;1688;4863;491;1520;554;1545;1045;3065
317103;201810;1787;5726;1571;5324;177;845;994;3086;1171;3931
317107;201810;1307;3679;1045;3153;59;242;627;1678;686;1920
317110;201810;691;1516;332;983;40;149;110;336;150;485
317115;201810;1089;3207;917;2869;64;200;672;2092;736;2292
317120;201810;11668;34105;9195;29792;1452;5247;4711;14686;6163;19933
317130;201810;9191;22600;5827;17016;1210;3873;1874;5395;3084;9268
317140;201810;606;1819;519;1657;58;187;327;1064;385;1251
317150;201810;1009;2538;803;2272;41;159;630;1721;671;1880
317160;201810;3547;8781;2451;7112;254;761;1440;4203;1694;4964
317170;201810;1937;4996;1340;3908;216;742;492;1233;708;1975
317180;201810;1640;5400;1268;4514;282;1059;318;1063;600;2122
317190;201810;1213;3417;916;2925;114;375;548;1733;662;2108
317200;201810;4754;13039;3530;10796;911;2999;747;2118;1658;5117
317210;201810;1107;2870;877;2537;49;196;633;1849;682;2045
317220;201810;276;902;239;816;62;219;92;312;154;531
320010;201810;4459;13404;3662;11827;567;1941;2160;6801;2727;8742
320013;201810;1605;4869;1171;3864;189;614;532;1795;721;2409
320016;201810;2951;7806;2386;6988;124;356;1897;5534;2021;5890
320020;201810;3927;10954;2958;9192;733;2421;975;3117;1708;5538
320030;201810;1466;4436;1029;3486;234;862;332;1055;566;1917
320035;201810;1640;4717;1390;4290;401;1353;590;1762;991;3115
320040;201810;3461;10435;2841;9234;458;1609;1414;4487;1872;6096
320050;201810;1739;4166;1499;3785;267;753;847;2076;1114;2829
320060;201810;10127;29828;7584;24664;1371;4900;2996;9259;4367;14159
320070;201810;1369;4042;992;3261;203;715;306;970;509;1685
320080;201810;5348;14498;3892;11632;779;2454;1461;4329;2240;6783
320090;201810;6872;19120;5019;15412;1169;3813;2088;6086;3257;9899
320100;201810;2524;7490;1986;6451;466;1622;871;2739;1337;4361
320110;201810;1289;3461;1018;2974;213;640;392;1145;605;1785
320115;201810;1750;5878;1522;5467;722;2688;431;1601;1153;4289
320120;201810;15746;42841;11201;34496;2149;7182;4090;11992;6239;19174
320130;201810;36282;107674;30952;97745;5061;17437;16929;51879;21990;69316
320140;201810;2910;8599;2138;7001;453;1688;754;2387;1207;4075
320150;201810;12881;35154;9184;27798;2676;8460;1618;4752;4294;13212
320160;201810;5304;15730;4068;13267;749;2592;1841;5905;2590;8497
320170;201810;1501;4545;1107;3704;302;1028;388;1301;690;2329
320180;201810;683;2264;556;1999;198;751;113;399;311;1150
320190;201810;2813;9347;2145;7750;515;1943;475;1642;990;3585
320200;201810;1015;2955;741;2444;204;773;217;706;421;1479
320210;201810;4426;11749;3477;10079;592;1859;1800;5017;2392;6876
320220;201810;2632;7415;2011;6305;386;1298;987;3014;1373;4312
320225;201810;1315;4253;920;3256;335;1261;133;460;468;1721
320230;201810;4433;13005;3401;11196;860;3097;1349;4373;2209;7470
320240;201810;13410;36449;10363;31309;2248;7224;4301;12819;6549;20043
320245;201810;2790;8770;2321;7760;962;3314;517;1699;1479;5013
320250;201810;1828;5325;1249;3970;318;1137;287;841;605;1978
320255;201810;1624;5400;1436;5055;542;1939;576;2132;1118;4071
320260;201810;1046;3115;745;2388;201;701;191;509;392;1210
320265;201810;2344;7456;1981;6727;918;3253;413;1393;1331;4646
320270;201810;2174;6443;1652;5357;336;1167;750;2416;1086;3583
320280;201810;5339;15562;4399;13807;1187;3977;1523;4713;2710;8690
320290;201810;1252;3892;846;2890;256;962;175;538;431;1500
320300;201810;3547;11351;2895;9906;911;3348;575;1897;1486;5245
320305;201810;4616;13773;3696;11849;836;2870;1604;4958;2440;7828
320310;201810;1819;5204;1274;4033;264;881;523;1611;787;2492
320313;201810;2149;5744;1379;4146;341;1091;261;746;602;1837
320316;201810;1534;4435;1202;3781;219;716;642;2016;861;2732
320320;201810;19989;54754;14256;44678;3673;12119;5077;15835;8750;27954
320330;201810;2796;7997;2226;6936;599;1851;958;3100;1557;4951
320332;201810;5196;15657;4338;14090;1054;3637;2136;6831;3190;10468
320334;201810;1905;5773;1332;4522;293;1147;288;841;581;1988
320335;201810;1699;5024;1079;3569;280;985;217;655;497;1640
320340;201810;4737;12496;3950;11255;651;1947;2131;6160;2782;8107
320350;201810;4922;12593;3462;9921;519;1627;1668;4534;2187;6161
320360;201810;1478;3865;1074;3084;155;424;517;1446;672;1870
320370;201810;2452;8004;1903;6682;563;2044;642;2207;1205;4251
320380;201810;2188;6172;1849;5604;324;1075;1040;3054;1364;4129
320390;201810;7157;20194;5354;16442;1203;3919;2031;5958;3234;9877
320400;201810;3248;9587;2621;8245;690;2275;1011;3119;1701;5394
320405;201810;4398;12111;3394;10364;524;1670;1733;5250;2257;6920
320410;201810;4678;12794;3574;11007;585;1784;1799;5787;2384;7571
320420;201810;2665;7546;2124;6630;611;2092;569;1726;1180;3818
320425;201810;1973;4839;1512;4074;126;395;989;2542;1115;2937
320430;201810;2704;7040;2110;5879;311;919;1238;3292;1549;4211
320435;201810;2218;7216;1775;6298;631;2337;486;1748;1117;4085
320440;201810;1197;3542;904;2937;155;561;403;1267;558;1828
320450;201810;1553;4674;1237;4057;309;1121;539;1655;848;2776
320455;201810;3754;11769;2601;8993;755;2754;687;2286;1442;5040
320460;201810;2145;6613;1494;5141;363;1293;354;1147;717;2440
320465;201810;1225;3574;928;2966;112;389;533;1710;645;2099
320470;201810;3728;10580;2547;8095;679;2315;546;1596;1225;3911
320480;201810;1613;4757;1381;4300;265;926;690;2059;955;2985
320490;201810;17095;47664;13131;40459;2490;8566;5380;16373;7870;24939
320495;201810;1391;3936;935;3023;208;734;305;942;513;1676
320500;201810;45557;127863;37823;113861;6615;21403;20613;59813;27228;81216
320501;201810;4534;13520;3295;11248;912;3489;1009;3319;1921;6808
320503;201810;1989;6311;1480;5177;466;1775;453;1444;919;3219
320506;201810;2754;8424;1889;6376;548;2005;130;398;678;2403
320510;201810;9391;26555;7633;23353;1178;3999;4257;12592;5435;16591
320515;201810;1736;4787;1337;3966;401;1254;380;1123;781;2377
320517;201810;1975;6279;1596;5436;558;2053;344;1147;902;3200
320520;201810;31687;88147;24205;75216;4832;16395;9821;29962;14653;46357
320530;201810;28758;79767;22498;68341;2866;10273;13116;37331;15982;47604
330010;201810;19477;55513;16278;49887;3115;9923;8965;27178;12080;37101
330015;201810;1330;3520;1088;3099;185;603;586;1574;771;2177
330020;201810;19003;49953;16760;46670;2483;7870;11605;31310;14088;39180
330022;201810;1886;5194;1476;4493;258;839;874;2612;1132;3451
330023;201810;3597;9586;2721;8240;607;1934;1201;3545;1808;5479
330025;201810;4853;12270;3304;9575;963;3026;1055;3003;2018;6029
330030;201810;9119;26630;7292;23283;1014;3727;4188;12589;5202;16316
330040;201810;11879;33263;10114;30126;1388;4629;6506;18656;7894;23285
330045;201810;79677;197823;67613;181516;7495;19484;50630;135039;58125;154523
330050;201810;2287;6324;1767;5431;422;1396;790;2302;1212;3698
330060;201810;4908;13590;4126;12287;928;3030;1758;4893;2686;7923
330070;201810;20632;56115;17288;50909;3303;10395;9132;26611;12435;37006
330080;201810;8539;23226;7536;21693;966;2918;4958;14155;5924;17073
330090;201810;3030;6727;2172;5591;218;601;1395;3541;1613;4142
330093;201810;2209;5908;1688;5075;182;568;1168;3516;1350;4084
330095;201810;1078;3318;885;2925;94;379;463;1384;557;1763
330100;201810;62925;176001;54069;162356;4409;15505;39174;115486;43583;130991
330110;201810;1991;6013;1769;5629;333;1167;864;2640;1197;3807
330115;201810;1882;5004;1487;4390;268;840;856;2480;1124;3320
330120;201810;3186;7586;2466;6629;205;619;1807;4744;2012;5363
330130;201810;3420;9979;2913;9213;519;1762;1721;5440;2240;7202
330140;201810;3321;9193;2766;8338;471;1624;1634;4742;2105;6366
330150;201810;2005;5639;1594;4952;348;1129;669;2022;1017;3151
330160;201810;1188;3381;976;3059;211;740;487;1437;698;2177
330170;201810;91663;249458;79259;231608;12821;37879;50419;147984;63240;185863
330180;201810;2091;5484;1666;4803;122;426;1137;3156;1259;3582
330185;201810;9139;25088;7665;22585;888;3009;5296;15032;6184;18041
330187;201810;3651;9756;2996;8735;453;1450;1854;5327;2307;6777
330190;201810;29035;74635;25635;69821;2560;7330;19632;52854;22192;60184
330200;201810;13718;38065;11783;35456;2668;7667;6928;21496;9596;29163
330205;201810;1957;5122;1583;4480;118;386;1083;2949;1201;3335
330210;201810;3202;8528;2330;6851;462;1449;845;2291;1307;3740
330220;201810;10097;27330;7584;22689;1787;5791;2220;6060;4007;11851
330225;201810;3384;9284;2742;8262;243;918;1925;5605;2168;6523
330227;201810;16179;42180;14151;39461;1104;3413;11371;31217;12475;34630
330230;201810;1498;3727;1119;3202;90;282;769;2145;859;2427
330240;201810;19541;53966;15981;47923;3171;10323;8501;24697;11672;35020
330245;201810;1527;3965;956;2996;239;787;248;785;487;1572
330250;201810;33682;92369;29046;85060;7038;20947;14174;42137;21212;63084
330260;201810;4244;11687;3389;10333;543;1819;1871;5435;2414;7254
330270;201810;24651;52248;15020;38217;2820;7834;6192;15367;9012;23201
330280;201810;2279;6221;1753;5270;238;776;959;2771;1197;3547
330285;201810;19839;50832;16345;45706;1855;5866;11258;30463;13113;36329
330290;201810;3195;8735;2685;7885;403;1264;1570;4467;1973;5731
330300;201810;4334;11629;3378;10124;397;1382;2148;6218;2545;7600
330310;201810;2196;5881;1734;5089;124;363;1119;3289;1243;3652
330320;201810;13641;35719;11709;33100;1763;5054;8168;23248;9931;28302
330330;201810;29301;71833;24315;64611;3031;8950;16707;43144;19738;52094
330340;201810;13679;36196;10234;30475;2025;6610;4658;13180;6683;19790
330350;201810;98060;252817;84349;234556;8421;24890;63570;175503;71991;200393
330360;201810;7457;18771;6418;17527;396;1167;5264;14273;5660;15440
330370;201810;4085;12656;3234;11025;830;2995;1224;4228;2054;7223
330380;201810;4956;14296;3887;12380;850;2954;1608;4941;2458;7895
330385;201810;3818;11801;3229;10871;871;3196;1382;4660;2253;7856
330390;201810;22452;66607;18092;58096;3395;11943;8875;27252;12270;39195
330395;201810;3100;8238;2644;7613;223;731;1809;5075;2032;5806
330400;201810;2855;8127;2530;7537;213;776;1795;5021;2008;5797
330410;201810;2760;7876;2061;6602;424;1473;897;2715;1321;4188
330411;201810;2527;7164;2079;6294;195;663;1426;4137;1621;4800
330412;201810;1435;4424;1185;3951;184;673;632;1959;816;2632
330414;201810;22771;59896;18849;54383;2444;6970;12649;36410;15093;43380
330415;201810;3469;9845;2712;8522;428;1330;1442;4652;1870;5982
330420;201810;9296;24044;6167;18721;1009;3337;2438;7007;3447;10344
330430;201810;8313;21755;7220;20061;651;2155;5168;13775;5819;15930
330440;201810;1771;5145;1428;4602;361;1304;630;1899;991;3203
330450;201810;1310;3973;1063;3509;181;644;506;1614;687;2258
330452;201810;14777;39651;11613;34420;2160;6927;6272;18071;8432;24998
330455;201810;522713;1313261;406651;1134602;70682;208500;235987;645861;306669;854361
330460;201810;1156;3395;909;3006;198;684;421;1356;619;2040
330470;201810;4402;11722;3358;10040;928;2878;1310;3903;2238;6781
330475;201810;8325;22932;6852;20867;1491;4972;3815;11372;5306;16344
330480;201810;5771;15889;5004;14670;610;2017;3165;8974;3775;10991
330490;201810;113092;273784;96032;249399;10707;29948;68393;174134;79100;204082
330500;201810;5595;15463;4927;14469;707;2255;3438;9919;4145;12174
330510;201810;36386;98988;29377;88588;7734;23994;14537;43583;22271;67577
330513;201810;1134;3246;976;2954;295;946;361;1049;656;1995
330515;201810;2505;7114;2081;6399;600;1937;872;2597;1472;4534
330520;201810;10511;29680;8810;26755;1505;5038;4680;13643;6185;18681
330530;201810;1604;4122;1202;3431;257;796;524;1419;781;2215
330540;201810;2813;7787;2201;6680;660;2048;770;2309;1430;4357
330550;201810;7640;23057;6451;21094;2325;8014;1758;5717;4083;13731
330555;201810;12414;30760;10516;28223;1444;4195;7184;19331;8628;23526
330560;201810;4225;11791;3516;10519;498;1553;2085;6043;2583;7596
330570;201810;2747;7901;2319;7149;426;1433;1351;4083;1777;5516
330575;201810;5307;14346;4655;13193;413;1322;3497;9546;3910;10868
330580;201810;12582;36401;9894;31166;2344;7902;4207;12740;6551;20642
330590;201810;1498;4263;1322;4038;182;553;911;2822;1093;3375
330600;201810;11028;30996;8763;26955;1342;4307;4740;14462;6082;18769
330610;201810;8804;24891;7490;22828;816;2924;4835;14252;5651;17176
330615;201810;1861;5439;1483;4913;355;1312;829;2723;1184;4035
330620;201810;3575;11167;2957;10023;892;3257;953;3029;1845;6286
330630;201810;23717;62903;18799;54750;1990;6793;12571;35052;14561;41845
350010;201810;1798;5002;922;2971;235;791;103;266;338;1057
350020;201810;663;1766;346;1110;37;132;134;390;171;522
350030;201810;3612;10636;2714;8873;724;2499;856;2709;1580;5208
350040;201810;612;1884;383;1369;71;285;112;324;183;609
350050;201810;864;2412;633;1958;141;504;199;482;340;986
350055;201810;745;1988;628;1821;55;183;484;1387;539;1570
350060;201810;107;303;80;255;15;52;38;118;53;170
350070;201810;3646;9901;2256;7191;445;1515;697;1994;1142;3509
350075;201810;597;1860;448;1545;184;653;56;170;240;823
350080;201810;621;1668;383;1192;43;146;170;479;213;625
350090;201810;618;1523;356;1024;85;255;106;289;191;544
350100;201810;2011;5593;1334;4322;173;653;647;1955;820;2608
350110;201810;399;1146;306;958;23;86;194;586;217;672
350115;201810;1307;3902;1071;3380;193;670;539;1540;732;2210
350120;201810;759;2003;440;1351;56;176;255;786;311;962
350130;201810;3094;8641;2490;7462;385;1246;1305;3698;1690;4944
350140;201810;592;1883;467;1636;37;163;254;823;291;986
350150;201810;511;1605;431;1439;117;400;110;333;227;733
350160;201810;10461;26692;6853;20155;897;3118;3947;10834;4844;13952
350170;201810;1646;5048;1277;4174;266;914;425;1325;691;2239
350180;201810;1087;2763;566;1715;119;397;185;505;304;902
350190;201810;2825;8281;2012;6535;455;1658;745;1987;1200;3645
350200;201810;395;1118;322;978;22;73;223;637;245;710
350210;201810;5220;12575;3448;9747;681;2001;1812;4957;2493;6958
350220;201810;2522;7222;1819;5767;394;1349;690;1972;1084;3321
350230;201810;917;2605;776;2366;153;503;393;1160;546;1663
350240;201810;677;2036;456;1507;84;285;156;500;240;785
350250;201810;2254;7187;1750;6211;623;2396;310;1148;933;3544
350260;201810;798;2017;509;1481;71;208;270;756;341;964
350270;201810;4503;12784;3620;10995;616;2044;1806;5105;2422;7149
350275;201810;2201;6384;1800;5635;343;1184;909;2659;1252;3843
350280;201810;18830;43411;11385;31186;2211;6459;3990;10565;6201;17024
350290;201810;3012;8710;2049;6706;390;1377;798;2535;1188;3912
350300;201810;639;1813;462;1438;92;300;175;496;267;796
350310;201810;777;2329;602;1925;94;356;253;725;347;1081
350315;201810;556;1531;380;1199;48;179;157;434;205;613
350320;201810;11980;32959;9428;28319;2493;8029;2594;7634;5087;15663
350330;201810;13840;35290;9703;26887;1366;4057;5472;14361;6838;18418
350335;201810;347;1000;281;885;19;60;185;587;204;647
350340;201810;1097;2937;647;2082;121;417;220;689;341;1106
350350;201810;729;2007;566;1810;92;324;286;862;378;1186
350360;201810;952;3000;784;2613;235;775;239;804;474;1579
350370;201810;598;1605;393;1172;121;349;83;238;204;587
350380;201810;4424;12274;2980;9442;779;2519;785;2500;1564;5019
350390;201810;9310;26300;7549;23102;2031;6428;2901;8636;4932;15064
350395;201810;411;1063;186;612;21;64;54;166;75;230
350400;201810;7466;19607;5337;15911;1418;4581;1544;4362;2962;8943
350410;201810;8925;26262;6569;21529;1586;5763;2033;6141;3619;11904
350420;201810;612;1780;450;1464;86;326;92;266;178;592
350430;201810;686;1936;570;1728;67;243;359;998;426;1241
350440;201810;1604;4368;1280;3821;159;529;787;2297;946;2826
350450;201810;6237;18426;5018;16067;1182;4028;1842;5588;3024;9616
350460;201810;1578;4078;811;2523;141;485;180;507;321;992
350470;201810;246;635;190;531;7;29;123;312;130;341
350480;201810;817;2251;540;1695;110;392;78;201;188;593
350490;201810;1678;4797;1253;3980;308;996;401;1192;709;2188
350500;201810;634;1768;500;1514;95;312;240;692;335;1004
350510;201810;1037;2904;757;2351;99;345;398;1171;497;1516
350520;201810;1826;5996;1404;5063;279;1121;557;1847;836;2968
350530;201810;2376;6273;1761;5047;327;1024;878;2359;1205;3383
350535;201810;1398;4019;1226;3769;150;543;814;2424;964;2967
350540;201810;1632;4338;1201;3599;223;721;600;1784;823;2505
350550;201810;8969;22299;5975;17325;745;2486;3079;8358;3824;10844
350560;201810;3597;10649;2907;9295;291;1014;1763;5438;2054;6452
350570;201810;20507;60364;16757;52735;3969;13553;7414;22115;11383;35668
350580;201810;1701;4898;954;3136;228;794;118;310;346;1104
350590;201810;4249;12204;3120;9637;590;2056;1595;4509;2185;6565
350600;201810;36928;89598;23574;64856;3259;9979;11641;29354;14900;39333
350610;201810;6429;18264;4782;15007;1017;3385;1997;6081;3014;9466
350620;201810;397;1009;258;806;32;118;134;390;166;508
350630;201810;1439;3887;1035;3136;89;321;594;1679;683;2000
350635;201810;7304;19316;5591;16474;1049;3429;2957;8253;4006;11682
350640;201810;863;2419;477;1498;63;217;159;432;222;649
350650;201810;7535;21060;4980;15657;1033;3494;1499;4318;2532;7812
350660;201810;4398;12125;3463;10494;697;2182;1655;5019;2352;7201
350670;201810;1613;4656;1398;4308;204;661;840;2589;1044;3250
350680;201810;1080;3010;717;2291;141;480;307;945;448;1425
350690;201810;1107;3182;832;2645;149;516;420;1262;569;1778
350700;201810;4521;11885;3021;9463;676;2318;1241;3645;1917;5963
350710;201810;2590;7492;2233;6863;321;1101;1267;3719;1588;4820
350715;201810;829;2393;698;2128;84;317;373;1019;457;1336
350720;201810;161;420;119;344;19;59;52;142;71;201
350730;201810;471;1470;365;1243;49;199;204;646;253;845
350740;201810;1545;4443;1026;3284;186;627;269;785;455;1412
350745;201810;530;1462;327;1029;37;128;142;402;179;530
350750;201810;8733;24653;7029;21399;1361;4746;2882;7766;4243;12512
350760;201810;12791;33975;9185;27534;2444;7836;2522;6782;4966;14618
350770;201810;726;1941;504;1515;58;182;313;911;371;1093
350775;201810;660;1689;477;1379;66;208;206;574;272;782
350780;201810;1853;5074;1391;4282;314;1057;406;1374;720;2431
350790;201810;1615;4557;1019;3377;195;715;204;582;399;1297
350800;201810;3073;9507;2701;8787;456;1572;1379;4383;1835;5955
350810;201810;2228;5771;1839;5258;285;861;1081;3178;1366;4039
350820;201810;786;1948;446;1300;46;144;214;569;260;713
350830;201810;833;2397;473;1573;60;211;146;415;206;626
350840;201810;2679;8354;2018;7009;560;2105;669;2147;1229;4252
350850;201810;6295;18827;4887;16020;1293;4433;1523;4896;2816;9329
350860;201810;3098;8939;2824;8531;139;543;2163;6370;2302;6913
350870;201810;2683;7843;1989;6676;360;1355;985;3172;1345;4527
350880;201810;1219;3731;987;3200;235;791;319;991;554;1782
350890;201810;578;1557;359;1084;43;146;130;329;173;475
350900;201810;6404;18508;4110;13328;1245;4393;633;1885;1878;6278
350910;201810;859;2297;732;2060;122;400;469;1278;591;1678
350920;201810;11587;30234;9899;27342;590;1913;7749;20484;8339;22397
350925;201810;4366;12555;3156;10213;656;2209;1233;3604;1889;5813
350930;201810;1426;3730;956;2832;130;407;489;1361;619;1768
350940;201810;1942;5604;1582;4905;224;761;965;2908;1189;3669
350945;201810;862;2512;656;2091;124;445;283;815;407;1260
350950;201810;77376;211813;61052;178380;9563;30807;34931;96488;44494;127295
350960;201810;5344;15559;4263;13436;718;2576;2329;6912;3047;9488
350970;201810;3461;10817;2644;8997;871;3218;382;1123;1253;4341
350980;201810;574;1727;471;1509;164;536;165;518;329;1054
350990;201810;1702;5187;1317;4497;338;1290;430;1349;768;2639
350995;201810;771;2480;691;2302;54;226;460;1454;514;1680
351000;201810;2534;6846;1831;5527;424;1421;516;1449;940;2870
351010;201810;314;809;186;563;22;69;92;270;114;339
351015;201810;693;2179;569;1931;86;345;271;842;357;1187
351020;201810;8768;24896;6821;21634;1347;4500;3538;10957;4885;15457
351030;201810;2462;7661;1994;6647;322;1229;1003;3189;1325;4418
351040;201810;4407;11672;3778;10655;260;893;2910;7877;3170;8770
351050;201810;16163;41143;11012;32687;2525;8048;4182;12169;6707;20217
351060;201810;43265;114165;33812;97375;4750;14827;20875;58057;25625;72884
351070;201810;1316;3498;776;2498;238;807;94;290;332;1097
351080;201810;2524;6798;1887;5977;390;1400;955;2791;1345;4191
351090;201810;339;1033;233;832;47;176;51;192;98;368
351100;201810;2334;6590;1524;4827;382;1297;380;1212;762;2509
351110;201810;5643;14990;3719;11383;808;2692;1359;3801;2167;6493
351120;201810;717;1928;491;1494;77;249;208;594;285;843
351130;201810;1021;2702;486;1606;95;327;82;243;177;570
351140;201810;1674;5150;1233;4226;342;1290;317;941;659;2231
351150;201810;1824;5516;1142;3926;231;853;300;912;531;1765
351160;201810;1091;3592;895;3144;207;774;294;917;501;1691
351170;201810;1329;3929;1166;3575;137;462;731;2141;868;2603
351190;201810;819;2379;573;1807;115;356;221;638;336;994
351200;201810;1597;4047;1226;3465;83;263;802;2171;885;2434
351210;201810;1414;3554;841;2430;89;290;464;1206;553;1496
351220;201810;2957;8894;2586;8221;389;1281;1586;4976;1975;6257
351230;201810;1756;5064;1319;4261;299;1090;532;1530;831;2620
351240;201810;1827;4914;1206;3570;233;750;539;1441;772;2191
351250;201810;1059;2882;589;1887;76;264;211;663;287;927
351260;201810;925;2526;698;2100;177;530;222;667;399;1197
351270;201810;351;1073;302;975;55;215;160;438;215;653
351280;201810;3901;10927;3116;9372;574;1921;1480;4188;2054;6109
351290;201810;964;2588;661;2015;123;374;308;919;431;1293
351300;201810;14319;41403;9972;32626;2174;7556;3610;11674;5784;19230
351310;201810;3021;8122;2327;6934;245;877;1459;4026;1704;4903
351320;201810;860;2654;647;2117;105;372;232;708;337;1080
351330;201810;1040;3781;968;3653;47;123;835;3243;882;3366
351340;201810;6103;18370;4918;16180;1371;4645;1893;6247;3264;10892
351350;201810;10845;29195;9297;26502;1126;3473;6755;18662;7881;22135
351360;201810;3748;10617;3149;9593;803;2661;1059;2981;1862;5642
351370;201810;2155;6293;1464;4781;369;1233;464;1338;833;2571
351380;201810;43764;112392;32323;91262;5460;16204;16798;45855;22258;62059
351385;201810;270;697;157;477;33;88;51;153;84;241
351390;201810;1322;3398;846;2674;135;504;466;1359;601;1863
351400;201810;883;2611;706;2226;170;541;348;1078;518;1619
351410;201810;2227;6527;1701;5476;322;1047;749;2382;1071;3429
351420;201810;345;858;185;556;40;110;67;193;107;303
351430;201810;738;2251;667;2112;61;223;508;1571;569;1794
351440;201810;3204;8703;2125;6384;405;1321;528;1336;933;2657
351450;201810;1665;4425;1131;3465;247;819;241;655;488;1474
351460;201810;722;2004;586;1769;173;509;278;846;451;1355
351470;201810;1095;2989;875;2581;87;308;536;1481;623;1789
351480;201810;2548;7871;2123;7115;323;1207;1000;3178;1323;4385
351490;201810;1752;5306;1540;4880;91;365;1140;3445;1231;3810
351492;201810;320;905;263;785;16;54;163;461;179;515
351495;201810;177;529;142;442;20;67;77;225;97;292
351500;201810;34340;89136;25364;72936;5078;15493;12704;34794;17782;50287
351510;201810;11290;29946;8327;24444;1264;4112;4824;13525;6088;17637
351512;201810;481;1348;318;975;53;166;100;273;153;439
351515;201810;3015;7123;1825;5145;357;1121;475;1335;832;2456
351518;201810;2174;5856;1466;4578;227;822;771;2165;998;2987
351519;201810;568;1662;383;1229;66;229;85;218;151;447
351520;201810;1098;2809;421;1332;66;238;162;433;228;671
351530;201810;354;1005;191;615;37;123;59;149;96;272
351535;201810;2017;5028;1473;4109;195;634;858;2233;1053;2867
351540;201810;1995;5237;1331;4063;444;1504;244;608;688;2112
351550;201810;5736;15273;3906;11552;520;1743;2052;5585;2572;7328
351560;201810;377;1158;311;1020;73;272;92;281;165;553
351565;201810;172;550;138;486;35;128;43;140;78;268
351570;201810;17792;49717;13469;40331;1825;5926;8121;23230;9946;29156
351580;201810;276;737;157;497;18;53;57;194;75;247
351590;201810;505;1188;269;743;32;113;149;366;181;479
351600;201810;1523;4076;1168;3418;141;445;681;1839;822;2284
351610;201810;703;1729;465;1314;27;100;249;625;276;725
351620;201810;19101;54822;14477;45978;2675;9658;5841;16537;8516;26195
351630;201810;25286;71241;20871;63124;3813;12067;12350;36377;16163;48444
351640;201810;15199;42429;11968;36129;1506;5118;7656;22119;9162;27237
351650;201810;407;1133;175;586;28;93;33;115;61;208
351660;201810;730;2195;452;1479;79;290;81;236;160;526
351670;201810;4938;13922;3592;10959;717;2259;1708;4855;2425;7114
351680;201810;416;1253;262;846;54;157;66;193;120;350
351685;201810;417;1283;332;1117;84;287;101;321;185;608
351690;201810;1008;2698;597;1826;108;354;217;587;325;941
351700;201810;930;2561;765;2262;140;414;385;1092;525;1506
351710;201810;685;1932;467;1501;52;196;211;616;263;812
351720;201810;1414;3869;919;2900;165;557;346;1014;511;1571
351730;201810;902;2510;748;2224;92;317;424;1175;516;1492
351740;201810;3757;9781;2918;8130;545;1586;1293;3335;1838;4921
351750;201810;1278;3666;782;2675;151;553;256;862;407;1415
351760;201810;3234;9449;2300;7430;518;1849;771;2282;1289;4131
351770;201810;1844;5605;1527;4981;394;1328;657;2110;1051;3438
351780;201810;1383;3668;705;2205;121;445;199;577;320;1022
351790;201810;1250;3159;1005;2804;184;494;596;1684;780;2178
351800;201810;548;1267;277;764;39;125;84;190;123;315
351810;201810;973;2663;800;2371;53;130;584;1676;637;1806
351820;201810;2383;7011;1661;5511;408;1453;306;964;714;2417
351830;201810;4163;11726;3214;9968;407;1464;1807;5323;2214;6787
351840;201810;7142;21408;5552;18343;989;3624;2499;7779;3488;11403
351850;201810;1831;4857;1145;3587;224;791;317;884;541;1675
351860;201810;2767;8404;2230;7335;439;1545;1134;3681;1573;5226
351870;201810;21990;59807;17488;52176;5825;17939;6106;18830;11931;36769
351880;201810;111965;313187;85353;263341;24650;81927;26509;77167;51159;159094
351885;201810;688;2141;604;1962;112;373;326;1026;438;1399
351890;201810;605;1815;473;1565;105;336;68;195;173;531
351900;201810;979;2807;772;2466;160;522;340;1086;500;1608
351905;201810;379;1075;253;802;28;95;99;272;127;367
351907;201810;20705;56263;16451;48423;1650;5415;11082;31561;12732;36976
351910;201810;1148;3125;813;2419;125;430;412;1087;537;1517
351920;201810;864;2336;642;1906;80;269;319;881;399;1150
351925;201810;942;2670;732;2261;116;379;331;952;447;1331
351930;201810;2944;8716;2748;8325;322;1170;2132;6260;2454;7430
351940;201810;1049;2785;756;2252;109;366;405;1156;514;1522
351950;201810;1357;3358;1041;2888;58;186;701;1892;759;2078
351960;201810;4854;13097;3636;10859;841;2726;1530;4230;2371;6956
351970;201810;5532;18293;4840;16981;906;3573;2575;8561;3481;12134
351980;201810;973;2526;666;1974;90;307;370;1024;460;1331
351990;201810;1343;3366;951;2717;101;357;385;1000;486;1357
352000;201810;2333;7088;2004;6398;247;912;1239;3640;1486;4552
352010;201810;2006;5787;1608;5028;409;1376;280;915;689;2291
352020;201810;1486;4201;1160;3627;211;714;533;1560;744;2274
352030;201810;5311;14655;4188;12833;867;2884;2146;6441;3013;9325
352040;201810;2312;6519;1480;4757;263;894;385;1079;648;1973
352042;201810;3039;7705;1841;5554;373;1189;727;2205;1100;3394
352044;201810;1956;5572;1134;3883;187;695;208;646;395;1341
352050;201810;11743;32911;7651;24266;1950;6959;1157;3177;3107;10136
352060;201810;692;1993;516;1645;78;283;231;673;309;956
352070;201810;785;1683;552;1368;82;226;280;655;362;881
352080;201810;468;1237;282;851;44;151;96;247;140;398
352090;201810;1386;4315;1095;3630;172;656;399;1172;571;1828
352100;201810;2963;8683;2475;7732;617;2074;1085;3188;1702;5262
352110;201810;564;1756;439;1470;92;334;169;529;261;863
352115;201810;505;1486;414;1326;89;317;218;681;307;998
352120;201810;850;2639;673;2245;77;293;365;1125;442;1418
352130;201810;1837;5324;1171;3610;240;759;408;1180;648;1939
352140;201810;1314;3624;848;2673;136;455;383;1155;519;1610
352150;201810;793;2219;602;1865;149;474;293;905;442;1379
352160;201810;959;2446;697;2030;101;347;341;912;442;1259
352170;201810;2844;8117;2291;6933;445;1472;1130;3167;1575;4639
352180;201810;2714;7511;2158;6440;516;1721;695;1819;1211;3540
352190;201810;1118;3142;842;2675;139;487;360;1132;499;1619
352200;201810;373;1168;254;909;35;140;82;282;117;422
352210;201810;16710;42384;13657;37908;1576;4695;9830;26964;11406;31659
352215;201810;524;1447;459;1361;62;195;311;905;373;1100
352220;201810;15863;42709;10941;33239;2967;9413;3275;9645;6242;19058
352230;201810;12065;37544;9364;32146;2486;9387;3057;9798;5543;19185
352240;201810;11245;30115;8318;24964;1918;6536;3206;8655;5124;15191
352250;201810;21301;62744;17504;55690;4107;13827;8934;27835;13041;41662
352260;201810;5339;14804;3705;11422;592;2009;2074;6132;2666;8141
352265;201810;890;2614;779;2419;66;263;549;1624;615;1887
352270;201810;1456;4617;1107;3821;251;957;343;1080;594;2037
352280;201810;2276;6075;1784;5324;203;741;964;2656;1167;3397
352290;201810;1029;3133;867;2792;154;540;424;1232;578;1772
352300;201810;954;2656;667;2049;99;341;309;831;408;1172
352310;201810;43866;120156;32888;100388;8959;27717;13683;41942;22642;69659
352320;201810;5847;16407;4592;13812;796;2649;2194;5884;2990;8533
352330;201810;2037;5824;1619;5223;369;1365;730;2220;1099;3585
352340;201810;4669;13285;3511;11179;795;2761;1396;4147;2191;6908
352350;201810;1863;5657;1526;4890;208;806;786;2229;994;3035
352360;201810;1112;3112;973;2873;121;455;705;1952;826;2407
352370;201810;982;3000;878;2801;37;166;660;2035;697;2201
352380;201810;818;2361;637;2025;144;487;204;615;348;1102
352390;201810;16372;41042;10907;31470;1739;5524;5784;15728;7523;21252
352400;201810;3329;9399;2818;8471;540;1985;1654;4539;2194;6524
352410;201810;2883;7981;2283;6909;302;1061;1329;3840;1631;4901
352420;201810;891;2219;614;1771;115;352;209;576;324;928
352430;201810;6985;18848;5152;15545;1466;4777;1942;5584;3408;10361
352440;201810;16625;47936;12926;40540;2912;9619;5327;16206;8239;25825
352450;201810;773;2052;391;1281;57;193;113;330;170;523
352460;201810;2743;7978;1917;6306;418;1551;634;1945;1052;3496
352470;201810;3488;9038;2554;7453;326;1090;1424;3818;1750;4908
352480;201810;3406;8545;2314;6539;401;1260;1088;2819;1489;4079
352490;201810;703;2190;546;1849;109;418;229;720;338;1138
352500;201810;9697;25968;6992;20848;3381;10908;886;1661;4267;12569
352510;201810;3260;9265;2460;7810;613;2126;888;2644;1501;4770
352520;201810;2337;6852;1861;5946;453;1592;840;2500;1293;4092
352530;201810;8744;24774;5692;18119;1299;4621;969;2305;2268;6926
352540;201810;515;1560;373;1228;78;266;75;214;153;480
352550;201810;934;2814;656;2234;128;483;181;570;309;1053
352560;201810;557;1598;384;1216;73;247;118;340;191;587
352570;201810;1977;5980;1282;4472;324;1208;199;604;523;1812
352580;201810;761;2148;603;1836;102;351;275;781;377;1132
352585;201810;242;728;185;607;22;89;98;303;120;392
352590;201810;13138;36153;9409;28624;3040;9924;3564;9999;6604;19923
352600;201810;1876;5533;1463;4674;251;827;742;2321;993;3148
352610;201810;3006;8779;2308;7501;524;1860;810;2494;1334;4354
352620;201810;5491;15033;4388;13271;1377;4246;1548;4693;2925;8939
352630;201810;803;2041;620;1753;106;356;291;737;397;1093
352640;201810;2821;7574;2097;6316;187;611;1322;3858;1509;4469
352650;201810;580;1699;411;1290;68;242;146;422;214;664
352660;201810;965;3096;802;2753;180;647;323;1072;503;1719
352670;201810;8536;24304;5319;17503;1448;5140;531;1719;1979;6859
352680;201810;3083;9577;2213;7485;414;1577;955;2973;1369;4550
352690;201810;28122;73147;20728;59419;2010;6587;13021;35363;15031;41950
352700;201810;546;1434;404;1218;156;509;94;228;250;737
352710;201810;4814;13102;3493;10582;913;3060;1384;3846;2297;6906
352720;201810;7855;22961;6214;19570;2853;9135;928;2603;3781;11738
352725;201810;434;1187;220;703;15;55;91;270;106;325
352730;201810;2654;7776;2310;6980;398;1360;1287;3525;1685;4885
352740;201810;2103;5232;1618;4484;235;716;876;2311;1111;3027
352750;201810;413;1039;217;664;44;129;59;156;103;285
352760;201810;1399;4157;1113;3521;170;578;537;1644;707;2222
352770;201810;896;2466;589;1844;119;382;213;636;332;1018
352780;201810;633;1931;455;1552;90;331;144;461;234;792
352790;201810;523;1416;348;1060;42;125;124;330;166;455
352800;201810;1198;3849;868;3025;212;788;164;493;376;1281
352810;201810;1090;2686;661;1866;99;312;340;887;439;1199
352820;201810;513;1336;332;1024;80;256;70;206;150;462
352830;201810;596;1564;263;829;44;155;49;122;93;277
352840;201810;3732;11503;3194;10446;1119;3892;996;3097;2115;6989
352850;201810;10087;26459;6862;21033;1914;6216;2030;5937;3944;12153
352860;201810;914;2687;716;2278;145;497;285;867;430;1364
352870;201810;878;2264;598;1651;53;175;365;946;418;1121
352880;201810;1844;4599;1291;3569;198;571;706;1784;904;2355
352885;201810;255;773;199;675;28;104;115;384;143;488
352890;201810;707;1732;425;1130;53;151;219;503;272;654
352900;201810;17023;46063;11746;35560;2179;7176;5140;14449;7319;21625
352910;201810;452;1209;212;674;26;77;49;139;75;216
352920;201810;2519;6782;1819;5480;195;668;1113;3160;1308;3828
352930;201810;5328;15272;4100;12762;824;2710;1728;5059;2552;7769
352940;201810;22093;64576;16817;52967;4628;16061;4746;13821;9374;29882
352950;201810;479;1284;266;854;63;216;28;72;91;288
352960;201810;664;1868;345;1125;48;177;67;203;115;380
352965;201810;268;743;152;513;41;143;30;89;71;232
352970;201810;2960;7248;2297;6187;237;638;1533;4127;1770;4765
352980;201810;1331;3825;1048;3339;236;792;475;1459;711;2251
352990;201810;3956;11426;3265;10268;655;2318;1687;5026;2342;7344
353000;201810;475;1291;227;724;40;138;47;127;87;265
353010;201810;2532;6582;1696;5017;412;1333;536;1437;948;2770
353020;201810;3663;9695;2120;6409;289;954;764;2121;1053;3075
353030;201810;4004;10833;2811;8540;713;2274;595;1786;1308;4060
353040;201810;587;1463;441;1218;66;207;229;572;295;779
353050;201810;4842;14663;3664;12257;865;3129;1493;4727;2358;7856
353060;201810;44935;120884;37529;108541;3271;11328;27102;75181;30373;86509
353070;201810;9099;26674;6435;21065;1459;5091;2055;6353;3514;11444
353080;201810;4077;11999;2864;9508;632;2311;910;2744;1542;5055
353090;201810;523;1697;436;1502;48;191;240;774;288;965
353100;201810;308;848;118;389;20;69;32;92;52;161
353110;201810;6960;20241;5886;18579;1055;3555;3450;10957;4505;14512
353120;201810;460;1217;317;930;53;173;130;321;183;494
353130;201810;2307;5957;1601;4830;480;1589;494;1403;974;2992
353140;201810;2148;5669;1623;4650;171;557;968;2594;1139;3151
353150;201810;1410;3739;1026;3068;254;772;386;1091;640;1863
353160;201810;584;1571;404;1258;92;320;155;423;247;743
353170;201810;495;1459;403;1322;76;311;196;585;272;896
353180;201810;9341;23993;7440;20923;1004;3143;5051;13799;6055;16942
353190;201810;3291;9192;2626;7818;317;1038;1597;4433;1914;5471
353200;201810;1976;5447;890;2936;138;492;221;644;359;1136
353205;201810;313;1030;267;914;62;240;118;390;180;630
353210;201810;946;2319;600;1706;27;95;378;1038;405;1133
353215;201810;411;1200;335;1043;51;173;133;365;184;538
353220;201810;692;1933;445;1411;114;365;76;227;190;592
353230;201810;745;2205;633;2027;168;602;250;691;418;1293
353240;201810;2167;6237;1777;5490;256;914;1018;2977;1274;3891
353250;201810;1198;2769;705;1928;105;306;347;923;452;1229
353260;201810;1011;2507;586;1749;119;401;201;552;320;953
353270;201810;632;1751;508;1498;56;171;297;832;353;1003
353280;201810;722;2028;507;1560;88;278;176;504;264;782
353282;201810;1788;5255;1552;4787;192;672;912;2651;1104;3323
353284;201810;374;940;192;565;29;105;73;184;102;289
353286;201810;145;383;87;282;21;75;24;69;45;144
353290;201810;1399;3832;882;2765;95;373;449;1279;544;1652
353300;201810;1672;4713;1239;3808;214;747;526;1421;740;2168
353310;201810;367;942;250;717;23;85;139;368;162;453
353320;201810;578;1574;495;1421;21;67;387;1095;408;1162
353325;201810;601;1860;418;1423;95;323;127;423;222;746
353330;201810;551;1457;334;1000;41;133;166;464;207;597
353340;201810;2719;7570;1885;5947;522;1776;658;2026;1180;3802
353350;201810;3101;8667;2085;6417;458;1552;404;1049;862;2601
353360;201810;524;1612;429;1414;58;214;218;692;276;906
353370;201810;520;1626;429;1459;40;148;278;907;318;1055
353380;201810;262;838;211;724;34;125;96;311;130;436
353390;201810;5217;13733;4003;11491;645;2000;1958;5293;2603;7293
353400;201810;389;1156;298;967;62;229;60;151;122;380
353410;201810;536;1510;426;1305;91;313;210;618;301;931
353420;201810;467;1276;278;851;44;121;33;76;77;197
353430;201810;2100;6160;1565;5101;396;1401;525;1575;921;2976
353440;201810;59242;169841;42284;134652;8780;29388;19567;59688;28347;89076
353450;201810;392;1032;264;797;39;141;118;322;157;463
353460;201810;3232;8993;2352;7229;216;746;1046;3163;1262;3909
353470;201810;7033;19418;4996;15472;1010;3454;1797;5101;2807;8555
353475;201810;1381;3741;980;2863;135;424;457;1239;592;1663
353480;201810;1547;4322;1256;3755;80;283;861;2464;941;2747
353490;201810;928;2569;635;1930;120;383;272;785;392;1168
353500;201810;978;2413;786;2117;189;510;425;1170;614;1680
353510;201810;784;2417;569;1868;159;540;109;316;268;856
353520;201810;1079;2928;703;2209;68;230;340;1025;408;1255
353530;201810;2405;6604;1868;5534;261;874;931;2556;1192;3430
353540;201810;1990;5744;1636;5120;319;1026;831;2530;1150;3556
353550;201810;5629;15432;4469;13371;956;3044;2103;5949;3059;8993
353560;201810;2011;5967;1520;5119;515;1864;363;1122;878;2986
353570;201810;522;1451;383;1189;70;226;202;594;272;820
353580;201810;2008;5526;1605;4768;382;1167;729;2078;1111;3245
353590;201810;699;1957;430;1353;104;355;126;393;230;748
353600;201810;1698;4416;1376;3811;182;523;725;1926;907;2449
353610;201810;574;1823;422;1484;102;411;99;304;201;715
353620;201810;2529;7167;1813;5813;399;1396;521;1491;920;2887
353625;201810;517;1332;317;946;31;116;181;515;212;631
353630;201810;1177;3791;914;3173;223;816;244;769;467;1585
353640;201810;1347;3584;1058;3094;119;389;637;1824;756;2213
353650;201810;8816;24674;6364;19428;901;3036;3379;9583;4280;12619
353657;201810;295;860;235;753;29;103;113;330;142;433
353660;201810;1132;2520;763;1959;307;797;192;454;499;1251
353670;201810;3458;10296;2863;9059;696;2421;1313;3834;2009;6255
353680;201810;724;2059;548;1783;105;356;278;877;383;1233
353690;201810;473;1244;189;617;19;61;20;58;39;119
353700;201810;1846;5243;1578;4706;199;636;1006;2879;1205;3515
353710;201810;3865;8903;2114;5791;255;700;1180;2972;1435;3672
353715;201810;445;1207;289;902;21;82;96;268;117;350
353720;201810;1865;5243;1487;4655;214;739;924;2791;1138;3530
353730;201810;4049;11466;3032;9366;503;1671;1379;3968;1882;5639
353740;201810;1831;4998;1244;3860;307;1062;357;1022;664;2084
353750;201810;830;2628;580;2097;134;505;99;365;233;870
353760;201810;11657;28949;9281;25513;1406;4178;5761;15435;7167;19613
353770;201810;717;2165;339;1162;59;201;38;98;97;299
353780;201810;4446;13531;3521;11602;905;3268;1076;3221;1981;6489
353790;201810;2323;7393;1765;6194;534;2159;345;1000;879;3159
353800;201810;15996;45430;12536;39226;2340;7826;6051;18821;8391;26647
353810;201810;1053;2948;696;2225;120;448;258;772;378;1220
353820;201810;1677;4911;1208;3880;252;876;407;1264;659;2140
353830;201810;584;1510;444;1279;58;171;235;647;293;818
353850;201810;1619;4699;1241;3941;327;1006;378;1235;705;2241
353860;201810;2465;7350;1950;6275;492;1683;768;2330;1260;4013
353870;201810;26947;73763;18780;57411;2925;9836;8773;24527;11698;34363
353880;201810;2892;8357;2271;7177;236;850;1289;3943;1525;4793
353890;201810;2273;5290;1601;4255;159;465;1035;2606;1194;3071
353900;201810;656;1891;485;1553;100;350;192;595;292;945
353910;201810;2096;6777;1839;6332;243;885;1285;4478;1528;5363
353920;201810;2095;5844;1421;4511;312;1141;333;893;645;2034
353930;201810;4010;11161;2722;8808;662;2319;745;2196;1407;4515
353940;201810;1032;3124;709;2410;148;515;196;621;344;1136
353950;201810;2941;8513;2370;7378;482;1648;1239;3529;1721;5177
353960;201810;702;1995;460;1485;98;308;155;480;253;788
353970;201810;605;1631;492;1438;44;134;314;885;358;1019
353980;201810;13735;36946;10777;31432;1376;4283;6853;19321;8229;23604
353990;201810;867;2181;529;1543;64;218;274;738;338;956
354000;201810;2404;6076;1341;4026;276;872;223;680;499;1552
354010;201810;356;980;264;818;31;95;168;508;199;603
354020;201810;3465;10308;2765;8706;733;2490;928;2653;1661;5143
354025;201810;726;2020;466;1486;97;355;96;273;193;628
354030;201810;474;1065;230;622;40;104;87;232;127;336
354040;201810;769;1873;472;1343;36;118;296;796;332;914
354050;201810;909;2740;646;2207;157;565;180;613;337;1178
354060;201810;3868;11367;2587;8576;657;2277;698;2123;1355;4400
354070;201810;3064;8894;2195;7137;500;1785;614;1710;1114;3495
354075;201810;2184;6898;1719;5987;284;1128;870;2928;1154;4056
354080;201810;1414;4075;909;3027;169;582;232;695;401;1277
354085;201810;417;898;327;787;1;6;220;494;221;500
354090;201810;1423;4111;1259;3770;111;386;925;2709;1036;3095
354100;201810;15517;45919;11493;38518;2810;10123;4607;15328;7417;25451
354105;201810;1154;3138;896;2658;114;350;540;1573;654;1923
354110;201810;397;1082;306;946;71;231;105;317;176;548
354120;201810;1516;4237;1004;3091;211;669;319;864;530;1533
354130;201810;5628;15275;3664;11361;1074;3604;190;368;1264;3972
354140;201810;19789;49104;12861;36572;2673;8125;4769;12540;7442;20665
354150;201810;3187;8017;2365;6600;491;1472;1005;2674;1496;4146
354160;201810;3172;9609;2354;7791;663;2311;704;2225;1367;4536
354165;201810;554;1685;433;1441;84;321;203;627;287;948
354170;201810;1475;4390;1191;3769;98;349;707;2098;805;2447
354180;201810;451;1315;326;1032;64;221;113;319;177;540
354190;201810;1420;4184;1039;3385;119;423;391;1254;510;1677
354200;201810;874;2293;682;1979;88;264;359;974;447;1238
354210;201810;648;1890;530;1669;52;186;330;946;382;1132
354220;201810;3042;8538;2266;6964;434;1420;1037;2999;1471;4419
354230;201810;678;1827;529;1621;57;229;335;961;392;1190
354240;201810;1467;4279;955;3182;168;608;265;767;433;1375
354250;201810;542;1434;350;1114;106;344;99;319;205;663
354260;201810;7750;21559;6040;18521;1451;4661;2133;6464;3584;11125
354270;201810;1084;3328;858;2888;195;661;316;1053;511;1714
354280;201810;738;1980;627;1809;80;298;375;995;455;1293
354290;201810;868;2891;738;2577;137;475;326;1131;463;1606
354300;201810;3612;11027;3164;10186;1037;3425;1010;3106;2047;6531
354310;201810;670;2047;530;1742;105;362;179;537;284;899
354320;201810;879;2294;551;1678;98;349;205;536;303;885
354323;201810;513;1307;336;963;47;127;133;368;180;495
354325;201810;1196;3681;863;2938;165;586;339;1105;504;1691
354330;201810;7315;19672;5152;15079;821;2867;2893;7746;3714;10613
354340;201810;25590;68853;17817;54720;4167;13895;7227;21154;11394;35049
354350;201810;1144;3125;928;2698;144;459;563;1528;707;1987
354360;201810;535;1500;315;1072;58;192;48;160;106;352
354370;201810;969;3055;821;2768;142;518;437;1430;579;1948
354380;201810;788;2143;537;1704;94;344;126;331;220;675
354390;201810;12921;33056;8188;24390;1670;5281;2611;7326;4281;12607
354400;201810;1529;5094;1192;4279;215;833;412;1461;627;2294
354410;201810;5060;14685;3933;12382;958;3229;1662;4993;2620;8222
354420;201810;1399;3888;1016;3088;146;471;574;1662;720;2133
354425;201810;2325;6001;1716;4911;421;1231;624;1828;1045;3059
354430;201810;1459;4119;1150;3583;191;681;580;1682;771;2363
354440;201810;545;1515;335;1050;46;154;139;389;185;543
354450;201810;396;1068;214;701;29;92;55;164;84;256
354460;201810;903;2396;577;1774;92;302;267;785;359;1087
354470;201810;503;1283;326;917;27;86;162;407;189;493
354480;201810;1018;2388;705;1897;63;181;464;1189;527;1370
354490;201810;775;2339;560;1868;118;416;203;611;321;1027
354500;201810;2026;5945;1701;5451;564;1980;391;1236;955;3216
354510;201810;751;2091;607;1781;76;234;324;860;400;1094
354515;201810;291;897;209;721;37;145;80;262;117;407
354520;201810;6566;19201;4259;13599;725;2562;2177;6446;2902;9008
354530;201810;3861;11836;3005;10015;750;2596;1095;3622;1845;6218
354540;201810;1300;3601;946;2929;232;775;284;882;516;1657
354550;201810;540;1458;406;1198;61;187;236;659;297;846
354560;201810;1938;4991;1046;3096;146;459;509;1446;655;1905
354570;201810;1126;2985;479;1441;80;262;78;220;158;482
354580;201810;9301;25165;6054;18806;1042;3572;2743;8051;3785;11623
354600;201810;1684;4877;1316;4163;192;673;736;2234;928;2907
354610;201810;382;1027;200;623;32;109;69;204;101;313
354620;201810;446;1328;290;1010;49;187;104;307;153;494
354625;201810;312;885;184;622;25;85;47;135;72;220
354630;201810;1849;5735;1510;5051;654;2330;162;504;816;2834
354640;201810;3098;9327;2248;7489;391;1487;645;1963;1036;3450
354650;201810;883;2429;716;2117;75;235;411;1194;486;1429
354660;201810;2632;6794;1723;5224;154;567;1098;3228;1252;3795
354670;201810;1057;3072;753;2401;146;509;285;822;431;1331
354680;201810;4471;12728;3680;11355;960;3044;1829;5708;2789;8752
354690;201810;576;1834;400;1419;93;364;109;364;202;728
354700;201810;931;2529;642;1927;112;374;287;753;399;1127
354710;201810;515;1430;359;1097;52;184;158;418;210;602
354720;201810;316;791;137;413;44;128;27;83;71;211
354730;201810;9538;27759;7021;22838;1092;3861;3724;11648;4816;15509
354740;201810;322;890;125;436;14;58;22;69;36;127
354750;201810;2411;6649;1600;5088;318;1154;597;1696;915;2850
354760;201810;1890;5377;1323;4237;375;1311;332;992;707;2303
354765;201810;257;713;125;413;19;74;26;75;45;149
354770;201810;2227;5723;1585;4597;338;1074;656;1771;994;2845
354780;201810;52312;137860;40374;113259;5974;18654;22629;59274;28603;77928
354790;201810;903;2676;742;2385;113;390;405;1254;518;1644
354800;201810;2509;6907;1950;5918;507;1592;762;2183;1269;3775
354805;201810;1181;3003;816;2349;111;349;367;925;478;1274
354810;201810;582;1754;338;1200;52;204;93;307;145;511
354820;201810;909;2778;655;2239;120;473;155;469;275;942
354830;201810;473;1191;308;886;83;238;109;298;192;536
354840;201810;938;2448;503;1507;65;190;230;672;295;862
354850;201810;19703;54190;13875;43084;2094;7515;7642;22147;9736;29662
354860;201810;1433;4262;1007;3384;194;705;322;951;516;1656
354870;201810;48652;127538;38836;109314;5676;17448;22638;60675;28314;78123
354880;201810;5640;14509;2615;7706;353;1155;880;2077;1233;3232
354890;201810;15336;40476;12299;35297;1908;6030;6944;19206;8852;25236
354900;201810;428;1158;267;844;33;111;70;203;103;314
354910;201810;4908;13650;2873;9643;602;2149;302;933;904;3082
354920;201810;458;1228;185;629;21;90;40;120;61;210
354925;201810;277;832;142;510;19;72;33;92;52;164
354930;201810;384;959;223;670;27;94;103;283;130;377
354940;201810;1784;5763;1354;4762;460;1746;175;565;635;2311
354950;201810;1473;4113;1161;3625;81;353;750;2206;831;2559
354960;201810;801;2224;619;1936;115;414;298;868;413;1282
354970;201810;3831;11468;3069;10019;483;1682;1722;5460;2205;7142
354980;201810;28318;70469;18973;53651;2472;8217;10300;26976;12772;35193
354990;201810;57897;153868;42983;125874;5170;16748;25062;69699;30232;86447
354995;201810;2402;6069;1803;5189;288;936;1097;2970;1385;3906
355000;201810;1412;3950;1126;3460;199;700;415;1138;614;1838
355010;201810;2917;8614;1948;6358;705;2418;156;514;861;2932
355020;201810;3274;9647;2408;8014;765;2796;593;1872;1358;4668
355030;201810;1287081;3265900;937588;2558636;169952;504763;446346;1124703;616298;1629466
355040;201810;2770;7684;2291;6967;414;1328;1417;4283;1831;5611
355050;201810;937;2429;694;2023;215;631;179;476;394;1107
355060;201810;5135;14812;3868;12337;690;2495;1826;5216;2516;7711
355070;201810;7791;21503;6296;18956;854;2953;3693;10340;4547;13293
355080;201810;810;2465;509;1832;103;396;47;145;150;541
355090;201810;1143;3486;872;2939;215;721;253;865;468;1586
355100;201810;20201;55692;16139;49456;3156;10365;9383;28193;12539;38558
355110;201810;983;2900;745;2479;254;888;130;452;384;1340
355120;201810;630;1754;447;1433;62;215;166;500;228;715
355130;201810;701;1639;326;871;21;56;178;441;199;497
355140;201810;1479;3876;1302;3607;133;440;979;2631;1112;3071
355150;201810;4025;11180;3217;9702;465;1497;1776;5182;2241;6679
355160;201810;1786;5184;1341;4350;340;1250;314;980;654;2230
355170;201810;8492;23001;6784;20053;1751;5521;3187;9180;4938;14701
355180;201810;2683;7707;1954;6401;437;1643;614;1746;1051;3389
355190;201810;1789;4906;1398;4248;388;1205;636;2021;1024;3226
355200;201810;783;2577;681;2397;239;946;206;648;445;1594
355210;201810;2883;8272;2433;7347;328;1141;1427;4039;1755;5180
355220;201810;41719;115812;33162;98891;9111;28690;12063;32897;21174;61587
355230;201810;1153;2966;620;1862;122;364;169;492;291;856
355240;201810;21802;58748;14798;44721;2429;7888;6997;20418;9426;28306
355250;201810;34027;95198;25175;77826;6579;21602;8908;26377;15487;47979
355255;201810;834;2184;433;1345;83;270;131;389;214;659
355260;201810;1290;3358;933;2744;126;456;551;1507;677;1963
355270;201810;1274;3905;970;3210;255;879;309;956;564;1835
355280;201810;26804;72578;19353;57685;3402;10835;8575;24235;11977;35070
355290;201810;799;2321;590;1884;129;398;223;672;352;1070
355300;201810;1194;3578;954;3081;183;616;310;977;493;1593
355310;201810;1019;2884;763;2436;98;353;392;1252;490;1605
355320;201810;522;1412;383;1135;66;221;146;367;212;588
355330;201810;2150;5988;1610;4974;181;639;1038;3051;1219;3690
355340;201810;3252;7499;2719;6738;354;861;1827;4525;2181;5386
355350;201810;1297;3948;956;3205;203;729;301;992;504;1721
355360;201810;1289;3505;1039;3084;113;359;702;2074;815;2433
355365;201810;364;1016;188;655;35;111;30;104;65;215
355370;201810;5642;14721;4318;12748;1120;3306;1797;5679;2917;8985
355380;201810;2904;8070;2164;6551;385;1280;680;1755;1065;3035
355385;201810;1303;3715;1086;3362;134;507;623;1745;757;2252
355390;201810;730;2065;541;1660;118;368;215;609;333;977
355395;201810;1855;5426;1320;4242;199;708;566;1647;765;2355
355400;201810;8807;27168;7150;23570;2067;7521;2100;6237;4167;13758
355410;201810;21089;60061;14231;46721;3515;12643;3170;10363;6685;23006
355420;201810;666;2265;549;2002;150;632;114;387;264;1019
355430;201810;3656;9475;2789;7948;746;2118;1155;3300;1901;5418
355440;201810;854;2403;512;1626;104;359;142;406;246;765
355450;201810;3405;9233;2193;6781;410;1355;800;2267;1210;3622
355460;201810;566;1456;350;1069;54;191;153;410;207;601
355465;201810;380;1119;272;883;56;197;88;276;144;473
355470;201810;1180;3167;628;1975;185;609;170;500;355;1109
355475;201810;281;712;252;660;26;74;194;506;220;580
355480;201810;3502;10411;2928;9455;443;1661;1799;5602;2242;7263
355490;201810;947;2632;505;1628;51;178;219;664;270;842
355495;201810;781;2331;579;1947;85;313;200;645;285;958
355500;201810;6392;17643;3799;12055;609;2081;1080;3142;1689;5223
355510;201810;1316;3480;811;2469;117;398;289;782;406;1180
355520;201810;369;841;171;471;29;80;61;150;90;230
355530;201810;434;989;143;416;22;75;55;129;77;204
355535;201810;516;1469;406;1285;96;337;156;443;252;780
355540;201810;9073;24911;7547;22464;1517;4816;4260;12333;5777;17149
355550;201810;645;1963;514;1697;73;246;241;774;314;1020
355560;201810;1088;3043;593;1963;132;466;26;87;158;553
355570;201810;232;675;127;427;25;78;25;76;50;154
355580;201810;1206;3048;789;2344;103;359;398;1125;501;1484
355590;201810;178;457;134;391;18;54;80;221;98;275
355600;201810;1495;3849;982;2909;246;770;369;1039;615;1809
355610;201810;1669;4387;1127;3358;156;458;530;1505;686;1963
355620;201810;4354;12470;3301;10230;466;1688;1705;4808;2171;6496
355630;201810;2135;6213;1510;4944;295;986;674;2168;969;3154
355635;201810;933;2845;725;2440;124;476;321;1027;445;1503
355640;201810;2644;7916;1812;6201;444;1580;362;1248;806;2828
355645;201810;4209;12527;3271;10842;428;1574;1911;6216;2339;7790
355650;201810;6493;18172;5393;16104;1472;4686;2570;7091;4042;11777
355660;201810;1264;3510;888;2755;120;488;312;910;432;1398
355670;201810;3271;9499;2266;7044;353;1303;1065;2852;1418;4155
355680;201810;3117;8893;1201;4044;335;1175;126;434;461;1609
355690;201810;700;2190;464;1682;121;474;23;63;144;537
355695;201810;226;685;127;434;13;49;15;29;28;78
355700;201810;6349;19192;5228;16627;1139;3639;2393;7368;3532;11007
355710;201810;7952;19380;5013;13920;942;2822;2011;5028;2953;7850
355715;201810;374;1091;219;730;62;231;43;127;105;358
355720;201810;1398;4275;1096;3666;211;760;508;1549;719;2309
355730;201810;945;2825;742;2396;186;602;252;767;438;1369
410010;201810;1214;3457;933;2866;199;672;215;643;414;1315
410020;201810;984;3105;791;2647;278;884;216;728;494;1612
410030;201810;1359;4058;1171;3696;190;694;598;1848;788;2542
410040;201810;10447;30911;8078;26260;1801;6349;2630;7924;4431;14273
410045;201810;959;2568;636;1955;102;348;192;548;294;896
410050;201810;2481;6348;1537;4579;368;1205;307;796;675;2001
410060;201810;2029;6075;1592;5114;393;1314;454;1404;847;2718
410070;201810;1674;4506;1238;3628;232;727;450;1259;682;1986
410080;201810;1336;3643;975;2965;164;527;407;1240;571;1767
410090;201810;973;2749;884;2582;112;330;484;1484;596;1814
410100;201810;1917;5711;1343;4298;203;778;253;762;456;1540
410105;201810;448;1218;239;752;38;137;55;164;93;301
410110;201810;3048;8147;2093;6140;310;956;798;2253;1108;3209
410115;201810;544;1385;378;1085;67;220;130;346;197;566
410120;201810;2383;7467;2097;6953;714;2524;624;2030;1338;4554
410130;201810;1102;3157;982;2921;306;1008;370;972;676;1980
410140;201810;14196;35497;8672;25258;1802;5597;1836;4883;3638;10480
410150;201810;16138;39503;7607;21843;1430;4469;1530;4151;2960;8620
410160;201810;2845;8203;2349;7277;490;1676;861;2654;1351;4330
410165;201810;691;1956;573;1686;58;195;342;934;400;1129
410170;201810;2397;6513;1568;4640;410;1306;139;429;549;1735
410180;201810;13615;40190;10800;33906;1753;5943;5529;16333;7282;22276
410185;201810;470;1291;331;1012;55;174;104;296;159;470
410190;201810;2118;5572;1579;4575;337;1005;417;1159;754;2164
410200;201810;4512;11229;2550;7568;495;1736;544;1564;1039;3300
410210;201810;2573;6890;1705;5141;300;1043;522;1310;822;2353
410220;201810;548;1447;348;1042;45;162;71;216;116;378
410230;201810;1451;4176;1198;3661;190;681;635;1776;825;2457
410240;201810;4200;11943;3220;9958;911;3168;306;876;1217;4044
410250;201810;2479;6258;1784;5011;202;695;789;2096;991;2791
410260;201810;1709;4427;1140;3410;245;785;475;1382;720;2167
410270;201810;453;1208;332;971;33;112;159;442;192;554
410275;201810;665;1967;437;1433;64;220;197;597;261;817
410280;201810;2145;5964;1362;4274;259;876;459;1337;718;2213
410290;201810;3000;8721;2190;6977;532;1718;723;2273;1255;3991
410300;201810;637;1667;500;1405;70;215;233;608;303;823
410302;201810;362;956;178;578;31;102;85;260;116;362
410304;201810;1118;3233;945;2857;141;461;512;1495;653;1956
410305;201810;1619;4139;1161;3427;224;680;597;1736;821;2416
410310;201810;2420;7284;1920;6208;415;1466;667;2136;1082;3602
410315;201810;700;1770;349;1134;105;350;77;239;182;589
410320;201810;1093;3118;690;2207;103;389;107;335;210;724
410322;201810;501;1396;277;875;24;82;116;355;140;437
410330;201810;1443;3721;1040;2924;196;588;284;795;480;1383
410335;201810;829;2353;670;2016;99;324;295;822;394;1146
410337;201810;782;1959;544;1483;52;156;253;650;305;806
410340;201810;493;1353;329;943;34;122;154;372;188;494
410345;201810;2235;5998;1144;3550;268;841;248;717;516;1558
410347;201810;692;1782;498;1426;56;195;143;386;199;581
410350;201810;1275;3471;913;2766;107;355;390;1109;497;1464
410360;201810;3881;9715;3063;8320;228;732;1982;5151;2210;5883
410370;201810;10794;29490;7366;21860;1055;3502;2780;7303;3835;10805
410380;201810;1359;3717;1016;2996;118;414;423;1147;541;1561
410390;201810;2482;6758;1629;5051;413;1410;360;1015;773;2425
410395;201810;874;2668;711;2300;147;526;303;960;450;1486
410400;201810;4823;13626;3714;11493;682;2192;1523;4551;2205;6743
410405;201810;782;1991;615;1728;145;443;266;703;411;1146
410410;201810;1136;3269;1106;3225;167;611;693;2067;860;2678
410420;201810;7470;22492;5773;18787;1175;4259;1664;4850;2839;9109
410425;201810;2795;8270;2029;6683;359;1276;654;1977;1013;3253
410430;201810;12620;32601;8659;25115;1468;4605;2833;7826;4301;12431
410440;201810;2691;8923;2371;8283;373;1355;1348;4852;1721;6207
410442;201810;2192;7026;1875;6287;571;1958;581;1946;1152;3904
410445;201810;2180;6665;1735;5767;388;1444;477;1655;865;3099
410450;201810;1499;4086;1110;3312;224;738;279;717;503;1455
410460;201810;1718;4548;1341;3947;200;629;596;1672;796;2301
410465;201810;2473;7578;1942;6402;431;1437;571;1779;1002;3216
410470;201810;1788;5403;1291;4298;362;1337;213;730;575;2067
410480;201810;32268;81546;17786;54314;2959;10016;3048;8046;6007;18062
410490;201810;10556;30553;7452;23785;1535;5297;2484;7423;4019;12720
410500;201810;1635;4685;1164;3670;277;969;265;734;542;1703
410510;201810;2028;5195;1313;3738;251;705;395;1120;646;1825
410520;201810;2949;9717;2708;9219;768;2673;1139;3921;1907;6594
410530;201810;1434;3858;715;2171;126;378;108;249;234;627
410540;201810;2472;6955;1804;5625;257;860;921;2840;1178;3700
410550;201810;6571;18086;4202;12772;776;2588;963;2532;1739;5120
410560;201810;1367;3662;1071;3088;235;724;437;1120;672;1844
410570;201810;2529;7403;1949;6287;551;2059;160;549;711;2608
410580;201810;22839;62431;17357;51933;3608;11777;7154;19793;10762;31570
410590;201810;1374;4068;901;2839;160;537;231;643;391;1180
410600;201810;1750;4846;1319;3978;293;857;477;1498;770;2355
410610;201810;722;1951;521;1558;61;194;226;642;287;836
410620;201810;1930;6007;1267;4354;303;1113;204;628;507;1741
410630;201810;2244;6263;1446;4492;295;993;223;560;518;1553
410640;201810;4321;10769;2879;8287;710;2306;418;1158;1128;3464
410645;201810;1010;3206;873;2984;349;1222;296;1034;645;2256
410650;201810;1930;5598;1390;4432;345;1156;395;1144;740;2300
410655;201810;904;2330;634;1827;58;205;294;777;352;982
410657;201810;648;1760;406;1245;70;246;157;404;227;650
410660;201810;3118;8312;1693;5114;351;1106;321;925;672;2031
410670;201810;1018;2563;601;1727;105;295;282;770;387;1065
410680;201810;2770;8604;1978;6624;489;1575;486;1696;975;3271
410685;201810;563;1503;457;1311;98;319;215;573;313;892
410690;201810;116196;303130;76464;225120;13856;45644;24851;64025;38707;109669
410700;201810;2219;5953;1915;5433;345;1035;960;2565;1305;3600
410710;201810;814;2160;531;1598;61;197;273;780;334;977
410712;201810;669;2023;568;1810;152;515;194;570;346;1085
410715;201810;820;2517;512;1768;105;362;147;493;252;855
410720;201810;2997;8161;2181;6472;319;1125;445;1127;764;2252
410725;201810;1123;2869;660;1973;123;384;118;308;241;692
410730;201810;571;1529;413;1237;89;304;89;241;178;545
410740;201810;958;2757;679;2204;127;449;248;780;375;1229
410750;201810;1650;4473;1345;3889;228;733;533;1473;761;2206
410752;201810;344;897;154;471;29;98;58;158;87;256
410753;201810;204;629;146;502;17;63;27;83;44;146
410754;201810;1117;2979;924;2670;66;160;598;1857;664;2017
410755;201810;623;1605;444;1249;54;174;211;523;265;697
410760;201810;3105;8367;2320;6944;688;2243;544;1584;1232;3827
410765;201810;12080;35428;9407;30066;1565;5488;1438;4255;3003;9743
410770;201810;941;2331;655;1846;81;261;298;814;379;1075
410773;201810;1272;3448;1103;3169;131;413;738;2066;869;2479
410775;201810;1397;3705;1223;3434;126;394;655;1788;781;2182
410780;201810;586;1478;348;978;63;185;88;251;151;436
410785;201810;761;2207;602;1890;108;357;210;626;318;983
410790;201810;561;1657;442;1403;112;388;47;98;159;486
410800;201810;3019;6951;2405;6022;120;355;1466;3539;1586;3894
410810;201810;350;996;264;832;40;139;119;347;159;486
410820;201810;721;2112;410;1280;89;288;77;213;166;501
410830;201810;27901;72787;20024;58948;4959;16325;6600;18290;11559;34615
410832;201810;980;2653;825;2354;105;366;464;1224;569;1590
410840;201810;7104;19134;4285;13396;923;3189;727;1963;1650;5152
410845;201810;1108;3078;903;2701;175;569;327;942;502;1511
410850;201810;2287;6847;2008;6322;375;1262;868;2713;1243;3975
410855;201810;685;1750;463;1335;44;129;201;537;245;666
410860;201810;3746;10012;2924;8436;568;1772;1009;2710;1577;4482
410865;201810;1339;4257;1190;3928;228;812;651;2194;879;3006
410870;201810;1254;3488;1094;3227;55;169;805;2368;860;2537
410880;201810;3993;11420;2921;9305;529;1894;424;1417;953;3311
410890;201810;955;2844;688;2252;162;567;191;612;353;1179
410895;201810;899;3053;774;2751;303;1143;118;403;421;1546
410900;201810;861;2352;571;1762;89;281;128;316;217;597
410910;201810;363;877;183;521;12;41;107;272;119;313
410920;201810;743;1913;536;1561;89;306;226;646;315;952
410930;201810;1401;3968;1076;3314;277;995;246;749;523;1744
410940;201810;20578;60375;15480;50458;3752;13216;3848;12528;7600;25744
410950;201810;1892;5664;1713;5374;73;299;1402;4299;1475;4598
410960;201810;7021;18732;4497;14101;1158;4073;1460;4370;2618;8443
410965;201810;961;2663;717;2165;123;386;358;1048;481;1434
410970;201810;3691;10314;2625;8217;626;2359;363;960;989;3319
410975;201810;1289;3463;994;2922;175;565;343;1005;518;1570
410980;201810;6522;17352;4211;12879;567;1922;1656;4840;2223;6762
410990;201810;1143;3041;749;2320;237;844;154;384;391;1228
411000;201810;491;1377;339;1053;55;207;87;214;142;421
411005;201810;422;1164;276;849;56;177;48;141;104;318
411007;201810;2128;6322;1798;5708;433;1471;564;1776;997;3247
411010;201810;4020;12543;3232;10788;848;3036;304;911;1152;3947
411020;201810;2316;6847;1947;6180;582;1953;546;1644;1128;3597
411030;201810;699;1819;459;1284;53;168;205;527;258;695
411040;201810;792;2109;371;1120;55;172;91;251;146;423
411050;201810;1766;5777;1488;5112;413;1511;203;594;616;2105
411060;201810;1616;4404;1056;3251;177;668;203;550;380;1218
411065;201810;334;932;246;758;32;102;110;337;142;439
411070;201810;6215;16942;4947;14580;976;3144;1998;5669;2974;8813
411080;201810;2113;5851;1694;5072;448;1460;432;1262;880;2722
411090;201810;846;2242;527;1611;52;190;122;333;174;523
411095;201810;1511;3709;1042;2906;128;424;365;943;493;1367
411100;201810;1070;2907;731;2250;80;287;204;630;284;917
411110;201810;603;1609;249;800;27;64;19;48;46;112
411120;201810;1274;3693;976;3074;343;1212;197;506;540;1718
411125;201810;4718;14305;4361;13651;961;3108;2072;6630;3033;9738
411130;201810;644;1819;456;1413;94;292;171;554;265;846
411140;201810;2169;6882;1782;5973;464;1661;602;2010;1066;3671
411150;201810;3579;9653;2524;7435;506;1696;212;479;718;2175
411155;201810;954;2532;574;1760;57;183;263;750;320;933
411160;201810;343;805;222;620;28;84;56;159;84;243
411170;201810;695;2145;510;1695;114;387;168;532;282;919
411180;201810;5172;14363;4046;12259;734;2443;1671;4761;2405;7204
411190;201810;1352;3660;1017;3006;206;635;311;850;517;1485
411200;201810;4791;13427;3319;10479;926;3223;684;1997;1610;5220
411210;201810;2228;5425;1604;4389;427;1346;272;684;699;2030
411220;201810;849;2299;623;1824;137;436;187;536;324;972
411230;201810;822;2295;555;1757;117;380;199;644;316;1024
411240;201810;1527;3771;904;2566;79;264;443;1192;522;1456
411250;201810;1967;5483;1497;4605;357;1259;446;1341;803;2600
411260;201810;324;853;207;618;31;95;79;215;110;310
411270;201810;1744;5008;1372;4219;230;748;628;1862;858;2610
411275;201810;1332;3445;957;2770;165;526;434;1224;599;1750
411280;201810;1365;3796;861;2753;163;548;117;333;280;881
411290;201810;723;2018;490;1545;59;176;226;728;285;904
411295;201810;1093;2791;861;2363;82;256;427;1115;509;1371
411300;201810;982;2487;614;1728;71;214;238;581;309;795
411310;201810;845;2071;647;1768;42;117;285;775;327;892
411320;201810;5212;14213;3719;11322;826;2626;1214;3392;2040;6018
411325;201810;1532;4487;1295;4029;239;734;670;2144;909;2878
411330;201810;3198;9129;2379;7514;610;2099;634;2044;1244;4143
411340;201810;840;2374;501;1574;66;220;195;580;261;800
411342;201810;892;2244;568;1612;86;243;265;742;351;985
411345;201810;1031;2831;784;2391;105;368;512;1551;617;1919
411350;201810;2417;6886;1707;5408;452;1581;174;525;626;2106
411360;201810;596;1477;412;1185;52;168;133;359;185;527
411370;201810;46218;118958;33889;97220;3309;11262;19035;50838;22344;62100
411373;201810;1316;3559;1082;3182;121;395;526;1579;647;1974
411375;201810;1034;2687;742;2135;126;384;272;718;398;1102
411380;201810;1054;2576;716;1867;61;188;414;976;475;1164
411390;201810;1605;4600;1246;3748;215;718;464;1248;679;1966
411400;201810;2036;5377;1628;4600;248;841;750;2009;998;2850
411410;201810;2028;5826;1515;4694;349;1185;303;870;652;2055
411420;201810;3845;9957;2216;6703;337;1172;399;968;736;2140
411430;201810;3254;9168;2598;7953;558;1873;1027;2858;1585;4731
411435;201810;419;1238;270;899;53;172;95;272;148;444
411440;201810;2489;7449;2043;6537;456;1589;681;2161;1137;3750
411450;201810;2533;6945;1925;5876;297;890;987;3061;1284;3951
411460;201810;3622;9922;2037;6545;374;1386;316;908;690;2294
411470;201810;703;1972;504;1547;87;284;148;406;235;690
411480;201810;4257;12124;3016;9635;567;2033;812;2398;1379;4431
411490;201810;1496;4086;1151;3449;170;594;410;1072;580;1666
411500;201810;1401;3805;926;2799;143;499;269;756;412;1255
411510;201810;2074;5686;1697;4965;365;1218;386;1136;751;2354
411520;201810;27227;68000;15120;44106;2138;6996;4983;12946;7121;19942
411530;201810;884;2425;551;1750;113;400;96;272;209;672
411535;201810;457;1368;204;712;22;75;26;72;48;147
411540;201810;2731;7187;1907;5475;311;984;714;1984;1025;2968
411545;201810;923;2775;779;2506;79;263;514;1649;593;1912
411550;201810;665;1763;470;1385;78;250;80;233;158;483
411560;201810;1874;5130;1115;3486;169;604;69;161;238;765
411570;201810;6837;16760;4708;13285;984;3046;1253;3511;2237;6557
411573;201810;756;2124;652;1943;91;288;373;1094;464;1382
411575;201810;1722;4909;1326;4080;275;894;350;1035;625;1929
411580;201810;4104;10011;2306;7055;263;995;319;878;582;1873
411585;201810;687;2083;313;1068;87;297;50;153;137;450
411590;201810;364;1064;255;814;29;114;141;403;170;517
411600;201810;270;740;162;541;37;134;55;179;92;313
411605;201810;1448;3622;905;2574;127;433;435;1185;562;1618
411610;201810;2201;5751;1554;4399;160;506;870;2364;1030;2870
411620;201810;2772;7781;2419;7209;424;1390;1376;3992;1800;5382
411630;201810;664;1741;439;1297;82;277;128;325;210;602
411640;201810;506;1407;345;1017;47;145;126;329;173;474
411650;201810;198;584;132;434;26;84;25;86;51;170
411660;201810;900;2343;638;1831;54;155;337;937;391;1092
411670;201810;1128;2936;818;2257;126;356;320;824;446;1180
411680;201810;1510;4207;1212;3628;125;418;632;1874;757;2292
411690;201810;3379;9212;2619;7875;538;1678;792;2469;1330;4147
411695;201810;626;1938;461;1551;65;236;165;566;230;802
411700;201810;1605;4329;1052;3247;244;827;134;366;378;1193
411705;201810;1745;5729;1505;5281;315;1099;817;3023;1132;4122
411710;201810;1806;4823;1299;3867;361;1136;152;454;513;1590
411720;201810;1034;2588;713;1961;98;291;296;741;394;1032
411721;201810;833;2237;624;1827;129;397;134;390;263;787
411722;201810;693;1956;396;1236;59;221;150;403;209;624
411725;201810;1195;3601;773;2618;183;632;156;541;339;1173
411727;201810;1433;4175;951;3089;283;939;113;353;396;1292
411729;201810;681;1689;453;1262;60;206;152;372;212;578
411730;201810;5139;14378;3847;11682;1081;3397;1208;3617;2289;7014
411740;201810;558;1545;292;930;50;172;59;172;109;344
411745;201810;775;2272;501;1589;63;215;96;250;159;465
411750;201810;4695;12897;3405;10212;490;1614;1592;4477;2082;6091
411760;201810;6829;18942;5323;16113;1882;5961;994;3246;2876;9207
411770;201810;3011;9157;2216;7276;579;2021;271;825;850;2846
411780;201810;2886;8410;2488;7617;680;2173;882;2691;1562;4864
411790;201810;2847;7259;1568;4752;375;1259;204;506;579;1765
411800;201810;948;2723;634;1979;99;309;119;364;218;673
411810;201810;1599;4213;1174;3386;197;627;559;1481;756;2108
411820;201810;10614;32710;8697;28764;2701;9338;2922;9513;5623;18851
411830;201810;591;1479;407;1155;89;278;77;231;166;509
411840;201810;10907;29725;7150;21748;1326;4398;1823;5133;3149;9531
411845;201810;416;1219;211;697;40;160;17;46;57;206
411850;201810;7192;19519;5235;15852;1521;5068;748;2054;2269;7122
411860;201810;752;2237;557;1809;97;349;153;458;250;807
411870;201810;652;2033;442;1490;90;329;95;287;185;616
411880;201810;2000;5364;1479;4435;321;1050;317;935;638;1985
411885;201810;967;2555;726;2123;109;377;260;725;369;1102
411890;201810;1088;3075;748;2329;127;454;52;132;179;586
411900;201810;812;2391;476;1595;120;420;47;157;167;577
411910;201810;991;3116;713;2461;208;765;175;558;383;1323
411915;201810;15553;39595;9642;28338;1734;5616;2891;7612;4625;13228
411920;201810;947;3030;799;2674;206;744;217;694;423;1438
411925;201810;510;1361;338;1035;77;256;104;297;181;553
411930;201810;5061;16428;4368;14994;2006;7488;261;996;2267;8484
411940;201810;3070;9676;2388;7972;614;2097;572;1732;1186;3829
411950;201810;12779;36395;10556;32478;2056;6970;5283;15615;7339;22585
411960;201810;5475;15371;4542;13454;983;3190;1594;4408;2577;7598
411965;201810;430;1222;301;955;51;180;112;331;163;511
411970;201810;974;2390;762;2086;152;396;349;1079;501;1475
411980;201810;1434;3830;1092;3210;275;871;397;1083;672;1954
411990;201810;34271;97109;23534;75157;5032;17745;7610;22871;12642;40616
411995;201810;2722;7204;2077;6174;585;1942;591;1610;1176;3552
412000;201810;2074;4864;1507;3908;74;256;988;2388;1062;2644
412010;201810;629;1988;436;1519;64;253;104;298;168;551
412015;201810;556;1618;465;1442;61;211;258;790;319;1001
412020;201810;434;1247;253;825;38;140;94;295;132;435
412030;201810;653;1902;451;1488;83;284;135;430;218;714
412033;201810;864;2468;608;1902;82;249;229;734;311;983
412035;201810;784;2116;504;1609;78;291;241;721;319;1012
412040;201810;557;1566;356;1130;70;233;56;159;126;392
412050;201810;1704;4461;1185;3474;217;716;285;828;502;1544
412060;201810;6904;21878;5918;19781;1780;6523;1404;4437;3184;10960
412065;201810;610;1738;449;1407;87;278;138;427;225;705
412070;201810;1139;3012;874;2432;133;392;358;961;491;1353
412080;201810;1794;5307;1114;3713;180;633;112;324;292;957
412085;201810;280;755;93;319;12;39;7;20;19;59
412090;201810;5442;14628;4421;12749;1213;3555;1797;5283;3010;8838
412100;201810;1738;4902;1311;4137;404;1377;239;788;643;2165
412110;201810;823;2307;605;1822;109;347;188;553;297;900
412120;201810;1771;5560;1424;4790;301;1116;419;1214;720;2330
412125;201810;652;1998;491;1605;100;329;166;521;266;850
412130;201810;646;1741;447;1321;68;225;108;330;176;555
412135;201810;600;1656;266;810;47;151;87;238;134;389
412140;201810;1536;4008;995;2994;219;766;157;419;376;1185
412150;201810;2828;7676;2363;6821;328;1050;1470;4081;1798;5131
412160;201810;1023;3268;630;2225;142;548;85;285;227;833
412170;201810;4088;11996;3424;10764;804;2683;1360;3965;2164;6648
412175;201810;1305;4098;1106;3706;279;933;405;1372;684;2305
412180;201810;1699;4825;1238;3948;187;714;514;1477;701;2191
412190;201810;3226;8423;2392;6869;348;1118;1035;2945;1383;4063
412200;201810;1788;5518;1250;4168;333;1178;202;639;535;1817
412210;201810;601;1555;342;1034;68;232;93;239;161;471
412215;201810;3677;10011;2985;8664;842;2437;1168;3785;2010;6222
412217;201810;999;2705;844;2449;71;223;569;1588;640;1811
412220;201810;5568;16273;4612;14333;1209;3765;1470;4801;2679;8566
412230;201810;2630;8262;2114;7136;390;1477;572;1669;962;3146
412240;201810;6670;17652;4204;12670;766;2553;1133;3138;1899;5691
412250;201810;1934;5187;1494;4331;398;1171;257;725;655;1896
412260;201810;1190;3337;841;2570;136;413;251;718;387;1131
412265;201810;804;2399;683;2140;138;463;284;857;422;1320
412270;201810;773;2274;520;1688;80;288;200;590;280;878
412280;201810;481;1432;381;1252;92;314;107;337;199;651
412290;201810;965;2494;644;1888;109;328;204;567;313;895
412300;201810;1419;4078;1148;3532;297;957;249;762;546;1719
412310;201810;751;2107;623;1876;54;226;334;970;388;1196
412320;201810;816;2178;565;1683;77;310;198;563;275;873
412330;201810;1408;3868;954;2933;167;533;364;1135;531;1668
412340;201810;979;2883;620;2011;111;393;120;347;231;740
412350;201810;2685;7346;1758;5420;364;1117;348;1097;712;2214
412360;201810;238;666;145;456;16;54;63;184;79;238
412370;201810;747;2235;540;1816;107;415;37;135;144;550
412380;201810;1546;4395;1071;3348;297;967;153;505;450;1472
412382;201810;547;1437;360;1083;58;190;110;287;168;477
412385;201810;2162;6165;1800;5425;623;1841;511;1677;1134;3518
412390;201810;2308;5981;1892;5303;362;1101;849;2347;1211;3448
412395;201810;677;1938;471;1481;56;170;207;622;263;792
412400;201810;885;2507;647;2004;143;465;154;510;297;975
412402;201810;1736;4548;1270;3746;315;1013;151;452;466;1465
412405;201810;3002;8372;1923;6073;449;1621;56;176;505;1797
412410;201810;5132;14190;3737;11548;802;2804;959;2722;1761;5526
412420;201810;461;1227;273;812;26;89;105;272;131;361
412430;201810;535;1415;349;1041;33;113;162;458;195;571
412440;201810;2701;7701;1810;5903;498;1768;299;992;797;2760
412450;201810;347;1065;231;769;40;127;25;62;65;189
412460;201810;922;2587;745;2270;139;466;295;885;434;1351
412470;201810;1602;5293;1300;4551;342;1255;300;1093;642;2348
412480;201810;951;2672;592;1824;102;335;111;285;213;620
412490;201810;1081;2862;889;2480;115;319;456;1227;571;1546
412500;201810;1805;4799;1379;3956;305;896;312;822;617;1718
412510;201810;1942;6086;1363;4559;311;1089;112;325;423;1414
412520;201810;1318;3561;719;2200;159;471;56;163;215;634
412530;201810;647;1762;470;1388;66;221;122;354;188;575
412535;201810;754;2068;528;1586;125;418;103;272;228;690
412540;201810;1217;3316;831;2482;106;393;254;759;360;1152
412545;201810;692;1810;460;1335;76;245;128;340;204;585
412550;201810;29639;83472;20271;63419;4050;13593;6584;18957;10634;32550
412555;201810;237;644;154;461;25;76;35;78;60;154
412560;201810;4839;14535;3538;11404;697;2450;948;2974;1645;5424
412570;201810;3779;10226;2300;7192;515;1728;324;1092;839;2820
412575;201810;917;2502;750;2159;85;278;438;1170;523;1448
412580;201810;1312;3521;907;2726;160;528;398;1147;558;1675
412590;201810;419;1143;215;706;40;144;20;61;60;205
412600;201810;1371;3974;1011;3180;184;672;390;1155;574;1827
412610;201810;764;2117;484;1447;65;206;222;591;287;797
412620;201810;1244;3555;937;2976;188;662;281;814;469;1476
412625;201810;8215;22955;5273;16835;802;2770;502;1708;1304;4478
412627;201810;1007;2903;677;2204;168;617;176;559;344;1176
412630;201810;2824;8416;2044;6625;394;1275;649;1913;1043;3188
412635;201810;332;909;230;679;43;135;63;154;106;289
412640;201810;1027;2878;566;1789;84;303;128;346;212;649
412650;201810;1512;4338;1210;3704;229;803;422;1113;651;1916
412660;201810;2504;6853;1779;5373;320;1071;524;1416;844;2487
412665;201810;539;1327;307;897;55;163;117;316;172;479
412667;201810;1708;4614;1267;3711;196;652;486;1336;682;1988
412670;201810;730;1869;505;1466;86;290;190;527;276;817
412680;201810;1477;4176;934;3065;141;544;355;1017;496;1561
412690;201810;862;2443;624;1928;116;379;179;519;295;898
412700;201810;2036;5583;1623;4899;289;1047;732;2092;1021;3139
412710;201810;5731;17428;4547;14903;982;3532;1324;4003;2306;7535
412720;201810;1238;3734;918;2953;154;506;187;503;341;1009
412730;201810;2035;5790;1143;3749;238;846;181;565;419;1411
412740;201810;1685;4847;1117;3570;209;724;169;563;378;1287
412750;201810;3810;10727;3286;9885;397;1432;2113;6020;2510;7452
412760;201810;2788;7855;2366;7104;367;1209;1340;3859;1707;5068
412770;201810;9766;25593;5131;15924;770;2494;1025;2807;1795;5301
412780;201810;1224;3476;966;2991;209;696;351;1057;560;1753
412785;201810;1994;5226;1393;4101;251;770;697;1988;948;2758
412788;201810;1315;3857;1074;3364;254;808;454;1383;708;2191
412790;201810;1146;3181;646;2076;127;464;189;504;316;968
412795;201810;1245;3344;661;2035;131;428;124;361;255;789
412796;201810;2306;7041;1920;6153;400;1353;630;1879;1030;3232
412800;201810;3331;8552;2240;6383;301;960;931;2389;1232;3349
412810;201810;10490;27413;6244;18422;883;2932;2035;5247;2918;8179
412820;201810;6454;18280;4653;14641;1102;3628;1354;4257;2456;7885
412830;201810;340;982;232;739;38;107;45;140;83;247
412840;201810;1751;4668;1266;3698;180;568;423;1156;603;1724
412850;201810;2875;7851;2156;6545;370;1212;775;2267;1145;3479
412853;201810;1699;4581;1403;3902;165;513;728;1831;893;2344
412855;201810;1152;3177;773;2325;161;543;193;514;354;1057
412860;201810;816;2272;606;1855;111;380;258;754;369;1134
412862;201810;700;1704;458;1279;61;187;209;570;270;757
412863;201810;1170;3679;1084;3531;122;395;781;2550;903;2945
412865;201810;708;2028;521;1661;99;329;179;574;278;903
412870;201810;878;2430;670;2074;206;724;135;438;341;1162
412880;201810;832;2352;533;1692;100;342;75;215;175;557
420005;201810;425;1303;233;837;35;127;94;340;129;467
420010;201810;3507;8875;2335;6778;221;707;1604;4653;1825;5360
420020;201810;487;1519;290;1003;50;199;45;125;95;324
420030;201810;118;372;77;301;20;94;13;49;33;143
420040;201810;581;1821;332;1235;53;216;17;46;70;262
420050;201810;633;1567;409;1163;52;165;249;669;301;834
420055;201810;155;470;79;283;14;63;24;81;38;144
420060;201810;120;358;76;251;13;51;17;38;30;89
420070;201810;851;2713;632;2181;134;488;216;712;350;1200
420075;201810;82;221;42;130;9;23;10;23;19;46
420080;201810;370;1123;291;958;91;307;89;282;180;589
420090;201810;394;1310;249;927;61;229;48;187;109;416
420100;201810;1103;3133;964;2926;59;197;767;2300;826;2497
420110;201810;243;810;220;763;47;177;85;274;132;451
420120;201810;378;1127;261;869;58;221;99;289;157;510
420125;201810;319;1058;255;922;64;264;114;394;178;658
420127;201810;285;819;101;357;18;70;22;71;40;141
420130;201810;1986;6035;1491;5028;315;1234;592;1797;907;3031
420140;201810;3227;9113;2362;7526;639;2334;309;913;948;3247
420150;201810;556;1459;342;1092;62;209;149;447;211;656
420160;201810;240;611;108;338;14;51;38;110;52;161
420165;201810;154;464;94;319;24;84;28;87;52;171
420170;201810;248;758;150;518;24;85;28;86;52;171
420180;201810;199;623;117;422;13;46;36;119;49;165
420190;201810;159;534;96;369;35;142;15;54;50;196
420195;201810;1257;3472;942;2936;269;948;114;300;383;1248
420200;201810;3247;8868;1870;6009;321;1268;607;1675;928;2943
420205;201810;1229;3507;901;2904;153;522;491;1605;644;2127
420207;201810;1536;4233;985;3159;217;810;349;1048;566;1858
420208;201810;376;1053;209;753;36;160;83;285;119;445
420209;201810;144;495;93;337;27;118;33;104;60;222
420210;201810;2309;6315;1497;4958;342;1259;612;1928;954;3187
420213;201810;767;2505;658;2280;169;642;293;987;462;1629
420215;201810;223;682;155;529;45;155;29;86;74;241
420220;201810;204;644;130;476;31;132;49;155;80;287
420230;201810;3949;11271;2994;9476;439;1557;1531;4671;1970;6228
420240;201810;10844;30132;6909;21576;931;3397;3531;9783;4462;13180
420243;201810;386;1143;305;979;56;197;159;484;215;681
420245;201810;1215;3358;846;2660;88;345;468;1388;556;1733
420250;201810;425;1274;366;1153;81;292;186;539;267;831
420253;201810;508;1305;368;1093;29;96;191;547;220;643
420257;201810;189;499;113;359;22;74;54;164;76;238
420260;201810;1057;3036;777;2594;126;478;426;1384;552;1862
420270;201810;452;1232;214;661;17;54;81;241;98;295
420280;201810;1344;3730;858;2810;179;645;237;748;416;1393
420285;201810;103;285;55;186;8;34;8;18;16;52
420287;201810;439;1124;299;896;89;285;91;263;180;548
420290;201810;3840;11307;2927;9255;511;1816;1355;3871;1866;5687
420300;201810;6267;18097;3669;12054;780;2903;946;2719;1726;5622
420310;201810;856;2070;409;1152;82;240;195;498;277;738
420315;201810;821;2514;579;1992;145;550;197;652;342;1202
420320;201810;3975;11806;3151;10278;1006;3576;707;2120;1713;5696
420325;201810;246;761;183;635;47;151;55;186;102;337
420330;201810;838;2611;560;1957;126;482;177;555;303;1037
420340;201810;961;2874;687;2296;148;514;56;174;204;688
420350;201810;1354;3707;943;2895;124;419;563;1705;687;2124
420360;201810;2470;7213;1340;4591;263;958;134;456;397;1414
420370;201810;1157;3252;919;2832;120;449;607;1794;727;2243
420380;201810;4798;13314;3105;9948;702;2390;970;2958;1672;5348
420390;201810;1055;2647;699;1900;113;352;313;627;426;979
420395;201810;974;2904;637;2161;89;318;75;228;164;546
420400;201810;892;2676;578;1948;116;440;159;517;275;957
420410;201810;520;1484;395;1232;45;189;249;727;294;916
420415;201810;306;943;227;766;73;265;67;232;140;497
420417;201810;628;1944;506;1668;118;399;182;612;300;1011
420419;201810;159;581;126;488;44;187;9;29;53;216
420420;201810;10153;28005;7049;22189;2418;8315;1572;4550;3990;12865
420425;201810;714;1913;493;1500;47;176;230;672;277;848
420430;201810;3097;8879;1922;6182;455;1567;545;1533;1000;3100
420435;201810;284;762;126;430;23;96;52;165;75;261
420440;201810;697;2086;406;1365;127;465;103;299;230;764
420445;201810;311;841;185;569;41;134;54;148;95;282
420450;201810;632;1938;459;1539;89;364;145;430;234;794
420455;201810;1921;5061;1426;4230;201;662;722;2051;923;2713
420460;201810;8325;23231;6228;19312;1126;3975;2883;8411;4009;12386
420470;201810;591;1639;342;1127;64;239;87;252;151;491
420475;201810;38;117;29;96;10;30;4;15;14;45
420480;201810;4751;12595;3143;9750;666;2246;995;2980;1661;5226
420490;201810;411;1189;252;865;65;253;70;233;135;486
420500;201810;1273;3833;914;3108;188;668;329;1087;517;1755
420510;201810;167;496;91;310;16;58;25;83;41;141
420515;201810;52;144;36;109;5;15;14;41;19;56
420517;201810;747;2084;654;1921;54;156;490;1434;544;1590
420519;201810;316;791;204;615;27;94;82;248;109;342
420520;201810;377;1020;159;566;20;62;12;43;32;105
420530;201810;856;2554;589;1958;129;492;170;482;299;974
420535;201810;199;565;90;304;21;72;20;75;41;147
420540;201810;25952;65451;16728;48433;2992;9588;5900;14880;8892;24468
420543;201810;231;678;178;555;24;78;93;281;117;359
420545;201810;1129;3468;878;2905;205;712;317;1030;522;1742
420550;201810;3369;9782;2249;7655;483;1798;880;3017;1363;4815
420555;201810;287;860;198;665;42;154;92;286;134;440
420560;201810;418;1108;299;913;67;202;159;487;226;689
420570;201810;2038;6004;1546;4999;327;1172;574;1727;901;2899
420580;201810;1620;4343;1203;3687;261;856;555;1671;816;2527
420590;201810;2895;8076;1710;5402;344;1247;384;911;728;2158
420600;201810;936;2892;728;2455;149;572;314;1007;463;1579
420610;201810;335;1021;198;690;49;177;49;169;98;346
420620;201810;499;1393;393;1203;113;365;130;396;243;761
420630;201810;848;2555;621;1991;133;474;277;785;410;1259
420640;201810;511;1481;246;874;64;234;22;57;86;291
420650;201810;2777;7850;1632;5293;267;933;602;1693;869;2626
420660;201810;347;993;239;767;62;214;57;175;119;389
420665;201810;511;1405;325;1059;59;218;127;369;186;587
420670;201810;1411;3985;941;3070;167;677;339;966;506;1643
420675;201810;136;402;85;297;24;101;16;40;40;141
420680;201810;322;789;181;574;32;106;85;263;117;369
420690;201810;777;2447;495;1719;76;287;110;306;186;593
420700;201810;2704;7589;2095;6479;334;1169;1022;3006;1356;4175
420710;201810;658;2022;513;1704;84;343;254;740;338;1083
420720;201810;1308;3681;952;3121;242;780;399;1284;641;2064
420730;201810;2695;7437;2092;6462;369;1211;1119;3340;1488;4551
420740;201810;651;1996;409;1464;115;437;51;198;166;635
420750;201810;1740;5299;1153;3896;212;814;434;1320;646;2134
420757;201810;63;156;22;89;5;22;8;31;13;53
420760;201810;364;1108;153;506;41;140;19;63;60;203
420765;201810;406;1305;224;797;35;131;80;277;115;408
420768;201810;1174;3660;1004;3325;203;663;642;2139;845;2802
420770;201810;489;1368;226;824;45;183;76;258;121;441
420775;201810;417;1243;251;867;58;223;44;125;102;348
420780;201810;975;2848;571;1946;121;430;128;398;249;828
420785;201810;188;514;135;403;23;70;46;119;69;189
420790;201810;953;3109;735;2650;171;687;338;1147;509;1834
420800;201810;729;1911;339;1086;89;287;72;237;161;524
420810;201810;1448;4886;1180;4271;370;1498;285;888;655;2386
420820;201810;9353;24796;6440;19906;1435;4958;2618;7270;4053;12228
420830;201810;2960;8473;2272;7187;533;1834;832;2548;1365;4382
420840;201810;589;1760;257;933;63;229;47;169;110;398
420845;201810;1778;4795;1035;3444;214;785;338;1110;552;1895
420850;201810;1065;3588;661;2477;158;651;95;301;253;952
420860;201810;264;704;157;507;42;155;33;94;75;249
420870;201810;804;2245;641;1969;185;664;269;766;454;1430
420880;201810;870;2759;682;2339;149;560;213;652;362;1212
420890;201810;7517;20567;4108;13405;679;2459;1129;3103;1808;5562
420895;201810;161;483;92;298;31;109;27;79;58;188
420900;201810;1392;3624;831;2598;125;480;346;944;471;1424
420910;201810;23774;65914;15211;48866;2624;9411;5503;15912;8127;25323
420915;201810;542;2024;368;1489;63;256;168;677;231;933
420917;201810;337;920;174;511;30;100;72;201;102;301
420920;201810;87;251;33;123;4;17;3;10;7;27
420930;201810;16948;45691;12165;37248;2202;7376;5479;15908;7681;23284
420940;201810;2286;6031;1436;4484;354;1201;176;437;530;1638
420945;201810;136;412;100;320;31;116;30;79;61;195
420950;201810;323;984;188;649;30;116;58;175;88;291
420960;201810;926;2450;635;1894;112;387;254;680;366;1067
420970;201810;2489;7365;1687;5693;463;1617;263;943;726;2560
420980;201810;312;982;250;888;124;438;71;281;195;719
420985;201810;307;921;158;564;29;116;52;161;81;277
420990;201810;408;1237;209;760;48;177;33;101;81;278
421000;201810;466;1560;312;1150;74;297;67;197;141;494
421003;201810;468;1134;152;475;17;53;25;71;42;124
421005;201810;54;188;48;178;14;56;18;68;32;124
421010;201810;3547;9964;2509;8067;544;1909;564;1612;1108;3521
421020;201810;366;1127;289;989;22;89;196;674;218;763
421030;201810;722;2297;563;1939;175;662;153;474;328;1136
421040;201810;696;1680;426;1256;42;143;262;751;304;894
421050;201810;1146;3295;713;2289;144;497;237;690;381;1187
421055;201810;170;469;84;265;15;55;29;73;44;128
421060;201810;547;1676;362;1202;66;248;138;422;204;670
421070;201810;498;1553;284;1011;62;230;42;145;104;375
421080;201810;660;2664;607;2577;62;199;456;2112;518;2311
421085;201810;380;1134;150;562;24;97;23;74;47;171
421090;201810;298;804;167;523;21;69;51;155;72;224
421100;201810;903;2136;395;1191;91;305;49;133;140;438
421105;201810;1343;3792;1084;3408;169;523;618;2000;787;2523
421110;201810;1013;3010;858;2760;50;153;603;2007;653;2160
421120;201810;914;2973;635;2284;91;380;198;636;289;1016
421125;201810;255;711;206;632;69;233;71;175;140;408
421130;201810;3734;11492;3182;10441;752;2710;1663;5288;2415;7998
421140;201810;276;788;182;597;41;136;56;165;97;301
421145;201810;455;1313;266;863;54;197;118;357;172;554
421150;201810;492;1364;295;1005;58;227;106;342;164;569
421160;201810;712;1890;404;1271;61;215;216;651;277;866
421165;201810;197;613;134;463;30;103;55;189;85;292
421170;201810;1062;2918;841;2563;139;415;526;1626;665;2041
421175;201810;1033;2750;680;2162;133;503;263;737;396;1240
421180;201810;378;1003;188;619;43;174;47;148;90;322
421185;201810;316;841;214;635;32;94;117;343;149;437
421187;201810;329;971;207;663;35;112;75;221;110;333
421189;201810;349;1065;261;871;50;171;83;262;133;433
421190;201810;9488;26344;6006;19674;1293;4639;1390;4300;2683;8939
421200;201810;656;2022;537;1774;94;330;256;802;350;1132
421205;201810;181;519;141;454;30;110;68;205;98;315
421210;201810;1044;2838;663;2135;170;555;221;709;391;1264
421220;201810;1278;4126;1049;3592;250;953;231;688;481;1641
421223;201810;374;1097;249;845;59;193;106;362;165;555
421225;201810;897;2801;781;2570;163;579;423;1400;586;1979
421227;201810;957;2585;572;1812;101;354;265;834;366;1188
421230;201810;557;1525;353;1143;100;355;110;346;210;701
421240;201810;306;941;121;454;13;65;15;56;28;121
421250;201810;1498;4034;987;3153;174;620;394;1204;568;1824
421260;201810;191;539;45;162;10;36;7;27;17;63
421265;201810;643;1915;592;1842;35;128;507;1574;542;1702
421270;201810;420;1105;188;671;33;117;73;254;106;371
421280;201810;1493;4500;1147;3849;252;988;489;1526;741;2514
421290;201810;756;2132;434;1382;81;267;87;266;168;533
421300;201810;217;613;138;449;25;92;46;143;71;235
421310;201810;169;534;136;452;19;68;62;204;81;272
421315;201810;205;617;130;438;35;115;24;84;59;199
421320;201810;630;1870;328;1091;50;174;49;110;99;284
421330;201810;599;1819;435;1486;101;379;117;369;218;748
421335;201810;343;1100;277;967;53;218;103;341;156;559
421340;201810;1266;3717;950;3117;204;729;402;1284;606;2013
421350;201810;1132;3258;816;2656;151;573;356;1067;507;1640
421360;201810;2198;6262;1349;4504;310;1213;452;1320;762;2533
421370;201810;474;1576;286;1064;70;288;59;192;129;480
421380;201810;772;2202;679;2021;110;362;397;1137;507;1499
421390;201810;173;469;62;208;10;29;19;55;29;84
421400;201810;253;863;173;667;38;170;78;271;116;441
421410;201810;251;699;108;392;15;55;42;153;57;208
421415;201810;271;829;134;447;34;116;28;83;62;199
421420;201810;511;1514;434;1360;72;249;245;725;317;974
421430;201810;128;434;98;357;14;54;31;103;45;157
421440;201810;615;1658;394;1286;84;272;188;625;272;897
421450;201810;358;1082;227;767;35;141;41;151;76;292
421460;201810;357;1032;221;761;48;172;58;178;106;350
421470;201810;221;713;144;522;34;150;47;167;81;317
421480;201810;2633;7229;1704;5491;444;1601;486;1382;930;2983
421490;201810;121;369;71;244;12;49;17;44;29;93
421500;201810;1995;6163;1398;4891;391;1531;291;922;682;2453
421505;201810;306;925;266;854;43;156;151;461;194;617
421507;201810;381;1163;229;797;69;262;67;220;136;482
421510;201810;243;709;144;463;34;107;63;186;97;293
421520;201810;526;1428;335;998;45;161;180;484;225;645
421530;201810;307;982;186;668;37;168;40;114;77;282
421535;201810;409;1164;262;874;36;137;135;418;171;555
421540;201810;204;532;127;402;18;69;48;138;66;207
421545;201810;683;2058;499;1685;96;358;214;705;310;1063
421550;201810;1920;5623;1600;5100;375;1291;765;2355;1140;3646
421555;201810;190;586;63;232;10;41;9;22;19;63
421560;201810;88;286;52;197;12;49;14;51;26;100
421565;201810;836;2273;604;1888;144;495;202;648;346;1143
421567;201810;478;1692;317;1198;147;570;53;180;200;750
421568;201810;359;1090;248;831;34;128;105;332;139;460
421569;201810;187;564;69;251;20;71;23;90;43;161
421570;201810;969;2745;652;2121;179;634;138;417;317;1051
421575;201810;295;914;255;798;52;197;107;282;159;479
421580;201810;2824;8431;1936;6513;410;1587;608;1751;1018;3338
421590;201810;136;450;109;376;31;112;29;88;60;200
421600;201810;497;1409;340;1060;78;258;84;221;162;479
421605;201810;710;1923;481;1516;98;302;159;494;257;796
421610;201810;1087;3023;676;2193;140;471;153;486;293;957
421620;201810;3702;10516;2183;7530;567;2130;542;1807;1109;3937
421625;201810;218;593;87;283;23;70;12;32;35;102
421630;201810;2454;6854;1405;4512;245;913;336;931;581;1844
421635;201810;214;608;141;435;17;57;69;186;86;243
421640;201810;709;1972;482;1570;98;328;136;445;234;773
421650;201810;2078;6054;1340;4543;316;1221;292;809;608;2030
421660;201810;7019;21262;5498;18201;987;3697;2148;6532;3135;10229
421670;201810;785;2301;551;1756;129;484;234;700;363;1184
421680;201810;879;2722;685;2310;199;725;248;762;447;1487
421690;201810;1165;3597;827;2817;179;691;232;762;411;1453
421700;201810;439;1378;223;802;45;187;53;154;98;341
421710;201810;197;636;90;316;22;84;26;84;48;168
421715;201810;104;300;75;231;18;58;50;146;68;204
421720;201810;1869;5271;1067;3559;297;1080;266;776;563;1856
421725;201810;186;473;103;316;27;92;39;92;66;184
421730;201810;331;1017;191;619;31;110;77;221;108;331
421740;201810;605;1806;420;1382;119;423;100;299;219;722
421750;201810;815;1976;420;1261;85;276;164;453;249;729
421755;201810;168;481;95;304;15;57;42;118;57;175
421760;201810;836;2393;491;1670;86;327;138;381;224;708
421770;201810;2160;5995;1589;4985;413;1288;542;1856;955;3144
421775;201810;235;640;146;456;26;91;66;182;92;273
421780;201810;756;2437;516;1898;116;459;176;615;292;1074
421790;201810;620;1602;363;1188;86;303;181;569;267;872
421795;201810;222;665;135;429;20;73;54;152;74;225
421800;201810;2305;6721;1736;5660;346;1237;832;2589;1178;3826
421810;201810;606;1705;424;1343;60;228;226;668;286;896
421820;201810;780;2320;416;1430;93;341;82;254;175;595
421825;201810;1285;3769;1179;3601;148;514;824;2437;972;2951
421830;201810;2008;6508;1725;5953;399;1495;636;2070;1035;3565
421835;201810;211;576;121;406;15;69;53;154;68;223
421840;201810;219;699;146;531;40;153;30;98;70;251
421850;201810;370;1120;209;734;37;154;58;150;95;304
421860;201810;271;833;182;637;25;116;58;158;83;274
421870;201810;3156;8421;2202;6583;506;1706;870;2371;1376;4077
421875;201810;218;660;106;380;20;76;22;58;42;134
421880;201810;471;1349;360;1155;111;422;73;237;184;659
421885;201810;188;550;130;447;39;136;25;71;64;207
421890;201810;748;2433;601;2135;134;526;257;835;391;1361
421895;201810;342;1003;311;957;41;147;209;639;250;786
421900;201810;925;2442;654;1926;108;360;306;815;414;1175
421910;201810;313;968;218;752;51;208;41;108;92;316
421915;201810;381;1092;203;669;43;142;25;76;68;218
421917;201810;547;1474;347;1184;125;472;68;227;193;699
421920;201810;504;1472;324;1157;152;561;94;345;246;906
421930;201810;2195;5945;1066;3636;303;1117;151;482;454;1599
421935;201810;425;1406;340;1209;68;249;176;597;244;846
421940;201810;299;938;123;439;27;114;32;104;59;218
421950;201810;2948;7563;1449;4638;309;1083;301;853;610;1936
421960;201810;153;403;101;322;20;80;22;62;42;142
421970;201810;1942;5182;1064;3360;233;771;290;793;523;1564
421985;201810;282;740;162;490;15;57;58;181;73;238
422000;201810;1574;4468;1317;3997;187;664;805;2409;992;3073
430003;201810;509;1499;353;1201;76;287;128;424;204;711
430005;201810;263;739;165;550;49;164;63;204;112;368
430010;201810;1642;4363;1298;3742;193;617;809;2248;1002;2865
430020;201810;588;1417;453;1230;77;246;259;648;336;894
430030;201810;1015;2507;580;1701;177;531;161;445;338;976
430040;201810;9404;23985;5664;16895;1506;4952;374;1172;1880;6124
430045;201810;555;1451;370;1081;39;122;205;558;244;680
430047;201810;250;566;102;305;23;73;26;76;49;149
430050;201810;921;2435;508;1542;115;378;109;308;224;686
430055;201810;272;693;114;351;15;50;55;156;70;206
430057;201810;95;217;32;91;7;26;8;19;15;45
430060;201810;15571;45124;12542;40114;3243;11088;5145;16378;8388;27466
430063;201810;872;2483;680;2055;128;389;374;1121;502;1510
430064;201810;970;2819;723;2255;214;706;210;637;424;1343
430066;201810;112;258;78;203;4;15;57;133;61;148
430070;201810;707;1815;105;351;10;36;10;21;20;57
430080;201810;743;1967;442;1346;88;285;188;510;276;795
430085;201810;865;2085;501;1448;84;255;198;549;282;804
430087;201810;543;1571;451;1432;96;312;242;771;338;1083
430090;201810;594;1570;196;642;20;82;59;191;79;273
430100;201810;570;1459;317;968;59;192;117;325;176;517
430105;201810;983;2727;638;2128;117;441;289;965;406;1406
430107;201810;176;535;121;402;20;69;28;77;48;146
430110;201810;2046;5221;1492;4380;263;810;822;2346;1085;3156
430120;201810;1367;4206;851;2846;170;594;369;1252;539;1846
430130;201810;3749;9904;2958;8745;1049;2864;873;3231;1922;6095
430140;201810;925;2742;613;2044;174;573;222;754;396;1327
430150;201810;566;1484;312;973;66;216;93;281;159;497
430155;201810;261;669;127;400;22;75;30;81;52;156
430160;201810;17255;44618;13931;39519;3018;9084;6019;17365;9037;26449
430163;201810;2345;6058;1687;5005;165;573;1067;3119;1232;3692
430165;201810;394;930;81;265;12;35;9;21;21;56
430170;201810;891;2444;313;1099;64;224;61;194;125;418
430175;201810;663;2073;542;1788;132;417;261;858;393;1275
430180;201810;672;1757;533;1504;83;262;349;939;432;1201
430185;201810;454;1118;278;784;45;136;134;345;179;481
430187;201810;658;1698;464;1384;79;254;224;658;303;912
430190;201810;1387;3957;1146;3509;274;885;501;1487;775;2372
430192;201810;120;358;49;153;7;23;12;33;19;56
430195;201810;387;1167;62;222;9;31;7;22;16;53
430200;201810;1030;3278;884;2981;293;1061;251;847;544;1908
430205;201810;496;1348;397;1142;18;66;319;880;337;946
430210;201810;4973;12647;3425;9540;616;1877;1298;2918;1914;4795
430215;201810;305;826;194;582;39;128;73;211;112;339
430220;201810;652;1642;167;580;31;122;36;113;67;235
430222;201810;183;539;150;471;22;70;63;183;85;253
430223;201810;253;704;211;622;37;117;112;315;149;432
430225;201810;15;36;13;32;2;3;9;16;11;19
430230;201810;1619;4751;1489;4569;192;547;1132;3546;1324;4093
430235;201810;246;752;180;591;36;125;55;166;91;291
430237;201810;545;1344;363;1021;24;82;245;651;269;733
430240;201810;1145;2607;676;1871;70;235;387;1022;457;1257
430245;201810;702;2150;538;1796;177;590;232;792;409;1382
430250;201810;965;2606;768;2298;223;727;37;91;260;818
430258;201810;118;337;89;281;8;25;42;132;50;157
430260;201810;624;1707;448;1352;80;251;227;672;307;923
430265;201810;194;582;143;489;28;102;39;131;67;233
430270;201810;2696;7080;2179;6245;285;923;1452;4028;1737;4951
430280;201810;4722;11793;3404;9430;736;2152;1397;3826;2133;5978
430290;201810;2112;5226;1863;4883;70;213;1602;4131;1672;4344
430300;201810;8486;23319;6711;19958;1330;4285;3245;9449;4575;13734
430310;201810;9059;23798;6075;17903;947;3205;2838;7756;3785;10961
430320;201810;917;2526;508;1616;81;219;257;865;338;1084
430330;201810;598;1538;398;1122;83;266;188;461;271;727
430340;201810;662;1545;347;1032;73;232;181;518;254;750
430350;201810;5824;16533;4596;14023;1127;3525;1979;5908;3106;9433
430355;201810;321;834;109;359;27;87;11;37;38;124
430360;201810;741;1914;530;1530;115;377;186;480;301;857
430367;201810;324;810;165;500;46;155;51;152;97;307
430370;201810;492;1372;229;750;51;175;58;166;109;341
430380;201810;694;1768;357;1139;82;298;72;234;154;532
430390;201810;3032;7617;1631;4907;298;973;125;295;423;1268
430400;201810;1099;2440;825;2024;94;239;579;1354;673;1593
430410;201810;564;1427;391;1126;62;205;218;595;280;800
430420;201810;2762;7850;2103;6352;664;2087;700;2014;1364;4101
430430;201810;653;1718;314;987;75;237;64;204;139;441
430435;201810;1521;3992;1147;3355;278;878;464;1333;742;2211
430440;201810;3614;10558;2696;8636;517;1777;1372;4365;1889;6142
430450;201810;6389;16903;5191;14737;759;2440;2948;8152;3707;10592
430460;201810;27340;73509;19572;60370;4298;14772;8155;23753;12453;38525
430461;201810;419;1071;119;375;23;71;29;82;52;153
430462;201810;242;669;147;487;18;64;50;178;68;242
430463;201810;4548;13160;3622;11495;707;2451;1815;5667;2522;8118
430465;201810;472;1287;388;1111;66;203;233;646;299;849
430466;201810;3788;9778;3033;8495;785;2313;1382;3655;2167;5968
430467;201810;484;1249;348;1013;55;202;167;452;222;654
430468;201810;1296;3330;1041;2938;150;458;615;1709;765;2167
430469;201810;642;1805;75;256;11;34;11;19;22;53
430470;201810;5537;15097;3908;12105;1296;4281;862;2597;2158;6878
430471;201810;490;1525;423;1371;76;237;204;642;280;879
430480;201810;838;2231;416;1329;67;226;75;199;142;425
430485;201810;156;432;57;192;8;25;11;38;19;63
430490;201810;411;1102;228;695;35;122;101;287;136;409
430495;201810;360;1021;220;724;34;116;82;247;116;363
430500;201810;1039;2763;745;2249;224;734;234;639;458;1373
430510;201810;22526;61048;16187;48041;3555;11640;6248;16953;9803;28593
430511;201810;319;945;115;402;16;53;15;44;31;97
430512;201810;891;2164;715;1878;184;495;224;606;408;1101
430513;201810;780;1991;369;1065;73;218;159;437;232;655
430515;201810;391;1111;274;863;44;126;131;421;175;547
430517;201810;893;2830;745;2527;136;468;380;1341;516;1809
430520;201810;1313;3501;685;2140;138;430;128;360;266;790
430530;201810;1057;2713;371;1136;76;225;84;251;160;476
430535;201810;2891;7897;2042;6246;334;1058;975;2941;1309;3999
430537;201810;329;1191;296;1080;34;111;223;824;257;935
430540;201810;569;1375;332;992;55;166;154;443;209;609
430543;201810;639;1276;398;991;64;140;226;600;290;740
430544;201810;630;1921;449;1482;102;365;210;659;312;1024
430545;201810;1779;4982;1374;4364;291;961;671;2189;962;3150
430550;201810;423;1218;249;810;47;155;70;214;117;369
430558;201810;112;260;52;148;10;28;17;45;27;73
430560;201810;348;799;145;442;13;45;46;131;59;176
430570;201810;834;1991;586;1576;88;280;351;866;439;1146
430580;201810;1043;2543;671;1953;157;506;276;760;433;1266
430583;201810;190;470;36;109;2;7;5;15;7;22
430585;201810;225;556;122;340;15;39;59;145;74;184
430587;201810;185;553;139;450;24;75;51;168;75;243
430590;201810;1403;3448;1213;3143;62;205;1047;2648;1109;2853
430593;201810;13;46;12;42;2;8;8;26;10;34
430595;201810;409;992;89;306;7;31;18;49;25;80
430597;201810;351;980;219;669;24;77;78;181;102;258
430600;201810;1760;4688;819;2499;152;480;226;653;378;1133
430605;201810;1087;3169;826;2618;126;479;314;934;440;1413
430607;201810;621;1421;454;1165;33;88;313;814;346;902
430610;201810;5493;14019;3855;11383;1097;3517;632;1970;1729;5487
430613;201810;265;635;82;250;10;32;19;47;29;79
430620;201810;551;1493;442;1274;99;316;201;549;300;865
430630;201810;431;1239;121;390;15;50;26;66;41;116
430632;201810;539;1484;244;757;34;113;108;315;142;428
430635;201810;525;1429;390;1147;68;213;253;729;321;942
430637;201810;447;1175;353;1015;44;144;201;542;245;686
430640;201810;1161;3021;642;1935;101;307;206;568;307;875
430642;201810;367;1002;261;770;45;128;133;383;178;511
430645;201810;239;515;80;207;16;40;14;38;30;78
430650;201810;1527;4735;1286;4292;339;1156;604;2056;943;3212
430655;201810;228;553;134;370;14;43;71;178;85;221
430660;201810;4599;12512;3554;10637;817;2694;1605;4717;2422;7411
430670;201810;571;1481;437;1238;42;140;280;797;322;937
430673;201810;573;1358;224;683;45;141;74;218;119;359
430675;201810;212;629;60;212;19;77;12;37;31;114
430676;201810;4165;11014;3228;9441;515;1608;1774;5074;2289;6682
430680;201810;966;2627;580;1835;162;502;141;429;303;931
430690;201810;3087;8704;2509;7618;789;2479;674;1988;1463;4467
430692;201810;198;634;156;565;14;44;107;401;121;445
430693;201810;1017;2708;578;1765;118;424;122;315;240;739
430695;201810;509;1263;301;864;36;104;165;449;201;553
430697;201810;387;1006;285;835;59;172;143;440;202;612
430700;201810;6886;17585;3675;11551;890;3003;367;1143;1257;4146
430705;201810;362;932;178;559;28;96;68;198;96;294
430710;201810;1671;3813;1176;3080;193;574;626;1592;819;2166
430720;201810;709;1744;380;1163;61;178;159;479;220;657
430730;201810;1155;3121;771;2391;125;375;374;1172;499;1547
430740;201810;589;1659;308;1026;51;181;89;311;140;492
430745;201810;450;1273;236;768;39;141;59;172;98;313
430750;201810;1347;3589;956;2893;192;631;504;1455;696;2086
430755;201810;471;1168;291;794;23;70;161;403;184;473
430760;201810;1985;5165;1521;4415;382;1143;635;1814;1017;2957
430770;201810;6054;15776;4599;13461;741;2416;2721;7661;3462;10077
430780;201810;2030;5232;1183;3753;235;776;362;1233;597;2009
430781;201810;388;1116;224;740;55;187;47;133;102;320
430783;201810;434;1034;246;719;24;81;133;372;157;453
430786;201810;40;139;24;94;5;21;2;9;7;30
430790;201810;4323;11325;2974;8757;503;1636;1549;4260;2052;5896
430800;201810;753;1922;547;1528;55;180;341;925;396;1105
430805;201810;458;1262;270;826;27;92;157;445;184;537
430807;201810;325;808;211;612;20;74;114;308;134;382
430810;201810;829;2061;269;873;40;148;72;204;112;352
430820;201810;1286;3502;689;2296;157;536;147;495;304;1031
430825;201810;285;745;91;256;18;48;20;49;38;97
430830;201810;1558;4698;1324;4252;89;347;913;2913;1002;3260
430840;201810;848;2393;713;2149;140;439;424;1261;564;1700
430843;201810;110;266;34;104;5;14;15;40;20;54
430845;201810;352;894;242;699;79;244;64;155;143;399
430850;201810;2211;6075;1673;5018;325;1036;780;2307;1105;3343
430860;201810;853;1963;432;1253;80;275;189;490;269;765
430865;201810;512;1350;424;1199;93;272;197;526;290;798
430870;201810;653;1747;287;911;47;161;93;259;140;420
430880;201810;1191;2897;792;2264;194;586;338;945;532;1531
430885;201810;220;525;97;314;8;34;54;164;62;198
430890;201810;1024;2778;687;2110;53;252;121;334;174;586
430900;201810;2933;6841;1985;5383;224;719;1164;2956;1388;3675
430905;201810;799;2143;502;1532;99;335;169;490;268;825
430910;201810;1377;3813;933;2885;176;609;385;1071;561;1680
430912;201810;480;1352;324;1049;34;107;206;679;240;786
430915;201810;502;1569;371;1316;100;362;121;448;221;810
430920;201810;21806;57346;16874;49141;2611;8381;9718;27471;12329;35852
430925;201810;136;307;50;145;8;25;19;57;27;82
430930;201810;9796;23645;5895;17478;1434;4581;1923;5881;3357;10462
430940;201810;1161;3365;639;2064;201;693;75;190;276;883
430950;201810;700;1768;439;1266;77;251;232;606;309;857
430955;201810;217;583;65;197;17;52;14;32;31;84
430957;201810;187;648;173;617;34;124;89;309;123;433
430960;201810;1257;3025;796;2231;164;511;389;1064;553;1575
430965;201810;1688;4203;1278;3535;75;236;957;2595;1032;2831
430970;201810;370;968;188;587;29;101;96;287;125;388
430975;201810;468;1486;364;1227;89;320;147;483;236;803
430980;201810;411;1016;225;679;40;126;90;259;130;385
430990;201810;545;1601;320;1027;42;153;158;498;200;651
430995;201810;572;1529;407;1231;65;197;194;576;259;773
431000;201810;1324;3162;541;1585;92;298;33;80;125;378
431010;201810;2080;5603;1214;3966;198;740;125;344;323;1084
431020;201810;8272;18935;5077;13810;1209;3572;1592;3908;2801;7480
431030;201810;317;886;140;493;25;93;22;77;47;170
431033;201810;3037;8039;2025;6392;516;1632;685;2366;1201;3998
431036;201810;356;785;73;217;12;28;16;45;28;73
431040;201810;928;2459;598;1822;96;349;262;734;358;1083
431041;201810;460;1084;351;920;41;110;218;549;259;659
431043;201810;409;1010;219;678;73;237;71;215;144;452
431046;201810;114;303;48;144;4;10;10;29;14;39
431050;201810;1426;3593;1023;2949;197;578;528;1529;725;2107
431053;201810;503;1453;322;1060;75;260;99;310;174;570
431055;201810;609;1542;524;1408;46;109;393;1043;439;1152
431057;201810;280;821;128;440;19;67;34;105;53;172
431060;201810;4785;13564;3596;11331;1045;3568;717;2369;1762;5937
431065;201810;492;1323;325;1013;67;211;96;297;163;508
431070;201810;451;1345;254;863;72;270;32;92;104;362
431075;201810;219;672;146;498;27;96;42;142;69;238
431080;201810;603;1693;419;1316;90;303;120;360;210;663
431085;201810;685;1876;486;1410;80;221;258;730;338;951
431087;201810;458;1328;365;1117;30;88;253;793;283;881
431090;201810;408;974;146;472;28;98;37;115;65;213
431100;201810;3095;7318;2276;6172;400;1166;1055;2837;1455;4003
431110;201810;1347;3229;962;2556;224;611;440;1094;664;1705
431112;201810;509;1579;436;1427;92;317;209;655;301;972
431113;201810;363;1044;306;929;85;271;138;415;223;686
431115;201810;1102;3187;867;2746;151;519;476;1450;627;1969
431120;201810;2308;6727;1633;5314;549;1997;377;1114;926;3111
431123;201810;386;1102;240;785;56;162;114;396;170;558
431125;201810;1090;3299;801;2655;310;1007;225;802;535;1809
431127;201810;263;702;66;215;10;31;11;26;21;57
431130;201810;3045;8326;2150;6624;462;1550;883;2654;1345;4204
431140;201810;4890;11858;2714;7670;383;1206;1092;2684;1475;3890
431142;201810;483;1339;363;1126;54;164;222;694;276;858
431150;201810;994;2777;697;2179;153;497;266;815;419;1312
431160;201810;663;1921;485;1542;105;329;163;530;268;859
431162;201810;471;1167;215;676;28;109;77;217;105;326
431164;201810;205;482;42;137;10;36;4;15;14;51
431170;201810;530;1462;360;1119;101;304;95;294;196;598
431171;201810;622;1592;521;1451;73;207;339;933;412;1140
431173;201810;397;1099;296;919;105;351;87;261;192;612
431175;201810;998;2528;610;1832;157;478;124;370;281;848
431177;201810;686;2049;526;1769;158;568;232;767;390;1335
431179;201810;345;734;69;205;15;49;17;37;32;86
431180;201810;2146;5659;1306;3984;363;1134;233;707;596;1841
431190;201810;467;1277;240;769;30;94;48;128;78;222
431198;201810;292;932;259;863;93;332;73;258;166;590
431200;201810;379;996;88;284;10;23;1;6;11;29
431205;201810;192;565;87;320;21;75;37;136;58;211
431210;201810;617;1645;503;1472;135;373;241;740;376;1113
431213;201810;243;717;180;603;16;67;95;310;111;377
431215;201810;493;1238;228;702;28;93;95;262;123;355
431217;201810;154;447;105;349;12;44;56;170;68;214
431220;201810;619;1660;352;1109;33;130;178;509;211;639
431225;201810;1447;3659;1100;3039;129;392;687;1882;816;2274
431230;201810;685;2033;493;1523;81;269;278;817;359;1086
431235;201810;135;350;22;68;3;8;2;6;5;14
431237;201810;365;1113;289;964;53;199;150;482;203;681
431238;201810;24;62;20;52;6;14;7;16;13;30
431240;201810;3752;9920;2995;8668;669;2142;1316;3651;1985;5793
431242;201810;316;898;258;784;68;213;114;346;182;559
431244;201810;327;799;150;430;24;92;51;108;75;200
431245;201810;1300;3146;821;2258;111;326;392;1020;503;1346
431247;201810;220;609;106;342;18;62;24;65;42;127
431250;201810;1415;4085;1129;3629;261;814;526;1783;787;2597
431260;201810;221;629;121;424;15;69;43;135;58;204
431261;201810;249;797;198;693;20;75;97;317;117;392
431262;201810;391;1108;170;575;16;52;104;353;120;405
431265;201810;1455;3474;584;1718;96;319;174;424;270;743
431267;201810;255;717;147;444;7;30;100;269;107;299
431270;201810;2580;6155;1380;4044;362;1162;380;1102;742;2264
431275;201810;148;419;75;242;17;59;10;26;27;85
431280;201810;258;720;72;256;7;22;4;10;11;32
431290;201810;297;856;209;673;29;94;69;189;98;283
431295;201810;72;191;25;78;3;13;6;17;9;30
431300;201810;382;959;55;191;6;28;11;30;17;58
431301;201810;221;657;52;187;6;14;4;11;10;25
431303;201810;568;1534;326;996;35;122;119;337;154;459
431306;201810;2075;5037;1234;3580;192;648;465;1193;657;1841
431308;201810;25;84;22;74;13;47;4;11;17;58
431310;201810;560;1612;350;1106;55;187;142;436;197;623
431320;201810;600;1625;273;918;49;162;40;129;89;291
431330;201810;1700;4167;805;2487;224;768;181;507;405;1275
431333;201810;228;634;118;353;14;35;37;103;51;138
431335;201810;38;113;24;82;6;14;4;8;10;22
431337;201810;2550;7045;1777;5646;486;1715;547;1619;1033;3334
431339;201810;441;1149;310;893;75;219;146;420;221;639
431340;201810;19572;49918;13771;39828;2876;9117;4886;13221;7762;22338
431342;201810;465;1087;351;912;27;86;290;733;317;819
431344;201810;381;1002;226;679;13;38;150;435;163;473
431346;201810;261;662;91;292;15;47;19;59;34;106
431349;201810;632;1710;353;1076;68;223;132;369;200;592
431350;201810;3776;10301;2802;8567;541;1806;1274;3846;1815;5652
431360;201810;581;1413;329;949;78;237;112;294;190;531
431365;201810;1720;4513;1451;4092;154;502;1060;2941;1214;3443
431370;201810;4062;10738;3049;8977;779;2447;1284;3867;2063;6314
431380;201810;729;2106;621;1915;50;176;393;1197;443;1373
431390;201810;2379;6072;1377;4132;240;820;504;1340;744;2160
431395;201810;1214;3333;882;2795;233;760;332;1091;565;1851
431400;201810;371;1093;183;594;32;106;45;134;77;240
431402;201810;911;2174;626;1682;96;278;379;966;475;1244
431403;201810;175;480;145;434;21;85;93;248;114;333
431405;201810;4249;11487;3416;10195;433;1499;2067;5964;2500;7463
431406;201810;449;1385;366;1228;101;321;175;606;276;927
431407;201810;445;1250;290;907;59;190;127;384;186;574
431410;201810;14589;39189;9330;29079;1861;6504;3565;10356;5426;16860
431413;201810;179;462;54;176;6;18;8;27;14;45
431415;201810;674;1743;412;1297;63;242;161;446;224;688
431417;201810;572;1332;389;1041;69;201;202;511;271;712
431420;201810;1337;3340;1078;2947;223;612;473;1339;696;1951
431430;201810;531;1376;260;817;45;148;62;166;107;314
431440;201810;23750;59885;17601;49633;3919;11778;5953;16424;9872;28202
431442;201810;102;297;53;184;8;27;8;22;16;49
431445;201810;429;1233;135;469;20;64;14;48;34;112
431446;201810;332;940;221;700;56;191;78;234;134;425
431447;201810;609;1694;407;1266;97;321;151;460;248;781
431449;201810;711;1912;434;1274;69;204;188;529;257;733
431450;201810;2060;4539;1701;4045;121;313;1290;2944;1411;3257
431454;201810;41;133;39;129;7;26;16;61;23;87
431455;201810;603;1489;300;842;45;146;143;350;188;496
431460;201810;2861;7448;2148;6094;590;1726;622;1811;1212;3537
431470;201810;1459;4204;1061;3364;205;655;447;1408;652;2063
431475;201810;246;720;32;134;1;5;2;10;3;15
431477;201810;438;1146;273;809;44;129;127;346;171;475
431478;201810;242;621;60;187;18;58;4;11;22;69
431480;201810;3058;7881;2378;6803;402;1215;1365;3853;1767;5068
431490;201810;97032;245073;79986;218371;7528;23574;58145;153970;65673;177544
431500;201810;487;1290;357;1028;68;187;185;511;253;698
431505;201810;385;938;247;709;28;77;145;415;173;492
431507;201810;346;828;145;413;33;110;51;124;84;234
431510;201810;1490;4033;1064;3177;237;746;405;1203;642;1949
431513;201810;255;604;131;369;11;29;93;269;104;298
431514;201810;85;233;46;155;10;36;18;58;28;94
431515;201810;515;1352;340;1004;78;255;158;424;236;679
431517;201810;72;211;56;171;12;33;18;56;30;89
431520;201810;432;1068;160;524;31;109;52;147;83;256
431530;201810;3825;8569;2334;6386;696;1927;374;1051;1070;2978
431531;201810;195;554;132;417;18;53;54;165;72;218
431532;201810;494;1248;335;942;78;230;134;376;212;606
431535;201810;278;718;105;336;21;76;19;53;40;129
431540;201810;1718;5676;1607;5488;77;291;1285;4398;1362;4689
431545;201810;367;973;71;226;6;23;19;54;25;77
431550;201810;1891;5179;1546;4493;304;943;696;1961;1000;2904
431555;201810;676;1585;420;1142;33;105;248;657;281;762
431560;201810;19764;51903;13133;40686;3045;10034;3531;11692;6576;21726
431570;201810;4610;11516;3693;10219;607;1874;2256;6024;2863;7898
431575;201810;193;574;141;453;25;69;29;84;54;153
431580;201810;544;1458;295;933;48;180;127;373;175;553
431590;201810;700;1900;504;1491;111;333;180;538;291;871
431595;201810;329;954;221;707;39;116;90;278;129;394
431600;201810;1354;3444;996;2882;285;884;353;1023;638;1907
431610;201810;1316;3597;917;2763;133;379;450;1400;583;1779
431620;201810;556;1527;236;721;46;149;102;286;148;435
431630;201810;1205;3196;579;1827;143;472;171;469;314;941
431640;201810;5813;15352;5213;14470;697;2014;3687;10260;4384;12274
431642;201810;465;1194;299;852;30;76;152;414;182;490
431643;201810;328;830;144;422;18;51;48;136;66;187
431645;201810;1666;4206;1341;3688;131;406;950;2600;1081;3006
431647;201810;202;517;102;296;14;47;24;56;38;103
431650;201810;169;495;120;390;22;82;40;118;62;200
431660;201810;836;2265;455;1485;80;295;102;285;182;580
431670;201810;1136;2816;775;2171;129;409;391;1028;520;1437
431673;201810;242;642;89;316;14;44;13;34;27;78
431675;201810;557;1403;128;418;11;43;38;108;49;151
431680;201810;7258;19610;5403;15962;1499;4612;1910;5635;3409;10247
431690;201810;19568;51489;13839;40788;3481;10853;4659;13928;8140;24781
431695;201810;150;386;93;279;17;58;40;91;57;149
431697;201810;467;1158;368;993;61;164;203;556;264;720
431700;201810;1368;3681;1169;3315;174;478;672;1887;846;2365
431710;201810;11106;29460;8506;25449;2133;6698;3378;10628;5511;17326
431720;201810;5709;15166;3686;11024;1002;3139;595;1647;1597;4786
431725;201810;26;73;18;55;5;14;4;11;9;25
431730;201810;3509;9131;2347;7141;630;2069;703;2236;1333;4305
431740;201810;4749;12098;3273;9466;992;3217;630;1529;1622;4746
431750;201810;6850;18840;5834;17238;1096;3527;3091;9168;4187;12695
431755;201810;319;859;64;228;10;39;12;46;22;85
431760;201810;5376;12606;3476;9493;392;1311;2052;5203;2444;6514
431770;201810;1737;4383;1406;3903;138;420;1004;2723;1142;3143
431775;201810;205;546;96;300;21;76;18;44;39;120
431780;201810;1838;4834;1256;3722;244;774;445;1278;689;2052
431790;201810;906;2511;654;1996;145;445;261;767;406;1212
431795;201810;249;657;121;362;27;82;31;89;58;171
431800;201810;7003;18917;5047;15461;1576;5356;621;1946;2197;7302
431805;201810;287;665;89;286;6;22;34;97;40;119
431810;201810;3226;7969;2043;5714;394;1244;825;2140;1219;3384
431820;201810;2106;6140;1759;5523;448;1468;703;2246;1151;3714
431830;201810;8570;20045;6568;17076;1703;4925;2353;6097;4056;11022
431840;201810;2406;6787;1998;6071;400;1274;1120;3375;1520;4649
431842;201810;681;1704;227;707;32;109;68;193;100;302
431843;201810;313;873;246;730;33;105;114;322;147;427
431844;201810;223;582;67;222;17;63;19;56;36;119
431845;201810;507;1360;354;1038;23;76;219;630;242;706
431846;201810;249;725;223;685;21;68;181;548;202;616
431848;201810;155;396;79;246;9;30;13;28;22;58
431849;201810;411;985;60;176;8;18;6;12;14;30
431850;201810;3950;11104;3125;9387;777;2513;912;2642;1689;5155
431860;201810;670;1726;416;1199;96;284;199;539;295;823
431861;201810;116;303;51;156;6;21;19;50;25;71
431862;201810;425;1368;345;1220;80;302;171;592;251;894
431870;201810;16812;46090;13695;40653;2355;7928;7107;20184;9462;28112
431880;201810;3669;9968;2773;8351;537;1834;1174;3359;1711;5193
431890;201810;4015;10717;2556;7768;812;2689;337;1093;1149;3782
431900;201810;1000;2649;616;1877;119;416;297;843;416;1259
431910;201810;782;1940;289;850;47;139;79;198;126;337
431912;201810;436;1270;352;1102;78;250;198;613;276;863
431915;201810;944;2571;771;2267;68;221;534;1525;602;1746
431920;201810;1156;2969;981;2700;55;167;821;2225;876;2392
431930;201810;747;2221;548;1847;138;416;278;997;416;1413
431935;201810;76;219;49;161;13;44;10;29;23;73
431936;201810;286;869;165;569;36;128;40;136;76;264
431937;201810;180;453;109;305;26;86;39;86;65;172
431940;201810;2474;6200;1500;4337;258;871;641;1725;899;2596
431950;201810;1679;4680;1410;4233;359;1102;623;1874;982;2976
431960;201810;2639;6909;2046;5778;564;1636;565;1584;1129;3220
431970;201810;369;973;153;499;35;111;31;89;66;200
431971;201810;63;158;36;112;3;8;6;15;9;23
431973;201810;458;1494;372;1319;42;143;260;937;302;1080
431975;201810;105;226;23;76;5;17;3;6;8;23
431980;201810;1058;2888;820;2463;192;620;352;1011;544;1631
431990;201810;5668;14344;3694;11265;624;2092;1382;4080;2006;6172
432000;201810;9998;25661;7478;21535;2010;6019;3103;8941;5113;14960
432010;201810;1899;5072;1459;4263;222;693;817;2292;1039;2985
432020;201810;1805;4529;1264;3579;311;939;547;1443;858;2382
432023;201810;498;1242;260;760;46;155;119;310;165;465
432026;201810;996;2910;733;2363;170;554;318;1009;488;1563
432030;201810;333;891;198;609;38;123;104;310;142;433
432032;201810;403;1075;273;814;26;89;145;399;171;488
432035;201810;720;2121;642;1989;214;686;235;731;449;1417
432040;201810;1080;2543;385;1233;74;265;112;320;186;585
432045;201810;197;556;107;363;29;98;25;90;54;188
432050;201810;500;1339;382;1115;106;297;126;377;232;674
432055;201810;697;1888;450;1396;143;485;137;390;280;875
432057;201810;256;662;195;530;45;102;81;208;126;310
432060;201810;434;1054;135;437;26;102;51;139;77;241
432065;201810;225;639;157;483;31;92;58;176;89;268
432067;201810;741;2221;612;1911;85;281;382;1153;467;1434
432070;201810;1829;4948;1130;3496;251;839;264;716;515;1555
432080;201810;3730;9722;2966;8424;747;2389;1171;3165;1918;5554
432085;201810;390;1017;252;796;90;268;84;290;174;558
432090;201810;1271;3454;923;2782;211;681;391;1120;602;1801
432100;201810;1008;2750;444;1461;88;319;44;100;132;419
432110;201810;2122;5992;1419;4611;349;1307;92;309;441;1616
432120;201810;2788;8093;2288;7174;693;2350;556;1682;1249;4032
432130;201810;2501;6695;2117;6151;755;2321;764;2219;1519;4540
432132;201810;237;642;121;399;24;84;41;120;65;204
432135;201810;895;2303;603;1726;59;197;419;1159;478;1356
432140;201810;1541;4823;1166;4058;212;759;597;2099;809;2858
432143;201810;1308;3630;1034;3188;105;367;638;1954;743;2321
432145;201810;1291;3594;749;2369;121;417;176;481;297;898
432146;201810;107;311;70;231;22;80;16;46;38;126
432147;201810;441;1373;296;1036;81;294;61;206;142;500
432149;201810;369;989;218;646;30;91;98;277;128;368
432150;201810;2845;7810;2118;6417;531;1805;626;1834;1157;3639
432160;201810;4542;13026;3555;11347;1023;3479;1107;3469;2130;6948
432162;201810;282;637;34;99;6;16;4;11;10;27
432163;201810;161;446;32;104;2;6;2;6;4;12
432166;201810;516;1539;401;1284;76;253;130;376;206;629
432170;201810;1290;3660;835;2747;190;684;226;686;416;1370
432180;201810;2543;6522;1356;4116;265;861;390;1058;655;1919
432183;201810;348;1049;223;739;59;223;56;172;115;395
432185;201810;808;2160;477;1487;34;123;266;784;300;907
432190;201810;1996;5170;1285;3818;304;1016;471;1268;775;2284
432195;201810;954;2412;598;1768;177;494;217;663;394;1157
432200;201810;2968;8252;2154;6772;445;1434;1006;3231;1451;4665
432210;201810;355;978;235;754;48;173;101;305;149;478
432215;201810;645;1949;573;1834;64;197;401;1306;465;1503
432218;201810;251;639;126;353;18;53;54;135;72;188
432220;201810;3744;9239;2798;7655;397;1247;1670;4344;2067;5591
432225;201810;91;270;67;217;18;57;30;98;48;155
432230;201810;687;1755;385;1139;59;186;165;445;224;631
432232;201810;486;1244;327;955;70;216;120;345;190;561
432234;201810;300;789;128;389;33;97;19;46;52;143
432235;201810;92;253;32;101;7;21;8;28;15;49
432237;201810;357;920;310;838;16;43;230;589;246;632
432240;201810;13434;37210;10493;32884;983;3500;6426;20937;7409;24437
432250;201810;4071;13224;3532;12156;1103;3915;1236;4360;2339;8275
432252;201810;432;1133;274;798;48;153;112;302;160;455
432253;201810;1072;3345;594;2078;136;517;34;106;170;623
432254;201810;873;2182;169;543;29;106;16;43;45;149
432255;201810;136;355;67;210;8;28;27;72;35;100
432260;201810;5045;13214;3692;10708;1018;3060;1070;3091;2088;6151
432270;201810;1909;5665;1563;4948;502;1698;252;770;754;2468
432280;201810;1107;2898;597;1846;102;343;218;613;320;956
432285;201810;189;590;18;61;0;0;2;5;2;5
432290;201810;358;1057;196;664;57;193;46;132;103;325
432300;201810;24703;66461;19373;57533;3025;9959;11345;32580;14370;42539
432310;201810;721;2046;536;1704;74;244;335;1053;409;1297
432320;201810;224;538;70;206;9;36;25;64;34;100
432330;201810;230;588;84;272;20;64;16;48;36;112
432335;201810;171;489;57;214;8;31;13;52;21;83
432340;201810;305;739;128;401;24;88;34;86;58;174
432345;201810;568;1427;519;1361;33;116;407;1031;440;1147
432350;201810;325;884;162;539;29;96;52;165;81;261
432360;201810;210;624;39;131;5;24;8;26;13;50
432370;201810;310;807;208;614;19;55;124;360;143;415
432375;201810;508;1311;392;1098;62;155;216;603;278;758
432377;201810;231;733;35;123;6;19;4;7;10;26
432380;201810;1475;4276;930;3114;186;708;418;1312;604;2020
500020;201810;2157;5889;1548;4816;333;1128;707;2153;1040;3281
500025;201810;1229;2828;766;2040;75;212;453;1184;528;1396
500060;201810;6149;17972;4687;15368;712;2398;2721;9348;3433;11746
500070;201810;3741;10194;2761;8501;582;1842;1212;3885;1794;5727
500080;201810;1158;3185;841;2621;184;647;362;1044;546;1691
500085;201810;1960;4925;1337;3947;279;896;666;1901;945;2797
500090;201810;1841;5147;1271;4082;230;764;508;1673;738;2437
500100;201810;3350;8825;2560;7504;354;1156;1328;3706;1682;4862
500110;201810;6796;18953;4584;15279;1007;3618;1443;5490;2450;9108
500124;201810;1893;5944;1602;5445;333;1113;863;3101;1196;4214
500150;201810;1157;2732;728;2043;176;531;241;623;417;1154
500190;201810;4256;10447;3109;8901;737;2205;1287;3830;2024;6035
500200;201810;2111;5155;1580;4261;207;593;937;2387;1144;2980
500210;201810;4428;12108;3389;10548;904;2872;1430;4517;2334;7389
500215;201810;1356;3904;939;3089;100;373;475;1519;575;1892
500220;201810;2608;7496;1878;6187;341;1230;714;2324;1055;3554
500230;201810;2087;5145;1554;4337;215;608;954;2614;1169;3222
500240;201810;3339;10582;2351;8420;425;1745;643;2375;1068;4120
500260;201810;3060;6777;1851;5030;236;633;944;2485;1180;3118
500270;201810;126058;307233;73348;213116;14797;46587;23078;63525;37875;110112
500280;201810;1231;3224;883;2666;112;378;528;1539;640;1917
500290;201810;3609;8406;1991;5867;349;1127;707;1957;1056;3084
500295;201810;2868;7325;1673;5012;289;959;623;1633;912;2592
500310;201810;870;2023;627;1701;114;282;326;916;440;1198
500315;201810;3241;9707;2667;8746;325;1080;1751;5950;2076;7030
500320;201810;17207;50781;12410;42248;3323;12074;3900;14023;7223;26097
500325;201810;4024;9508;2721;7549;331;982;1520;4225;1851;5207
500330;201810;6603;15685;4226;11888;500;1607;2189;6225;2689;7832
500345;201810;1902;4756;1266;3768;336;1030;427;1241;763;2271
500348;201810;2558;6610;1979;5658;254;769;1163;3357;1417;4126
500350;201810;1267;3520;650;2124;74;261;249;816;323;1077
500370;201810;21275;58489;14791;47166;2507;9033;6814;21602;9321;30635
500375;201810;2328;6430;1635;4965;347;1175;526;1530;873;2705
500380;201810;3469;8748;2401;7010;667;2044;835;2466;1502;4510
500390;201810;492;1070;290;795;39;107;153;422;192;529
500400;201810;1101;3056;747;2297;168;575;235;672;403;1247
500410;201810;2306;6115;1727;5186;240;712;993;3059;1233;3771
500430;201810;2477;6468;1678;5208;284;998;641;2077;925;3075
500440;201810;1178;2852;707;2061;117;345;262;808;379;1153
500450;201810;1293;3354;714;2241;145;471;126;365;271;836
500460;201810;3420;9620;2155;7103;455;1663;558;1870;1013;3533
500470;201810;2378;6656;1487;4762;464;1613;290;814;754;2427
500480;201810;2131;6361;1847;5950;165;548;1301;4410;1466;4958
500490;201810;908;2263;542;1691;147;522;163;504;310;1026
500500;201810;4018;11218;2757;9213;925;3552;601;2033;1526;5585
500510;201810;691;1764;429;1275;25;80;258;740;283;820
500515;201810;1874;4762;1509;4224;133;372;1060;2987;1193;3359
500520;201810;3049;10271;2480;9123;687;2686;981;3625;1668;6311
500525;201810;887;2721;733;2471;88;333;427;1462;515;1795
500540;201810;4311;11502;2540;8245;726;2772;218;639;944;3411
500560;201810;5025;15016;4198;13829;358;1294;3116;10355;3474;11649
500568;201810;4108;9341;2514;6980;638;1962;752;2083;1390;4045
500570;201810;7081;17337;4019;11830;934;2995;979;2678;1913;5673
500580;201810;3066;8484;2377;7286;488;1554;1198;3657;1686;5211
500600;201810;3102;7904;2086;6291;411;1306;829;2524;1240;3830
500620;201810;7226;19952;4918;15385;1021;3341;1933;5978;2954;9319
500625;201810;485;1372;264;862;49;181;105;319;154;500
500627;201810;721;1884;443;1354;71;222;128;392;199;614
500630;201810;5736;14312;3513;10502;829;2657;1034;3141;1863;5798
500635;201810;2601;8840;2091;8090;146;625;1533;6268;1679;6893
500640;201810;1685;3899;1095;3012;45;154;773;2028;818;2182
500660;201810;16048;45753;11496;38261;4002;14769;2488;8430;6490;23199
500690;201810;2212;6352;1555;5257;634;2400;101;263;735;2663
500710;201810;2828;8129;2168;6880;620;2081;569;1731;1189;3812
500720;201810;4752;12554;2995;9521;773;2721;700;2223;1473;4944
500730;201810;900;2422;587;1816;100;297;234;736;334;1033
500740;201810;4476;11077;3221;8966;340;1058;1804;5040;2144;6098
500750;201810;964;2542;679;2018;103;324;265;711;368;1035
500755;201810;866;2427;522;1745;110;381;80;235;190;616
500769;201810;4802;12318;2512;7706;488;1670;375;862;863;2532
500770;201810;1508;4191;944;3103;163;569;298;996;461;1565
500780;201810;1220;3154;802;2391;183;567;210;594;393;1161
500790;201810;7808;20892;6297;18448;1214;3903;3376;9881;4590;13784
500793;201810;1814;4868;1262;3914;406;1298;263;713;669;2011
500795;201810;2415;6551;1992;5980;142;399;1617;5047;1759;5446
500797;201810;711;1915;474;1458;113;368;167;494;280;862
500800;201810;2734;6695;1821;5319;621;2040;281;903;902;2943
500830;201810;17148;43842;11742;33933;1858;5849;5526;15182;7384;21031
500840;201810;1212;3149;753;2270;92;296;295;830;387;1126
510010;201810;1770;4310;1195;3500;185;546;689;2037;874;2583
510020;201810;3571;9345;1883;5841;426;1391;347;941;773;2332
510025;201810;6559;17574;4121;13008;750;2626;1339;3979;2089;6605
510030;201810;2117;4900;1403;3879;353;994;501;1450;854;2444
510035;201810;1174;3062;707;2304;108;339;407;1419;515;1758
510040;201810;2157;5094;1563;4256;135;368;1004;2735;1139;3103
510050;201810;1895;4581;1284;3624;232;749;755;1985;987;2734
510060;201810;1352;3518;1010;2985;175;561;447;1274;622;1835
510080;201810;1172;3315;787;2600;230;821;208;595;438;1416
510100;201810;641;1570;413;1167;53;165;209;559;262;724
510120;201810;260;496;150;365;9;29;111;265;120;294
510125;201810;2210;5585;1690;4785;242;889;745;1908;987;2797
510130;201810;1399;3723;1026;3089;245;799;293;881;538;1680
510140;201810;2843;7914;2008;6800;722;2739;683;2176;1405;4915
510160;201810;1419;4103;1145;3738;203;670;771;2531;974;3201
510170;201810;4542;12676;3394;10737;819;2724;1412;4447;2231;7171
510180;201810;12859;31322;7923;23228;1998;6317;2255;7456;4253;13773
510185;201810;1730;4588;1147;3738;410;1348;375;1491;785;2839
510190;201810;2108;5968;1443;4884;467;1725;369;1292;836;3017
510250;201810;13851;37956;11502;34637;2425;7642;6297;19581;8722;27223
510260;201810;2075;8526;1676;7751;265;1261;975;5029;1240;6290
510263;201810;3022;8626;1893;6313;378;1348;251;768;629;2116
510267;201810;4651;13588;2894;9655;641;2221;506;1731;1147;3952
510268;201810;1412;3636;949;2782;144;435;474;1327;618;1762
510269;201810;1062;3025;670;2245;173;633;219;682;392;1315
510270;201810;2764;8482;2052;7147;385;1429;778;2678;1163;4107
510279;201810;1716;4801;1220;3878;234;820;604;1829;838;2649
510285;201810;1102;3051;773;2480;226;792;184;560;410;1352
510300;201810;3480;9115;2647;7980;361;1018;1628;5172;1989;6190
510305;201810;1417;4137;924;3154;194;709;260;969;454;1678
510310;201810;904;2404;648;1961;214;667;194;618;408;1285
510320;201810;3635;9585;2655;7851;646;2086;727;2126;1373;4212
510325;201810;4559;13791;3585;12206;1035;3632;1424;5048;2459;8680
510330;201810;2910;8937;1988;7239;406;1538;697;2827;1103;4365
510335;201810;4711;13744;3527;12027;477;1780;2006;7169;2483;8949
510336;201810;487;1421;348;1176;67;210;164;597;231;807
510337;201810;1603;4888;1089;3935;434;1703;163;596;597;2299
510340;201810;83409;194683;50657;144395;14989;49531;11826;31288;26815;80819
510343;201810;975;2820;678;2229;140;502;230;706;370;1208
510345;201810;1263;3739;944;3102;183;604;387;1213;570;1817
510350;201810;2848;7688;1867;6030;450;1494;732;2389;1182;3883
510360;201810;1800;3994;1164;3205;65;208;864;2422;929;2630
510370;201810;1632;5026;1199;4226;214;836;629;2252;843;3088
510380;201810;490;1303;258;845;73;268;46;143;119;411
510385;201810;1042;3755;761;3148;81;369;460;2015;541;2384
510390;201810;1046;3228;817;2893;222;780;373;1451;595;2231
510395;201810;727;1679;483;1314;36;98;263;772;299;870
510410;201810;4213;12470;3214;10608;777;2639;1573;5401;2350;8040
510420;201810;2064;4762;1477;3923;168;488;863;2300;1031;2788
510450;201810;518;1342;305;939;84;262;45;144;129;406
510452;201810;662;1905;441;1463;81;270;208;689;289;959
510454;201810;779;2293;584;1944;58;184;358;1264;416;1448
510455;201810;888;2623;637;2052;94;355;240;697;334;1052
510460;201810;1912;4852;1374;4049;147;505;821;2301;968;2806
510480;201810;4331;11033;2851;8105;571;1754;1146;3076;1717;4830
510490;201810;1609;4642;1223;4083;274;929;590;2013;864;2942
510500;201810;1502;4037;903;2928;168;595;339;1082;507;1677
510510;201810;3174;9922;2434;8432;773;2923;582;2147;1355;5070
510515;201810;5493;15010;3529;11137;782;2747;925;2640;1707;5387
510517;201810;1161;3414;898;2943;241;889;178;525;419;1414
510520;201810;2008;4227;1214;3252;74;214;690;1953;764;2167
510523;201810;971;2610;740;2220;141;412;423;1271;564;1683
510525;201810;5626;16246;4267;13458;754;2630;1823;5281;2577;7911
510530;201810;547;1398;403;1186;27;113;278;777;305;890
510550;201810;2623;8024;1899;6671;478;1728;712;2549;1190;4277
510558;201810;1976;5499;1562;4905;168;580;833;2798;1001;3378
510560;201810;1575;4664;910;3348;214;876;223;873;437;1749
510562;201810;4998;13689;3626;11119;867;2859;1385;4345;2252;7204
510590;201810;2971;7718;2155;6657;352;1097;1320;4192;1672;5289
510600;201810;1528;3622;945;2700;203;570;369;1079;572;1649
510610;201810;2520;6493;1813;5503;184;633;1125;3378;1309;4011
510615;201810;1989;5628;1481;4720;274;879;828;2702;1102;3581
510617;201810;936;2727;691;2327;100;353;417;1477;517;1830
510618;201810;1272;3514;892;2812;182;650;452;1359;634;2009
510619;201810;714;1889;402;1304;67;256;77;226;144;482
510620;201810;1415;3280;671;2096;156;564;72;179;228;743
510621;201810;1282;3627;840;2771;181;641;245;796;426;1437
510622;201810;3880;11438;2740;8840;994;3493;433;1251;1427;4744
510623;201810;2694;7152;1941;5875;425;1533;566;1638;991;3171
510624;201810;1573;4247;702;2423;90;335;128;371;218;706
510625;201810;2380;6024;1376;4187;308;1072;279;824;587;1896
510626;201810;1601;3844;943;2838;272;921;208;637;480;1558
510627;201810;648;1680;369;1117;93;288;74;239;167;527
510628;201810;1567;3576;1029;2867;174;464;615;1811;789;2275
510629;201810;1521;4631;1161;3902;281;1007;372;1280;653;2287
510630;201810;3183;9350;1882;6698;431;1683;290;1098;721;2781
510631;201810;499;1280;359;1071;20;58;256;771;276;829
510637;201810;3162;8116;2347;6781;710;2288;630;1725;1340;4013
510642;201810;4932;15047;3965;13546;1095;4035;1577;5582;2672;9617
510645;201810;851;1897;499;1414;137;391;162;446;299;837
510650;201810;6534;18649;5500;17483;768;2286;3997;13436;4765;15722
510665;201810;1762;4216;1030;2930;184;560;395;1171;579;1731
510670;201810;402;857;218;587;27;87;116;309;143;396
510675;201810;5738;16681;4176;13678;1220;4356;713;2272;1933;6628
510677;201810;2103;5589;1477;4620;224;755;760;2357;984;3112
510680;201810;619;1729;384;1265;97;332;52;160;149;492
510682;201810;1576;5005;1175;4257;366;1432;247;905;613;2337
510685;201810;685;2012;515;1666;77;250;237;749;314;999
510700;201810;3527;9273;2484;7675;444;1443;1450;4534;1894;5977
510704;201810;9578;23963;6321;18144;1267;3952;1878;5198;3145;9150
510706;201810;1801;5552;1276;4676;236;946;659;2555;895;3501
510710;201810;2469;6632;1706;5118;363;1138;596;1678;959;2816
510715;201810;678;1576;474;1259;57;152;210;577;267;729
510718;201810;2508;5538;1356;4148;574;1782;237;993;811;2775
510719;201810;396;866;243;661;38;110;131;344;169;454
510720;201810;963;2401;634;1874;159;505;196;538;355;1043
510724;201810;677;1885;469;1522;89;323;222;677;311;1000
510726;201810;1145;2101;596;1408;71;175;328;776;399;951
510729;201810;640;1551;298;906;45;157;68;202;113;359
510730;201810;2941;7440;1990;5895;437;1401;776;2260;1213;3661
510735;201810;1009;3053;759;2682;83;328;524;1871;607;2199
510740;201810;1173;3224;831;2593;85;232;530;1774;615;2006
510757;201810;582;1896;472;1698;188;724;135;459;323;1183
510760;201810;37390;84857;21927;61222;6364;19937;4981;12658;11345;32595
510770;201810;4093;9705;2975;8313;324;858;1981;5776;2305;6634
510774;201810;346;974;246;764;42;137;120;393;162;530
510775;201810;589;1668;408;1361;99;373;87;268;186;641
510776;201810;463;1262;320;963;85;261;98;300;183;561
510777;201810;1604;4461;1181;3876;143;543;794;2576;937;3119
510779;201810;569;1629;452;1431;67;182;267;890;334;1072
510780;201810;3593;9842;2697;8463;689;2188;1066;3686;1755;5874
510785;201810;2054;5518;1183;3888;285;1032;170;597;455;1629
510787;201810;2395;6860;1660;5369;692;2354;112;338;804;2692
510788;201810;706;1693;481;1346;83;225;180;607;263;832
510790;201810;14364;39300;8860;28401;2066;7551;1303;3573;3369;11124
510792;201810;8372;22904;5336;17164;1072;3759;1236;3815;2308;7574
510794;201810;1207;3409;790;2621;257;951;153;440;410;1391
510795;201810;6942;19644;4908;15886;1261;4470;1188;3849;2449;8319
510800;201810;1586;4138;1083;3324;284;900;295;836;579;1736
510805;201810;1670;4636;1091;3532;225;756;370;1073;595;1829
510810;201810;650;1414;429;1111;112;309;200;502;312;811
510820;201810;798;1560;430;1090;47;151;196;489;243;640
510830;201810;788;1990;550;1652;85;250;321;1014;406;1264
510835;201810;547;1434;368;1141;54;184;180;541;234;725
510840;201810;44366;102492;32280;87180;6408;16917;16845;48837;23253;65754
510850;201810;1781;4469;1012;3183;297;1046;122;302;419;1348
510860;201810;2582;7211;1671;5592;535;2074;169;536;704;2610
510880;201810;642;1914;490;1624;131;450;209;717;340;1167
510885;201810;570;1487;395;1222;73;246;131;397;204;643
510890;201810;646;1962;519;1770;117;425;249;864;366;1289
510895;201810;1192;3189;799;2490;203;727;288;802;491;1529
520005;201810;2019;5590;1627;5092;427;1234;763;2734;1190;3968
520010;201810;2223;6729;1568;5305;426;1583;346;1035;772;2618
520013;201810;2601;7114;1866;5657;454;1442;472;1524;926;2966
520015;201810;536;1400;405;1218;108;338;122;400;230;738
520017;201810;1077;2943;820;2523;142;473;462;1387;604;1860
520020;201810;369;926;293;818;62;199;161;424;223;623
520025;201810;32239;92195;28343;86843;3519;11241;19715;60345;23234;71586
520030;201810;4996;13799;4043;12321;513;1698;2497;7565;3010;9263
520050;201810;429;1014;267;723;22;50;150;426;172;476
520055;201810;1150;3085;844;2485;63;188;493;1423;556;1611
520060;201810;1404;4130;1091;3534;271;962;279;879;550;1841
520080;201810;1823;4846;1398;4256;246;737;659;2193;905;2930
520082;201810;1027;2567;848;2259;116;263;456;1283;572;1546
520085;201810;695;1996;548;1744;124;389;185;551;309;940
520090;201810;808;1733;587;1479;95;206;392;1037;487;1243
520110;201810;37675;105511;26889;87633;8916;32591;1795;5216;10711;37807
520120;201810;190;482;107;336;13;50;35;110;48;160
520130;201810;3626;9471;3009;8449;594;1764;1409;3995;2003;5759
520140;201810;35525;102845;26848;87208;9864;34767;2854;9481;12718;44248
520145;201810;500;1248;350;1010;74;223;136;361;210;584
520150;201810;554;1378;430;1213;84;240;229;655;313;895
520160;201810;811;1949;588;1606;95;264;285;775;380;1039
520170;201810;5002;10481;3587;8856;228;587;2830;6923;3058;7510
520180;201810;1917;5507;1592;4973;406;1347;648;2008;1054;3355
520215;201810;1935;4748;1400;3894;312;950;578;1525;890;2475
520235;201810;604;1462;388;1122;51;152;146;412;197;564
520250;201810;1427;3776;1027;3155;282;945;196;635;478;1580
520260;201810;844;2018;513;1430;102;311;191;533;293;844
520280;201810;619;1661;489;1420;139;405;181;560;320;965
520310;201810;1233;2833;823;2204;204;584;309;859;513;1443
520320;201810;1731;4903;1364;4291;141;473;741;2345;882;2818
520330;201810;3391;9806;2458;8167;469;1791;1010;3293;1479;5084
520340;201810;2182;5125;1482;4119;161;397;950;2741;1111;3138
520350;201810;2826;7204;2076;5956;683;2063;640;1782;1323;3845
520355;201810;1783;4997;1349;4157;324;1101;505;1470;829;2571
520357;201810;796;2016;618;1728;29;82;454;1287;483;1369
520360;201810;699;1886;533;1597;158;476;138;444;296;920
520380;201810;1305;3377;777;2328;86;301;394;1094;480;1395
520390;201810;922;2119;541;1616;173;551;142;448;315;999
520393;201810;533;1284;370;1018;42;131;180;454;222;585
520396;201810;802;2224;667;1976;86;271;407;1170;493;1441
520400;201810;1522;4003;1232;3592;213;657;771;2245;984;2902
520410;201810;1632;3607;1009;2730;117;316;585;1570;702;1886
520420;201810;381;939;286;750;31;98;197;479;228;577
520425;201810;1379;3378;915;2604;240;696;320;926;560;1622
520430;201810;2164;5178;1148;3497;190;703;45;115;235;818
520440;201810;3167;7819;1993;5724;504;1540;518;1428;1022;2968
520450;201810;10937;27554;7236;21455;2399;7673;708;2175;3107;9848
520455;201810;651;1831;477;1553;133;459;131;418;264;877
520460;201810;918;2447;780;2248;104;270;586;1735;690;2005
520465;201810;819;2185;667;1945;113;360;412;1144;525;1504
520470;201810;1890;5484;1606;5099;391;1261;848;2853;1239;4114
520480;201810;830;2407;562;1904;157;566;120;426;277;992
520485;201810;1555;4389;1284;4012;213;686;813;2512;1026;3198
520490;201810;3792;10963;2999;9734;901;2924;1298;4399;2199;7323
520495;201810;1465;3427;1150;3001;68;187;879;2321;947;2508
520500;201810;1415;3812;992;3034;222;761;351;1051;573;1812
520505;201810;719;1753;513;1466;102;297;262;738;364;1035
520510;201810;6824;18063;4792;14946;1132;3916;1250;4108;2382;8024
520520;201810;1107;2910;833;2475;218;644;254;801;472;1445
520530;201810;1963;6011;1463;5111;532;1918;362;1423;894;3341
520540;201810;2914;7802;1782;5494;389;1246;385;1177;774;2423
520545;201810;914;2526;702;2173;135;426;257;802;392;1228
520547;201810;726;2103;571;1804;159;514;237;738;396;1252
520549;201810;11441;32660;9412;29318;2000;6465;5048;15724;7048;22189
520551;201810;4224;12001;3607;11083;483;1739;2431;7274;2914;9013
520552;201810;814;2246;723;2126;119;330;498;1533;617;1863
520570;201810;618;1485;403;1162;105;291;131;402;236;693
520580;201810;2756;6239;1941;5212;182;523;1270;3407;1452;3930
520590;201810;1255;3431;889;2755;240;753;142;434;382;1187
520620;201810;8142;22581;6535;20210;1678;5311;2961;9344;4639;14655
520630;201810;918;2330;559;1707;101;313;139;406;240;719
520640;201810;2517;6362;1913;5319;492;1384;730;2097;1222;3481
520650;201810;914;2252;627;1777;113;321;305;898;418;1219
520660;201810;526;1266;244;747;48;157;46;148;94;305
520670;201810;954;2699;797;2470;80;257;521;1554;601;1811
520680;201810;710;1806;531;1523;115;317;242;713;357;1030
520690;201810;379;893;248;703;78;208;76;232;154;440
520710;201810;513;1258;341;957;13;36;219;598;232;634
520725;201810;1606;3914;1134;3129;135;416;715;1910;850;2326
520735;201810;766;1948;518;1513;102;287;177;546;279;833
520740;201810;1872;4561;1489;4067;266;713;866;2452;1132;3165
520750;201810;652;1649;472;1366;88;236;228;683;316;919
520753;201810;1403;3739;1104;3164;198;591;470;1270;668;1861
520760;201810;1164;2558;1050;2413;79;146;873;2099;952;2245
520780;201810;1551;3812;1169;3263;122;353;617;1683;739;2036
520790;201810;3414;8145;2384;6554;240;672;1417;4123;1657;4795
520800;201810;14825;39616;11993;35717;2385;7139;6924;21539;9309;28678
520810;201810;1311;2827;943;2399;182;501;506;1330;688;1831
520815;201810;614;1876;451;1545;115;412;91;352;206;764
520830;201810;1782;4028;1279;3434;66;153;1014;2699;1080;2852
520840;201810;2278;6339;1860;5766;785;2547;497;1665;1282;4212
520850;201810;649;1778;454;1474;165;611;90;293;255;904
520860;201810;6112;17251;4706;14990;1167;4038;1695;5389;2862;9427
520870;201810;87718;214854;61303;174737;16827;51920;18049;50367;34876;102287
520880;201810;5952;17369;4748;15303;1407;4840;1378;4378;2785;9218
520890;201810;3772;9627;2656;7805;592;1894;1112;3212;1704;5106
520910;201810;4232;10983;2715;8278;749;2510;479;1471;1228;3981
520915;201810;602;1720;418;1326;73;260;153;465;226;725
520920;201810;4382;10477;2968;8495;437;1314;1509;4356;1946;5670
520929;201810;717;1786;513;1432;108;275;222;677;330;952
520940;201810;1068;2889;845;2571;55;182;640;1926;695;2108
520945;201810;497;1148;391;973;27;64;272;666;299;730
520960;201810;1026;2687;812;2325;114;352;485;1335;599;1687
520970;201810;2420;7072;1988;6281;576;1973;469;1531;1045;3504
520980;201810;768;1986;600;1726;132;403;239;661;371;1064
520990;201810;2861;8449;2476;7861;307;992;1625;5209;1932;6201
520993;201810;1009;2452;686;1910;39;122;481;1305;520;1427
520995;201810;2194;5788;1748;5169;398;1186;719;2169;1117;3355
521000;201810;7693;21177;5585;17318;1397;4541;1555;4792;2952;9333
521010;201810;3732;9872;2796;8255;352;1019;1517;4470;1869;5489
521015;201810;676;1741;533;1518;62;190;339;936;401;1126
521020;201810;2901;7749;1769;5480;522;1724;168;526;690;2250
521030;201810;527;1220;375;997;52;104;191;560;243;664
521040;201810;7451;18418;5585;15503;1449;4228;2120;6011;3569;10239
521056;201810;845;2329;661;2032;200;636;186;620;386;1256
521060;201810;1047;2697;775;2245;63;202;405;1181;468;1383
521080;201810;1069;2450;549;1575;78;237;181;440;259;677
521090;201810;3275;8620;2290;6890;635;2041;305;951;940;2992
521100;201810;1732;4100;1275;3455;249;654;684;1902;933;2556
521120;201810;4821;11393;3363;9546;315;838;1599;5170;1914;6008
521130;201810;953;2331;641;1760;35;124;371;1018;406;1142
521140;201810;1225;3274;906;2718;151;489;361;1075;512;1564
521150;201810;11678;26735;7572;20924;1661;5184;3120;8776;4781;13960
521160;201810;666;1479;448;1139;63;166;248;591;311;757
521170;201810;1078;2562;765;2079;83;226;491;1291;574;1517
521180;201810;6560;19493;5493;17487;1095;3758;2367;7282;3462;11040
521190;201810;10196;26770;5889;18931;1492;5097;1101;3694;2593;8791
521200;201810;735;1852;509;1465;60;173;283;798;343;971
521205;201810;611;1596;459;1343;25;67;331;950;356;1017
521210;201810;726;1920;406;1249;94;319;54;118;148;437
521220;201810;3960;9837;2650;7740;563;1777;789;2172;1352;3949
521225;201810;342;777;266;690;35;82;172;460;207;542
521230;201810;1376;4165;1271;4011;433;1269;689;2356;1122;3625
521250;201810;30573;86016;24557;77270;9841;32202;7052;23659;16893;55861
521260;201810;593;1390;428;1122;62;168;251;649;313;817
521270;201810;1800;4659;1555;4367;108;267;1210;3430;1318;3697
521280;201810;1866;5220;1430;4435;411;1374;475;1474;886;2848
521290;201810;446;1158;332;1001;57;195;174;506;231;701
521295;201810;1152;2535;909;2253;84;187;696;1817;780;2004
521300;201810;1882;4849;1521;4341;300;806;908;2681;1208;3487
521305;201810;702;1807;504;1485;67;195;276;806;343;1001
521308;201810;4661;12938;3404;10451;521;1626;1801;5465;2322;7091
521310;201810;8162;21721;5417;16746;1334;4458;1715;5095;3049;9553
521340;201810;407;973;304;819;24;62;222;588;246;650
521350;201810;2049;5297;1590;4597;187;601;1057;2938;1244;3539
521370;201810;1175;3053;715;2257;173;607;143;462;316;1069
521375;201810;1400;3585;1000;3017;250;763;349;1127;599;1890
521377;201810;1455;3205;1088;2755;71;150;904;2336;975;2486
521380;201810;5647;15500;3874;12163;433;1479;958;3180;1391;4659
521385;201810;610;1526;485;1362;104;289;226;691;330;980
521390;201810;693;1784;509;1503;176;556;154;478;330;1034
521400;201810;2431;5653;1897;5029;195;547;1414;3829;1609;4376
521405;201810;1296;3361;981;2842;200;589;439;1256;639;1845
521410;201810;764;2079;614;1848;126;368;305;985;431;1353
521440;201810;1346;3575;995;2966;284;912;263;763;547;1675
521450;201810;3809;11748;2909;9889;713;2438;779;2802;1492;5240
521460;201810;5833;15954;4345;13264;1526;4906;965;2844;2491;7750
521470;201810;626;1766;379;1208;63;198;106;313;169;511
521480;201810;356;947;205;651;43;149;46;127;89;276
521483;201810;2444;6068;1759;4956;445;1345;595;1612;1040;2957
521486;201810;1657;3988;1282;3470;73;200;979;2633;1052;2833
521487;201810;447;1138;324;956;62;188;141;421;203;609
521490;201810;850;2371;633;1993;47;197;424;1290;471;1487
521500;201810;1675;4363;1213;3605;96;344;826;2367;922;2711
521520;201810;784;1815;530;1431;87;242;226;623;313;865
521523;201810;11151;37083;9736;34598;3400;12912;2405;8785;5805;21697
521525;201810;1039;2489;799;2136;90;255;550;1442;640;1697
521530;201810;2218;5813;1289;3904;265;850;319;1024;584;1874
521540;201810;858;2208;544;1667;93;341;223;684;316;1025
521550;201810;1212;3118;756;2258;161;518;239;754;400;1272
521560;201810;3960;11297;2853;9755;626;2492;1345;4774;1971;7266
521565;201810;601;1511;485;1347;92;240;286;778;378;1018
521570;201810;3787;10201;2495;7753;519;1805;343;1128;862;2933
521580;201810;512;1267;286;853;38;121;64;160;102;281
521590;201810;604;1568;469;1352;124;408;197;525;321;933
521600;201810;399;1141;244;781;47;135;52;169;99;304
521630;201810;1596;3672;955;2681;192;577;295;797;487;1374
521640;201810;1978;4753;1436;3967;327;945;516;1394;843;2339
521645;201810;563;1519;370;1165;87;267;101;318;188;585
521680;201810;1131;3538;909;3075;282;1009;102;376;384;1385
521690;201810;502;1359;428;1227;73;229;248;679;321;908
521710;201810;2962;7864;2018;6195;367;1233;440;1304;807;2537
521720;201810;1976;5106;1490;4294;201;611;820;2294;1021;2905
521730;201810;3670;10935;2875;9439;940;3428;509;1405;1449;4833
521740;201810;3786;10405;2972;9157;905;3014;961;3083;1866;6097
521760;201810;14025;41423;11466;37308;3475;12299;3723;12525;7198;24824
521770;201810;2856;7361;2018;5896;647;2015;433;1235;1080;3250
521800;201810;5675;16301;4601;14490;1327;4337;1519;5188;2846;9525
521805;201810;576;1361;409;1127;147;378;160;466;307;844
521810;201810;709;1657;480;1317;85;247;226;623;311;870
521830;201810;5156;14905;4236;13513;435;1596;2818;8806;3253;10402
521839;201810;636;1682;467;1359;90;271;190;520;280;791
521850;201810;5113;13229;3549;10596;789;2594;425;1162;1214;3756
521860;201810;1771;4669;1223;3724;206;695;402;1192;608;1887
521870;201810;670;1947;475;1577;108;366;134;418;242;784
521878;201810;653;1779;465;1419;78;277;199;546;277;823
521880;201810;18132;44822;12337;35901;3297;10009;3800;11445;7097;21454
521890;201810;3065;8529;2082;6538;516;1729;258;738;774;2467
521900;201810;1622;3913;983;2939;247;723;218;689;465;1412
521910;201810;1207;2737;806;2257;79;230;482;1396;561;1626
521920;201810;427;1236;315;1015;59;210;112;375;171;585
521925;201810;711;1993;529;1676;117;374;190;568;307;942
521930;201810;4377;11462;3203;9685;972;2896;1074;3536;2046;6432
521935;201810;825;2107;601;1706;85;249;333;894;418;1143
521940;201810;1268;2984;858;2426;208;675;334;885;542;1560
521945;201810;541;1560;442;1372;92;275;199;659;291;934
521950;201810;619;1522;486;1354;71;232;334;886;405;1118
521960;201810;703;1940;460;1439;69;231;214;641;283;872
521970;201810;2543;6616;2141;6135;121;319;1739;5102;1860;5421
521971;201810;759;1913;523;1533;142;441;131;369;273;810
521973;201810;1088;2996;894;2708;76;274;592;1742;668;2016
521975;201810;12118;32659;10256;30131;1802;5484;6235;18356;8037;23840
521980;201810;2547;6267;2002;5546;202;516;1462;4090;1664;4606
521990;201810;1121;3156;923;2835;128;400;481;1505;609;1905
522000;201810;3555;11648;2986;10901;250;785;2186;8525;2436;9310
522005;201810;342;865;260;748;57;149;115;343;172;492
522010;201810;3783;9648;2768;8003;808;2467;701;1956;1509;4423
522015;201810;942;2569;681;2138;156;515;248;776;404;1291
522020;201810;5143;12695;3464;9955;835;2503;1448;4238;2283;6741
522026;201810;659;1850;505;1585;91;299;213;668;304;967
522028;201810;505;1367;360;1058;95;275;124;342;219;617
522040;201810;2950;6733;2090;5604;275;793;1388;3659;1663;4452
522045;201810;16391;48305;12351;40497;3056;10620;2877;9161;5933;19781
522050;201810;1056;2886;723;2291;160;548;263;787;423;1335
522060;201810;2475;6938;1996;6213;277;927;1127;3608;1404;4535
522068;201810;1720;4771;1407;4382;178;526;985;3156;1163;3682
522070;201810;592;1591;489;1422;38;142;360;988;398;1130
522100;201810;595;1606;428;1331;70;232;220;676;290;908
522108;201810;899;2490;709;2184;47;212;563;1651;610;1863
522119;201810;1550;4061;1204;3596;199;615;625;1931;824;2546
522130;201810;385;980;278;834;58;190;141;435;199;625
522140;201810;16080;43933;11821;36329;3510;11456;2146;6388;5656;17844
522145;201810;839;2106;615;1773;152;397;302;941;454;1338
522150;201810;924;2281;698;1943;220;592;223;669;443;1261
522155;201810;895;2389;698;2051;149;430;313;926;462;1356
522157;201810;550;1455;475;1347;25;89;361;1001;386;1090
522160;201810;5869;15731;3931;12102;1096;3648;306;1028;1402;4676
522170;201810;2519;6730;1834;5593;465;1463;729;2243;1194;3706
522180;201810;453;1158;294;875;62;186;37;131;99;317
522185;201810;16033;41477;12178;36358;5210;16751;2733;8927;7943;25678
522190;201810;739;1797;545;1505;103;281;212;609;315;890
522200;201810;1704;5107;1093;3745;200;724;108;343;308;1067
522205;201810;1581;3826;1218;3311;123;358;840;2274;963;2632
522220;201810;1308;3442;1002;2982;165;471;523;1598;688;2069
522230;201810;1182;3159;991;2876;189;615;553;1581;742;2196
530010;201810;159648;465416;137155;428153;28420;97862;70228;214029;98648;311891
110001;201811;3632;10716;2615;8782;680;2443;997;3301;1677;5744
110002;201811;11094;30095;8037;24830;2432;7978;2545;7880;4977;15858
110003;201811;647;1935;467;1546;125;447;95;300;220;747
110004;201811;9138;26015;6459;20867;1726;5864;1591;5377;3317;11241
110005;201811;2380;6425;1477;4701;381;1291;426;1455;807;2746
110006;201811;1757;4983;1093;3598;256;919;162;521;418;1440
110007;201811;1087;3124;822;2675;317;1071;239;873;556;1944
110008;201811;2662;8221;2228;7546;301;974;1579;5586;1880;6560
110009;201811;3971;11483;2612;8986;777;2758;847;3036;1624;5794
110010;201811;6173;21122;4953;18848;1268;4699;2247;9526;3515;14225
110011;201811;6220;17566;4563;14482;1616;5264;818;2682;2434;7946
110012;201811;13470;35750;8787;27306;2295;7397;1144;3736;3439;11133
110013;201811;5140;15645;4071;13494;1697;5783;611;2261;2308;8044
110014;201811;3654;10009;2592;8028;737;2331;989;3036;1726;5367
110015;201811;4936;13538;2821;9178;749;2635;421;1231;1170;3866
110018;201811;3312;8814;2045;6569;506;1830;513;1550;1019;3380
110020;201811;70172;176796;48947;146726;11024;34271;19432;62359;30456;96630
110025;201811;4693;12000;3146;9253;725;2252;1428;4063;2153;6315
110026;201811;479;1382;372;1213;113;388;140;440;253;828
110028;201811;5853;16134;3886;12353;1099;3721;566;1764;1665;5485
110029;201811;1332;3322;788;2427;190;591;321;997;511;1588
110030;201811;11920;29350;8010;23574;1627;5523;2620;7835;4247;13358
110032;201811;2917;8757;2064;6915;713;2425;493;1664;1206;4089
110033;201811;3937;12758;3178;11286;1148;4132;795;3113;1943;7245
110034;201811;3344;8399;2316;6927;734;2360;939;2859;1673;5219
110037;201811;1572;5071;1266;4459;325;1159;581;2029;906;3188
110040;201811;2865;8424;2127;7040;648;2291;545;1729;1193;4020
110045;201811;4842;14603;3862;12868;1113;4020;1426;4749;2539;8769
110050;201811;1660;4958;1240;4110;520;1795;245;809;765;2604
110060;201811;786;2422;556;1926;213;781;55;183;268;964
110070;201811;1817;5845;1425;4931;481;1760;301;942;782;2702
110080;201811;5655;13890;4221;12162;617;1683;2787;8490;3404;10173
110090;201811;592;1642;409;1306;115;382;152;479;267;861
110092;201811;1138;3475;871;2971;144;501;462;1650;606;2151
110094;201811;2871;8675;2229;7515;787;2761;571;2043;1358;4804
110100;201811;1739;5393;1455;4787;358;1243;676;2211;1034;3454
110110;201811;1664;4846;1184;3958;402;1403;240;851;642;2254
110120;201811;1286;3920;975;3269;281;976;260;862;541;1838
110130;201811;2570;6778;1609;4973;369;1260;536;1620;905;2880
110140;201811;2075;6581;1520;5389;413;1523;378;1363;791;2886
110143;201811;1312;3670;917;2878;319;1004;206;663;525;1667
110145;201811;939;2617;599;1952;159;553;186;609;345;1162
110146;201811;441;1224;309;1012;65;203;148;519;213;722
110147;201811;745;1995;468;1420;81;242;179;486;260;728
110148;201811;834;2484;505;1741;110;418;49;174;159;592
110149;201811;2842;8260;2085;7036;836;2807;491;1812;1327;4619
110150;201811;2281;6157;1601;5152;609;2148;453;1442;1062;3590
110155;201811;651;2016;514;1701;127;442;174;544;301;986
110160;201811;1512;4792;1125;3919;391;1360;243;889;634;2249
110170;201811;2205;5927;1403;4334;272;886;698;2080;970;2966
110175;201811;1468;4314;1098;3705;204;719;515;1823;719;2542
110180;201811;1246;3569;882;2815;209;673;374;1195;583;1868
120001;201811;3566;12219;3130;11584;452;1524;2160;8459;2612;9983
120005;201811;1879;7271;1688;6947;168;750;1300;5463;1468;6213
120010;201811;5217;16391;4463;15143;626;2057;3010;10509;3636;12566
120013;201811;2110;7977;1981;7793;528;2007;1125;4708;1653;6715
120017;201811;2102;7183;1903;6860;343;1286;1140;4303;1483;5589
120020;201811;14185;59202;13310;57397;1325;6197;10039;44064;11364;50261
120025;201811;2769;8484;2333;7924;459;1580;1492;5199;1951;6779
120030;201811;6415;25732;6158;25284;422;2224;5003;20522;5425;22746
120032;201811;1656;7622;1580;7440;98;610;1259;5887;1357;6497
120033;201811;3943;14988;3703;14557;147;780;3180;12439;3327;13219
120034;201811;2493;9396;2171;8784;128;735;1735;6897;1863;7632
120035;201811;3494;14574;3337;14269;324;1475;2640;11508;2964;12983
120038;201811;2646;8878;2322;8309;608;2291;1149;4150;1757;6441
120039;201811;1936;8696;1832;8485;169;1029;1395;6437;1564;7466
120040;201811;41393;138230;36896;130505;6490;24185;21952;78683;28442;102868
120042;201811;3258;12634;3007;12103;188;988;2357;9434;2545;10422
120043;201811;1302;5591;1229;5438;68;406;1068;4702;1136;5108
120045;201811;5639;15973;5047;15304;160;643;4611;13838;4771;14481
120050;201811;8701;32675;8089;31679;581;2804;6486;25547;7067;28351
120060;201811;8777;35814;8248;34942;437;2470;7104;30078;7541;32548
120070;201811;2961;9939;2644;9483;296;1102;1841;6854;2137;7956
120080;201811;4180;14388;3779;13712;597;2316;2518;9239;3115;11555
130002;201811;3153;12701;2876;12318;124;654;2546;10941;2670;11595
130006;201811;2322;8971;1914;8234;160;790;1436;6137;1596;6927
130008;201811;2515;9075;2262;8665;76;398;1889;7230;1965;7628
130010;201811;3896;11357;3353;10739;69;232;3125;10094;3194;10326
130014;201811;2935;9160;2376;8196;445;1554;1471;5183;1916;6737
130020;201811;2678;10639;2456;10269;145;876;1955;8096;2100;8972
130030;201811;9397;31686;8597;30786;213;866;7835;28313;8048;29179
130040;201811;3724;11400;3162;10635;174;622;2539;8615;2713;9237
130050;201811;7384;27419;6248;25951;225;1052;5608;23511;5833;24563
130060;201811;7169;29631;6250;28360;543;3155;4881;21997;5424;25152
130063;201811;5911;20168;5329;19490;125;564;4958;18199;5083;18763
130068;201811;3340;13097;2931;12309;218;1214;2207;9145;2425;10359
130070;201811;8054;24496;6898;23201;314;1044;5945;20365;6259;21409
130080;201811;6603;25847;5930;24969;337;1959;4862;20582;5199;22541
130083;201811;2542;9018;2316;8731;192;859;1885;7048;2077;7907
130090;201811;3395;10837;3053;10379;57;247;2651;9223;2708;9470
130100;201811;7295;23029;6406;22070;94;271;6033;21219;6127;21490
130110;201811;8096;23622;6832;22063;796;2183;5381;18170;6177;20353
130115;201811;5395;17332;4735;16537;107;433;4158;14697;4265;15130
130120;201811;14418;52995;13216;51415;1324;5471;10684;42070;12008;47541
130130;201811;5042;17055;4052;15754;461;2057;3022;11705;3483;13762
130140;201811;6722;24975;6340;24536;263;1308;5648;21870;5911;23178
130150;201811;3588;13834;3417;13617;108;676;3100;12282;3208;12958
130160;201811;4949;18442;4351;17641;335;1577;3569;14690;3904;16267
130165;201811;3024;11996;2891;11785;112;606;2556;10400;2668;11006
130170;201811;11572;35032;9575;32611;692;2744;7942;27150;8634;29894
130180;201811;4480;14371;4238;14083;49;246;4088;13539;4137;13785
130185;201811;17606;44453;14431;41050;729;1439;12667;37425;13396;38864
130190;201811;18358;61808;15345;57312;1950;7375;10768;41507;12718;48882
130195;201811;2319;8802;1929;8282;75;402;1708;7338;1783;7740
130200;201811;2406;7231;2033;6714;136;508;1619;5382;1755;5890
130210;201811;1352;5156;1216;4994;107;645;959;3830;1066;4475
130220;201811;2087;7879;1912;7593;96;500;1586;6289;1682;6789
130230;201811;4157;18253;3756;17660;330;1938;3056;14389;3386;16327
130240;201811;10892;34963;9117;32486;241;1356;7978;28325;8219;29681
130250;201811;25438;78191;22411;74754;1679;5357;18406;63573;20085;68930
130255;201811;4175;14530;3743;13748;211;958;2977;10896;3188;11854
130260;201811;245753;730795;207601;672227;59835;206585;90269;295892;150104;502477
130270;201811;8595;32405;7401;30492;1226;5193;4918;20980;6144;26173
130280;201811;3494;14220;3263;13962;130;613;2993;13001;3123;13614
130290;201811;13001;44120;11524;42329;513;2009;10241;38168;10754;40177
130300;201811;4626;16833;4273;16299;196;1018;3651;13804;3847;14822
130310;201811;5635;20408;5090;19635;406;1654;4135;16216;4541;17870
130320;201811;3348;11200;2909;10642;294;1040;2215;8342;2509;9382
130330;201811;4470;14641;3748;13744;202;926;3199;11716;3401;12642
130340;201811;21466;72436;18939;69491;1574;5452;15719;59408;17293;64860
130350;201811;3860;14414;3527;13969;159;901;3048;11950;3207;12851
130353;201811;6447;19003;5451;17710;847;2661;3752;12617;4599;15278
130356;201811;4898;16772;4259;15710;599;2234;2849;10835;3448;13069
130360;201811;3223;9605;2768;9096;69;203;2584;8577;2653;8780
130370;201811;5721;22260;5113;21448;278;1440;4370;18288;4648;19728
130380;201811;7416;31134;7015;30520;470;2656;5908;25351;6378;28007
130390;201811;5861;24896;5191;23701;572;3086;3716;16850;4288;19936
130395;201811;2362;7721;2052;7173;254;950;1448;5024;1702;5974
130400;201811;2646;8702;2301;8217;129;455;2014;7283;2143;7738
130406;201811;10867;40268;9538;38448;1914;7998;6282;25833;8196;33831
130410;201811;4045;14797;3532;13920;1079;4422;1650;6715;2729;11137
130420;201811;12738;47544;11177;45589;1098;5460;8811;35850;9909;41310
130423;201811;3999;13286;3580;12765;173;887;3167;11073;3340;11960
130426;201811;2848;11206;2731;11026;98;487;2516;10194;2614;10681
130430;201811;4015;12287;3575;11643;374;1343;2805;9036;3179;10379
130440;201811;4586;14705;4056;14077;94;370;3759;13139;3853;13509
140002;201811;2024;6145;1780;5813;107;438;1445;4618;1552;5056
140005;201811;3311;9157;3066;8877;129;425;2760;7987;2889;8412
140010;201811;53639;144681;42146;127605;10909;34837;16224;50969;27133;85806
140015;201811;3316;11003;2971;10579;246;867;2487;9044;2733;9911
140017;201811;3712;11225;3287;10660;353;1087;2407;8146;2760;9233
140020;201811;5123;15606;4384;14599;339;1438;3376;11186;3715;12624
140023;201811;2260;7015;1860;6428;249;921;1287;4493;1536;5414
140028;201811;2127;5518;1810;5108;151;493;1385;3807;1536;4300
140030;201811;4490;12504;4008;11909;357;923;3268;9995;3625;10918
140040;201811;2153;9147;1978;8877;134;814;1675;7360;1809;8174
140045;201811;2565;9684;2177;9114;417;1711;1383;6124;1800;7835
140047;201811;5985;17796;5120;16473;821;2826;3320;10782;4141;13608
140050;201811;1381;4134;1180;3835;133;443;823;2708;956;3151
140060;201811;1559;4287;1324;3931;111;333;1046;3155;1157;3488
140070;201811;1843;9856;1775;9667;153;1048;1381;7424;1534;8472
150010;201811;43076;111060;39635;106456;1120;3277;35195;93751;36315;97028
150013;201811;1900;5106;1578;4739;148;379;1194;3790;1342;4169
150020;201811;13882;42994;13096;41964;1195;2953;11039;36592;12234;39545
150030;201811;8753;33445;8027;32531;414;1911;7044;28702;7458;30613
150034;201811;4227;11040;3575;10178;262;756;2923;8407;3185;9163
150040;201811;15216;40811;13283;38610;1394;2616;10795;33992;12189;36608
150050;201811;6691;24110;6185;23371;142;707;5664;21502;5806;22209
150060;201811;20187;57466;16958;52624;3137;9711;10185;32552;13322;42263
150070;201811;6429;25037;5794;24257;193;1030;5248;22214;5441;23244
150080;201811;82771;203563;69211;185211;16396;45352;27191;82039;43587;127391
150085;201811;6632;20636;6095;19960;215;684;5607;18514;5822;19198
150090;201811;10025;37721;9465;36697;664;2824;7633;29665;8297;32489
150095;201811;5551;17001;4953;16194;307;815;4070;13800;4377;14615
150100;201811;3004;10683;2677;10104;202;760;2055;7830;2257;8590
150110;201811;4038;17836;3927;17692;229;1116;3525;15966;3754;17082
150120;201811;7400;24606;7171;24281;323;875;6369;22233;6692;23108
150125;201811;735;2071;572;1851;119;438;334;1059;453;1497
150130;201811;22990;67631;20198;63491;2782;7870;14348;46815;17130;54685
150140;201811;212744;527621;185024;488993;30862;80366;109616;301440;140478;381806
150145;201811;4587;13753;3931;12843;805;2369;2593;9026;3398;11395
150150;201811;14788;39702;13190;37641;938;2773;10568;30364;11506;33137
150157;201811;3317;9392;2764;8663;306;1057;1932;6200;2238;7257
150160;201811;2942;9126;2764;8819;699;2185;1499;4973;2198;7158
150170;201811;24309;80700;21120;75438;3899;13285;12736;48484;16635;61769
150172;201811;4251;12360;3495;11267;303;861;2552;8541;2855;9402
150175;201811;1721;5354;1481;4913;222;781;952;3229;1174;4010
150178;201811;10157;28953;8521;27014;392;1227;7208;23256;7600;24483
150180;201811;20493;77094;19103;75311;1042;4206;16620;66539;17662;70745
150190;201811;6921;23529;6524;23013;291;1250;5726;20123;6017;21373
150195;201811;5496;17615;5217;17190;103;473;4814;15747;4917;16220
150200;201811;5286;16226;4865;15759;55;166;4627;15105;4682;15271
150210;201811;24895;90427;23488;88508;1937;7254;19070;73897;21007;81151
150215;201811;6934;20873;6018;19519;1571;5046;2977;10242;4548;15288
150220;201811;11456;34206;10213;32319;1592;4958;6309;20504;7901;25462
150230;201811;12399;36101;10749;33868;1376;4156;7307;23979;8683;28135
150240;201811;31847;91398;26336;81578;8391;26431;7488;23697;15879;50128
150250;201811;4096;16607;3907;16341;587;2492;2945;12539;3532;15031
150260;201811;2482;8658;2305;8368;217;771;1736;6397;1953;7168
150270;201811;8325;24293;6084;20819;2039;7239;1998;7166;4037;14405
150275;201811;6590;21853;6117;21135;314;1188;5163;17771;5477;18959
150276;201811;2245;6291;1935;5914;263;743;1372;4476;1635;5219
150277;201811;5078;13842;4218;12829;1536;4788;2134;6821;3670;11609
150280;201811;6349;26710;6192;26405;549;2308;5064;21860;5613;24168
150285;201811;3194;11531;2846;10996;329;1373;1978;7771;2307;9144
150290;201811;10805;29357;9974;28443;411;946;8965;26174;9376;27120
150293;201811;9794;24578;7161;21056;1502;4480;3573;11321;5075;15801
150295;201811;7853;21575;5832;18932;2059;7332;2028;7130;4087;14462
150300;201811;2150;6840;1944;6555;56;268;1702;5709;1758;5977
150304;201811;4049;12501;3394;11390;618;1987;2102;7340;2720;9327
150307;201811;6302;20464;5885;19819;448;1391;4765;16331;5213;17722
150309;201811;6048;19086;5006;17285;1094;3678;2591;9419;3685;13097
150310;201811;7174;28594;6822;28148;260;1464;5980;24827;6240;26291
150320;201811;9407;25642;8594;24529;490;1482;6778;19297;7268;20779
150330;201811;14003;46066;12969;44311;1666;5620;9411;32963;11077;38583
150340;201811;2648;7854;2377;7450;360;1100;1644;5240;2004;6340
150345;201811;7714;23201;6996;22264;452;1522;5896;18918;6348;20440
150350;201811;8872;24028;8158;23123;907;1901;6572;19397;7479;21298
150360;201811;23399;67149;19030;61527;2310;6832;13060;44198;15370;51030
150370;201811;9873;32557;8491;30598;994;3333;6132;23240;7126;26573
150375;201811;3231;13596;2929;13128;296;1442;2320;10478;2616;11920
150380;201811;10385;27997;8733;25756;292;976;7542;22308;7834;23284
150390;201811;7740;32241;7080;31135;1166;4770;4819;22295;5985;27065
150400;201811;6212;23029;5972;22563;284;1156;5088;19295;5372;20451
150405;201811;9131;24721;8117;23456;540;1209;6515;19550;7055;20759
150410;201811;1833;6114;1588;5677;226;774;1009;3714;1235;4488
150420;201811;36144;107814;27831;94886;9211;32741;8044;31684;17255;64425
150430;201811;8207;24943;7656;24167;855;2187;5993;19704;6848;21891
150440;201811;5624;18538;5300;18047;510;1590;4161;14459;4671;16049
150442;201811;24128;62284;20329;57081;2484;6782;13397;38705;15881;45487
150445;201811;6013;19256;5403;18289;262;930;4535;15432;4797;16362
150450;201811;4876;21677;4594;21269;379;1874;3844;17942;4223;19816
150460;201811;8162;27407;7588;26635;242;1021;6596;23865;6838;24886
150470;201811;18695;52995;17668;51775;862;2231;15851;46966;16713;49197
150475;201811;4367;14564;3927;13878;195;731;3270;11707;3465;12438
150480;201811;13775;45986;12361;43764;2241;7465;8300;30942;10541;38407
150490;201811;8051;28686;7577;28074;251;1153;6716;24994;6967;26147
150495;201811;5149;18310;4999;18103;112;530;4608;16668;4720;17198
150497;201811;2737;9119;2232;8184;587;2254;1049;4044;1636;6298
150500;201811;3303;8708;2932;8133;323;816;2236;6255;2559;7071
150503;201811;4453;12476;3233;10759;1040;3605;1081;3959;2121;7564
150506;201811;9806;31866;8682;30264;1879;5929;5539;20870;7418;26799
150510;201811;9895;36852;8663;34421;1274;4907;5694;23701;6968;28608
150520;201811;7349;27774;7036;27381;211;1115;6451;25075;6662;26190
150530;201811;12363;42530;10886;40299;1674;5192;7724;30281;9398;35473
150540;201811;4871;13796;4190;12781;163;494;3568;10863;3731;11357
150543;201811;6948;19276;5695;17614;899;2869;3833;12387;4732;15256
150548;201811;9893;31390;8983;30159;346;1173;7939;26755;8285;27928
150549;201811;2029;6225;1766;5888;51;213;1557;5185;1608;5398
150550;201811;19123;58543;16368;53902;4267;14362;7177;24923;11444;39285
150553;201811;23043;72727;18405;63965;6372;22801;5222;19931;11594;42732
150555;201811;1796;5023;1443;4446;135;381;991;3100;1126;3481
150560;201811;1817;5717;1622;5326;295;926;903;3063;1198;3989
150563;201811;2449;7819;2139;7252;466;1693;1150;3884;1616;5577
150565;201811;4219;13865;3746;13080;98;488;3128;10941;3226;11429
150570;201811;6176;20857;5914;20442;310;1211;4995;17208;5305;18419
150580;201811;10182;41853;9251;40805;680;3333;7637;34436;8317;37769
150590;201811;7207;26544;6618;25770;216;1163;5992;23238;6208;24401
150600;201811;9047;31360;8454;30598;256;1106;7689;27898;7945;29004
150610;201811;2655;8228;2373;7707;138;510;1911;6130;2049;6640
150611;201811;2967;8915;2684;8473;124;495;2318;7229;2442;7724
150613;201811;13191;37183;10041;31748;2059;6837;4642;14909;6701;21746
150616;201811;3274;9244;2421;7816;595;2035;886;2792;1481;4827
150618;201811;6751;20569;5574;18654;723;2367;3422;11970;4145;14337
150619;201811;5935;17782;4982;16322;267;1021;3942;12874;4209;13895
150620;201811;6483;21888;5688;20699;867;3081;3926;14662;4793;17743
150630;201811;6200;17237;5720;16646;408;1170;4803;14154;5211;15324
150635;201811;4493;13084;3888;12047;649;2039;2314;7269;2963;9308
150640;201811;2194;6388;2015;6180;34;110;1879;5838;1913;5948
150650;201811;11593;33365;10266;31064;3201;9248;4396;14318;7597;23566
150655;201811;5728;16871;5242;16121;239;743;4477;13763;4716;14506
150658;201811;4339;12581;3560;11435;702;2377;2078;6961;2780;9338
150660;201811;5718;16763;5174;15995;571;1741;3576;11244;4147;12985
150670;201811;8081;19643;6373;17643;714;1632;4939;14325;5653;15957
150680;201811;65079;200849;50351;176938;13063;45792;21678;85031;34741;130823
150690;201811;2492;6751;2222;6384;122;313;1884;5487;2006;5800
150700;201811;6272;18978;5669;18210;446;1314;4481;14743;4927;16057
150710;201811;3795;12803;3469;12269;265;1003;2661;9466;2926;10469
150715;201811;5144;15654;4385;14437;376;1168;3451;11563;3827;12731
150720;201811;6472;24596;6122;23973;456;2051;5002;19615;5458;21666
150730;201811;11328;36045;9960;33905;1140;4057;7427;25744;8567;29801
150740;201811;3713;10961;3314;10268;423;1225;2294;7237;2717;8462
150745;201811;5070;14966;4219;13711;881;3047;2674;8712;3555;11759
150746;201811;1558;4989;1443;4795;95;309;1171;3921;1266;4230
150747;201811;4999;16110;4440;15221;829;2535;2809;10215;3638;12750
150750;201811;3584;11407;3068;10605;231;864;2349;8301;2580;9165
150760;201811;11872;35412;10885;34139;1401;4134;8003;25713;9404;29847
150770;201811;6200;22785;5911;22400;201;621;5435;21169;5636;21790
150775;201811;933;2726;744;2432;134;494;406;1306;540;1800
150780;201811;4482;13630;4118;13185;104;341;3784;12244;3888;12585
150790;201811;5471;16322;4819;15599;245;683;3949;13889;4194;14572
150795;201811;13774;44569;12475;42389;3319;10809;6781;24462;10100;35271
150796;201811;3520;9286;3070;8743;188;525;2573;7418;2761;7943
150797;201811;3924;12545;3406;11727;160;525;2809;9753;2969;10278
150800;201811;13162;42279;12171;41044;1744;5453;9022;31576;10766;37029
150803;201811;6760;23054;6360;22410;426;1540;5376;18983;5802;20523
150805;201811;3272;10585;2799;9824;325;1171;2073;7322;2398;8493
150808;201811;5821;17554;4361;14948;1625;6068;554;2090;2179;8158
150810;201811;20358;56601;15735;50818;2826;9061;8881;30972;11707;40033
150812;201811;5360;15588;4785;14557;478;1555;3493;10391;3971;11946
150815;201811;8923;27956;7729;26428;777;2653;6015;20892;6792;23545
150820;201811;12125;33093;10168;30759;999;2614;7930;24873;8929;27487
150830;201811;11649;43915;11032;43159;392;2074;9560;38103;9952;40177
150835;201811;2177;7552;1952;7146;423;1535;965;3600;1388;5135
150840;201811;7305;21695;5885;19149;1233;4214;2966;9615;4199;13829
160005;201811;1177;3276;1071;3122;25;114;999;2868;1024;2982
160010;201811;2358;6165;2298;6103;14;53;2249;5942;2263;5995
160015;201811;2326;7525;2125;7248;94;354;1926;6581;2020;6935
160020;201811;1968;6763;1777;6487;235;852;1328;4930;1563;5782
160021;201811;1090;4362;1017;4250;83;473;808;3302;891;3775
160023;201811;1214;4484;1082;4273;132;490;747;3122;879;3612
160025;201811;1912;5430;1862;5370;16;58;1827;5268;1843;5326
160027;201811;8744;24583;7953;23642;616;1747;6557;19877;7173;21624
160030;201811;58110;176071;48237;162780;11064;35329;25450;94876;36514;130205
160040;201811;5176;18518;4707;17882;99;568;4322;16425;4421;16993
160050;201811;4409;14286;3597;13083;1549;5437;1136;5090;2685;10527
160053;201811;3470;11687;3252;11404;334;1102;2591;9328;2925;10430
160055;201811;722;2460;706;2442;29;115;650;2244;679;2359
160060;201811;22520;63398;18952;59287;1202;3704;15299;49569;16501;53273
160070;201811;2945;11242;2675;10785;207;900;2111;8705;2318;9605
160080;201811;2943;10160;2753;9932;69;334;2493;9012;2562;9346
170025;201811;613;1698;461;1480;105;323;224;744;329;1067
170030;201811;1178;3735;942;3261;168;587;451;1596;619;2183
170035;201811;1454;3824;1052;3153;117;377;592;1787;709;2164
170040;201811;1800;5346;1475;4898;116;428;833;2890;949;3318
170070;201811;1635;3993;1187;3413;128;413;685;1998;813;2411
170100;201811;2454;7117;2029;6374;216;631;1325;4220;1541;4851
170105;201811;727;2177;511;1701;129;392;169;575;298;967
170110;201811;924;2952;726;2568;114;413;348;1227;462;1640
170130;201811;1332;4089;953;3328;176;644;477;1722;653;2366
170190;201811;1392;4033;961;3330;337;1130;181;837;518;1967
170200;201811;1743;4415;1058;3211;279;910;241;704;520;1614
170210;201811;24848;69304;18912;59282;6671;22766;1950;7031;8621;29797
170215;201811;1320;3679;1106;3377;64;256;824;2477;888;2733
170220;201811;5850;18451;4994;16809;1198;3816;2436;8808;3634;12624
170230;201811;1233;3788;956;3222;246;857;215;740;461;1597
170240;201811;2622;7517;2070;6612;187;735;1373;4255;1560;4990
170255;201811;3959;11776;2761;9456;536;1927;1237;4346;1773;6273
170270;201811;1043;2535;670;2013;33;99;423;1251;456;1350
170290;201811;3022;8696;2576;8174;137;357;2088;6929;2225;7286
170300;201811;1864;5378;1567;4895;181;572;1003;3191;1184;3763
170305;201811;728;2123;573;1815;86;311;274;835;360;1146
170307;201811;953;3340;768;2956;119;459;408;1601;527;2060
170310;201811;1628;4230;1118;3354;207;678;500;1512;707;2190
170320;201811;974;2612;735;2239;82;248;444;1358;526;1606
170330;201811;863;2730;785;2601;53;225;617;1986;670;2211
170360;201811;459;1319;335;1105;52;187;199;617;251;804
170370;201811;1313;3599;964;3011;202;630;408;1337;610;1967
170380;201811;1797;5379;1356;4658;185;651;707;2545;892;3196
170382;201811;546;1692;451;1524;56;223;299;980;355;1203
170384;201811;1491;5684;1266;5215;326;1412;547;2254;873;3666
170386;201811;793;2246;501;1657;74;291;135;401;209;692
170388;201811;629;1831;450;1492;59;221;203;670;262;891
170389;201811;1115;3801;966;3538;45;194;774;2878;819;3072
170390;201811;1625;3869;1195;3342;79;208;931;2683;1010;2891
170410;201811;552;1651;400;1366;22;99;255;837;277;936
170460;201811;368;1014;294;886;46;139;172;524;218;663
170510;201811;857;2662;641;2222;56;257;382;1252;438;1509
170550;201811;6464;17680;4563;14425;1349;4563;843;2840;2192;7403
170555;201811;1342;3767;1057;3306;84;281;560;1812;644;2093
170560;201811;1046;3024;788;2653;88;335;441;1626;529;1961
170600;201811;1378;3871;1115;3468;243;650;627;2111;870;2761
170610;201811;1759;4843;1288;4084;82;296;797;2472;879;2768
170625;201811;438;1215;281;882;32;97;86;260;118;357
170650;201811;1257;3854;982;3358;190;651;439;1589;629;2240
170700;201811;3434;10260;2632;8798;608;2163;1048;3577;1656;5740
170710;201811;1497;4198;1169;3610;192;667;637;1923;829;2590
170720;201811;1893;4850;1512;4293;63;123;1269;3718;1332;3841
170730;201811;1006;2883;763;2482;174;566;323;1086;497;1652
170740;201811;2038;7038;1736;6428;224;853;1127;4191;1351;5044
170755;201811;876;2535;613;2022;69;253;295;954;364;1207
170765;201811;1237;3271;847;2654;209;673;321;1064;530;1737
170770;201811;1764;5426;1510;5005;202;642;975;3313;1177;3955
170820;201811;3475;11162;2919;10082;507;1804;1512;5313;2019;7117
170825;201811;958;2272;753;1993;83;223;505;1344;588;1567
170830;201811;1382;3821;1144;3433;23;75;953;2866;976;2941
170900;201811;2626;8747;2269;8181;182;708;1774;6473;1956;7181
170930;201811;3676;10434;2890;9004;678;2272;1130;3499;1808;5771
170950;201811;11051;31437;7750;25389;2275;8445;1088;3728;3363;12173
170980;201811;436;1256;352;1114;25;117;234;697;259;814
171050;201811;1539;5044;1365;4727;66;319;1081;3678;1147;3997
171070;201811;1330;3985;1147;3701;262;795;626;2220;888;3015
171090;201811;1056;2639;864;2365;69;174;614;1678;683;1852
171110;201811;572;1600;410;1300;79;276;172;492;251;768
171150;201811;1062;2745;649;2004;78;278;403;1226;481;1504
171180;201811;738;2105;493;1603;85;266;189;648;274;914
171190;201811;1588;5676;1409;5339;229;889;841;3259;1070;4148
171195;201811;819;2742;690;2495;132;514;389;1413;521;1927
171200;201811;531;1558;404;1329;84;303;171;552;255;855
171215;201811;401;1148;308;975;56;187;172;525;228;712
171240;201811;742;2557;616;2301;46;235;385;1429;431;1664
171245;201811;634;1970;487;1648;69;256;259;848;328;1104
171250;201811;1084;2898;799;2443;199;656;366;1104;565;1760
171270;201811;388;1503;328;1358;74;304;139;638;213;942
171280;201811;838;2596;652;2267;136;453;303;1143;439;1596
171320;201811;3970;11348;3092;9786;576;1793;1349;4500;1925;6293
171330;201811;2662;7432;2058;6379;485;1481;934;3017;1419;4498
171360;201811;1419;4280;1184;3936;85;329;903;3003;988;3332
171370;201811;691;1815;537;1602;61;191;368;1112;429;1303
171380;201811;1432;4098;1176;3693;127;424;803;2529;930;2953
171395;201811;917;2693;633;2112;74;286;337;1086;411;1372
171420;201811;1860;5716;1366;4694;238;918;595;2035;833;2953
171430;201811;1018;3049;819;2639;82;302;553;1711;635;2013
171488;201811;2368;7124;1864;6294;299;1035;955;3329;1254;4364
171500;201811;950;2509;724;2151;50;159;544;1615;594;1774
171510;201811;762;2654;686;2501;44;197;479;1745;523;1942
171515;201811;465;1286;345;1079;28;113;210;627;238;740
171525;201811;645;1956;525;1748;37;173;312;963;349;1136
171550;201811;336;1005;240;836;39;152;122;417;161;569
171570;201811;1136;3512;956;3180;170;532;540;1866;710;2398
171575;201811;1841;4967;1162;3702;181;623;464;1435;645;2058
171610;201811;5583;16068;4181;13657;987;3481;1137;3973;2124;7454
171620;201811;2738;7739;2310;7141;164;617;1812;5587;1976;6204
171630;201811;955;2647;780;2393;140;450;486;1528;626;1978
171650;201811;2086;6157;1539;5122;394;1366;484;1724;878;3090
171660;201811;2369;6221;1645;4949;268;775;860;2619;1128;3394
171665;201811;1339;3814;1019;3297;181;643;476;1573;657;2216
171670;201811;1803;4970;1393;4288;209;737;768;2301;977;3038
171700;201811;1184;3473;877;2918;121;399;485;1609;606;2008
171720;201811;818;2204;630;1896;46;167;453;1346;499;1513
171750;201811;1237;3579;883;2921;225;775;129;516;354;1291
171780;201811;1238;3254;902;2769;66;246;625;1869;691;2115
171790;201811;1408;4863;1127;4220;261;964;482;1904;743;2868
171800;201811;720;2056;543;1783;68;249;298;974;366;1223
171820;201811;10708;30811;8046;26075;1951;6631;2635;9057;4586;15688
171830;201811;1444;4979;1228;4532;123;551;785;2850;908;3401
171840;201811;739;1967;579;1715;39;122;412;1207;451;1329
171845;201811;641;1666;476;1427;67;236;262;794;329;1030
171850;201811;869;3013;748;2761;66;296;521;1876;587;2172
171855;201811;1082;3323;929;3046;92;311;582;1879;674;2190
171865;201811;370;1213;316;1126;54;207;154;525;208;732
171870;201811;758;2177;547;1777;60;212;287;970;347;1182
171875;201811;1228;3755;992;3360;62;253;726;2427;788;2680
171880;201811;1064;3422;956;3285;50;191;762;2673;812;2864
171884;201811;845;2274;608;1905;124;451;211;716;335;1167
171886;201811;1430;4131;1009;3380;294;1068;189;651;483;1719
171888;201811;757;2162;519;1699;47;147;315;1035;362;1182
171889;201811;440;1376;378;1260;74;269;171;561;245;830
171890;201811;1123;3189;849;2728;173;503;477;1596;650;2099
171900;201811;506;1797;368;1454;89;342;132;558;221;900
172000;201811;575;1784;476;1594;65;261;260;823;325;1084
172010;201811;1073;3780;923;3456;82;397;589;2128;671;2525
172015;201811;344;1252;259;1067;51;195;106;464;157;659
172020;201811;2366;7326;2150;7005;190;720;1610;5271;1800;5991
172025;201811;736;2094;541;1762;53;204;331;1053;384;1257
172030;201811;1230;3706;1067;3455;25;108;876;2825;901;2933
172049;201811;1319;3259;868;2580;262;831;399;1179;661;2010
172065;201811;1488;3765;1188;3403;89;198;1009;3014;1098;3212
172080;201811;2322;7081;1894;6288;131;508;1278;4227;1409;4735
172085;201811;490;1363;312;989;47;129;96;297;143;426
172090;201811;4020;10459;3114;9213;135;497;2390;7011;2525;7508
172093;201811;493;1507;368;1278;51;223;190;626;241;849
172097;201811;583;1599;426;1341;69;228;194;634;263;862
172100;201811;47317;120557;31865;95115;6832;22208;9824;30330;16656;52538
172110;201811;1569;5933;1367;5619;156;705;998;4235;1154;4940
172120;201811;4798;14747;3827;13147;631;2201;1989;7054;2620;9255
172125;201811;309;885;223;739;32;108;116;384;148;492
172130;201811;918;2908;786;2679;26;93;625;2158;651;2251
172208;201811;2431;6283;1958;5635;250;652;1270;3738;1520;4390
172210;201811;2718;7406;2099;6562;452;1484;1073;3369;1525;4853
210005;201811;19624;58265;15584;51593;4722;16289;5805;20134;10527;36423
210010;201811;1816;5893;1643;5622;49;227;1462;5010;1511;5237
210015;201811;3376;10156;3010;9650;135;333;2593;8486;2728;8819
210020;201811;7515;17187;6680;16241;102;251;6214;15113;6316;15364
210030;201811;4829;16131;4582;15780;293;1101;3928;13582;4221;14683
210040;201811;2169;5941;1960;5702;28;53;1845;5435;1873;5488
210043;201811;6493;17841;5344;16436;679;1986;3834;12314;4513;14300
210047;201811;6574;21643;5722;20457;219;1031;4953;17588;5172;18619
210050;201811;2173;7586;1731;6765;222;979;1124;4385;1346;5364
210055;201811;1821;6055;1668;5788;68;273;1371;4717;1439;4990
210060;201811;6964;26569;6206;25069;808;3364;4290;17804;5098;21168
210070;201811;7219;20713;6828;20245;32;116;6582;19621;6614;19737
210080;201811;4034;14172;3907;14007;35;197;3768;13507;3803;13704
210083;201811;5422;16184;4621;15314;76;414;4373;14373;4449;14787
210087;201811;2981;8357;2637;7901;155;383;2205;6810;2360;7193
210090;201811;9496;29905;9037;29112;308;1096;8064;25824;8372;26920
210095;201811;6386;20948;5937;20382;267;1033;4909;17628;5176;18661
210100;201811;6751;20448;6200;19601;254;928;5242;16531;5496;17459
210110;201811;2850;9112;2677;8881;32;156;2512;8322;2544;8478
210120;201811;23262;64644;19879;60356;2558;6542;13438;43587;15996;50129
210125;201811;4102;11764;3737;11293;787;1935;2662;8569;3449;10504
210130;201811;4241;11588;3622;10795;163;429;3086;9257;3249;9686
210135;201811;1457;4484;1290;4218;57;199;1062;3487;1119;3686
210140;201811;17287;49636;13980;45159;2898;9332;7754;25987;10652;35319
210150;201811;4539;11150;4071;10501;115;313;3627;9273;3742;9586
210160;201811;16197;49369;14674;47168;2745;9003;9403;31116;12148;40119
210170;201811;14518;47373;13773;46354;628;2165;12337;41595;12965;43760
210173;201811;2379;8898;2182;8566;62;359;2027;7908;2089;8267
210177;201811;3288;9432;3013;9089;100;190;2744;8550;2844;8740
210180;201811;1450;4076;1313;3883;40;113;1161;3433;1201;3546
210190;201811;4741;14198;4299;13418;96;478;3622;11016;3718;11494
210193;201811;1246;3785;1121;3587;51;166;895;2911;946;3077
210197;201811;2019;6637;1891;6460;184;630;1492;5212;1676;5842
210200;201811;7536;24906;6961;24009;650;2282;5558;19365;6208;21647
210203;201811;7082;21418;6303;20339;609;1923;5027;16537;5636;18460
210207;201811;3457;9893;3109;9439;161;423;2595;8053;2756;8476
210210;201811;8313;27153;7759;26412;108;638;7188;24358;7296;24996
210215;201811;2178;7222;1993;6964;64;310;1763;6135;1827;6445
210220;201811;6043;21333;5743;20808;232;1342;5023;17806;5255;19148
210230;201811;5205;16120;4759;15460;278;739;4137;13653;4415;14392
210232;201811;11441;36694;9515;33891;1543;5659;6136;23114;7679;28773
210235;201811;3560;10675;3134;10113;99;435;2775;8958;2874;9393
210237;201811;2514;8807;2310;8545;24;145;2185;8065;2209;8210
210240;201811;2694;8544;2464;8140;85;340;2143;7008;2228;7348
210250;201811;5550;17214;5108;16666;94;513;4594;14933;4688;15446
210255;201811;2580;8037;2227;7356;268;931;1511;4943;1779;5874
210260;201811;5286;16369;4692;15471;283;1036;3910;12830;4193;13866
210270;201811;4865;13666;4377;13017;104;493;3909;11514;4013;12007
210275;201811;3615;9105;3251;8650;58;137;3056;8206;3114;8343
210280;201811;5490;16229;4526;14728;240;1143;3318;10496;3558;11639
210290;201811;6716;19402;6169;18733;167;505;5568;16939;5735;17444
210300;201811;33788;92598;28370;85479;2356;6933;20979;66074;23335;73007
210310;201811;3046;7998;2713;7528;122;261;2366;6634;2488;6895
210312;201811;2654;7059;2357;6712;50;210;2179;6129;2229;6339
210315;201811;2923;8288;2495;7783;80;209;2231;7140;2311;7349
210317;201811;4051;12959;3731;12587;137;638;3390;11339;3527;11977
210320;201811;19018;60533;17767;58873;464;2192;16085;53071;16549;55263
210325;201811;3481;10361;3071;9781;92;305;2737;8842;2829;9147
210330;201811;26334;75183;21964;69445;6039;18029;10603;38464;16642;56493
210340;201811;10199;31156;9225;29690;911;2879;6889;22809;7800;25688
210350;201811;9345;27535;8352;26252;212;748;7334;23159;7546;23907
210355;201811;4416;15474;3923;14685;140;729;3333;12532;3473;13261
210360;201811;14382;43884;12924;41777;607;2524;10554;33817;11161;36341
210370;201811;10636;24051;8411;21666;295;559;7588;20021;7883;20580
210375;201811;3185;8903;2438;7881;713;2289;1087;3810;1800;6099
210380;201811;5488;14581;4893;13826;271;686;4197;11976;4468;12662
210390;201811;2608;9505;2431;9185;148;688;1983;7419;2131;8107
210400;201811;4583;14418;4189;13906;129;349;3818;12818;3947;13167
210405;201811;7073;19579;5764;17683;1120;3247;3217;10490;4337;13737
210407;201811;1956;6686;1634;6052;118;530;1291;4688;1409;5218
210408;201811;2430;9371;2287;9144;153;773;1830;7338;1983;8111
210409;201811;3704;13071;3395;12630;122;693;2817;10455;2939;11148
210410;201811;3463;10842;2980;10068;242;910;2193;7394;2435;8304
210420;201811;3989;12876;3602;12192;198;622;3024;10341;3222;10963
210430;201811;2220;6612;2077;6432;121;339;1802;5625;1923;5964
210440;201811;4188;11869;3886;11453;81;272;3651;10746;3732;11018
210450;201811;2486;7634;2228;7204;118;443;1831;5872;1949;6315
210455;201811;4054;10981;3194;9899;879;2678;1666;5346;2545;8024
210460;201811;3438;10453;3074;9950;99;400;2661;8575;2760;8975
210462;201811;1514;4974;1340;4647;47;212;1091;3748;1138;3960
210465;201811;2587;7779;2273;7338;91;308;1941;6286;2032;6594
210467;201811;5696;19024;5260;18489;306;1256;4572;16114;4878;17370
210470;201811;2133;5610;1474;4656;83;197;1116;3633;1199;3830
210480;201811;15450;47375;13122;44364;1439;4637;9476;33916;10915;38553
210490;201811;3769;9725;3087;8757;90;273;2678;7591;2768;7864
210500;201811;6028;24494;5677;23837;395;2055;4584;19044;4979;21099
210510;201811;5949;20502;5505;19981;113;542;4990;18305;5103;18847
210515;201811;3694;11019;3277;10562;109;384;2931;9555;3040;9939
210520;201811;2580;7471;2306;7125;100;330;2048;6329;2148;6659
210530;201811;48159;125337;39279;111779;6890;24365;11372;39744;18262;64109
210535;201811;3148;10759;2974;10487;106;400;2560;9126;2666;9526
210540;201811;14423;43224;12182;40160;1508;4709;8603;29564;10111;34273
210542;201811;6225;15673;5227;14555;304;532;4579;13346;4883;13878
210545;201811;2273;7128;2137;6905;52;218;1891;6018;1943;6236
210547;201811;3622;12973;3220;12169;316;1176;2302;8956;2618;10132
210550;201811;5960;18251;5011;16865;360;1286;3941;13560;4301;14846
210560;201811;3475;10863;3174;10340;118;382;2723;8806;2841;9188
210565;201811;1474;5089;1247;4740;76;391;967;3699;1043;4090
210570;201811;11168;30612;10014;29226;308;836;9042;26769;9350;27605
210580;201811;3034;8403;2636;7918;233;444;2120;6720;2353;7164
210590;201811;4280;12941;3765;12246;106;521;3329;10738;3435;11259
210592;201811;2574;7758;2413;7492;34;176;2160;6623;2194;6799
210594;201811;2537;6977;1985;6095;83;222;1520;4803;1603;5025
210596;201811;2378;8685;2211;8336;151;620;1756;6658;1907;7278
210598;201811;1841;5353;1705;5163;37;152;1583;4766;1620;4918
210600;201811;2978;8212;2431;7418;78;216;2003;6185;2081;6401
210610;201811;2479;7498;2235;7198;67;309;1980;6316;2047;6625
210620;201811;2448;7103;2102;6660;64;207;1919;6158;1983;6365
210630;201811;3098;10765;2823;10368;167;840;2310;8329;2477;9169
210632;201811;4253;14235;3858;13638;317;1289;3028;10626;3345;11915
210635;201811;1782;6328;1691;6166;133;440;1406;5253;1539;5693
210637;201811;2352;8093;2125;7745;168;728;1602;5875;1770;6603
210640;201811;5186;19756;5103;19664;39;181;4992;19255;5031;19436
210650;201811;7217;20912;6760;20306;89;351;6396;19166;6485;19517
210660;201811;8416;24555;7492;23122;334;1154;6448;19739;6782;20893
210663;201811;2559;7778;2415;7611;126;325;2132;6910;2258;7235
210667;201811;1881;6223;1769;6054;64;269;1588;5462;1652;5731
210670;201811;4437;15499;4109;14950;157;752;3576;12910;3733;13662
210675;201811;5082;14010;4448;13149;322;794;3658;11140;3980;11934
210680;201811;4095;10653;3463;9866;135;270;3057;8922;3192;9192
210690;201811;7506;24335;6818;23548;266;1111;6051;21061;6317;22172
210700;201811;2720;7501;2237;6877;145;375;1802;5903;1947;6278
210710;201811;4981;15733;4445;14941;130;619;3902;12977;4032;13596
210720;201811;2788;9403;2625;9192;52;283;2414;8369;2466;8652
210725;201811;1313;4555;1156;4295;48;222;813;3122;861;3344
210730;201811;1202;3252;1022;3009;84;212;798;2407;882;2619
210735;201811;4564;13949;3970;13103;299;1018;3298;11049;3597;12067
210740;201811;5268;14526;4651;13850;152;552;3943;11617;4095;12169
210745;201811;4498;12546;4219;12168;157;383;3812;11049;3969;11432
210750;201811;20825;53923;18098;50629;1609;4234;13442;38958;15051;43192
210760;201811;5779;16090;5168;15387;28;111;5000;14896;5028;15007
210770;201811;6051;15927;5266;15029;57;251;4927;14013;4984;14264
210780;201811;7211;23755;6483;22503;630;2009;5003;17754;5633;19763
210790;201811;4572;14565;4223;14113;221;664;3347;11859;3568;12523
210800;201811;4988;13416;4362;12600;74;284;3977;11358;4051;11642
210805;201811;3888;14578;3740;14346;111;626;3363;12795;3474;13421
210810;201811;4981;14891;4587;14380;221;501;4003;12956;4224;13457
210820;201811;7106;20596;6093;18928;862;2699;3816;12088;4678;14787
210825;201811;6506;20551;6087;19999;254;842;5337;17777;5591;18619
210830;201811;7731;22297;7317;21773;510;1094;6314;19543;6824;20637
210840;201811;3311;8850;2976;8378;84;241;2636;7329;2720;7570
210845;201811;6351;17603;5930;17141;24;67;5845;16938;5869;17005
210850;201811;5714;20003;5053;18960;316;1513;3971;14806;4287;16319
210860;201811;18900;51899;16233;48387;798;2206;13441;41236;14239;43442
210870;201811;6679;18805;5869;17835;274;814;5127;15631;5401;16445
210880;201811;4412;13673;4021;13223;254;951;3324;10919;3578;11870
210890;201811;4233;12794;3847;12325;261;678;3193;10571;3454;11249
210900;201811;4772;13967;3635;11916;1398;4913;638;2331;2036;7244
210905;201811;1925;5497;1643;5111;51;109;1476;4682;1527;4791
210910;201811;7281;22611;6284;20962;859;2982;4228;14157;5087;17139
210920;201811;3203;10740;2836;10232;91;472;2513;8993;2604;9465
210923;201811;1420;4523;1271;4283;63;261;979;3272;1042;3533
210927;201811;5137;16239;4583;15626;131;489;4090;14110;4221;14599
210930;201811;2408;8557;2209;8207;133;644;1739;6376;1872;7020
210940;201811;3882;11414;3659;11126;106;487;3317;9890;3423;10377
210945;201811;5995;18018;5617;17565;243;701;4965;15700;5208;16401
210950;201811;5160;15207;4055;13541;636;1833;2653;9379;3289;11212
210955;201811;1617;5193;1441;4902;137;450;1046;3624;1183;4074
210960;201811;8710;26983;7813;25658;1589;4815;4775;16706;6364;21521
210970;201811;1269;4130;1064;3753;73;326;792;2701;865;3027
210975;201811;1676;5491;1529;5233;120;428;1179;4024;1299;4452
210980;201811;10440;23544;9296;22363;130;252;8877;21524;9007;21776
210990;201811;16349;47718;13224;43590;1242;4214;9401;31571;10643;35785
211000;201811;14378;43811;12393;41541;630;2547;10205;34922;10835;37469
211003;201811;5332;16945;4578;16019;172;655;3944;14071;4116;14726
211010;201811;6313;23154;5851;22508;76;465;5379;20789;5455;21254
211020;201811;7867;24799;7371;24171;313;1234;6357;20911;6670;22145
211023;201811;2036;6806;1931;6658;102;403;1626;5549;1728;5952
211027;201811;2655;9321;2607;9234;191;726;2234;7891;2425;8617
211030;201811;3839;11034;3487;10609;269;647;2893;9024;3162;9671
211040;201811;4534;16566;4278;16168;132;746;3798;14246;3930;14992
211050;201811;9521;24360;8736;23370;172;455;8139;21764;8311;22219
211060;201811;6758;21810;6295;21164;149;586;5831;19628;5980;20214
211065;201811;2126;6170;1807;5729;80;278;1519;4853;1599;5131
211070;201811;7466;24954;6621;23581;515;1873;5229;18758;5744;20631
211080;201811;1271;3659;1041;3284;42;235;804;2377;846;2612
211085;201811;1984;6002;1768;5698;103;297;1518;4980;1621;5277
211090;201811;3263;9057;2945;8641;45;221;2685;7777;2730;7998
211100;201811;6592;17125;6209;16608;40;135;5800;15562;5840;15697
211102;201811;2882;10508;2678;10206;166;791;2286;8630;2452;9421
211105;201811;2343;7609;1980;6920;195;689;1372;4769;1567;5458
211107;201811;4468;14233;3908;13417;157;630;3200;11265;3357;11895
211110;201811;5910;16808;4628;14790;559;1671;3189;10504;3748;12175
211120;201811;39160;105934;36261;102473;4814;12553;24380;73370;29194;85923
211125;201811;2014;6133;1722;5672;61;249;1454;4777;1515;5026
211130;201811;188119;472794;174752;455767;25897;68139;78116;231911;104013;300050
211140;201811;4910;15114;4409;14397;227;675;3770;12351;3997;13026
211150;201811;9250;26203;8142;24779;325;1049;6966;21255;7291;22304
211153;201811;2573;7652;2117;7082;311;1101;1408;4880;1719;5981
211157;201811;1087;3494;905;3173;41;238;638;2209;679;2447
211160;201811;3844;11761;3176;10681;180;782;2369;7779;2549;8561
211163;201811;1803;5846;1662;5639;15;70;1555;5357;1570;5427
211167;201811;1563;5062;1457;4895;33;160;1351;4502;1384;4662
211170;201811;6244;15695;5936;15324;54;174;5708;14677;5762;14851
211172;201811;2419;6832;2097;6313;86;289;1727;5022;1813;5311
211174;201811;2751;8253;2555;8000;61;302;2319;7179;2380;7481
211176;201811;4136;12374;3312;11174;218;879;2562;8589;2780;9468
211178;201811;4655;10882;4055;10197;36;170;3831;9509;3867;9679
211180;201811;4019;13676;3759;13280;212;844;3208;11332;3420;12176
211190;201811;3039;9176;2643;8555;45;232;2311;7407;2356;7639
211195;201811;1380;4023;1184;3745;85;212;972;3183;1057;3395
211200;201811;2080;6257;1716;5772;189;653;1181;4042;1370;4695
211210;201811;6454;19893;5961;19206;300;1033;5157;16635;5457;17668
211220;201811;35160;93061;29871;86501;3193;9102;21707;64461;24900;73563
211223;201811;4821;13600;4273;12760;536;1491;3073;9351;3609;10842
211227;201811;1709;5864;1563;5639;44;225;1366;4955;1410;5180
211230;201811;7098;22105;6478;21085;464;1484;5198;17029;5662;18513
211240;201811;8174;26579;7729;25995;150;790;7076;23527;7226;24317
211245;201811;6564;17185;6243;16855;68;175;6104;16491;6172;16666
211250;201811;13543;40716;12419;39329;511;2093;10670;33333;11181;35426
211260;201811;7774;25541;7137;24671;212;917;6482;22484;6694;23401
211270;201811;10296;33618;9076;31935;373;1788;7515;26514;7888;28302
211280;201811;13122;37381;11852;35738;976;2398;9557;30065;10533;32463
211285;201811;1629;5824;1450;5514;223;896;795;3127;1018;4023
211290;201811;7079;22386;6601;21710;204;864;5702;18634;5906;19498
211300;201811;7984;22915;7292;21985;153;476;6750;20370;6903;20846
211400;201811;11273;33835;9419;31104;1528;5039;5772;20216;7300;25255
220005;201811;1833;4997;1647;4709;39;159;1357;3782;1396;3941
220010;201811;1481;4235;1244;3815;32;141;970;2934;1002;3075
220020;201811;3313;9922;2976;9357;293;979;2248;6983;2541;7962
220025;201811;2206;5116;1887;4626;29;83;1592;3789;1621;3872
220027;201811;1229;3238;1073;3027;31;105;885;2457;916;2562
220030;201811;3353;8951;3194;8710;111;325;2796;7504;2907;7829
220040;201811;6943;21288;6252;19978;1245;3855;3804;12387;5049;16242
220045;201811;1457;4561;1243;4179;40;211;990;3249;1030;3460
220050;201811;4536;12919;3874;11939;109;468;3437;10481;3546;10949
220060;201811;2385;5129;2023;4708;33;90;1892;4377;1925;4467
220070;201811;2491;6517;2155;6020;92;209;1778;4977;1870;5186
220080;201811;692;1989;605;1855;32;127;511;1516;543;1643
220090;201811;1804;4394;1498;3956;16;62;1279;3446;1295;3508
220095;201811;655;1718;621;1678;17;37;569;1541;586;1578
220100;201811;1329;3811;1083;3377;48;207;869;2618;917;2825
220105;201811;2021;6401;1769;5867;157;526;1288;4284;1445;4810
220110;201811;3440;9543;3222;9151;47;226;2851;7955;2898;8181
220115;201811;2687;8209;2499;7922;81;335;2249;7010;2330;7345
220117;201811;1360;3369;1050;2908;18;71;891;2405;909;2476
220120;201811;11802;33735;10885;32535;114;470;10282;30623;10396;31093
220130;201811;1074;3061;914;2826;17;117;816;2456;833;2573
220140;201811;1909;4308;1647;3985;160;420;1388;3312;1548;3732
220150;201811;6446;19323;6044;18693;144;719;5172;15618;5316;16337
220155;201811;1104;3248;866;2807;22;96;610;1925;632;2021
220157;201811;1051;2623;875;2337;18;78;705;1809;723;1887
220160;201811;2689;7836;2341;7180;48;257;1933;5771;1981;6028
220170;201811;1445;3924;1229;3603;12;60;1097;3170;1109;3230
220173;201811;1999;5775;1610;5043;38;166;1319;3998;1357;4164
220177;201811;1915;5540;1860;5475;12;33;1815;5358;1827;5391
220180;201811;1143;2897;897;2433;9;45;678;1724;687;1769
220190;201811;5925;16231;5092;15055;416;1344;3786;11148;4202;12492
220191;201811;1395;4484;1286;4286;80;337;939;3056;1019;3393
220192;201811;1819;5023;1439;4337;29;104;1153;3397;1182;3501
220194;201811;1716;4999;1530;4682;63;248;1252;3724;1315;3972
220196;201811;1918;5270;1741;4981;39;181;1464;4075;1503;4256
220198;201811;1256;3536;1055;3266;8;20;992;3114;1000;3134
220200;201811;4786;14460;4326;13851;260;922;3555;11368;3815;12290
220202;201811;2181;6206;1878;5667;32;150;1594;4702;1626;4852
220205;201811;2534;7135;2257;6686;40;173;1937;5631;1977;5804
220207;201811;805;2446;679;2219;64;231;443;1435;507;1666
220208;201811;1705;5335;1376;4667;257;923;670;2268;927;3191
220209;201811;1598;4639;1380;4266;29;134;1116;3403;1145;3537
220210;201811;1582;4147;1362;3777;18;83;1136;3045;1154;3128
220211;201811;1549;4086;1447;3951;15;60;1285;3524;1300;3584
220213;201811;1730;4725;1501;4280;31;119;1211;3322;1242;3441
220217;201811;2044;6267;1939;6140;42;134;1811;5798;1853;5932
220220;201811;10201;27262;8581;24712;576;1548;6154;18122;6730;19670
220225;201811;1115;2929;907;2662;8;26;822;2384;830;2410
220230;201811;5715;14306;4943;13268;213;558;4257;11451;4470;12009
220240;201811;2933;8734;2685;8246;90;325;2187;6682;2277;7007
220245;201811;1595;4020;1284;3621;13;61;1155;3287;1168;3348
220250;201811;2760;8159;2440;7730;27;146;2206;6938;2233;7084
220253;201811;1644;4533;1397;4096;79;236;1148;3282;1227;3518
220255;201811;1863;4645;1565;4180;33;155;1305;3320;1338;3475
220260;201811;4264;13367;3727;12419;180;651;2976;9887;3156;10538
220265;201811;1233;4067;1123;3898;53;221;889;3049;942;3270
220270;201811;6421;20322;6039;19633;295;1209;5082;16047;5377;17256
220271;201811;1476;3877;1275;3580;43;140;1106;3106;1149;3246
220272;201811;1715;4957;1516;4578;59;196;1145;3355;1204;3551
220273;201811;1206;3481;1005;3106;41;153;758;2287;799;2440
220275;201811;2229;5458;1716;4738;43;158;1489;4067;1532;4225
220277;201811;2100;5460;1825;5022;25;88;1561;4211;1586;4299
220280;201811;1591;3962;1334;3575;37;119;1124;2930;1161;3049
220285;201811;1510;3919;1265;3601;18;86;1129;3166;1147;3252
220290;201811;5973;18060;4890;16533;365;1384;3626;12303;3991;13687
220300;201811;1913;5820;1583;5352;47;289;1308;4294;1355;4583
220310;201811;2874;8067;2318;7428;51;264;1966;6204;2017;6468
220320;201811;2941;8823;2346;7681;128;539;1775;5659;1903;6198
220323;201811;1593;4973;1302;4489;82;319;1038;3548;1120;3867
220325;201811;1278;3806;1088;3468;36;160;893;2797;929;2957
220327;201811;1426;4227;1267;3958;53;234;1028;3126;1081;3360
220330;201811;4095;10374;3455;9541;125;371;2951;8084;3076;8455
220335;201811;1797;5368;1591;5121;27;86;1442;4642;1469;4728
220340;201811;1837;4877;1453;4242;50;175;1028;2871;1078;3046
220342;201811;1178;3549;1049;3350;46;209;827;2595;873;2804
220345;201811;3094;7115;2491;6277;16;50;2334;5850;2350;5900
220350;201811;3379;8911;2716;7832;149;478;1997;5667;2146;6145
220360;201811;1253;3229;999;2825;20;61;796;2222;816;2283
220370;201811;8914;25444;8071;24213;197;845;7165;21201;7362;22046
220375;201811;1513;4525;1391;4358;9;31;1348;4232;1357;4263
220380;201811;1535;3721;1265;3327;24;77;1099;2839;1123;2916
220385;201811;802;1951;645;1666;11;42;559;1414;570;1456
220390;201811;8591;24462;7145;21964;1853;5667;2965;9662;4818;15329
220400;201811;1485;3653;1128;3088;34;101;854;2270;888;2371
220410;201811;1165;3265;958;2909;55;156;763;2275;818;2431
220415;201811;808;2157;687;1961;18;56;529;1482;547;1538
220420;201811;1984;5574;1612;4857;61;169;1239;3677;1300;3846
220430;201811;2538;6833;2425;6673;74;231;2136;5793;2210;6024
220435;201811;1697;4611;1505;4308;61;211;1186;3315;1247;3526
220440;201811;2418;7772;2109;7241;124;490;1734;5851;1858;6341
220450;201811;2338;6379;1926;5838;171;603;1490;4483;1661;5086
220455;201811;1304;4066;1233;3971;27;127;1110;3543;1137;3670
220460;201811;943;2388;850;2278;35;124;748;1943;783;2067
220465;201811;2322;7390;2068;6991;159;586;1580;5382;1739;5968
220470;201811;3448;9839;3103;9270;90;286;2536;7456;2626;7742
220480;201811;2494;6702;2006;5894;143;369;1447;4186;1590;4555
220490;201811;2347;6181;2136;5907;38;171;1898;5160;1936;5331
220500;201811;2558;6911;2344;6555;50;203;1948;5250;1998;5453
220510;201811;2598;7587;2113;6719;96;284;1663;5292;1759;5576
220515;201811;1687;4079;1503;3822;41;89;1322;3344;1363;3433
220520;201811;5012;13076;4501;12322;103;313;3981;10829;4084;11142
220525;201811;1276;3379;1158;3216;12;48;1050;2870;1062;2918
220527;201811;1317;3733;1160;3473;20;66;989;2984;1009;3050
220530;201811;1298;3442;1161;3250;24;88;1084;2987;1108;3075
220535;201811;801;2284;738;2202;45;161;592;1734;637;1895
220540;201811;3327;10502;3133;10151;103;388;2727;8787;2830;9175
220545;201811;1371;4327;1274;4143;89;362;1042;3305;1131;3667
220550;201811;8641;26815;7797;25372;610;2139;5820;18681;6430;20820
220551;201811;1424;4238;1247;3932;36;140;1004;3097;1040;3237
220552;201811;1535;4544;1288;4056;41;185;1031;3143;1072;3328
220553;201811;1620;4423;1372;4038;55;129;1095;3312;1150;3441
220554;201811;853;2302;628;1922;37;102;439;1321;476;1423
220555;201811;2009;6532;1870;6290;59;280;1546;5170;1605;5450
220556;201811;1272;3781;1093;3402;63;245;766;2264;829;2509
220557;201811;1575;4826;1332;4331;87;334;948;2993;1035;3327
220558;201811;1384;3656;1082;3231;25;108;911;2677;936;2785
220559;201811;1624;4227;1393;3867;6;36;1139;3188;1145;3224
220560;201811;1753;4017;1414;3566;37;83;1248;3140;1285;3223
220570;201811;7235;22097;6616;21145;515;1723;5206;16611;5721;18334
220580;201811;6826;19290;6346;18501;127;449;5692;16410;5819;16859
220585;201811;1930;6298;1730;5928;65;247;1417;4844;1482;5091
220590;201811;1286;3607;1073;3288;107;332;766;2357;873;2689
220595;201811;2455;6803;2256;6536;14;73;2082;5964;2096;6037
220600;201811;1408;3162;1169;2851;120;189;951;2398;1071;2587
220605;201811;1671;4871;1426;4426;28;127;1131;3414;1159;3541
220610;201811;2821;8803;2651;8564;37;171;2445;7881;2482;8052
220620;201811;7924;24853;7367;24071;211;1010;6651;21449;6862;22459
220630;201811;365;1090;286;950;36;118;178;607;214;725
220635;201811;1640;5264;1448;4853;66;272;1083;3556;1149;3828
220640;201811;2651;7296;2249;6686;98;365;1859;5427;1957;5792
220650;201811;2049;5788;1731;5239;51;169;1392;4170;1443;4339
220660;201811;2646;8326;2294;7745;94;462;1898;6208;1992;6670
220665;201811;1281;3958;1112;3679;33;179;919;2971;952;3150
220667;201811;1625;5177;1451;4856;74;291;1142;3813;1216;4104
220669;201811;1680;5205;1617;5092;80;360;1363;4192;1443;4552
220670;201811;2194;5863;1768;5275;33;113;1533;4531;1566;4644
220672;201811;3085;7698;2523;7018;138;391;2183;6039;2321;6430
220675;201811;1209;3361;1111;3175;47;130;887;2510;934;2640
220680;201811;2640;7331;2527;7165;121;279;2271;6478;2392;6757
220690;201811;1493;4069;1325;3795;114;284;1001;2907;1115;3191
220695;201811;896;2519;824;2384;15;52;707;2017;722;2069
220700;201811;9168;23489;7339;20870;365;1083;5637;15888;6002;16971
220710;201811;856;2435;645;2025;36;102;473;1460;509;1562
220720;201811;2080;5087;1868;4787;24;86;1620;4099;1644;4185
220730;201811;1244;3587;1061;3286;22;102;895;2706;917;2808
220735;201811;980;2329;755;1966;25;75;630;1580;655;1655
220740;201811;1411;3950;1139;3589;39;127;956;3032;995;3159
220750;201811;3747;9973;3356;9394;224;553;2887;8110;3111;8663
220755;201811;1209;3103;1018;2798;29;101;809;2132;838;2233
220760;201811;2995;8780;2650;8306;119;375;2269;7210;2388;7585
220770;201811;20523;64455;17730;59344;6141;21329;5929;20528;12070;41857
220775;201811;1113;2959;1033;2858;14;53;1000;2756;1014;2809
220777;201811;1628;4231;1260;3624;46;120;922;2638;968;2758
220779;201811;1341;3314;1187;3097;26;85;1027;2646;1053;2731
220780;201811;5686;14622;4886;13313;248;778;3921;10389;4169;11167
220785;201811;1445;3244;1299;3037;15;21;1245;2916;1260;2937
220790;201811;10147;29297;9132;27825;295;1367;7712;23045;8007;24412
220793;201811;856;2305;706;2043;22;66;581;1687;603;1753
220795;201811;1413;3712;1256;3505;26;110;1120;3084;1146;3194
220800;201811;16713;40537;14097;36770;831;2172;10202;26209;11033;28381
220810;201811;2964;8441;2565;7704;56;223;2130;6256;2186;6479
220820;201811;5224;13619;4477;12567;428;1070;3263;9174;3691;10244
220830;201811;7108;19288;6443;18317;264;847;5446;15330;5710;16177
220840;201811;12201;37961;10442;34304;2416;7627;5086;17301;7502;24928
220850;201811;3025;9646;2752;9296;65;364;2461;8194;2526;8558
220855;201811;593;1657;522;1539;15;79;442;1260;457;1339
220860;201811;1008;2511;869;2294;15;50;781;2038;796;2088
220865;201811;2556;6846;1996;5868;67;232;1526;4375;1593;4607
220870;201811;2758;8126;2293;7488;42;209;2080;6733;2122;6942
220880;201811;5216;12672;4625;11943;75;226;4269;10934;4344;11160
220885;201811;1311;4266;1119;3937;51;248;879;3083;930;3331
220887;201811;1462;3276;1240;2979;9;31;1165;2764;1174;2795
220890;201811;1479;4773;1263;4359;82;299;978;3375;1060;3674
220900;201811;2001;4933;1668;4468;40;90;1448;3835;1488;3925
220910;201811;1483;4244;1260;3913;50;166;1046;3221;1096;3387
220915;201811;974;2632;767;2227;12;43;611;1711;623;1754
220920;201811;1371;4562;1165;4272;79;369;926;3357;1005;3726
220930;201811;1585;4569;1392;4271;30;111;1252;3792;1282;3903
220935;201811;1038;2997;814;2529;33;125;541;1558;574;1683
220937;201811;1346;3686;1166;3400;31;119;951;2710;982;2829
220940;201811;1440;4199;1174;3677;32;140;886;2691;918;2831
220945;201811;414;1455;372;1372;27;144;264;932;291;1076
220950;201811;1397;3324;902;2519;16;60;710;1908;726;1968
220955;201811;1559;4089;1358;3741;38;95;1167;3221;1205;3316
220960;201811;847;2144;652;1836;15;60;495;1339;510;1399
220965;201811;1769;4886;1561;4589;24;152;1340;3824;1364;3976
220970;201811;1818;4653;1393;3970;42;115;1115;3161;1157;3276
220975;201811;701;2114;611;1996;21;139;543;1674;564;1813
220980;201811;1151;3329;1043;3160;36;151;868;2581;904;2732
220985;201811;1171;3256;1057;3086;44;160;824;2289;868;2449
220987;201811;1498;4424;1286;4052;59;252;1050;3229;1109;3481
220990;201811;1695;4794;1481;4453;29;156;1218;3557;1247;3713
220995;201811;1177;3512;919;3057;55;209;651;2160;706;2369
220997;201811;2436;7119;2263;6868;56;236;2045;6120;2101;6356
221000;201811;4074;11657;3771;11192;102;488;3212;9307;3314;9795
221005;201811;1429;3947;1301;3717;44;164;1092;2987;1136;3151
221010;201811;1200;2894;985;2623;28;60;849;2230;877;2290
221020;201811;1547;4799;1409;4513;30;137;1066;3337;1096;3474
221030;201811;1570;4197;1358;3899;34;143;1167;3304;1201;3447
221035;201811;1418;3772;1248;3541;27;50;1101;3207;1128;3257
221037;201811;602;1782;518;1630;10;53;345;1023;355;1076
221038;201811;525;1494;414;1280;21;71;289;885;310;956
221039;201811;878;2371;778;2209;19;80;644;1751;663;1831
221040;201811;4160;12638;3723;11860;166;584;2955;9400;3121;9984
221050;201811;3766;10147;3388;9658;57;226;3105;8776;3162;9002
221060;201811;8475;23410;7003;21102;263;800;5515;16892;5778;17692
221062;201811;1172;3917;1021;3627;49;245;813;2814;862;3059
221063;201811;1164;3377;994;3117;81;301;704;2120;785;2421
221065;201811;2629;6821;2306;6258;29;119;2041;5426;2070;5545
221070;201811;3303;10556;2759;9442;324;1130;1769;6109;2093;7239
221080;201811;3492;8568;2811;7549;54;212;2332;6147;2386;6359
221090;201811;1415;3740;1147;3264;15;59;988;2728;1003;2787
221093;201811;1366;3917;1262;3704;126;367;851;2439;977;2806
221095;201811;895;2358;755;2141;5;13;626;1749;631;1762
221097;201811;830;2191;639;1835;28;90;461;1263;489;1353
221100;201811;102712;283724;89224;260901;13624;41479;55146;157998;68770;199477
221110;201811;9908;29997;9200;29053;210;1093;8179;25344;8389;26437
221120;201811;4365;12735;3972;12066;224;766;3351;10098;3575;10864
221130;201811;4937;13196;3702;10735;879;2520;1655;4811;2534;7331
221135;201811;1595;4400;1434;4179;43;151;1261;3629;1304;3780
221140;201811;1295;3142;1131;2906;10;36;1009;2525;1019;2561
221150;201811;1104;2757;874;2354;20;93;694;1743;714;1836
221160;201811;795;1978;701;1850;31;61;566;1497;597;1558
221170;201811;1000;2952;920;2816;18;55;779;2379;797;2434
230010;201811;3180;8498;2568;7403;126;431;1954;5490;2080;5921
230015;201811;2902;9662;2654;9178;246;979;1825;6188;2071;7167
230020;201811;12869;41006;12316;40114;418;1738;10569;33945;10987;35683
230030;201811;12478;32455;10837;30116;247;712;9557;26502;9804;27214
230040;201811;4376;11522;3683;10378;97;392;3017;8345;3114;8737
230050;201811;2745;8740;2013;6910;362;1216;785;2648;1147;3864
230060;201811;2359;6525;1884;5604;50;227;1526;4423;1576;4650
230070;201811;3972;10948;3251;9504;186;632;2192;6375;2378;7007
230075;201811;9009;29476;8378;28345;373;1868;6885;22623;7258;24491
230080;201811;2924;6286;2234;5391;18;83;1985;4756;2003;4839
230090;201811;4132;10618;3560;9685;172;523;2764;7412;2936;7935
230100;201811;17624;47519;15779;44865;1533;4618;10784;30642;12317;35260
230110;201811;12146;36772;10609;33645;1858;5890;5767;18365;7625;24255
230120;201811;7387;20380;6501;18897;606;1574;4715;13986;5321;15560
230125;201811;3099;8379;2535;7443;89;326;1942;5631;2031;5957
230130;201811;5604;17643;4650;15544;589;2053;2864;9389;3453;11442
230140;201811;3481;10516;2951;9491;129;536;2191;6842;2320;7378
230150;201811;1614;4837;1354;4260;239;684;735;2396;974;3080
230160;201811;6447;17175;5610;15866;150;580;4700;13025;4850;13605
230170;201811;5958;17428;5117;15786;301;1009;3742;11332;4043;12341
230180;201811;1641;4637;1394;4133;26;120;1097;3131;1123;3251
230185;201811;4133;12378;3563;11365;313;1088;2586;8230;2899;9318
230190;201811;12837;38174;10976;34637;1748;5646;5837;18492;7585;24138
230195;201811;5133;15243;4561;14229;355;1166;3517;10859;3872;12025
230200;201811;4920;13643;4242;12323;156;485;3303;9371;3459;9856
230205;201811;3972;12400;3586;11721;172;716;2730;8741;2902;9457
230210;201811;10016;25164;8543;23072;458;1442;6446;17179;6904;18621
230220;201811;13193;34587;11927;32571;515;1560;9918;26688;10433;28248
230230;201811;6818;20824;6140;19404;454;1497;4460;13986;4914;15483
230240;201811;12593;33930;11200;31665;365;1179;9284;25933;9649;27112
230250;201811;8846;25803;8698;25570;321;1153;7020;20119;7341;21272
230260;201811;13945;43675;12562;40920;1635;5497;7528;24675;9163;30172
230270;201811;7412;20647;5947;17822;570;1686;3908;11761;4478;13447
230280;201811;20360;55619;16988;49861;689;2724;13327;37678;14016;40402
230290;201811;4703;13358;4005;11966;371;986;2953;8887;3324;9873
230300;201811;4475;12486;4206;12086;84;347;3729;10518;3813;10865
230310;201811;4673;13390;3969;12167;156;638;2838;8447;2994;9085
230320;201811;7612;22116;6623;20238;312;1182;5054;15128;5366;16310
230330;201811;4664;12897;3834;11302;173;534;2854;8269;3027;8803
230340;201811;3530;11285;3029;10250;305;1073;2033;6806;2338;7879
230350;201811;18066;51049;16148;47835;1097;3760;10555;31445;11652;35205
230360;201811;2840;7908;2271;6830;148;491;1542;4584;1690;5075
230365;201811;3075;7758;2575;6964;50;242;2162;5743;2212;5985
230370;201811;53562;156638;46321;145158;8746;27930;24514;78834;33260;106764
230380;201811;6431;17985;5111;15472;175;640;3733;11105;3908;11745
230390;201811;3295;10001;2898;9326;132;545;2206;6977;2338;7522
230393;201811;2980;9253;2481;8228;99;523;1919;6090;2018;6613
230395;201811;5660;15571;4941;14307;418;1145;3411;9924;3829;11069
230400;201811;5778;16209;5085;15053;146;696;4011;11438;4157;12134
230410;201811;14435;43473;11790;38271;1186;4013;7575;24638;8761;28651
230420;201811;25930;75077;21984;67589;2828;9082;12615;38454;15443;47536
230423;201811;4725;14131;4124;12907;112;503;3320;10168;3432;10671
230425;201811;5360;16983;4921;16033;472;1588;3499;11334;3971;12922
230426;201811;2614;7048;1971;5774;43;164;1505;4330;1548;4494
230427;201811;1859;5296;1278;3976;68;220;890;2661;958;2881
230428;201811;9668;26677;8565;24947;1218;3631;5142;14934;6360;18565
230430;201811;4531;13320;3745;11887;177;654;2855;8853;3032;9507
230435;201811;5496;15109;4718;13762;544;1626;3019;8737;3563;10363
230440;201811;391943;1017996;329800;920631;46490;136004;190749;527894;237239;663898
230445;201811;4326;11571;3587;10264;213;554;2508;7036;2721;7590
230450;201811;3499;10429;3091;9731;250;966;2262;6971;2512;7937
230460;201811;2082;5950;1816;5501;82;320;1487;4471;1569;4791
230465;201811;3973;11338;3381;10241;101;449;2501;7276;2602;7725
230470;201811;11150;37557;10155;35621;945;3955;7346;25282;8291;29237
230480;201811;1391;4167;1190;3788;105;417;862;2620;967;3037
230490;201811;2386;6865;2056;6248;195;629;1258;3671;1453;4300
230495;201811;5821;17590;5143;16337;468;1807;3304;10257;3772;12064
230500;201811;8690;29128;8098;27963;351;1454;6477;22279;6828;23733
230510;201811;1593;5098;1182;4129;212;783;511;1765;723;2548
230520;201811;4396;12821;3878;11816;318;986;2749;8289;3067;9275
230523;201811;14777;44365;12091;38551;2838;9060;3166;10615;6004;19675
230526;201811;3876;11268;3293;10190;154;608;2500;7561;2654;8169
230530;201811;5290;16554;4534;15123;399;1444;3160;10529;3559;11973
230533;201811;4111;10552;3534;9503;110;303;2923;7781;3033;8084
230535;201811;5423;15225;4595;13756;280;829;3216;9764;3496;10593
230540;201811;15800;44183;14000;41421;291;1212;12033;35021;12324;36233
230550;201811;19918;54879;16547;48879;1873;5799;9932;29083;11805;34882
230560;201811;7762;19884;6409;17539;91;349;5387;14541;5478;14890
230565;201811;3121;8641;2588;7673;74;307;1975;5757;2049;6064
230570;201811;3565;9073;3074;8427;68;200;2606;7100;2674;7300
230580;201811;10061;27520;8936;25857;365;1214;7494;21506;7859;22720
230590;201811;8856;25887;7375;23064;518;1830;5245;15875;5763;17705
230600;201811;3661;9695;2779;7995;90;291;1855;5381;1945;5672
230610;201811;6479;18359;5806;17290;544;1534;4372;13084;4916;14618
230620;201811;2102;5786;1595;4751;138;452;957;2763;1095;3215
230625;201811;7909;23426;6846;21332;2119;6863;1765;5773;3884;12636
230630;201811;10200;31346;9064;28966;2188;6539;4210;14259;6398;20798
230640;201811;27078;83337;24768;79523;1643;6242;19501;61785;21144;68027
230650;201811;4946;13963;4214;12593;173;658;3275;9555;3448;10213
230655;201811;9221;32194;8786;31397;705;2790;6824;24467;7529;27257
230660;201811;6200;18478;5092;16395;182;957;4108;12885;4290;13842
230670;201811;6085;14894;4486;12213;181;550;3534;9376;3715;9926
230680;201811;2543;7201;2186;6529;184;562;1505;4501;1689;5063
230690;201811;6668;20304;5939;18753;507;1788;3668;11341;4175;13129
230700;201811;9429;24868;8083;22339;358;1123;6143;16481;6501;17604
230710;201811;6931;21836;6012;19929;595;2084;4191;13673;4786;15757
230720;201811;1929;5777;1595;5062;131;388;1066;3325;1197;3713
230725;201811;3766;11832;3311;10862;535;1885;1574;5042;2109;6927
230730;201811;54911;154198;44984;138038;10593;35014;15381;49423;25974;84437
230740;201811;6002;17113;5248;15834;143;578;4201;12553;4344;13131
230750;201811;8379;22807;7003;20502;196;739;5529;15700;5725;16439
230760;201811;11286;30704;10028;28655;703;2324;7383;20533;8086;22857
230763;201811;4428;12735;3813;11564;163;673;2993;8771;3156;9444
230765;201811;39547;112647;33612;102343;6550;20790;14332;43689;20882;64479
230770;201811;25424;66067;21780;60984;2816;8227;13527;37935;16343;46162
230780;201811;5898;21270;5543;20531;868;3256;3254;12368;4122;15624
230790;201811;2925;8600;2616;8074;146;561;1950;5854;2096;6415
230800;201811;7655;25219;6917;23659;828;3160;4108;13777;4936;16937
230810;201811;11634;35404;10474;33432;472;1833;8052;25110;8524;26943
230820;201811;3172;10511;2699;9436;312;1263;1622;5419;1934;6682
230830;201811;7524;21061;6430;19111;162;683;5235;15164;5397;15847
230835;201811;4156;10089;3167;8504;108;331;2586;6809;2694;7140
230837;201811;3128;9884;2686;9024;132;624;2066;6710;2198;7334
230840;201811;8985;26967;7858;25068;596;2022;5878;18748;6474;20770
230850;201811;9159;27377;8017;25061;487;1678;5698;17653;6185;19331
230860;201811;5242;13671;4378;12393;113;396;3747;10456;3860;10852
230870;201811;16822;41700;14497;38031;501;1420;11668;30323;12169;31743
230880;201811;2043;6347;1890;6087;64;333;1499;4686;1563;5019
230890;201811;4397;14525;4078;13882;347;1319;2958;9894;3305;11213
230900;201811;3044;9087;2566;8097;256;866;1636;5017;1892;5883
230910;201811;2963;8307;2430;7374;80;372;1928;5718;2008;6090
230920;201811;4455;12749;3862;11794;157;617;3027;9023;3184;9640
230930;201811;6476;18682;5423;16611;406;1315;3699;11239;4105;12554
230940;201811;7778;20581;6860;19129;214;645;5721;15812;5935;16457
230945;201811;6525;19035;5644;17221;398;1338;3913;11821;4311;13159
230950;201811;6247;15926;5682;15208;140;322;5095;13840;5235;14162
230960;201811;13188;39272;11903;36834;1945;6148;5953;18638;7898;24786
230970;201811;13349;37279;11484;34230;2216;6836;5605;16755;7821;23591
230980;201811;2688;7994;2347;7370;492;1466;1307;4286;1799;5752
230990;201811;1692;4834;1415;4279;79;314;975;2820;1054;3134
231000;201811;2523;6785;2076;5874;81;228;1483;4100;1564;4328
231010;201811;3187;7929;2633;6989;99;320;2154;5547;2253;5867
231020;201811;7688;25071;7011;23583;1253;3982;4125;14368;5378;18350
231025;201811;7256;20920;6440;19542;900;2721;4266;13050;5166;15771
231030;201811;7044;21553;5679;18593;968;3152;3000;9842;3968;12994
231040;201811;3111;9119;2694;8327;99;396;2088;6307;2187;6703
231050;201811;11777;31168;9479;26982;676;1893;6993;19541;7669;21434
231060;201811;2573;7600;2333;7194;82;317;1900;5827;1982;6144
231070;201811;7939;23562;6815;21502;930;2973;4029;12715;4959;15688
231080;201811;3950;11509;3496;10727;136;649;2708;8034;2844;8683
231085;201811;5909;15686;5121;14674;305;871;3857;11130;4162;12001
231090;201811;4250;11413;3215;9309;118;436;2274;6360;2392;6796
231095;201811;2115;6527;1740;5656;152;535;1197;3858;1349;4393
231100;201811;2928;8779;2478;7936;142;486;1864;5947;2006;6433
231110;201811;3413;10505;3267;10232;202;728;2381;7347;2583;8075
231120;201811;2087;6375;1787;5824;109;408;1208;3884;1317;4292
231123;201811;1898;5011;1590;4446;75;213;1197;3308;1272;3521
231126;201811;5583;15626;4465;13437;232;738;3244;9566;3476;10304
231130;201811;19490;53833;16942;50220;1507;5237;11835;34688;13342;39925
231135;201811;4196;11862;3525;10608;156;549;2550;7527;2706;8076
231140;201811;16696;48297;13802;43009;811;3324;9590;28863;10401;32187
231150;201811;5386;15291;4370;13236;836;2538;1898;5822;2734;8360
231160;201811;5857;18338;5318;17266;1102;3391;2863;9630;3965;13021
231170;201811;4343;13079;3576;11494;224;812;2452;7613;2676;8425
231180;201811;13681;39897;11598;35334;2936;8952;4430;13602;7366;22554
231190;201811;3813;10964;3262;9883;123;507;2573;7532;2696;8039
231195;201811;4574;14426;3921;13040;211;869;2911;9446;3122;10315
231200;201811;7775;24933;6771;22793;263;1323;5180;16845;5443;18168
231210;201811;4656;14167;4033;13043;188;729;3084;9708;3272;10437
231220;201811;11838;31738;9421;27011;536;1596;6845;18933;7381;20529
231230;201811;9166;29320;8184;27645;560;2178;6064;20502;6624;22680
231240;201811;11530;34520;10314;32067;1736;5382;5857;18328;7593;23710
231250;201811;2036;5386;1350;3813;107;311;803;2211;910;2522
231260;201811;3213;9384;2820;8741;304;932;1856;5875;2160;6807
231270;201811;6388;16930;5393;15267;142;571;4150;11444;4292;12015
231280;201811;1620;5144;1523;4953;134;459;1125;3641;1259;4100
231290;201811;36472;111754;31589;101471;5634;18296;14632;46667;20266;64963
231300;201811;3966;11219;3160;9559;263;845;2011;5954;2274;6799
231310;201811;7196;19375;5878;16802;581;1650;3822;10777;4403;12427
231320;201811;7550;21302;6023;18414;114;520;4678;14083;4792;14603
231325;201811;2493;6916;2073;6213;332;948;1193;3621;1525;4569
231330;201811;9933;30569;8297;27211;1673;5402;4177;14044;5850;19446
231335;201811;5697;15161;4809;13674;98;451;4157;11588;4255;12039
231340;201811;17281;54245;15589;51360;1285;4315;11485;38213;12770;42528
231350;201811;15565;42853;14147;40843;340;1178;12662;36207;13002;37385
231355;201811;4470;13630;4007;12799;213;786;3074;9718;3287;10504
231360;201811;7419;22856;6497;21209;425;1537;4861;15777;5286;17314
231370;201811;2287;6192;1815;5348;42;135;1389;4043;1431;4178
231375;201811;4338;13761;3965;13072;151;690;3280;10624;3431;11314
231380;201811;5795;15892;5348;15324;209;551;4453;12955;4662;13506
231390;201811;3312;9832;2986;9273;191;694;2162;6522;2353;7216
231395;201811;3932;11941;3304;10898;590;1950;1799;6050;2389;8000
231400;201811;8983;26443;7934;24450;343;1363;6105;18429;6448;19792
231410;201811;15029;47087;13359;44233;789;2962;10426;34018;11215;36980
240010;201811;2492;6834;1936;5761;202;682;1204;3455;1406;4137
240020;201811;11288;33135;9828;30453;882;3253;6331;19184;7213;22437
240030;201811;2681;7014;2505;6752;120;364;2183;5802;2303;6166
240040;201811;813;2315;668;2041;16;78;494;1451;510;1529
240050;201811;3172;8571;2666;7643;58;177;2115;5938;2173;6115
240060;201811;1392;3785;1175;3382;36;119;947;2671;983;2790
240070;201811;2161;6504;1997;6155;214;704;1488;4506;1702;5210
240080;201811;2722;7512;2375;6890;72;274;1851;5289;1923;5563
240090;201811;2271;5696;1847;4964;23;69;1527;4045;1550;4114
240100;201811;9151;23524;7525;20448;353;1072;5821;15347;6174;16419
240110;201811;4405;12959;3863;11943;252;926;2757;8332;3009;9258
240120;201811;3555;9711;2642;8646;223;883;1734;5795;1957;6678
240130;201811;3458;7518;2953;6797;56;171;2690;6079;2746;6250
240140;201811;2031;6091;1724;5503;193;685;1119;3492;1312;4177
240145;201811;6280;18126;5298;16395;758;2425;3272;10205;4030;12630
240150;201811;874;2592;795;2436;53;195;616;1819;669;2014
240160;201811;1440;4405;1225;3967;67;305;871;2805;938;3110
240165;201811;908;2539;778;2292;68;205;579;1685;647;1890
240170;201811;2352;6638;2003;6000;225;750;1265;3638;1490;4388
240180;201811;3058;9008;2451;7809;503;1558;1231;4087;1734;5645
240185;201811;1240;4074;1126;3886;63;278;913;3103;976;3381
240190;201811;1000;2998;884;2804;23;101;731;2290;754;2391
240200;201811;10639;28393;8866;25271;1195;3567;4639;13117;5834;16684
240210;201811;2890;7525;2567;7000;48;198;2146;5665;2194;5863
240220;201811;7281;22630;6582;21530;427;1826;4987;16018;5414;17844
240230;201811;5792;14888;4725;13083;252;675;3739;10329;3991;11004
240240;201811;2053;6562;1346;4735;131;426;575;2121;706;2547
240250;201811;2821;7750;2562;7367;157;435;2048;5908;2205;6343
240260;201811;13324;40634;11693;37762;1800;5681;7040;23689;8840;29370
240270;201811;2240;6693;2006;6325;116;314;1586;5115;1702;5429
240280;201811;1643;4261;1400;3889;49;139;1127;3076;1176;3215
240290;201811;1213;3575;1006;3131;41;191;691;1998;732;2189
240300;201811;2181;5724;1589;4570;88;276;1002;2792;1090;3068
240310;201811;8841;23848;7254;21049;928;2796;3903;11217;4831;14013
240320;201811;2009;5559;1487;4524;29;139;1120;3227;1149;3366
240325;201811;29577;82043;23187;70604;5654;18111;7443;23361;13097;41472
240330;201811;1602;4503;1289;3881;45;154;913;2627;958;2781
240340;201811;1941;4668;1587;4123;62;147;1280;3267;1342;3414
240350;201811;2044;5452;1907;5290;35;134;1694;4703;1729;4837
240360;201811;7802;22501;6963;21138;1139;3416;4239;13339;5378;16755
240370;201811;2002;5394;1558;4480;88;260;1047;2947;1135;3207
240375;201811;889;2268;755;2012;35;137;590;1482;625;1619
240380;201811;2286;6536;1668;5149;165;508;960;2909;1125;3417
240390;201811;955;2491;693;1955;18;54;471;1246;489;1300
240400;201811;1385;3723;1112;3211;33;132;800;2242;833;2374
240410;201811;550;1731;467;1541;55;217;262;834;317;1051
240420;201811;4674;16891;4152;15706;579;2580;2230;8235;2809;10815
240430;201811;3313;8980;2836;8045;232;754;2034;5555;2266;6309
240440;201811;2564;5846;2164;5274;153;364;1667;4003;1820;4367
240450;201811;4224;11867;3429;10382;346;1202;2045;5951;2391;7153
240460;201811;2957;8573;2745;8239;269;859;2141;6404;2410;7263
240470;201811;3536;10868;2788;9301;393;1363;1516;5037;1909;6400
240480;201811;538;1483;390;1184;37;120;181;534;218;654
240485;201811;2081;6114;1732;5420;180;594;1098;3433;1278;4027
240490;201811;1750;4379;1399;3758;54;122;1125;3038;1179;3160
240500;201811;2193;5913;1922;5515;46;163;1644;4671;1690;4834
240510;201811;1670;4474;1509;4244;92;294;1251;3440;1343;3734
240520;201811;1280;3348;1067;3043;40;143;867;2427;907;2570
240530;201811;1948;6016;1793;5738;105;358;1423;4526;1528;4884
240540;201811;2200;5616;1946;5230;89;221;1655;4441;1744;4662
240550;201811;667;1890;611;1786;37;118;458;1305;495;1423
240560;201811;3283;8771;2810;8135;284;747;2060;6061;2344;6808
240570;201811;2877;7627;1948;5545;262;786;868;2254;1130;3040
240580;201811;7644;22666;6959;21444;533;1718;5608;17224;6141;18942
240590;201811;684;1846;588;1678;15;56;458;1278;473;1334
240600;201811;1745;4783;1291;3846;70;253;839;2387;909;2640
240610;201811;4369;12043;3697;10797;160;543;2765;7910;2925;8453
240615;201811;1087;3038;871;2592;68;232;589;1669;657;1901
240620;201811;1854;5275;1590;4796;88;244;1265;3791;1353;4035
240630;201811;2032;5930;1823;5564;134;337;1260;3970;1394;4307
240640;201811;904;2495;735;2210;30;130;538;1570;568;1700
240650;201811;3843;10840;3418;10107;224;659;2649;7794;2873;8453
240660;201811;2805;7544;2528;7179;62;243;2290;6404;2352;6647
240670;201811;2445;7029;2023;6158;151;501;1286;3794;1437;4295
240680;201811;1605;4382;1283;3807;66;243;935;2665;1001;2908
240690;201811;914;2356;724;2022;20;74;587;1583;607;1657
240700;201811;2376;6915;1979;6202;70;287;1549;4749;1619;5036
240710;201811;16103;42487;13673;38206;2371;6435;7674;21773;10045;28208
240720;201811;5236;13655;4543;12550;565;1676;2970;7988;3535;9664
240725;201811;1060;3102;829;2599;36;124;563;1722;599;1846
240730;201811;2066;5939;1765;5326;88;282;1368;4043;1456;4325
240740;201811;1865;5063;1556;4481;58;225;1155;3140;1213;3365
240750;201811;2282;7683;1923;6905;295;1158;1026;3693;1321;4851
240760;201811;1522;3762;1088;3076;61;151;845;2407;906;2558
240770;201811;3020;8632;2679;8136;132;508;2167;6458;2299;6966
240780;201811;5453;14870;4295;12928;567;1702;2559;7901;3126;9603
240790;201811;848;2456;706;2173;17;66;522;1559;539;1625
240800;201811;40623;104774;33347;93246;5132;14889;16091;45049;21223;59938
240810;201811;81832;222153;72321;205681;13806;39542;40040;113659;53846;153201
240820;201811;5555;17077;4833;15792;851;2871;2728;9056;3579;11927
240830;201811;8612;25398;7895;24251;313;1353;6452;19391;6765;20744
240840;201811;1119;2884;907;2502;61;165;641;1710;702;1875
240850;201811;1251;3558;910;2793;44;150;536;1617;580;1767
240860;201811;1230;3403;943;2849;24;103;709;2045;733;2148
240870;201811;1169;2947;914;2512;82;254;625;1671;707;1925
240880;201811;1284;4061;1179;3867;99;371;918;2961;1017;3332
240890;201811;4590;12683;3533;10623;565;1795;1720;5014;2285;6809
240895;201811;2666;8599;2411;8218;191;695;1976;6717;2167;7412
240910;201811;3149;8867;2713;8003;67;232;2239;6499;2306;6731
240920;201811;821;2441;695;2199;77;255;370;1190;447;1445
240930;201811;3625;8528;3061;7829;182;260;2425;6421;2607;6681
240933;201811;1812;4359;1497;3878;51;200;1276;3216;1327;3416
240940;201811;6253;15564;4961;13370;308;885;3561;9277;3869;10162
240950;201811;922;2849;818;2639;41;176;643;2011;684;2187
240960;201811;715;2210;639;2057;44;164;473;1482;517;1646
240970;201811;1823;4838;1508;4264;58;230;1247;3403;1305;3633
240980;201811;2925;9186;2674;8705;184;728;2040;6502;2224;7230
240990;201811;2537;7414;2326;6974;273;883;1639;4797;1912;5680
241000;201811;927;2500;757;2169;42;116;523;1490;565;1606
241010;201811;2724;8832;2530;8427;212;839;1838;5967;2050;6806
241020;201811;2037;5533;1512;4437;147;429;956;2741;1103;3170
241025;201811;1708;4956;1379;4308;60;233;929;2852;989;3085
241030;201811;2457;7846;2028;6936;220;781;1316;4465;1536;5246
241040;201811;2273;7268;2032;6856;100;446;1617;5404;1717;5850
241050;201811;1266;3569;1040;3124;37;129;796;2328;833;2457
241060;201811;730;2061;641;1884;47;135;450;1291;497;1426
241070;201811;642;1789;565;1646;22;77;446;1245;468;1322
241080;201811;1119;3208;852;2667;9;41;638;1978;647;2019
241090;201811;2023;5891;1625;5203;66;318;1273;3998;1339;4316
241100;201811;1127;3231;908;2738;51;161;627;1831;678;1992
241105;201811;1060;3219;869;2852;273;907;290;986;563;1893
241110;201811;887;2594;680;2120;40;157;449;1332;489;1489
241120;201811;7332;21335;6347;19549;1167;3459;3446;11081;4613;14540
241140;201811;3284;8756;2659;7510;160;472;1937;5298;2097;5770
241142;201811;752;2069;560;1678;36;125;317;890;353;1015
241150;201811;5694;15460;5071;14402;193;698;4099;11367;4292;12065
241160;201811;1561;4641;1365;4311;149;414;992;3190;1141;3604
241170;201811;1294;3327;1128;3051;44;157;933;2407;977;2564
241180;201811;966;2579;704;2049;68;200;409;1156;477;1356
241190;201811;1121;2993;915;2575;26;98;673;1806;699;1904
241200;201811;18933;50663;16367;46730;3057;8896;8758;25131;11815;34027
241210;201811;1350;3755;1027;3092;115;364;604;1786;719;2150
241220;201811;8645;26420;7631;24633;2091;6767;3240;10993;5331;17760
241230;201811;2898;7900;2580;7361;107;378;2144;5960;2251;6338
241240;201811;1186;3438;703;2291;46;175;334;1076;380;1251
241250;201811;5451;16324;4556;14569;188;905;3421;10460;3609;11365
241255;201811;1973;6583;1734;6052;143;599;1209;4109;1352;4708
241260;201811;4861;12898;3821;11139;94;427;2957;8372;3051;8799
241270;201811;1764;5171;1471;4602;128;468;1026;3135;1154;3603
241280;201811;2075;5358;1831;4921;78;219;1547;4110;1625;4329
241290;201811;3392;8483;2616;7188;91;336;2028;5397;2119;5733
241300;201811;1431;3939;1178;3483;43;162;782;2239;825;2401
241310;201811;1989;5235;1716;4830;24;94;1447;4058;1471;4152
241320;201811;992;3215;822;2863;92;374;509;1752;601;2126
241330;201811;1754;4554;1389;4100;34;142;1189;3493;1223;3635
241335;201811;3038;8693;2738;8137;95;329;2320;6801;2415;7130
241340;201811;1673;4907;1316;4112;289;910;542;1662;831;2572
241350;201811;1970;5818;1753;5421;120;393;1316;3990;1436;4383
241355;201811;1296;3558;1068;3124;21;72;840;2427;861;2499
241360;201811;2076;5432;1611;4502;66;200;1156;3101;1222;3301
241370;201811;1355;3819;1074;3252;66;221;706;2036;772;2257
241380;201811;650;1824;513;1552;88;255;267;821;355;1076
241390;201811;2712;8255;2473;7864;223;694;1870;5970;2093;6664
241400;201811;3554;9963;3195;9436;210;708;2577;7515;2787;8223
241410;201811;2277;6943;1911;6186;367;1242;1029;3311;1396;4553
241415;201811;1623;4814;1349;4296;88;325;959;2979;1047;3304
241420;201811;2180;7261;1870;6671;501;1928;758;2693;1259;4621
241430;201811;546;1579;384;1182;25;88;235;695;260;783
241440;201811;7142;23070;6429;21755;463;1800;4939;16465;5402;18265
241445;201811;1077;2819;987;2708;27;73;903;2521;930;2594
241450;201811;2805;7091;2459;6555;300;712;1778;4777;2078;5489
241460;201811;3566;9883;3007;8696;187;616;2110;5901;2297;6517
241470;201811;1420;3757;1125;3320;36;137;932;2713;968;2850
241475;201811;1204;3475;941;2951;31;166;697;2064;728;2230
241480;201811;2716;8711;2329;7897;841;2837;635;2482;1476;5319
241490;201811;661;1611;522;1394;28;92;357;913;385;1005
241500;201811;802;2334;690;2184;12;53;612;1926;624;1979
250010;201811;2630;7948;2179;6994;78;314;1594;4980;1672;5294
250020;201811;1576;4336;1137;3457;59;162;813;2444;872;2606
250030;201811;6739;18803;6097;17811;498;1500;4671;13425;5169;14925
250040;201811;3930;12473;3505;11669;250;960;2521;8243;2771;9203
250050;201811;3445;9583;3154;9155;171;598;2574;7330;2745;7928
250053;201811;1164;3382;1065;3230;86;269;776;2380;862;2649
250057;201811;636;2360;605;2316;10;56;556;2141;566;2197
250060;201811;5189;14211;4772;13673;425;1161;3768;10946;4193;12107
250070;201811;3859;11151;3449;10414;57;257;2733;7992;2790;8249
250073;201811;728;2011;603;1816;9;23;491;1429;500;1452
250077;201811;2201;6045;1648;5090;96;324;1200;3663;1296;3987
250080;201811;4403;11770;3993;11188;97;361;3436;9471;3533;9832
250090;201811;2906;7544;2632;7146;92;248;2240;6003;2332;6251
250100;201811;3702;11511;3430;10994;152;620;2796;8703;2948;9323
250110;201811;4746;13497;4362;12931;379;1355;3401;9795;3780;11150
250115;201811;526;1534;456;1413;8;43;346;1029;354;1072
250120;201811;1789;5324;1506;4853;43;195;1200;3823;1243;4018
250130;201811;5347;15322;4610;14179;96;520;3808;11482;3904;12002
250135;201811;1125;3122;1025;2967;17;63;925;2673;942;2736
250140;201811;2091;6444;1994;6304;89;417;1737;5386;1826;5803
250150;201811;4639;15057;4263;14339;175;837;3440;11268;3615;12105
250153;201811;1463;3772;1217;3415;29;105;1002;2755;1031;2860
250157;201811;1719;5238;1546;4886;119;380;1173;3683;1292;4063
250160;201811;3817;9755;3095;8753;35;133;2834;7970;2869;8103
250170;201811;1732;4536;1554;4264;43;160;1344;3617;1387;3777
250180;201811;17678;45884;15796;43318;976;2976;12236;32895;13212;35871
250190;201811;3992;11067;3455;10193;428;1162;2312;6796;2740;7958
250200;201811;1827;5111;1556;4670;52;179;1326;3962;1378;4141
250205;201811;790;2574;708;2435;22;118;580;1954;602;2072
250210;201811;1521;4671;1391;4457;46;229;1118;3486;1164;3715
250215;201811;1524;4364;1276;3939;66;213;796;2449;862;2662
250220;201811;689;1966;565;1778;27;107;416;1270;443;1377
250230;201811;1586;3712;1163;3059;22;73;943;2400;965;2473
250240;201811;2136;6649;1963;6346;43;184;1683;5367;1726;5551
250250;201811;4420;12562;3913;11827;106;357;3322;9997;3428;10354
250260;201811;1684;4734;1431;4303;46;152;1151;3443;1197;3595
250270;201811;1205;3707;1078;3552;78;263;799;2722;877;2985
250280;201811;3243;9301;2825;8644;101;341;2259;6872;2360;7213
250290;201811;1613;4289;1389;3970;25;59;1149;3300;1174;3359
250300;201811;5332;14712;5012;14320;234;974;4189;11530;4423;12504
250310;201811;1127;3189;972;2912;41;137;739;2166;780;2303
250320;201811;10380;26294;9326;24976;473;1411;7941;21015;8414;22426
250330;201811;2295;6722;1967;6253;140;467;1548;4867;1688;5334
250340;201811;1073;2858;952;2685;8;30;835;2316;843;2346
250350;201811;4057;11236;3666;10684;144;379;3076;9160;3220;9539
250355;201811;1967;6037;1793;5808;29;155;1618;5209;1647;5364
250360;201811;1792;5038;1625;4786;40;128;1338;3924;1378;4052
250370;201811;12040;32658;10402;30262;412;1536;8629;24636;9041;26172
250375;201811;1099;2951;943;2757;10;43;872;2554;882;2597
250380;201811;1582;4220;1475;4076;45;181;1244;3302;1289;3483
250390;201811;1781;4636;1480;4142;176;479;1036;2925;1212;3404
250400;201811;69680;174389;50430;144102;14429;43580;14955;44365;29384;87945
250403;201811;1608;4746;1481;4576;103;473;1144;3368;1247;3841
250407;201811;1207;3116;1018;2837;72;141;749;2129;821;2270
250410;201811;575;1617;507;1500;4;24;436;1263;440;1287
250415;201811;1869;5363;1651;4999;56;219;1360;4077;1416;4296
250420;201811;1204;3458;1096;3309;17;63;1031;3114;1048;3177
250430;201811;6157;15484;5366;14359;188;604;4478;11735;4666;12339
250435;201811;1484;4191;1244;3786;26;110;957;2843;983;2953
250440;201811;4386;12067;3923;11436;86;281;3428;9932;3514;10213
250450;201811;1794;4921;1529;4562;30;117;1282;3798;1312;3915
250460;201811;7092;19469;6441;18571;385;1174;5310;15246;5695;16420
250470;201811;1515;3896;1257;3522;66;199;972;2668;1038;2867
250480;201811;3839;10794;3448;10321;28;117;3136;9460;3164;9577
250485;201811;713;1632;513;1347;28;67;378;946;406;1013
250490;201811;4632;11915;4227;11411;227;711;3605;9597;3832;10308
250500;201811;1907;5350;1701;5009;75;239;1393;4091;1468;4330
250510;201811;5391;13673;4690;12756;90;259;4177;11366;4267;11625
250520;201811;1773;4951;1548;4621;158;492;1062;3145;1220;3637
250523;201811;2171;5388;1974;5142;85;346;1689;4259;1774;4605
250527;201811;1657;4340;1523;4179;38;107;1359;3746;1397;3853
250530;201811;588;1632;517;1532;14;50;456;1344;470;1394
250535;201811;1316;3937;1216;3739;32;148;992;2961;1024;3109
250540;201811;2807;6753;2351;6231;68;154;2048;5467;2116;5621
250550;201811;803;2625;725;2490;23;109;580;1937;603;2046
250560;201811;1629;4611;1475;4392;49;172;1238;3601;1287;3773
250570;201811;2577;7822;2244;7209;76;328;1788;5602;1864;5930
250580;201811;1058;2754;968;2617;57;187;789;2091;846;2278
250590;201811;806;2325;728;2210;19;89;606;1819;625;1908
250600;201811;7922;20893;6805;19377;343;974;5654;16065;5997;17039
250610;201811;2964;8369;2707;8000;135;501;2238;6492;2373;6993
250620;201811;669;1874;588;1721;14;62;461;1314;475;1376
250625;201811;2557;7470;2333;7110;45;230;1969;5837;2014;6067
250630;201811;9450;27172;8081;24601;951;3041;5230;15480;6181;18521
250640;201811;3282;9530;3053;9208;92;429;2578;7551;2670;7980
250650;201811;886;2213;750;2027;35;102;628;1656;663;1758
250660;201811;1606;4076;1405;3795;41;108;1198;3165;1239;3273
250670;201811;2295;7265;2131;6992;57;291;1830;5850;1887;6141
250680;201811;5835;13668;5224;12961;121;464;4704;11344;4825;11808
250690;201811;6502;15291;5857;14460;143;369;5294;12955;5437;13324
250700;201811;4217;12082;3787;11413;343;1037;2862;8565;3205;9602
250710;201811;4392;12773;3827;12009;311;1054;2813;8860;3124;9914
250720;201811;2739;7276;2483;6903;42;202;2215;6057;2257;6259
250730;201811;3951;10691;3503;10095;143;522;2923;8179;3066;8701
250740;201811;1906;4949;1584;4499;109;347;1262;3517;1371;3864
250750;201811;96209;250531;84926;234230;8266;24805;60001;161879;68267;186684
250760;201811;2317;6099;2035;5654;115;327;1566;4238;1681;4565
250770;201811;3769;11810;3458;11405;329;1163;2525;8301;2854;9464
250780;201811;1689;4665;1423;4167;89;300;1041;2967;1130;3267
250790;201811;2347;7187;2097;6792;256;915;1387;4443;1643;5358
250800;201811;2440;6575;2127;6081;99;220;1771;5089;1870;5309
250810;201811;1234;3378;1022;3070;30;89;874;2640;904;2729
250820;201811;1794;5489;1729;5392;55;236;1585;4876;1640;5112
250830;201811;5447;16626;4718;15163;361;1373;3289;10276;3650;11649
250840;201811;799;2547;682;2301;21;91;495;1670;516;1761
250850;201811;1828;5515;1639;5192;39;202;1373;4218;1412;4420
250855;201811;957;2822;833;2617;70;251;609;1873;679;2124
250860;201811;3079;9424;2563;8522;448;1587;1382;4620;1830;6207
250870;201811;1055;2892;905;2628;31;112;738;2110;769;2222
250880;201811;1542;4084;1269;3676;154;453;853;2479;1007;2932
250890;201811;9480;26389;8776;25397;533;2157;7062;19522;7595;21679
250900;201811;2747;8024;2371;7316;88;320;1962;5927;2050;6247
250905;201811;2241;6485;2098;6267;50;189;1891;5632;1941;5821
250910;201811;5570;14415;4705;13358;118;422;4055;11504;4173;11926
250915;201811;1887;4704;1444;4231;18;46;1318;3931;1336;3977
250920;201811;3296;8743;2978;8236;370;978;2131;5833;2501;6811
250930;201811;2120;5844;1952;5602;75;279;1665;4673;1740;4952
250933;201811;1116;3434;994;3203;28;142;745;2325;773;2467
250937;201811;701;1951;590;1759;25;85;445;1333;470;1418
250939;201811;1667;4633;1480;4339;59;202;1185;3418;1244;3620
250940;201811;3768;10439;3406;9902;58;244;2945;8477;3003;8721
250950;201811;1624;4223;1333;3854;28;125;1146;3267;1174;3392
250960;201811;1065;3190;962;3027;36;161;774;2352;810;2513
250970;201811;8182;21789;7105;20036;360;1128;5563;15431;5923;16559
250980;201811;2447;6725;2227;6334;51;197;1865;5163;1916;5360
250990;201811;1853;5953;1643;5513;83;364;1247;4106;1330;4470
251000;201811;2065;5825;1704;5244;30;127;1434;4369;1464;4496
251010;201811;2600;7430;2360;7042;38;164;2130;6316;2168;6480
251020;201811;1674;4480;1554;4334;41;150;1405;3879;1446;4029
251030;201811;959;2625;833;2387;36;106;592;1649;628;1755
251040;201811;1836;5373;1576;4923;51;240;1260;3848;1311;4088
251050;201811;1081;2968;896;2615;54;167;659;1856;713;2023
251060;201811;1041;2271;779;1931;11;44;654;1589;665;1633
251065;201811;425;1169;347;1051;13;36;251;730;264;766
251070;201811;755;2117;656;1980;9;34;569;1696;578;1730
251080;201811;18396;48405;15368;43865;2247;6755;9503;27190;11750;33945
251090;201811;2697;7921;2317;7183;62;235;1870;5737;1932;5972
251100;201811;814;2533;724;2379;29;127;549;1733;578;1860
251110;201811;1671;4608;1461;4217;54;145;1132;3229;1186;3374
251120;201811;6770;20400;5988;19288;276;1152;4710;14998;4986;16150
251130;201811;3755;8941;3386;8514;189;506;2977;7443;3166;7949
251140;201811;4151;11874;3795;11365;102;394;3140;9312;3242;9706
251150;201811;2615;7738;2397;7405;117;508;1951;5824;2068;6332
251160;201811;1995;6157;1804;5848;135;461;1457;4702;1592;5163
251170;201811;1509;4244;1363;4075;39;155;1207;3576;1246;3731
251180;201811;2489;6972;2131;6459;197;651;1427;4271;1624;4922
251190;201811;4353;11528;4100;11234;60;252;3760;10128;3820;10380
251200;201811;3978;12269;3675;11884;88;352;3268;10614;3356;10966
251203;201811;936;3070;892;2976;31;146;686;2216;717;2362
251207;201811;1027;2975;821;2605;24;111;582;1779;606;1890
251210;201811;7171;19137;6017;17641;273;770;4787;14164;5060;14934
251220;201811;1174;2902;920;2543;58;150;708;1979;766;2129
251230;201811;4567;12620;4027;11802;148;551;3292;9416;3440;9967
251240;201811;3528;9914;2996;9099;179;582;2259;6703;2438;7285
251250;201811;9737;26900;8761;25373;871;2570;6393;18015;7264;20585
251260;201811;471;1413;428;1332;16;72;333;999;349;1071
251270;201811;4022;12793;3669;12317;112;482;3145;10618;3257;11100
251272;201811;1319;3654;1221;3509;38;152;1070;3013;1108;3165
251274;201811;881;2537;724;2254;48;179;498;1478;546;1657
251275;201811;1211;3405;1051;3146;43;188;779;2218;822;2406
251276;201811;1285;3445;1158;3288;36;170;976;2689;1012;2859
251278;201811;536;1565;487;1474;36;94;367;1120;403;1214
251280;201811;2189;6149;1969;5798;50;205;1620;4657;1670;4862
251290;201811;5622;14140;5304;13713;262;916;4550;11281;4812;12197
251300;201811;794;2434;739;2351;13;55;625;1978;638;2033
251310;201811;2683;7822;2447;7454;63;278;2013;6011;2076;6289
251315;201811;1652;5255;1528;5039;74;271;1180;3830;1254;4101
251320;201811;1627;4343;1152;3527;36;127;845;2566;881;2693
251330;201811;1970;4713;1626;4298;21;75;1500;3975;1521;4050
251335;201811;1128;3729;1044;3604;33;137;906;3099;939;3236
251340;201811;3602;9192;2925;8276;134;436;2168;6034;2302;6470
251350;201811;1039;3129;957;2994;32;148;811;2455;843;2603
251360;201811;1783;5186;1490;4792;25;122;1295;4169;1320;4291
251365;201811;708;2024;568;1724;15;49;438;1328;453;1377
251370;201811;22068;62433;20260;59922;2898;8739;13562;40416;16460;49155
251380;201811;1188;3450;1057;3237;24;124;901;2654;925;2778
251385;201811;711;1853;559;1582;24;73;419;1135;443;1208
251390;201811;6054;18632;5288;17243;790;2725;3099;9933;3889;12658
251392;201811;938;2647;799;2419;26;120;621;1839;647;1959
251394;201811;624;1920;528;1749;25;100;401;1309;426;1409
251396;201811;699;1927;599;1760;25;57;408;1190;433;1247
251398;201811;904;2348;652;1892;20;80;500;1411;520;1491
251400;201811;1161;2984;952;2687;27;102;739;2007;766;2109
251410;201811;1550;3743;1304;3392;24;113;1121;2818;1145;2931
251420;201811;1848;5040;1527;4660;52;209;1218;3657;1270;3866
251430;201811;1519;4773;1361;4511;42;199;1180;3867;1222;4066
251440;201811;1099;3122;898;2743;22;82;715;2177;737;2259
251445;201811;1485;4299;1400;4173;62;255;1161;3331;1223;3586
251450;201811;4287;12975;3921;12443;93;393;3310;10384;3403;10777
251455;201811;920;2818;836;2663;36;148;638;1988;674;2136
251460;201811;886;2586;788;2426;27;104;653;2013;680;2117
251465;201811;424;1260;361;1123;8;35;289;880;297;915
251470;201811;1168;3280;877;2663;80;259;530;1544;610;1803
251480;201811;944;2545;798;2298;19;90;599;1657;618;1747
251490;201811;1837;5027;1490;4540;62;206;1098;3334;1160;3540
251500;201811;1829;5482;1731;5305;68;266;1493;4514;1561;4780
251510;201811;2575;8046;2193;7264;162;615;1449;4688;1611;5303
251520;201811;948;2529;724;2078;71;192;473;1332;544;1524
251530;201811;13344;33548;11621;31330;136;687;10430;27639;10566;28326
251540;201811;2754;8304;2545;7904;116;434;2050;6244;2166;6678
251550;201811;3606;8780;2869;7828;76;215;2450;6654;2526;6869
251560;201811;574;1749;519;1661;88;292;321;982;409;1274
251570;201811;896;2593;746;2291;19;91;578;1702;597;1793
251580;201811;1893;4644;1689;4350;91;278;1443;3602;1534;3880
251590;201811;1574;4134;1362;3873;57;194;1102;3051;1159;3245
251593;201811;924;2736;847;2612;94;317;533;1589;627;1906
251597;201811;1969;5723;1858;5576;33;123;1644;4852;1677;4975
251600;201811;6289;17395;5661;16430;175;569;4775;13622;4950;14191
251610;201811;3246;9351;2802;8531;315;923;1909;5858;2224;6781
251615;201811;1193;3057;968;2683;27;74;766;2083;793;2157
251620;201811;17373;41642;14149;37839;174;430;12317;33794;12491;34224
251630;201811;4597;11098;3736;9911;209;604;2938;7721;3147;8325
251640;201811;2028;5875;1873;5584;54;246;1603;4656;1657;4902
251650;201811;4051;10824;3580;10221;144;464;3090;8777;3234;9241
251660;201811;3408;10308;3029;9635;91;424;2526;7830;2617;8254
251670;201811;4165;11745;3637;10993;50;241;3335;9982;3385;10223
251675;201811;641;1897;584;1824;88;307;382;1176;470;1483
251680;201811;2633;7151;2136;6430;50;192;1715;5129;1765;5321
251690;201811;3179;9081;2747;8271;85;272;2072;6113;2157;6385
251700;201811;1855;5724;1711;5537;50;244;1465;4633;1515;4877
251710;201811;819;2153;556;1593;51;183;321;890;372;1073
251720;201811;1323;3774;1100;3386;30;130;831;2462;861;2592
251740;201811;656;1816;509;1545;35;118;364;1062;399;1180
260005;201811;29070;62573;24005;55937;1982;4729;18082;41346;20064;46075
260010;201811;9770;25796;8105;23335;476;1435;5026;14664;5502;16099
260020;201811;6793;16321;5770;14844;145;615;4767;12026;4912;12641
260030;201811;6378;17089;5467;15640;206;709;4356;12343;4562;13052
260040;201811;7892;21635;6564;19567;647;2011;4356;13086;5003;15097
260050;201811;12632;34897;11529;33577;326;1039;10197;30146;10523;31185
260060;201811;3912;10217;3363;9294;227;616;2613;7212;2840;7828
260070;201811;10169;26655;8833;24622;530;1780;6783;18463;7313;20243
260080;201811;6540;15284;5729;14088;172;524;4773;11465;4945;11989
260090;201811;4997;13004;4487;12323;733;2007;2995;8292;3728;10299
260100;201811;3171;8539;2672;7788;88;338;2169;6223;2257;6561
260105;201811;5178;13946;4610;13133;163;607;3796;10574;3959;11181
260110;201811;22515;60773;20267;57617;1161;3650;16734;46881;17895;50531
260120;201811;13772;38359;11798;35192;1658;5032;7249;21991;8907;27023
260130;201811;2996;8022;2723;7596;227;692;2008;5457;2235;6149
260140;201811;13090;30469;11325;28223;620;1680;9368;23072;9988;24752
260150;201811;3454;8407;2987;7826;135;430;2519;6470;2654;6900
260160;201811;6517;17424;5558;16175;112;436;4871;14284;4983;14720
260170;201811;17872;45892;15570;42556;1659;4372;11364;31116;13023;35488
260180;201811;3285;9339;2928;8816;125;448;2437;7210;2562;7658
260190;201811;18000;37536;15434;34522;209;599;13566;29749;13775;30348
260200;201811;11095;27128;9703;25383;535;1260;8197;21567;8732;22827
260210;201811;11977;34371;10224;31502;380;1433;8148;24942;8528;26375
260220;201811;10092;25149;9387;24266;206;702;8328;21262;8534;21964
260230;201811;10321;26456;9038;24656;279;860;7467;20066;7746;20926
260240;201811;2775;8277;2428;7691;178;614;1853;5831;2031;6445
260250;201811;2177;5868;1873;5416;98;316;1434;4064;1532;4380
260260;201811;12804;34121;11239;31687;533;1832;8754;24131;9287;25963
260270;201811;3798;9953;3405;9417;147;623;2746;7352;2893;7975
260280;201811;12887;39561;11722;37908;565;2256;9950;31810;10515;34066
260290;201811;37672;100734;33061;93606;4321;12626;21263;59599;25584;72225
260300;201811;9366;25979;8198;24295;268;1163;6739;19770;7007;20933
260310;201811;4664;12577;4180;11912;412;1126;3109;8983;3521;10109
260320;201811;7369;21761;6543;20313;300;936;5323;16555;5623;17491
260330;201811;2525;7845;2263;7309;75;277;1810;5716;1885;5993
260340;201811;2036;5486;1760;5059;32;141;1505;4225;1537;4366
260345;201811;23876;65618;20637;60549;3987;12484;9771;27910;13758;40394
260350;201811;5090;12656;4541;11958;120;362;3999;10450;4119;10812
260360;201811;2461;6600;2242;6199;52;233;1559;4228;1611;4461
260370;201811;5435;15927;4740;14713;232;835;3621;11153;3853;11988
260380;201811;4859;14798;4234;13767;206;732;3131;10056;3337;10788
260390;201811;4251;13087;3640;11822;243;849;2505;7989;2748;8838
260392;201811;3458;11074;3077;10573;134;740;2461;8413;2595;9153
260400;201811;15711;38951;13971;36584;761;2272;10853;27516;11614;29788
260410;201811;65068;166943;52197;148236;10965;32893;22944;66376;33909;99269
260415;201811;4159;11636;3565;10554;102;466;2745;7828;2847;8294
260420;201811;12674;27232;10880;25179;209;589;9780;22402;9989;22991
260430;201811;2870;8918;2461;8118;131;497;1709;5581;1840;6078
260440;201811;3561;9740;3109;8923;123;449;2479;6930;2602;7379
260450;201811;5624;14526;5117;13889;300;705;4226;11621;4526;12326
260460;201811;5236;16347;4560;15005;565;2062;2682;8656;3247;10718
260470;201811;4985;13152;4252;12289;126;320;3807;11218;3933;11538
260480;201811;4087;10967;3446;10053;316;1108;2303;6753;2619;7861
260490;201811;5304;12606;4637;11531;72;260;4108;9969;4180;10229
260500;201811;6095;15810;5188;14448;509;1338;3561;10031;4070;11369
260510;201811;9394;23399;8008;21484;181;617;7035;18623;7216;19240
260515;201811;4391;12384;3361;10378;167;569;2191;6611;2358;7180
260520;201811;17429;41405;15512;38794;1037;2685;12439;30719;13476;33404
260530;201811;9497;27823;8269;25866;211;928;7034;21745;7245;22673
260540;201811;6973;15480;6213;14544;431;906;5316;12507;5747;13413
260545;201811;42;133;19;83;5;19;5;23;10;42
260550;201811;2822;8304;2377;7446;166;701;1542;4689;1708;5390
260560;201811;6063;15583;5177;14312;140;594;4317;11625;4457;12219
260570;201811;7457;21221;6622;20041;519;1676;5093;15370;5612;17046
260580;201811;4340;10584;3884;9943;37;143;3548;9010;3585;9153
260590;201811;6704;15893;5730;14787;289;729;4712;12246;5001;12975
260600;201811;30000;80294;24825;72139;1511;4779;18189;52126;19700;56905
260610;201811;6934;18914;6358;18085;455;1423;4751;13335;5206;14758
260620;201811;15380;42392;13790;39989;1728;5474;9148;26005;10876;31479
260630;201811;2341;6374;1938;5726;40;170;1584;4593;1624;4763
260640;201811;19877;47450;17147;44193;1010;2850;13473;34281;14483;37131
260650;201811;5568;15800;4741;14588;180;766;3956;12009;4136;12775
260660;201811;7297;19546;6331;18274;180;765;5347;15099;5527;15864
260670;201811;2219;5815;1823;5226;87;225;1321;3752;1408;3977
260680;201811;25001;62556;21234;56809;2082;5850;13666;35890;15748;41740
260690;201811;3617;9403;2984;8427;125;427;2377;6616;2502;7043
260700;201811;5969;17550;5683;17210;23;58;5523;16871;5546;16929
260710;201811;1315;3528;1210;3397;52;175;907;2580;959;2755
260720;201811;20679;56413;18458;53130;2858;8456;11534;32895;14392;41351
260730;201811;7291;21814;6468;20614;362;1346;5287;16563;5649;17909
260740;201811;1324;3733;1113;3390;23;116;875;2647;898;2763
260750;201811;6869;19462;5991;18309;136;446;5384;16660;5520;17106
260760;201811;5558;13492;4826;12556;227;646;3917;10237;4144;10883
260765;201811;7549;23097;6784;21963;627;2626;4646;14524;5273;17150
260770;201811;3778;9888;3235;8967;95;323;2567;7001;2662;7324
260775;201811;5132;14055;4659;13347;256;968;3544;9802;3800;10770
260780;201811;3599;10897;3231;10284;350;1309;2019;6233;2369;7542
260790;201811;113854;264804;96824;241654;16368;40195;58165;144964;74533;185159
260795;201811;3049;8223;2634;7620;135;448;1984;5748;2119;6196
260800;201811;5515;12853;4966;12070;179;542;4360;10256;4539;10798
260805;201811;3580;10497;3050;9552;200;714;2148;6600;2348;7314
260810;201811;6580;18081;5910;16811;583;1625;4230;11793;4813;13418
260820;201811;4367;10667;3881;9989;205;692;3078;7651;3283;8343
260825;201811;2851;8756;2493;8104;134;492;1835;5928;1969;6420
260830;201811;4310;12720;3588;11389;501;1469;2280;7436;2781;8905
260840;201811;4071;11053;3611;10374;183;552;2997;8525;3180;9077
260845;201811;4033;11089;3690;10486;279;789;2720;7657;2999;8446
260850;201811;4845;14172;4158;12779;449;1463;2528;7546;2977;9009
260860;201811;3435;9948;2937;9025;110;393;2367;7120;2477;7513
260870;201811;4447;10877;3880;10167;108;418;3432;8794;3540;9212
260875;201811;6674;17536;5594;15816;685;1928;3691;10427;4376;12355
260880;201811;9715;27587;8562;25571;465;1374;6785;20369;7250;21743
260890;201811;13270;35289;11813;33098;955;2938;8347;22844;9302;25782
260900;201811;5207;15394;4445;14102;343;1259;2975;9259;3318;10518
260910;201811;3157;8798;2767;8173;105;366;2168;6326;2273;6692
260915;201811;5105;15193;4552;14514;83;347;4148;13246;4231;13593
260920;201811;3285;8736;2886;8242;115;370;2438;6943;2553;7313
260930;201811;3485;11379;3079;10618;185;745;2398;8172;2583;8917
260940;201811;14464;35562;12685;32887;978;2766;9400;23897;10378;26663
260950;201811;6485;18389;5250;15999;581;2023;2950;8461;3531;10484
260960;201811;63474;151317;52410;135897;7445;20351;30981;78926;38426;99277
260970;201811;5138;14150;4629;13467;167;451;3613;10593;3780;11044
260980;201811;4407;13211;3968;12637;69;266;3605;11535;3674;11801
260990;201811;17402;50188;15091;46968;883;3112;11672;36062;12555;39174
261000;201811;15776;39066;13488;35862;593;2091;10426;27198;11019;29289
261010;201811;2464;6444;2183;6070;76;202;1920;5346;1996;5548
261020;201811;6350;17638;5433;15896;320;1054;4234;11968;4554;13022
261030;201811;4165;11637;3606;10696;217;612;2824;8295;3041;8907
261040;201811;5126;15502;4224;13647;224;878;3040;9614;3264;10492
261050;201811;7689;20758;6956;19509;650;1564;4791;13567;5441;15131
261060;201811;13271;34845;11860;32898;503;1578;9681;26542;10184;28120
261070;201811;58324;131247;48973;118512;3750;8664;36206;86679;39956;95343
261080;201811;5968;15527;5589;14992;189;522;5083;13634;5272;14156
261090;201811;17728;44181;16031;41929;440;1413;13736;35475;14176;36888
261100;201811;8076;23346;7053;21779;642;2150;4986;15414;5628;17564
261110;201811;58751;169904;50416;155824;10308;33415;25476;79007;35784;112422
261120;201811;3785;9510;3242;8795;88;263;2852;7734;2940;7997
261130;201811;7506;18169;6628;17040;113;361;5933;15118;6046;15479
261140;201811;3498;8371;3137;7876;226;611;2479;6116;2705;6727
261150;201811;5230;14153;4631;13194;107;417;3972;11132;4079;11549
261153;201811;1939;5761;1670;5311;79;307;1144;3605;1223;3912
261160;201811;203730;492364;171215;446022;44569;120411;67214;177884;111783;298295
261170;201811;5962;15644;5370;14740;358;939;4224;11573;4582;12512
261180;201811;9796;25260;8731;23842;546;1646;6299;17024;6845;18670
261190;201811;4747;14264;4287;13497;296;1186;3134;9539;3430;10725
261200;201811;3408;7956;3022;7449;182;475;2483;6023;2665;6498
261210;201811;1909;4689;1625;4290;64;197;1384;3601;1448;3798
261220;201811;13614;39784;11354;35376;1538;5222;6331;19499;7869;24721
261230;201811;4397;12589;3676;11634;75;321;3072;9794;3147;10115
261240;201811;5083;13340;4475;12380;271;733;3631;9972;3902;10705
261245;201811;3496;10115;3000;9237;102;463;2362;6999;2464;7462
261247;201811;2967;8941;2496;8063;169;621;1705;5422;1874;6043
261250;201811;20303;48460;17773;45439;2182;5253;12752;33477;14934;38730
261255;201811;4001;11992;3433;10898;165;720;2545;7784;2710;8504
261260;201811;12980;35023;11198;32733;432;1703;9457;27324;9889;29027
261270;201811;3936;10615;3512;9983;214;706;2834;7866;3048;8572
261280;201811;2578;7354;2275;6821;86;347;1785;5197;1871;5544
261290;201811;2910;7835;2520;7344;101;388;2042;5949;2143;6337
261300;201811;11736;34041;10004;30962;645;2426;7066;21367;7711;23793
261310;201811;8105;21856;7041;20283;933;2899;4713;13223;5646;16122
261320;201811;5924;17008;5199;15737;102;423;4327;12836;4429;13259
261330;201811;5860;14919;5407;14300;196;676;4686;12166;4882;12842
261340;201811;4165;12352;3631;11585;205;825;2802;8825;3007;9650
261350;201811;8374;25219;7671;24038;135;660;6310;19367;6445;20027
261360;201811;8387;20745;7114;18946;302;949;5664;14638;5966;15587
261370;201811;20497;54599;17948;50897;2885;8134;10843;30959;13728;39093
261380;201811;3953;12467;3563;11723;500;1823;2289;7373;2789;9196
261390;201811;16047;46913;13785;43116;1388;4688;8817;27456;10205;32144
261400;201811;4612;14963;4045;13761;192;890;2963;9814;3155;10704
261410;201811;9208;24030;7813;21755;549;1524;6163;17012;6712;18536
261420;201811;7103;22438;6584;21758;982;3687;4335;14191;5317;17878
261430;201811;3378;9703;2845;8877;103;406;2330;7180;2433;7586
261440;201811;1477;4498;1272;4093;47;234;886;2742;933;2976
261450;201811;14390;39703;13133;37671;250;973;11124;31738;11374;32711
261460;201811;7273;20293;6553;19254;225;804;5569;16257;5794;17061
261470;201811;4251;10754;3758;10094;48;215;3187;8549;3235;8764
261480;201811;4814;15225;4194;14162;249;991;3173;10477;3422;11468
261485;201811;4990;14458;4320;13346;404;1438;2916;8773;3320;10211
261500;201811;5618;15016;4959;14093;519;1354;3370;9915;3889;11269
261510;201811;1838;5631;1581;5161;73;268;1168;3848;1241;4116
261520;201811;2439;7512;2271;7183;87;318;1558;4981;1645;5299
261530;201811;10966;33716;9182;30206;1402;5210;4119;13165;5521;18375
261540;201811;7674;22612;6932;21429;1178;3606;3907;12527;5085;16133
261550;201811;3597;9685;3161;8984;245;762;2222;6187;2467;6949
261560;201811;7574;22987;6635;21605;418;1638;4932;15997;5350;17635
261570;201811;3394;9378;2792;8392;226;809;1881;5536;2107;6345
261580;201811;6511;17522;5834;16572;131;582;5241;14656;5372;15238
261590;201811;2670;6982;2149;6207;91;279;1593;4582;1684;4861
261600;201811;5213;13462;4363;12209;445;1150;2879;8321;3324;9471
261610;201811;2451;6625;2051;5995;106;364;1512;4406;1618;4770
261618;201811;2510;6451;2246;6094;88;261;1784;4769;1872;5030
261620;201811;3956;11666;3682;11248;861;2436;2194;7013;3055;9449
261630;201811;6704;18850;5646;16902;467;1734;3592;10159;4059;11893
261640;201811;36797;84353;32155;78553;1904;4097;25108;62702;27012;66799
261650;201811;4103;10540;3658;9965;162;569;2703;7281;2865;7850
270010;201811;4279;14915;3811;14051;196;1099;2923;10445;3119;11544
270020;201811;3945;10203;3512;9622;230;732;2854;7620;3084;8352
270030;201811;34525;96594;30065;89402;4582;13468;19086;57124;23668;70592
270040;201811;11239;30561;9767;28785;464;1843;8023;23277;8487;25120
270050;201811;5509;12772;4707;11871;184;465;4160;10526;4344;10991
270060;201811;2013;5329;1757;5003;140;390;1378;3951;1518;4341
270070;201811;4556;13175;4017;12401;151;657;3366;10160;3517;10817
270080;201811;1441;4069;1198;3628;65;214;879;2542;944;2756
270090;201811;1904;5890;1690;5463;78;349;1319;4103;1397;4452
270100;201811;5531;15292;4868;14271;253;942;3881;11112;4134;12054
270110;201811;3275;8054;2621;7272;153;408;2047;5875;2200;6283
270120;201811;3041;8196;2654;7715;84;321;2310;6671;2394;6992
270130;201811;5269;14033;4619;13284;206;658;3845;11103;4051;11761
270135;201811;2028;4973;1761;4662;64;174;1591;4198;1655;4372
270140;201811;9945;23052;8149;20592;531;1598;6438;15546;6969;17144
270150;201811;2681;8124;2569;7974;10;32;2527;7843;2537;7875
270160;201811;5530;16108;4899;15339;70;429;4490;13848;4560;14277
270170;201811;3487;10376;3034;9756;244;1040;2211;6836;2455;7876
270180;201811;2263;7048;2077;6793;51;230;1815;5838;1866;6068
270190;201811;1678;5092;1532;4891;67;275;1300;4109;1367;4384
270200;201811;2492;7565;2140;7074;134;537;1573;5058;1707;5595
270210;201811;5620;13837;4921;13021;164;574;4426;11524;4590;12098
270220;201811;1419;3970;1191;3640;235;756;643;1943;878;2699
270230;201811;9338;27350;7951;25121;808;2923;5325;16406;6133;19329
270235;201811;5809;18321;5204;17280;198;839;4216;13821;4414;14660
270240;201811;10594;29169;8714;26768;1053;3532;6166;18862;7219;22394
270250;201811;2886;7468;2559;7016;286;707;1903;5317;2189;6024
270255;201811;4672;13448;3580;11417;178;738;2564;7975;2742;8713
270260;201811;5618;16913;5222;16277;134;630;4527;13682;4661;14312
270270;201811;1028;2775;937;2657;139;387;637;1804;776;2191
270280;201811;3849;9551;3116;8618;457;820;2161;6370;2618;7190
270290;201811;7802;25088;7077;23898;290;1308;5971;19856;6261;21164
270300;201811;4102;11173;3256;10246;198;630;2440;7800;2638;8430
270310;201811;7128;20256;6204;18860;166;834;5213;15344;5379;16178
270320;201811;5737;16903;5080;15678;636;2078;3475;10423;4111;12501
270330;201811;3765;12654;3439;12180;278;1083;2681;9466;2959;10549
270340;201811;1637;4657;1403;4336;69;213;1137;3490;1206;3703
270350;201811;1903;4652;1597;4280;204;578;1071;2902;1275;3480
270360;201811;2398;6349;2180;6092;77;211;1996;5606;2073;5817
270370;201811;1401;4373;1278;4150;49;210;1014;3242;1063;3452
270375;201811;3141;7499;2671;6944;28;82;2465;6408;2493;6490
270380;201811;5616;16509;4855;15475;445;1492;3383;11009;3828;12501
270390;201811;1176;3088;983;2829;25;122;813;2287;838;2409
270400;201811;6203;16990;5328;15604;249;800;4064;11584;4313;12384
270410;201811;4567;13723;4051;12831;235;849;3192;9950;3427;10799
270420;201811;5614;16898;5146;16225;182;785;4325;13359;4507;14144
270430;201811;138616;348957;112312;314351;24642;72382;49659;141098;74301;213480
270440;201811;4820;13287;4145;12445;119;518;3475;10290;3594;10808
270450;201811;6732;18819;6073;18009;290;1092;5053;14813;5343;15905
270460;201811;3688;8490;3250;7966;52;223;3028;7257;3080;7480
270470;201811;10901;31813;9685;30028;940;3098;6979;21746;7919;24844
270480;201811;2855;7869;2452;7251;155;590;1931;5502;2086;6092
270490;201811;968;2803;858;2669;57;212;666;2040;723;2252
270500;201811;4832;15158;4419;14580;221;905;3581;11670;3802;12575
270510;201811;5721;15856;4966;14808;465;1736;3551;10073;4016;11809
270520;201811;3944;11601;3158;10203;742;2495;1159;3945;1901;6440
270530;201811;1168;3514;1035;3292;67;203;761;2446;828;2649
270540;201811;2149;6486;1913;6175;72;354;1631;5146;1703;5500
270550;201811;6728;18108;5597;16839;552;1493;4191;13025;4743;14518
270560;201811;3128;8527;2784;8041;178;564;2155;6107;2333;6671
270570;201811;4046;11624;3468;10721;150;594;2810;8504;2960;9098
270580;201811;2234;6466;2070;6220;109;331;1788;5350;1897;5681
270590;201811;1608;4792;1487;4636;11;53;1422;4434;1433;4487
270600;201811;2778;8710;2508;8260;76;387;2181;7035;2257;7422
270610;201811;3659;9798;3114;9092;92;366;2738;7861;2830;8227
270620;201811;1268;3959;1159;3759;49;212;964;3036;1013;3248
270630;201811;15742;42073;13983;39359;926;2955;11209;31058;12135;34013
270640;201811;5578;16133;4843;15008;206;852;3852;11553;4058;12405
270642;201811;2353;7776;2137;7434;148;731;1668;5570;1816;6301
270644;201811;3439;8794;2855;8032;238;648;2146;6134;2384;6782
270650;201811;3252;9760;2922;9283;447;1621;1955;5960;2402;7581
270660;201811;2163;5357;1742;4766;73;266;1315;3511;1388;3777
270670;201811;15701;38394;13540;35775;701;2011;11246;29426;11947;31437
270680;201811;5226;13196;4711;12613;163;259;4364;11894;4527;12153
270690;201811;9329;23435;7815;21615;1126;2882;5492;15404;6618;18286
270700;201811;551;1677;476;1537;38;153;341;1088;379;1241
270710;201811;5724;17347;5262;16701;279;1178;4338;13443;4617;14621
270720;201811;3364;10331;2999;9718;83;496;2603;8185;2686;8681
270730;201811;7698;18350;7034;17611;378;937;5643;15156;6021;16093
270740;201811;2368;6377;2117;6053;110;378;1716;4791;1826;5169
270750;201811;5426;14984;4791;14099;196;733;4031;11748;4227;12481
270760;201811;3357;9596;2957;9008;70;343;2502;7481;2572;7824
270770;201811;21171;52227;16863;46891;3230;8389;9402;28029;12632;36418
270780;201811;1776;5278;1682;5145;102;361;1398;4240;1500;4601
270790;201811;1581;4646;1378;4345;131;430;926;2920;1057;3350
270800;201811;10759;30162;9703;28674;428;1768;8266;23725;8694;25493
270810;201811;3260;9798;2604;8613;194;793;1792;5833;1986;6626
270820;201811;1701;5144;1439;4705;85;320;1094;3503;1179;3823
270830;201811;5430;13231;4485;12053;220;738;3591;9547;3811;10285
270840;201811;8154;24410;7333;23230;205;1153;6427;19722;6632;20875
270850;201811;8776;22085;7956;21041;560;1789;6589;16897;7149;18686
270860;201811;12174;30232;10152;27775;530;1700;8191;22021;8721;23721
270870;201811;2064;5975;1794;5507;228;743;1222;3782;1450;4525
270880;201811;8104;24510;7313;23347;256;1109;6066;18998;6322;20107
270890;201811;2603;7250;2272;6786;170;572;1639;4806;1809;5378
270895;201811;2919;9631;2721;9365;85;476;2411;8086;2496;8562
270900;201811;1807;4738;1398;4089;58;207;1081;3092;1139;3299
270910;201811;3748;11269;3257;10424;118;478;2508;7883;2626;8361
270915;201811;9105;27672;7698;25162;863;3299;5012;15855;5875;19154
270920;201811;5456;17073;5079;16473;247;1154;4153;12970;4400;14124
270930;201811;17349;41850;13747;37568;2122;5388;9142;25757;11264;31145
270940;201811;6031;17369;5384;16542;263;1229;4205;12510;4468;13739
280010;201811;671;1845;563;1637;24;102;387;1022;411;1124
280020;201811;4684;12397;4044;11358;577;1533;2649;7505;3226;9038
280030;201811;71875;174768;57493;154203;14642;40115;22691;63424;37333;103539
280040;201811;3033;8628;2668;8053;304;941;1804;5415;2108;6356
280050;201811;3869;11238;3378;10401;559;1811;1987;6102;2546;7913
280060;201811;5345;14771;4327;13174;802;2547;2126;6673;2928;9220
280067;201811;6975;17913;5919;16264;426;1256;4212;11349;4638;12605
280070;201811;1897;5855;1810;5694;101;365;1513;4678;1614;5043
280100;201811;3716;10555;3229;9754;368;1172;2220;6672;2588;7844
280110;201811;1328;3758;1182;3500;30;130;1027;2943;1057;3073
280120;201811;7452;22278;6780;21144;731;2127;5072;16051;5803;18178
280130;201811;8753;21416;7818;20075;634;1717;6031;15472;6665;17189
280140;201811;5541;13745;4917;12888;257;731;4099;10662;4356;11393
280150;201811;3864;10138;3452;9580;224;628;2783;7669;3007;8297
280160;201811;1209;3559;1010;3203;135;438;628;1950;763;2388
280170;201811;5130;13728;4657;13085;268;746;3861;10858;4129;11604
280190;201811;1195;2777;1025;2530;54;150;827;1980;881;2130
280200;201811;1310;3494;1068;3096;103;380;744;2074;847;2454
280210;201811;15295;40289;13493;37737;2029;6013;8067;22555;10096;28568
280220;201811;1758;4780;1521;4461;43;221;1255;3640;1298;3861
280230;201811;3766;9925;3384;9380;270;726;2480;6818;2750;7544
280240;201811;3399;9148;3072;8642;73;337;2604;7114;2677;7451
280250;201811;821;2126;664;1891;73;246;389;1033;462;1279
280260;201811;2114;5279;1930;5042;42;117;1797;4710;1839;4827
280270;201811;2292;6591;2049;6194;131;462;1707;5047;1838;5509
280280;201811;3938;12516;3570;11956;494;1506;2381;8329;2875;9835
280290;201811;17228;47415;15226;44533;2101;6468;9622;28413;11723;34881
280300;201811;10829;27922;9473;26412;318;1016;7468;21954;7786;22970
280310;201811;1359;3617;1125;3206;35;123;844;2322;879;2445
280320;201811;8492;23855;7458;22250;899;2757;4900;14427;5799;17184
280330;201811;4809;12093;4091;11040;294;804;3029;8066;3323;8870
280340;201811;5480;11432;4688;10555;285;562;4018;9190;4303;9752
280350;201811;23923;59220;20926;54885;1631;4494;15778;40878;17409;45372
280360;201811;5823;16733;5175;15596;922;2779;2808;8534;3730;11313
280370;201811;2168;5362;1787;4704;82;222;1436;3718;1518;3940
280380;201811;974;2760;858;2593;99;339;562;1679;661;2018
280390;201811;3523;9107;2905;8073;194;594;2208;6017;2402;6611
280400;201811;3886;10341;3423;9650;537;1433;2058;5978;2595;7411
280410;201811;2109;6171;1731;5472;203;676;1027;3154;1230;3830
280420;201811;4306;11723;3907;11165;102;360;3501;9936;3603;10296
280430;201811;2029;5129;1789;4793;72;266;1431;3722;1503;3988
280440;201811;4461;12137;3910;11308;252;830;3128;8793;3380;9623
280445;201811;2313;5971;2071;5545;55;167;1526;3901;1581;4068
280450;201811;10296;23747;9168;22265;396;784;7857;19270;8253;20054
280460;201811;6688;16414;6110;15601;505;1245;4964;12613;5469;13858
280470;201811;1745;4996;1534;4622;78;292;1127;3326;1205;3618
280480;201811;37641;96142;33521;90218;3087;9094;23972;63176;27059;72270
280490;201811;3812;10966;3268;10043;103;463;2477;7332;2580;7795
280500;201811;945;2321;798;2117;37;130;660;1725;697;1855
280510;201811;2575;6909;2242;6411;105;395;1657;4664;1762;5059
280520;201811;1628;4196;1440;3946;79;214;1166;3162;1245;3376
280530;201811;2689;6559;2312;6095;260;625;1694;4532;1954;5157
280540;201811;8978;24348;8247;23262;235;933;7251;20023;7486;20956
280550;201811;6662;15999;5510;14265;276;857;4368;10960;4644;11817
280560;201811;7035;20189;6649;19618;176;665;5845;16990;6021;17655
280570;201811;6381;16175;5218;14641;262;935;3797;10488;4059;11423
280580;201811;5448;15207;4698;13993;639;1793;3127;9462;3766;11255
280590;201811;2992;7124;2518;6532;173;605;1851;4573;2024;5178
280600;201811;3374;9437;3031;8942;216;719;2161;6313;2377;7032
280610;201811;2578;6438;2336;6107;201;493;1850;4804;2051;5297
280620;201811;5372;13812;4603;12712;461;1144;3271;9332;3732;10476
280630;201811;3746;11043;3386;10490;202;711;2696;8342;2898;9053
280640;201811;2462;6727;2232;6475;56;156;2019;5891;2075;6047
280650;201811;1253;3269;989;2876;75;258;723;2035;798;2293
280660;201811;3166;7560;2820;7155;112;304;2459;6200;2571;6504
280670;201811;19197;44302;16907;41317;1185;3029;13233;32246;14418;35275
280680;201811;2759;6863;2370;6259;201;445;1727;4553;1928;4998
280690;201811;960;2461;803;2230;42;120;597;1617;639;1737
280700;201811;1090;2833;946;2615;20;77;740;2005;760;2082
280710;201811;14803;33688;12826;31428;490;847;11240;28188;11730;29035
280720;201811;2745;6184;2221;5572;130;390;1480;3872;1610;4262
280730;201811;1092;2796;973;2613;78;242;736;1908;814;2150
280740;201811;14024;34964;12004;31810;1434;3654;7914;20766;9348;24420
280750;201811;3512;10080;3129;9399;186;661;2280;6709;2466;7370
280760;201811;6108;17065;5420;15974;623;1794;3586;10845;4209;12639
290010;201811;3120;6680;2136;5148;11;35;1742;4002;1753;4037
290020;201811;5308;14373;4941;13879;381;723;4194;12183;4575;12906
290030;201811;4067;10229;3529;9599;196;494;2953;8079;3149;8573
290035;201811;5201;11598;4201;10296;317;554;3327;8489;3644;9043
290040;201811;4316;10585;3642;9764;135;403;2841;7821;2976;8224
290050;201811;2133;6835;1798;6150;161;651;1191;3969;1352;4620
290060;201811;1299;3251;990;2730;97;340;663;1740;760;2080
290070;201811;34525;80055;29868;74047;2459;6251;21343;52829;23802;59080
290080;201811;5512;16462;4691;15230;563;1906;3134;10308;3697;12214
290090;201811;2216;4285;1652;3680;38;87;1499;3319;1537;3406
290100;201811;9574;25874;8077;23588;1073;2956;4848;14595;5921;17551
290110;201811;5142;14093;4650;13221;472;1384;3206;9016;3678;10400
290115;201811;4305;12484;3666;11463;247;838;2773;8635;3020;9473
290120;201811;6844;16843;5631;15318;151;532;4848;12955;4999;13487
290130;201811;4567;11349;3674;10220;112;416;2952;8090;3064;8506
290135;201811;4325;10290;3530;9005;240;623;2653;6570;2893;7193
290140;201811;4681;12550;3714;11317;126;467;3161;9580;3287;10047
290150;201811;2354;6489;2139;6197;184;581;1594;4529;1778;5110
290160;201811;3161;7657;2874;7289;322;709;2187;5612;2509;6321
290170;201811;3107;8441;2791;8063;106;360;2494;7181;2600;7541
290180;201811;2950;8108;2453;7312;91;326;1960;5758;2051;6084
290190;201811;4084;12020;3647;11412;168;674;2957;9092;3125;9766
290195;201811;2342;5999;1875;5305;45;203;1543;4328;1588;4531
290200;201811;3993;11378;3353;10339;255;846;2546;7812;2801;8658
290205;201811;3437;8940;3045;8374;152;556;2394;6369;2546;6925
290210;201811;13292;37759;11850;35602;1065;2877;8957;27680;10022;30557
290220;201811;2761;7158;2496;6818;176;511;1993;5357;2169;5868
290225;201811;3536;7513;2887;6828;27;74;2725;6443;2752;6517
290230;201811;2425;6689;2210;6437;54;215;1949;5641;2003;5856
290240;201811;3648;9384;3011;8566;126;426;2479;6963;2605;7389
290250;201811;4108;11975;3601;11278;164;517;2939;9445;3103;9962
290260;201811;5374;13647;4431;12280;229;804;3563;9665;3792;10469
290265;201811;3621;10580;2975;9378;152;583;2216;6865;2368;7448
290270;201811;11474;39331;10884;38301;694;2934;8621;29908;9315;32842
290280;201811;5906;17699;5204;16498;371;1354;3770;11764;4141;13118
290290;201811;10033;29773;8275;26474;859;2924;5543;17545;6402;20469
290300;201811;4325;11868;3184;9712;180;622;2231;6788;2411;7410
290310;201811;1538;4009;1287;3666;93;350;955;2637;1048;2987
290320;201811;24329;65897;20046;59426;4821;14431;9426;29064;14247;43495
290323;201811;3746;10221;3298;9571;78;273;2723;7802;2801;8075
290327;201811;4173;12197;3608;11105;295;894;2557;7847;2852;8741
290330;201811;2085;4547;1694;4113;51;114;1494;3626;1545;3740
290340;201811;5683;15207;4576;13794;612;1954;3184;9628;3796;11582
290350;201811;4649;13430;3928;12199;301;980;2811;8780;3112;9760
290360;201811;4998;13424;4355;12559;139;427;3747;10790;3886;11217
290370;201811;5329;13141;4007;11394;219;533;2983;8638;3202;9171
290380;201811;5583;15198;4787;14078;121;399;4163;12286;4284;12685
290390;201811;14457;41551;12355;38381;1372;4295;8320;26263;9692;30558
290395;201811;2774;8327;2336;7554;70;330;1815;5786;1885;6116
290400;201811;3595;9958;2916;8846;100;398;2208;6546;2308;6944
290405;201811;4670;13753;3917;12422;267;872;2743;8827;3010;9699
290410;201811;5712;15912;4510;13928;137;645;3429;10184;3566;10829
290420;201811;2976;8439;2460;7623;118;390;1914;5905;2032;6295
290430;201811;3114;8876;2573;7986;320;1033;1640;5052;1960;6085
290440;201811;2765;7105;2053;5991;53;178;1485;4377;1538;4555
290450;201811;3255;8791;2682;7955;154;513;2064;6012;2218;6525
290460;201811;11872;33429;10236;30367;2493;7563;4378;12912;6871;20475
290470;201811;4357;11378;3270;9775;379;1286;1836;5508;2215;6794
290475;201811;6391;18808;5447;17094;109;548;4375;13385;4484;13933
290480;201811;1819;4739;1577;4372;131;392;1032;2734;1163;3126
290485;201811;4511;13448;3966;12630;137;705;3374;10486;3511;11191
290490;201811;8910;21573;8096;20447;537;1312;6330;16132;6867;17444
290500;201811;3969;12078;3055;10125;516;1790;1378;4431;1894;6221
290510;201811;3347;8703;2843;8028;89;320;2444;6795;2533;7115
290515;201811;3750;10152;3178;9417;68;193;2794;8463;2862;8656
290520;201811;11251;32956;8712;27901;469;1787;5542;17355;6011;19142
290530;201811;5004;14379;4323;13266;170;587;3559;10914;3729;11501
290540;201811;3656;9801;3293;9345;81;286;2983;8407;3064;8693
290550;201811;4387;11374;3847;10742;32;103;3581;10100;3613;10203
290560;201811;6591;17459;5183;15321;495;1752;3451;9907;3946;11659
290570;201811;42990;109628;39084;104557;2935;8112;30841;81925;33776;90037
290580;201811;7740;23479;6876;22174;694;2209;5037;16585;5731;18794
290590;201811;6971;21761;6054;20116;152;622;4966;16494;5118;17116
290600;201811;18374;52175;16621;49443;845;2659;13225;39405;14070;42064
290610;201811;2505;8052;2010;7032;101;430;1389;4765;1490;5195
290620;201811;6510;18304;5675;16920;213;661;4798;14156;5011;14817
290630;201811;9072;22389;7299;20057;640;1747;5602;15434;6242;17181
290640;201811;2737;7282;2046;6161;97;305;1551;4620;1648;4925
290650;201811;12165;32281;11100;30920;2931;7868;6080;17933;9011;25801
290660;201811;3673;9509;3092;8681;81;213;2325;6790;2406;7003
290670;201811;6745;19197;5851;17717;472;1378;4432;13563;4904;14941
290680;201811;10487;29748;9035;27586;235;1177;7319;21758;7554;22935
290682;201811;4598;12364;4047;11570;139;350;3416;9787;3555;10137
290685;201811;3600;8165;2394;6468;215;549;1511;4299;1726;4848
290687;201811;6815;18866;5474;16624;810;2414;3291;10270;4101;12684
290689;201811;2826;8121;2310;7215;138;467;1713;5357;1851;5824
290690;201811;5643;14871;4617;13448;486;1389;3157;9167;3643;10556
290700;201811;2642;7346;2368;6975;88;339;1961;5759;2049;6098
290710;201811;8617;24373;7330;22578;211;833;6211;19006;6422;19839
290720;201811;19027;51811;17481;49599;1023;3185;14252;40095;15275;43280
290730;201811;7167;17758;6177;16556;267;631;4811;12917;5078;13548
290740;201811;1046;2915;797;2474;40;170;595;1827;635;1997
290750;201811;10557;27659;9253;25330;914;2667;6474;17205;7388;19872
290755;201811;2167;6057;1703;5216;97;323;1198;3643;1295;3966
290760;201811;3903;11444;3085;9816;298;861;1921;6349;2219;7210
290770;201811;2554;8445;2356;8193;55;271;1983;6940;2038;7211
290780;201811;8340;20921;7199;19336;364;808;5702;15533;6066;16341
290790;201811;4481;12601;3994;11934;150;466;3400;10217;3550;10683
290800;201811;7173;15121;5313;12945;369;841;3987;9886;4356;10727
290810;201811;5677;15422;4562;13665;123;449;3402;10184;3525;10633
290820;201811;5045;13543;4500;12738;259;828;3311;9396;3570;10224
290830;201811;4628;10726;4146;10091;70;195;3565;8541;3635;8736
290840;201811;16722;45844;14681;42649;1892;4837;9608;29236;11500;34073
290850;201811;6286;16088;5711;15452;440;993;4662;13007;5102;14000
290860;201811;5772;17477;5065;16617;244;855;4227;14090;4471;14945
290870;201811;4842;13403;3734;11408;132;456;2688;8128;2820;8584
290880;201811;1426;3642;1113;3191;78;196;771;2262;849;2458
290890;201811;8294;17967;7508;17053;209;491;6946;15667;7155;16158
290900;201811;2366;6307;1781;5313;108;322;1149;3368;1257;3690
290910;201811;5182;13060;4041;11302;48;193;3358;9263;3406;9456
290920;201811;5132;12741;4748;12271;68;177;4460;11528;4528;11705
290930;201811;8044;22641;6587;20095;222;961;5204;15390;5426;16351
290940;201811;3747;10663;3127;9766;186;674;2428;7597;2614;8271
290950;201811;1502;3878;1261;3520;67;180;911;2556;978;2736
290960;201811;5337;14558;4862;13927;140;438;4175;11930;4315;12368
290970;201811;3565;10382;2952;9347;168;570;2227;7017;2395;7587
290980;201811;11143;28264;9509;25599;1088;3078;5480;14420;6568;17498
290990;201811;9118;25252;8030;23435;371;1381;6495;18361;6866;19742
291000;201811;3365;9134;2709;8296;238;672;2085;6501;2323;7173
291005;201811;14868;36704;13290;34718;805;2207;10937;28361;11742;30568
291010;201811;3019;9157;2451;7972;143;501;1627;5195;1770;5696
291020;201811;1281;3240;1031;2765;27;88;722;1839;749;1927
291030;201811;2433;6126;1685;4743;94;270;1084;2950;1178;3220
291040;201811;5350;15241;4613;14158;196;793;3670;11079;3866;11872
291050;201811;7392;20681;6467;19263;1026;3320;4137;12099;5163;15419
291060;201811;5816;19100;5090;18051;409;1781;3701;12924;4110;14705
291070;201811;15734;43305;13380;39616;551;1990;10726;31408;11277;33398
291072;201811;23584;63374;17477;52000;3620;11235;6849;20504;10469;31739
291075;201811;5075;13449;4508;12515;129;430;3681;9975;3810;10405
291077;201811;1577;4199;1245;3594;53;152;867;2500;920;2652
291080;201811;82914;229848;69469;208707;25857;79625;12168;38855;38025;118480
291085;201811;5726;14574;4780;13205;187;576;4029;11052;4216;11628
291090;201811;1932;3767;1482;3259;170;232;1122;2576;1292;2808
291100;201811;3104;6949;2148;5799;121;396;1637;4307;1758;4703
291110;201811;5806;17988;5007;16581;453;1786;3577;11414;4030;13200
291120;201811;7744;19402;6761;18061;433;1231;5102;13561;5535;14792
291125;201811;2163;3841;1586;3199;129;197;1194;2502;1323;2699
291130;201811;3072;9096;2365;7702;99;466;1689;5268;1788;5734
291140;201811;4654;12932;3483;10681;486;1334;2192;6811;2678;8145
291150;201811;2199;5107;1883;4737;20;53;1732;4336;1752;4389
291160;201811;4977;14291;4241;13161;422;1399;2844;8721;3266;10120
291165;201811;2204;6100;1709;5158;37;145;1256;3665;1293;3810
291170;201811;20469;52631;17352;47505;1053;3135;11267;30523;12320;33658
291180;201811;5939;14559;4641;12642;452;1223;3396;9287;3848;10510
291185;201811;3146;8770;2768;8091;87;296;2194;6300;2281;6596
291190;201811;7638;19152;6403;17465;399;1174;5000;13576;5399;14750
291200;201811;2879;8108;2162;6743;118;379;1309;4015;1427;4394
291210;201811;6806;15273;5318;13476;180;547;4010;10137;4190;10684
291220;201811;3993;11655;3602;11037;261;925;2727;8248;2988;9173
291230;201811;4478;9878;3466;8740;79;152;3123;7988;3202;8140
291240;201811;4214;11070;3695;10180;62;204;3191;8643;3253;8847
291250;201811;3400;10077;2693;8785;182;590;1770;5810;1952;6400
291260;201811;1383;3263;1172;2983;35;107;987;2508;1022;2615
291270;201811;5101;14275;4129;12685;822;2478;2425;7641;3247;10119
291280;201811;2403;6397;1835;5443;191;644;1080;3083;1271;3727
291290;201811;5955;15960;4782;14119;461;1409;3181;9345;3642;10754
291300;201811;3973;10819;3002;9178;144;460;2208;6685;2352;7145
291310;201811;5205;14158;4430;12700;145;489;3637;10223;3782;10712
291320;201811;6061;17633;4741;15005;1119;3332;2229;7371;3348;10703
291330;201811;1803;4599;1526;4147;81;225;1130;2992;1211;3217
291340;201811;4196;10989;3494;9835;91;317;2691;7432;2782;7749
291345;201811;3041;9368;2799;9006;141;497;2274;7320;2415;7817
291350;201811;6766;17385;5266;15365;117;364;4449;13148;4566;13512
291360;201811;34838;85227;28377;76884;3958;11026;16804;46513;20762;57539
291370;201811;7926;21880;7175;20800;554;1754;5368;15414;5922;17168
291380;201811;3341;9678;3004;9142;110;470;2450;7274;2560;7744
291390;201811;12838;29276;10325;26402;502;1383;8264;21052;8766;22435
291400;201811;13798;36911;11731;33785;1778;4660;7015;21546;8793;26206
291410;201811;2905;7656;2220;6491;65;294;1649;4672;1714;4966
291420;201811;1907;4817;1547;4355;46;187;1321;3670;1367;3857
291430;201811;2976;8352;2581;7738;103;428;2050;5977;2153;6405
291440;201811;6470;18780;5575;17245;337;1138;4394;13632;4731;14770
291450;201811;8592;22572;7271;20981;135;272;6357;18914;6492;19186
291460;201811;14869;40760;13185;38206;859;2716;9803;28261;10662;30977
291465;201811;8994;24222;7384;22296;250;1060;6213;18656;6463;19716
291470;201811;15636;37528;13370;34911;661;1657;10042;26925;10703;28582
291480;201811;39801;90951;29772;77195;4055;11051;15441;40048;19496;51099
291490;201811;5242;13818;4642;13071;217;684;4017;11308;4234;11992
291500;201811;5070;12515;4236;11376;69;294;3823;10183;3892;10477
291510;201811;3723;10331;3007;9273;100;489;2409;7322;2509;7811
291520;201811;4392;10422;3440;9143;541;1287;2222;6056;2763;7343
291530;201811;2254;5431;1679;4654;332;827;953;2870;1285;3697
291535;201811;3187;9687;2939;9261;193;579;2238;7147;2431;7726
291540;201811;2251;5013;1573;4229;55;218;1356;3520;1411;3738
291550;201811;5395;12834;4259;11304;448;1067;2771;7484;3219;8551
291560;201811;19703;44629;13607;37254;994;2569;9118;26121;10112;28690
291570;201811;2314;5591;1884;5057;89;189;1558;4292;1647;4481
291580;201811;6159;16609;4907;14899;330;1169;3541;10542;3871;11711
291590;201811;1842;5112;1678;4883;132;409;1343;3875;1475;4284
291600;201811;5132;12991;3869;10963;519;1588;2317;6351;2836;7939
291610;201811;5520;15363;5217;15022;88;320;4883;14031;4971;14351
291620;201811;3213;7133;2328;6152;120;321;1780;4800;1900;5121
291630;201811;3263;7555;2467;6529;240;702;1843;4799;2083;5501
291640;201811;15205;39500;11821;34338;1949;5631;4989;15302;6938;20933
291650;201811;8865;23521;7895;22306;497;1114;6698;19277;7195;20391
291660;201811;2155;5258;1560;4319;137;458;1020;2662;1157;3120
291670;201811;2027;5358;1731;4943;109;288;1368;3944;1477;4232
291680;201811;3967;10297;3331;9268;328;910;2419;6679;2747;7589
291685;201811;4652;11304;3754;10139;272;570;2823;7976;3095;8546
291690;201811;4130;9450;2981;7790;124;305;2422;6247;2546;6552
291700;201811;8654;25514;7723;23817;474;1605;6232;18989;6706;20594
291710;201811;5219;12931;3952;11094;342;1058;2702;7414;3044;8472
291720;201811;4487;13919;3703;12297;478;1688;2338;7574;2816;9262
291730;201811;6389;16915;5505;15731;265;916;4523;12835;4788;13751
291733;201811;2923;7609;2475;6991;75;257;1846;5405;1921;5662
291735;201811;2988;7726;2462;6906;83;247;1983;5520;2066;5767
291740;201811;3835;9996;2979;8564;116;352;2265;6397;2381;6749
291750;201811;19851;48548;16049;42802;1839;5010;10369;27683;12208;32693
291760;201811;10446;31163;8346;27623;2688;10048;2045;6772;4733;16820
291770;201811;7020;19627;5863;17489;552;1741;4124;12038;4676;13779
291780;201811;4951;13567;4491;12881;104;373;3913;11076;4017;11449
291790;201811;2634;7623;2443;7355;245;665;1842;5633;2087;6298
291800;201811;29812;77146;23146;66993;3574;10106;12466;37085;16040;47191
291810;201811;10548;25892;8811;23711;248;823;7637;20343;7885;21166
291820;201811;3791;10291;3323;9616;113;388;2618;7579;2731;7967
291830;201811;4299;10547;3664;9663;236;620;2920;7724;3156;8344
291835;201811;6302;19056;4939;16342;837;2845;2751;9354;3588;12199
291840;201811;46283;128445;40330;120068;5100;15758;27398;82243;32498;98001
291845;201811;2501;6791;2076;6257;120;361;1698;5166;1818;5527
291850;201811;4084;11676;3332;10395;310;871;2361;7590;2671;8461
291855;201811;2104;4361;1664;3840;57;146;1458;3345;1515;3491
291860;201811;2249;5953;1567;4619;37;127;1045;2970;1082;3097
291870;201811;1344;3402;894;2589;54;162;598;1666;652;1828
291875;201811;2661;8102;2374;7560;106;401;1785;5530;1891;5931
291880;201811;5421;15988;4737;14716;328;1012;3439;10674;3767;11686
291890;201811;1498;3271;1017;2686;184;433;630;1679;814;2112
291900;201811;1191;3058;927;2615;21;84;734;2009;755;2093
291905;201811;2703;6828;2079;5792;90;309;1548;4180;1638;4489
291910;201811;2839;7366;2421;6843;79;276;2067;5825;2146;6101
291915;201811;7303;21070;6017;18855;277;1025;4455;13879;4732;14904
291920;201811;25203;69357;22143;65003;2839;8855;14492;41922;17331;50777
291930;201811;2435;6897;2097;6346;250;826;1385;4091;1635;4917
291940;201811;3699;9829;2503;7717;239;718;1437;4347;1676;5065
291950;201811;8902;27588;7719;25269;565;2036;5030;16439;5595;18475
291955;201811;14153;36639;12838;34945;1356;3672;9717;26822;11073;30494
291960;201811;3127;8490;2558;7659;163;493;1928;5906;2091;6399
291970;201811;4232;11449;3665;10656;192;701;2717;7848;2909;8549
291980;201811;10305;29143;8153;25817;683;2112;5521;17690;6204;19802
291990;201811;2095;5707;1920;5511;21;85;1821;5242;1842;5327
291992;201811;4386;10599;3184;8914;295;746;2441;6942;2736;7688
291995;201811;2146;5903;1732;5269;56;259;1393;4122;1449;4381
292000;201811;2528;6317;2072;5689;149;524;1546;4172;1695;4696
292010;201811;6069;14149;4990;12640;237;670;4099;10221;4336;10891
292020;201811;4553;13499;3831;12209;276;993;2778;8609;3054;9602
292030;201811;1698;5426;1632;5307;199;665;920;2904;1119;3569
292040;201811;4268;11269;3493;10146;266;720;2717;8092;2983;8812
292045;201811;4026;10790;3024;9293;54;115;2674;8410;2728;8525
292050;201811;6453;18527;5215;16191;360;1253;3291;10049;3651;11302
292060;201811;12315;28369;11402;27249;654;1500;9796;23128;10450;24628
292070;201811;5746;15258;5062;14430;291;886;4320;12258;4611;13144
292080;201811;3242;8215;2669;7483;102;313;2333;6545;2435;6858
292090;201811;4523;9972;3353;8596;266;672;2567;6689;2833;7361
292100;201811;10364;26557;8914;24622;1379;3990;5354;14739;6733;18729
292105;201811;3319;8778;2934;8201;79;286;2435;6700;2514;6986
292110;201811;6220;15804;4493;12919;1086;3149;1989;5718;3075;8867
292120;201811;6859;18009;5599;15798;450;1326;4080;11316;4530;12642
292130;201811;3261;8115;2725;7442;166;500;2072;5612;2238;6112
292140;201811;5134;12272;4269;11025;291;718;3394;8736;3685;9454
292145;201811;2281;6819;1939;6195;88;315;1450;4627;1538;4942
292150;201811;13094;37069;11720;34943;281;1215;9813;28789;10094;30004
292160;201811;2783;7155;2200;6399;68;212;1842;5410;1910;5622
292170;201811;8309;22593;6932;20261;559;1716;4871;14113;5430;15829
292180;201811;2856;7843;2085;6488;305;902;1182;3677;1487;4579
292190;201811;2906;7823;2481;7206;175;528;1799;5280;1974;5808
292200;201811;7690;20475;5930;17791;1010;3113;3183;9687;4193;12800
292205;201811;3834;10775;3319;9964;70;336;2933;8642;3003;8978
292210;201811;6162;14995;5098;13594;100;447;4541;11885;4641;12332
292220;201811;2067;5158;1814;4789;98;283;1379;3552;1477;3835
292225;201811;3220;9481;2869;8943;84;344;2392;7324;2476;7668
292230;201811;8254;20108;7420;19026;186;672;6283;15728;6469;16400
292240;201811;4906;14223;4207;12889;369;1086;2820;8635;3189;9721
292250;201811;5205;14524;4758;13806;659;1817;3116;9214;3775;11031
292260;201811;3314;8977;2968;8512;144;391;2566;7428;2710;7819
292265;201811;3332;9401;2822;8576;85;403;2205;6512;2290;6915
292270;201811;4160;9862;3382;8910;200;554;2744;7251;2944;7805
292273;201811;2567;5705;2080;5101;69;125;1610;4117;1679;4242
292275;201811;1734;4500;1367;3966;71;173;1053;3105;1124;3278
292280;201811;2558;6235;2126;5735;109;251;1738;4850;1847;5101
292285;201811;2560;6310;2012;5532;92;233;1566;4351;1658;4584
292290;201811;7039;19543;5848;17798;195;729;4785;14503;4980;15232
292300;201811;10118;26478;8006;23744;981;3155;5160;15314;6141;18469
292303;201811;2877;8342;2532;7797;67;198;2170;6700;2237;6898
292305;201811;2532;6757;2335;6472;50;231;2073;5625;2123;5856
292310;201811;6598;17308;5706;16187;202;669;4855;13637;5057;14306
292320;201811;6235;17046;5090;14934;309;960;3804;10883;4113;11843
292330;201811;2718;6108;2171;5483;117;281;1690;4352;1807;4633
292335;201811;4816;12563;4300;11817;303;774;3516;9751;3819;10525
292340;201811;5855;16313;4970;14639;236;737;3725;10776;3961;11513
292350;201811;2502;6746;2063;6171;87;322;1700;5087;1787;5409
292360;201811;4883;13150;4123;11806;344;1105;2830;7873;3174;8978
292370;201811;10983;25099;9603;23259;146;451;8875;21092;9021;21543
292380;201811;6808;19244;6146;18090;446;1302;4677;13678;5123;14980
292390;201811;4378;8653;3183;7245;438;560;2444;5998;2882;6558
292400;201811;21392;63065;18964;58928;1943;6356;13163;40772;15106;47128
292405;201811;4431;10854;3634;9718;169;408;2933;7844;3102;8252
292410;201811;2124;5178;1848;4844;63;179;1627;4279;1690;4458
292420;201811;3626;11095;3355;10669;171;754;2789;8709;2960;9463
292430;201811;4831;14851;3749;12978;314;1122;2478;8672;2792;9794
292440;201811;8378;26930;7752;25995;128;642;7048;23588;7176;24230
292450;201811;3817;11283;3086;9810;153;561;2367;7474;2520;8035
292460;201811;4842;13634;4000;12170;377;1115;2840;8663;3217;9778
292465;201811;2540;6839;2097;6202;98;262;1470;4564;1568;4826
292467;201811;1756;5164;1599;4947;232;667;1092;3498;1324;4165
292470;201811;3027;7667;2354;6595;77;180;1841;5179;1918;5359
292480;201811;6487;15499;5210;13937;90;327;4659;12261;4749;12588
292490;201811;2108;5640;1766;5123;108;312;1340;3907;1448;4219
292500;201811;6457;18068;5273;15908;613;1867;3430;10281;4043;12148
292510;201811;12478;34375;10167;30826;601;2169;7447;22451;8048;24620
292520;201811;6707;17239;5901;16016;704;1911;4208;11436;4912;13347
292525;201811;5724;13790;4742;12636;128;380;4137;11019;4265;11399
292530;201811;26540;72058;21312;63469;5868;17631;7523;23282;13391;40913
292540;201811;3942;8014;3175;7173;135;276;2778;6285;2913;6561
292550;201811;7831;21694;6141;19512;443;1526;4530;14744;4973;16270
292560;201811;4291;11042;3657;10130;108;400;3005;8257;3113;8657
292570;201811;3911;10241;3360;9380;76;272;2954;8103;3030;8375
292575;201811;6922;20506;6421;19812;309;1062;5368;16481;5677;17543
292580;201811;7412;19286;6341;17681;178;565;5309;14662;5487;15227
292590;201811;7285;19497;6510;18301;304;981;5500;15095;5804;16076
292593;201811;2814;7025;2367;6280;79;200;1946;5124;2025;5324
292595;201811;5415;14430;4707;13534;180;607;3940;11174;4120;11781
292600;201811;10921;30004;9496;27916;485;1320;7416;21885;7901;23205
292610;201811;4347;11415;3645;10205;227;530;2600;7456;2827;7986
292620;201811;6417;17869;5440;16745;78;200;5137;15976;5215;16176
292630;201811;8656;21452;7120;18961;545;1443;4921;13160;5466;14603
292640;201811;8153;24443;7188;22874;237;978;5158;16389;5395;17367
292650;201811;4643;11364;4204;10781;139;394;3803;9617;3942;10011
292660;201811;11069;30625;9585;28407;552;1765;7499;22156;8051;23921
292665;201811;2209;6596;1990;6318;80;240;1687;5452;1767;5692
292670;201811;3562;9673;2751;8168;119;419;1878;5462;1997;5881
292680;201811;3930;10728;3187;9336;194;580;2313;6597;2507;7177
292690;201811;2602;6932;1857;5698;170;488;1154;3702;1324;4190
292700;201811;9755;26924;8527;25059;863;2429;5784;17461;6647;19890
292710;201811;2386;7645;2199;7386;60;217;1964;6639;2024;6856
292720;201811;9360;22499;7873;20830;305;824;6375;16999;6680;17823
292730;201811;4351;10554;4102;10238;206;389;3566;8991;3772;9380
292740;201811;325046;819980;292916;771025;49698;133017;174401;455183;224099;588200
292750;201811;6298;16892;5422;15583;292;850;4091;11873;4383;12723
292760;201811;3868;11271;3419;10489;260;861;2473;7521;2733;8382
292770;201811;5892;16413;4932;14948;828;2629;2915;9126;3743;11755
292780;201811;1926;4018;1455;3435;101;205;1133;2624;1234;2829
292790;201811;4107;8806;3236;7854;220;490;2741;6710;2961;7200
292800;201811;10790;27520;9406;25375;387;1055;7765;20739;8152;21794
292805;201811;3435;8587;2719;7608;196;510;2012;5640;2208;6150
292810;201811;10447;28331;8294;25017;273;1093;6168;18178;6441;19271
292820;201811;7580;20725;5509;17483;572;1938;3732;11674;4304;13612
292830;201811;2881;6750;2442;6206;80;263;2146;5409;2226;5672
292840;201811;8954;23515;7834;21974;176;639;6812;18653;6988;19292
292850;201811;2564;6942;2139;6275;148;490;1470;4172;1618;4662
292860;201811;16337;38028;14652;35890;816;1994;11983;29154;12799;31148
292870;201811;16929;44165;14895;41175;1137;3468;9859;26867;10996;30335
292880;201811;11541;31407;9949;29068;366;1502;7719;21719;8085;23221
292890;201811;6382;18578;5680;17457;275;1027;4695;14274;4970;15301
292895;201811;2976;6555;2200;5399;108;273;1695;4115;1803;4388
292900;201811;2711;7505;2510;7179;69;310;2022;5568;2091;5878
292905;201811;4295;11652;3366;10249;203;697;2357;7102;2560;7799
292910;201811;4960;13815;4499;13069;307;1011;3340;9557;3647;10568
292920;201811;9859;27319;9247;26455;288;1114;8029;22501;8317;23615
292925;201811;5307;15222;4651;14071;266;810;3463;10352;3729;11162
292930;201811;6359;19306;5560;17730;471;1812;3480;10728;3951;12540
292935;201811;2227;5973;1795;5488;35;174;1583;4875;1618;5049
292937;201811;3161;7568;2745;7060;75;219;2429;6233;2504;6452
292940;201811;3068;7933;2466;6994;192;458;1774;5162;1966;5620
292950;201811;9727;25340;8632;23664;445;1217;6570;17776;7015;18993
292960;201811;5302;12798;4520;11732;133;393;3615;9166;3748;9559
292970;201811;3967;11538;3410;10724;122;535;2785;8759;2907;9294
292975;201811;4474;9821;3972;9243;200;372;3531;8335;3731;8707
292980;201811;3312;8176;2640;7137;110;346;2083;5520;2193;5866
292990;201811;11452;31495;9660;28319;731;2332;7149;20777;7880;23109
293000;201811;2607;6307;2299;5893;38;142;1817;4717;1855;4859
293010;201811;18053;47113;14756;41740;2134;6141;8802;24782;10936;30923
293015;201811;7788;24640;6278;21583;485;2003;4254;14459;4739;16462
293020;201811;9684;28809;8784;27537;149;682;7814;24657;7963;25339
293030;201811;5453;14793;4201;12842;572;1630;2373;7667;2945;9297
293040;201811;3928;11176;3459;10516;97;348;3010;9138;3107;9486
293050;201811;21459;53976;19163;50674;1417;3864;13958;36809;15375;40673
293060;201811;3503;9244;2861;8182;209;650;2085;5822;2294;6472
293070;201811;24842;61856;20947;56567;3071;8394;13104;36047;16175;44441
293075;201811;3295;10706;2950;10156;221;915;2309;7904;2530;8819
293076;201811;3638;9195;3224;8657;107;289;2711;7346;2818;7635
293077;201811;5882;16730;4840;15159;513;1649;3123;10090;3636;11739
293080;201811;4792;14340;4206;13343;144;626;3342;10350;3486;10976
293090;201811;3170;9406;2475;8243;273;966;1571;5215;1844;6181
293100;201811;5735;15689;4673;13771;332;1023;3531;10336;3863;11359
293105;201811;3688;11771;3236;10852;229;796;2335;7728;2564;8524
293110;201811;2439;6034;2072;5535;72;284;1737;4472;1809;4756
293120;201811;4246;11898;3822;11194;140;369;3175;9325;3315;9694
293130;201811;3796;10571;3387;10042;105;442;2909;8513;3014;8955
293135;201811;29557;71588;21918;60783;4135;12631;9339;25924;13474;38555
293140;201811;2291;5401;2026;5074;93;249;1685;4162;1778;4411
293150;201811;5333;16377;4465;14695;441;1466;3018;9991;3459;11457
293160;201811;3885;9601;3333;8953;267;506;2713;7637;2980;8143
293170;201811;4319;9925;3773;9199;124;347;3145;7562;3269;7909
293180;201811;4689;12819;3810;11330;117;504;3069;8862;3186;9366
293190;201811;13725;38433;12271;36271;256;1109;10688;31291;10944;32400
293200;201811;8061;20313;6667;18220;240;865;5227;13991;5467;14856
293210;201811;5161;13759;4388;12494;320;867;3397;9684;3717;10551
293220;201811;4941;13377;3769;11300;902;2743;1447;4495;2349;7238
293230;201811;3957;10485;3025;9117;286;922;2022;6171;2308;7093
293240;201811;4472;11875;3586;10423;98;266;2728;8118;2826;8384
293245;201811;3957;10732;3552;10160;187;595;2963;8363;3150;8958
293250;201811;5502;13613;4739;12544;256;698;3830;10081;4086;10779
293260;201811;4412;12351;3635;11146;124;397;2570;7829;2694;8226
293270;201811;6809;15904;5510;14478;533;985;4165;11655;4698;12640
293280;201811;4885;12905;4217;11981;275;710;3232;9231;3507;9941
293290;201811;13338;41328;12065;39194;2545;8230;6564;22085;9109;30315
293300;201811;6000;14431;5115;13222;348;823;3723;9751;4071;10574
293305;201811;4051;10173;3566;9517;51;150;3196;8492;3247;8642
293310;201811;2136;5545;1775;4920;72;217;1358;3706;1430;3923
293315;201811;4183;10239;3419;9052;190;473;2720;7159;2910;7632
293317;201811;2464;6223;2200;5818;186;429;1661;4422;1847;4851
293320;201811;10338;27243;9597;26353;446;1319;8368;22897;8814;24216
293325;201811;1688;4410;1366;3933;196;568;873;2525;1069;3093
293330;201811;43425;135949;37758;125609;8458;28549;16825;57100;25283;85649
293340;201811;2376;6670;1927;5880;124;432;1309;3943;1433;4375
293345;201811;3258;9185;2694;8378;306;716;1909;6340;2215;7056
293350;201811;6722;19156;5969;18311;64;228;5546;17308;5610;17536
293360;201811;15107;39368;13055;36758;508;1827;11328;31393;11836;33220
310010;201811;817;1982;577;1627;83;277;248;649;331;926
310020;201811;2296;6581;1717;5541;362;1277;276;821;638;2098
310030;201811;2161;6275;1710;5467;263;946;1066;3245;1329;4191
310040;201811;951;2481;776;2199;46;173;549;1470;595;1643
310050;201811;1565;4987;1407;4692;207;836;783;2500;990;3336
310060;201811;3295;9419;2870;8875;134;569;2358;7174;2492;7743
310070;201811;365;851;247;665;6;16;187;497;193;513
310080;201811;816;2243;555;1706;72;258;224;639;296;897
310090;201811;4489;12450;3732;11169;328;1069;2678;7862;3006;8931
310100;201811;3305;9436;2806;8593;101;441;2245;6641;2346;7082
310110;201811;4839;13086;3835;11286;762;2476;1737;4836;2499;7312
310120;201811;645;1621;405;1205;70;261;202;523;272;784
310130;201811;377;1060;316;958;44;170;194;540;238;710
310140;201811;226;704;165;589;38;160;50;148;88;308
310150;201811;4670;13253;3611;11186;660;2242;1426;4247;2086;6489
310160;201811;7196;19389;5355;16273;1256;4201;1610;4738;2866;8939
310163;201811;983;2912;793;2561;248;895;216;613;464;1508
310170;201811;8945;23602;7345;21120;753;2240;5127;14705;5880;16945
310180;201811;1701;4451;1327;3838;113;405;898;2483;1011;2888
310190;201811;2856;8858;2343;7847;556;2049;313;964;869;3013
310200;201811;1708;5288;1300;4437;245;910;508;1692;753;2602
310205;201811;1075;2975;778;2497;179;627;258;807;437;1434
310210;201811;2684;7155;2224;6419;124;370;1691;4849;1815;5219
310220;201811;1103;3063;897;2718;108;355;606;1787;714;2142
310230;201811;2287;6577;1899;5819;229;837;1132;3216;1361;4053
310240;201811;887;2891;763;2663;63;280;524;1777;587;2057
310250;201811;1020;2798;838;2503;55;215;595;1722;650;1937
310260;201811;2759;7617;1739;5769;498;1888;319;782;817;2670
310270;201811;2655;6772;2064;5950;120;448;1664;4711;1784;5159
310280;201811;2306;5549;1821;4846;312;875;998;2507;1310;3382
310285;201811;1873;6250;1630;5825;168;715;1006;3555;1174;4270
310290;201811;1134;3096;967;2791;223;737;506;1310;729;2047
310300;201811;1465;4563;1313;4299;211;831;667;1980;878;2811
310310;201811;323;831;225;654;39;122;116;329;155;451
310320;201811;506;1337;321;1010;31;119;157;467;188;586
310330;201811;497;1188;298;818;39;128;131;318;170;446
310340;201811;7735;21608;6202;18991;1041;3125;3055;9648;4096;12773
310350;201811;11913;30023;8282;24000;1983;6094;2787;7827;4770;13921
310360;201811;471;1163;370;1036;13;41;278;768;291;809
310370;201811;1279;4113;1077;3710;250;905;316;1119;566;2024
310375;201811;885;2384;593;1905;108;370;227;723;335;1093
310380;201811;387;916;205;592;41;112;77;203;118;315
310390;201811;442;1377;364;1228;91;328;85;229;176;557
310400;201811;9577;24172;6756;19710;1031;3384;3382;9535;4413;12919
310410;201811;781;2307;485;1748;111;420;125;412;236;832
310420;201811;3942;10544;2542;7670;469;1606;705;1866;1174;3472
310430;201811;1437;4073;935;3104;202;731;266;819;468;1550
310440;201811;584;1487;393;1148;22;100;238;666;260;766
310445;201811;1379;4030;1025;3324;62;208;709;2269;771;2477
310450;201811;4716;12185;3553;10330;206;715;2639;7487;2845;8202
310460;201811;1658;4545;1123;3511;234;783;301;909;535;1692
310470;201811;3918;8595;3090;7511;327;914;2317;5524;2644;6438
310480;201811;1069;2878;799;2403;119;406;477;1369;596;1775
310490;201811;2893;8350;2286;7224;364;1360;1089;3153;1453;4513
310500;201811;1455;4246;1052;3469;211;748;476;1540;687;2288
310510;201811;1899;5186;1223;3888;253;889;375;1190;628;2079
310520;201811;1329;3368;953;2739;132;366;542;1543;674;1909
310530;201811;808;2175;441;1361;67;236;97;223;164;459
310540;201811;3305;9683;2737;8657;697;2303;1081;3288;1778;5591
310550;201811;1254;3279;881;2636;84;316;524;1463;608;1779
310560;201811;14054;38375;10470;32115;2221;7596;3650;10107;5871;17703
310570;201811;1095;3042;903;2746;95;376;607;1765;702;2141
310590;201811;4117;11277;3359;9939;316;1065;1909;5362;2225;6427
310600;201811;1409;4276;1159;3747;178;640;558;1682;736;2322
310610;201811;522;1421;336;1106;64;237;161;483;225;720
310620;201811;156645;419231;117035;346253;23495;78353;46900;123531;70395;201884
310630;201811;4441;12503;3703;11124;284;1005;2511;7313;2795;8318
310640;201811;1021;3178;851;2826;205;750;278;861;483;1611
310650;201811;2435;7259;1808;6049;220;817;1015;3258;1235;4075
310660;201811;1266;3517;1083;3281;52;177;876;2603;928;2780
310665;201811;1333;3553;1074;3170;57;208;858;2499;915;2707
310670;201811;48901;132742;41234;118899;5620;18215;25157;68762;30777;86977
310680;201811;672;1686;569;1544;29;85;447;1182;476;1267
310690;201811;1707;4722;1274;3978;137;501;703;2079;840;2580
310700;201811;501;1134;377;986;41;128;256;639;297;767
310710;201811;5288;15768;3781;13521;866;3626;447;1513;1313;5139
310720;201811;913;2340;731;2094;53;182;524;1442;577;1624
310730;201811;9202;26007;7932;23902;532;1983;5610;16509;6142;18492
310740;201811;5279;15122;3596;11529;701;2405;992;2946;1693;5351
310750;201811;1230;3039;867;2508;143;476;381;1009;524;1485
310760;201811;549;1524;412;1287;41;143;181;574;222;717
310770;201811;1071;3017;728;2488;109;416;341;1108;450;1524
310780;201811;4015;10257;3250;9039;159;478;2341;6387;2500;6865
310790;201811;1834;5798;1614;5353;400;1388;589;1982;989;3370
310800;201811;2321;7084;1677;5755;427;1741;101;303;528;2044
310810;201811;1138;2984;919;2589;59;207;605;1636;664;1843
310820;201811;1157;3107;697;2243;158;540;139;440;297;980
310825;201811;2589;8369;2115;7540;95;537;1659;5694;1754;6231
310830;201811;1516;4471;1074;3576;240;894;412;1287;652;2181
310840;201811;1926;5407;1367;4390;330;1160;339;962;669;2122
310850;201811;1529;4234;1301;3921;69;325;1011;2908;1080;3233
310855;201811;3262;8875;2558;7763;231;805;1767;5213;1998;6018
310860;201811;6934;20379;5574;17679;606;1959;3339;10651;3945;12610
310870;201811;1062;2567;800;2175;91;256;567;1546;658;1802
310880;201811;1005;3049;791;2608;91;310;467;1504;558;1814
310890;201811;2267;6515;1485;5018;313;1163;176;497;489;1660
310900;201811;4325;12303;3237;10187;523;1817;1435;4126;1958;5943
310910;201811;1701;4459;1092;3356;124;451;158;417;282;868
310920;201811;1848;5027;1431;4357;265;821;708;2155;973;2976
310925;201811;955;2757;794;2477;112;386;511;1541;623;1927
310930;201811;5838;15809;4270;13254;813;2649;2108;6679;2921;9328
310940;201811;6297;16089;5057;14192;304;1048;3588;9751;3892;10799
310945;201811;1229;3309;1029;3012;109;374;624;1757;733;2131
310950;201811;1863;5645;1276;4329;249;949;427;1304;676;2253
310960;201811;745;1924;433;1338;57;195;156;492;213;687
310970;201811;1172;3531;813;2760;192;710;179;545;371;1255
310980;201811;361;853;227;631;23;65;140;367;163;432
310990;201811;1233;3637;959;3070;215;707;378;1175;593;1882
311000;201811;4052;11694;3063;9960;946;3204;1003;3135;1949;6339
311010;201811;775;2427;627;2097;251;898;174;544;425;1442
311020;201811;1005;2690;675;2059;82;281;306;886;388;1167
311030;201811;1514;4011;1030;3140;255;873;378;1035;633;1908
311040;201811;324;1042;255;870;71;242;67;204;138;446
311050;201811;2413;6519;1878;5665;433;1446;761;2184;1194;3630
311060;201811;2776;7574;1905;5752;313;1103;729;1956;1042;3059
311070;201811;1922;5259;1411;4383;192;735;657;1903;849;2638
311080;201811;999;2501;825;2189;69;256;572;1400;641;1656
311090;201811;1989;6576;1567;5769;387;1580;419;1477;806;3057
311100;201811;2013;6032;1301;4563;312;1225;191;586;503;1811
311110;201811;3531;7688;2090;5598;470;1385;794;2102;1264;3487
311115;201811;1280;3207;1043;2870;74;251;804;2144;878;2395
311120;201811;6564;17733;4874;14570;877;2958;1628;4293;2505;7251
311130;201811;1888;5156;1473;4562;148;598;777;2268;925;2866
311140;201811;1350;3348;1000;2848;80;261;642;1843;722;2104
311150;201811;1475;4813;1224;4323;209;834;648;2193;857;3027
311160;201811;3674;11140;2616;9137;756;2910;672;2269;1428;5179
311170;201811;843;2299;666;2026;43;136;414;1288;457;1424
311180;201811;1321;3115;855;2402;207;626;345;962;552;1588
311190;201811;1050;2943;772;2385;117;434;309;861;426;1295
311200;201811;1732;4894;1253;3933;314;1076;320;891;634;1967
311205;201811;905;2813;752;2504;60;261;423;1348;483;1609
311210;201811;1013;3061;891;2900;134;431;636;2112;770;2543
311220;201811;737;2157;613;1926;86;298;314;911;400;1209
311230;201811;7698;23656;5775;19779;1096;3937;1938;6851;3034;10788
311240;201811;945;2617;733;2317;179;628;363;1120;542;1748
311250;201811;869;2535;699;2243;160;548;318;984;478;1532
311260;201811;2357;5914;1535;4518;300;919;530;1486;830;2405
311265;201811;1224;3293;937;2815;65;234;648;1878;713;2112
311270;201811;3077;9425;2703;8848;214;1011;1915;5901;2129;6912
311280;201811;1167;3169;570;1854;96;344;93;276;189;620
311290;201811;1874;5869;1748;5602;199;660;1168;3705;1367;4365
311300;201811;4574;13281;3844;12088;231;1013;2959;9055;3190;10068
311310;201811;568;1675;486;1516;71;245;224;653;295;898
311320;201811;3041;9644;2667;8795;433;1629;1203;3641;1636;5270
311330;201811;4724;13114;3971;11854;488;1608;2161;6499;2649;8107
311340;201811;10317;30753;8315;26944;2412;8317;2080;6748;4492;15065
311350;201811;2198;5725;1589;4598;158;533;836;2164;994;2697
311360;201811;1039;2698;671;2082;226;767;169;501;395;1268
311370;201811;4348;11267;3278;9435;187;739;2016;5493;2203;6232
311380;201811;403;1269;322;1098;79;278;108;371;187;649
311390;201811;1717;5498;1392;5055;585;2433;338;1044;923;3477
311400;201811;1401;4069;998;3244;145;552;398;1144;543;1696
311410;201811;1583;4891;1346;4560;243;905;689;2355;932;3260
311420;201811;1622;4932;1094;3767;186;675;170;454;356;1129
311430;201811;3358;9280;2216;6974;421;1364;629;1989;1050;3353
311440;201811;2444;7219;1726;5907;406;1594;513;1700;919;3294
311450;201811;1756;5501;1303;4622;335;1312;288;872;623;2184
311455;201811;971;2308;668;1830;178;489;251;700;429;1189
311460;201811;493;1600;335;1266;81;387;92;307;173;694
311470;201811;435;1409;321;1125;71;287;54;170;125;457
311480;201811;1535;5251;1389;5044;48;137;1220;4577;1268;4714
311490;201811;217;677;180;598;52;198;73;217;125;415
311500;201811;412;1086;301;894;29;95;176;515;205;610
311510;201811;2816;7811;1886;6072;354;1260;629;1864;983;3124
311520;201811;559;1697;514;1601;119;414;272;802;391;1216
311530;201811;8788;21405;5701;16250;1439;4505;1504;4224;2943;8729
311535;201811;747;2086;503;1622;99;369;133;392;232;761
311540;201811;514;1659;460;1559;97;325;250;857;347;1182
311545;201811;2041;5808;1756;5425;104;403;1329;4011;1433;4414
311547;201811;1480;3879;1283;3558;43;142;941;2625;984;2767
311550;201811;2721;7885;2165;6822;354;1247;832;2492;1186;3739
311560;201811;279;631;192;511;30;79;106;252;136;331
311570;201811;1871;4421;1360;3713;65;190;1062;2966;1127;3156
311580;201811;2151;4138;1442;3302;173;352;919;2172;1092;2524
311590;201811;478;1364;395;1238;64;238;205;624;269;862
311600;201811;1671;3901;1380;3533;61;183;1167;2917;1228;3100
311610;201811;2378;8069;2000;7214;358;1313;943;3395;1301;4708
311615;201811;2947;8839;2428;7981;173;688;1794;5781;1967;6469
311620;201811;401;1115;345;1033;25;92;270;788;295;880
311630;201811;1343;3731;1084;3227;100;316;711;2038;811;2354
311640;201811;553;1675;454;1479;87;329;199;588;286;917
311650;201811;1890;5092;1622;4663;132;468;1097;2998;1229;3466
311660;201811;2762;8131;2018;6723;405;1475;424;1192;829;2667
311670;201811;1561;4154;1175;3508;201;672;491;1483;692;2155
311680;201811;2082;6131;1594;5255;313;1068;893;2934;1206;4002
311690;201811;576;1289;453;1143;38;90;337;893;375;983
311700;201811;2262;5505;1763;4815;38;139;1458;3875;1496;4014
311710;201811;1469;4343;1015;3455;266;968;326;1105;592;2073
311720;201811;410;1266;331;1109;39;161;173;551;212;712
311730;201811;4397;11112;2690;8009;850;2793;401;1156;1251;3949
311740;201811;808;2372;707;2238;41;119;623;1997;664;2116
311750;201811;3806;11915;3133;10755;481;1802;1603;5263;2084;7065
311760;201811;621;1849;520;1661;90;358;206;544;296;902
311770;201811;1956;5857;1510;4997;292;1042;576;1793;868;2835
311780;201811;1228;3777;862;2985;172;679;227;680;399;1359
311783;201811;2183;6221;1800;5553;53;240;1448;4335;1501;4575
311787;201811;685;2041;484;1574;68;243;185;522;253;765
311790;201811;1513;4017;972;3057;233;812;316;962;549;1774
311800;201811;4589;14295;3803;12545;736;2679;631;1888;1367;4567
311810;201811;951;3000;758;2637;66;266;451;1547;517;1813
311820;201811;746;2002;585;1698;78;265;350;947;428;1212
311830;201811;8152;24303;5682;18747;1547;5452;622;1927;2169;7379
311840;201811;3111;8492;2665;7835;311;1010;1869;5437;2180;6447
311850;201811;306;869;256;788;25;82;160;479;185;561
311860;201811;53986;141650;42116;121535;6961;21358;23072;64457;30033;85815
311870;201811;1825;5065;1261;4020;236;843;466;1311;702;2154
311880;201811;6186;16660;5306;15407;381;1037;3999;11718;4380;12755
311890;201811;1534;3959;1211;3469;125;416;798;2199;923;2615
311900;201811;688;1839;532;1610;61;217;351;1030;412;1247
311910;201811;4219;11086;3204;9749;635;1941;1609;4997;2244;6938
311920;201811;1945;5637;1587;5049;155;504;927;2956;1082;3460
311930;201811;3202;8173;2496;7131;928;2838;754;1987;1682;4825
311940;201811;13758;37863;10283;31134;1578;5238;4607;13033;6185;18271
311950;201811;2132;6061;1610;5129;99;437;1085;3353;1184;3790
311960;201811;558;1363;456;1200;30;142;309;682;339;824
311970;201811;437;1454;292;1079;56;233;61;208;117;441
311980;201811;435;1226;239;812;32;111;69;228;101;339
311990;201811;540;1339;361;1083;82;287;152;425;234;712
311995;201811;967;2739;512;1678;21;73;54;121;75;194
312000;201811;568;1555;476;1416;38;129;339;1005;377;1134
312010;201811;880;2555;682;2197;70;248;399;1239;469;1487
312015;201811;1297;3959;1166;3714;64;280;897;2752;961;3032
312020;201811;1124;3528;946;3206;229;818;336;1114;565;1932
312030;201811;2043;5119;1785;4821;30;127;1637;4378;1667;4505
312040;201811;777;2519;592;2099;67;270;244;826;311;1096
312050;201811;1215;3947;956;3410;214;878;240;746;454;1624
312060;201811;825;2146;567;1800;144;477;254;798;398;1275
312070;201811;880;2613;613;2062;73;281;310;991;383;1272
312080;201811;2760;6978;2063;5902;162;530;1288;3473;1450;4003
312083;201811;880;2383;670;2055;81;273;420;1232;501;1505
312087;201811;2268;6213;1898;5659;79;286;1467;4368;1546;4654
312090;201811;9325;25865;7254;22346;1442;4766;3160;9605;4602;14371
312100;201811;1537;4690;1110;3902;159;677;497;1658;656;2335
312110;201811;1015;3296;853;2951;224;871;238;727;462;1598
312120;201811;688;1981;500;1643;147;559;157;425;304;984
312125;201811;1566;4294;1324;3919;151;486;920;2637;1071;3123
312130;201811;888;2278;674;1910;70;224;267;705;337;929
312140;201811;776;2371;646;2082;140;486;254;742;394;1228
312150;201811;458;1314;387;1147;12;56;276;757;288;813
312160;201811;7786;23006;6082;19830;979;3635;2591;7912;3570;11547
312170;201811;842;2340;672;2038;45;139;441;1299;486;1438
312180;201811;1346;3766;1084;3240;163;518;549;1554;712;2072
312190;201811;556;1685;395;1349;84;308;76;248;160;556
312200;201811;4653;12859;3790;11320;810;2517;1944;5736;2754;8253
312210;201811;1329;3178;960;2640;64;231;657;1736;721;1967
312220;201811;1877;5859;1631;5426;127;454;1030;3409;1157;3863
312230;201811;11644;31946;7818;24730;2241;7777;1224;3404;3465;11181
312235;201811;1715;4683;1401;4219;119;423;984;2888;1103;3311
312240;201811;706;2324;533;1949;113;432;148;519;261;951
312245;201811;2505;6716;2094;6114;75;277;1681;4856;1756;5133
312247;201811;855;2239;617;1877;140;464;284;852;424;1316
312250;201811;969;2572;637;1934;108;335;241;723;349;1058
312260;201811;893;2591;728;2317;54;215;510;1559;564;1774
312270;201811;678;1922;538;1650;32;142;293;820;325;962
312280;201811;433;1304;335;1113;112;382;38;119;150;501
312290;201811;729;2274;602;2025;127;471;189;615;316;1086
312300;201811;918;2768;631;2099;170;609;104;277;274;886
312310;201811;739;2497;629;2270;97;413;284;991;381;1404
312320;201811;1798;4839;1339;4008;399;1256;228;638;627;1894
312330;201811;857;2536;706;2259;80;277;469;1455;549;1732
312340;201811;234;637;179;547;40;143;64;174;104;317
312350;201811;278;606;220;544;27;80;150;355;177;435
312352;201811;1620;4842;1411;4472;138;452;874;2910;1012;3362
312360;201811;2521;7641;1891;6293;394;1405;465;1510;859;2915
312370;201811;1736;4905;1438;4366;272;944;681;1941;953;2885
312380;201811;2182;5089;1844;4656;24;63;1650;4142;1674;4205
312385;201811;1295;3663;1012;3131;218;744;445;1279;663;2023
312390;201811;1871;5604;1421;4758;238;874;474;1427;712;2301
312400;201811;2838;8582;2258;7445;779;2675;615;2060;1394;4735
312410;201811;11335;32897;9419;29462;1895;6170;4587;14091;6482;20261
312420;201811;3694;10630;3150;9650;594;1946;1643;4891;2237;6837
312430;201811;8004;21586;6449;18829;626;2002;4179;11974;4805;13976
312440;201811;894;2893;680;2380;352;1293;67;203;419;1496
312450;201811;1147;3509;866;2964;259;939;278;971;537;1910
312460;201811;422;1107;291;907;44;163;162;515;206;678
312470;201811;490;1245;323;953;58;211;119;300;177;511
312480;201811;1181;2997;813;2475;126;409;419;1223;545;1632
312490;201811;2010;5041;1539;4302;245;698;762;2078;1007;2776
312500;201811;858;2225;682;1963;59;205;440;1231;499;1436
312510;201811;3568;9880;2736;8290;651;1938;934;2798;1585;4736
312520;201811;186;567;157;516;46;147;71;232;117;379
312530;201811;580;1511;497;1406;21;65;436;1235;457;1300
312540;201811;1446;4273;942;3154;184;649;419;1374;603;2023
312550;201811;764;2103;574;1693;46;139;360;980;406;1119
312560;201811;1954;5110;1616;4628;89;324;1257;3555;1346;3879
312570;201811;2207;5833;1714;5152;529;1657;590;1811;1119;3468
312580;201811;566;1695;435;1399;58;213;187;560;245;773
312590;201811;1627;4921;1325;4320;153;618;711;2162;864;2780
312595;201811;1628;5177;1471;4873;313;990;849;2963;1162;3953
312600;201811;968;2433;549;1808;77;300;199;644;276;944
312610;201811;6511;16887;4151;12491;691;2313;1259;3571;1950;5884
312620;201811;2452;6407;1791;5498;65;290;1385;4299;1450;4589
312630;201811;274;859;205;719;39;162;82;277;121;439
312640;201811;579;1605;382;1267;51;171;126;431;177;602
312650;201811;2077;5551;1414;4231;95;326;931;2623;1026;2949
312660;201811;1332;3286;1014;2791;99;330;680;1795;779;2125
312670;201811;4996;13650;4078;12253;285;1186;2797;7988;3082;9174
312675;201811;1239;3514;1008;3116;76;316;764;2281;840;2597
312680;201811;1375;3962;1159;3631;70;305;894;2721;964;3026
312690;201811;2351;5627;1858;4984;119;377;1458;3806;1577;4183
312695;201811;932;2799;804;2565;60;181;608;1947;668;2128
312700;201811;2054;5586;1499;4560;166;567;831;2413;997;2980
312705;201811;1333;3482;1108;3114;29;106;910;2505;939;2611
312707;201811;1396;4225;1076;3608;84;407;642;2008;726;2415
312710;201811;6339;14778;3753;10793;1110;3501;933;2778;2043;6279
312720;201811;989;2854;731;2408;93;367;387;1215;480;1582
312730;201811;1632;3968;1219;3402;85;277;759;2052;844;2329
312733;201811;1454;3868;1104;3208;39;135;745;2071;784;2206
312735;201811;678;1860;583;1682;92;310;372;961;464;1271
312737;201811;815;1949;564;1571;83;265;297;756;380;1021
312738;201811;572;1567;398;1241;65;239;175;500;240;739
312740;201811;399;994;224;707;55;186;51;128;106;314
312750;201811;1293;4189;1063;3736;180;706;441;1470;621;2176
312760;201811;1849;5654;1347;4588;258;915;419;1371;677;2286
312770;201811;42097;104440;26885;78608;6369;19732;8126;23181;14495;42913
312780;201811;2425;7680;2078;7061;235;896;1319;4429;1554;5325
312790;201811;272;679;166;532;13;60;57;150;70;210
312800;201811;4908;14573;3807;12327;797;2824;1560;4885;2357;7709
312810;201811;1749;4826;1145;3747;286;1031;343;990;629;2021
312820;201811;1802;5022;1489;4420;62;238;1046;2998;1108;3236
312825;201811;1309;3203;1145;2991;35;117;962;2484;997;2601
312830;201811;2253;6636;1471;5090;368;1400;314;1047;682;2447
312840;201811;1134;3477;886;2956;139;557;348;1054;487;1611
312850;201811;847;2169;602;1773;58;235;310;816;368;1051
312860;201811;1371;3537;889;2742;235;764;223;667;458;1431
312870;201811;6273;17607;3799;12472;606;2187;887;2678;1493;4865
312880;201811;1383;3639;1113;3217;54;202;626;1805;680;2007
312890;201811;2015;5425;1366;4206;184;582;555;1741;739;2323
312900;201811;1187;3241;963;2947;81;265;585;1850;666;2115
312910;201811;1534;2867;842;1959;132;289;405;951;537;1240
312920;201811;1002;2775;695;2249;147;542;309;925;456;1467
312930;201811;2095;5574;1686;4936;370;1114;719;2058;1089;3172
312940;201811;907;2650;737;2369;106;389;344;1076;450;1465
312950;201811;2878;7480;1974;5978;561;1819;649;1896;1210;3715
312960;201811;1906;5119;1604;4671;119;336;1176;3497;1295;3833
312965;201811;1679;5045;1428;4561;137;453;892;2808;1029;3261
312970;201811;1079;3209;833;2788;176;685;366;1130;542;1815
312980;201811;21518;62615;17998;56077;3145;10922;9278;27351;12423;38273
312990;201811;426;1166;276;904;54;209;113;352;167;561
313000;201811;408;1244;328;1098;42;181;164;511;206;692
313005;201811;2578;7582;2206;6936;166;576;1591;4877;1757;5453
313010;201811;4572;13318;3741;11856;690;2449;2144;6543;2834;8992
313020;201811;913;2859;609;2147;89;340;95;280;184;620
313030;201811;1221;3022;827;2408;105;379;464;1255;569;1634
313040;201811;795;2509;651;2191;55;227;351;1112;406;1339
313050;201811;1751;5100;1250;4335;234;957;343;1039;577;1996
313055;201811;1761;5034;1602;4798;52;162;1371;4086;1423;4248
313060;201811;978;2566;663;2026;209;706;135;352;344;1058
313065;201811;1699;5318;1476;4946;91;404;1091;3532;1182;3936
313070;201811;934;2525;708;2100;95;312;394;1133;489;1445
313080;201811;379;1066;273;860;73;261;71;174;144;435
313090;201811;4631;13059;3943;11827;737;2455;2230;6531;2967;8986
313100;201811;1415;3747;1077;3242;58;222;775;2288;833;2510
313110;201811;1495;4087;1048;3244;109;415;554;1563;663;1978
313115;201811;2402;7411;2089;6764;339;1209;1044;3141;1383;4350
313120;201811;3661;8912;2771;7715;302;926;1697;4666;1999;5592
313130;201811;27296;75151;21690;64350;3092;10301;11174;31250;14266;41551
313140;201811;536;1258;340;956;23;84;234;639;257;723
313150;201811;1384;4027;1009;3269;278;950;259;774;537;1724
313160;201811;971;2569;745;2180;54;187;502;1427;556;1614
313170;201811;11322;34103;8005;27407;1520;5477;2776;8973;4296;14450
313180;201811;2239;6080;1559;4705;220;729;801;2335;1021;3064
313190;201811;4156;12401;3079;10127;584;2042;1020;3121;1604;5163
313200;201811;1079;3122;930;2855;33;133;770;2279;803;2412
313210;201811;3866;11537;3156;10223;460;1615;1782;5610;2242;7225
313220;201811;1745;4751;1173;3631;202;718;409;1106;611;1824
313230;201811;2842;8234;2461;7747;81;249;2082;6609;2163;6858
313240;201811;8822;23011;5589;17529;1067;3803;2254;6460;3321;10263
313250;201811;5696;17383;4648;15401;649;2246;2429;7902;3078;10148
313260;201811;606;1654;422;1289;54;193;194;554;248;747
313270;201811;5481;15234;4393;13439;764;2474;2552;7813;3316;10287
313280;201811;407;1191;281;915;38;134;114;358;152;492
313290;201811;814;2671;634;2378;229;921;175;632;404;1553
313300;201811;1580;4633;1170;3822;336;1165;200;570;536;1735
313310;201811;1036;3230;841;2800;146;559;198;550;344;1109
313320;201811;2140;5809;1506;4795;317;1143;645;2023;962;3166
313330;201811;3965;11077;3090;9678;232;1012;1996;6000;2228;7012
313340;201811;1278;3000;903;2451;113;308;616;1663;729;1971
313350;201811;2193;6364;1512;4905;237;877;554;1621;791;2498
313360;201811;1263;3282;873;2637;148;532;446;1248;594;1780
313370;201811;1292;3864;1153;3600;149;546;664;1926;813;2472
313375;201811;1717;4563;1089;3436;219;800;252;745;471;1545
313380;201811;5652;14918;4068;11977;855;2760;1671;4420;2526;7180
313390;201811;857;2840;767;2687;61;276;495;1657;556;1933
313400;201811;3505;9222;2825;8309;182;571;2173;6261;2355;6832
313410;201811;1255;3394;982;2927;97;339;682;1984;779;2323
313420;201811;15204;35085;7887;22475;1714;5390;1022;2981;2736;8371
313430;201811;873;2601;651;2156;110;419;261;787;371;1206
313440;201811;5939;13090;3838;10328;346;993;2433;6510;2779;7503
313450;201811;623;1792;453;1450;96;342;141;386;237;728
313460;201811;2099;6353;1711;5726;365;1422;779;2427;1144;3849
313470;201811;3019;7628;2428;6804;218;595;1713;4837;1931;5432
313480;201811;888;2599;499;1702;85;316;121;358;206;674
313490;201811;1507;3549;750;2437;266;1001;60;202;326;1203
313500;201811;384;1184;301;985;38;133;115;340;153;473
313505;201811;9481;25790;8162;24098;326;1164;6794;19963;7120;21127
313507;201811;1473;3830;1220;3464;37;143;979;2752;1016;2895
313510;201811;12707;35754;10485;31697;1390;4524;5285;15523;6675;20047
313520;201811;13307;39280;10983;35094;824;2998;7795;24459;8619;27457
313530;201811;506;1477;407;1300;23;87;197;606;220;693
313535;201811;2384;6642;2079;6060;151;424;1465;4209;1616;4633
313540;201811;822;2560;616;2016;126;420;219;687;345;1107
313545;201811;1189;4036;1014;3674;185;727;535;1842;720;2569
313550;201811;1720;5287;1459;4752;379;1347;656;2028;1035;3375
313560;201811;2547;5199;1901;4418;78;172;1596;3683;1674;3855
313570;201811;952;2977;772;2620;187;689;300;975;487;1664
313580;201811;5356;14721;4183;12748;624;2026;2241;6969;2865;8995
313590;201811;954;2762;728;2418;250;909;258;864;508;1773
313600;201811;3724;10423;3118;9433;137;530;2521;7522;2658;8052
313610;201811;1006;2682;816;2332;122;362;487;1346;609;1708
313620;201811;5521;15227;4498;13429;805;2643;2288;6595;3093;9238
313630;201811;8201;20895;5678;17033;763;2603;3003;8924;3766;11527
313640;201811;1010;2459;631;1924;183;610;204;607;387;1217
313650;201811;1815;5586;1507;5071;101;409;972;3272;1073;3681
313652;201811;776;2611;708;2454;128;495;411;1368;539;1863
313655;201811;1076;2978;875;2680;60;206;651;1971;711;2177
313657;201811;1258;3436;970;2956;51;215;699;1995;750;2210
313660;201811;864;2545;698;2215;113;432;363;1058;476;1490
313665;201811;4406;12470;3502;10816;560;1972;1903;5572;2463;7544
313670;201811;44313;115438;29044;88015;5294;17487;11307;32288;16601;49775
313680;201811;984;2708;835;2472;69;227;533;1517;602;1744
313690;201811;815;2702;657;2379;138;527;206;718;344;1245
313695;201811;1686;4804;1305;4165;98;341;884;2828;982;3169
313700;201811;3142;10341;2720;9773;259;954;2090;7527;2349;8481
313710;201811;1366;3372;981;2794;94;272;636;1813;730;2085
313720;201811;5239;14946;3842;12128;619;2197;1601;4621;2220;6818
313730;201811;1273;3052;965;2624;82;203;630;1673;712;1876
313740;201811;1702;6104;1371;5236;328;1382;191;635;519;2017
313750;201811;1912;5380;1483;4516;333;1125;548;1532;881;2657
313753;201811;2114;5198;1432;4078;171;535;796;2202;967;2737
313760;201811;4997;14256;3692;11699;887;3030;1339;3994;2226;7024
313770;201811;3692;10664;2952;9516;267;930;2007;6501;2274;7431
313780;201811;3996;11013;2970;9238;343;1220;825;2597;1168;3817
313790;201811;473;1502;421;1404;60;209;221;702;281;911
313800;201811;1310;3190;1017;2752;119;365;611;1565;730;1930
313810;201811;1591;4229;1269;3763;95;351;912;2660;1007;3011
313820;201811;13902;33672;9389;25811;1551;4744;3473;9161;5024;13905
313830;201811;321;968;274;874;61;206;110;330;171;536
313835;201811;914;2795;748;2468;92;352;348;1074;440;1426
313840;201811;6456;17428;4637;14247;1172;3813;1006;3106;2178;6919
313850;201811;959;2421;780;2154;131;447;409;996;540;1443
313860;201811;2617;7379;1921;5953;343;1144;699;2007;1042;3151
313862;201811;1525;3464;797;2321;64;196;405;1113;469;1309
313865;201811;2257;6325;1962;5861;131;393;1481;4354;1612;4747
313867;201811;1095;3584;933;3251;295;1078;401;1377;696;2455
313868;201811;1673;5343;1415;4832;87;381;1059;3537;1146;3918
313870;201811;787;2211;594;1863;120;410;197;553;317;963
313880;201811;1438;3948;1069;3331;209;702;434;1219;643;1921
313890;201811;1988;4628;1448;3928;130;398;944;2568;1074;2966
313900;201811;3638;11385;2791;9663;780;2936;648;2158;1428;5094
313910;201811;597;1845;443;1539;107;383;86;290;193;673
313920;201811;2993;9536;2473;8472;551;1844;1168;4065;1719;5909
313925;201811;1609;4242;1276;3625;249;672;740;2106;989;2778
313930;201811;5011;15297;4083;13611;372;1405;2644;8698;3016;10103
313940;201811;8184;24786;5889;20663;1306;5262;1236;4668;2542;9930
313950;201811;4665;11145;3442;9487;518;1864;2039;5390;2557;7254
313960;201811;5402;13743;3686;10810;814;2629;1204;3261;2018;5890
313970;201811;1314;3795;1165;3527;46;184;732;2207;778;2391
313980;201811;1348;3674;878;2877;140;528;313;976;453;1504
313990;201811;1722;5858;1295;4795;364;1491;367;1206;731;2697
314000;201811;9308;25502;7869;22972;519;1954;5294;15113;5813;17067
314010;201811;1308;3308;1056;2964;28;106;821;2240;849;2346
314015;201811;2044;5766;1581;5015;231;861;829;2540;1060;3401
314020;201811;504;1412;303;1003;61;227;49;171;110;398
314030;201811;764;2316;601;1973;81;285;297;945;378;1230
314040;201811;687;1902;555;1648;106;349;268;756;374;1105
314050;201811;1663;4615;1211;3755;190;684;571;1603;761;2287
314053;201811;1711;5197;1407;4621;257;819;757;2598;1014;3417
314055;201811;2282;6306;1969;5850;53;215;1620;4823;1673;5038
314060;201811;1168;3237;894;2775;49;185;622;1890;671;2075
314070;201811;4360;12412;3424;10677;792;2531;1354;4095;2146;6626
314080;201811;2043;5652;1325;4234;210;803;438;1202;648;2005
314085;201811;2037;6254;1690;5707;353;1238;803;2730;1156;3968
314090;201811;3843;11332;3292;10439;262;1058;2177;6806;2439;7864
314100;201811;3182;7612;2512;6686;99;261;1970;5263;2069;5524
314110;201811;4168;12414;3463;10986;503;1788;1782;5296;2285;7084
314120;201811;782;1816;337;1041;80;293;60;180;140;473
314130;201811;726;1996;389;1290;47;182;173;551;220;733
314140;201811;4656;13631;3536;11371;608;2073;1555;4881;2163;6954
314150;201811;1412;3738;1088;3160;110;351;692;1911;802;2262
314160;201811;2268;6179;1657;5064;271;885;662;2045;933;2930
314170;201811;1024;2951;830;2562;84;288;487;1392;571;1680
314180;201811;5312;15275;4394;13764;456;1575;2527;7905;2983;9480
314190;201811;668;1821;482;1532;100;352;230;701;330;1053
314200;201811;2880;8353;2381;7454;142;578;1673;5014;1815;5592
314210;201811;1911;5183;1571;4583;163;506;870;2489;1033;2995
314220;201811;1252;3618;905;2978;233;867;281;854;514;1721
314225;201811;1135;3307;981;3065;81;254;704;2201;785;2455
314230;201811;750;2054;637;1913;93;316;389;1190;482;1506
314240;201811;1059;2935;831;2604;191;650;317;999;508;1649
314250;201811;513;1485;326;1069;53;185;119;357;172;542
314260;201811;920;2826;745;2510;168;643;351;1085;519;1728
314270;201811;3202;9305;2590;8304;102;400;1907;6007;2009;6407
314280;201811;3299;7955;2091;5918;326;1022;886;2345;1212;3367
314290;201811;4441;11803;3700;10512;431;1242;2413;6745;2844;7987
314300;201811;1539;4630;1109;3691;278;988;324;1050;602;2038
314310;201811;4697;12827;3391;10530;1055;3511;697;2006;1752;5517
314315;201811;882;3180;759;2906;61;289;522;1932;583;2221
314320;201811;2737;7549;1807;5863;404;1386;638;2059;1042;3445
314330;201811;46812;133637;36194;115247;10828;36041;8045;26304;18873;62345
314340;201811;2332;5960;1265;3932;286;1042;264;643;550;1685
314345;201811;1367;4199;1141;3784;161;555;676;2185;837;2740
314350;201811;954;2729;652;2149;132;480;165;504;297;984
314360;201811;595;1784;372;1294;62;237;94;304;156;541
314370;201811;658;1892;543;1695;26;104;415;1254;441;1358
314380;201811;1116;3248;771;2563;202;745;128;420;330;1165
314390;201811;11737;31654;7751;24018;1694;5579;2056;5712;3750;11291
314400;201811;4025;12122;3217;10681;896;3076;1111;3805;2007;6881
314410;201811;2633;7529;1821;5968;334;1205;603;2066;937;3271
314420;201811;770;1947;584;1686;19;101;432;1176;451;1277
314430;201811;6676;17688;4919;14533;927;2847;1897;5433;2824;8280
314435;201811;1456;4279;1212;3869;43;180;919;2888;962;3068
314437;201811;941;2473;661;2001;53;197;342;1014;395;1211
314440;201811;552;1620;402;1320;114;420;87;237;201;657
314450;201811;1334;3711;1109;3349;128;471;661;1886;789;2357
314460;201811;3392;10657;2448;8528;617;2261;393;1332;1010;3593
314465;201811;2218;6536;1942;5992;66;288;1489;4408;1555;4696
314467;201811;858;2461;731;2234;23;74;588;1781;611;1855
314470;201811;2193;6523;1776;5640;341;1217;762;2230;1103;3447
314480;201811;5909;17924;4195;13987;757;2720;1113;3330;1870;6050
314490;201811;954;2684;704;2148;83;281;405;1179;488;1460
314500;201811;1652;4312;1188;3552;233;709;454;1325;687;2034
314505;201811;1956;5019;1635;4569;109;342;1178;3227;1287;3569
314510;201811;1751;4705;1210;3877;259;907;508;1589;767;2496
314520;201811;4134;13211;2886;10282;529;2077;322;994;851;3071
314530;201811;5528;18317;4989;17253;473;1847;3436;11744;3909;13591
314535;201811;2595;6870;2120;6173;128;471;1597;4549;1725;5020
314537;201811;1127;3289;862;2829;71;272;587;1869;658;2141
314540;201811;406;1070;283;831;26;99;141;383;167;482
314545;201811;1723;4451;1531;4195;49;126;1283;3667;1332;3793
314550;201811;640;1624;469;1374;42;167;237;620;279;787
314560;201811;3836;12193;2995;10323;527;1911;962;3130;1489;5041
314570;201811;292;827;225;703;33;112;106;333;139;445
314580;201811;449;1402;336;1165;91;332;70;245;161;577
314585;201811;666;2168;529;1851;73;308;243;785;316;1093
314587;201811;1959;5570;1513;4829;229;672;822;2684;1051;3356
314590;201811;3221;9417;2269;7486;379;1368;797;2484;1176;3852
314600;201811;1768;5091;1023;3555;214;809;108;337;322;1146
314610;201811;8467;22916;6011;19066;1210;4469;2373;7231;3583;11700
314620;201811;1918;4885;1554;4381;70;251;1265;3476;1335;3727
314625;201811;1471;4392;1276;4100;71;370;1019;3164;1090;3534
314630;201811;5002;13511;4180;12295;130;542;3449;10087;3579;10629
314640;201811;627;1575;437;1250;80;256;204;529;284;785
314650;201811;892;2252;582;1750;57;217;258;676;315;893
314655;201811;1547;4414;1110;3582;238;770;461;1471;699;2241
314660;201811;330;795;206;555;9;20;122;308;131;328
314670;201811;1634;3909;1186;3232;49;181;744;1982;793;2163
314675;201811;1726;4749;1485;4321;111;385;1129;3177;1240;3562
314690;201811;2062;6102;1567;5280;480;1741;396;1325;876;3066
314700;201811;9764;28854;6287;21581;1355;5163;1497;4896;2852;10059
314710;201811;7614;21948;5440;17353;1195;4180;1223;3424;2418;7604
314720;201811;2110;6499;1510;5222;341;1263;337;1134;678;2397
314730;201811;2053;5867;1504;4769;390;1277;367;1102;757;2379
314740;201811;2775;8029;2202;6988;283;1007;1141;3532;1424;4539
314750;201811;326;918;251;767;21;79;130;361;151;440
314760;201811;1865;5862;1276;4477;179;721;316;903;495;1624
314770;201811;1066;3214;532;1781;47;165;131;387;178;552
314780;201811;345;833;224;655;43;137;117;316;160;453
314790;201811;9558;26994;6806;21903;1955;7035;1651;4836;3606;11871
314795;201811;1446;3954;1223;3578;48;207;951;2655;999;2862
314800;201811;10769;28207;6257;19517;1295;4372;1152;3188;2447;7560
314810;201811;8983;25394;6678;21280;1870;6145;1909;6366;3779;12511
314820;201811;954;2491;725;2116;72;268;439;1217;511;1485
314830;201811;1509;4696;1266;4223;290;1029;569;1866;859;2895
314840;201811;900;2969;701;2630;67;349;468;1660;535;2009
314850;201811;1851;4784;1537;4312;63;216;1307;3639;1370;3855
314860;201811;3127;9729;2629;8739;399;1486;1566;5026;1965;6512
314870;201811;6040;16350;4704;14486;392;1338;3386;10410;3778;11748
314875;201811;1719;5282;1532;5030;111;321;1243;4117;1354;4438
314880;201811;885;2185;697;1922;36;93;476;1363;512;1456
314890;201811;435;1273;310;989;45;164;118;340;163;504
314900;201811;668;1820;509;1547;118;384;181;539;299;923
314910;201811;1645;4887;1258;4260;284;1108;571;1797;855;2905
314915;201811;2228;6784;1886;6164;139;535;1274;4034;1413;4569
314920;201811;441;1134;294;929;11;41;200;626;211;667
314930;201811;5151;15483;3960;13107;835;2984;1346;4229;2181;7213
314940;201811;406;1072;342;955;38;99;205;537;243;636
314950;201811;432;1165;281;910;29;121;117;335;146;456
314960;201811;790;2090;609;1734;47;155;408;1091;455;1246
314970;201811;726;2166;592;1924;104;375;268;806;372;1181
314980;201811;1306;3605;965;3068;274;972;261;800;535;1772
314990;201811;2223;6637;1510;4959;339;1238;311;873;650;2111
314995;201811;1596;4642;1290;4095;92;373;786;2370;878;2743
315000;201811;1077;2903;783;2428;81;278;482;1447;563;1725
315010;201811;384;1104;286;910;58;220;120;339;178;559
315015;201811;2111;6263;1898;5933;209;727;1230;3850;1439;4577
315020;201811;808;2423;591;1968;82;307;254;784;336;1091
315030;201811;542;1552;371;1205;99;330;82;241;181;571
315040;201811;829;2473;720;2218;115;381;432;1322;547;1703
315050;201811;1109;2997;863;2642;79;304;470;1402;549;1706
315053;201811;1142;3091;882;2613;72;233;519;1485;591;1718
315057;201811;1623;5253;1408;4815;193;657;864;2992;1057;3649
315060;201811;604;1894;414;1491;80;293;86;310;166;603
315070;201811;582;1604;419;1298;116;404;106;283;222;687
315080;201811;2613;8072;2047;6861;424;1426;948;3158;1372;4584
315090;201811;778;2493;584;2080;106;408;196;654;302;1062
315100;201811;1168;3688;741;2620;141;569;279;873;420;1442
315110;201811;1523;4049;1171;3447;154;463;560;1659;714;2122
315120;201811;11672;28028;8349;23064;1124;3058;4257;12193;5381;15251
315130;201811;1271;3826;1023;3321;166;637;389;1166;555;1803
315140;201811;2762;7964;2137;6795;434;1569;993;2887;1427;4456
315150;201811;4114;10446;2922;8471;452;1459;1290;3609;1742;5068
315160;201811;1555;4005;1007;3089;212;657;410;1220;622;1877
315170;201811;1405;4492;948;3396;232;874;157;554;389;1428
315180;201811;16307;41762;8560;26365;1316;4626;2226;5917;3542;10543
315190;201811;2042;4768;1626;4196;241;653;1161;2958;1402;3611
315200;201811;3638;10938;2683;9138;822;3018;586;1928;1408;4946
315210;201811;7815;21069;5686;16567;710;2293;2581;6818;3291;9111
315213;201811;1114;3015;959;2792;28;82;764;2203;792;2285
315217;201811;2489;7880;1985;6975;113;564;1319;4458;1432;5022
315220;201811;8322;23242;6640;20294;1805;5835;2266;6838;4071;12673
315230;201811;3083;7515;2675;7011;69;169;2322;6235;2391;6404
315240;201811;2405;7430;2108;6908;555;1975;1046;3327;1601;5302
315250;201811;10251;29164;7649;24245;1378;4775;3205;9748;4583;14523
315260;201811;917;2679;504;1707;90;303;39;111;129;414
315270;201811;773;2353;534;1854;84;344;153;452;237;796
315280;201811;2796;7149;1596;4843;356;1177;252;740;608;1917
315290;201811;1198;3090;715;2305;214;750;185;603;399;1353
315300;201811;700;1733;458;1394;162;538;133;416;295;954
315310;201811;1296;3763;975;3131;90;317;536;1625;626;1942
315320;201811;699;2046;490;1648;58;260;211;649;269;909
315330;201811;739;2596;405;1644;76;331;112;407;188;738
315340;201811;3172;8078;2381;6938;183;593;1536;4415;1719;5008
315350;201811;1515;4230;1145;3592;181;638;565;1722;746;2360
315360;201811;1648;5139;1186;4089;198;726;434;1398;632;2124
315370;201811;436;1292;349;1108;71;220;144;450;215;670
315380;201811;191;599;149;502;39;149;23;53;62;202
315390;201811;1176;3562;895;3002;169;614;317;988;486;1602
315400;201811;4004;11424;3192;9915;493;1606;1604;4835;2097;6441
315410;201811;2298;5393;1813;4692;430;1204;525;1341;955;2545
315415;201811;1189;3443;964;3076;245;912;377;1179;622;2091
315420;201811;1137;3379;748;2608;145;518;90;299;235;817
315430;201811;3538;8953;2504;7298;532;1832;935;2486;1467;4318
315440;201811;973;2677;793;2360;92;336;425;1164;517;1500
315445;201811;2027;4993;1470;4166;139;427;1000;2790;1139;3217
315450;201811;2164;6362;1846;5848;284;863;1125;3616;1409;4479
315460;201811;31716;94225;26733;84811;6502;22310;10843;32381;17345;54691
315470;201811;465;1348;371;1171;42;161;194;575;236;736
315480;201811;1353;3960;923;3027;188;650;259;820;447;1470
315490;201811;2941;7343;2008;5975;283;889;737;2157;1020;3046
315500;201811;494;1368;299;932;33;133;140;374;173;507
315510;201811;1239;3443;1065;3172;31;136;905;2623;936;2759
315520;201811;1070;3019;843;2649;58;218;587;1780;645;1998
315530;201811;611;1891;482;1597;173;619;169;529;342;1148
315540;201811;1267;3558;874;2792;112;432;360;1107;472;1539
315550;201811;1831;4978;1275;4033;292;1041;343;1032;635;2073
315560;201811;6130;19463;5356;18059;375;1303;3512;11925;3887;13228
315570;201811;1819;5300;1550;4801;124;486;874;2560;998;3046
315580;201811;2188;5672;1704;4883;377;1234;553;1543;930;2777
315590;201811;911;2496;733;2201;101;357;352;987;453;1344
315600;201811;2380;7887;1755;6632;286;1072;918;3584;1204;4656
315610;201811;903;2363;698;1967;131;446;298;719;429;1165
315620;201811;311;1015;282;969;52;177;160;583;212;760
315630;201811;858;2461;701;2182;161;548;221;616;382;1164
315640;201811;330;907;285;836;32;115;172;472;204;587
315645;201811;939;2498;626;1951;161;544;159;462;320;1006
315650;201811;1714;4481;1363;3974;52;215;1094;3075;1146;3290
315660;201811;2474;6124;1862;5078;122;348;1279;3380;1401;3728
315670;201811;12959;37434;10181;32226;2201;7383;4413;13444;6614;20827
315680;201811;2998;9338;2244;7827;397;1518;978;3301;1375;4819
315690;201811;2710;7102;1746;5407;401;1302;484;1619;885;2921
315700;201811;7186;20781;5556;17527;992;3322;2482;7525;3474;10847
315710;201811;1869;4819;1288;3869;72;316;884;2466;956;2782
315720;201811;4166;12145;3546;11011;194;879;2478;7345;2672;8224
315725;201811;1629;4633;1356;4248;176;564;909;2897;1085;3461
315727;201811;545;1497;400;1228;62;219;175;500;237;719
315730;201811;640;1997;563;1835;70;251;253;780;323;1031
315733;201811;1414;3723;990;2957;179;643;355;976;534;1619
315737;201811;1089;3222;877;2813;55;229;606;1877;661;2106
315740;201811;935;2694;730;2266;141;492;361;1013;502;1505
315750;201811;1208;3351;1009;3025;94;304;632;1897;726;2201
315760;201811;1200;2881;1104;2768;52;121;972;2445;1024;2566
315765;201811;1854;5063;1526;4635;41;152;1326;4006;1367;4158
315770;201811;1037;3210;886;2994;341;1253;275;864;616;2117
315780;201811;26375;76325;22596;69303;2091;7695;14029;40913;16120;48608
315790;201811;3564;11249;3057;10284;828;2919;1405;4792;2233;7711
315800;201811;1191;4512;871;3574;168;759;196;735;364;1494
315810;201811;1294;3270;1116;2999;61;224;888;2257;949;2481
315820;201811;2425;7141;2051;6548;233;839;1387;4340;1620;5179
315830;201811;1083;3200;784;2633;57;234;347;1101;404;1335
315840;201811;792;1992;485;1404;63;221;220;572;283;793
315850;201811;1092;3395;907;3070;192;708;433;1376;625;2084
315860;201811;501;1535;349;1231;77;307;98;316;175;623
315870;201811;448;1190;359;1058;25;90;239;655;264;745
315880;201811;1125;2945;754;2303;62;245;227;627;289;872
315890;201811;1519;4668;1240;4224;371;1354;523;1709;894;3063
315895;201811;5929;16613;4609;13965;580;2015;2247;6266;2827;8281
315900;201811;836;2202;730;2056;66;198;545;1485;611;1683
315910;201811;506;1528;424;1385;73;259;264;836;337;1095
315920;201811;1598;4253;835;2610;153;505;232;674;385;1179
315930;201811;1030;2464;703;1954;140;401;294;800;434;1201
315935;201811;800;2509;662;2241;131;467;212;736;343;1203
315940;201811;586;1729;487;1548;62;202;247;767;309;969
315950;201811;1187;3339;1012;3054;132;389;746;2270;878;2659
315960;201811;3813;11115;2216;7782;702;2851;147;316;849;3167
315970;201811;634;1728;488;1526;63;209;324;1024;387;1233
315980;201811;3987;8886;2198;5950;439;1270;709;1785;1148;3055
315990;201811;3577;9298;2819;8020;324;996;1636;4560;1960;5556
316000;201811;512;1437;404;1261;70;271;170;483;240;754
316010;201811;676;1981;538;1715;37;137;334;986;371;1123
316020;201811;980;3018;806;2684;86;372;492;1504;578;1876
316030;201811;2799;7920;2080;6631;255;859;1299;4155;1554;5014
316040;201811;2883;9338;2177;7942;298;1121;779;3036;1077;4157
316045;201811;1975;5420;1818;5198;126;273;1481;4394;1607;4667
316050;201811;359;1085;271;920;50;189;139;449;189;638
316060;201811;676;1869;516;1616;43;172;340;984;383;1156
316070;201811;5585;16121;4603;14191;855;2803;2020;5967;2875;8770
316080;201811;732;2353;587;2046;151;577;75;250;226;827
316090;201811;437;1321;307;1043;42;173;125;391;167;564
316095;201811;1284;4054;1066;3563;248;867;418;1365;666;2232
316100;201811;2512;7717;1798;6075;327;1188;555;1710;882;2898
316105;201811;844;2293;639;1974;76;244;415;1280;491;1524
316110;201811;12502;38091;10582;34741;1171;4185;6882;22495;8053;26680
316120;201811;1036;3152;664;2203;118;415;157;425;275;840
316130;201811;1244;2831;755;2048;64;212;408;1068;472;1280
316140;201811;1062;2905;683;2212;131;438;327;1049;458;1487
316150;201811;1678;4035;1413;3633;262;802;587;1375;849;2177
316160;201811;1046;2953;848;2597;75;278;526;1539;601;1817
316165;201811;880;2235;670;1894;111;376;351;931;462;1307
316170;201811;1086;2903;814;2474;85;295;488;1417;573;1712
316180;201811;1287;3806;841;2843;173;656;134;359;307;1015
316190;201811;2591;7563;1502;4910;250;842;518;1477;768;2319
316200;201811;3276;9729;2355;7944;516;1934;534;1684;1050;3618
316210;201811;3966;11975;2873;9538;903;3169;279;897;1182;4066
316220;201811;602;1851;400;1388;83;310;48;191;131;501
316225;201811;1400;3357;1066;2781;49;194;784;1889;833;2083
316230;201811;428;1162;327;1010;42;131;164;512;206;643
316240;201811;5824;17081;5151;15998;481;1548;3871;11877;4352;13425
316245;201811;2978;10100;2685;9597;169;965;2018;6823;2187;7788
316250;201811;9394;24078;6680;19501;1684;5366;1888;5325;3572;10691
316255;201811;2805;8050;2447;7503;221;751;1746;5384;1967;6135
316257;201811;1227;3082;875;2523;157;475;416;1162;573;1637
316260;201811;1816;4817;1366;4104;239;782;594;1828;833;2610
316265;201811;1275;3383;924;2780;54;207;619;1809;673;2016
316270;201811;3471;11182;2996;10099;561;2004;1335;4316;1896;6320
316280;201811;3007;9105;2598;8324;396;1392;1373;4243;1769;5635
316290;201811;3326;9593;2581;8114;381;1374;964;2970;1345;4344
316292;201811;4606;12778;3807;11461;421;1483;2639;7696;3060;9179
316294;201811;754;2302;556;1956;109;439;100;321;209;760
316295;201811;2673;7748;2217;6907;134;543;1543;4569;1677;5112
316300;201811;958;3019;811;2738;57;226;534;1800;591;2026
316310;201811;959;2401;549;1715;83;288;159;454;242;742
316320;201811;573;1663;436;1411;55;211;190;589;245;800
316330;201811;1055;2980;783;2440;67;254;529;1570;596;1824
316340;201811;1049;3056;769;2492;82;343;394;1181;476;1524
316350;201811;1170;3553;1015;3303;137;480;643;2059;780;2539
316360;201811;661;1746;524;1518;74;238;347;976;421;1214
316370;201811;4645;13172;3570;11091;755;2682;1112;3045;1867;5727
316380;201811;1611;4015;1246;3509;38;106;895;2507;933;2613
316390;201811;850;2317;627;1923;215;742;149;411;364;1153
316400;201811;1226;3570;824;2763;135;491;290;897;425;1388
316410;201811;1059;3219;885;2929;66;247;689;2221;755;2468
316420;201811;1719;5210;1544;4967;76;328;1238;3881;1314;4209
316430;201811;853;2394;543;1791;129;459;120;370;249;829
316440;201811;713;2257;547;1972;135;551;76;253;211;804
316443;201811;581;1699;444;1431;106;370;108;342;214;712
316447;201811;1828;5018;1592;4654;65;221;1270;3671;1335;3892
316450;201811;2205;6892;1701;5826;214;773;1030;3469;1244;4242
316460;201811;938;2554;785;2306;201;639;387;1063;588;1702
316470;201811;6114;18182;4603;15082;881;3265;1604;4823;2485;8088
316480;201811;197;586;168;527;30;105;82;238;112;343
316490;201811;308;844;224;675;26;90;97;260;123;350
316500;201811;1195;3948;764;2824;148;575;120;414;268;989
316510;201811;688;2367;551;2084;126;512;223;843;349;1355
316520;201811;1037;2823;814;2441;130;475;367;1020;497;1495
316530;201811;1016;2873;756;2390;122;482;327;890;449;1372
316540;201811;722;2101;608;1913;101;374;262;757;363;1131
316550;201811;1252;3900;1116;3621;93;356;820;2602;913;2958
316553;201811;3387;10525;2285;7820;528;1952;520;1609;1048;3561
316555;201811;2564;8546;2321;8199;156;660;1762;6303;1918;6963
316556;201811;597;1459;415;1148;23;67;236;588;259;655
316557;201811;919;3072;801;2850;305;1151;223;760;528;1911
316560;201811;271;837;208;748;52;218;55;179;107;397
316570;201811;1097;3404;967;3148;279;930;328;1047;607;1977
316580;201811;387;914;241;658;46;138;100;256;146;394
316590;201811;1310;3517;953;2830;172;516;513;1450;685;1966
316600;201811;984;3135;854;2858;163;591;422;1374;585;1965
316610;201811;599;1931;497;1759;66;311;307;1020;373;1331
316620;201811;2014;5753;1759;5378;105;379;1299;3994;1404;4373
316630;201811;1514;4642;1211;4043;353;1164;446;1638;799;2802
316640;201811;142;391;117;354;26;84;56;141;82;225
316650;201811;991;3280;801;2977;68;274;497;1894;565;2168
316660;201811;196;498;89;270;11;40;12;36;23;76
316670;201811;1880;4977;1413;4193;401;1267;419;1175;820;2442
316680;201811;2056;5433;1611;4686;146;496;1143;3232;1289;3728
316690;201811;1070;3314;878;2946;185;680;375;1246;560;1926
316695;201811;980;2939;825;2660;40;177;564;1782;604;1959
316700;201811;379;946;317;875;15;66;243;629;258;695
316710;201811;2779;9588;2149;8215;575;2297;752;2896;1327;5193
316720;201811;19371;56020;14549;46354;3001;10270;5544;16802;8545;27072
316730;201811;389;1130;314;970;62;222;134;360;196;582
316740;201811;669;2071;608;1978;59;262;423;1347;482;1609
316750;201811;402;1260;306;1059;69;260;111;357;180;617
316760;201811;3690;11779;2940;10281;1245;4664;734;2463;1979;7127
316770;201811;1500;3743;1220;3355;37;127;1034;2858;1071;2985
316780;201811;572;1774;441;1513;144;576;61;169;205;745
316790;201811;718;1965;508;1572;122;395;142;414;264;809
316800;201811;5779;16947;4692;14949;452;1667;2632;8082;3084;9749
316805;201811;971;2182;826;2024;19;32;737;1864;756;1896
316810;201811;580;1624;413;1310;86;326;200;607;286;933
316820;201811;331;822;168;515;15;51;51;158;66;209
316830;201811;667;1940;560;1768;88;340;329;986;417;1326
316840;201811;2649;7448;2220;6666;336;1177;1256;3563;1592;4740
316850;201811;2028;5461;1469;4456;211;716;655;1913;866;2629
316860;201811;17397;48263;13464;42124;2579;9159;5916;17906;8495;27065
316870;201811;6620;19329;5006;16051;1023;3639;1829;5431;2852;9070
316880;201811;814;2233;671;2025;139;481;291;859;430;1340
316890;201811;1133;2621;718;2062;142;482;387;976;529;1458
316900;201811;2238;6292;1770;5343;381;1272;583;1579;964;2851
316905;201811;492;1537;400;1344;99;356;152;506;251;862
316910;201811;861;2402;574;1906;156;591;50;150;206;741
316920;201811;1583;4144;1051;3275;194;661;443;1371;637;2032
316930;201811;7649;23710;5579;19556;1070;4023;1196;4012;2266;8035
316935;201811;3858;10946;2764;8883;622;2081;874;2736;1496;4817
316940;201811;6594;20181;5041;16725;941;3466;1659;5035;2600;8501
316950;201811;1737;4313;1354;3762;54;191;1054;2845;1108;3036
316960;201811;4908;11689;3649;9873;500;1474;2274;5986;2774;7460
316970;201811;3312;9921;2912;9113;677;2213;1060;3124;1737;5337
316980;201811;712;2188;515;1783;159;610;67;238;226;848
316990;201811;10145;29092;7306;22968;2009;6662;843;2435;2852;9097
317000;201811;2627;8152;2367;7754;180;569;1726;5718;1906;6287
317005;201811;2543;7464;2073;6533;375;1222;1027;3168;1402;4390
317010;201811;22658;55074;13899;41446;3504;11400;3808;11805;7312;23205
317020;201811;59871;148148;33994;100659;6636;21401;8982;24125;15618;45526
317030;201811;645;1822;518;1627;28;115;390;1199;418;1314
317040;201811;10351;27414;7402;22195;1863;5852;2615;7956;4478;13808
317043;201811;812;1951;610;1666;95;274;377;1043;472;1317
317047;201811;1164;2858;791;2251;126;331;427;1237;553;1568
317050;201811;1249;3988;872;3082;120;434;308;979;428;1413
317052;201811;2347;6905;1933;6194;265;926;1223;3843;1488;4769
317057;201811;1608;4102;1154;3320;60;224;743;2067;803;2291
317060;201811;416;1133;240;747;40;134;84;229;124;363
317065;201811;1229;3581;1000;3150;62;242;648;1904;710;2146
317070;201811;7872;22423;5253;17091;1146;4210;1085;3298;2231;7508
317075;201811;900;2552;621;1990;117;394;165;487;282;881
317080;201811;5893;14558;4388;12046;1411;4082;1181;2988;2592;7070
317090;201811;4314;13530;3942;12932;396;1309;2826;9228;3222;10537
317100;201811;2520;6147;1697;4881;484;1503;563;1569;1047;3072
317103;201811;1795;5724;1574;5315;170;804;998;3092;1168;3896
317107;201811;1316;3705;1043;3152;59;246;629;1681;688;1927
317110;201811;699;1540;336;996;38;143;112;348;150;491
317115;201811;1092;3214;922;2878;62;189;674;2100;736;2289
317120;201811;11835;34501;9308;30104;1451;5230;4757;14785;6208;20015
317130;201811;9379;22944;5904;17180;1219;3903;1881;5372;3100;9275
317140;201811;620;1858;525;1678;61;200;327;1062;388;1262
317150;201811;1009;2527;800;2257;42;160;627;1707;669;1867
317160;201811;3588;8849;2468;7131;249;743;1443;4200;1692;4943
317170;201811;1949;5020;1348;3924;215;736;493;1234;708;1970
317180;201811;1652;5414;1273;4507;279;1048;319;1055;598;2103
317190;201811;1218;3423;917;2925;113;373;550;1739;663;2112
317200;201811;4807;13150;3563;10864;921;3001;744;2108;1665;5109
317210;201811;1121;2862;882;2520;50;197;635;1832;685;2029
317220;201811;279;907;239;818;59;210;91;309;150;519
320010;201811;4488;13454;3677;11856;597;2038;2129;6691;2726;8729
320013;201811;1613;4868;1171;3847;193;619;530;1773;723;2392
320016;201811;2972;7837;2398;7005;125;358;1907;5537;2032;5895
320020;201811;3973;11026;2986;9235;735;2412;985;3126;1720;5538
320030;201811;1496;4501;1036;3502;231;857;337;1066;568;1923
320035;201811;1657;4752;1403;4318;402;1358;596;1768;998;3126
320040;201811;3520;10571;2885;9342;471;1647;1434;4526;1905;6173
320050;201811;1764;4190;1517;3803;269;760;854;2074;1123;2834
320060;201811;10379;30446;7766;25133;1400;4961;3065;9430;4465;14391
320070;201811;1393;4109;1004;3292;206;721;310;985;516;1706
320080;201811;5373;14363;3872;11407;795;2489;1401;4008;2196;6497
320090;201811;6932;19246;5041;15462;1156;3784;2097;6076;3253;9860
320100;201811;2539;7536;1997;6481;468;1624;880;2775;1348;4399
320110;201811;1316;3525;1033;3018;212;636;404;1175;616;1811
320115;201811;1764;5935;1533;5516;724;2701;436;1623;1160;4324
320120;201811;16245;43914;11415;35082;2144;7159;4202;12299;6346;19458
320130;201811;36477;108142;31068;98060;5099;17563;16939;51848;22038;69411
320140;201811;2930;8652;2148;7033;455;1682;755;2401;1210;4083
320150;201811;13049;35504;9252;27934;2671;8449;1626;4732;4297;13181
320160;201811;5351;15818;4082;13286;731;2534;1857;5932;2588;8466
320170;201811;1502;4540;1104;3697;305;1042;383;1279;688;2321
320180;201811;691;2283;558;2004;198;748;115;410;313;1158
320190;201811;2851;9446;2171;7819;521;1962;481;1653;1002;3615
320200;201811;1051;3015;755;2467;197;751;219;699;416;1450
320210;201811;4470;11817;3505;10113;593;1861;1823;5035;2416;6896
320220;201811;2640;7434;2010;6307;383;1286;986;3018;1369;4304
320225;201811;1323;4263;919;3233;338;1279;129;435;467;1714
320230;201811;4496;13157;3444;11314;862;3102;1372;4429;2234;7531
320240;201811;13619;36922;10482;31613;2315;7434;4272;12666;6587;20100
320245;201811;2833;8883;2350;7848;964;3312;513;1686;1477;4998
320250;201811;1877;5453;1269;4023;320;1150;295;836;615;1986
320255;201811;1654;5478;1449;5095;557;1977;577;2138;1134;4115
320260;201811;1035;3091;738;2369;199;698;192;516;391;1214
320265;201811;2346;7463;1980;6721;908;3221;402;1352;1310;4573
320270;201811;2191;6476;1661;5375;333;1158;750;2408;1083;3566
320280;201811;5450;15793;4479;13985;1204;4022;1559;4784;2763;8806
320290;201811;1261;3937;849;2910;257;963;172;533;429;1496
320300;201811;3577;11424;2907;9933;905;3323;566;1858;1471;5181
320305;201811;4683;13931;3738;11959;838;2862;1625;5020;2463;7882
320310;201811;1836;5244;1277;4035;271;904;520;1589;791;2493
320313;201811;2178;5818;1397;4203;352;1107;260;747;612;1854
320316;201811;1550;4457;1211;3795;218;701;654;2048;872;2749
320320;201811;20186;55190;14381;44995;3690;12184;5125;15933;8815;28117
320330;201811;2832;8066;2239;6957;597;1838;963;3115;1560;4953
320332;201811;5233;15712;4356;14105;1065;3682;2124;6748;3189;10430
320334;201811;1929;5847;1350;4580;302;1185;289;832;591;2017
320335;201811;1710;5062;1082;3592;274;964;214;650;488;1614
320340;201811;4780;12567;3982;11306;653;1938;2129;6128;2782;8066
320350;201811;4984;12691;3484;9951;518;1624;1685;4553;2203;6177
320360;201811;1486;3848;1072;3048;155;430;512;1405;667;1835
320370;201811;2467;8028;1907;6680;561;2040;633;2167;1194;4207
320380;201811;2222;6267;1870;5670;309;1014;1067;3143;1376;4157
320390;201811;7270;20447;5427;16621;1199;3902;2075;6067;3274;9969
320400;201811;3260;9614;2627;8254;701;2325;1010;3101;1711;5426
320405;201811;4414;12124;3388;10332;535;1719;1711;5169;2246;6888
320410;201811;4728;12875;3609;11060;589;1779;1811;5801;2400;7580
320420;201811;2728;7672;2163;6724;615;2093;589;1772;1204;3865
320425;201811;1988;4869;1524;4101;129;405;993;2542;1122;2947
320430;201811;2744;7139;2136;5954;314;921;1256;3351;1570;4272
320435;201811;2263;7322;1800;6368;636;2348;491;1762;1127;4110
320440;201811;1213;3563;911;2945;155;547;408;1282;563;1829
320450;201811;1558;4683;1237;4053;307;1103;536;1651;843;2754
320455;201811;3788;11875;2621;9059;754;2750;704;2339;1458;5089
320460;201811;2170;6685;1508;5179;362;1288;360;1163;722;2451
320465;201811;1238;3601;931;2966;114;402;528;1679;642;2081
320470;201811;3761;10650;2560;8125;672;2291;545;1602;1217;3893
320480;201811;1625;4764;1387;4292;263;913;697;2061;960;2974
320490;201811;17796;49166;13513;41407;2561;8767;5426;16350;7987;25117
320495;201811;1404;3974;943;3051;211;755;309;953;520;1708
320500;201811;46310;129700;38318;115224;6646;21468;20866;60459;27512;81927
320501;201811;4616;13723;3327;11312;920;3499;1010;3315;1930;6814
320503;201811;2013;6372;1488;5197;462;1762;457;1447;919;3209
320506;201811;2782;8505;1915;6459;555;2026;135;425;690;2451
320510;201811;9544;26947;7743;23650;1174;3985;4312;12716;5486;16701
320515;201811;1751;4834;1345;3998;404;1265;380;1118;784;2383
320517;201811;2002;6347;1619;5492;563;2072;350;1157;913;3229
320520;201811;32346;89586;24603;76138;4881;16492;9852;29747;14733;46239
320530;201811;29172;80717;22796;69091;2881;10265;13277;37700;16158;47965
330010;201811;19766;55910;16438;50064;3121;9910;9056;27162;12177;37072
330015;201811;1367;3618;1115;3179;202;649;582;1563;784;2212
330020;201811;19289;50414;16946;46991;2482;7865;11759;31561;14241;39426
330022;201811;1955;5316;1499;4541;262;822;879;2623;1141;3445
330023;201811;3693;9777;2771;8360;611;1956;1216;3563;1827;5519
330025;201811;4957;12425;3346;9638;975;3033;1054;2983;2029;6016
330030;201811;9284;26982;7386;23512;1009;3689;4239;12714;5248;16403
330040;201811;12765;35249;10642;31453;1419;4718;6787;19253;8206;23971
330045;201811;80844;199579;68340;182668;7577;19619;51006;135337;58583;154956
330050;201811;2334;6420;1792;5490;423;1388;790;2286;1213;3674
330060;201811;4955;13681;4155;12350;926;3000;1763;4893;2689;7893
330070;201811;21136;57212;17634;51764;3349;10541;9292;26924;12641;37465
330080;201811;8622;23344;7583;21753;999;2991;4985;14192;5984;17183
330090;201811;3266;7094;2228;5717;220;600;1418;3586;1638;4186
330093;201811;2337;6168;1757;5233;186;579;1203;3577;1389;4156
330095;201811;1111;3394;902;2975;92;369;470;1406;562;1775
330100;201811;63955;178366;54752;164149;4383;15445;39700;116818;44083;132263
330110;201811;2005;6051;1779;5662;337;1184;864;2642;1201;3826
330115;201811;1972;5183;1522;4497;282;881;851;2459;1133;3340
330120;201811;3239;7666;2491;6670;209;631;1813;4738;2022;5369
330130;201811;3481;10126;2952;9320;513;1741;1751;5512;2264;7253
330140;201811;3339;9204;2781;8348;459;1565;1645;4758;2104;6323
330150;201811;2025;5656;1599;4950;354;1140;663;1990;1017;3130
330160;201811;1233;3496;1006;3130;208;738;508;1482;716;2220
330170;201811;92908;251699;79999;233159;12762;37529;50951;149067;63713;186596
330180;201811;2131;5538;1680;4810;123;429;1145;3153;1268;3582
330185;201811;9223;25223;7709;22656;884;2980;5355;15175;6239;18155
330187;201811;3732;9926;3037;8840;462;1480;1865;5347;2327;6827
330190;201811;29529;75603;25981;70578;2562;7358;19901;53382;22463;60740
330200;201811;14006;38645;11949;35883;2659;7653;7059;21797;9718;29450
330205;201811;2047;5277;1607;4538;120;394;1092;2970;1212;3364
330210;201811;3177;8425;2320;6788;453;1421;862;2325;1315;3746
330220;201811;10637;28279;7752;23071;1830;5916;2231;6022;4061;11938
330225;201811;3394;9298;2744;8268;246;922;1912;5567;2158;6489
330227;201811;16413;42564;14315;39770;1068;3279;11551;31618;12619;34897
330230;201811;1580;3824;1155;3249;84;259;803;2210;887;2469
330240;201811;20253;55523;16472;49114;3157;10231;8871;25604;12028;35835
330245;201811;1625;4168;980;3070;240;791;257;809;497;1600
330250;201811;34167;93362;29362;85832;7054;20876;14396;42764;21450;63640
330260;201811;4274;11725;3415;10365;540;1809;1901;5490;2441;7299
330270;201811;24842;52630;15146;38500;2837;7870;6239;15454;9076;23324
330280;201811;2310;6277;1758;5284;230;751;965;2779;1195;3530
330285;201811;20071;51282;16467;45999;1860;5884;11305;30543;13165;36427
330290;201811;3282;8847;2726;7943;413;1304;1579;4449;1992;5753
330300;201811;4697;12232;3515;10396;406;1389;2210;6328;2616;7717
330310;201811;2213;5902;1713;5030;115;334;1106;3260;1221;3594
330320;201811;14027;36388;11875;33487;1769;5058;8244;23374;10013;28432
330330;201811;30073;73300;24850;65761;3128;9185;16998;43678;20126;52863
330340;201811;13996;36791;10369;30785;2035;6633;4718;13300;6753;19933
330350;201811;100023;256522;85855;237728;8474;24898;64847;178210;73321;203108
330360;201811;7503;18842;6452;17586;387;1140;5297;14313;5684;15453
330370;201811;4401;13259;3348;11298;837;2974;1239;4267;2076;7241
330380;201811;5081;14563;3957;12547;863;2999;1637;4989;2500;7988
330385;201811;3895;11937;3268;10944;880;3206;1392;4667;2272;7873
330390;201811;22855;67497;18349;58708;3393;11918;9036;27543;12429;39461
330395;201811;3182;8347;2692;7680;244;765;1802;5032;2046;5797
330400;201811;2916;8236;2582;7635;217;790;1824;5047;2041;5837
330410;201811;2812;7981;2098;6677;442;1519;907;2713;1349;4232
330411;201811;2591;7286;2104;6337;186;640;1452;4188;1638;4828
330412;201811;1465;4478;1204;4003;176;643;653;2021;829;2664
330414;201811;22903;60122;18920;54522;2419;6897;12712;36531;15131;43428
330415;201811;3503;9929;2739;8597;411;1277;1473;4728;1884;6005
330420;201811;9587;24692;6342;19186;1024;3374;2511;7176;3535;10550
330430;201811;8459;21993;7332;20263;628;2079;5306;14070;5934;16149
330440;201811;1934;5507;1511;4830;358;1292;661;1987;1019;3279
330450;201811;1327;4012;1074;3537;174;627;511;1620;685;2247
330452;201811;15057;40123;11808;34753;2169;6930;6422;18307;8591;25237
330455;201811;531009;1327691;410909;1143308;70967;208672;237897;648719;308864;857391
330460;201811;1158;3396;905;2992;198;688;417;1336;615;2024
330470;201811;4523;11941;3419;10173;951;2937;1309;3879;2260;6816
330475;201811;8446;23111;6920;20981;1479;4918;3874;11486;5353;16404
330480;201811;5832;15997;5029;14717;610;2020;3171;8963;3781;10983
330490;201811;114190;275888;96705;250913;11041;30860;68354;173753;79395;204613
330500;201811;5776;15781;5029;14669;716;2288;3497;10017;4213;12305
330510;201811;36881;100008;29693;89345;7695;23838;14766;44137;22461;67975
330513;201811;1151;3276;984;2975;297;956;366;1059;663;2015
330515;201811;2532;7174;2100;6450;591;1905;895;2654;1486;4559
330520;201811;10591;29838;8842;26828;1488;4958;4713;13751;6201;18709
330530;201811;1648;4206;1212;3452;255;792;518;1400;773;2192
330540;201811;2868;7897;2236;6749;658;2029;785;2338;1443;4367
330550;201811;7863;23477;6576;21360;2330;7998;1815;5829;4145;13827
330555;201811;12674;31130;10713;28518;1443;4190;7343;19581;8786;23771
330560;201811;4280;11880;3532;10546;505;1581;2071;5971;2576;7552
330570;201811;2792;7972;2346;7189;431;1432;1358;4081;1789;5513
330575;201811;5408;14573;4698;13323;407;1299;3514;9592;3921;10891
330580;201811;13066;37548;10209;31990;2401;8059;4331;12998;6732;21057
330590;201811;1507;4277;1327;4049;184;564;908;2807;1092;3371
330600;201811;11287;31443;8885;27193;1355;4336;4813;14562;6168;18898
330610;201811;8949;25128;7541;22908;819;2901;4849;14272;5668;17173
330615;201811;1970;5652;1516;5006;349;1289;856;2809;1205;4098
330620;201811;3636;11290;2992;10093;903;3286;967;3043;1870;6329
330630;201811;24142;63708;19041;55253;2005;6843;12708;35262;14713;42105
350010;201811;1850;5104;944;3032;237;788;104;265;341;1053
350020;201811;667;1771;348;1111;40;137;131;383;171;520
350030;201811;3741;10960;2774;9061;717;2488;841;2642;1558;5130
350040;201811;629;1927;391;1391;67;267;117;339;184;606
350050;201811;891;2469;650;1995;138;494;209;505;347;999
350055;201811;754;2016;637;1848;52;172;495;1423;547;1595
350060;201811;111;312;84;264;17;57;40;122;57;179
350070;201811;3679;9954;2271;7224;445;1497;707;2026;1152;3523
350075;201811;608;1895;453;1564;187;667;53;160;240;827
350080;201811;631;1694;385;1197;42;143;168;473;210;616
350090;201811;622;1526;357;1018;82;242;108;291;190;533
350100;201811;2034;5631;1339;4321;173;645;654;1975;827;2620
350110;201811;398;1143;305;955;23;86;193;583;216;669
350115;201811;1321;3944;1080;3406;199;689;542;1548;741;2237
350120;201811;700;1747;378;1091;55;170;193;531;248;701
350130;201811;3115;8684;2507;7490;393;1270;1301;3672;1694;4942
350140;201811;608;1907;469;1637;38;175;258;827;296;1002
350150;201811;516;1623;432;1453;114;391;104;323;218;714
350160;201811;10606;27014;6939;20351;908;3143;4007;10969;4915;14112
350170;201811;1715;5212;1329;4309;270;923;455;1387;725;2310
350180;201811;1088;2762;561;1705;119;393;177;491;296;884
350190;201811;2878;8437;2044;6652;464;1684;742;1985;1206;3669
350200;201811;407;1150;330;1006;23;78;230;656;253;734
350210;201811;5284;12683;3489;9827;680;1991;1843;5008;2523;6999
350220;201811;2677;7556;1859;5883;402;1367;684;1958;1086;3325
350230;201811;941;2651;790;2395;160;522;394;1153;554;1675
350240;201811;689;2088;458;1523;83;282;154;493;237;775
350250;201811;2303;7319;1775;6307;624;2407;300;1108;924;3515
350260;201811;813;2035;517;1488;68;197;275;761;343;958
350270;201811;4550;12863;3630;11003;623;2064;1795;5050;2418;7114
350275;201811;2257;6511;1816;5693;340;1161;916;2687;1256;3848
350280;201811;19076;43881;11485;31397;2225;6507;4021;10578;6246;17085
350290;201811;3047;8768;2068;6731;389;1378;805;2528;1194;3906
350300;201811;648;1826;464;1435;89;289;179;501;268;790
350310;201811;797;2386;609;1961;92;354;249;715;341;1069
350315;201811;565;1549;379;1196;47;176;157;436;204;612
350320;201811;12371;33828;9673;28935;2524;8133;2712;7857;5236;15990
350330;201811;13999;35621;9772;27036;1373;4074;5488;14346;6861;18420
350335;201811;351;1014;281;888;20;65;185;585;205;650
350340;201811;1124;2998;660;2113;122;426;227;706;349;1132
350350;201811;746;2030;578;1826;90;321;297;888;387;1209
350360;201811;966;3030;795;2642;240;792;238;799;478;1591
350370;201811;611;1636;400;1189;121;351;84;241;205;592
350380;201811;4495;12442;2995;9487;795;2563;769;2443;1564;5006
350390;201811;9412;26502;7597;23221;2030;6436;2895;8592;4925;15028
350395;201811;413;1062;187;611;22;67;56;166;78;233
350400;201811;7581;19841;5398;16057;1425;4602;1554;4366;2979;8968
350410;201811;9046;26573;6635;21716;1599;5807;2052;6183;3651;11990
350420;201811;637;1839;462;1501;88;331;97;278;185;609
350430;201811;689;1936;570;1719;66;237;353;974;419;1211
350440;201811;1625;4398;1297;3854;160;540;786;2268;946;2808
350450;201811;6342;18668;5081;16234;1191;4061;1858;5624;3049;9685
350460;201811;1588;4108;813;2529;140;476;180;509;320;985
350470;201811;251;643;191;531;8;31;123;312;131;343
350480;201811;825;2266;546;1701;109;376;83;218;192;594
350490;201811;1730;4879;1271;4012;310;995;401;1179;711;2174
350500;201811;640;1769;507;1526;97;322;235;660;332;982
350510;201811;1054;2938;767;2372;98;336;400;1170;498;1506
350520;201811;1868;6088;1424;5111;279;1115;575;1884;854;2999
350530;201811;2446;6412;1801;5128;312;978;924;2466;1236;3444
350535;201811;1410;4045;1234;3790;152;554;817;2433;969;2987
350540;201811;1655;4398;1214;3638;219;692;614;1831;833;2523
350550;201811;9130;22679;6090;17610;770;2558;3137;8480;3907;11038
350560;201811;3665;10794;2944;9361;295;1030;1786;5482;2081;6512
350570;201811;20954;61477;17092;53637;4024;13669;7540;22406;11564;36075
350580;201811;1794;5090;980;3206;228;799;121;311;349;1110
350590;201811;4326;12362;3168;9733;585;2026;1627;4561;2212;6587
350600;201811;37396;90626;23776;65355;3305;10107;11667;29290;14972;39397
350610;201811;6533;18519;4827;15112;1024;3393;1996;6065;3020;9458
350620;201811;412;1036;258;803;33;121;136;393;169;514
350630;201811;1479;3976;1063;3211;88;323;621;1743;709;2066
350635;201811;7490;19688;5715;16758;1067;3475;3043;8445;4110;11920
350640;201811;890;2471;487;1528;63;213;157;417;220;630
350650;201811;7566;21075;5003;15663;1037;3512;1537;4409;2574;7921
350660;201811;4445;12204;3496;10560;682;2107;1685;5111;2367;7218
350670;201811;1690;4756;1421;4341;199;643;853;2605;1052;3248
350680;201811;1106;3059;725;2307;144;484;309;949;453;1433
350690;201811;1126;3194;839;2639;152;514;422;1265;574;1779
350700;201811;4885;12562;3109;9731;630;2184;1191;3455;1821;5639
350710;201811;2647;7587;2254;6897;323;1112;1270;3691;1593;4803
350715;201811;861;2480;713;2185;89;324;333;907;422;1231
350720;201811;165;421;122;346;21;63;48;127;69;190
350730;201811;488;1506;380;1274;45;183;222;691;267;874
350740;201811;1583;4513;1047;3328;185;623;278;802;463;1425
350745;201811;534;1472;328;1031;37;125;141;396;178;521
350750;201811;8932;25134;7153;21734;1362;4704;2936;7909;4298;12613
350760;201811;13013;34415;9308;27795;2461;7869;2561;6825;5022;14694
350770;201811;742;1969;514;1535;62;190;314;912;376;1102
350775;201811;668;1705;480;1388;63;197;204;564;267;761
350780;201811;1924;5154;1392;4283;310;1048;409;1379;719;2427
350790;201811;1647;4625;1031;3412;198;717;202;580;400;1297
350800;201811;3136;9638;2725;8859;448;1547;1398;4433;1846;5980
350810;201811;2306;5933;1871;5342;292;878;1072;3142;1364;4020
350820;201811;808;2000;462;1346;48;151;229;610;277;761
350830;201811;856;2475;482;1607;58;211;148;425;206;636
350840;201811;2723;8472;2052;7113;560;2096;675;2169;1235;4265
350850;201811;6378;18962;4917;16070;1298;4457;1556;4959;2854;9416
350860;201811;3153;9065;2860;8626;144;562;2157;6348;2301;6910
350870;201811;2711;7884;1995;6681;360;1354;982;3147;1342;4501
350880;201811;1237;3775;992;3215;238;797;320;992;558;1789
350890;201811;586;1573;363;1091;46;155;130;326;176;481
350900;201811;6521;18817;4169;13512;1241;4351;664;1996;1905;6347
350910;201811;881;2346;748;2100;120;396;478;1295;598;1691
350920;201811;11711;30519;9988;27548;613;2002;7781;20506;8394;22508
350925;201811;4418;12672;3183;10263;662;2226;1263;3676;1925;5902
350930;201811;1453;3773;969;2855;132;410;500;1384;632;1794
350940;201811;1963;5661;1597;4949;226;768;972;2920;1198;3688
350945;201811;870;2535;658;2103;129;463;280;804;409;1267
350950;201811;78893;215238;61933;180551;9616;30921;35357;97402;44973;128323
350960;201811;5409;15711;4300;13535;716;2555;2349;6946;3065;9501
350970;201811;3550;10987;2672;9081;875;3235;384;1125;1259;4360
350980;201811;580;1735;472;1508;165;544;166;519;331;1063
350990;201811;1733;5239;1326;4515;338;1277;429;1344;767;2621
350995;201811;772;2482;691;2302;53;226;458;1444;511;1670
351000;201811;2597;6993;1849;5588;432;1454;520;1454;952;2908
351010;201811;314;806;186;560;22;69;92;267;114;336
351015;201811;703;2207;577;1957;86;335;269;830;355;1165
351020;201811;8929;25179;6856;21681;1360;4527;3499;10775;4859;15302
351030;201811;2491;7735;2014;6714;321;1213;1005;3207;1326;4420
351040;201811;4460;11792;3810;10736;260;896;2938;7951;3198;8847
351050;201811;16546;41890;11182;33105;2546;8072;4217;12234;6763;20306
351060;201811;43911;115638;34248;98441;4764;14875;21181;58695;25945;73570
351070;201811;1330;3521;780;2506;234;791;97;302;331;1093
351080;201811;2550;6847;1894;5991;389;1386;957;2791;1346;4177
351090;201811;340;1035;233;829;46;173;52;194;98;367
351100;201811;2416;6762;1559;4926;386;1308;392;1237;778;2545
351110;201811;5738;15236;3763;11509;807;2691;1388;3863;2195;6554
351120;201811;723;1944;494;1504;77;253;209;593;286;846
351130;201811;1026;2710;481;1596;97;334;81;242;178;576
351140;201811;1748;5296;1268;4311;341;1276;335;990;676;2266
351150;201811;1864;5621;1152;3945;229;841;315;964;544;1805
351160;201811;1112;3667;903;3183;213;796;289;904;502;1700
351170;201811;1351;3978;1178;3602;138;464;736;2155;874;2619
351190;201811;829;2403;575;1820;115;355;223;652;338;1007
351200;201811;1627;4110;1242;3507;83;268;812;2189;895;2457
351210;201811;1492;3776;863;2483;92;298;458;1189;550;1487
351220;201811;3013;9015;2616;8281;381;1260;1617;5040;1998;6300
351230;201811;1796;5144;1335;4294;299;1084;530;1501;829;2585
351240;201811;1862;5003;1228;3634;241;781;540;1442;781;2223
351250;201811;1085;2937;597;1907;77;266;209;663;286;929
351260;201811;937;2548;700;2101;172;515;225;671;397;1186
351270;201811;371;1107;309;993;57;221;164;449;221;670
351280;201811;3946;11034;3146;9452;576;1921;1486;4191;2062;6112
351290;201811;980;2617;673;2038;131;399;304;901;435;1300
351300;201811;14561;41978;10102;32985;2186;7588;3673;11829;5859;19417
351310;201811;3084;8230;2361;7000;242;861;1484;4065;1726;4926
351320;201811;879;2702;660;2157;107;379;237;718;344;1097
351330;201811;1043;3772;965;3634;46;126;832;3219;878;3345
351340;201811;6174;18539;4958;16299;1375;4668;1908;6275;3283;10943
351350;201811;11093;29707;9445;26820;1136;3502;6850;18842;7986;22344
351360;201811;3808;10714;3174;9636;801;2626;1046;2931;1847;5557
351370;201811;2165;6315;1464;4788;365;1230;466;1344;831;2574
351380;201811;44424;113513;32619;91728;5470;16238;16888;45696;22358;61934
351385;201811;280;715;160;483;36;97;51;150;87;247
351390;201811;1341;3433;855;2695;132;493;476;1383;608;1876
351400;201811;891;2614;713;2228;173;543;350;1068;523;1611
351410;201811;2265;6612;1720;5521;330;1076;743;2344;1073;3420
351420;201811;352;868;187;561;39;107;70;201;109;308
351430;201811;748;2268;676;2131;59;214;519;1596;578;1810
351440;201811;3247;8825;2142;6441;415;1349;524;1321;939;2670
351450;201811;1701;4505;1142;3488;252;833;241;645;493;1478
351460;201811;745;2051;598;1795;177;511;279;846;456;1357
351470;201811;1114;3025;876;2590;88;308;534;1483;622;1791
351480;201811;2576;7915;2131;7123;334;1242;985;3114;1319;4356
351490;201811;1782;5393;1566;4959;91;370;1153;3476;1244;3846
351492;201811;326;919;268;794;16;54;166;467;182;521
351495;201811;190;560;146;452;21;68;78;227;99;295
351500;201811;34738;89910;25620;73480;5054;15395;12909;35243;17963;50638
351510;201811;11478;30255;8436;24648;1302;4251;4860;13517;6162;17768
351512;201811;482;1347;318;972;53;168;99;267;152;435
351515;201811;3096;7272;1857;5203;369;1163;483;1341;852;2504
351518;201811;2236;5990;1496;4633;228;815;780;2175;1008;2990
351519;201811;569;1678;380;1232;61;217;81;210;142;427
351520;201811;1114;2863;430;1364;66;238;164;441;230;679
351530;201811;359;1012;196;625;38;130;61;151;99;281
351535;201811;2029;5050;1472;4096;194;622;834;2163;1028;2785
351540;201811;2068;5368;1359;4117;436;1476;260;635;696;2111
351550;201811;5869;15557;3976;11730;513;1726;2108;5707;2621;7433
351560;201811;403;1225;329;1073;79;291;96;292;175;583
351565;201811;170;543;137;481;35;128;43;140;78;268
351570;201811;17988;50209;13587;40657;1817;5893;8201;23432;10018;29325
351580;201811;275;735;158;499;18;55;57;192;75;247
351590;201811;510;1193;272;748;33;116;152;371;185;487
351600;201811;1528;4083;1170;3420;139;443;679;1826;818;2269
351610;201811;735;1794;485;1354;26;89;255;633;281;722
351620;201811;19574;56075;14740;46763;2699;9720;5923;16702;8622;26422
351630;201811;25626;72013;21102;63700;3852;12172;12438;36494;16290;48666
351640;201811;15298;42609;12003;36159;1506;5101;7648;22021;9154;27122
351650;201811;413;1140;177;587;27;87;35;115;62;202
351660;201811;744;2210;451;1471;83;303;83;237;166;540
351670;201811;5063;14227;3662;11124;725;2270;1713;4840;2438;7110
351680;201811;420;1261;261;843;54;158;66;192;120;350
351685;201811;424;1307;338;1138;88;299;101;321;189;620
351690;201811;1023;2717;603;1826;110;356;219;583;329;939
351700;201811;978;2672;805;2356;140;410;419;1167;559;1577
351710;201811;701;1969;468;1500;54;208;209;598;263;806
351720;201811;1429;3886;921;2889;168;563;344;1001;512;1564
351730;201811;917;2547;759;2255;88;304;432;1196;520;1500
351740;201811;3767;9789;2926;8141;545;1591;1293;3325;1838;4916
351750;201811;1294;3692;788;2683;155;565;255;849;410;1414
351760;201811;3293;9583;2331;7503;521;1844;790;2332;1311;4176
351770;201811;1888;5704;1535;5003;384;1290;663;2132;1047;3422
351780;201811;1392;3675;700;2181;120;439;195;561;315;1000
351790;201811;1255;3171;1008;2816;180;487;597;1692;777;2179
351800;201811;547;1276;271;757;36;108;83;196;119;304
351810;201811;985;2682;808;2384;55;136;586;1671;641;1807
351820;201811;2445;7164;1682;5566;410;1460;305;958;715;2418
351830;201811;4216;11837;3242;10029;407;1468;1828;5372;2235;6840
351840;201811;7294;21790;5653;18600;992;3615;2561;7945;3553;11560
351850;201811;1836;4882;1147;3594;219;775;322;895;541;1670
351860;201811;2791;8463;2241;7361;439;1532;1144;3710;1583;5242
351870;201811;22482;60983;17782;52999;5888;18129;6123;18868;12011;36997
351880;201811;113738;317306;86373;266021;24701;82022;27012;78263;51713;160285
351885;201811;719;2176;613;1963;108;361;333;1020;441;1381
351890;201811;611;1823;474;1560;105;338;66;183;171;521
351900;201811;986;2823;779;2483;161;529;342;1080;503;1609
351905;201811;382;1088;255;814;27;92;99;275;126;367
351907;201811;21038;56950;16625;48806;1704;5555;11113;31539;12817;37094
351910;201811;1159;3144;818;2426;126;429;415;1085;541;1514
351920;201811;878;2367;650;1925;83;276;319;881;402;1157
351925;201811;941;2665;732;2255;113;374;330;939;443;1313
351930;201811;3012;8889;2792;8449;336;1201;2125;6232;2461;7433
351940;201811;1059;2798;765;2266;111;368;407;1150;518;1518
351950;201811;1393;3403;1059;2913;56;177;719;1929;775;2106
351960;201811;5010;13363;3704;10987;849;2711;1544;4251;2393;6962
351970;201811;5703;18694;4953;17265;921;3602;2603;8608;3524;12210
351980;201811;1010;2588;675;1991;90;307;380;1042;470;1349
351990;201811;1369;3418;967;2755;103;362;393;1019;496;1381
352000;201811;2379;7183;2035;6459;253;938;1250;3640;1503;4578
352010;201811;2028;5821;1617;5047;415;1394;279;916;694;2310
352020;201811;1508;4247;1178;3667;208;697;547;1591;755;2288
352030;201811;5394;14796;4241;12929;881;2896;2151;6414;3032;9310
352040;201811;2382;6709;1526;4894;279;936;398;1119;677;2055
352042;201811;3148;7961;1889;5681;382;1221;736;2217;1118;3438
352044;201811;1984;5633;1152;3931;193;702;213;663;406;1365
352050;201811;11956;33367;7721;24447;1933;6872;1182;3240;3115;10112
352060;201811;707;2019;520;1654;76;275;230;669;306;944
352070;201811;794;1697;556;1376;82;225;285;665;367;890
352080;201811;475;1255;287;863;43;146;99;257;142;403
352090;201811;1410;4366;1111;3666;166;619;407;1195;573;1814
352100;201811;3016;8817;2500;7813;620;2078;1087;3187;1707;5265
352110;201811;573;1791;445;1489;95;342;169;526;264;868
352115;201811;511;1505;420;1347;86;309;220;687;306;996
352120;201811;862;2663;683;2267;75;276;374;1146;449;1422
352130;201811;1861;5381;1176;3619;234;737;416;1202;650;1939
352140;201811;1331;3661;855;2687;139;464;383;1152;522;1616
352150;201811;800;2242;606;1882;147;466;295;916;442;1382
352160;201811;964;2460;700;2043;98;332;344;932;442;1264
352170;201811;2903;8214;2319;6982;453;1498;1141;3168;1594;4666
352180;201811;2725;7537;2162;6452;517;1728;685;1785;1202;3513
352190;201811;1139;3188;859;2717;145;493;365;1147;510;1640
352200;201811;379;1191;256;921;34;139;86;298;120;437
352210;201811;17208;43154;13851;38294;1553;4622;9953;27142;11506;31764
352215;201811;519;1433;453;1346;58;181;309;899;367;1080
352220;201811;16109;43221;11027;33496;2973;9444;3315;9734;6288;19178
352230;201811;12260;37983;9477;32402;2491;9335;3084;9840;5575;19175
352240;201811;11466;30520;8416;25200;1931;6548;3220;8667;5151;15215
352250;201811;21587;63455;17712;56254;4144;13919;9029;28065;13173;41984
352260;201811;5147;13744;3504;10339;594;2016;1848;4982;2442;6998
352265;201811;901;2630;788;2433;68;268;559;1647;627;1915
352270;201811;1482;4668;1109;3817;252;951;342;1071;594;2022
352280;201811;2299;6119;1793;5350;199;734;969;2664;1168;3398
352290;201811;1052;3203;886;2854;159;552;424;1222;583;1774
352300;201811;968;2681;672;2055;99;338;318;857;417;1195
352310;201811;44535;121749;33288;101527;9066;28023;13807;42261;22873;70284
352320;201811;5911;16511;4626;13882;800;2659;2205;5889;3005;8548
352330;201811;2080;5925;1643;5288;356;1335;750;2259;1106;3594
352340;201811;4805;13582;3576;11326;799;2768;1430;4202;2229;6970
352350;201811;1942;5861;1576;5026;205;792;819;2322;1024;3114
352360;201811;1128;3143;984;2903;122;455;711;1972;833;2427
352370;201811;1006;3033;878;2795;39;173;653;2004;692;2177
352380;201811;824;2386;636;2027;145;495;203;605;348;1100
352390;201811;16606;41596;11037;31841;1778;5639;5813;15785;7591;21424
352400;201811;3410;9603;2885;8658;539;1958;1696;4665;2235;6623
352410;201811;2948;8101;2306;6960;301;1062;1341;3863;1642;4925
352420;201811;894;2222;613;1769;116;355;204;560;320;915
352430;201811;7098;19033;5166;15563;1455;4760;1944;5543;3399;10303
352440;201811;16822;48168;13019;40557;2969;9759;5250;15742;8219;25501
352450;201811;784;2088;395;1309;57;196;112;340;169;536
352460;201811;2827;8162;1937;6384;411;1512;621;1901;1032;3413
352470;201811;3520;9124;2563;7495;332;1109;1420;3818;1752;4927
352480;201811;3437;8632;2331;6603;405;1269;1087;2823;1492;4092
352490;201811;716;2231;551;1877;108;418;236;746;344;1164
352500;201811;9897;26492;7071;21126;3349;10788;868;1610;4217;12398
352510;201811;3323;9451;2504;7961;617;2145;910;2698;1527;4843
352520;201811;2387;6936;1891;6002;461;1619;858;2513;1319;4132
352530;201811;8960;25225;5775;18320;1289;4583;989;2340;2278;6923
352540;201811;515;1558;376;1235;74;248;82;249;156;497
352550;201811;942;2817;663;2240;130;490;177;547;307;1037
352560;201811;567;1623;391;1233;71;241;129;369;200;610
352570;201811;1987;6005;1289;4492;321;1194;200;596;521;1790
352580;201811;769;2161;611;1857;97;325;284;819;381;1144
352585;201811;248;739;190;617;21;86;101;305;122;391
352590;201811;13416;36878;9599;29164;3071;10015;3626;10139;6697;20154
352600;201811;1893;5566;1474;4687;248;822;747;2314;995;3136
352610;201811;3050;8863;2309;7510;518;1823;807;2500;1325;4323
352620;201811;5550;15097;4404;13280;1374;4216;1553;4698;2927;8914
352630;201811;809;2050;624;1760;103;348;289;731;392;1079
352640;201811;2880;7691;2131;6394;199;645;1326;3842;1525;4487
352650;201811;585;1707;409;1284;69;246;146;422;215;668
352660;201811;993;3153;811;2777;178;636;325;1075;503;1711
352670;201811;8649;24548;5366;17615;1455;5144;556;1798;2011;6942
352680;201811;3125;9684;2243;7562;418;1605;972;2997;1390;4602
352690;201811;28440;73757;20885;59761;2024;6621;13088;35437;15112;42058
352700;201811;559;1475;415;1255;162;534;98;238;260;772
352710;201811;4906;13273;3524;10650;908;3010;1390;3873;2298;6883
352720;201811;7920;23094;6231;19599;2850;9131;908;2529;3758;11660
352725;201811;488;1278;251;757;20;65;108;300;128;365
352730;201811;2714;7910;2347;7057;398;1356;1312;3576;1710;4932
352740;201811;2124;5264;1624;4488;235;720;881;2315;1116;3035
352750;201811;422;1059;224;681;44;129;64;169;108;298
352760;201811;1416;4204;1125;3554;172;591;542;1650;714;2241
352770;201811;907;2499;596;1863;119;379;214;639;333;1018
352780;201811;655;1968;462;1567;92;339;142;456;234;795
352790;201811;526;1426;350;1066;42;128;121;313;163;441
352800;201811;1214;3895;877;3052;211;771;157;474;368;1245
352810;201811;1100;2709;659;1860;97;308;341;887;438;1195
352820;201811;518;1346;334;1027;79;253;72;211;151;464
352830;201811;602;1577;268;842;44;154;50;126;94;280
352840;201811;3801;11616;3218;10490;1132;3934;991;3064;2123;6998
352850;201811;10190;26552;6901;21036;1931;6244;2014;5819;3945;12063
352860;201811;951;2771;732;2332;151;512;286;881;437;1393
352870;201811;889;2284;605;1667;53;176;373;964;426;1140
352880;201811;1875;4661;1302;3600;197;575;709;1792;906;2367
352885;201811;268;801;201;668;30;111;114;371;144;482
352890;201811;715;1749;429;1135;55;158;220;497;275;655
352900;201811;17379;46832;11900;35884;2215;7269;5179;14502;7394;21771
352910;201811;458;1228;213;677;26;77;48;136;74;213
352920;201811;2569;6911;1839;5534;189;654;1125;3198;1314;3852
352930;201811;5481;15646;4166;12949;827;2737;1746;5082;2573;7819
352940;201811;22380;65272;16989;53388;4595;15911;4893;14194;9488;30105
352950;201811;482;1283;270;860;62;214;30;75;92;289
352960;201811;678;1900;341;1125;51;188;65;199;116;387
352965;201811;270;741;151;503;40;136;31;88;71;224
352970;201811;3000;7331;2311;6216;242;661;1539;4113;1781;4774
352980;201811;1355;3852;1062;3356;250;834;472;1438;722;2272
352990;201811;4020;11541;3294;10324;653;2297;1687;5035;2340;7332
353000;201811;472;1279;225;715;39;134;48;132;87;266
353010;201811;2568;6667;1711;5059;427;1371;532;1423;959;2794
353020;201811;3676;9726;2123;6425;300;991;748;2060;1048;3051
353030;201811;4057;10914;2828;8563;714;2264;602;1796;1316;4060
353040;201811;597;1482;448;1228;66;211;238;589;304;800
353050;201811;4931;14912;3704;12364;864;3107;1510;4763;2374;7870
353060;201811;45327;121449;37713;108747;3293;11365;27132;74942;30425;86307
353070;201811;9234;27041;6519;21311;1470;5127;2074;6386;3544;11513
353080;201811;4127;12112;2894;9586;633;2322;930;2791;1563;5113
353090;201811;527;1709;432;1496;49;194;232;751;281;945
353100;201811;313;863;119;391;20;67;32;92;52;159
353110;201811;7043;20414;5938;18706;1065;3555;3448;10957;4513;14512
353120;201811;464;1225;318;931;50;162;134;332;184;494
353130;201811;2344;6053;1616;4883;488;1615;491;1392;979;3007
353140;201811;2191;5750;1647;4709;161;531;993;2657;1154;3188
353150;201811;1438;3782;1041;3095;253;769;400;1119;653;1888
353160;201811;592;1587;405;1259;90;312;154;421;244;733
353170;201811;504;1482;408;1338;81;325;192;574;273;899
353180;201811;9495;24278;7528;21105;996;3109;5135;13974;6131;17083
353190;201811;3321;9259;2628;7822;313;1031;1560;4311;1873;5342
353200;201811;2043;5550;913;2998;120;430;210;604;330;1034
353205;201811;315;1043;268;922;61;234;117;387;178;621
353210;201811;971;2349;607;1706;27;94;385;1041;412;1135
353215;201811;411;1200;329;1026;50;173;131;356;181;529
353220;201811;721;1984;454;1424;116;362;73;215;189;577
353230;201811;789;2336;668;2146;178;637;257;716;435;1353
353240;201811;2219;6337;1808;5562;257;925;1033;2998;1290;3923
353250;201811;1253;2865;730;1983;108;308;356;945;464;1253
353260;201811;1044;2577;597;1784;122;408;211;588;333;996
353270;201811;649;1775;518;1512;55;168;311;860;366;1028
353280;201811;728;2041;512;1571;91;287;177;504;268;791
353282;201811;1814;5311;1566;4812;193;670;922;2668;1115;3338
353284;201811;380;955;195;574;30;110;77;197;107;307
353286;201811;147;389;88;286;22;78;25;74;47;152
353290;201811;1522;4078;908;2801;96;368;457;1282;553;1650
353300;201811;1705;4803;1259;3871;224;774;532;1445;756;2219
353310;201811;371;946;252;719;24;89;141;375;165;464
353320;201811;592;1619;505;1459;22;72;399;1139;421;1211
353325;201811;605;1884;421;1446;92;315;133;451;225;766
353330;201811;557;1466;331;983;42;137;164;453;206;590
353340;201811;2758;7694;1911;6033;517;1753;674;2079;1191;3832
353350;201811;3172;8831;2128;6521;467;1583;415;1070;882;2653
353360;201811;548;1648;442;1439;60;219;222;691;282;910
353370;201811;524;1628;429;1456;40;148;275;893;315;1041
353380;201811;268;840;215;726;32;116;97;306;129;422
353390;201811;5369;14053;4037;11595;642;1993;1966;5325;2608;7318
353400;201811;396;1170;302;974;57;210;63;155;120;365
353410;201811;543;1521;432;1315;89;299;217;632;306;931
353420;201811;467;1273;275;845;42;117;31;70;73;187
353430;201811;2153;6270;1588;5153;396;1399;542;1616;938;3015
353440;201811;60176;172036;42826;136080;8817;29520;19794;60083;28611;89603
353450;201811;396;1040;265;796;39;140;117;318;156;458
353460;201811;3265;9053;2363;7249;222;771;1049;3151;1271;3922
353470;201811;7202;19811;5080;15711;1024;3488;1828;5188;2852;8676
353475;201811;1400;3764;988;2874;133;411;459;1233;592;1644
353480;201811;1579;4375;1270;3781;87;303;858;2450;945;2753
353490;201811;944;2607;637;1947;126;408;269;778;395;1186
353500;201811;990;2431;792;2126;194;525;425;1159;619;1684
353510;201811;791;2434;570;1873;157;529;110;318;267;847
353520;201811;1085;2932;706;2208;71;246;336;997;407;1243
353530;201811;2421;6625;1874;5541;252;849;943;2585;1195;3434
353540;201811;2023;5828;1658;5191;328;1050;833;2543;1161;3593
353550;201811;5679;15512;4498;13417;950;3016;2132;5996;3082;9012
353560;201811;2057;6101;1551;5226;527;1898;362;1131;889;3029
353570;201811;524;1455;385;1196;69;222;206;606;275;828
353580;201811;2044;5589;1621;4791;388;1163;723;2062;1111;3225
353590;201811;710;1985;435;1367;113;378;120;374;233;752
353600;201811;1742;4493;1387;3832;189;535;722;1919;911;2454
353610;201811;582;1832;425;1487;106;424;97;292;203;716
353620;201811;2574;7239;1832;5842;400;1394;532;1512;932;2906
353625;201811;528;1356;326;971;33;120;187;529;220;649
353630;201811;1190;3836;921;3195;224;827;250;790;474;1617
353640;201811;1358;3609;1065;3115;120;394;637;1818;757;2212
353650;201811;8942;24956;6440;19620;898;3030;3402;9602;4300;12632
353657;201811;298;862;235;749;31;112;114;327;145;439
353660;201811;1129;2506;760;1945;305;791;191;447;496;1238
353670;201811;3531;10496;2907;9195;698;2420;1334;3881;2032;6301
353680;201811;724;2060;548;1784;104;352;279;882;383;1234
353690;201811;472;1236;185;601;19;61;18;51;37;112
353700;201811;1867;5290;1589;4737;196;640;1023;2913;1219;3553
353710;201811;3908;8981;2141;5843;254;698;1208;3036;1462;3734
353715;201811;450;1210;288;897;20;76;96;272;116;348
353720;201811;1879;5290;1498;4693;207;714;939;2848;1146;3562
353730;201811;4089;11529;3045;9383;495;1646;1389;3989;1884;5635
353740;201811;1874;5112;1267;3934;315;1087;361;1038;676;2125
353750;201811;835;2632;582;2095;135;506;94;349;229;855
353760;201811;11788;29162;9349;25639;1446;4267;5749;15370;7195;19637
353770;201811;721;2178;341;1173;58;200;38;102;96;302
353780;201811;4564;13776;3571;11704;908;3259;1107;3304;2015;6563
353790;201811;2382;7559;1793;6298;541;2188;351;1011;892;3199
353800;201811;16223;45860;12692;39556;2343;7772;6131;19006;8474;26778
353810;201811;1071;2970;710;2243;121;442;268;787;389;1229
353820;201811;1707;4968;1217;3899;248;859;411;1268;659;2127
353830;201811;588;1517;444;1272;59;172;233;634;292;806
353850;201811;1632;4718;1247;3946;327;1009;382;1234;709;2243
353860;201811;2504;7453;1977;6356;493;1697;788;2374;1281;4071
353870;201811;27283;74537;18990;57913;2955;9938;8887;24757;11842;34695
353880;201811;2954;8490;2309;7257;244;883;1303;3945;1547;4828
353890;201811;2339;5362;1602;4262;166;488;1036;2603;1202;3091
353900;201811;669;1913;491;1561;99;342;195;595;294;937
353910;201811;1950;6142;1688;5688;243;892;1129;3814;1372;4706
353920;201811;2095;5857;1424;4526;312;1146;339;917;651;2063
353930;201811;4079;11289;2749;8868;655;2280;772;2261;1427;4541
353940;201811;1057;3171;716;2420;148;518;199;616;347;1134
353950;201811;2958;8532;2371;7370;477;1626;1234;3509;1711;5135
353960;201811;717;2022;469;1493;96;298;158;477;254;775
353970;201811;687;1747;514;1470;50;164;304;826;354;990
353980;201811;13937;37357;10887;31706;1355;4219;6940;19527;8295;23746
353990;201811;894;2237;540;1569;63;212;277;741;340;953
354000;201811;2454;6168;1349;4041;281;875;211;643;492;1518
354010;201811;358;980;267;821;31;95;170;509;201;604
354020;201811;3499;10378;2779;8733;722;2431;933;2667;1655;5098
354025;201811;741;2052;474;1505;96;349;95;271;191;620
354030;201811;479;1076;235;635;41;108;88;233;129;341
354040;201811;781;1899;479;1361;36;122;305;820;341;942
354050;201811;923;2782;650;2231;159;572;180;613;339;1185
354060;201811;3918;11506;2597;8596;652;2248;696;2125;1348;4373
354070;201811;3142;9083;2236;7257;506;1795;633;1768;1139;3563
354075;201811;2219;6962;1739;6028;297;1189;869;2911;1166;4100
354080;201811;1443;4126;925;3050;166;570;237;719;403;1289
354085;201811;417;896;327;784;3;12;219;488;222;500
354090;201811;1437;4144;1268;3791;111;381;928;2714;1039;3095
354100;201811;15819;46688;11664;39027;2834;10188;4654;15438;7488;25626
354105;201811;1227;3314;916;2714;116;354;545;1595;661;1949
354110;201811;415;1134;317;983;73;235;103;321;176;556
354120;201811;1530;4275;1017;3124;212;671;319;861;531;1532
354130;201811;5703;15467;3689;11441;1064;3555;186;358;1250;3913
354140;201811;19963;49484;12946;36766;2674;8113;4797;12562;7471;20675
354150;201811;3215;8073;2381;6630;495;1477;1001;2656;1496;4133
354160;201811;3212;9687;2379;7851;664;2302;711;2225;1375;4527
354165;201811;577;1740;439;1460;84;317;204;630;288;947
354170;201811;1496;4430;1209;3810;96;335;722;2128;818;2463
354180;201811;456;1324;329;1037;65;220;113;317;178;537
354190;201811;1470;4292;1058;3427;120;417;389;1250;509;1667
354200;201811;885;2315;688;1993;85;254;367;992;452;1246
354210;201811;657;1911;536;1682;53;188;334;956;387;1144
354220;201811;3097;8653;2279;6982;436;1421;1025;2948;1461;4369
354230;201811;695;1857;541;1647;50;196;347;997;397;1193
354240;201811;1484;4326;966;3213;174;621;262;754;436;1375
354250;201811;548;1445;351;1117;105;342;98;319;203;661
354260;201811;7900;21890;6099;18693;1455;4669;2142;6461;3597;11130
354270;201811;1086;3335;860;2895;200;682;307;1018;507;1700
354280;201811;743;1986;628;1808;81;301;370;977;451;1278
354290;201811;885;2927;744;2591;137;475;334;1157;471;1632
354300;201811;3640;11076;3168;10198;1029;3399;1012;3130;2041;6529
354310;201811;672;2055;530;1745;106;363;169;503;275;866
354320;201811;896;2326;560;1698;94;335;209;548;303;883
354323;201811;516;1316;337;968;46;123;135;376;181;499
354325;201811;1204;3708;861;2932;161;573;338;1101;499;1674
354330;201811;7498;20061;5240;15280;821;2857;2940;7854;3761;10711
354340;201811;26115;70124;18147;55594;4167;13897;7430;21658;11597;35555
354350;201811;1158;3153;935;2713;139;439;573;1555;712;1994
354360;201811;539;1508;315;1070;60;200;47;156;107;356
354370;201811;984;3082;831;2786;151;548;433;1411;584;1959
354380;201811;797;2173;548;1736;97;358;129;337;226;695
354390;201811;13195;33642;8315;24696;1668;5262;2695;7532;4363;12794
354400;201811;1541;5115;1202;4299;217;842;417;1458;634;2300
354410;201811;5155;14881;3981;12484;965;3237;1667;4981;2632;8218
354420;201811;1420;3940;1028;3127;146;478;580;1683;726;2161
354425;201811;2388;6137;1745;4983;427;1256;625;1818;1052;3074
354430;201811;1487;4176;1173;3636;190;680;594;1711;784;2391
354440;201811;555;1537;337;1058;45;150;138;387;183;537
354450;201811;404;1091;220;722;30;98;59;177;89;275
354460;201811;921;2447;592;1825;92;303;277;815;369;1118
354470;201811;503;1284;326;917;28;88;160;402;188;490
354480;201811;1040;2424;717;1920;65;190;470;1190;535;1380
354490;201811;780;2357;559;1871;116;407;205;622;321;1029
354500;201811;2037;5966;1707;5466;566;1978;385;1205;951;3183
354510;201811;755;2098;608;1780;75;229;326;864;401;1093
354515;201811;292;901;209;722;41;162;78;254;119;416
354520;201811;6668;19454;4301;13704;719;2542;2192;6461;2911;9003
354530;201811;3916;11911;3030;10044;746;2554;1098;3606;1844;6160
354540;201811;1304;3601;943;2917;233;785;279;860;512;1645
354550;201811;544;1474;408;1210;60;183;239;675;299;858
354560;201811;1958;5030;1040;3078;145;448;503;1432;648;1880
354570;201811;1146;3016;479;1434;79;253;78;223;157;476
354580;201811;9411;25432;6102;18929;1041;3581;2751;8006;3792;11587
354600;201811;1724;4972;1343;4237;192;678;753;2272;945;2950
354610;201811;393;1050;208;646;36;122;70;205;106;327
354620;201811;450;1335;290;1006;49;187;106;316;155;503
354625;201811;320;907;188;639;24;81;49;145;73;226
354630;201811;1871;5784;1524;5081;661;2338;164;511;825;2849
354640;201811;3151;9441;2269;7534;396;1499;653;1973;1049;3472
354650;201811;899;2469;729;2152;77;239;413;1201;490;1440
354660;201811;2701;6939;1742;5281;154;556;1097;3221;1251;3777
354670;201811;1078;3112;759;2418;153;538;286;832;439;1370
354680;201811;4562;12903;3718;11427;951;2999;1832;5700;2783;8699
354690;201811;585;1858;403;1430;95;370;107;352;202;722
354700;201811;938;2538;646;1927;114;375;286;749;400;1124
354710;201811;520;1441;362;1106;55;194;155;406;210;600
354720;201811;325;808;140;420;43;124;28;87;71;211
354730;201811;9649;28041;7089;23016;1106;3913;3726;11600;4832;15513
354740;201811;321;885;124;431;14;58;21;64;35;122
354750;201811;2436;6689;1599;5071;308;1100;586;1654;894;2754
354760;201811;1916;5418;1336;4250;377;1317;337;988;714;2305
354765;201811;262;736;128;427;20;79;25;73;45;152
354770;201811;2264;5800;1606;4645;338;1075;668;1787;1006;2862
354780;201811;52994;139467;40730;114159;6003;18713;22693;59283;28696;77996
354790;201811;921;2716;759;2424;111;385;418;1277;529;1662
354800;201811;2531;6950;1965;5942;508;1591;773;2201;1281;3792
354805;201811;1305;3242;882;2506;118;363;400;994;518;1357
354810;201811;591;1777;342;1216;57;227;91;295;148;522
354820;201811;930;2823;660;2249;119;471;154;460;273;931
354830;201811;479;1210;306;889;82;233;108;299;190;532
354840;201811;985;2540;515;1528;66;193;236;681;302;874
354850;201811;19879;54586;13930;43232;2048;7359;7679;22244;9727;29603
354860;201811;1484;4380;1027;3441;195;694;321;952;516;1646
354870;201811;50093;130986;39995;112201;5716;17522;23133;61720;28849;79242
354880;201811;5685;14607;2620;7724;352;1144;870;2047;1222;3191
354890;201811;15667;41123;12473;35655;1923;6056;7032;19346;8955;25402
354900;201811;442;1192;276;866;35;116;72;208;107;324
354910;201811;4982;13819;2901;9740;604;2151;297;914;901;3065
354920;201811;457;1227;184;628;21;90;39;119;60;209
354925;201811;281;841;145;519;19;72;32;90;51;162
354930;201811;386;963;223;670;28;96;101;275;129;371
354940;201811;1835;5853;1372;4789;457;1726;178;557;635;2283
354950;201811;1485;4125;1169;3629;79;344;762;2226;841;2570
354960;201811;824;2270;635;1973;106;374;312;914;418;1288
354970;201811;3884;11576;3107;10102;492;1712;1744;5505;2236;7217
354980;201811;28771;71412;19205;54196;2509;8316;10421;27216;12930;35532
354990;201811;58851;156060;43530;127239;5179;16828;25362;70218;30541;87046
354995;201811;2445;6150;1834;5261;280;903;1126;3038;1406;3941
355000;201811;1434;3989;1141;3491;199;693;415;1131;614;1824
355010;201811;2962;8711;1952;6354;709;2425;153;495;862;2920
355020;201811;3332;9769;2416;8036;762;2787;589;1837;1351;4624
355030;201811;1302828;3295091;944732;2571061;170667;506446;446699;1118031;617366;1624477
355040;201811;2798;7711;2300;6970;419;1345;1414;4248;1833;5593
355050;201811;956;2463;700;2033;214;625;180;483;394;1108
355060;201811;5213;15023;3916;12499;687;2490;1856;5319;2543;7809
355070;201811;7954;21838;6382;19161;862;2980;3727;10400;4589;13380
355080;201811;834;2521;521;1865;106;398;49;148;155;546
355090;201811;1152;3496;878;2950;215;721;254;864;469;1585
355100;201811;20660;56796;16456;50318;3178;10429;9581;28668;12759;39097
355110;201811;983;2889;744;2468;252;882;126;436;378;1318
355120;201811;634;1756;447;1429;60;208;165;493;225;701
355130;201811;725;1669;327;867;23;60;181;444;204;504
355140;201811;1519;3934;1332;3650;137;457;997;2635;1134;3092
355150;201811;4105;11363;3270;9830;469;1504;1813;5265;2282;6769
355160;201811;1808;5243;1356;4398;345;1275;308;955;653;2230
355170;201811;8764;23603;6918;20383;1758;5556;3234;9247;4992;14803
355180;201811;2731;7804;1971;6448;440;1648;615;1761;1055;3409
355190;201811;1822;4965;1417;4288;386;1199;644;2027;1030;3226
355200;201811;812;2648;699;2455;238;942;213;674;451;1616
355210;201811;2896;8304;2429;7323;326;1138;1411;3990;1737;5128
355220;201811;42486;117635;33554;99934;9123;28727;12193;33168;21316;61895
355230;201811;1191;3048;624;1869;120;351;169;490;289;841
355240;201811;21936;58967;14840;44737;2411;7837;7071;20526;9482;28363
355250;201811;34400;95840;25327;77954;6649;21742;8789;25750;15438;47492
355255;201811;842;2198;438;1353;86;280;132;389;218;669
355260;201811;1334;3449;945;2780;124;444;554;1526;678;1970
355270;201811;1290;3953;979;3249;261;902;304;948;565;1850
355280;201811;27289;73532;19542;58106;3393;10812;8627;24215;12020;35027
355290;201811;832;2389;608;1923;130;394;234;702;364;1096
355300;201811;1209;3618;956;3091;186;638;310;973;496;1611
355310;201811;1024;2884;762;2429;101;356;392;1248;493;1604
355320;201811;538;1461;394;1172;70;237;147;364;217;601
355330;201811;2187;6056;1642;5041;179;638;1067;3119;1246;3757
355340;201811;3336;7674;2760;6853;369;897;1829;4540;2198;5437
355350;201811;1304;3959;962;3214;207;739;303;994;510;1733
355360;201811;1311;3549;1048;3110;122;393;697;2052;819;2445
355365;201811;368;1028;190;663;36;115;30;104;66;219
355370;201811;5775;14980;4368;12863;1128;3317;1794;5660;2922;8977
355380;201811;2923;8103;2173;6556;385;1275;687;1764;1072;3039
355385;201811;1325;3763;1099;3403;135;506;626;1755;761;2261
355390;201811;738;2088;545;1672;123;381;214;608;337;989
355395;201811;1874;5484;1325;4263;200;703;554;1624;754;2327
355400;201811;8932;27498;7237;23825;2065;7518;2128;6306;4193;13824
355410;201811;21386;60635;14335;46980;3523;12670;3221;10461;6744;23131
355420;201811;669;2271;549;2003;152;638;110;377;262;1015
355430;201811;3714;9593;2812;8010;753;2134;1153;3292;1906;5426
355440;201811;864;2433;513;1639;108;370;140;409;248;779
355450;201811;3458;9357;2210;6827;412;1351;810;2301;1222;3652
355460;201811;569;1472;353;1084;53;185;156;425;209;610
355465;201811;385;1129;277;894;56;196;91;280;147;476
355470;201811;1196;3203;631;1982;181;593;171;500;352;1093
355475;201811;287;714;259;664;27;75;200;511;227;586
355480;201811;3534;10443;2940;9469;447;1664;1810;5614;2257;7278
355490;201811;966;2676;510;1647;52;183;225;683;277;866
355495;201811;800;2377;592;1983;83;304;200;643;283;947
355500;201811;6527;17903;3835;12142;611;2080;1090;3154;1701;5234
355510;201811;1321;3474;811;2457;119;407;286;770;405;1177
355520;201811;375;856;173;476;27;73;62;151;89;224
355530;201811;431;984;138;402;21;71;54;130;75;201
355535;201811;526;1478;411;1287;95;332;155;441;250;773
355540;201811;9285;25315;7668;22752;1554;4902;4299;12380;5853;17282
355550;201811;652;1980;518;1710;69;232;244;779;313;1011
355560;201811;1106;3077;592;1957;129;454;28;90;157;544
355570;201811;234;682;128;433;25;81;26;80;51;161
355580;201811;1221;3072;799;2357;99;343;401;1114;500;1457
355590;201811;180;459;136;394;18;54;82;224;100;278
355600;201811;1520;3890;988;2921;243;767;374;1052;617;1819
355610;201811;1711;4456;1137;3378;157;452;532;1509;689;1961
355620;201811;4449;12709;3351;10379;477;1728;1713;4814;2190;6542
355630;201811;2209;6359;1537;4998;295;979;685;2194;980;3173
355635;201811;943;2882;728;2460;124;479;297;942;421;1421
355640;201811;2695;8051;1829;6259;439;1573;369;1262;808;2835
355645;201811;4255;12619;3289;10878;450;1639;1886;6124;2336;7763
355650;201811;6586;18376;5457;16259;1505;4775;2544;6971;4049;11746
355660;201811;1285;3541;893;2758;127;510;304;887;431;1397
355670;201811;3317;9635;2267;7048;350;1292;1062;2837;1412;4129
355680;201811;3157;8993;1200;4037;336;1176;121;424;457;1600
355690;201811;723;2246;479;1726;131;509;22;59;153;568
355695;201811;226;687;127;436;13;49;14;28;27;77
355700;201811;6504;19589;5308;16835;1145;3657;2415;7402;3560;11059
355710;201811;8052;19604;5062;14043;941;2816;2033;5071;2974;7887
355715;201811;385;1115;223;747;62;232;43;125;105;357
355720;201811;1409;4293;1101;3675;215;773;503;1526;718;2299
355730;201811;950;2820;738;2367;187;605;246;731;433;1336
410010;201811;1222;3470;935;2868;198;674;211;625;409;1299
410020;201811;998;3143;798;2664;275;867;217;732;492;1599
410030;201811;1389;4112;1190;3735;186;678;609;1872;795;2550
410040;201811;10706;31538;8187;26553;1816;6358;2625;7900;4441;14258
410045;201811;971;2595;642;1963;103;351;191;537;294;888
410050;201811;2532;6476;1566;4668;369;1182;316;838;685;2020
410060;201811;2054;6127;1598;5131;404;1344;443;1379;847;2723
410070;201811;1710;4571;1242;3619;219;686;448;1236;667;1922
410080;201811;1344;3680;978;2989;170;549;400;1228;570;1777
410090;201811;980;2753;886;2581;121;347;474;1458;595;1805
410100;201811;1948;5790;1344;4305;197;759;249;747;446;1506
410105;201811;450;1228;239;753;37;131;53;163;90;294
410110;201811;3089;8217;2107;6162;315;977;802;2250;1117;3227
410115;201811;549;1398;382;1103;64;208;132;358;196;566
410120;201811;2426;7580;2126;7035;717;2523;636;2078;1353;4601
410130;201811;1121;3192;993;2946;306;1010;374;982;680;1992
410140;201811;14421;35990;8711;25375;1795;5602;1840;4840;3635;10442
410150;201811;16419;40059;7710;22093;1435;4484;1571;4236;3006;8720
410160;201811;2876;8254;2352;7291;491;1683;851;2629;1342;4312
410165;201811;693;1963;574;1691;60;201;338;925;398;1126
410170;201811;2431;6602;1576;4656;404;1284;135;406;539;1690
410180;201811;13800;40599;10905;34159;1753;5941;5574;16399;7327;22340
410185;201811;476;1307;334;1021;56;177;102;289;158;466
410190;201811;2171;5677;1598;4617;332;975;422;1170;754;2145
410200;201811;4774;11765;2593;7672;477;1645;540;1563;1017;3208
410210;201811;2707;7123;1730;5209;307;1069;533;1340;840;2409
410220;201811;546;1446;346;1038;47;170;64;189;111;359
410230;201811;1483;4233;1212;3692;190;681;643;1799;833;2480
410240;201811;4276;12104;3242;10014;882;3060;290;822;1172;3882
410250;201811;2517;6315;1804;5050;201;681;800;2128;1001;2809
410260;201811;1762;4585;1164;3481;238;762;475;1377;713;2139
410270;201811;460;1222;335;979;35;119;161;446;196;565
410275;201811;670;1978;436;1428;64;221;194;582;258;803
410280;201811;2172;6033;1377;4322;252;845;478;1400;730;2245
410290;201811;3010;8766;2194;7007;538;1741;704;2213;1242;3954
410300;201811;646;1692;503;1418;65;198;235;618;300;816
410302;201811;368;959;181;577;32;104;83;248;115;352
410304;201811;1132;3266;956;2887;142;459;517;1505;659;1964
410305;201811;1647;4176;1163;3418;220;665;601;1737;821;2402
410310;201811;2482;7447;1952;6286;417;1477;687;2188;1104;3665
410315;201811;708;1791;352;1146;108;356;78;245;186;601
410320;201811;1106;3161;703;2248;110;416;106;330;216;746
410322;201811;511;1422;282;892;25;85;117;358;142;443
410330;201811;1485;3782;1051;2937;189;568;285;790;474;1358
410335;201811;845;2392;674;2033;94;304;296;826;390;1130
410337;201811;796;2000;553;1516;51;159;255;657;306;816
410340;201811;502;1387;336;973;35;125;155;380;190;505
410345;201811;2262;6039;1158;3561;268;836;247;696;515;1532
410347;201811;699;1798;501;1433;58;199;143;386;201;585
410350;201811;1304;3544;925;2809;98;336;400;1135;498;1471
410360;201811;3913;9776;3084;8370;234;741;1987;5169;2221;5910
410370;201811;11176;30597;7521;22305;1062;3523;2818;7369;3880;10892
410380;201811;1383;3756;1031;3016;123;426;425;1134;548;1560
410390;201811;2522;6846;1651;5098;409;1408;371;1028;780;2436
410395;201811;886;2682;715;2299;145;511;302;950;447;1461
410400;201811;4942;13894;3753;11607;682;2187;1538;4583;2220;6770
410405;201811;782;1985;612;1720;146;445;260;681;406;1126
410410;201811;1143;3297;1108;3248;175;642;682;2048;857;2690
410420;201811;7627;22860;5879;19075;1174;4232;1713;4986;2887;9218
410425;201811;2833;8366;2046;6731;365;1292;658;1995;1023;3287
410430;201811;12796;32997;8709;25236;1465;4610;2847;7814;4312;12424
410440;201811;2411;7477;2077;6813;363;1313;1051;3388;1414;4701
410442;201811;2225;7101;1885;6307;581;1984;567;1885;1148;3869
410445;201811;2212;6725;1752;5803;383;1408;466;1617;849;3025
410450;201811;1512;4113;1109;3323;220;730;279;723;499;1453
410460;201811;1746;4600;1357;3979;206;653;588;1630;794;2283
410465;201811;2519;7681;1965;6458;425;1416;584;1809;1009;3225
410470;201811;1807;5442;1306;4335;374;1385;201;681;575;2066
410480;201811;33244;83205;18089;54903;3002;10111;3163;8185;6165;18296
410490;201811;10703;30902;7540;23993;1552;5340;2513;7468;4065;12808
410500;201811;1654;4714;1168;3668;275;970;267;721;542;1691
410510;201811;2039;5197;1316;3746;249;703;398;1127;647;1830
410520;201811;2981;9797;2734;9283;785;2726;1127;3870;1912;6596
410530;201811;1454;3894;722;2176;129;391;113;261;242;652
410540;201811;2507;7046;1825;5687;269;898;920;2839;1189;3737
410550;201811;6706;18424;4244;12884;772;2563;985;2604;1757;5167
410560;201811;1381;3698;1072;3089;233;721;434;1112;667;1833
410570;201811;2540;7419;1947;6272;554;2082;157;519;711;2601
410580;201811;23238;63291;17523;52357;3640;11861;7178;19791;10818;31652
410590;201811;1414;4186;922;2905;161;538;239;663;400;1201
410600;201811;1778;4912;1326;3996;295;857;469;1476;764;2333
410610;201811;730;1978;521;1562;59;197;223;628;282;825
410620;201811;1950;6044;1272;4363;312;1151;195;589;507;1740
410630;201811;2278;6332;1451;4497;299;989;232;597;531;1586
410640;201811;4426;10964;2904;8331;709;2301;411;1127;1120;3428
410645;201811;1025;3216;877;2983;339;1180;306;1062;645;2242
410650;201811;1957;5663;1397;4465;344;1149;394;1140;738;2289
410655;201811;903;2304;627;1789;58;202;283;736;341;938
410657;201811;649;1766;407;1251;70;252;157;404;227;656
410660;201811;3147;8375;1695;5123;346;1104;321;907;667;2011
410670;201811;1033;2590;600;1721;104;295;276;743;380;1038
410680;201811;2784;8637;1983;6630;501;1621;471;1636;972;3257
410685;201811;569;1516;458;1314;98;322;211;559;309;881
410690;201811;117938;306550;77260;226824;13871;45606;25203;64572;39074;110178
410700;201811;2259;6014;1943;5478;351;1048;957;2547;1308;3595
410710;201811;825;2177;533;1603;60;193;273;777;333;970
410712;201811;670;2022;568;1805;153;516;192;561;345;1077
410715;201811;858;2621;518;1789;109;375;149;508;258;883
410720;201811;3045;8237;2205;6521;319;1123;453;1128;772;2251
410725;201811;1141;2915;669;2005;125;394;117;310;242;704
410730;201811;569;1524;411;1232;88;302;89;241;177;543
410740;201811;961;2757;681;2205;127;451;246;767;373;1218
410750;201811;1686;4531;1359;3908;234;747;536;1473;770;2220
410752;201811;348;907;156;478;27;90;59;164;86;254
410753;201811;213;649;153;518;15;54;31;89;46;143
410754;201811;1126;2994;927;2672;60;144;599;1851;659;1995
410755;201811;627;1619;444;1249;56;185;207;511;263;696
410760;201811;3157;8460;2339;6982;690;2246;542;1564;1232;3810
410765;201811;12305;36026;9528;30422;1572;5513;1465;4321;3037;9834
410770;201811;957;2360;661;1859;80;256;302;826;382;1082
410773;201811;1284;3469;1111;3181;129;401;743;2072;872;2473
410775;201811;1414;3749;1235;3471;120;381;666;1811;786;2192
410780;201811;596;1498;351;979;64;187;90;250;154;437
410785;201811;773;2237;609;1908;106;351;215;641;321;992
410790;201811;579;1708;452;1435;117;409;50;107;167;516
410800;201811;3149;7253;2505;6257;117;352;1523;3663;1640;4015
410810;201811;361;1020;270;843;41;142;125;361;166;503
410820;201811;736;2154;406;1269;87;283;78;217;165;500
410830;201811;28577;74154;20276;59571;4953;16318;6640;18316;11593;34634
410832;201811;1012;2707;836;2377;112;379;466;1223;578;1602
410840;201811;7165;19247;4278;13358;920;3169;729;1964;1649;5133
410845;201811;1122;3105;908;2715;183;592;323;935;506;1527
410850;201811;2302;6879;2014;6342;372;1240;877;2755;1249;3995
410855;201811;701;1795;469;1349;42;127;206;544;248;671
410860;201811;3817;10147;2959;8512;568;1780;1036;2783;1604;4563
410865;201811;1345;4273;1198;3945;228;808;650;2190;878;2998
410870;201811;1256;3499;1091;3223;53;167;804;2361;857;2528
410880;201811;4031;11537;2940;9379;524;1849;435;1470;959;3319
410890;201811;969;2872;695;2264;162;555;181;573;343;1128
410895;201811;924;3120;782;2778;304;1142;118;402;422;1544
410900;201811;890;2434;581;1807;93;300;125;309;218;609
410910;201811;365;884;188;534;12;39;110;282;122;321
410920;201811;783;1967;548;1576;88;297;230;643;318;940
410930;201811;1420;4002;1082;3329;280;1005;250;758;530;1763
410940;201811;21008;61165;15576;50679;3725;13116;3890;12582;7615;25698
410950;201811;1913;5712;1725;5407;72;292;1406;4306;1478;4598
410960;201811;7099;18896;4523;14171;1154;4048;1482;4444;2636;8492
410965;201811;973;2693;726;2192;122;376;362;1065;484;1441
410970;201811;3759;10474;2666;8334;635;2380;359;947;994;3327
410975;201811;1307;3485;997;2916;168;541;355;1029;523;1570
410980;201811;6589;17458;4231;12884;568;1904;1646;4767;2214;6671
410990;201811;1175;3100;761;2356;242;862;155;386;397;1248
411000;201811;489;1359;334;1026;51;188;88;215;139;403
411005;201811;440;1229;278;863;55;175;50;149;105;324
411007;201811;2152;6373;1805;5727;425;1448;568;1794;993;3242
411010;201811;4063;12636;3243;10808;848;3027;290;855;1138;3882
411020;201811;2327;6865;1948;6182;588;1967;539;1630;1127;3597
411030;201811;710;1838;465;1298;54;173;212;542;266;715
411040;201811;813;2165;379;1144;52;161;96;267;148;428
411050;201811;1789;5844;1494;5133;409;1492;201;587;610;2079
411060;201811;1635;4445;1062;3260;178;669;210;566;388;1235
411065;201811;337;941;244;754;33;107;107;326;140;433
411070;201811;6303;17105;4976;14644;959;3085;2033;5757;2992;8842
411080;201811;2149;5929;1713;5124;447;1452;438;1273;885;2725
411090;201811;860;2273;530;1616;47;174;123;334;170;508
411095;201811;1542;3764;1058;2939;129;421;369;956;498;1377
411100;201811;1088;2938;735;2266;80;282;206;644;286;926
411110;201811;605;1612;249;803;27;64;18;44;45;108
411120;201811;1295;3738;987;3091;345;1210;198;502;543;1712
411125;201811;4764;14422;4397;13755;979;3174;2071;6609;3050;9783
411130;201811;663;1861;464;1439;93;287;175;563;268;850
411140;201811;2180;6899;1787;5978;465;1650;600;2002;1065;3652
411150;201811;3614;9731;2529;7436;503;1694;207;451;710;2145
411155;201811;969;2559;573;1749;57;184;261;737;318;921
411160;201811;344;813;224;627;26;79;56;159;82;238
411170;201811;707;2190;513;1715;115;393;169;538;284;931
411180;201811;5262;14575;4067;12329;722;2397;1672;4766;2394;7163
411190;201811;1391;3759;1038;3070;206;636;313;858;519;1494
411200;201811;4852;13549;3347;10541;920;3168;672;1945;1592;5113
411210;201811;2357;5668;1679;4570;414;1307;331;823;745;2130
411220;201811;855;2310;624;1826;136;437;188;531;324;968
411230;201811;830;2322;559;1773;115;375;202;654;317;1029
411240;201811;1561;3836;912;2581;83;276;443;1184;526;1460
411250;201811;2022;5593;1516;4655;347;1221;450;1355;797;2576
411260;201811;334;879;213;638;32;100;81;216;113;316
411270;201811;1809;5161;1402;4297;234;751;630;1862;864;2613
411275;201811;1360;3486;972;2789;160;513;442;1232;602;1745
411280;201811;1381;3821;873;2775;171;559;112;331;283;890
411290;201811;725;2025;492;1551;60;182;226;724;286;906
411295;201811;1126;2862;860;2357;80;252;427;1111;507;1363
411300;201811;991;2510;622;1752;71;214;238;581;309;795
411310;201811;860;2097;652;1776;43;120;289;780;332;900
411320;201811;5287;14393;3765;11439;837;2660;1234;3421;2071;6081
411325;201811;1532;4477;1289;4008;238;736;663;2111;901;2847
411330;201811;3234;9195;2399;7547;611;2108;640;2048;1251;4156
411340;201811;847;2382;508;1582;66;219;194;569;260;788
411342;201811;913;2294;578;1639;92;263;263;733;355;996
411345;201811;1050;2879;792;2418;103;355;516;1575;619;1930
411350;201811;2454;6962;1701;5398;440;1544;169;505;609;2049
411360;201811;607;1505;421;1210;52;166;134;366;186;532
411370;201811;47358;121295;34433;98537;3317;11264;19278;51275;22595;62539
411373;201811;1337;3590;1089;3190;122;391;528;1583;650;1974
411375;201811;1050;2717;757;2161;127;389;274;717;401;1106
411380;201811;1050;2550;712;1844;60;180;417;974;477;1154
411390;201811;1616;4631;1251;3769;213;713;464;1246;677;1959
411400;201811;2082;5476;1634;4611;247;832;754;2011;1001;2843
411410;201811;2060;5940;1526;4743;355;1210;300;872;655;2082
411420;201811;3898;10073;2228;6736;331;1152;400;976;731;2128
411430;201811;3303;9290;2621;8029;558;1875;1018;2839;1576;4714
411435;201811;423;1241;270;897;54;168;94;274;148;442
411440;201811;2517;7505;2062;6568;459;1597;680;2147;1139;3744
411450;201811;2588;7050;1952;5937;295;881;1001;3095;1296;3976
411460;201811;3660;9991;2053;6567;384;1427;321;903;705;2330
411470;201811;717;2005;511;1568;88;290;155;425;243;715
411480;201811;4324;12274;3060;9751;577;2057;819;2410;1396;4467
411490;201811;1519;4124;1158;3464;169;580;413;1084;582;1664
411500;201811;1411;3828;927;2798;139;485;264;735;403;1220
411510;201811;2094;5717;1701;4971;367;1225;383;1120;750;2345
411520;201811;27855;69293;15377;44654;2170;7050;5087;13117;7257;20167
411530;201811;900;2470;558;1784;119;426;91;258;210;684
411535;201811;464;1383;207;723;20;71;28;75;48;146
411540;201811;2755;7241;1913;5490;308;977;704;1954;1012;2931
411545;201811;936;2797;783;2516;79;260;514;1649;593;1909
411550;201811;677;1782;479;1398;82;260;80;229;162;489
411560;201811;1901;5215;1116;3507;169;621;69;167;238;788
411570;201811;6925;16995;4751;13427;1001;3085;1258;3539;2259;6624
411573;201811;771;2161;662;1967;90;283;377;1101;467;1384
411575;201811;1730;4936;1323;4076;276;903;340;1008;616;1911
411580;201811;4174;10138;2330;7102;268;1007;318;856;586;1863
411585;201811;700;2105;317;1075;86;288;49;155;135;443
411590;201811;367;1061;257;808;30;116;141;401;171;517
411600;201811;274;753;164;550;40;143;53;177;93;320
411605;201811;1523;3736;921;2615;127;434;446;1212;573;1646
411610;201811;2251;5841;1565;4412;152;492;883;2380;1035;2872
411620;201811;2813;7863;2439;7256;426;1401;1373;3966;1799;5367
411630;201811;682;1796;451;1336;83;279;134;339;217;618
411640;201811;512;1427;348;1029;47;143;128;339;175;482
411650;201811;205;597;134;439;26;84;26;87;52;171
411660;201811;912;2365;646;1843;53;150;342;941;395;1091
411670;201811;1149;2984;828;2285;124;352;331;857;455;1209
411680;201811;1524;4215;1209;3605;125;410;630;1860;755;2270
411690;201811;3449;9353;2662;7964;551;1718;787;2421;1338;4139
411695;201811;629;1941;462;1549;64;231;167;571;231;802
411700;201811;1621;4360;1052;3249;248;844;129;349;377;1193
411705;201811;1809;5886;1542;5390;323;1117;820;3032;1143;4149
411710;201811;1827;4873;1304;3883;361;1138;151;447;512;1585
411720;201811;1060;2626;725;1975;103;300;300;747;403;1047
411721;201811;859;2277;640;1859;131;404;137;397;268;801
411722;201811;708;1995;398;1252;59;222;147;398;206;620
411725;201811;1212;3625;782;2630;183;626;160;554;343;1180
411727;201811;1443;4194;949;3081;276;925;116;352;392;1277
411729;201811;683;1692;449;1246;55;189;151;367;206;556
411730;201811;5178;14441;3858;11693;1071;3376;1230;3653;2301;7029
411740;201811;563;1557;289;926;51;177;57;166;108;343
411745;201811;778;2279;501;1591;61;209;96;245;157;454
411750;201811;4816;13122;3462;10319;483;1582;1625;4537;2108;6119
411760;201811;6910;19082;5344;16159;1885;5965;992;3216;2877;9181
411770;201811;3066;9257;2238;7328;582;2014;269;817;851;2831
411780;201811;2914;8470;2499;7636;685;2196;874;2660;1559;4856
411790;201811;2898;7362;1587;4792;377;1260;203;510;580;1770
411800;201811;965;2765;647;2015;101;319;118;356;219;675
411810;201811;1615;4236;1189;3412;191;601;575;1524;766;2125
411820;201811;10734;32994;8770;28932;2699;9329;2954;9557;5653;18886
411830;201811;590;1479;404;1146;87;272;78;235;165;507
411840;201811;11169;30361;7253;22011;1345;4456;1841;5120;3186;9576
411845;201811;428;1251;219;722;42;169;16;45;58;214
411850;201811;7303;19706;5272;15909;1513;5018;745;2023;2258;7041
411860;201811;753;2232;553;1788;96;344;145;428;241;772
411870;201811;657;2036;447;1497;91;336;97;280;188;616
411880;201811;2036;5432;1500;4489;313;1017;328;970;641;1987
411885;201811;988;2586;722;2111;107;368;259;728;366;1096
411890;201811;1106;3121;752;2353;123;441;54;136;177;577
411900;201811;813;2389;475;1589;117;403;45;154;162;557
411910;201811;996;3127;717;2472;205;760;178;558;383;1318
411915;201811;15736;39974;9756;28614;1736;5633;2971;7775;4707;13408
411920;201811;971;3078;814;2705;210;758;227;716;437;1474
411925;201811;512;1364;340;1036;79;266;104;293;183;559
411930;201811;5113;16526;4373;15003;1998;7434;248;967;2246;8401
411940;201811;3106;9770;2403;8020;618;2112;588;1769;1206;3881
411950;201811;12965;36769;10655;32698;2057;6957;5327;15694;7384;22651
411960;201811;5543;15516;4576;13517;984;3173;1590;4385;2574;7558
411965;201811;439;1246;305;969;50;179;111;325;161;504
411970;201811;976;2386;757;2074;155;407;343;1055;498;1462
411980;201811;1463;3883;1108;3235;281;888;405;1094;686;1982
411990;201811;34698;98053;23684;75535;5041;17731;7625;22906;12666;40637
411995;201811;2780;7352;2113;6281;599;1989;592;1613;1191;3602
412000;201811;2085;4879;1516;3920;71;239;998;2404;1069;2643
412010;201811;637;2011;437;1521;67;268;105;294;172;562
412015;201811;560;1621;466;1438;59;204;262;798;321;1002
412020;201811;440;1260;254;829;38;141;94;298;132;439
412030;201811;655;1913;449;1489;81;273;133;428;214;701
412033;201811;863;2445;602;1869;82;248;221;693;303;941
412035;201811;785;2120;504;1609;76;281;242;725;318;1006
412040;201811;559;1570;355;1129;70;233;59;165;129;398
412050;201811;1726;4504;1191;3492;217;720;283;822;500;1542
412060;201811;6969;22027;5954;19852;1771;6496;1418;4439;3189;10935
412065;201811;616;1750;453;1415;89;277;136;425;225;702
412070;201811;1162;3052;875;2443;130;381;358;965;488;1346
412080;201811;1811;5341;1125;3735;186;658;117;338;303;996
412085;201811;287;775;97;327;12;40;10;26;22;66
412090;201811;5535;14809;4457;12813;1222;3585;1777;5214;2999;8799
412100;201811;1753;4925;1315;4138;397;1345;243;809;640;2154
412110;201811;843;2353;618;1856;109;344;192;557;301;901
412120;201811;1804;5633;1440;4823;308;1143;416;1201;724;2344
412125;201811;674;2053;504;1643;105;347;161;500;266;847
412130;201811;662;1769;454;1337;69;229;107;325;176;554
412135;201811;604;1657;267;807;48;152;87;236;135;388
412140;201811;1559;4054;999;2999;220;766;157;417;377;1183
412150;201811;2847;7705;2377;6844;337;1078;1456;4029;1793;5107
412160;201811;1044;3321;637;2243;145;560;88;290;233;850
412170;201811;4153;12119;3470;10864;794;2648;1389;4026;2183;6674
412175;201811;1309;4081;1104;3680;278;931;404;1368;682;2299
412180;201811;1712;4837;1246;3947;188;713;514;1463;702;2176
412190;201811;3269;8465;2402;6859;334;1057;1044;2955;1378;4012
412200;201811;1803;5558;1263;4205;335;1179;197;618;532;1797
412210;201811;606;1572;348;1055;68;232;93;241;161;473
412215;201811;3731;10115;3013;8725;850;2456;1173;3800;2023;6256
412217;201811;1002;2713;845;2457;70;223;562;1567;632;1790
412220;201811;5646;16417;4642;14408;1202;3731;1461;4766;2663;8497
412230;201811;2653;8308;2139;7190;394;1486;569;1643;963;3129
412240;201811;6741;17729;4227;12658;769;2546;1122;3045;1891;5591
412250;201811;1942;5204;1493;4335;392;1147;257;733;649;1880
412260;201811;1197;3352;842;2568;136;419;248;698;384;1117
412265;201811;800;2384;679;2125;137;461;281;844;418;1305
412270;201811;777;2284;518;1679;79;281;197;576;276;857
412280;201811;482;1430;379;1245;93;313;104;326;197;639
412290;201811;979;2526;650;1902;111;337;208;580;319;917
412300;201811;1442;4107;1154;3527;288;915;253;765;541;1680
412310;201811;755;2110;626;1877;53;223;335;964;388;1187
412320;201811;828;2199;572;1689;73;292;201;570;274;862
412330;201811;1422;3911;965;2969;165;530;370;1150;535;1680
412340;201811;982;2893;630;2045;112;399;124;356;236;755
412350;201811;2730;7434;1780;5461;365;1112;353;1106;718;2218
412360;201811;243;678;148;464;15;52;65;192;80;244
412370;201811;746;2216;535;1789;105;405;36;132;141;537
412380;201811;1557;4408;1072;3339;294;952;157;522;451;1474
412382;201811;555;1440;357;1069;55;182;107;274;162;456
412385;201811;2178;6201;1802;5433;621;1841;507;1656;1128;3497
412390;201811;2328;6023;1911;5343;371;1125;851;2342;1222;3467
412395;201811;688;1957;472;1483;58;180;203;615;261;795
412400;201811;894;2515;653;2013;146;467;157;516;303;983
412402;201811;1786;4646;1283;3780;330;1068;147;431;477;1499
412405;201811;3066;8469;1948;6128;456;1656;55;173;511;1829
412410;201811;5231;14369;3781;11649;803;2791;983;2781;1786;5572
412420;201811;467;1243;279;829;29;95;106;277;135;372
412430;201811;541;1423;353;1048;32;105;164;464;196;569
412440;201811;2737;7789;1820;5942;508;1806;290;962;798;2768
412450;201811;356;1092;234;782;41;131;24;58;65;189
412460;201811;950;2649;758;2310;134;456;305;920;439;1376
412470;201811;1633;5369;1307;4578;339;1250;305;1103;644;2353
412480;201811;965;2706;602;1857;98;326;120;310;218;636
412490;201811;1098;2887;898;2492;107;293;475;1271;582;1564
412500;201811;1824;4833;1391;3974;308;899;318;835;626;1734
412510;201811;1965;6144;1368;4569;305;1068;115;332;420;1400
412520;201811;1335;3609;725;2228;166;490;51;150;217;640
412530;201811;654;1786;475;1405;68;229;121;350;189;579
412535;201811;770;2084;524;1577;121;408;101;270;222;678
412540;201811;1227;3319;838;2487;105;378;254;755;359;1133
412545;201811;695;1823;460;1338;76;249;127;336;203;585
412550;201811;29993;84318;20448;63868;4031;13528;6676;19162;10707;32690
412555;201811;240;651;157;468;26;79;36;78;62;157
412560;201811;4899;14703;3574;11514;684;2392;976;3077;1660;5469
412570;201811;3838;10359;2310;7227;511;1725;318;1074;829;2799
412575;201811;933;2515;763;2170;90;288;441;1155;531;1443
412580;201811;1328;3563;913;2748;159;526;396;1146;555;1672
412590;201811;422;1153;214;703;40;145;20;61;60;206
412600;201811;1380;3997;1015;3195;184;668;390;1165;574;1833
412610;201811;780;2143;494;1464;63;198;229;603;292;801
412620;201811;1273;3597;948;2982;188;661;286;822;474;1483
412625;201811;8310;22983;5256;16629;820;2853;357;1091;1177;3944
412627;201811;1022;2934;676;2196;165;603;179;563;344;1166
412630;201811;2847;8469;2055;6650;401;1295;648;1909;1049;3204
412635;201811;334;914;225;659;41;124;62;155;103;279
412640;201811;1030;2876;563;1775;82;296;124;337;206;633
412650;201811;1529;4392;1222;3742;232;804;421;1116;653;1920
412660;201811;2534;6927;1793;5413;315;1059;529;1420;844;2479
412665;201811;544;1334;307;897;57;168;114;310;171;478
412667;201811;1717;4639;1267;3714;196;649;487;1335;683;1984
412670;201811;743;1894;508;1475;88;298;188;519;276;817
412680;201811;1511;4247;957;3118;135;509;369;1059;504;1568
412690;201811;877;2485;638;1967;114;372;189;550;303;922
412700;201811;2060;5624;1633;4921;281;1018;740;2109;1021;3127
412710;201811;5784;17579;4579;14991;984;3555;1323;3995;2307;7550
412720;201811;1247;3764;922;2968;152;501;187;511;339;1012
412730;201811;2085;5895;1166;3799;228;808;197;608;425;1416
412740;201811;1718;4940;1135;3632;209;723;171;566;380;1289
412750;201811;3870;10784;3318;9909;409;1456;2114;5971;2523;7427
412760;201811;2819;7902;2368;7089;368;1209;1330;3809;1698;5018
412770;201811;9906;25898;5183;16080;782;2537;1021;2792;1803;5329
412780;201811;1243;3492;972;2992;212;703;351;1041;563;1744
412785;201811;2004;5244;1393;4096;241;740;710;2020;951;2760
412788;201811;1324;3867;1076;3366;252;796;457;1389;709;2185
412790;201811;1197;3280;659;2104;135;485;189;495;324;980
412795;201811;1268;3401;667;2054;135;437;121;348;256;785
412796;201811;2319;7062;1919;6150;411;1396;628;1869;1039;3265
412800;201811;3368;8597;2246;6381;294;937;934;2383;1228;3320
412810;201811;10594;27597;6309;18552;885;2934;2057;5254;2942;8188
412820;201811;6548;18516;4664;14658;1097;3611;1360;4278;2457;7889
412830;201811;346;997;231;736;38;106;45;142;83;248
412840;201811;1768;4688;1275;3696;179;558;433;1193;612;1751
412850;201811;2886;7865;2144;6522;368;1209;765;2230;1133;3439
412853;201811;1710;4605;1407;3911;165;508;728;1835;893;2343
412855;201811;1187;3264;787;2365;167;562;196;526;363;1088
412860;201811;837;2300;611;1863;103;344;265;774;368;1118
412862;201811;704;1695;458;1267;67;206;208;560;275;766
412863;201811;1185;3716;1095;3560;123;401;789;2568;912;2969
412865;201811;716;2055;522;1671;102;342;176;561;278;903
412870;201811;883;2434;669;2070;208;731;134;431;342;1162
412880;201811;850;2397;541;1723;101;348;80;225;181;573
420005;201811;432;1326;228;827;34;120;95;349;129;469
420010;201811;3521;8872;2338;6760;218;694;1607;4642;1825;5336
420020;201811;489;1528;292;1015;49;196;46;129;95;325
420030;201811;119;375;78;304;21;97;13;49;34;146
420040;201811;584;1824;332;1231;53;217;16;40;69;257
420050;201811;647;1606;419;1191;52;167;257;691;309;858
420055;201811;155;467;79;279;14;62;23;74;37;136
420060;201811;121;360;75;243;13;51;17;35;30;86
420070;201811;849;2707;631;2176;132;482;218;717;350;1199
420075;201811;84;228;41;127;9;23;8;17;17;40
420080;201811;374;1132;294;966;93;317;87;271;180;588
420090;201811;399;1322;252;936;61;229;50;187;111;416
420100;201811;1120;3170;977;2955;59;201;779;2324;838;2525
420110;201811;247;820;224;773;47;178;89;283;136;461
420120;201811;392;1160;267;883;60;228;100;291;160;519
420125;201811;327;1081;262;941;67;274;121;412;188;686
420127;201811;287;823;102;359;20;78;21;65;41;143
420130;201811;2073;6224;1550;5190;321;1257;633;1905;954;3162
420140;201811;3308;9289;2400;7622;646;2354;307;894;953;3248
420150;201811;566;1489;348;1115;64;219;155;466;219;685
420160;201811;244;621;112;350;15;56;38;108;53;164
420165;201811;158;476;94;322;24;83;25;78;49;161
420170;201811;252;770;154;532;25;88;27;84;52;172
420180;201811;201;624;117;418;15;55;35;109;50;164
420190;201811;157;521;93;355;33;139;15;50;48;189
420195;201811;1275;3510;952;2963;270;952;114;296;384;1248
420200;201811;3338;9079;1915;6134;331;1307;633;1733;964;3040
420205;201811;1271;3599;929;2973;160;535;501;1617;661;2152
420207;201811;1562;4290;998;3190;216;800;354;1071;570;1871
420208;201811;383;1077;214;776;36;157;87;309;123;466
420209;201811;145;497;94;339;26;109;35;113;61;222
420210;201811;2345;6377;1524;5009;351;1285;624;1948;975;3233
420213;201811;771;2516;661;2290;169;639;293;987;462;1626
420215;201811;226;690;158;537;45;151;31;92;76;243
420220;201811;208;653;133;485;33;145;50;151;83;296
420230;201811;3951;11306;3002;9515;431;1528;1554;4737;1985;6265
420240;201811;11117;30823;7021;21879;964;3525;3542;9726;4506;13251
420243;201811;396;1168;312;996;57;203;162;484;219;687
420245;201811;1232;3397;858;2682;89;351;477;1402;566;1753
420250;201811;430;1279;369;1155;79;281;186;539;265;820
420253;201811;511;1306;370;1094;31;103;192;548;223;651
420257;201811;189;500;113;360;23;79;53;160;76;239
420260;201811;1072;3058;786;2606;129;487;434;1405;563;1892
420270;201811;457;1252;213;663;20;69;78;230;98;299
420280;201811;1357;3769;870;2849;182;652;238;757;420;1409
420285;201811;99;273;53;179;7;30;8;18;15;48
420287;201811;443;1133;303;905;91;290;94;272;185;562
420290;201811;3953;11577;2989;9406;514;1838;1407;3988;1921;5826
420300;201811;6403;18488;3715;12186;781;2884;941;2693;1722;5577
420310;201811;867;2108;413;1169;80;238;197;509;277;747
420315;201811;834;2554;587;2027;148;564;196;654;344;1218
420320;201811;4033;11933;3191;10379;1006;3585;707;2092;1713;5677
420325;201811;248;765;183;637;47;156;54;180;101;336
420330;201811;848;2635;565;1972;130;499;180;555;310;1054
420340;201811;968;2898;692;2318;146;505;59;187;205;692
420350;201811;1358;3708;945;2896;122;411;563;1700;685;2111
420360;201811;2514;7307;1356;4632;261;952;134;455;395;1407
420370;201811;1163;3251;923;2826;118;442;613;1793;731;2235
420380;201811;4821;13340;3120;9970;698;2380;976;2963;1674;5343
420390;201811;1083;2721;710;1916;115;365;323;639;438;1004
420395;201811;994;2973;649;2206;91;316;76;237;167;553
420400;201811;903;2710;587;1981;116;433;166;545;282;978
420410;201811;529;1496;395;1223;45;175;240;700;285;875
420415;201811;311;953;230;771;73;264;67;229;140;493
420417;201811;634;1963;510;1682;124;419;176;592;300;1011
420419;201811;159;579;126;486;41;174;10;31;51;205
420420;201811;10334;28474;7119;22425;2413;8309;1586;4560;3999;12869
420425;201811;723;1931;497;1507;45;167;229;666;274;833
420430;201811;3136;8948;1935;6204;461;1596;551;1536;1012;3132
420435;201811;285;766;127;434;23;96;53;169;76;265
420440;201811;700;2095;409;1374;128;471;103;294;231;765
420445;201811;314;837;185;559;41;132;55;145;96;277
420450;201811;643;1967;462;1549;89;364;150;448;239;812
420455;201811;1940;5086;1438;4242;198;653;719;2021;917;2674
420460;201811;8437;23481;6285;19463;1117;3942;2911;8481;4028;12423
420470;201811;589;1638;339;1111;64;240;88;251;152;491
420475;201811;38;117;29;96;10;30;4;15;14;45
420480;201811;4834;12800;3176;9851;670;2266;991;2944;1661;5210
420490;201811;419;1203;254;870;62;239;75;253;137;492
420500;201811;1293;3879;916;3111;188;659;332;1105;520;1764
420510;201811;169;500;92;316;16;58;26;84;42;142
420515;201811;54;147;35;102;5;15;14;41;19;56
420517;201811;757;2100;652;1918;54;155;489;1431;543;1586
420519;201811;323;800;210;622;28;93;87;258;115;351
420520;201811;382;1036;164;582;20;62;13;45;33;107
420530;201811;867;2583;595;1980;128;486;170;481;298;967
420535;201811;199;563;90;302;23;82;20;71;43;153
420540;201811;26633;66712;16939;48865;3017;9677;5847;14474;8864;24151
420543;201811;235;686;177;554;26;85;90;271;116;356
420545;201811;1145;3504;886;2928;204;709;320;1036;524;1745
420550;201811;3419;9887;2266;7700;484;1793;880;3019;1364;4812
420555;201811;292;860;200;660;40;148;92;277;132;425
420560;201811;428;1135;304;932;70;213;160;488;230;701
420570;201811;2058;6046;1556;5026;329;1178;563;1690;892;2868
420580;201811;1645;4395;1223;3734;267;866;562;1694;829;2560
420590;201811;2946;8190;1723;5430;344;1247;389;919;733;2166
420600;201811;949;2910;734;2456;159;598;311;993;470;1591
420610;201811;341;1039;199;697;50;182;47;165;97;347
420620;201811;510;1408;394;1207;115;369;129;393;244;762
420630;201811;864;2609;630;2027;138;494;278;789;416;1283
420640;201811;514;1488;247;875;62;226;23;60;85;286
420650;201811;2837;7990;1660;5362;273;942;614;1735;887;2677
420660;201811;354;1014;246;790;65;222;59;183;124;405
420665;201811;522;1420;329;1058;58;211;130;373;188;584
420670;201811;1428;4008;943;3063;163;659;341;969;504;1628
420675;201811;137;407;85;297;24;101;16;40;40;141
420680;201811;322;792;182;578;30;102;88;271;118;373
420690;201811;793;2498;494;1713;75;289;111;309;186;598
420700;201811;2771;7719;2131;6564;335;1164;1034;3029;1369;4193
420710;201811;673;2074;521;1731;83;344;256;741;339;1085
420720;201811;1328;3740;961;3151;247;810;401;1282;648;2092
420730;201811;2722;7495;2115;6521;370;1212;1130;3365;1500;4577
420740;201811;656;2013;412;1473;117;445;51;193;168;638
420750;201811;1791;5427;1189;3996;211;806;452;1365;663;2171
420757;201811;64;158;21;85;4;18;8;31;12;49
420760;201811;364;1108;152;503;43;145;19;63;62;208
420765;201811;410;1319;224;805;34;130;83;290;117;420
420768;201811;1189;3691;1016;3345;196;630;653;2161;849;2791
420770;201811;490;1368;226;822;43;173;79;269;122;442
420775;201811;416;1237;250;861;55;210;45;129;100;339
420780;201811;979;2859;571;1951;122;436;126;399;248;835
420785;201811;195;542;141;427;23;70;49;131;72;201
420790;201811;993;3236;746;2689;169;688;341;1147;510;1835
420800;201811;734;1933;344;1108;89;288;75;250;164;538
420810;201811;1455;4893;1186;4277;375;1505;289;891;664;2396
420820;201811;9671;25586;6681;20547;1461;5035;2740;7536;4201;12571
420830;201811;3018;8585;2308;7259;533;1824;850;2582;1383;4406
420840;201811;591;1765;256;931;63;228;47;170;110;398
420845;201811;1835;4928;1070;3527;216;797;353;1132;569;1929
420850;201811;1085;3632;670;2499;157;642;99;313;256;955
420860;201811;269;714;157;505;42;155;31;86;73;241
420870;201811;814;2252;641;1964;184;660;264;754;448;1414
420880;201811;895;2829;699;2396;151;563;215;659;366;1222
420890;201811;7617;20771;4158;13514;692;2515;1172;3193;1864;5708
420895;201811;161;483;92;298;30;105;27;79;57;184
420900;201811;1404;3645;825;2588;124;467;335;918;459;1385
420910;201811;24610;67841;15524;49769;2668;9547;5576;16086;8244;25633
420915;201811;553;2063;376;1518;66;273;169;679;235;952
420917;201811;342;932;177;520;28;92;75;214;103;306
420920;201811;86;247;32;119;4;17;3;10;7;27
420930;201811;17105;45927;12203;37253;2206;7371;5474;15850;7680;23221
420940;201811;2324;6123;1460;4548;354;1198;178;441;532;1639
420945;201811;136;411;99;317;29;108;30;81;59;189
420950;201811;333;1011;189;651;30;117;56;165;86;282
420960;201811;933;2456;639;1897;115;398;252;667;367;1065
420970;201811;2494;7366;1686;5684;462;1610;257;914;719;2524
420980;201811;314;989;252;894;125;440;69;274;194;714
420985;201811;308;930;158;571;30;121;52;162;82;283
420990;201811;415;1252;209;755;46;170;34;104;80;274
421000;201811;481;1605;322;1187;74;303;70;204;144;507
421003;201811;475;1148;154;482;17;53;26;73;43;126
421005;201811;54;184;48;174;12;45;20;75;32;120
421010;201811;3576;10026;2528;8121;544;1901;562;1607;1106;3508
421020;201811;371;1145;293;1002;28;117;185;627;213;744
421030;201811;736;2340;573;1977;177;670;156;480;333;1150
421040;201811;706;1700;429;1263;40;137;265;758;305;895
421050;201811;1146;3287;712;2280;143;496;235;678;378;1174
421055;201811;172;473;85;267;15;55;29;71;44;126
421060;201811;567;1724;371;1215;65;239;144;432;209;671
421070;201811;509;1576;288;1016;61;219;43;148;104;367
421080;201811;501;1505;446;1414;63;204;288;925;351;1129
421085;201811;380;1131;150;560;25;102;22;70;47;172
421090;201811;299;804;168;523;22;73;51;154;73;227
421100;201811;911;2145;393;1188;89;298;52;142;141;440
421105;201811;1342;3781;1080;3390;169;520;614;1986;783;2506
421110;201811;1038;3053;876;2798;49;147;613;2036;662;2183
421120;201811;920;2972;638;2274;89;365;199;634;288;999
421125;201811;261;726;212;647;70;236;73;178;143;414
421130;201811;3828;11781;3253;10672;764;2762;1704;5406;2468;8168
421140;201811;279;795;185;604;38;130;56;163;94;293
421145;201811;456;1317;267;868;50;183;123;372;173;555
421150;201811;496;1376;296;1006;59;229;102;333;161;562
421160;201811;717;1908;407;1287;61;214;218;665;279;879
421165;201811;197;616;134;466;30;103;54;187;84;290
421170;201811;1070;2933;848;2577;141;422;530;1632;671;2054
421175;201811;1035;2753;677;2158;132;500;260;730;392;1230
421180;201811;381;1017;192;634;46;188;48;150;94;338
421185;201811;314;838;210;628;32;93;112;332;144;425
421187;201811;331;976;206;659;37;117;72;212;109;329
421189;201811;353;1073;269;888;50;162;85;267;135;429
421190;201811;9634;26742;6105;19988;1315;4716;1414;4365;2729;9081
421200;201811;665;2039;543;1783;94;323;262;827;356;1150
421205;201811;182;522;140;455;30;110;67;206;97;316
421210;201811;1059;2874;665;2145;169;552;216;694;385;1246
421220;201811;1299;4184;1060;3626;250;946;232;687;482;1633
421223;201811;376;1094;249;837;60;194;104;350;164;544
421225;201811;910;2837;789;2593;169;604;422;1387;591;1991
421227;201811;971;2620;576;1819;101;347;265;829;366;1176
421230;201811;575;1567;361;1159;98;346;110;344;208;690
421240;201811;306;942;121;457;15;77;14;51;29;128
421250;201811;1533;4115;1014;3225;171;598;415;1274;586;1872
421260;201811;195;556;46;167;10;36;8;32;18;68
421265;201811;648;1924;596;1850;35;128;511;1579;546;1707
421270;201811;416;1112;186;676;30;111;74;259;104;370
421280;201811;1529;4601;1164;3910;259;1018;489;1520;748;2538
421290;201811;769;2169;434;1389;80;258;87;275;167;533
421300;201811;220;623;139;455;25;90;45;143;70;233
421310;201811;167;528;133;443;21;74;58;193;79;267
421315;201811;208;616;132;435;35;114;25;82;60;196
421320;201811;639;1895;332;1099;50;171;53;119;103;290
421330;201811;602;1813;433;1472;100;372;116;368;216;740
421335;201811;351;1123;283;987;56;221;106;357;162;578
421340;201811;1281;3754;958;3139;211;754;395;1264;606;2018
421350;201811;1160;3340;833;2721;161;621;354;1058;515;1679
421360;201811;2222;6304;1350;4494;300;1166;453;1323;753;2489
421370;201811;489;1623;292;1091;71;290;63;209;134;499
421380;201811;798;2250;694;2057;107;356;405;1154;512;1510
421390;201811;174;470;61;205;9;25;19;55;28;80
421400;201811;256;863;175;666;38;169;80;274;118;443
421410;201811;251;697;109;389;16;59;41;148;57;207
421415;201811;276;842;139;460;37;124;30;88;67;212
421420;201811;516;1517;438;1362;75;259;247;720;322;979
421430;201811;128;434;98;357;12;46;32;105;44;151
421440;201811;623;1662;397;1282;86;281;187;610;273;891
421450;201811;361;1093;225;760;32;133;39;143;71;276
421460;201811;360;1040;223;770;49;181;54;161;103;342
421470;201811;236;750;150;535;33;143;50;174;83;317
421480;201811;2674;7322;1729;5545;445;1590;502;1415;947;3005
421490;201811;121;368;71;243;12;49;17;44;29;93
421500;201811;2015;6207;1413;4928;394;1539;298;947;692;2486
421505;201811;312;938;272;866;41;148;155;461;196;609
421507;201811;382;1166;229;797;67;253;68;221;135;474
421510;201811;249;725;145;465;33;105;64;191;97;296
421520;201811;529;1433;336;998;47;170;181;481;228;651
421530;201811;320;1026;193;692;37;167;43;126;80;293
421535;201811;411;1166;264;876;37;140;135;415;172;555
421540;201811;207;533;128;399;19;71;48;133;67;204
421545;201811;690;2083;505;1707;97;361;222;734;319;1095
421550;201811;1952;5690;1616;5143;371;1274;762;2339;1133;3613
421555;201811;191;597;64;242;10;41;10;25;20;66
421560;201811;89;289;53;200;11;45;15;55;26;100
421565;201811;848;2298;613;1909;150;507;199;639;349;1146
421567;201811;484;1705;319;1202;146;562;52;178;198;740
421568;201811;362;1097;250;835;35;131;106;333;141;464
421569;201811;190;568;70;253;20;71;24;93;44;164
421570;201811;990;2815;663;2160;179;639;137;412;316;1051
421575;201811;299;925;258;809;52;195;105;276;157;471
421580;201811;2856;8513;1947;6542;410;1581;613;1775;1023;3356
421590;201811;136;450;109;376;31;112;29;88;60;200
421600;201811;498;1411;341;1062;78;258;86;228;164;486
421605;201811;720;1944;491;1539;103;315;161;498;264;813
421610;201811;1102;3066;680;2216;134;449;159;516;293;965
421620;201811;3786;10677;2215;7600;568;2108;549;1830;1117;3938
421625;201811;221;600;88;284;24;72;12;32;36;104
421630;201811;2500;6965;1424;4566;248;926;338;946;586;1872
421635;201811;218;619;144;444;17;55;74;204;91;259
421640;201811;717;2004;489;1603;101;339;135;445;236;784
421650;201811;2107;6131;1361;4611;321;1234;302;831;623;2065
421660;201811;7350;21884;5622;18501;987;3674;2192;6619;3179;10293
421670;201811;791;2325;555;1773;125;472;241;725;366;1197
421680;201811;883;2725;688;2312;200;723;250;763;450;1486
421690;201811;1181;3629;833;2827;178;677;236;781;414;1458
421700;201811;441;1377;225;803;43;180;55;160;98;340
421710;201811;206;665;90;315;20;75;28;91;48;166
421715;201811;106;305;76;234;19;61;50;146;69;207
421720;201811;1881;5323;1073;3590;295;1085;261;760;556;1845
421725;201811;190;478;105;317;27;92;41;93;68;185
421730;201811;347;1061;196;638;31;110;74;213;105;323
421740;201811;607;1811;420;1383;118;417;96;291;214;708
421750;201811;819;1992;420;1264;86;278;161;448;247;726
421755;201811;174;498;98;310;15;56;45;125;60;181
421760;201811;865;2494;503;1711;85;318;145;401;230;719
421770;201811;2184;6054;1604;5026;416;1301;547;1863;963;3164
421775;201811;238;649;149;465;27;96;69;190;96;286
421780;201811;772;2472;525;1925;112;455;184;635;296;1090
421790;201811;653;1719;383;1266;95;334;181;570;276;904
421795;201811;225;672;138;436;20;73;54;151;74;224
421800;201811;2353;6843;1753;5700;341;1219;845;2621;1186;3840
421810;201811;615;1723;423;1340;60;230;227;674;287;904
421820;201811;817;2439;428;1465;90;326;84;252;174;578
421825;201811;1316;3835;1201;3655;143;491;837;2461;980;2952
421830;201811;2027;6527;1733;5950;389;1458;657;2128;1046;3586
421835;201811;213;582;122;410;14;67;54;157;68;224
421840;201811;220;698;144;523;39;150;29;92;68;242
421850;201811;378;1139;213;747;37;150;60;156;97;306
421860;201811;274;837;184;638;25;116;56;145;81;261
421870;201811;3296;8731;2298;6783;516;1720;939;2517;1455;4237
421875;201811;219;656;105;373;19;72;22;57;41;129
421880;201811;488;1402;360;1161;110;418;71;227;181;645
421885;201811;192;562;132;453;39;136;26;75;65;211
421890;201811;756;2454;606;2145;131;517;258;831;389;1348
421895;201811;361;1027;314;957;41;142;209;638;250;780
421900;201811;940;2469;665;1946;107;348;306;816;413;1164
421910;201811;316;972;218;748;53;215;39;102;92;317
421915;201811;381;1097;203;674;43;143;26;78;69;221
421917;201811;562;1489;349;1182;126;476;68;227;194;703
421920;201811;507;1471;326;1154;150;543;92;334;242;877
421930;201811;2245;6063;1085;3700;307;1136;154;490;461;1626
421935;201811;437;1435;341;1206;68;249;175;591;243;840
421940;201811;302;938;125;439;27;114;32;97;59;211
421950;201811;3018;7729;1466;4699;317;1113;298;840;615;1953
421960;201811;153;403;101;322;20;80;22;62;42;142
421970;201811;1952;5210;1064;3367;237;781;288;796;525;1577
421985;201811;282;738;162;487;15;57;60;187;75;244
422000;201811;1597;4516;1334;4039;188;669;821;2445;1009;3114
430003;201811;518;1524;357;1213;78;290;127;425;205;715
430005;201811;265;737;166;544;48;154;62;203;110;357
430010;201811;1657;4382;1309;3753;191;607;822;2274;1013;2881
430020;201811;594;1421;456;1232;77;248;260;646;337;894
430030;201811;1016;2507;581;1703;172;516;158;431;330;947
430040;201811;9529;24208;5715;17018;1494;4892;392;1222;1886;6114
430045;201811;558;1462;371;1089;40;127;202;552;242;679
430047;201811;251;568;103;307;21;68;26;76;47;144
430050;201811;917;2424;508;1547;116;386;105;301;221;687
430055;201811;274;697;114;351;15;50;55;156;70;206
430057;201811;94;214;31;90;7;26;7;18;14;44
430060;201811;15938;45760;12689;40388;3248;11049;5167;16358;8415;27407
430063;201811;877;2488;682;2055;130;390;372;1113;502;1503
430064;201811;979;2822;726;2247;216;697;215;642;431;1339
430066;201811;113;261;79;206;4;15;58;136;62;151
430070;201811;708;1814;103;341;10;36;11;25;21;61
430080;201811;750;1982;443;1348;93;306;182;490;275;796
430085;201811;886;2110;505;1452;84;254;202;555;286;809
430087;201811;547;1577;453;1437;96;312;243;775;339;1087
430090;201811;595;1571;194;640;20;82;57;184;77;266
430100;201811;594;1522;333;1014;69;221;117;327;186;548
430105;201811;998;2774;642;2151;119;446;290;978;409;1424
430107;201811;178;540;122;403;20;69;29;78;49;147
430110;201811;2086;5306;1515;4445;259;807;833;2378;1092;3185
430120;201811;1384;4247;851;2836;170;585;367;1244;537;1829
430130;201811;3789;9970;2969;8766;1067;2920;859;3187;1926;6107
430140;201811;936;2777;624;2081;173;572;226;766;399;1338
430150;201811;567;1485;311;970;67;219;93;280;160;499
430155;201811;271;699;129;406;22;72;30;81;52;153
430160;201811;17399;44801;14017;39611;3006;8990;6095;17454;9101;26444
430163;201811;2384;6102;1705;5025;162;558;1087;3160;1249;3718
430165;201811;393;923;80;257;13;34;9;21;22;55
430170;201811;901;2457;314;1098;61;213;62;200;123;413
430175;201811;664;2078;544;1795;136;433;260;848;396;1281
430180;201811;675;1761;536;1509;83;262;351;942;434;1204
430185;201811;459;1137;280;797;47;140;131;344;178;484
430187;201811;659;1700;463;1382;77;250;224;657;301;907
430190;201811;1423;4017;1159;3534;274;888;498;1455;772;2343
430192;201811;124;366;51;159;8;26;13;36;21;62
430195;201811;391;1177;63;225;9;31;7;22;16;53
430200;201811;1052;3313;891;2986;298;1061;251;849;549;1910
430205;201811;504;1353;403;1145;15;50;330;905;345;955
430210;201811;5013;12767;3440;9601;638;1941;1285;2862;1923;4803
430215;201811;308;826;193;573;38;121;74;211;112;332
430220;201811;654;1634;166;568;33;128;36;107;69;235
430222;201811;185;539;150;469;22;73;62;178;84;251
430223;201811;258;726;216;644;36;114;118;340;154;454
430225;201811;16;38;14;34;1;2;10;17;11;19
430230;201811;1652;4808;1506;4602;196;555;1134;3540;1330;4095
430235;201811;248;756;182;597;36;123;53;153;89;276
430237;201811;544;1341;361;1017;24;78;240;641;264;719
430240;201811;1150;2612;677;1871;69;230;387;1023;456;1253
430245;201811;702;2145;538;1790;171;570;231;782;402;1352
430250;201811;968;2609;769;2298;222;723;36;89;258;812
430258;201811;118;338;89;281;8;25;41;127;49;152
430260;201811;626;1712;449;1358;81;255;228;675;309;930
430265;201811;196;588;144;494;28;102;40;135;68;237
430270;201811;2722;7138;2195;6290;317;1032;1421;3915;1738;4947
430280;201811;4782;11915;3426;9461;737;2144;1404;3812;2141;5956
430290;201811;2132;5255;1870;4897;71;215;1607;4143;1678;4358
430300;201811;8611;23591;6789;20130;1314;4229;3293;9551;4607;13780
430310;201811;9339;24431;6232;18300;967;3275;2906;7863;3873;11138
430320;201811;929;2541;517;1629;82;217;262;874;344;1091
430330;201811;605;1551;403;1130;83;265;188;460;271;725
430340;201811;670;1564;351;1041;75;236;183;522;258;758
430350;201811;6005;16888;4653;14169;1135;3543;1993;5941;3128;9484
430355;201811;322;841;109;361;27;86;11;37;38;123
430360;201811;740;1910;530;1531;111;363;186;481;297;844
430367;201811;341;849;176;519;46;153;59;165;105;318
430370;201811;494;1374;228;746;49;167;60;173;109;340
430380;201811;697;1767;356;1124;76;271;74;237;150;508
430390;201811;3080;7750;1647;4978;303;986;125;295;428;1281
430400;201811;1109;2446;831;2028;93;241;586;1357;679;1598
430410;201811;572;1433;387;1115;61;197;215;593;276;790
430420;201811;2790;7909;2126;6400;657;2074;710;2021;1367;4095
430430;201811;662;1744;316;994;79;248;64;205;143;453
430435;201811;1555;4043;1167;3393;276;862;469;1338;745;2200
430440;201811;3661;10675;2722;8699;514;1758;1397;4432;1911;6190
430450;201811;6540;17215;5244;14876;754;2422;2940;8090;3694;10512
430460;201811;27774;74469;19825;61000;4321;14778;8259;23950;12580;38728
430461;201811;420;1070;117;370;22;70;29;83;51;153
430462;201811;243;673;147;488;16;56;48;172;64;228
430463;201811;4628;13323;3655;11581;714;2472;1816;5649;2530;8121
430465;201811;476;1295;389;1115;63;198;235;646;298;844
430466;201811;3843;9878;3069;8568;796;2335;1388;3645;2184;5980
430467;201811;493;1263;353;1022;59;213;167;450;226;663
430468;201811;1320;3390;1057;2988;144;436;619;1715;763;2151
430469;201811;644;1812;76;257;11;34;11;19;22;53
430470;201811;5596;15220;3918;12137;1277;4236;868;2598;2145;6834
430471;201811;496;1533;428;1377;77;242;202;632;279;874
430480;201811;842;2236;413;1296;65;212;82;214;147;426
430485;201811;157;432;58;194;9;27;10;36;19;63
430490;201811;418;1114;234;706;35;122;103;285;138;407
430495;201811;361;1022;217;720;33;115;81;246;114;361
430500;201811;1048;2792;750;2275;233;771;228;619;461;1390
430510;201811;22896;61965;16379;48571;3552;11598;6330;17191;9882;28789
430511;201811;319;945;115;402;16;53;15;44;31;97
430512;201811;903;2188;726;1901;184;494;231;618;415;1112
430513;201811;775;1973;362;1042;72;208;159;438;231;646
430515;201811;402;1138;282;885;45;129;138;440;183;569
430517;201811;900;2860;751;2552;146;498;377;1337;523;1835
430520;201811;1319;3509;688;2143;134;417;128;365;262;782
430530;201811;1067;2745;376;1155;78;234;84;250;162;484
430535;201811;2919;7958;2055;6284;335;1053;981;2966;1316;4019
430537;201811;328;1185;295;1074;34;111;223;821;257;932
430540;201811;571;1384;331;989;56;168;152;436;208;604
430543;201811;649;1293;397;993;63;141;226;599;289;740
430544;201811;640;1939;457;1496;109;383;210;656;319;1039
430545;201811;1808;5045;1385;4398;285;935;679;2217;964;3152
430550;201811;424;1221;250;813;48;160;69;210;117;370
430558;201811;113;261;53;149;10;28;18;46;28;74
430560;201811;349;802;146;443;13;46;46;127;59;173
430570;201811;840;2010;591;1598;90;286;351;869;441;1155
430580;201811;1049;2555;675;1962;164;525;271;745;435;1270
430583;201811;190;472;37;113;2;7;5;15;7;22
430585;201811;225;554;122;339;15;38;59;145;74;183
430587;201811;186;556;133;433;19;60;51;169;70;229
430590;201811;1423;3489;1232;3184;64;205;1065;2695;1129;2900
430593;201811;17;58;12;42;2;8;8;26;10;34
430595;201811;413;999;87;298;7;31;18;49;25;80
430597;201811;351;977;217;661;23;73;77;177;100;250
430600;201811;1777;4719;822;2494;149;472;224;640;373;1112
430605;201811;1105;3197;834;2635;129;480;312;929;441;1409
430607;201811;622;1420;454;1165;34;93;311;806;345;899
430610;201811;5591;14195;3890;11457;1114;3573;631;1965;1745;5538
430613;201811;266;634;82;249;7;21;19;47;26;68
430620;201811;557;1517;443;1284;98;315;204;562;302;877
430630;201811;433;1240;121;389;15;50;26;66;41;116
430632;201811;541;1483;245;756;30;101;112;327;142;428
430635;201811;530;1437;392;1152;65;203;256;738;321;941
430637;201811;451;1182;353;1013;42;130;201;543;243;673
430640;201811;1172;3049;650;1957;101;317;208;578;309;895
430642;201811;371;1010;264;777;45;128;136;391;181;519
430645;201811;240;518;80;207;18;48;13;33;31;81
430650;201811;1538;4757;1292;4305;338;1152;601;2053;939;3205
430655;201811;232;559;137;373;14;42;71;175;85;217
430660;201811;4669;12694;3599;10778;826;2704;1600;4700;2426;7404
430670;201811;587;1521;446;1261;44;148;282;799;326;947
430673;201811;576;1365;224;686;45;141;74;222;119;363
430675;201811;214;635;62;219;19;77;15;48;34;125
430676;201811;4216;11090;3261;9491;510;1578;1811;5141;2321;6719
430680;201811;974;2651;585;1852;165;514;143;427;308;941
430690;201811;3109;8725;2517;7609;797;2489;655;1922;1452;4411
430692;201811;200;637;158;568;12;37;114;421;126;458
430693;201811;1024;2723;585;1782;118;419;125;332;243;751
430695;201811;513;1284;303;876;36;105;167;458;203;563
430697;201811;391;1019;289;848;60;176;147;452;207;628
430700;201811;6967;17743;3696;11566;882;2961;377;1163;1259;4124
430705;201811;366;941;178;561;28;96;68;201;96;297
430710;201811;1684;3823;1180;3076;192;562;625;1588;817;2150
430720;201811;715;1755;381;1161;61;174;163;495;224;669
430730;201811;1155;3124;773;2396;127;374;373;1175;500;1549
430740;201811;598;1678;309;1026;52;188;86;297;138;485
430745;201811;451;1276;236;768;39;141;59;172;98;313
430750;201811;1349;3590;955;2888;198;642;486;1404;684;2046
430755;201811;476;1175;297;804;21;62;164;408;185;470
430760;201811;2004;5200;1534;4439;385;1159;632;1785;1017;2944
430770;201811;6146;15910;4655;13542;737;2421;2760;7701;3497;10122
430780;201811;2086;5283;1180;3719;232;763;359;1194;591;1957
430781;201811;390;1122;224;740;53;180;48;135;101;315
430783;201811;441;1042;249;724;25;84;134;372;159;456
430786;201811;40;139;24;94;5;21;2;9;7;30
430790;201811;4377;11427;2998;8810;496;1613;1574;4314;2070;5927
430800;201811;755;1915;544;1514;56;178;339;920;395;1098
430805;201811;459;1265;270;828;24;83;158;446;182;529
430807;201811;326;805;209;608;20;74;108;291;128;365
430810;201811;833;2065;270;876;39;143;75;214;114;357
430820;201811;1302;3558;697;2326;155;529;145;493;300;1022
430825;201811;287;746;91;257;18;48;19;47;37;95
430830;201811;1577;4737;1333;4268;87;342;919;2920;1006;3262
430840;201811;876;2445;720;2165;135;428;432;1280;567;1708
430843;201811;112;271;35;106;5;14;15;40;20;54
430845;201811;358;906;242;703;78;240;65;162;143;402
430850;201811;2244;6153;1687;5062;325;1039;769;2279;1094;3318
430860;201811;871;1987;441;1256;79;270;198;496;277;766
430865;201811;517;1362;428;1208;86;251;207;553;293;804
430870;201811;653;1747;283;900;48;164;92;256;140;420
430880;201811;1205;2933;804;2300;196;592;342;954;538;1546
430885;201811;219;526;97;318;9;40;53;162;62;202
430890;201811;1048;2845;694;2139;56;267;118;320;174;587
430900;201811;2967;6871;2004;5400;220;700;1188;2994;1408;3694
430905;201811;801;2146;498;1523;97;328;167;486;264;814
430910;201811;1419;3910;959;2948;178;615;392;1088;570;1703
430912;201811;483;1361;327;1058;34;104;208;686;242;790
430915;201811;506;1583;375;1330;101;367;124;458;225;825
430920;201811;22181;58155;17101;49655;2640;8468;9797;27539;12437;36007
430925;201811;136;307;50;145;8;25;19;57;27;82
430930;201811;9902;23875;5946;17615;1423;4532;1971;6025;3394;10557
430940;201811;1171;3366;639;2052;194;665;73;178;267;843
430950;201811;708;1785;444;1276;80;256;233;609;313;865
430955;201811;233;615;66;197;16;46;13;32;29;78
430957;201811;189;651;175;620;36;128;89;308;125;436
430960;201811;1283;3071;802;2236;169;523;381;1036;550;1559
430965;201811;1702;4215;1288;3539;78;245;957;2576;1035;2821
430970;201811;375;982;192;601;30;108;95;278;125;386
430975;201811;472;1494;363;1219;90;324;143;462;233;786
430980;201811;412;1020;225;681;39;122;91;263;130;385
430990;201811;552;1623;322;1034;41;151;159;503;200;654
430995;201811;579;1534;412;1238;67;200;196;576;263;776
431000;201811;1346;3222;546;1604;91;292;34;81;125;373
431010;201811;2100;5642;1213;3960;200;747;120;325;320;1072
431020;201811;8410;19155;5138;13926;1224;3607;1588;3866;2812;7473
431030;201811;318;886;143;496;26;96;23;78;49;174
431033;201811;2990;7644;1958;5963;514;1622;601;1894;1115;3516
431036;201811;357;789;71;214;12;28;15;44;27;72
431040;201811;932;2471;600;1832;98;346;259;735;357;1081
431041;201811;461;1087;350;923;39;106;215;541;254;647
431043;201811;413;1025;220;684;73;242;72;217;145;459
431046;201811;114;304;48;145;5;16;10;29;15;45
431050;201811;1434;3614;1025;2958;198;587;523;1515;721;2102
431053;201811;517;1479;329;1076;74;253;99;312;173;565
431055;201811;612;1543;523;1401;43;99;396;1051;439;1150
431057;201811;279;820;129;445;18;62;33;102;51;164
431060;201811;4847;13674;3610;11363;1056;3603;704;2305;1760;5908
431065;201811;495;1324;326;1012;68;216;99;303;167;519
431070;201811;451;1345;254;866;70;266;32;92;102;358
431075;201811;222;684;147;502;27;97;42;142;69;239
431080;201811;607;1700;419;1314;91;305;118;351;209;656
431085;201811;698;1901;492;1419;84;243;257;721;341;964
431087;201811;462;1344;367;1127;32;94;251;789;283;883
431090;201811;408;973;146;471;28;97;36;113;64;210
431100;201811;3131;7369;2278;6177;394;1155;1057;2836;1451;3991
431110;201811;1362;3271;964;2559;225;601;427;1071;652;1672
431112;201811;510;1585;436;1429;93;324;211;658;304;982
431113;201811;366;1046;309;931;81;259;144;427;225;686
431115;201811;1103;3194;867;2748;146;501;477;1458;623;1959
431120;201811;2329;6759;1641;5317;550;1990;374;1098;924;3088
431123;201811;389;1109;238;781;51;143;117;411;168;554
431125;201811;1095;3309;804;2660;310;1010;225;802;535;1812
431127;201811;263;700;66;213;9;28;12;27;21;55
431130;201811;3071;8376;2170;6667;468;1569;898;2682;1366;4251
431140;201811;4956;12019;2742;7737;376;1188;1117;2743;1493;3931
431142;201811;484;1339;359;1111;54;163;218;678;272;841
431150;201811;1003;2793;704;2192;156;508;270;817;426;1325
431160;201811;661;1917;478;1522;98;309;159;519;257;828
431162;201811;477;1185;220;692;24;98;81;224;105;322
431164;201811;206;485;44;144;11;39;4;15;15;54
431170;201811;534;1476;364;1133;104;311;96;298;200;609
431171;201811;633;1610;529;1466;75;210;344;943;419;1153
431173;201811;399;1100;298;920;107;353;85;257;192;610
431175;201811;1012;2555;617;1850;152;461;133;397;285;858
431177;201811;702;2083;531;1786;160;577;233;770;393;1347
431179;201811;346;735;69;205;15;49;17;37;32;86
431180;201811;2179;5751;1324;4050;367;1163;235;717;602;1880
431190;201811;472;1292;242;775;28;86;48;128;76;214
431198;201811;306;976;271;903;97;348;74;260;171;608
431200;201811;379;993;88;286;12;32;1;6;13;38
431205;201811;193;565;86;316;20;71;36;131;56;202
431210;201811;623;1643;502;1463;135;373;240;733;375;1106
431213;201811;246;722;183;608;16;67;96;311;112;378
431215;201811;500;1248;229;700;27;88;97;265;124;353
431217;201811;156;454;105;350;11;40;57;175;68;215
431220;201811;617;1656;350;1105;32;127;174;498;206;625
431225;201811;1475;3698;1109;3057;126;385;697;1889;823;2274
431230;201811;689;2041;492;1520;81;267;273;802;354;1069
431235;201811;135;351;22;69;3;8;2;7;5;15
431237;201811;364;1109;288;960;53;199;149;478;202;677
431238;201811;23;61;19;51;6;14;6;15;12;29
431240;201811;3775;9951;3003;8671;671;2119;1311;3630;1982;5749
431242;201811;320;904;260;789;68;214;115;347;183;561
431244;201811;330;805;152;435;23;88;52;111;75;199
431245;201811;1324;3199;832;2294;110;322;401;1051;511;1373
431247;201811;219;609;104;338;19;66;23;64;42;130
431250;201811;1513;4233;1164;3691;266;820;539;1798;805;2618
431260;201811;225;645;124;434;16;71;44;137;60;208
431261;201811;249;793;198;689;21;80;94;302;115;382
431262;201811;398;1128;174;583;15;50;108;360;123;410
431265;201811;1466;3494;592;1728;96;315;187;455;283;770
431267;201811;255;715;146;437;6;25;100;269;106;294
431270;201811;2591;6154;1382;4029;359;1140;380;1105;739;2245
431275;201811;148;420;74;238;16;54;9;22;25;76
431280;201811;256;710;70;246;5;16;5;13;10;29
431290;201811;302;867;210;672;30;96;67;178;97;274
431295;201811;72;191;25;78;3;13;6;17;9;30
431300;201811;386;969;55;195;5;22;11;36;16;58
431301;201811;222;656;53;188;6;14;4;11;10;25
431303;201811;576;1547;331;1003;34;116;122;344;156;460
431306;201811;2099;5102;1252;3630;187;625;472;1215;659;1840
431308;201811;26;85;23;75;15;52;3;7;18;59
431310;201811;577;1646;356;1119;57;194;147;443;204;637
431320;201811;608;1639;279;930;51;167;39;122;90;289
431330;201811;1723;4226;820;2522;226;767;186;513;412;1280
431333;201811;231;643;118;356;13;32;41;116;54;148
431335;201811;39;115;24;82;6;14;4;8;10;22
431337;201811;2568;7066;1787;5664;489;1725;564;1670;1053;3395
431339;201811;444;1156;313;900;76;223;144;414;220;637
431340;201811;19709;50181;13841;39947;2861;9007;4940;13333;7801;22340
431342;201811;475;1099;353;915;29;89;291;735;320;824
431344;201811;382;999;224;672;12;36;148;432;160;468
431346;201811;255;644;87;282;15;47;20;62;35;109
431349;201811;659;1775;350;1065;68;224;128;356;196;580
431350;201811;3891;10560;2861;8715;521;1721;1317;3962;1838;5683
431360;201811;584;1414;329;944;75;232;111;292;186;524
431365;201811;1738;4527;1464;4108;153;499;1074;2963;1227;3462
431370;201811;4127;10859;3074;9021;782;2447;1289;3870;2071;6317
431380;201811;732;2110;619;1905;47;165;395;1204;442;1369
431390;201811;2391;6085;1373;4126;235;805;507;1350;742;2155
431395;201811;1225;3344;885;2795;229;731;335;1094;564;1825
431400;201811;378;1107;184;596;31;99;45;133;76;232
431402;201811;917;2174;628;1678;94;270;383;964;477;1234
431403;201811;179;493;144;433;21;85;89;238;110;323
431405;201811;4310;11644;3447;10297;434;1505;2067;5970;2501;7475
431406;201811;451;1389;366;1227;102;320;173;603;275;923
431407;201811;448;1259;290;907;60;193;127;382;187;575
431410;201811;14888;39806;9480;29454;1859;6506;3645;10496;5504;17002
431413;201811;180;466;54;176;5;16;9;29;14;45
431415;201811;680;1749;420;1308;65;244;164;448;229;692
431417;201811;577;1344;391;1050;69;201;202;513;271;714
431420;201811;1390;3426;1106;3000;217;604;507;1399;724;2003
431430;201811;532;1381;259;813;44;143;64;171;108;314
431440;201811;24593;61643;18034;50697;3946;11842;6115;16778;10061;28620
431442;201811;102;294;52;178;8;27;8;22;16;49
431445;201811;429;1236;133;466;20;64;14;48;34;112
431446;201811;332;936;221;696;55;187;82;244;137;431
431447;201811;612;1696;406;1260;98;323;146;448;244;771
431449;201811;718;1932;441;1296;78;227;182;513;260;740
431450;201811;2081;4566;1711;4053;119;302;1296;2945;1415;3247
431454;201811;44;137;41;131;10;36;15;52;25;88
431455;201811;603;1491;299;841;46;148;142;349;188;497
431460;201811;2902;7524;2162;6123;593;1739;614;1779;1207;3518
431470;201811;1465;4212;1063;3358;208;663;447;1401;655;2064
431475;201811;246;716;30;125;1;5;2;10;3;15
431477;201811;435;1142;270;804;43;129;122;331;165;460
431478;201811;244;625;60;187;18;58;4;11;22;69
431480;201811;3093;7948;2407;6863;413;1257;1370;3845;1783;5102
431490;201811;98896;248875;81168;220929;7601;23779;58837;155066;66438;178845
431500;201811;489;1290;354;1019;69;192;183;507;252;699
431505;201811;389;939;248;708;28;77;145;411;173;488
431507;201811;345;824;145;413;33;110;51;123;84;233
431510;201811;1510;4073;1073;3199;238;745;404;1198;642;1943
431513;201811;256;609;132;374;10;24;94;275;104;299
431514;201811;86;236;47;158;8;29;20;64;28;93
431515;201811;522;1364;344;1008;78;247;160;430;238;677
431517;201811;71;209;55;169;13;35;16;49;29;84
431520;201811;432;1068;161;521;30;103;55;154;85;257
431530;201811;3930;8699;2381;6452;681;1876;394;1101;1075;2977
431531;201811;198;558;132;415;19;57;53;164;72;221
431532;201811;517;1290;337;947;79;234;132;370;211;604
431535;201811;279;721;104;334;21;77;19;53;40;130
431540;201811;1735;5710;1617;5509;70;270;1286;4389;1356;4659
431545;201811;366;970;71;226;7;27;18;50;25;77
431550;201811;1908;5207;1554;4502;303;942;692;1931;995;2873
431555;201811;679;1593;424;1150;33;106;252;665;285;771
431560;201811;20273;52862;13340;41185;3103;10233;3535;11624;6638;21857
431570;201811;4642;11584;3710;10268;613;1893;2263;6039;2876;7932
431575;201811;204;607;149;481;26;80;29;84;55;164
431580;201811;558;1486;300;946;49;184;130;379;179;563
431590;201811;705;1909;506;1493;113;336;179;539;292;875
431595;201811;330;951;221;703;39;116;91;279;130;395
431600;201811;1373;3466;1005;2896;287;879;350;1013;637;1892
431610;201811;1329;3610;914;2742;138;383;446;1393;584;1776
431620;201811;554;1520;235;720;45;149;98;275;143;424
431630;201811;1220;3213;579;1820;139;459;173;473;312;932
431640;201811;5874;15453;5243;14519;702;2048;3716;10289;4418;12337
431642;201811;473;1197;304;855;30;72;160;428;190;500
431643;201811;327;825;143;417;18;51;48;136;66;187
431645;201811;1685;4233;1355;3709;129;402;963;2615;1092;3017
431647;201811;202;517;102;296;14;47;24;56;38;103
431650;201811;171;510;121;405;22;84;40;120;62;204
431660;201811;843;2279;458;1491;78;290;102;290;180;580
431670;201811;1154;2866;785;2207;127;404;406;1068;533;1472
431673;201811;240;635;88;311;14;44;14;37;28;81
431675;201811;562;1409;127;412;11;43;35;94;46;137
431680;201811;7366;19872;5452;16093;1488;4578;1914;5600;3402;10178
431690;201811;20139;52603;14111;41412;3494;10866;4767;14147;8261;25013
431695;201811;149;386;93;280;17;59;39;89;56;148
431697;201811;473;1166;368;993;63;167;195;538;258;705
431700;201811;1388;3721;1182;3341;181;497;675;1891;856;2388
431710;201811;11245;29681;8573;25570;2119;6652;3417;10678;5536;17330
431720;201811;5770;15281;3699;11063;1010;3167;589;1621;1599;4788
431725;201811;25;72;17;54;4;13;4;11;8;24
431730;201811;3600;9300;2369;7201;621;2022;696;2214;1317;4236
431740;201811;4828;12244;3286;9499;997;3221;632;1527;1629;4748
431750;201811;6907;18954;5854;17274;1125;3592;3003;8860;4128;12452
431755;201811;325;879;64;228;9;35;11;41;20;76
431760;201811;5415;12686;3509;9566;405;1357;2051;5167;2456;6524
431770;201811;1740;4386;1404;3902;130;394;1008;2747;1138;3141
431775;201811;206;546;95;296;21;76;17;41;38;117
431780;201811;1858;4894;1261;3750;246;783;444;1281;690;2064
431790;201811;912;2514;656;1993;147;450;261;759;408;1209
431795;201811;253;666;121;362;28;86;32;91;60;177
431800;201811;7090;19055;5076;15510;1572;5316;627;1958;2199;7274
431805;201811;288;664;88;282;7;23;33;95;40;118
431810;201811;3249;7987;2062;5743;394;1237;829;2133;1223;3370
431820;201811;2159;6252;1780;5583;461;1508;696;2219;1157;3727
431830;201811;8761;20331;6640;17216;1736;4978;2331;6047;4067;11025
431840;201811;2429;6812;2011;6080;397;1258;1134;3400;1531;4658
431842;201811;677;1702;224;701;31;107;68;194;99;301
431843;201811;313;865;244;720;32;99;114;318;146;417
431844;201811;225;589;69;229;17;63;20;58;37;121
431845;201811;508;1363;357;1047;25;82;219;633;244;715
431846;201811;254;732;227;692;23;72;183;551;206;623
431848;201811;157;399;81;246;9;30;12;24;21;54
431849;201811;415;992;59;173;8;17;6;12;14;29
431850;201811;3995;11206;3148;9453;781;2530;904;2626;1685;5156
431860;201811;676;1738;416;1196;92;275;202;547;294;822
431861;201811;115;300;51;157;4;15;20;55;24;70
431862;201811;426;1368;346;1220;81;305;172;595;253;900
431870;201811;17019;46541;13857;41013;2356;7908;7183;20327;9539;28235
431880;201811;3904;10437;2839;8512;536;1829;1194;3400;1730;5229
431890;201811;4064;10804;2568;7783;806;2660;335;1079;1141;3739
431900;201811;1012;2679;623;1893;116;404;299;845;415;1249
431910;201811;796;1973;289;849;48;144;80;196;128;340
431912;201811;442;1287;356;1112;82;260;196;610;278;870
431915;201811;964;2609;781;2286;64;207;545;1553;609;1760
431920;201811;1160;2966;983;2695;54;165;825;2223;879;2388
431930;201811;752;2221;550;1841;143;433;274;974;417;1407
431935;201811;75;218;47;157;11;35;10;31;21;66
431936;201811;289;877;165;566;37;131;43;141;80;272
431937;201811;186;470;114;319;28;89;41;94;69;183
431940;201811;2549;6337;1530;4389;248;834;673;1808;921;2642
431950;201811;1705;4762;1430;4299;373;1147;617;1866;990;3013
431960;201811;2683;6995;2057;5805;564;1636;558;1564;1122;3200
431970;201811;376;990;158;510;37;115;32;91;69;206
431971;201811;64;166;35;112;4;13;6;15;10;28
431973;201811;461;1504;373;1323;43;145;258;935;301;1080
431975;201811;104;223;22;73;5;17;3;6;8;23
431980;201811;1073;2927;827;2486;188;614;353;1012;541;1626
431990;201811;5727;14450;3731;11332;625;2104;1418;4147;2043;6251
432000;201811;10198;26093;7576;21781;2013;6045;3140;9009;5153;15054
432010;201811;1917;5099;1469;4270;227;718;811;2248;1038;2966
432020;201811;1805;4517;1260;3560;307;929;546;1437;853;2366
432023;201811;502;1246;261;755;47;157;120;306;167;463
432026;201811;1006;2940;739;2384;176;570;309;985;485;1555
432030;201811;338;906;201;619;37;120;107;320;144;440
432032;201811;402;1069;271;806;27;92;144;393;171;485
432035;201811;721;2122;641;1986;223;717;227;707;450;1424
432040;201811;1093;2570;386;1236;74;264;109;310;183;574
432045;201811;205;576;112;379;28;95;28;99;56;194
432050;201811;512;1364;387;1129;101;282;134;398;235;680
432055;201811;696;1888;446;1385;141;477;132;371;273;848
432057;201811;259;669;197;534;46;106;80;204;126;310
432060;201811;436;1059;136;440;27;107;51;136;78;243
432065;201811;229;654;161;498;35;107;57;171;92;278
432067;201811;746;2222;617;1914;84;287;387;1148;471;1435
432070;201811;1841;4981;1139;3521;243;810;276;747;519;1557
432080;201811;3800;9860;2999;8500;746;2393;1187;3197;1933;5590
432085;201811;393;1026;255;805;93;280;83;283;176;563
432090;201811;1297;3514;939;2823;211;678;404;1152;615;1830
432100;201811;1013;2756;449;1477;89;321;45;104;134;425
432110;201811;2139;6019;1428;4632;347;1300;96;323;443;1623
432120;201811;2822;8151;2305;7200;682;2312;567;1702;1249;4014
432130;201811;2522;6736;2123;6167;748;2301;772;2243;1520;4544
432132;201811;238;645;122;402;24;84;41;119;65;203
432135;201811;908;2325;610;1739;55;184;424;1174;479;1358
432140;201811;1555;4851;1170;4064;208;747;602;2114;810;2861
432143;201811;1322;3643;1046;3198;102;355;647;1955;749;2310
432145;201811;1311;3647;756;2390;120;411;173;473;293;884
432146;201811;110;322;72;239;23;84;16;46;39;130
432147;201811;446;1380;296;1035;81;292;60;203;141;495
432149;201811;371;999;219;654;28;86;101;290;129;376
432150;201811;2893;7895;2131;6445;527;1787;632;1844;1159;3631
432160;201811;4637;13236;3600;11468;1031;3499;1115;3477;2146;6976
432162;201811;288;651;36;106;7;17;5;16;12;33
432163;201811;161;446;32;104;2;6;2;6;4;12
432166;201811;515;1526;399;1270;76;253;130;372;206;625
432170;201811;1304;3703;837;2758;185;665;226;689;411;1354
432180;201811;2552;6545;1357;4121;263;864;393;1067;656;1931
432183;201811;355;1056;225;732;60;223;59;173;119;396
432185;201811;808;2161;477;1489;34;123;264;779;298;902
432190;201811;2020;5225;1287;3828;300;1005;472;1277;772;2282
432195;201811;964;2435;598;1777;170;478;222;679;392;1157
432200;201811;3014;8359;2188;6859;440;1417;1023;3275;1463;4692
432210;201811;360;994;237;762;47;176;102;303;149;479
432215;201811;654;1954;578;1836;66;200;402;1302;468;1502
432218;201811;252;640;127;358;18;52;55;140;73;192
432220;201811;3767;9255;2811;7654;399;1236;1674;4350;2073;5586
432225;201811;93;275;68;219;18;56;31;101;49;157
432230;201811;714;1786;380;1120;62;193;161;431;223;624
432232;201811;495;1259;328;958;70;216;122;351;192;567
432234;201811;301;790;128;389;33;97;19;46;52;143
432235;201811;93;256;32;101;8;24;8;28;16;52
432237;201811;361;925;312;839;17;43;231;590;248;633
432240;201811;13594;37492;10574;33058;989;3510;6484;21032;7473;24542
432250;201811;4120;13307;3562;12187;1124;3971;1230;4309;2354;8280
432252;201811;433;1134;275;799;47;148;114;309;161;457
432253;201811;1077;3358;598;2085;139;525;33;98;172;623
432254;201811;878;2187;169;540;30;107;15;41;45;148
432255;201811;137;356;67;208;8;28;27;73;35;101
432260;201811;5087;13310;3713;10754;1023;3050;1067;3089;2090;6139
432270;201811;1931;5703;1577;4960;493;1655;257;787;750;2442
432280;201811;1128;2960;610;1884;109;367;223;617;332;984
432285;201811;191;596;17;59;0;0;2;5;2;5
432290;201811;362;1063;195;660;60;202;42;119;102;321
432300;201811;25101;67416;19617;58109;3048;10014;11430;32695;14478;42709
432310;201811;729;2055;541;1709;70;228;340;1063;410;1291
432320;201811;224;538;70;206;9;36;25;64;34;100
432330;201811;233;594;86;276;21;67;17;49;38;116
432335;201811;174;502;55;210;6;22;13;56;19;78
432340;201811;306;734;127;394;20;72;35;86;55;158
432345;201811;575;1440;524;1372;31;104;412;1051;443;1155
432350;201811;324;882;160;535;28;95;51;162;79;257
432360;201811;211;623;37;120;4;17;9;28;13;45
432370;201811;311;808;208;613;17;47;123;356;140;403
432375;201811;508;1308;392;1094;63;156;214;597;277;753
432377;201811;227;722;35;123;6;19;4;7;10;26
432380;201811;1498;4308;939;3129;184;697;424;1323;608;2020
500020;201811;2180;5932;1554;4829;328;1104;723;2200;1051;3304
500025;201811;1233;2832;766;2035;73;201;454;1181;527;1382
500060;201811;6230;18131;4732;15468;709;2386;2755;9417;3464;11803
500070;201811;3803;10339;2780;8570;583;1838;1207;3881;1790;5719
500080;201811;1197;3263;856;2649;178;630;377;1076;555;1706
500085;201811;1980;4950;1344;3958;293;927;648;1839;941;2766
500090;201811;1853;5145;1281;4078;230;757;508;1660;738;2417
500100;201811;3401;8931;2594;7576;350;1121;1359;3791;1709;4912
500110;201811;6877;19102;4622;15355;1021;3653;1417;5385;2438;9038
500124;201811;1963;6116;1620;5493;334;1128;860;3086;1194;4214
500150;201811;1181;2784;737;2074;184;547;238;622;422;1169
500190;201811;4316;10555;3136;8946;761;2264;1266;3747;2027;6011
500200;201811;2128;5170;1594;4280;204;589;944;2384;1148;2973
500210;201811;4446;12113;3391;10535;911;2901;1416;4444;2327;7345
500215;201811;1370;3928;946;3101;99;370;480;1538;579;1908
500220;201811;2648;7618;1900;6266;338;1218;729;2364;1067;3582
500230;201811;2092;5128;1555;4317;214;606;956;2597;1170;3203
500240;201811;3418;10755;2385;8498;424;1716;665;2441;1089;4157
500260;201811;3090;6817;1860;5036;243;641;942;2477;1185;3118
500270;201811;128842;313802;74488;216423;14727;46344;23470;64443;38197;110787
500280;201811;1238;3241;884;2670;116;385;524;1532;640;1917
500290;201811;3640;8488;1996;5895;357;1159;694;1919;1051;3078
500295;201811;2910;7396;1697;5057;299;983;626;1626;925;2609
500310;201811;877;2038;626;1705;115;288;326;922;441;1210
500315;201811;3274;9765;2688;8782;312;1027;1784;6028;2096;7055
500320;201811;17394;51124;12493;42394;3355;12129;3876;13922;7231;26051
500325;201811;4069;9580;2750;7603;320;949;1554;4301;1874;5250
500330;201811;6660;15777;4265;11958;546;1756;2168;6130;2714;7886
500345;201811;1964;4869;1282;3797;334;1018;431;1246;765;2264
500348;201811;2568;6633;1977;5656;254;767;1158;3345;1412;4112
500350;201811;1281;3556;659;2154;78;272;255;839;333;1111
500370;201811;21930;59755;15086;47859;2545;9077;6912;21839;9457;30916
500375;201811;2349;6473;1644;4984;346;1171;532;1540;878;2711
500380;201811;3507;8837;2419;7066;672;2060;824;2432;1496;4492
500390;201811;504;1091;295;808;36;98;157;433;193;531
500400;201811;1124;3118;758;2328;166;567;241;685;407;1252
500410;201811;2330;6146;1723;5174;239;723;978;3000;1217;3723
500430;201811;2514;6546;1694;5254;283;1000;644;2098;927;3098
500440;201811;1190;2878;716;2079;116;340;263;808;379;1148
500450;201811;1328;3436;730;2275;141;462;130;376;271;838
500460;201811;3480;9733;2172;7150;459;1664;559;1869;1018;3533
500470;201811;2393;6690;1503;4804;472;1640;288;800;760;2440
500480;201811;2155;6444;1860;6006;168;559;1284;4332;1452;4891
500490;201811;926;2280;544;1687;149;534;161;483;310;1017
500500;201811;4103;11415;2758;9217;912;3485;593;2015;1505;5500
500510;201811;704;1791;437;1295;27;90;259;737;286;827
500515;201811;1918;4832;1504;4202;135;378;1030;2890;1165;3268
500520;201811;3058;10265;2481;9098;695;2724;967;3556;1662;6280
500525;201811;900;2748;739;2484;88;334;433;1473;521;1807
500540;201811;4396;11699;2583;8362;735;2797;214;614;949;3411
500560;201811;5088;15119;4235;13897;373;1341;3120;10334;3493;11675
500568;201811;4176;9453;2535;7018;640;1975;768;2096;1408;4071
500570;201811;7287;17726;4141;12087;945;3007;1024;2757;1969;5764
500580;201811;3087;8504;2376;7264;492;1583;1173;3551;1665;5134
500600;201811;3138;7982;2112;6341;398;1266;860;2599;1258;3865
500620;201811;7293;20084;4940;15428;1038;3406;1914;5889;2952;9295
500625;201811;482;1367;264;862;48;178;106;323;154;501
500627;201811;730;1905;449;1369;69;215;136;412;205;627
500630;201811;5808;14437;3534;10543;819;2630;1049;3176;1868;5806
500635;201811;2638;8883;2102;8105;150;643;1527;6245;1677;6888
500640;201811;1698;3923;1093;3012;45;157;772;2025;817;2182
500660;201811;16249;46095;11596;38449;4043;14839;2511;8464;6554;23303
500690;201811;2217;6330;1550;5224;624;2360;92;231;716;2591
500710;201811;2898;8268;2200;6956;629;2103;575;1747;1204;3850
500720;201811;4833;12722;3029;9598;762;2672;728;2315;1490;4987
500730;201811;905;2432;593;1831;98;286;232;730;330;1016
500740;201811;4531;11150;3238;8982;344;1057;1818;5047;2162;6104
500750;201811;976;2576;688;2047;101;314;265;714;366;1028
500755;201811;871;2437;517;1730;111;389;82;242;193;631
500769;201811;4853;12390;2522;7700;484;1639;376;855;860;2494
500770;201811;1533;4268;949;3148;160;569;307;1028;467;1597
500780;201811;1226;3167;807;2401;184;575;207;572;391;1147
500790;201811;7882;21039;6323;18517;1215;3899;3377;9848;4592;13747
500793;201811;1842;4925;1277;3949;404;1290;269;734;673;2024
500795;201811;2474;6600;2025;5997;143;403;1645;5053;1788;5456
500797;201811;731;1948;476;1456;116;375;167;488;283;863
500800;201811;2774;6763;1838;5356;625;2051;275;871;900;2922
500830;201811;17349;44311;11847;34221;1880;5903;5533;15197;7413;21100
500840;201811;1317;3363;775;2319;96;304;302;851;398;1155
510010;201811;1781;4325;1198;3502;182;522;695;2064;877;2586
510020;201811;3606;9446;1903;5915;434;1407;353;972;787;2379
510025;201811;6659;17699;4143;13029;744;2591;1360;4019;2104;6610
510030;201811;2140;4952;1411;3907;358;998;496;1439;854;2437
510035;201811;1199;3098;722;2332;106;335;409;1415;515;1750
510040;201811;2167;5100;1563;4255;140;396;995;2693;1135;3089
510050;201811;1914;4591;1290;3618;224;720;767;2007;991;2727
510060;201811;1358;3513;1012;2979;179;567;431;1215;610;1782
510080;201811;1195;3351;798;2620;239;839;209;596;448;1435
510100;201811;645;1584;416;1177;54;171;211;563;265;734
510120;201811;262;493;143;350;9;29;103;247;112;276
510125;201811;2237;5631;1707;4821;239;873;750;1917;989;2790
510130;201811;1437;3785;1044;3126;246;801;298;884;544;1685
510140;201811;2861;7948;2009;6813;739;2870;664;2045;1403;4915
510160;201811;1553;4309;1204;3839;208;660;809;2592;1017;3252
510170;201811;4551;12673;3386;10703;823;2736;1400;4411;2223;7147
510180;201811;13160;31893;8024;23457;2012;6348;2243;7389;4255;13737
510185;201811;1749;4621;1153;3753;418;1374;365;1450;783;2824
510190;201811;2133;6051;1449;4919;464;1705;358;1266;822;2971
510250;201811;14061;38255;11610;34780;2445;7659;6325;19556;8770;27215
510260;201811;2093;8591;1689;7804;268;1274;976;5028;1244;6302
510263;201811;3054;8714;1902;6353;378;1342;247;757;625;2099
510267;201811;4726;13790;2912;9697;633;2204;512;1722;1145;3926
510268;201811;1430;3680;958;2810;147;441;478;1345;625;1786
510269;201811;1072;3048;677;2263;169;625;224;697;393;1322
510270;201811;2789;8518;2051;7133;382;1416;775;2659;1157;4075
510279;201811;1739;4841;1226;3887;230;810;597;1796;827;2606
510285;201811;1104;3054;773;2477;226;794;184;555;410;1349
510300;201811;3522;9218;2646;8003;360;1026;1613;5143;1973;6169
510305;201811;1488;4292;936;3194;192;707;258;968;450;1675
510310;201811;933;2457;665;1990;215;678;202;622;417;1300
510320;201811;3685;9717;2672;7922;646;2076;722;2128;1368;4204
510325;201811;4595;13874;3597;12235;1040;3641;1419;5022;2459;8663
510330;201811;2935;8979;1997;7249;412;1540;699;2843;1111;4383
510335;201811;4768;13770;3539;11988;474;1746;2009;7134;2483;8880
510336;201811;488;1427;347;1176;67;216;162;583;229;799
510337;201811;1629;4942;1099;3951;437;1700;158;576;595;2276
510340;201811;84733;196971;51176;145396;14979;49297;11968;31458;26947;80755
510343;201811;996;2861;683;2233;141;504;231;710;372;1214
510345;201811;1282;3781;952;3123;185;603;388;1217;573;1820
510350;201811;2879;7745;1878;6044;454;1507;728;2351;1182;3858
510360;201811;1822;4037;1169;3228;63;197;860;2431;923;2628
510370;201811;1642;5046;1207;4234;213;825;631;2251;844;3076
510380;201811;506;1327;270;866;71;262;57;169;128;431
510385;201811;1059;3778;773;3166;78;359;470;2032;548;2391
510390;201811;1056;3249;817;2898;221;786;368;1436;589;2222
510395;201811;745;1705;490;1322;38;109;273;789;311;898
510410;201811;4260;12553;3238;10643;768;2586;1606;5478;2374;8064
510420;201811;2083;4794;1489;3943;176;509;858;2276;1034;2785
510450;201811;529;1351;309;935;83;251;44;139;127;390
510452;201811;661;1895;439;1454;83;277;202;665;285;942
510454;201811;778;2289;584;1941;55;172;358;1260;413;1432
510455;201811;893;2635;634;2045;98;372;233;680;331;1052
510460;201811;1927;4879;1378;4059;148;509;828;2322;976;2831
510480;201811;4553;11431;2947;8313;588;1802;1158;3109;1746;4911
510490;201811;1631;4662;1229;4088;273;940;593;2001;866;2941
510500;201811;1546;4095;917;2949;176;618;329;1040;505;1658
510510;201811;3225;10035;2460;8502;765;2880;596;2187;1361;5067
510515;201811;5556;15137;3569;11218;781;2727;941;2665;1722;5392
510517;201811;1172;3440;902;2959;236;864;182;550;418;1414
510520;201811;2040;4279;1214;3266;73;214;687;1954;760;2168
510523;201811;981;2613;740;2211;147;422;418;1255;565;1677
510525;201811;5744;16509;4290;13514;750;2592;1820;5280;2570;7872
510530;201811;550;1405;402;1186;28;113;275;776;303;889
510550;201811;2649;8066;1909;6684;483;1748;700;2490;1183;4238
510558;201811;1994;5539;1569;4928;171;603;831;2778;1002;3381
510560;201811;1600;4719;913;3360;215;871;228;895;443;1766
510562;201811;5069;13861;3640;11159;885;2915;1321;4108;2206;7023
510590;201811;3010;7782;2175;6694;346;1081;1334;4207;1680;5288
510600;201811;1550;3683;962;2751;200;567;384;1117;584;1684
510610;201811;2683;6795;1880;5658;192;665;1135;3382;1327;4047
510615;201811;1992;5642;1479;4714;276;882;813;2661;1089;3543
510617;201811;936;2730;686;2316;99;347;411;1461;510;1808
510618;201811;1278;3527;891;2811;179;640;451;1363;630;2003
510619;201811;732;1922;408;1310;70;263;84;242;154;505
510620;201811;1438;3318;678;2118;155;563;70;173;225;736
510621;201811;1315;3710;853;2815;185;653;247;795;432;1448
510622;201811;3961;11663;2794;8982;1010;3539;436;1255;1446;4794
510623;201811;2736;7238;1954;5917;433;1566;554;1584;987;3150
510624;201811;1588;4275;706;2424;88;329;131;376;219;705
510625;201811;2416;6074;1380;4192;306;1063;277;817;583;1880
510626;201811;1616;3854;949;2840;269;913;209;633;478;1546
510627;201811;662;1709;369;1115;90;278;75;240;165;518
510628;201811;1581;3609;1036;2888;170;447;614;1815;784;2262
510629;201811;1540;4674;1169;3927;280;1011;374;1282;654;2293
510630;201811;3199;9379;1873;6674;421;1634;289;1102;710;2736
510631;201811;514;1303;371;1096;21;59;267;794;288;853
510637;201811;3234;8260;2367;6837;719;2304;622;1699;1341;4003
510642;201811;4976;15133;3997;13618;1087;3988;1594;5637;2681;9625
510645;201811;855;1902;502;1417;134;381;166;453;300;834
510650;201811;6736;18799;5538;17472;743;2208;3988;13333;4731;15541
510665;201811;1795;4243;1030;2913;184;559;397;1162;581;1721
510670;201811;404;860;220;590;29;89;117;313;146;402
510675;201811;5782;16790;4194;13738;1226;4384;696;2207;1922;6591
510677;201811;2135;5668;1493;4676;222;748;765;2373;987;3121
510680;201811;634;1755;392;1276;98;333;54;166;152;499
510682;201811;1584;4996;1179;4242;365;1414;244;881;609;2295
510685;201811;687;2018;508;1647;76;246;233;732;309;978
510700;201811;3589;9378;2528;7763;438;1436;1496;4630;1934;6066
510704;201811;9710;24229;6355;18229;1272;3979;1867;5169;3139;9148
510706;201811;1819;5594;1293;4719;236;936;670;2599;906;3535
510710;201811;2508;6730;1716;5154;362;1150;594;1676;956;2826
510715;201811;681;1584;477;1267;56;150;211;581;267;731
510718;201811;2549;5631;1374;4204;598;1857;235;988;833;2845
510719;201811;397;863;237;648;37;108;128;337;165;445
510720;201811;982;2433;646;1896;160;512;202;546;362;1058
510724;201811;681;1886;468;1509;88;312;218;665;306;977
510726;201811;1159;2123;590;1401;74;182;308;726;382;908
510729;201811;649;1570;300;914;44;153;68;202;112;355
510730;201811;2974;7500;2011;5946;436;1399;779;2251;1215;3650
510735;201811;1017;3066;762;2688;82;326;525;1861;607;2187
510740;201811;975;2486;635;1861;86;238;329;1016;415;1254
510757;201811;592;1923;482;1726;187;719;140;475;327;1194
510760;201811;38738;87194;22428;62268;6486;20100;5057;12810;11543;32910
510770;201811;4137;9765;2993;8337;330;873;1983;5755;2313;6628
510774;201811;351;981;237;742;44;142;116;385;160;527
510775;201811;595;1674;410;1361;99;368;82;255;181;623
510776;201811;468;1276;325;977;85;260;102;311;187;571
510777;201811;1630;4488;1190;3883;160;641;764;2421;924;3062
510779;201811;580;1656;461;1452;64;178;270;892;334;1070
510780;201811;3640;9935;2724;8528;685;2180;1063;3669;1748;5849
510785;201811;2064;5531;1186;3892;290;1041;169;602;459;1643
510787;201811;2431;6970;1671;5418;689;2341;106;314;795;2655
510788;201811;703;1682;477;1334;83;225;178;601;261;826
510790;201811;14642;39910;8975;28714;2089;7597;1333;3647;3422;11244
510792;201811;8476;23163;5377;17301;1089;3821;1213;3722;2302;7543
510794;201811;1218;3427;797;2629;255;945;157;440;412;1385
510795;201811;7206;20261;4978;16095;1256;4454;1180;3819;2436;8273
510800;201811;1628;4238;1093;3360;298;940;262;752;560;1692
510805;201811;1674;4631;1092;3516;228;770;358;1016;586;1786
510810;201811;658;1425;433;1115;112;307;204;506;316;813
510820;201811;805;1574;433;1097;47;149;197;497;244;646
510830;201811;798;2006;558;1666;83;245;332;1036;415;1281
510835;201811;553;1454;373;1162;57;199;182;550;239;749
510840;201811;46354;105716;33188;89001;6541;17177;17065;49273;23606;66450
510850;201811;1804;4506;1021;3199;297;1036;123;302;420;1338
510860;201811;2612;7248;1669;5571;529;2055;167;530;696;2585
510880;201811;652;1933;496;1633;128;440;208;707;336;1147
510885;201811;587;1509;407;1237;76;255;136;406;212;661
510890;201811;675;2034;526;1796;118;438;248;848;366;1286
510895;201811;1202;3210;802;2500;203;723;288;801;491;1524
520005;201811;2036;5626;1637;5122;422;1211;775;2778;1197;3989
520010;201811;2251;6777;1588;5332;427;1583;366;1067;793;2650
520013;201811;2620;7157;1870;5671;453;1437;469;1514;922;2951
520015;201811;540;1407;410;1226;107;332;123;398;230;730
520017;201811;1089;2972;828;2552;134;442;474;1426;608;1868
520020;201811;366;916;290;808;62;199;159;416;221;615
520025;201811;32581;92995;28590;87467;3525;11232;19883;60730;23408;71962
520030;201811;5019;13830;4053;12333;509;1680;2507;7557;3016;9237
520050;201811;431;1016;269;725;22;50;150;424;172;474
520055;201811;1175;3129;857;2509;63;188;492;1405;555;1593
520060;201811;1414;4157;1098;3559;275;975;270;858;545;1833
520080;201811;1833;4869;1404;4273;254;755;646;2157;900;2912
520082;201811;1008;2536;830;2229;111;257;444;1264;555;1521
520085;201811;714;2031;559;1771;122;384;198;587;320;971
520090;201811;815;1735;589;1475;99;210;388;1024;487;1234
520110;201811;38149;106595;27129;88298;8928;32606;1821;5304;10749;37910
520120;201811;191;484;108;338;13;50;35;110;48;160
520130;201811;3701;9583;3029;8488;596;1765;1388;3918;1984;5683
520140;201811;36475;104682;27213;88158;9923;34896;2852;9425;12775;44321
520145;201811;508;1257;353;1011;73;219;141;366;214;585
520150;201811;558;1383;433;1215;82;233;232;661;314;894
520160;201811;815;1953;590;1608;96;264;286;778;382;1042
520170;201811;5059;10566;3599;8852;230;602;2830;6867;3060;7469
520180;201811;1937;5549;1596;4991;404;1334;653;2017;1057;3351
520215;201811;1932;4717;1394;3863;310;923;571;1504;881;2427
520235;201811;607;1474;388;1127;52;159;141;394;193;553
520250;201811;1462;3883;1067;3270;308;1048;200;630;508;1678
520260;201811;844;2014;512;1427;105;322;186;513;291;835
520280;201811;632;1686;501;1443;142;414;181;554;323;968
520310;201811;1227;2815;818;2187;202;579;307;851;509;1430
520320;201811;1744;4936;1372;4312;141;471;742;2341;883;2812
520330;201811;3450;9930;2497;8258;478;1817;1029;3333;1507;5150
520340;201811;2189;5121;1478;4094;167;414;936;2694;1103;3108
520350;201811;2853;7275;2083;5989;699;2113;628;1746;1327;3859
520355;201811;1798;5040;1359;4197;326;1108;498;1445;824;2553
520357;201811;796;2013;616;1722;31;87;448;1269;479;1356
520360;201811;701;1890;533;1596;158;477;142;460;300;937
520380;201811;1315;3392;781;2330;84;297;401;1107;485;1404
520390;201811;942;2133;542;1610;175;555;135;424;310;979
520393;201811;540;1303;373;1031;45;145;181;456;226;601
520396;201811;808;2227;671;1975;88;272;402;1150;490;1422
520400;201811;1533;4020;1234;3602;213;658;768;2238;981;2896
520410;201811;1658;3655;1013;2736;118;324;577;1544;695;1868
520420;201811;386;945;289;752;29;89;205;498;234;587
520425;201811;1405;3440;924;2633;239;692;325;940;564;1632
520430;201811;2187;5222;1163;3534;201;726;46;119;247;845
520440;201811;3178;7824;1988;5708;504;1537;508;1403;1012;2940
520450;201811;11059;27816;7316;21655;2420;7757;748;2273;3168;10030
520455;201811;650;1834;473;1550;129;444;131;426;260;870
520460;201811;922;2449;780;2245;105;269;582;1729;687;1998
520465;201811;825;2185;663;1936;116;365;406;1130;522;1495
520470;201811;1916;5518;1619;5117;392;1247;836;2811;1228;4058
520480;201811;838;2412;563;1900;158;571;118;413;276;984
520485;201811;1560;4416;1289;4035;224;715;805;2498;1029;3213
520490;201811;3810;10975;3007;9730;897;2905;1302;4387;2199;7292
520495;201811;1473;3413;1152;2978;63;174;888;2319;951;2493
520500;201811;1418;3820;990;3023;222;757;348;1042;570;1799
520505;201811;726;1760;518;1471;98;287;269;743;367;1030
520510;201811;6912;18270;4844;15093;1144;3958;1258;4132;2402;8090
520520;201811;1121;2931;838;2481;215;637;262;817;477;1454
520530;201811;1969;6028;1470;5131;524;1878;367;1447;891;3325
520540;201811;2922;7818;1781;5490;384;1243;388;1179;772;2422
520545;201811;924;2556;711;2201;139;428;252;788;391;1216
520547;201811;737;2124;576;1813;163;521;237;741;400;1262
520549;201811;11552;32936;9504;29573;1998;6469;5153;16016;7151;22485
520551;201811;4251;12027;3622;11096;479;1733;2441;7277;2920;9010
520552;201811;827;2254;725;2121;123;332;497;1527;620;1859
520570;201811;619;1479;403;1154;108;295;132;402;240;697
520580;201811;2754;6226;1939;5200;182;522;1270;3400;1452;3922
520590;201811;1264;3448;893;2762;242;756;142;433;384;1189
520620;201811;8197;22696;6558;20264;1678;5283;2972;9371;4650;14654
520630;201811;920;2326;558;1698;101;306;135;397;236;703
520640;201811;2530;6380;1919;5324;490;1376;725;2074;1215;3450
520650;201811;921;2260;630;1781;116;325;304;895;420;1220
520660;201811;538;1301;253;776;49;157;52;170;101;327
520670;201811;955;2703;798;2474;82;268;520;1546;602;1814
520680;201811;715;1808;532;1521;117;320;236;692;353;1012
520690;201811;383;895;250;703;81;216;74;223;155;439
520710;201811;517;1268;343;964;13;39;221;602;234;641
520725;201811;1614;3918;1135;3124;139;428;712;1885;851;2313
520735;201811;765;1944;516;1506;99;275;176;539;275;814
520740;201811;1903;4612;1497;4087;266;709;860;2440;1126;3149
520750;201811;659;1662;475;1371;90;242;228;684;318;926
520753;201811;1416;3765;1100;3158;197;583;456;1236;653;1819
520760;201811;1178;2593;1058;2439;80;150;880;2111;960;2261
520780;201811;1565;3847;1180;3296;123;354;619;1694;742;2048
520790;201811;3437;8194;2390;6569;241;665;1411;4110;1652;4775
520800;201811;15025;40120;12128;36099;2418;7289;6937;21501;9355;28790
520810;201811;1321;2826;947;2393;194;532;500;1297;694;1829
520815;201811;608;1839;445;1509;113;401;87;322;200;723
520830;201811;1789;4035;1281;3437;66;153;1015;2700;1081;2853
520840;201811;2300;6419;1875;5839;786;2562;508;1700;1294;4262
520850;201811;656;1796;457;1482;167;618;90;291;257;909
520860;201811;6188;17406;4764;15120;1173;4042;1726;5477;2899;9519
520870;201811;89300;217884;62104;176682;16840;51911;18335;50892;35175;102803
520880;201811;6056;17651;4818;15522;1410;4841;1397;4439;2807;9280
520890;201811;3807;9687;2672;7838;592;1897;1121;3228;1713;5125
520910;201811;4256;11038;2724;8296;740;2486;493;1505;1233;3991
520915;201811;608;1732;420;1330;76;274;152;452;228;726
520920;201811;4409;10519;2984;8533;443;1325;1515;4374;1958;5699
520929;201811;734;1801;513;1423;108;277;224;672;332;949
520940;201811;1066;2873;840;2551;54;178;632;1898;686;2076
520945;201811;502;1160;394;984;29;73;271;663;300;736
520960;201811;1034;2699;817;2332;114;351;489;1337;603;1688
520970;201811;2445;7126;2004;6327;577;1979;472;1535;1049;3514
520980;201811;780;2007;602;1738;133;410;238;654;371;1064
520990;201811;2898;8465;2481;7845;300;985;1627;5183;1927;6168
520993;201811;1020;2487;694;1941;38;118;484;1321;522;1439
520995;201811;2226;5816;1739;5142;395;1181;702;2111;1097;3292
521000;201811;7804;21480;5626;17477;1381;4486;1572;4847;2953;9333
521010;201811;3762;9942;2818;8313;351;1015;1530;4508;1881;5523
521015;201811;687;1753;532;1510;60;181;344;948;404;1129
521020;201811;2919;7788;1774;5503;518;1708;161;514;679;2222
521030;201811;527;1215;374;991;52;104;190;554;242;658
521040;201811;7531;18566;5623;15587;1448;4225;2133;6025;3581;10250
521056;201811;858;2357;666;2051;196;623;195;643;391;1266
521060;201811;1051;2709;776;2249;70;218;390;1145;460;1363
521080;201811;1074;2445;549;1557;73;219;189;451;262;670
521090;201811;3344;8846;2307;6948;635;2040;305;954;940;2994
521100;201811;1760;4135;1282;3471;250;657;683;1884;933;2541
521120;201811;4846;11439;3378;9580;311;825;1608;5199;1919;6024
521130;201811;957;2337;641;1758;36;127;366;1001;402;1128
521140;201811;1240;3303;917;2739;153;490;365;1088;518;1578
521150;201811;11797;26927;7629;21029;1662;5157;3149;8813;4811;13970
521160;201811;669;1477;451;1137;64;161;251;597;315;758
521170;201811;1087;2582;771;2093;83;226;495;1301;578;1527
521180;201811;6605;19579;5537;17581;1080;3702;2413;7402;3493;11104
521190;201811;10265;26911;5909;18985;1485;5077;1111;3715;2596;8792
521200;201811;732;1847;505;1458;61;176;274;777;335;953
521205;201811;617;1602;463;1347;26;70;335;954;361;1024
521210;201811;728;1916;401;1234;94;315;50;110;144;425
521220;201811;3987;9880;2642;7716;575;1810;761;2079;1336;3889
521225;201811;347;787;271;700;41;102;167;439;208;541
521230;201811;1384;4174;1279;4022;447;1310;683;2325;1130;3635
521250;201811;30814;86439;24673;77510;9849;32227;7031;23498;16880;55725
521260;201811;596;1394;431;1125;61;168;254;650;315;818
521270;201811;1808;4671;1560;4369;108;271;1206;3404;1314;3675
521280;201811;1899;5284;1442;4466;412;1374;476;1484;888;2858
521290;201811;452;1160;332;997;59;198;171;494;230;692
521295;201811;1152;2536;907;2252;83;184;694;1816;777;2000
521300;201811;1895;4865;1529;4355;302;807;902;2660;1204;3467
521305;201811;708;1818;502;1475;68;192;274;803;342;995
521308;201811;4715;13034;3426;10485;519;1609;1800;5438;2319;7047
521310;201811;8264;21926;5476;16879;1346;4482;1749;5163;3095;9645
521340;201811;408;970;304;815;23;58;223;585;246;643
521350;201811;2055;5306;1595;4606;186;602;1060;2941;1246;3543
521370;201811;1188;3090;726;2287;181;634;140;452;321;1086
521375;201811;1415;3601;1006;3020;249;751;344;1106;593;1857
521377;201811;1479;3225;1100;2758;77;152;905;2333;982;2485
521380;201811;5723;15658;3889;12192;429;1474;959;3162;1388;4636
521385;201811;613;1532;487;1367;100;279;231;702;331;981
521390;201811;696;1782;509;1498;170;533;159;493;329;1026
521400;201811;2448;5675;1911;5048;191;531;1430;3859;1621;4390
521405;201811;1308;3388;990;2859;203;596;441;1254;644;1850
521410;201811;775;2093;616;1849;129;377;302;973;431;1350
521440;201811;1359;3590;996;2965;285;918;263;760;548;1678
521450;201811;3842;11816;2920;9921;721;2459;780;2817;1501;5276
521460;201811;5919;16142;4371;13336;1534;4916;946;2800;2480;7716
521470;201811;629;1768;379;1205;59;187;109;318;168;505
521480;201811;360;949;209;652;43;146;46;124;89;270
521483;201811;2456;6075;1758;4949;442;1331;598;1630;1040;2961
521486;201811;1674;4025;1290;3496;75;215;981;2626;1056;2841
521487;201811;453;1150;329;965;61;184;143;426;204;610
521490;201811;852;2364;630;1977;46;196;429;1298;475;1494
521500;201811;1676;4355;1213;3597;94;336;834;2391;928;2727
521520;201811;789;1817;534;1436;87;242;225;616;312;858
521523;201811;11272;37385;9812;34833;3398;12851;2391;8765;5789;21616
521525;201811;1045;2507;799;2141;92;260;548;1445;640;1705
521530;201811;2229;5835;1289;3898;265;849;318;1011;583;1860
521540;201811;861;2206;546;1663;91;331;224;683;315;1014
521550;201811;1221;3136;762;2272;167;535;227;716;394;1251
521560;201811;4024;11404;2882;9808;619;2436;1366;4851;1985;7287
521565;201811;614;1541;493;1369;98;253;279;762;377;1015
521570;201811;3824;10283;2510;7793;516;1789;336;1099;852;2888
521580;201811;513;1266;287;854;37;117;64;159;101;276
521590;201811;614;1583;476;1364;126;409;202;534;328;943
521600;201811;399;1139;244;779;47;135;51;166;98;301
521630;201811;1619;3713;971;2714;194;575;300;805;494;1380
521640;201811;1986;4760;1437;3967;330;960;505;1360;835;2320
521645;201811;564;1524;366;1154;86;260;98;314;184;574
521680;201811;1146;3574;917;3108;285;1018;100;367;385;1385
521690;201811;506;1360;432;1228;72;223;253;686;325;909
521710;201811;2985;7920;2028;6226;367;1225;437;1295;804;2520
521720;201811;1990;5115;1495;4296;212;650;813;2261;1025;2911
521730;201811;3706;11013;2892;9474;930;3384;513;1415;1443;4799
521740;201811;3819;10490;2993;9222;910;3008;950;3047;1860;6055
521760;201811;14154;41667;11530;37429;3466;12258;3734;12535;7200;24793
521770;201811;2865;7359;2035;5914;634;1966;441;1254;1075;3220
521800;201811;5732;16419;4631;14570;1322;4322;1524;5189;2846;9511
521805;201811;579;1369;409;1126;145;369;159;462;304;831
521810;201811;711;1656;477;1310;82;237;225;620;307;857
521830;201811;5182;14935;4244;13512;436;1591;2804;8745;3240;10336
521839;201811;638;1676;469;1357;90;269;197;535;287;804
521850;201811;5155;13326;3562;10630;739;2422;399;1079;1138;3501
521860;201811;1786;4696;1228;3729;206;695;403;1178;609;1873
521870;201811;675;1960;476;1578;108;367;133;415;241;782
521878;201811;654;1770;467;1412;78;272;202;547;280;819
521880;201811;18332;45218;12428;36110;3308;10063;3825;11458;7133;21521
521890;201811;3090;8580;2092;6554;520;1741;265;758;785;2499
521900;201811;1624;3914;983;2935;250;734;203;639;453;1373
521910;201811;1222;2755;815;2271;85;240;478;1383;563;1623
521920;201811;429;1240;315;1014;61;215;112;375;173;590
521925;201811;719;2013;534;1690;116;369;197;595;313;964
521930;201811;4464;11618;3245;9771;973;2898;1089;3568;2062;6466
521935;201811;841;2152;610;1731;82;243;341;914;423;1157
521940;201811;1276;2992;863;2427;203;649;337;894;540;1543
521945;201811;553;1576;447;1375;97;289;201;656;298;945
521950;201811;632;1543;492;1365;78;247;328;867;406;1114
521960;201811;707;1955;464;1453;67;224;212;637;279;861
521970;201811;2552;6615;2145;6129;128;345;1729;5052;1857;5397
521971;201811;761;1920;526;1543;141;439;131;371;272;810
521973;201811;1119;3055;909;2749;72;258;606;1786;678;2044
521975;201811;12199;32799;10314;30235;1824;5528;6241;18322;8065;23850
521980;201811;2566;6284;2007;5547;208;544;1458;4067;1666;4611
521990;201811;1128;3163;922;2829;131;405;459;1435;590;1840
522000;201811;3559;11586;2984;10835;254;785;2174;8442;2428;9227
522005;201811;352;876;263;752;55;142;118;350;173;492
522010;201811;3808;9696;2774;8018;795;2423;704;1966;1499;4389
522015;201811;951;2580;682;2140;158;522;247;767;405;1289
522020;201811;5187;12752;3479;9956;846;2532;1447;4213;2293;6745
522026;201811;659;1853;505;1587;90;295;211;665;301;960
522028;201811;513;1380;363;1067;98;283;120;334;218;617
522040;201811;2955;6741;2092;5605;275;798;1381;3627;1656;4425
522045;201811;16583;48718;12440;40696;3051;10567;2908;9253;5959;19820
522050;201811;1059;2895;723;2288;154;525;269;807;423;1332
522060;201811;2497;6992;2005;6240;278;932;1124;3599;1402;4531
522068;201811;1733;4796;1416;4400;183;532;980;3144;1163;3676
522070;201811;594;1590;491;1421;38;143;363;991;401;1134
522100;201811;595;1608;429;1337;67;221;222;685;289;906
522108;201811;900;2490;708;2183;48;216;559;1642;607;1858
522119;201811;1556;4080;1208;3611;196;610;626;1928;822;2538
522130;201811;392;994;284;848;59;189;145;449;204;638
522140;201811;16371;44569;11986;36770;3517;11454;2239;6621;5756;18075
522145;201811;847;2114;614;1766;155;407;292;902;447;1309
522150;201811;932;2302;702;1954;224;604;218;657;442;1261
522155;201811;898;2390;700;2051;152;439;311;914;463;1353
522157;201811;558;1470;480;1358;26;91;362;999;388;1090
522160;201811;5904;15806;3929;12085;1101;3679;297;1004;1398;4683
522170;201811;2550;6769;1847;5613;459;1437;741;2266;1200;3703
522180;201811;454;1156;294;870;66;198;32;111;98;309
522185;201811;16208;41834;12277;36611;5261;16890;2736;8929;7997;25819
522190;201811;741;1795;543;1496;104;284;211;600;315;884
522200;201811;1728;5168;1106;3775;198;709;96;301;294;1010
522205;201811;1592;3828;1217;3300;125;362;835;2252;960;2614
522220;201811;1312;3442;998;2963;164;471;512;1550;676;2021
522230;201811;1191;3177;995;2888;199;657;540;1527;739;2184
530010;201811;162163;470550;138614;431672;28547;98098;70769;215002;99316;313100
110001;201812;3511;10331;2494;8366;656;2356;945;3128;1601;5484
110002;201812;10700;29111;7730;23924;2287;7515;2449;7590;4736;15105
110003;201812;600;1796;430;1428;112;400;88;284;200;684
110004;201812;8913;25101;6174;19874;1586;5383;1587;5350;3173;10733
110005;201812;2296;6218;1431;4561;360;1230;416;1420;776;2650
110006;201812;1683;4767;1047;3447;242;876;160;515;402;1391
110007;201812;996;2886;766;2509;297;1011;216;787;513;1798
110008;201812;2864;8469;2180;7408;285;940;1511;5349;1796;6289
110009;201812;3865;11208;2523;8726;736;2633;829;2997;1565;5630
110010;201812;5991;20684;4762;18318;1202;4519;2183;9346;3385;13865
110011;201812;5962;16688;4289;13598;1509;4930;730;2422;2239;7352
110012;201812;12913;34140;8341;25899;2154;6949;1028;3394;3182;10343
110013;201812;4887;14872;3834;12733;1626;5546;550;2043;2176;7589
110014;201812;3493;9590;2451;7627;688;2183;925;2847;1613;5030
110015;201812;4668;12744;2625;8506;704;2483;395;1138;1099;3621
110018;201812;3162;8410;1915;6176;468;1690;481;1484;949;3174
110020;201812;68610;172177;47563;142251;10606;32850;19008;60928;29614;93778
110025;201812;4602;11731;3046;8952;711;2202;1363;3906;2074;6108
110026;201812;432;1243;329;1080;98;341;125;397;223;738
110028;201812;5565;15196;3623;11470;1007;3404;540;1683;1547;5087
110029;201812;1293;3197;750;2296;177;542;305;952;482;1494
110030;201812;11437;27984;7577;22359;1549;5310;2407;7328;3956;12638
110032;201812;2732;8161;1905;6404;659;2241;457;1589;1116;3830
110033;201812;3548;11604;2831;10201;1019;3757;674;2701;1693;6458
110034;201812;3199;7979;2177;6519;689;2222;875;2685;1564;4907
110037;201812;1532;4912;1225;4306;312;1107;558;1952;870;3059
110040;201812;2784;8166;2047;6776;622;2188;520;1656;1142;3844
110045;201812;4670;14058;3714;12338;1039;3753;1373;4569;2412;8322
110050;201812;1622;4825;1204;3992;508;1766;234;774;742;2540
110060;201812;734;2243;514;1775;200;736;55;185;255;921
110070;201812;1683;5419;1307;4554;433;1589;266;854;699;2443
110080;201812;5499;13526;4078;11822;560;1532;2743;8396;3303;9928
110090;201812;531;1487;368;1191;106;360;138;445;244;805
110092;201812;1091;3325;829;2833;139;486;439;1578;578;2064
110094;201812;2762;8393;2129;7239;755;2670;547;1987;1302;4657
110100;201812;1657;5162;1377;4554;333;1160;642;2112;975;3272
110110;201812;1618;4721;1139;3823;377;1326;238;848;615;2174
110120;201812;1198;3681;915;3100;255;899;259;862;514;1761
110130;201812;2421;6398;1516;4699;340;1155;524;1599;864;2754
110140;201812;1947;6160;1409;5018;384;1409;354;1301;738;2710
110143;201812;1265;3509;871;2724;304;951;197;629;501;1580
110145;201812;856;2374;561;1813;146;509;178;585;324;1094
110146;201812;427;1192;292;974;60;196;145;511;205;707
110147;201812;730;1939;461;1388;69;209;186;491;255;700
110148;201812;740;2191;444;1532;104;397;49;171;153;568
110149;201812;2774;8031;2019;6812;798;2708;471;1748;1269;4456
110150;201812;2197;5929;1533;4945;576;2034;440;1416;1016;3450
110155;201812;619;1921;479;1602;121;426;155;495;276;921
110160;201812;1459;4627;1080;3766;376;1319;228;830;604;2149
110170;201812;2124;5647;1325;4056;252;816;672;2000;924;2816
110175;201812;1399;4156;1043;3546;197;695;498;1767;695;2462
110180;201812;1243;3537;856;2738;189;610;372;1189;561;1799
120001;201812;3001;9641;2580;9038;425;1430;1678;6132;2103;7562
120005;201812;1848;7195;1673;6906;162;744;1290;5424;1452;6168
120010;201812;5090;15976;4358;14768;593;1951;2964;10333;3557;12284
120013;201812;2074;7819;1945;7636;499;1881;1125;4700;1624;6581
120017;201812;2068;7074;1866;6745;329;1242;1146;4315;1475;5557
120020;201812;13861;58019;12997;56208;1248;5895;9960;43685;11208;49580
120025;201812;2745;8320;2282;7722;443;1517;1487;5150;1930;6667
120030;201812;6358;25523;6071;25008;410;2174;4899;20216;5309;22390
120032;201812;1599;7402;1532;7243;91;571;1255;5860;1346;6431
120033;201812;3929;14912;3693;14494;145;776;3171;12385;3316;13161
120034;201812;2475;9335;2151;8711;123;713;1725;6863;1848;7576
120035;201812;3446;14441;3294;14148;316;1442;2630;11490;2946;12932
120038;201812;2592;8673;2266;8101;588;2209;1135;4094;1723;6303
120039;201812;1910;8590;1804;8382;163;998;1391;6432;1554;7430
120040;201812;39484;131432;35072;123912;5955;22105;21300;76227;27255;98332
120042;201812;3236;12537;2980;11993;180;950;2364;9460;2544;10410
120043;201812;1319;5566;1228;5395;59;353;1075;4706;1134;5059
120045;201812;5569;15647;4962;14963;150;595;4531;13532;4681;14127
120050;201812;8718;32577;8036;31474;543;2661;6501;25554;7044;28215
120060;201812;8809;35754;8194;34762;424;2457;7023;29729;7447;32186
120070;201812;2945;9827;2587;9325;280;1065;1811;6758;2091;7823
120080;201812;4159;14303;3750;13621;580;2257;2506;9214;3086;11471
130002;201812;3066;12451;2795;12070;123;648;2484;10754;2607;11402
130006;201812;2310;8938;1892;8181;165;811;1422;6107;1587;6918
130008;201812;2502;8981;2253;8595;75;392;1908;7260;1983;7652
130010;201812;3833;11234;3293;10609;63;223;3085;10007;3148;10230
130014;201812;2847;8927;2299;7975;421;1485;1419;5035;1840;6520
130020;201812;2605;10437;2378;10072;146;894;1884;7902;2030;8796
130030;201812;9331;31540;8558;30645;185;780;7843;28269;8028;29049
130040;201812;3620;11072;3066;10322;165;599;2466;8369;2631;8968
130050;201812;7327;27217;6166;25713;201;952;5564;23415;5765;24367
130060;201812;7072;29146;6155;27885;530;3072;4845;21761;5375;24833
130063;201812;5913;20123;5299;19415;131;622;4918;18044;5049;18666
130068;201812;3315;12938;2914;12189;213;1188;2217;9147;2430;10335
130070;201812;7437;21879;6284;20595;296;984;5376;17893;5672;18877
130080;201812;6635;25671;5938;24788;309;1826;4951;20760;5260;22586
130083;201812;2502;8814;2292;8551;184;808;1911;7076;2095;7884
130090;201812;3345;10704;3004;10248;55;250;2628;9151;2683;9401
130100;201812;7351;23033;6446;22061;80;217;6080;21272;6160;21489
130110;201812;8000;23371;6737;21806;803;2188;5270;17893;6073;20081
130115;201812;5312;17077;4656;16286;99;386;4128;14619;4227;15005
130120;201812;13958;51565;12801;50024;1272;5368;10358;40834;11630;46202
130130;201812;5016;16916;4021;15609;449;2001;3013;11657;3462;13658
130140;201812;6591;24505;6193;24050;230;1217;5516;21413;5746;22630
130150;201812;3568;13695;3357;13433;97;626;3049;12145;3146;12771
130160;201812;4806;17982;4217;17194;304;1442;3507;14469;3811;15911
130165;201812;3036;11973;2889;11757;105;566;2573;10455;2678;11021
130170;201812;11326;34391;9380;32043;657;2649;7820;26759;8477;29408
130180;201812;4372;13965;4130;13683;46;241;3985;13149;4031;13390
130185;201812;17301;43790;14220;40477;727;1426;12511;36950;13238;38376
130190;201812;18150;61218;15133;56689;1857;7092;10752;41413;12609;48505
130195;201812;2287;8594;1863;8032;68;383;1654;7109;1722;7492
130200;201812;2399;7179;2008;6642;120;467;1615;5350;1735;5817
130210;201812;1276;4876;1151;4727;91;557;932;3727;1023;4284
130220;201812;2073;7810;1890;7524;93;502;1587;6289;1680;6791
130230;201812;4128;18141;3709;17527;314;1879;3038;14354;3352;16233
130240;201812;10860;34715;9072;32241;234;1324;7958;28184;8192;29508
130250;201812;25151;77473;22119;74046;1611;5159;18262;63235;19873;68394
130255;201812;4084;14293;3658;13517;194;916;2937;10801;3131;11717
130260;201812;236806;701123;199686;644952;57278;197305;88221;288962;145499;486267
130270;201812;8372;31691;7234;29874;1232;5171;4811;20610;6043;25781
130280;201812;3435;14092;3207;13839;129;613;2953;12900;3082;13513
130290;201812;12723;43630;11269;41821;527;2206;9952;37341;10479;39547
130300;201812;4560;16591;4200;16047;165;895;3636;13761;3801;14656
130310;201812;5555;20115;4970;19269;374;1593;4063;15950;4437;17543
130320;201812;3242;10863;2822;10341;285;1013;2186;8236;2471;9249
130330;201812;4456;14553;3702;13624;200;915;3166;11637;3366;12552
130340;201812;21185;71527;18709;68642;1481;5134;15613;58991;17094;64125
130350;201812;3858;14350;3501;13877;153;880;3038;11914;3191;12794
130353;201812;6337;18669;5345;17380;812;2549;3719;12500;4531;15049
130356;201812;4709;16035;4085;15016;588;2182;2735;10371;3323;12553
130360;201812;3073;9303;2657;8831;61;182;2490;8353;2551;8535
130370;201812;5585;22090;5020;21319;302;1500;4225;17906;4527;19406
130380;201812;7101;30013;6744;29445;432;2441;5712;24615;6144;27056
130390;201812;5803;24571;5132;23382;559;3027;3715;16811;4274;19838
130395;201812;2292;7511;1996;6996;244;904;1430;4978;1674;5882
130400;201812;2600;8531;2265;8069;122;442;1998;7199;2120;7641
130406;201812;10463;39042;9219;37356;1874;7860;6114;25258;7988;33118
130410;201812;3987;14596;3485;13750;1079;4421;1609;6562;2688;10983
130420;201812;12437;46312;10823;44320;1004;5174;8609;34983;9613;40157
130423;201812;3942;13205;3536;12704;176;875;3129;11055;3305;11930
130426;201812;2800;11064;2684;10892;95;512;2480;10052;2575;10564
130430;201812;3940;12045;3478;11376;354;1279;2734;8829;3088;10108
130440;201812;4582;14723;4037;14071;101;412;3741;13096;3842;13508
140002;201812;1976;6002;1739;5684;95;398;1442;4613;1537;5011
140005;201812;3003;8483;2764;8210;113;375;2461;7341;2574;7716
140010;201812;52369;141036;41217;124368;10626;33787;16059;50048;26685;83835
140015;201812;3137;10403;2817;10002;224;812;2382;8591;2606;9403
140017;201812;3634;11058;3222;10513;344;1093;2400;8123;2744;9216
140020;201812;4937;15085;4239;14131;310;1340;3313;10963;3623;12303
140023;201812;2220;6898;1831;6333;238;868;1290;4502;1528;5370
140028;201812;2048;5303;1736;4902;134;440;1347;3713;1481;4153
140030;201812;4474;12376;3991;11786;328;842;3307;10041;3635;10883
140040;201812;2129;9025;1955;8758;125;776;1678;7354;1803;8130
140045;201812;2455;9303;2079;8756;396;1618;1335;5943;1731;7561
140047;201812;5729;17062;4914;15825;768;2648;3269;10606;4037;13254
140050;201812;1343;4018;1150;3734;129;434;820;2693;949;3127
140060;201812;1536;4202;1297;3849;107;316;1026;3092;1133;3408
140070;201812;1763;9454;1707;9307;141;953;1353;7285;1494;8238
150010;201812;42713;109833;39343;105379;1025;2932;35205;93642;36230;96574
150013;201812;1850;4986;1538;4630;141;366;1181;3737;1322;4103
150020;201812;13814;42692;12997;41625;1173;2877;10999;36443;12172;39320
150030;201812;8575;32838;7863;31947;376;1813;6946;28300;7322;30113
150034;201812;4132;10752;3474;9891;253;721;2868;8271;3121;8992
150040;201812;15280;40671;13400;38550;1404;2559;10856;33967;12260;36526
150050;201812;6611;23842;6123;23140;135;655;5632;21390;5767;22045
150060;201812;19686;55842;16458;51026;2994;9252;9966;31837;12960;41089
150070;201812;6345;24828;5755;24098;180;963;5227;22122;5407;23085
150080;201812;81152;194839;68390;177598;16295;44467;25748;76398;42043;120865
150085;201812;6569;20392;6028;19712;199;647;5564;18315;5763;18962
150090;201812;9829;37077;9273;36044;630;2697;7548;29394;8178;32091
150095;201812;5439;16660;4851;15872;281;743;4039;13683;4320;14426
150100;201812;2992;10575;2653;9983;200;738;2047;7782;2247;8520
150110;201812;4025;17716;3910;17564;222;1080;3534;15932;3756;17012
150120;201812;7382;24421;7166;24116;298;785;6372;22163;6670;22948
150125;201812;732;2035;559;1797;111;410;315;996;426;1406
150130;201812;22429;66140;19730;62120;2693;7602;14140;46228;16833;53830
150140;201812;210862;518715;183035;480027;30241;78074;107975;295420;138216;373494
150145;201812;4480;13528;3839;12629;790;2339;2511;8833;3301;11172
150150;201812;14467;38914;12929;36947;850;2547;10502;30162;11352;32709
150157;201812;3215;9153;2678;8451;291;1019;1896;6136;2187;7155
150160;201812;2894;8974;2713;8665;675;2104;1495;4980;2170;7084
150170;201812;23864;79545;20763;74368;3834;13090;12559;47883;16393;60973
150172;201812;4295;12359;3503;11229;294;852;2572;8543;2866;9395
150175;201812;1668;5226;1434;4790;230;816;917;3102;1147;3918
150178;201812;9885;28309;8324;26453;351;1119;7136;23030;7487;24149
150180;201812;20304;76251;18911;74472;999;4013;16533;66092;17532;70105
150190;201812;6756;23063;6366;22549;296;1277;5589;19712;5885;20989
150195;201812;5339;17230;5089;16844;95;462;4707;15451;4802;15913
150200;201812;5354;16260;4919;15783;52;156;4648;15032;4700;15188
150210;201812;24174;88437;22847;86606;1837;6986;18699;72608;20536;79594
150215;201812;6839;20503;5949;19184;1501;4804;3015;10300;4516;15104
150220;201812;11285;33638;10074;31819;1523;4727;6319;20478;7842;25205
150230;201812;12016;35184;10493;33126;1303;3960;7205;23648;8508;27608
150240;201812;30588;87469;25285;78106;7928;24936;7365;23296;15293;48232
150250;201812;3952;16095;3778;15855;552;2348;2881;12298;3433;14646
150260;201812;2463;8577;2286;8284;205;732;1743;6399;1948;7131
150270;201812;8335;24272;5999;20525;2009;7196;1919;6869;3928;14065
150275;201812;6496;21531;6025;20814;278;1087;5150;17695;5428;18782
150276;201812;2227;6176;1916;5801;256;710;1336;4379;1592;5089
150277;201812;5079;13679;4173;12621;1585;4921;2008;6431;3593;11352
150280;201812;6328;26496;6167;26194;534;2207;5093;21911;5627;24118
150285;201812;3153;11396;2801;10836;310;1255;1974;7792;2284;9047
150290;201812;10605;29028;9803;28149;379;878;8848;25952;9227;26830
150293;201812;9346;23623;6891;20314;1404;4160;3559;11305;4963;15465
150295;201812;7741;21327;5690;18585;2030;7278;1920;6817;3950;14095
150300;201812;2130;6747;1918;6456;51;248;1705;5711;1756;5959
150304;201812;3954;12259;3306;11155;615;1976;2053;7226;2668;9202
150307;201812;6178;20183;5762;19522;412;1321;4688;16108;5100;17429
150309;201812;5992;18869;4921;17003;1051;3534;2547;9244;3598;12778
150310;201812;7057;28155;6743;27758;233;1347;5970;24712;6203;26059
150320;201812;9236;25317;8436;24225;473;1465;6603;18884;7076;20349
150330;201812;13614;45047;12642;43359;1585;5368;9221;32336;10806;37704
150340;201812;2559;7593;2310;7233;350;1045;1606;5126;1956;6171
150345;201812;7565;22849;6887;21965;417;1414;5882;18869;6299;20283
150350;201812;8701;23597;8008;22706;837;1763;6517;19168;7354;20931
150360;201812;22939;65917;18611;60347;2158;6429;12882;43691;15040;50120
150370;201812;9820;32138;8365;30099;963;3228;6096;23063;7059;26291
150375;201812;3215;13523;2910;13047;291;1445;2313;10408;2604;11853
150380;201812;10279;27729;8646;25499;269;917;7497;22188;7766;23105
150390;201812;7565;31566;6917;30484;1124;4579;4771;22107;5895;26686
150400;201812;6115;22713;5878;22258;277;1150;5070;19239;5347;20389
150405;201812;9012;24413;8008;23160;515;1163;6468;19394;6983;20557
150410;201812;1825;6056;1573;5610;219;744;1013;3716;1232;4460
150420;201812;36361;107456;27926;94289;9073;31963;8088;31647;17161;63610
150430;201812;8017;24441;7481;23702;819;2113;5933;19505;6752;21618
150440;201812;5513;18269;5199;17785;515;1605;4062;14172;4577;15777
150442;201812;23717;60909;19967;55857;2354;6425;13336;38307;15690;44732
150445;201812;5890;18932;5305;18011;245;883;4484;15274;4729;16157
150450;201812;4805;21431;4543;21065;367;1816;3838;17906;4205;19722
150460;201812;8151;27321;7581;26560;244;1022;6581;23805;6825;24827
150470;201812;18895;52689;17497;51078;786;2020;15839;46704;16625;48724
150475;201812;4396;14600;3938;13889;182;689;3292;11744;3474;12433
150480;201812;13533;45242;12150;43083;2222;7374;8160;30510;10382;37884
150490;201812;7935;28355;7476;27752;238;1102;6688;24910;6926;26012
150495;201812;5069;18081;4927;17882;109;527;4539;16437;4648;16964
150497;201812;2679;8930;2171;7997;563;2168;1049;4051;1612;6219
150500;201812;3230;8536;2876;7998;314;801;2192;6147;2506;6948
150503;201812;4256;11883;3051;10200;951;3312;1001;3738;1952;7050
150506;201812;9522;30514;8355;28852;1805;5633;5318;19897;7123;25530
150510;201812;9635;35967;8448;33636;1204;4610;5665;23625;6869;28235
150520;201812;7271;27549;6968;27163;192;1068;6411;24921;6603;25989
150530;201812;12133;41812;10659;39637;1645;5080;7571;29860;9216;34940
150540;201812;4837;13682;4166;12682;151;458;3578;10866;3729;11324
150543;201812;6840;18961;5602;17320;872;2750;3794;12290;4666;15040
150548;201812;9713;30999;8821;29775;316;1089;7836;26554;8152;27643
150549;201812;1994;6144;1736;5801;53;229;1521;5081;1574;5310
150550;201812;18708;56886;16037;52433;4086;13704;7091;24565;11177;38269
150553;201812;22306;70140;17795;61683;6115;21769;5166;19705;11281;41474
150555;201812;1763;4887;1399;4295;130;355;983;3081;1113;3436
150560;201812;1771;5589;1587;5211;292;930;889;3017;1181;3947
150563;201812;2390;7627;2069;7030;443;1617;1135;3832;1578;5449
150565;201812;4202;13798;3724;13006;96;473;3116;10906;3212;11379
150570;201812;6023;20313;5779;19939;279;1104;4973;17091;5252;18195
150580;201812;9936;40925;9023;39898;653;3220;7485;33830;8138;37050
150590;201812;7113;26278;6537;25523;204;1099;5930;23069;6134;24168
150600;201812;8969;31157;8385;30405;250;1082;7652;27802;7902;28884
150610;201812;2642;8154;2364;7644;133;515;1918;6105;2051;6620
150611;201812;2908;8764;2632;8335;110;439;2291;7176;2401;7615
150613;201812;12513;35237;9521;30075;1895;6340;4488;14328;6383;20668
150616;201812;3179;8941;2339;7545;572;1959;864;2727;1436;4686
150618;201812;6711;20256;5469;18291;677;2261;3382;11789;4059;14050
150619;201812;5856;17470;4890;16011;231;893;3932;12858;4163;13751
150620;201812;6319;21257;5517;20013;814;2868;3810;14204;4624;17072
150630;201812;6065;16920;5599;16348;410;1168;4705;13911;5115;15079
150635;201812;4406;12758;3808;11739;608;1892;2337;7312;2945;9204
150640;201812;2167;6333;1993;6130;33;109;1868;5810;1901;5919
150650;201812;11169;32140;9901;29961;3080;8816;4315;14093;7395;22909
150655;201812;5642;16620;5164;15886;219;686;4454;13686;4673;14372
150658;201812;4276;12352;3453;11134;667;2259;2016;6785;2683;9044
150660;201812;5590;16381;5046;15624;555;1674;3502;11054;4057;12728
150670;201812;7827;19098;6230;17253;696;1561;4855;14126;5551;15687
150680;201812;62124;191950;48041;169161;12383;43345;21000;82564;33383;125909
150690;201812;2537;6979;2282;6632;121;318;1967;5793;2088;6111
150700;201812;6054;18437;5477;17691;399;1184;4379;14453;4778;15637
150710;201812;3681;12470;3363;11943;258;994;2602;9303;2860;10297
150715;201812;4907;14654;4138;13436;362;1113;3226;10643;3588;11756
150720;201812;6388;24317;6038;23700;437;1992;4980;19545;5417;21537
150730;201812;11026;35117;9717;33113;1086;3857;7326;25422;8412;29279
150740;201812;3668;10741;3261;10035;407;1159;2296;7211;2703;8370
150745;201812;5011;14718;4107;13360;831;2876;2636;8583;3467;11459
150746;201812;1525;4861;1410;4671;92;302;1138;3785;1230;4087
150747;201812;4770;15650;4271;14831;796;2475;2753;10082;3549;12557
150750;201812;3552;11350;3027;10530;231;870;2315;8240;2546;9110
150760;201812;11559;34626;10630;33423;1344;3950;7881;25374;9225;29324
150770;201812;6118;22568;5837;22185;185;560;5381;21028;5566;21588
150775;201812;884;2587;700;2308;133;492;380;1239;513;1731
150780;201812;4443;13501;4051;13026;102;331;3726;12120;3828;12451
150790;201812;5314;15882;4676;15186;223;600;3886;13667;4109;14267
150795;201812;13325;43344;12113;41275;3234;10532;6646;24082;9880;34614
150796;201812;3485;9189;3051;8663;186;518;2574;7387;2760;7905
150797;201812;3834;12224;3329;11453;153;476;2757;9591;2910;10067
150800;201812;12719;41126;11802;39971;1637;5170;8866;31078;10503;36248
150803;201812;6644;22649;6265;22046;384;1365;5347;18869;5731;20234
150805;201812;3251;10508;2775;9740;312;1122;2069;7318;2381;8440
150808;201812;5609;16809;4176;14298;1562;5822;538;2048;2100;7870
150810;201812;20017;55557;15464;49883;2758;8839;8747;30453;11505;39292
150812;201812;5232;15217;4662;14198;466;1514;3409;10168;3875;11682
150815;201812;8757;27406;7563;25887;747;2555;5930;20622;6677;23177
150820;201812;11791;32417;9896;30135;952;2512;7763;24485;8715;26997
150830;201812;11266;43021;10740;42357;364;1957;9383;37528;9747;39485
150835;201812;2112;7335;1895;6937;406;1473;950;3538;1356;5011
150840;201812;7131;21160;5726;18637;1167;3999;2965;9630;4132;13629
160005;201812;1153;3196;1045;3041;28;124;974;2795;1002;2919
160010;201812;2377;6177;2286;6081;14;65;2225;5866;2239;5931
160015;201812;2295;7345;2091;7064;96;349;1894;6413;1990;6762
160020;201812;1946;6695;1748;6416;233;854;1312;4885;1545;5739
160021;201812;1052;4197;983;4095;71;423;798;3234;869;3657
160023;201812;1191;4401;1056;4178;121;446;734;3067;855;3513
160025;201812;1907;5384;1844;5307;12;37;1815;5227;1827;5264
160027;201812;8554;24180;7789;23247;549;1564;6480;19693;7029;21257
160030;201812;57935;174814;48046;161522;10889;34588;25518;94641;36407;129229
160040;201812;5129;18319;4660;17683;94;550;4284;16252;4378;16802
160050;201812;4325;14028;3524;12850;1511;5304;1120;5049;2631;10353
160053;201812;3466;11554;3228;11245;309;1018;2603;9301;2912;10319
160055;201812;706;2400;691;2383;27;106;639;2199;666;2305
160060;201812;22119;62230;18611;58172;1123;3460;15092;48890;16215;52350
160070;201812;2854;10987;2584;10536;191;815;2061;8604;2252;9419
160080;201812;2941;10077;2728;9824;63;330;2457;8880;2520;9210
170025;201812;608;1670;453;1443;98;306;223;727;321;1033
170030;201812;1187;3739;943;3255;170;594;452;1586;622;2180
170035;201812;1432;3769;1036;3107;110;357;591;1778;701;2135
170040;201812;1774;5268;1458;4834;110;409;826;2869;936;3278
170070;201812;1620;3924;1150;3317;112;361;667;1933;779;2294
170100;201812;2413;7035;1993;6298;198;594;1305;4187;1503;4781
170105;201812;721;2156;505;1684;125;381;164;557;289;938
170110;201812;912;2920;714;2535;106;389;344;1223;450;1612
170130;201812;1282;3983;918;3236;171;622;454;1654;625;2276
170190;201812;1358;3949;930;3245;315;1082;174;813;489;1895
170200;201812;1718;4337;1036;3152;263;869;245;724;508;1593
170210;201812;23753;66212;18000;56430;6339;21600;1747;6432;8086;28032
170215;201812;1312;3637;1095;3337;59;242;818;2458;877;2700
170220;201812;5765;18166;4899;16516;1186;3763;2316;8420;3502;12183
170230;201812;1212;3723;934;3153;246;857;193;677;439;1534
170240;201812;2606;7450;2020;6497;169;656;1347;4205;1516;4861
170255;201812;3910;11610;2725;9323;523;1887;1225;4298;1748;6185
170270;201812;1037;2522;663;1997;34;106;416;1231;450;1337
170290;201812;2963;8658;2534;8147;126;366;2050;6856;2176;7222
170300;201812;1831;5274;1529;4785;178;569;996;3155;1174;3724
170305;201812;707;2048;557;1755;77;279;268;818;345;1097
170307;201812;934;3289;752;2908;116;451;405;1599;521;2050
170310;201812;1599;4144;1091;3277;204;667;483;1470;687;2137
170320;201812;967;2590;730;2218;76;231;449;1369;525;1600
170330;201812;867;2742;774;2590;50;223;614;1990;664;2213
170360;201812;458;1305;327;1078;46;166;195;607;241;773
170370;201812;1264;3462;928;2900;210;631;376;1255;586;1886
170380;201812;1757;5259;1315;4542;184;651;669;2437;853;3088
170382;201812;540;1660;438;1484;55;222;293;960;348;1182
170384;201812;1469;5557;1216;5044;302;1314;530;2214;832;3528
170386;201812;813;2292;508;1673;76;299;141;414;217;713
170388;201812;619;1800;440;1466;56;209;200;667;256;876
170389;201812;1032;3412;885;3150;41;179;700;2518;741;2697
170390;201812;1614;3845;1183;3314;79;208;925;2671;1004;2879
170410;201812;548;1638;397;1355;22;95;251;826;273;921
170460;201812;361;984;285;855;47;139;172;525;219;664
170510;201812;853;2641;632;2202;56;261;376;1243;432;1504
170550;201812;6306;17297;4454;14092;1302;4422;837;2828;2139;7250
170555;201812;1323;3727;1044;3275;75;256;545;1767;620;2023
170560;201812;1021;2960;762;2583;83;326;437;1606;520;1932
170600;201812;1357;3805;1094;3404;242;629;609;2071;851;2700
170610;201812;1735;4786;1263;4025;74;277;778;2433;852;2710
170625;201812;433;1197;275;861;33;100;85;256;118;356
170650;201812;1253;3833;976;3339;185;628;446;1610;631;2238
170700;201812;3319;9886;2494;8356;557;1975;1027;3522;1584;5497
170710;201812;1453;4048;1125;3458;183;634;615;1847;798;2481
170720;201812;1865;4806;1493;4257;60;121;1251;3680;1311;3801
170730;201812;994;2842;751;2441;165;514;320;1093;485;1607
170740;201812;2006;6925;1708;6319;217;813;1119;4159;1336;4972
170755;201812;864;2503;603;1992;67;245;288;930;355;1175
170765;201812;1229;3233;833;2606;197;623;318;1057;515;1680
170770;201812;1747;5360;1479;4922;195;618;958;3267;1153;3885
170820;201812;3392;10863;2832;9763;512;1825;1435;5040;1947;6865
170825;201812;907;2197;729;1944;84;232;492;1316;576;1548
170830;201812;1367;3772;1132;3387;20;58;943;2829;963;2887
170900;201812;2571;8606;2215;8035;175;690;1730;6351;1905;7041
170930;201812;3589;10174;2796;8719;648;2159;1085;3372;1733;5531
170950;201812;10680;30351;7420;24352;2187;8092;1006;3511;3193;11603
170980;201812;414;1198;338;1070;24;112;228;674;252;786
171050;201812;1525;4983;1344;4646;60;288;1071;3647;1131;3935
171070;201812;1293;3886;1115;3611;248;759;621;2205;869;2964
171090;201812;1043;2590;849;2316;70;177;600;1637;670;1814
171110;201812;564;1581;404;1287;75;266;170;486;245;752
171150;201812;1045;2705;639;1975;78;268;399;1228;477;1496
171180;201812;732;2082;487;1587;84;261;190;657;274;918
171190;201812;1569;5605;1389;5270;225;870;841;3255;1066;4125
171195;201812;807;2692;678;2447;128;497;386;1400;514;1897
171200;201812;510;1513;383;1285;78;284;158;522;236;806
171215;201812;386;1108;296;941;51;172;169;519;220;691
171240;201812;736;2544;613;2292;45;231;386;1435;431;1666
171245;201812;620;1937;477;1622;65;248;257;845;322;1093
171250;201812;1059;2816;776;2375;194;639;358;1084;552;1723
171270;201812;379;1489;322;1342;73;313;128;580;201;893
171280;201812;829;2571;640;2230;118;400;322;1194;440;1594
171320;201812;3915;11210;3046;9663;569;1777;1315;4407;1884;6184
171330;201812;2621;7293;2023;6263;462;1387;937;3035;1399;4422
171360;201812;1396;4183;1154;3830;81;311;873;2901;954;3212
171370;201812;670;1773;521;1566;57;174;357;1092;414;1266
171380;201812;1435;4080;1181;3682;121;394;813;2539;934;2933
171395;201812;918;2702;623;2098;74;295;337;1092;411;1387
171420;201812;1853;5690;1359;4677;241;918;590;2025;831;2943
171430;201812;1000;3001;811;2614;73;267;556;1725;629;1992
171488;201812;2321;7020;1818;6181;290;1033;941;3291;1231;4324
171500;201812;949;2494;721;2134;48;152;536;1586;584;1738
171510;201812;739;2578;668;2435;43;186;465;1700;508;1886
171515;201812;461;1277;339;1068;28;117;204;612;232;729
171525;201812;647;1958;528;1748;37;173;311;955;348;1128
171550;201812;334;1008;237;835;37;147;125;438;162;585
171570;201812;1096;3412;918;3081;160;503;512;1788;672;2291
171575;201812;1789;4824;1123;3577;174;611;450;1383;624;1994
171610;201812;5481;15724;4076;13290;943;3335;1106;3851;2049;7186
171620;201812;2655;7608;2241;7006;146;565;1760;5481;1906;6046
171630;201812;930;2586;755;2332;135;433;474;1503;609;1936
171650;201812;2011;5947;1485;4959;385;1335;465;1665;850;3000
171660;201812;2312;6075;1597;4820;261;744;839;2580;1100;3324
171665;201812;1334;3783;1004;3239;174;634;467;1530;641;2164
171670;201812;1783;4909;1369;4223;205;720;766;2301;971;3021
171700;201812;1158;3413;856;2871;114;384;481;1600;595;1984
171720;201812;802;2145;622;1854;41;163;451;1313;492;1476
171750;201812;1222;3544;871;2885;226;778;118;481;344;1259
171780;201812;1202;3173;881;2704;63;238;616;1842;679;2080
171790;201812;1398;4796;1122;4182;262;953;474;1878;736;2831
171800;201812;713;2043;537;1766;67;257;290;946;357;1203
171820;201812;10497;30301;7895;25654;1902;6461;2611;9021;4513;15482
171830;201812;1439;4940;1215;4488;113;526;791;2852;904;3378
171840;201812;725;1944;567;1694;35;107;394;1167;429;1274
171845;201812;628;1640;465;1403;66;233;255;781;321;1014
171850;201812;854;2993;729;2705;66;305;512;1842;578;2147
171855;201812;1059;3274;907;2995;86;293;569;1853;655;2146
171865;201812;365;1188;309;1098;48;182;149;513;197;695
171870;201812;755;2173;541;1770;60;208;285;963;345;1171
171875;201812;1226;3738;985;3336;60;250;720;2402;780;2652
171880;201812;1063;3417;951;3267;45;183;768;2678;813;2861
171884;201812;791;2166;570;1814;118;434;204;703;322;1137
171886;201812;1399;4005;979;3277;284;1019;192;661;476;1680
171888;201812;732;2099;501;1649;44;144;300;990;344;1134
171889;201812;421;1340;360;1226;75;275;162;545;237;820
171890;201812;1136;3195;839;2702;175;500;464;1568;639;2068
171900;201812;500;1773;362;1424;85;325;130;542;215;867
172000;201812;559;1741;464;1562;58;241;260;828;318;1069
172010;201812;1044;3715;894;3390;79;384;559;2040;638;2424
172015;201812;344;1246;256;1057;50;192;105;464;155;656
172020;201812;2351;7252;2134;6929;193;728;1597;5216;1790;5944
172025;201812;744;2100;542;1761;45;177;339;1079;384;1256
172030;201812;1233;3703;1057;3433;28;124;865;2791;893;2915
172049;201812;1226;3101;852;2552;258;821;396;1179;654;2000
172065;201812;1488;3752;1177;3373;93;195;984;2964;1077;3159
172080;201812;2246;6879;1835;6118;125;480;1242;4132;1367;4612
172085;201812;481;1344;309;979;45;124;97;301;142;425
172090;201812;3938;10248;3033;9015;131;488;2324;6856;2455;7344
172093;201812;491;1492;359;1246;46;203;188;618;234;821
172097;201812;571;1555;415;1296;65;213;199;644;264;857
172100;201812;45755;116312;30805;91632;6534;21215;9677;29613;16211;50828
172110;201812;1546;5871;1341;5539;146;650;981;4189;1127;4839
172120;201812;4750;14526;3779;12921;599;2067;2007;7112;2606;9179
172125;201812;300;861;217;720;30;99;113;378;143;477
172130;201812;710;1946;581;1724;25;95;427;1221;452;1316
172208;201812;2403;6199;1937;5561;243;628;1274;3736;1517;4364
172210;201812;2686;7280;2066;6447;446;1473;1052;3317;1498;4790
210005;201812;18950;56373;14978;49741;4496;15565;5630;19510;10126;35075
210010;201812;1811;5799;1637;5535;51;225;1438;4880;1489;5105
210015;201812;3346;10075;2979;9567;132;336;2569;8411;2701;8747
210020;201812;7478;17155;6632;16194;101;250;6176;15087;6277;15337
210030;201812;4692;15784;4436;15422;310;1132;3779;13224;4089;14356
210040;201812;1873;4701;1688;4486;28;51;1579;4236;1607;4287
210043;201812;6268;17564;5204;16230;650;1944;3758;12140;4408;14084
210047;201812;6494;21379;5610;20131;203;1011;4871;17325;5074;18336
210050;201812;2163;7542;1713;6709;211;929;1113;4348;1324;5277
210055;201812;1808;5971;1653;5707;64;252;1368;4685;1432;4937
210060;201812;6855;26083;6109;24637;769;3212;4253;17637;5022;20849
210070;201812;7107;20540;6723;20079;34;125;6478;19453;6512;19578
210080;201812;3977;13934;3842;13760;40;242;3663;13109;3703;13351
210083;201812;5359;16022;4553;15152;66;362;4328;14297;4394;14659
210087;201812;2944;8240;2599;7787;142;346;2185;6742;2327;7088
210090;201812;9431;29598;8889;28651;318;1099;7891;25347;8209;26446
210095;201812;6217;20546;5757;19974;246;992;4823;17344;5069;18336
210100;201812;6665;20253;6102;19374;248;930;5177;16363;5425;17293
210110;201812;2820;9040;2644;8810;34;192;2478;8223;2512;8415
210120;201812;22504;62955;19223;58706;2369;6134;13053;42311;15422;48445
210125;201812;4066;11646;3684;11156;784;1925;2616;8448;3400;10373
210130;201812;4186;11415;3530;10568;150;393;3016;9076;3166;9469
210135;201812;1432;4401;1265;4128;54;179;1050;3455;1104;3634
210140;201812;16722;47502;13345;42999;2727;8740;7456;24967;10183;33707
210150;201812;4470;10959;3996;10297;121;326;3539;9028;3660;9354
210160;201812;15653;47717;14073;45531;2844;9422;8701;28967;11545;38389
210170;201812;14382;46887;13521;45683;607;2119;12052;40704;12659;42823
210173;201812;2292;8581;2077;8201;61;372;1926;7530;1987;7902
210177;201812;3232;9259;2943;8895;100;189;2676;8361;2776;8550
210180;201812;1415;3967;1281;3781;37;102;1143;3367;1180;3469
210190;201812;4742;14081;4268;13283;97;486;3611;10954;3708;11440
210193;201812;1241;3762;1115;3564;51;166;887;2894;938;3060
210197;201812;1966;6484;1846;6315;179;611;1465;5124;1644;5735
210200;201812;7373;24393;6790;23457;627;2230;5410;18852;6037;21082
210203;201812;6953;21063;6149;19952;609;1966;4877;16096;5486;18062
210207;201812;3327;9331;2972;8874;159;424;2468;7512;2627;7936
210210;201812;8127;26640;7590;25900;119;716;7012;23789;7131;24505
210215;201812;2170;7204;1987;6949;63;308;1760;6131;1823;6439
210220;201812;5964;20989;5661;20475;224;1321;4945;17490;5169;18811
210230;201812;5120;15872;4666;15194;288;772;4042;13373;4330;14145
210232;201812;11085;35732;9251;33038;1507;5503;5980;22591;7487;28094
210235;201812;3473;10472;3060;9919;90;407;2712;8776;2802;9183
210237;201812;2485;8728;2284;8474;25;146;2152;7952;2177;8098
210240;201812;2639;8424;2415;8023;85;346;2105;6914;2190;7260
210250;201812;5477;17013;5041;16474;86;485;4532;14756;4618;15241
210255;201812;2508;7809;2159;7143;246;856;1480;4849;1726;5705
210260;201812;5261;16312;4667;15418;271;1021;3896;12799;4167;13820
210270;201812;4734;13383;4261;12758;95;465;3835;11372;3930;11837
210275;201812;3543;9006;3173;8535;50;121;2968;8049;3018;8170
210280;201812;5436;16014;4416;14418;237;1129;3239;10271;3476;11400
210290;201812;6644;19140;6071;18428;154;477;5492;16689;5646;17166
210300;201812;32962;90639;27563;83417;2360;6931;20238;64064;22598;70995
210310;201812;2994;7897;2664;7427;118;260;2325;6540;2443;6800
210312;201812;2612;6956;2320;6614;47;203;2144;6034;2191;6237
210315;201812;2853;8154;2437;7667;69;195;2199;7072;2268;7267
210317;201812;4022;12934;3695;12557;126;607;3351;11309;3477;11916
210320;201812;18325;57652;17023;55898;436;2125;15225;49712;15661;51837
210325;201812;3364;10073;2968;9522;87;301;2680;8681;2767;8982
210330;201812;23418;70503;20459;66249;5804;17432;10102;36969;15906;54401
210340;201812;9850;30298;8913;28886;838;2739;6712;22279;7550;25018
210350;201812;9245;27206;8236;25927;188;680;7286;23021;7474;23701
210355;201812;4348;15340;3875;14586;133;702;3325;12564;3458;13266
210360;201812;14035;43149;12597;41087;552;2339;10282;33242;10834;35581
210370;201812;10297;23610;8171;21336;263;504;7423;19794;7686;20298
210375;201812;3121;8630;2363;7606;687;2193;1059;3717;1746;5910
210380;201812;5389;14314;4797;13569;242;617;4131;11754;4373;12371
210390;201812;2546;9292;2371;8967;140;667;1956;7303;2096;7970
210400;201812;4388;13935;4002;13429;133;396;3600;12195;3733;12591
210405;201812;6903;19080;5618;17211;1073;3085;3146;10239;4219;13324
210407;201812;1918;6555;1603;5934;108;488;1284;4660;1392;5148
210408;201812;2407;9271;2260;9037;149;755;1813;7256;1962;8011
210409;201812;3666;12972;3359;12535;117;674;2800;10417;2917;11091
210410;201812;3390;10635;2919;9874;229;867;2150;7248;2379;8115
210420;201812;3926;12669;3552;12014;191;598;3009;10282;3200;10880
210430;201812;2201;6555;2029;6338;113;327;1763;5528;1876;5855
210440;201812;4121;11674;3796;11215;72;244;3571;10526;3643;10770
210450;201812;2422;7438;2170;7026;106;406;1806;5809;1912;6215
210455;201812;4040;10874;3121;9714;859;2640;1602;5184;2461;7824
210460;201812;3401;10244;2988;9693;83;347;2617;8453;2700;8800
210462;201812;1524;4949;1346;4635;41;191;1088;3722;1129;3913
210465;201812;2563;7715;2244;7261;85;298;1920;6226;2005;6524
210467;201812;5508;18547;5067;17999;289;1222;4415;15700;4704;16922
210470;201812;2111;5550;1457;4609;84;199;1100;3593;1184;3792
210480;201812;15213;46751;12941;43848;1358;4412;9435;33782;10793;38194
210490;201812;3706;9593;3037;8635;89;268;2639;7506;2728;7774
210500;201812;5927;24148;5574;23498;368;1965;4541;18920;4909;20885
210510;201812;5844;20191;5387;19660;107;534;4909;18063;5016;18597
210515;201812;3626;10800;3206;10336;104;384;2853;9281;2957;9665
210520;201812;2475;7268;2239;6957;91;292;1988;6163;2079;6455
210530;201812;47953;121630;38740;107746;6655;23300;10991;38434;17646;61734
210535;201812;3084;10605;2895;10310;106;424;2469;8860;2575;9284
210540;201812;13933;41738;11772;38786;1449;4522;8336;28606;9785;33128
210542;201812;6116;15337;5090;14185;296;500;4450;13014;4746;13514
210545;201812;2235;7044;2100;6818;46;188;1860;5945;1906;6133
210547;201812;3518;12706;3125;11919;305;1137;2260;8865;2565;10002
210550;201812;6002;18364;4942;16765;362;1335;3795;13157;4157;14492
210560;201812;3379;10607;3077;10085;116;405;2624;8522;2740;8927
210565;201812;1457;5021;1232;4677;73;373;958;3673;1031;4046
210570;201812;10931;30040;9781;28648;288;804;8820;26176;9108;26980
210580;201812;2972;8287;2583;7812;211;428;2099;6645;2310;7073
210590;201812;4223;12820;3722;12138;90;478;3302;10675;3392;11153
210592;201812;2543;7632;2391;7388;33;167;2146;6564;2179;6731
210594;201812;2514;6876;1968;6026;77;200;1514;4779;1591;4979
210596;201812;2314;8520;2158;8189;129;550;1741;6623;1870;7173
210598;201812;1832;5280;1690;5085;33;138;1559;4675;1592;4813
210600;201812;2931;8123;2396;7323;75;197;1986;6147;2061;6344
210610;201812;2455;7368;2190;7049;62;298;1932;6152;1994;6450
210620;201812;2425;7064;2077;6622;60;199;1901;6120;1961;6319
210630;201812;3005;10424;2745;10033;149;781;2267;8110;2416;8891
210632;201812;4214;14052;3793;13430;298;1252;2943;10319;3241;11571
210635;201812;1750;6272;1665;6126;139;471;1369;5168;1508;5639
210637;201812;2277;7854;2047;7498;164;705;1564;5778;1728;6483
210640;201812;4448;16403;4285;16205;55;322;4091;15369;4146;15691
210650;201812;7126;20672;6618;19992;78;321;6227;18760;6305;19081
210660;201812;8172;23969;7272;22565;318;1139;6281;19314;6599;20453
210663;201812;2510;7624;2363;7453;117;306;2082;6741;2199;7047
210667;201812;1868;6176;1746;5992;59;246;1581;5451;1640;5697
210670;201812;4388;15306;4055;14751;146;716;3533;12744;3679;13460
210675;201812;4986;13804;4356;12938;303;764;3590;10944;3893;11708
210680;201812;4057;10550;3435;9775;129;250;3051;8889;3180;9139
210690;201812;7334;23695;6590;22835;255;1121;5828;20255;6083;21376
210700;201812;2682;7405;2196;6766;139;373;1764;5761;1903;6134
210710;201812;4955;15655;4394;14817;126;615;3865;12886;3991;13501
210720;201812;2768;9322;2603;9115;53;298;2390;8289;2443;8587
210725;201812;1326;4566;1161;4296;49;234;814;3121;863;3355
210730;201812;1186;3226;1010;2988;84;216;790;2399;874;2615
210735;201812;4555;13853;3932;12983;291;1013;3264;10929;3555;11942
210740;201812;5200;14299;4563;13584;139;493;3822;11262;3961;11755
210745;201812;4448;12410;4166;12020;148;368;3779;10950;3927;11318
210750;201812;20689;53694;18077;50511;1560;4118;13366;38807;14926;42925
210760;201812;5644;15468;5005;14729;24;104;4844;14262;4868;14366
210770;201812;5933;15713;5178;14845;52;226;4868;13922;4920;14148
210780;201812;6979;23160;6276;21942;594;1895;4908;17526;5502;19421
210790;201812;4371;13844;4029;13403;219;657;3194;11249;3413;11906
210800;201812;4886;13177;4256;12349;66;261;3882;11126;3948;11387
210805;201812;3844;14399;3698;14174;104;591;3332;12690;3436;13281
210810;201812;4890;14650;4500;14146;219;503;3899;12627;4118;13130
210820;201812;6863;19966;5866;18329;836;2612;3670;11675;4506;14287
210825;201812;6441;20445;6022;19892;243;831;5270;17608;5513;18439
210830;201812;7539;21819;7111;21264;484;1072;6146;19019;6630;20091
210840;201812;3206;8645;2901;8202;78;228;2584;7213;2662;7441
210845;201812;6174;17186;5730;16685;19;60;5633;16429;5652;16489
210850;201812;5646;19734;4951;18637;282;1374;3924;14683;4206;16057
210860;201812;18844;51513;16145;48011;749;2070;13374;41025;14123;43095
210870;201812;6614;18581;5765;17564;250;766;5048;15403;5298;16169
210880;201812;4337;13451;3938;12995;248;943;3257;10727;3505;11670
210890;201812;4005;12268;3633;11807;234;624;3043;10138;3277;10762
210900;201812;4508;13370;3465;11456;1354;4775;601;2226;1955;7001
210905;201812;1899;5426;1624;5054;51;114;1468;4658;1519;4772
210910;201812;7035;21838;6066;20251;816;2823;4095;13731;4911;16554
210920;201812;3161;10629;2804;10135;83;442;2506;8968;2589;9410
210923;201812;1421;4501;1261;4237;63;253;967;3233;1030;3486
210927;201812;5121;16165;4559;15541;141;507;4040;13961;4181;14468
210930;201812;2414;8566;2205;8197;137;659;1733;6360;1870;7019
210940;201812;3877;11340;3646;11049;96;462;3320;9859;3416;10321
210945;201812;5905;17810;5528;17354;231;700;4856;15404;5087;16104
210950;201812;5014;14772;3923;13143;616;1757;2579;9176;3195;10933
210955;201812;1560;5041;1388;4759;132;423;1018;3566;1150;3989
210960;201812;8503;26289;7592;24921;1511;4583;4692;16345;6203;20928
210970;201812;1227;3951;1018;3586;66;300;772;2628;838;2928
210975;201812;1629;5325;1480;5073;114;406;1152;3954;1266;4360
210980;201812;10159;23128;8997;21932;110;214;8597;21102;8707;21316
210990;201812;15674;45810;12728;41944;1080;3714;9284;31114;10364;34828
211000;201812;13915;42728;12041;40575;586;2411;9947;34188;10533;36599
211003;201812;5219;16534;4475;15615;158;607;3897;13853;4055;14460
211010;201812;6205;22785;5703;22104;72;449;5235;20402;5307;20851
211020;201812;7609;23954;7119;23342;296;1175;6160;20245;6456;21420
211023;201812;1980;6646;1888;6518;97;397;1588;5420;1685;5817
211027;201812;2658;9188;2600;9080;169;666;2256;7813;2425;8479
211030;201812;3780;10792;3419;10357;250;614;2817;8747;3067;9361
211040;201812;4461;16392;4212;15996;129;738;3751;14119;3880;14857
211050;201812;9238;23842;8468;22866;162;430;7876;21265;8038;21695
211060;201812;6608;21029;6158;20402;137;553;5725;18962;5862;19515
211065;201812;2089;6086;1780;5657;76;271;1502;4815;1578;5086
211070;201812;7251;24271;6417;22926;494;1791;5071;18247;5565;20038
211080;201812;1254;3602;1017;3226;33;202;791;2352;824;2554
211085;201812;1917;5771;1699;5466;93;268;1475;4819;1568;5087
211090;201812;3177;8871;2869;8467;41;194;2628;7677;2669;7871
211100;201812;6544;16996;6114;16419;42;134;5684;15315;5726;15449
211102;201812;2822;10339;2626;10039;160;779;2249;8509;2409;9288
211105;201812;2283;7418;1918;6729;189;669;1340;4679;1529;5348
211107;201812;4361;13975;3813;13168;145;599;3147;11114;3292;11713
211110;201812;5785;16448;4517;14453;520;1561;3157;10397;3677;11958
211120;201812;38813;102326;35668;98598;4753;12317;23332;68992;28085;81309
211125;201812;1985;6074;1698;5620;55;221;1429;4733;1484;4954
211130;201812;183697;453754;169974;436342;24939;65026;73677;216319;98616;281345
211140;201812;4825;14820;4299;14084;217;644;3685;12108;3902;12752
211150;201812;9096;25651;7916;24099;320;1029;6719;20511;7039;21540
211153;201812;2507;7455;2047;6883;278;1000;1374;4778;1652;5778
211157;201812;1056;3383;878;3071;37;220;637;2197;674;2417
211160;201812;3802;11435;3069;10294;159;705;2278;7490;2437;8195
211163;201812;1763;5709;1623;5502;12;59;1521;5238;1533;5297
211167;201812;1539;4999;1434;4835;31;155;1333;4459;1364;4614
211170;201812;6161;15501;5841;15110;51;164;5620;14483;5671;14647
211172;201812;2366;6734;2045;6215;82;279;1689;4956;1771;5235
211174;201812;2715;8197;2514;7940;56;283;2287;7146;2343;7429
211176;201812;4105;12195;3256;10956;208;836;2528;8462;2736;9298
211178;201812;4610;10799;3998;10097;38;181;3773;9401;3811;9582
211180;201812;3923;13352;3655;12937;197;781;3126;11064;3323;11845
211190;201812;2993;9088;2602;8465;46;239;2266;7296;2312;7535
211195;201812;1337;3928;1142;3653;71;194;947;3105;1018;3299
211200;201812;2026;6093;1667;5613;185;639;1155;3959;1340;4598
211210;201812;6327;19586;5836;18901;273;967;5071;16419;5344;17386
211220;201812;34174;90245;28849;83677;2908;8231;21324;63363;24232;71594
211223;201812;4700;13230;4149;12417;511;1424;2983;9102;3494;10526
211227;201812;1701;5846;1555;5622;42;220;1366;4961;1408;5181
211230;201812;6852;21377;6231;20373;427;1365;5052;16643;5479;18008
211240;201812;8102;26238;7651;25635;145;757;7014;23245;7159;24002
211245;201812;6521;16926;6182;16578;66;175;6035;16195;6101;16370
211250;201812;13236;40008;12118;38630;459;1974;10439;32779;10898;34753
211260;201812;7549;25155;6929;24288;202;945;6280;22014;6482;22959
211270;201812;10156;33222;8918;31493;359;1724;7406;26153;7765;27877
211280;201812;12724;36466;11511;34908;948;2346;9324;29486;10272;31832
211285;201812;1595;5674;1411;5373;215;857;805;3176;1020;4033
211290;201812;6979;22112;6494;21408;184;816;5626;18405;5810;19221
211300;201812;7815;22561;7136;21647;146;456;6607;20050;6753;20506
211400;201812;10908;32736;9080;30097;1395;4658;5689;19883;7084;24541
220005;201812;1801;4898;1617;4616;34;140;1350;3776;1384;3916
220010;201812;1441;4148;1209;3738;34;150;938;2858;972;3008
220020;201812;3257;9742;2914;9173;276;933;2232;6937;2508;7870
220025;201812;2180;5047;1856;4547;25;72;1573;3742;1598;3814
220027;201812;1223;3203;1056;2983;28;96;873;2424;901;2520
220030;201812;3225;8474;3056;8215;103;295;2675;7068;2778;7363
220040;201812;6734;20724;6046;19409;1218;3743;3652;11994;4870;15737
220045;201812;1412;4440;1197;4059;37;203;970;3210;1007;3413
220050;201812;4485;12788;3835;11827;102;460;3437;10468;3539;10928
220060;201812;2346;5065;1991;4653;30;83;1866;4337;1896;4420
220070;201812;2439;6364;2107;5876;79;177;1759;4923;1838;5100
220080;201812;678;1943;589;1806;28;104;504;1512;532;1616
220090;201812;1764;4319;1462;3892;15;58;1247;3398;1262;3456
220095;201812;632;1665;603;1630;15;33;554;1501;569;1534
220100;201812;1333;3793;1088;3381;47;202;874;2623;921;2825
220105;201812;1968;6258;1712;5712;144;476;1290;4311;1434;4787
220110;201812;3369;9365;3155;8973;44;212;2810;7864;2854;8076
220115;201812;2623;7962;2429;7666;75;307;2193;6811;2268;7118
220117;201812;1334;3309;1024;2852;18;78;872;2365;890;2443
220120;201812;11739;33483;10780;32225;97;383;10197;30389;10294;30772
220130;201812;1062;3031;900;2789;15;106;810;2448;825;2554
220140;201812;1902;4269;1643;3951;149;399;1406;3328;1555;3727
220150;201812;6372;19094;5957;18432;133;669;5114;15464;5247;16133
220155;201812;1093;3217;861;2786;21;90;614;1943;635;2033
220157;201812;1025;2557;857;2285;16;67;693;1785;709;1852
220160;201812;2651;7693;2304;7048;45;244;1908;5689;1953;5933
220170;201812;1456;3930;1228;3586;13;68;1093;3139;1106;3207
220173;201812;1978;5722;1592;4995;39;173;1304;3959;1343;4132
220177;201812;1912;5539;1852;5468;10;23;1813;5373;1823;5396
220180;201812;1100;2799;865;2357;7;37;659;1681;666;1718
220190;201812;5945;16198;5090;14985;402;1302;3809;11174;4211;12476
220191;201812;1369;4406;1259;4206;73;311;941;3069;1014;3380
220192;201812;1808;4958;1415;4250;28;103;1142;3346;1170;3449
220194;201812;1677;4879;1499;4575;61;242;1235;3674;1296;3916
220196;201812;1877;5148;1704;4869;33;160;1446;4023;1479;4183
220198;201812;1271;3552;1062;3281;7;19;989;3091;996;3110
220200;201812;4691;14208;4241;13603;233;841;3502;11216;3735;12057
220202;201812;2161;6130;1854;5604;32;154;1581;4676;1613;4830
220205;201812;2507;7072;2237;6627;39;168;1923;5596;1962;5764
220207;201812;769;2325;648;2112;60;209;423;1382;483;1591
220208;201812;1662;5220;1344;4574;255;917;661;2238;916;3155
220209;201812;1566;4557;1357;4204;28;132;1102;3365;1130;3497
220210;201812;1569;4101;1356;3743;17;76;1134;3030;1151;3106
220211;201812;1526;4026;1420;3884;15;60;1264;3473;1279;3533
220213;201812;1720;4680;1481;4221;29;110;1206;3312;1235;3422
220217;201812;2018;6221;1913;6092;40;135;1790;5746;1830;5881
220220;201812;9955;26687;8370;24169;539;1453;6027;17808;6566;19261
220225;201812;1085;2848;881;2584;5;22;811;2357;816;2379
220230;201812;5641;14193;4885;13160;202;533;4215;11377;4417;11910
220240;201812;2888;8608;2649;8136;92;322;2157;6608;2249;6930
220245;201812;1590;4005;1282;3608;12;60;1159;3288;1171;3348
220250;201812;2775;8142;2438;7688;23;136;2219;6945;2242;7081
220253;201812;1621;4473;1379;4044;73;224;1143;3268;1216;3492
220255;201812;1841;4582;1547;4131;34;159;1293;3295;1327;3454
220260;201812;4204;13192;3659;12228;169;621;2936;9778;3105;10399
220265;201812;1192;3972;1104;3832;50;209;889;3049;939;3258
220270;201812;6319;20006;5933;19307;279;1167;4976;15689;5255;16856
220271;201812;1447;3797;1254;3519;40;135;1101;3085;1141;3220
220272;201812;1705;4926;1508;4548;60;195;1148;3362;1208;3557
220273;201812;1192;3451;990;3073;39;148;752;2285;791;2433
220275;201812;2203;5396;1700;4688;39;145;1486;4058;1525;4203
220277;201812;2067;5376;1795;4948;27;92;1538;4161;1565;4253
220280;201812;1575;3880;1304;3492;31;95;1108;2902;1139;2997
220285;201812;1452;3811;1229;3522;16;78;1103;3116;1119;3194
220290;201812;5775;17445;4721;15953;324;1243;3548;12063;3872;13306
220300;201812;1889;5756;1564;5304;48;296;1292;4258;1340;4554
220310;201812;2875;7986;2284;7317;54;280;1910;6010;1964;6290
220320;201812;2933;8812;2320;7630;124;535;1751;5603;1875;6138
220323;201812;1574;4900;1291;4429;77;290;1035;3515;1112;3805
220325;201812;1254;3733;1071;3418;33;148;893;2797;926;2945
220327;201812;1424;4209;1263;3935;50;218;1034;3142;1084;3360
220330;201812;4061;10241;3391;9383;109;332;2927;8013;3036;8345
220335;201812;1757;5271;1558;5028;25;86;1416;4559;1441;4645
220340;201812;1794;4764;1420;4140;48;169;1018;2841;1066;3010
220342;201812;1158;3496;1031;3299;44;201;816;2574;860;2775
220345;201812;3061;7037;2456;6196;16;50;2298;5773;2314;5823
220350;201812;3308;8686;2641;7620;139;436;1948;5557;2087;5993
220360;201812;1232;3165;977;2761;20;61;792;2215;812;2276
220370;201812;8680;24967;7874;23767;181;785;7019;20866;7200;21651
220375;201812;1504;4452;1358;4259;9;31;1307;4116;1316;4147
220380;201812;1497;3629;1238;3251;24;77;1082;2799;1106;2876
220385;201812;781;1911;633;1640;12;44;551;1397;563;1441
220390;201812;8124;23077;6700;20651;1758;5353;2878;9449;4636;14802
220400;201812;1447;3574;1106;3035;31;94;840;2240;871;2334
220410;201812;1132;3169;930;2827;51;143;751;2248;802;2391
220415;201812;796;2123;675;1931;16;48;525;1479;541;1527
220420;201812;1945;5451;1583;4770;55;151;1222;3630;1277;3781
220430;201812;2482;6715;2373;6563;74;236;2095;5705;2169;5941
220435;201812;1659;4472;1460;4164;54;185;1163;3253;1217;3438
220440;201812;2360;7593;2043;7042;111;464;1698;5741;1809;6205
220450;201812;2311;6308;1912;5787;157;560;1496;4500;1653;5060
220455;201812;1301;4043;1230;3946;25;120;1096;3489;1121;3609
220460;201812;896;2302;838;2232;31;104;734;1910;765;2014
220465;201812;2314;7328;2058;6920;168;603;1545;5258;1713;5861
220470;201812;3366;9623;3026;9060;81;252;2472;7293;2553;7545
220480;201812;2476;6655;1987;5845;144;383;1438;4161;1582;4544
220490;201812;2325;6130;2107;5841;40;173;1874;5099;1914;5272
220500;201812;2475;6661;2273;6326;43;170;1926;5181;1969;5351
220510;201812;2454;7107;1991;6281;87;258;1572;4941;1659;5199
220515;201812;1650;4019;1478;3771;32;63;1307;3327;1339;3390
220520;201812;4924;12921;4427;12175;95;297;3924;10715;4019;11012
220525;201812;1266;3321;1138;3145;11;44;1038;2829;1049;2873
220527;201812;1283;3642;1134;3401;16;56;980;2972;996;3028
220530;201812;1296;3413;1153;3221;24;93;1077;2958;1101;3051
220535;201812;780;2212;718;2132;40;140;580;1700;620;1840
220540;201812;3267;10369;3064;9984;104;390;2666;8638;2770;9028
220545;201812;1339;4228;1244;4051;84;345;1029;3271;1113;3616
220550;201812;8350;25958;7538;24598;568;1985;5679;18323;6247;20308
220551;201812;1397;4142;1220;3833;36;136;984;3040;1020;3176
220552;201812;1500;4438;1254;3951;40;179;1011;3092;1051;3271
220553;201812;1540;4262;1358;3991;55;123;1095;3313;1150;3436
220554;201812;839;2263;612;1887;36;102;425;1288;461;1390
220555;201812;2000;6466;1870;6239;57;271;1514;5133;1571;5404
220556;201812;1238;3665;1058;3294;58;233;748;2224;806;2457
220557;201812;1559;4755;1320;4276;84;315;958;3017;1042;3332
220558;201812;1367;3612;1063;3184;23;105;898;2640;921;2745
220559;201812;1582;4130;1349;3764;5;30;1102;3107;1107;3137
220560;201812;1750;3999;1411;3551;36;80;1254;3154;1290;3234
220570;201812;7039;21511;6434;20601;469;1572;5117;16334;5586;17906
220580;201812;6737;19061;6239;18236;111;383;5609;16222;5720;16605
220585;201812;1882;6162;1688;5803;55;210;1398;4803;1453;5013
220590;201812;1257;3536;1048;3220;96;296;748;2303;844;2599
220595;201812;2416;6733;2222;6468;14;73;2048;5896;2062;5969
220600;201812;1393;3136;1153;2822;117;185;943;2384;1060;2569
220605;201812;1640;4797;1386;4345;26;125;1107;3375;1133;3500
220610;201812;2779;8691;2615;8460;32;141;2419;7822;2451;7963
220620;201812;7803;24598;7258;23833;208;993;6568;21299;6776;22292
220630;201812;359;1070;281;931;33;106;176;598;209;704
220635;201812;1603;5165;1420;4769;64;267;1076;3548;1140;3815
220640;201812;2594;7196;2210;6604;89;332;1817;5341;1906;5673
220650;201812;2035;5734;1700;5165;51;178;1366;4094;1417;4272
220660;201812;2585;8157;2242;7580;91;457;1860;6084;1951;6541
220665;201812;1274;3937;1101;3653;31;173;908;2944;939;3117
220667;201812;1597;5103;1425;4782;67;275;1135;3795;1202;4070
220669;201812;1649;5122;1585;5012;68;320;1354;4171;1422;4491
220670;201812;2170;5781;1746;5196;32;106;1506;4444;1538;4550
220672;201812;3066;7636;2490;6938;140;388;2149;5964;2289;6352
220675;201812;1192;3311;1093;3120;47;132;882;2493;929;2625
220680;201812;2625;7287;2505;7109;116;277;2255;6435;2371;6712
220690;201812;1452;3979;1293;3723;102;264;989;2877;1091;3141
220695;201812;856;2422;792;2302;14;49;690;1983;704;2032
220700;201812;9053;23127;7216;20523;356;1074;5561;15672;5917;16746
220710;201812;859;2437;646;2019;34;99;476;1463;510;1562
220720;201812;2045;4992;1834;4694;21;81;1580;3983;1601;4064
220730;201812;1257;3602;1063;3288;20;100;907;2732;927;2832
220735;201812;958;2286;736;1928;22;68;618;1559;640;1627
220740;201812;1365;3829;1101;3479;37;125;934;2970;971;3095
220750;201812;3654;9743;3266;9171;214;535;2828;7968;3042;8503
220755;201812;1193;3054;999;2749;28;98;796;2101;824;2199
220760;201812;2927;8622;2609;8186;106;330;2254;7164;2360;7494
220770;201812;19904;62280;17155;57304;5932;20568;5852;20259;11784;40827
220775;201812;1094;2909;1015;2807;14;53;983;2706;997;2759
220777;201812;1613;4153;1236;3542;41;114;910;2601;951;2715
220779;201812;1294;3207;1140;2992;26;84;994;2572;1020;2656
220780;201812;5663;14537;4855;13216;243;768;3914;10381;4157;11149
220785;201812;1432;3214;1281;3005;10;16;1233;2890;1243;2906
220790;201812;9955;28805;8958;27374;272;1302;7591;22752;7863;24054
220793;201812;849;2286;701;2028;22;66;575;1669;597;1735
220795;201812;1383;3660;1234;3467;23;96;1104;3059;1127;3155
220800;201812;16124;39011;13638;35458;771;2025;10055;25842;10826;27867
220810;201812;2901;8268;2499;7537;52;208;2099;6194;2151;6402
220820;201812;5083;13282;4341;12233;401;1002;3179;8983;3580;9985
220830;201812;7037;19056;6358;18054;249;787;5398;15198;5647;15985
220840;201812;11891;36988;10136;33315;2351;7398;4909;16787;7260;24185
220850;201812;2963;9476;2684;9113;59;335;2411;8079;2470;8414
220855;201812;585;1626;515;1508;13;74;447;1268;460;1342
220860;201812;1004;2526;863;2305;14;55;778;2049;792;2104
220865;201812;2528;6750;1969;5782;61;223;1522;4358;1583;4581
220870;201812;2752;8066;2290;7430;35;171;2086;6718;2121;6889
220880;201812;5062;12332;4476;11610;74;231;4143;10660;4217;10891
220885;201812;1294;4186;1104;3861;52;240;875;3061;927;3301
220887;201812;1470;3279;1233;2963;9;30;1161;2756;1170;2786
220890;201812;1406;4534;1211;4180;72;273;956;3286;1028;3559
220900;201812;1945;4799;1626;4354;35;85;1426;3779;1461;3864
220910;201812;1451;4148;1239;3830;34;110;1049;3227;1083;3337
220915;201812;948;2566;749;2172;11;42;604;1690;615;1732
220920;201812;1347;4486;1148;4206;76;346;922;3357;998;3703
220930;201812;1575;4526;1381;4224;28;107;1250;3773;1278;3880
220935;201812;1029;2975;807;2513;31;120;541;1567;572;1687
220937;201812;1328;3633;1149;3351;27;103;946;2705;973;2808
220940;201812;1428;4151;1161;3637;33;144;876;2664;909;2808
220945;201812;407;1414;365;1324;23;121;265;923;288;1044
220950;201812;1380;3270;885;2467;13;48;703;1890;716;1938
220955;201812;1544;4053;1337;3689;30;77;1159;3197;1189;3274
220960;201812;826;2098;636;1801;14;57;485;1318;499;1375
220965;201812;1740;4812;1537;4527;23;144;1320;3785;1343;3929
220970;201812;1808;4621;1388;3954;41;114;1114;3159;1155;3273
220975;201812;694;2101;607;1989;19;125;542;1685;561;1810
220980;201812;1128;3251;1023;3097;32;143;862;2562;894;2705
220985;201812;1140;3183;1024;3010;38;134;805;2261;843;2395
220987;201812;1479;4403;1264;4022;57;246;1027;3196;1084;3442
220990;201812;1659;4703;1450;4381;28;151;1189;3502;1217;3653
220995;201812;1158;3452;900;2993;47;186;642;2127;689;2313
220997;201812;2419;7089;2234;6815;52;230;2016;6054;2068;6284
221000;201812;4054;11538;3735;11059;91;449;3214;9305;3305;9754
221005;201812;1419;3862;1291;3636;42;162;1101;2970;1143;3132
221010;201812;1166;2814;953;2544;28;67;828;2179;856;2246
221020;201812;1497;4636;1363;4365;28;121;1040;3262;1068;3383
221030;201812;1527;4076;1322;3796;32;141;1155;3279;1187;3420
221035;201812;1396;3718;1221;3473;23;40;1080;3152;1103;3192
221037;201812;598;1758;513;1606;8;48;345;1021;353;1069
221038;201812;512;1459;406;1250;19;62;282;859;301;921
221039;201812;864;2350;768;2194;17;71;636;1740;653;1811
221040;201812;4045;12303;3613;11535;161;561;2891;9210;3052;9771
221050;201812;3720;10018;3330;9511;55;220;3052;8632;3107;8852
221060;201812;8208;22852;6801;20659;241;733;5448;16759;5689;17492
221062;201812;1138;3799;992;3521;47;229;799;2774;846;3003
221063;201812;1106;3194;945;2956;74;276;689;2069;763;2345
221065;201812;2560;6683;2254;6153;24;113;1999;5343;2023;5456
221070;201812;3247;10395;2715;9306;322;1120;1735;6005;2057;7125
221080;201812;3435;8450;2777;7463;52;209;2310;6089;2362;6298
221090;201812;1383;3652;1127;3206;13;49;975;2697;988;2746
221093;201812;1320;3780;1215;3565;118;340;839;2417;957;2757
221095;201812;884;2335;746;2125;6;14;618;1739;624;1753
221097;201812;811;2146;623;1802;28;92;450;1242;478;1334
221100;201812;98941;272361;85471;249898;12467;37920;53732;154094;66199;192014
221110;201812;9653;29281;8962;28368;195;1032;8005;24869;8200;25901
221120;201812;4353;12609;3954;11940;197;677;3352;10034;3549;10711
221130;201812;4855;12982;3622;10529;831;2394;1641;4777;2472;7171
221135;201812;1560;4314;1401;4094;40;145;1243;3590;1283;3735
221140;201812;1275;3094;1104;2852;11;50;986;2477;997;2527
221150;201812;1081;2695;859;2305;20;93;686;1719;706;1812
221160;201812;769;1910;675;1781;25;47;550;1455;575;1502
221170;201812;975;2875;899;2747;17;54;769;2345;786;2399
230010;201812;3095;8279;2509;7246;106;376;1945;5479;2051;5855
230015;201812;2839;9429;2572;8902;221;884;1794;6111;2015;6995
230020;201812;12663;40378;12080;39430;384;1606;10358;33379;10742;34985
230030;201812;12205;31834;10654;29633;227;650;9448;26243;9675;26893
230040;201812;4367;11499;3672;10349;92;373;3009;8332;3101;8705
230050;201812;2742;8708;1995;6854;359;1205;788;2656;1147;3861
230060;201812;2280;6301;1847;5482;44;194;1504;4366;1548;4560
230070;201812;3753;10350;3075;8991;174;592;2086;6032;2260;6624
230075;201812;8922;29138;8267;27994;349;1778;6806;22397;7155;24175
230080;201812;2902;6252;2222;5378;15;64;1979;4761;1994;4825
230090;201812;4053;10394;3496;9480;152;454;2753;7379;2905;7833
230100;201812;17199;46383;15382;43796;1432;4315;10653;30348;12085;34663
230110;201812;11965;36267;10396;33064;1792;5669;5643;18032;7435;23701
230120;201812;7141;19828;6305;18417;579;1484;4607;13689;5186;15173
230125;201812;3062;8276;2492;7326;75;282;1917;5575;1992;5857
230130;201812;5513;17403;4554;15259;578;2044;2805;9195;3383;11239
230140;201812;3306;10113;2856;9205;109;464;2173;6799;2282;7263
230150;201812;1574;4730;1322;4169;229;650;725;2375;954;3025
230160;201812;6367;16963;5546;15686;145;560;4661;12916;4806;13476
230170;201812;5792;16918;4953;15278;294;974;3658;11069;3952;12043
230180;201812;1586;4478;1356;4020;22;98;1084;3107;1106;3205
230185;201812;4080;12180;3512;11198;295;1053;2578;8185;2873;9238
230190;201812;12400;36911;10636;33570;1665;5337;5764;18266;7429;23603
230195;201812;4885;14744;4429;13872;342;1131;3427;10594;3769;11725
230200;201812;4888;13537;4185;12171;152;472;3239;9199;3391;9671
230205;201812;3862;12088;3508;11486;155;668;2707;8672;2862;9340
230210;201812;9832;24688;8404;22661;433;1378;6438;17108;6871;18486
230220;201812;12946;33804;11698;31892;498;1462;9813;26435;10311;27897
230230;201812;6727;20623;6060;19221;437;1444;4435;13955;4872;15399
230240;201812;12043;32746;10830;30759;339;1121;9110;25561;9449;26682
230250;201812;8614;25134;8440;24858;287;1028;6823;19624;7110;20652
230260;201812;13647;42663;12215;39921;1545;5204;7301;24067;8846;29271
230270;201812;7248;20182;5760;17335;553;1614;3807;11524;4360;13138
230280;201812;19759;54053;16476;48461;611;2468;13049;37007;13660;39475
230290;201812;4667;13224;3958;11822;343;910;2937;8835;3280;9745
230300;201812;4465;12436;4163;11985;69;289;3709;10485;3778;10774
230310;201812;4588;13170;3899;11968;142;587;2811;8389;2953;8976
230320;201812;7496;21815;6524;19969;297;1138;5016;15047;5313;16185
230330;201812;4533;12597;3755;11096;159;498;2815;8166;2974;8664
230340;201812;3505;11169;2985;10090;296;1035;1990;6677;2286;7712
230350;201812;17858;50284;15887;47056;1045;3577;10382;30933;11427;34510
230360;201812;2796;7799;2243;6755;145;470;1520;4535;1665;5005
230365;201812;2997;7598;2522;6845;50;241;2124;5663;2174;5904
230370;201812;52973;154527;45618;142873;8325;26511;24428;78429;32753;104940
230380;201812;6284;17628;5012;15209;159;582;3687;11002;3846;11584
230390;201812;3187;9690;2815;9067;123;509;2180;6920;2303;7429
230393;201812;2897;9029;2423;8058;87;476;1884;6003;1971;6479
230395;201812;5678;15592;4942;14310;416;1152;3391;9851;3807;11003
230400;201812;5731;16116;5049;14978;142;691;3945;11265;4087;11956
230410;201812;14105;42585;11531;37547;1112;3797;7501;24401;8613;28198
230420;201812;25740;74306;21754;66776;2705;8699;12620;38418;15325;47117
230423;201812;4646;13950;4058;12745;103;489;3285;10083;3388;10572
230425;201812;5339;16913;4873;15902;448;1499;3470;11277;3918;12776
230426;201812;2599;7008;1952;5724;43;175;1482;4251;1525;4426
230427;201812;1827;5220;1257;3931;65;218;882;2649;947;2867
230428;201812;9391;25828;8319;24178;1150;3410;5086;14728;6236;18138
230430;201812;4583;13316;3725;11810;169;626;2835;8788;3004;9414
230435;201812;5394;14850;4628;13530;522;1560;2978;8647;3500;10207
230440;201812;380532;984142;319585;889750;42983;125335;189052;522334;232035;647669
230445;201812;4213;11267;3454;9934;201;520;2420;6841;2621;7361
230450;201812;3468;10319;3053;9632;241;927;2233;6893;2474;7820
230460;201812;2032;5848;1801;5473;79;309;1479;4470;1558;4779
230465;201812;3874;11095;3311;10058;96;435;2459;7180;2555;7615
230470;201812;10917;36854;9935;34939;903;3763;7233;24954;8136;28717
230480;201812;1362;4056;1166;3701;101;399;849;2584;950;2983
230490;201812;2362;6783;2037;6176;191;628;1264;3661;1455;4289
230495;201812;5717;17322;5051;16090;451;1753;3267;10179;3718;11932
230500;201812;8607;28877;7990;27659;322;1350;6424;22133;6746;23483
230510;201812;1600;5079;1184;4106;217;790;515;1774;732;2564
230520;201812;4352;12674;3829;11662;308;957;2706;8162;3014;9119
230523;201812;13776;41547;11296;36163;2681;8557;3081;10389;5762;18946
230526;201812;3814;11076;3234;10020;151;576;2446;7431;2597;8007
230530;201812;5216;16393;4466;14951;380;1397;3127;10424;3507;11821
230533;201812;4039;10344;3481;9346;100;290;2888;7664;2988;7954
230535;201812;5174;14627;4416;13307;243;739;3172;9648;3415;10387
230540;201812;15498;43314;13670;40522;264;1137;11746;34248;12010;35385
230550;201812;19259;53005;15970;47199;1774;5467;9745;28589;11519;34056
230560;201812;7689;19589;6341;17306;83;329;5375;14472;5458;14801
230565;201812;2978;8357;2521;7513;77;325;1929;5650;2006;5975
230570;201812;3453;8831;2997;8231;59;183;2574;7028;2633;7211
230580;201812;9906;27086;8783;25444;328;1102;7381;21207;7709;22309
230590;201812;8716;25497;7267;22748;498;1771;5178;15697;5676;17468
230600;201812;3613;9567;2750;7925;89;290;1846;5370;1935;5660
230610;201812;6431;18199;5746;17101;501;1407;4377;13088;4878;14495
230620;201812;2048;5615;1558;4632;134;436;949;2746;1083;3182
230625;201812;7589;22383;6516;20317;2015;6530;1717;5651;3732;12181
230630;201812;10076;31047;8940;28644;2093;6300;4206;14243;6299;20543
230640;201812;26932;82853;24524;78879;1552;5958;19292;61218;20844;67176
230650;201812;4880;13797;4151;12460;171;692;3232;9438;3403;10130
230655;201812;9132;31891;8689;31064;688;2722;6773;24262;7461;26984
230660;201812;6033;17990;4969;16071;170;916;4041;12745;4211;13661
230670;201812;6014;14725;4420;12066;174;522;3488;9293;3662;9815
230680;201812;2476;7025;2137;6405;169;533;1493;4471;1662;5004
230690;201812;6679;20328;5928;18741;490;1727;3672;11359;4162;13086
230700;201812;9341;24603;7972;22049;344;1083;6078;16347;6422;17430
230710;201812;6676;21141;5809;19335;554;1939;4110;13461;4664;15400
230720;201812;1897;5679;1564;4969;123;369;1049;3268;1172;3637
230725;201812;3713;11577;3266;10661;502;1772;1589;5075;2091;6847
230730;201812;52680;147745;43106;132324;10134;33541;14958;48063;25092;81604
230740;201812;5981;17049;5191;15723;133;556;4156;12456;4289;13012
230750;201812;8237;22472;6905;20233;182;698;5483;15590;5665;16288
230760;201812;10828;29494;9656;27647;648;2132;7164;20017;7812;22149
230763;201812;4290;12377;3709;11260;153;633;2937;8640;3090;9273
230765;201812;39240;111035;33174;100605;6191;19476;14509;44077;20700;63553
230770;201812;24709;63800;21083;58788;2656;7750;13260;36997;15916;44747
230780;201812;5852;21141;5503;20410;848;3190;3242;12320;4090;15510
230790;201812;2886;8505;2566;7953;136;532;1916;5775;2052;6307
230800;201812;7540;24813;6811;23291;784;3002;4069;13627;4853;16629
230810;201812;11507;34966;10296;32944;441;1713;7908;24734;8349;26447
230820;201812;3161;10480;2690;9399;300;1229;1629;5428;1929;6657
230830;201812;7446;20820;6358;18873;152;650;5193;15003;5345;15653
230835;201812;4092;9960;3118;8390;100;317;2558;6738;2658;7055
230837;201812;2992;9452;2580;8668;110;532;2047;6683;2157;7215
230840;201812;8808;26461;7705;24598;590;1995;5743;18359;6333;20354
230850;201812;9086;27158;7920;24782;461;1624;5623;17409;6084;19033
230860;201812;5129;13447;4287;12187;102;364;3693;10358;3795;10722
230870;201812;16233;40332;14010;36831;457;1288;11382;29671;11839;30959
230880;201812;2021;6307;1858;6027;60;325;1474;4630;1534;4955
230890;201812;4339;14330;4024;13693;338;1284;2939;9825;3277;11109
230900;201812;2969;8847;2520;7927;234;803;1630;4978;1864;5781
230910;201812;2839;7996;2351;7163;74;365;1899;5639;1973;6004
230920;201812;4374;12608;3771;11641;149;585;2930;8829;3079;9414
230930;201812;6271;18050;5249;16035;365;1178;3637;11042;4002;12220
230940;201812;7591;20154;6716;18781;197;594;5666;15707;5863;16301
230945;201812;6467;18892;5585;17076;392;1328;3877;11753;4269;13081
230950;201812;6168;15776;5599;15043;135;308;5022;13684;5157;13992
230960;201812;12671;37747;11423;35392;1852;5854;5814;18214;7666;24068
230970;201812;12609;34954;10803;32082;2057;6296;5463;16332;7520;22628
230980;201812;2633;7834;2304;7229;475;1403;1307;4281;1782;5684
230990;201812;1680;4797;1398;4230;75;294;960;2779;1035;3073
231000;201812;2424;6524;2019;5720;71;196;1474;4091;1545;4287
231010;201812;3203;7935;2630;6960;86;284;2166;5553;2252;5837
231020;201812;7570;24688;6911;23240;1232;3902;4078;14247;5310;18149
231025;201812;7009;20273;6231;18978;858;2604;4169;12793;5027;15397
231030;201812;6944;21247;5586;18288;936;3042;2954;9682;3890;12724
231040;201812;3021;8906;2629;8158;92;363;2049;6231;2141;6594
231050;201812;11619;30800;9369;26665;660;1836;6934;19352;7594;21188
231060;201812;2587;7607;2313;7149;78;303;1879;5782;1957;6085
231070;201812;7876;23345;6705;21207;883;2830;3957;12501;4840;15331
231080;201812;3890;11366;3445;10607;130;609;2668;7949;2798;8558
231085;201812;6042;15678;5030;14435;254;746;3847;11094;4101;11840
231090;201812;4248;11391;3201;9267;112;416;2262;6326;2374;6742
231095;201812;2120;6500;1718;5594;142;497;1180;3810;1322;4307
231100;201812;2903;8687;2463;7862;140;482;1880;5963;2020;6445
231110;201812;3399;10413;3189;10016;190;685;2323;7190;2513;7875
231120;201812;2090;6364;1786;5806;103;385;1211;3887;1314;4272
231123;201812;1860;4929;1555;4367;71;193;1169;3236;1240;3429
231126;201812;5486;15392;4392;13226;228;726;3194;9435;3422;10161
231130;201812;19227;52631;16528;48961;1364;4796;11705;34189;13069;38985
231135;201812;4100;11567;3452;10367;145;521;2514;7395;2659;7916
231140;201812;16214;47013;13343;41757;727;3006;9297;28148;10024;31154
231150;201812;5272;14997;4268;12966;857;2610;1828;5633;2685;8243
231160;201812;5803;18146;5250;17074;1061;3245;2823;9520;3884;12765
231170;201812;4295;12921;3534;11358;215;770;2417;7514;2632;8284
231180;201812;13492;39362;11379;34701;2883;8740;4297;13281;7180;22021
231190;201812;3706;10682;3165;9624;112;481;2508;7379;2620;7860
231195;201812;4455;14058;3842;12761;195;799;2888;9369;3083;10168
231200;201812;7676;24682;6693;22557;248;1259;5143;16749;5391;18008
231210;201812;4616;14032;3980;12892;180;711;3040;9576;3220;10287
231220;201812;11711;31472;9259;26658;509;1547;6731;18656;7240;20203
231230;201812;8886;28567;7930;26929;513;2034;5923;20126;6436;22160
231240;201812;11281;33861;10068;31417;1669;5185;5739;18052;7408;23237
231250;201812;2037;5376;1344;3799;107;307;798;2207;905;2514
231260;201812;3163;9232;2775;8602;294;897;1831;5810;2125;6707
231270;201812;6301;16691;5251;14930;131;539;4014;11125;4145;11664
231280;201812;1612;5138;1515;4944;128;441;1115;3619;1243;4060
231290;201812;36037;110466;31114;100009;5519;17880;14414;45984;19933;63864
231300;201812;3911;11065;3113;9412;262;836;1975;5851;2237;6687
231310;201812;7056;18982;5761;16493;553;1569;3776;10676;4329;12245
231320;201812;7535;21243;5998;18362;101;470;4647;13998;4748;14468
231325;201812;2425;6697;2011;6004;307;866;1189;3610;1496;4476
231330;201812;9405;29029;7856;25853;1563;5044;4020;13594;5583;18638
231335;201812;5572;14865;4736;13476;89;426;4134;11541;4223;11967
231340;201812;17112;53901;15406;50898;1270;4247;11296;37669;12566;41916
231350;201812;15369;42358;13970;40375;318;1125;12548;35902;12866;37027
231355;201812;4351;13317;3912;12525;201;734;3036;9630;3237;10364
231360;201812;7322;22585;6405;20948;400;1433;4826;15731;5226;17164
231370;201812;2219;6029;1763;5208;42;129;1371;4002;1413;4131
231375;201812;4268;13537;3897;12880;144;672;3240;10520;3384;11192
231380;201812;5731;15764;5280;15181;203;556;4387;12784;4590;13340
231390;201812;3303;9785;2970;9224;179;665;2152;6494;2331;7159
231395;201812;3871;11754;3252;10726;566;1861;1776;5978;2342;7839
231400;201812;8942;26300;7868;24293;327;1305;6034;18244;6361;19549
231410;201812;14424;45663;12979;43146;733;2776;10276;33640;11009;36416
240010;201812;2432;6654;1880;5597;200;665;1175;3381;1375;4046
240020;201812;11217;32864;9746;30186;829;3079;6343;19235;7172;22314
240030;201812;2653;6914;2458;6620;111;337;2147;5703;2258;6040
240040;201812;800;2291;657;2028;15;73;497;1480;512;1553
240050;201812;3078;8325;2585;7427;55;160;2062;5806;2117;5966
240060;201812;1366;3712;1155;3322;32;105;935;2643;967;2748
240070;201812;2059;6230;1921;5938;199;661;1446;4397;1645;5058
240080;201812;2628;7263;2303;6676;64;254;1823;5194;1887;5448
240090;201812;2209;5559;1803;4862;21;64;1495;3975;1516;4039
240100;201812;9044;23206;7422;20149;331;1009;5763;15184;6094;16193
240110;201812;4208;12376;3681;11395;216;828;2687;8120;2903;8948
240120;201812;3486;9529;2573;8471;205;827;1706;5738;1911;6565
240130;201812;3457;7481;2940;6755;47;145;2683;6048;2730;6193
240140;201812;1916;5795;1647;5281;184;653;1093;3429;1277;4082
240145;201812;6156;17744;5194;16049;738;2368;3229;10059;3967;12427
240150;201812;855;2540;781;2394;52;189;613;1814;665;2003
240160;201812;1409;4347;1206;3932;62;294;874;2829;936;3123
240165;201812;904;2533;771;2280;67;208;577;1677;644;1885
240170;201812;2276;6445;1951;5867;216;729;1246;3604;1462;4333
240180;201812;2992;8853;2398;7666;498;1540;1204;4021;1702;5561
240185;201812;1221;3989;1103;3789;60;255;897;3030;957;3285
240190;201812;994;2985;881;2796;23;101;730;2297;753;2398
240200;201812;10262;27358;8548;24334;1082;3263;4599;12934;5681;16197
240210;201812;2843;7401;2526;6892;37;164;2122;5600;2159;5764
240220;201812;7208;22338;6506;21231;407;1746;4972;15922;5379;17668
240230;201812;5652;14624;4641;12891;243;668;3685;10205;3928;10873
240240;201812;1929;5936;1212;4081;131;431;452;1500;583;1931
240250;201812;2755;7572;2498;7196;144;402;2012;5808;2156;6210
240260;201812;13054;39711;11416;36829;1718;5405;6921;23261;8639;28666
240270;201812;2205;6597;1980;6248;109;296;1572;5076;1681;5372
240280;201812;1626;4222;1379;3843;45;122;1114;3053;1159;3175
240290;201812;1182;3489;982;3053;37;174;681;1969;718;2143
240300;201812;2129;5592;1551;4476;82;263;992;2782;1074;3045
240310;201812;8517;22984;6960;20216;895;2681;3755;10812;4650;13493
240320;201812;2001;5528;1473;4486;29;139;1114;3218;1143;3357
240325;201812;28352;78777;22184;67661;5282;16887;7464;23427;12746;40314
240330;201812;1591;4458;1276;3838;42;142;914;2625;956;2767
240340;201812;1870;4520;1543;4009;54;134;1262;3218;1316;3352
240350;201812;2001;5343;1869;5188;31;121;1673;4649;1704;4770
240360;201812;7622;21986;6829;20705;1074;3198;4257;13374;5331;16572
240370;201812;1918;5209;1511;4367;85;251;1035;2924;1120;3175
240375;201812;863;2201;735;1957;32;125;581;1462;613;1587
240380;201812;2206;6305;1630;5026;165;505;948;2873;1113;3378
240390;201812;933;2425;675;1898;17;52;454;1203;471;1255
240400;201812;1325;3400;1047;2878;33;129;735;1905;768;2034
240410;201812;534;1687;449;1493;56;227;252;800;308;1027
240420;201812;4522;16327;4012;15167;557;2469;2203;8143;2760;10612
240430;201812;3210;8719;2747;7812;226;719;1998;5488;2224;6207
240440;201812;2467;5623;2091;5085;138;318;1652;3961;1790;4279
240450;201812;4046;11426;3308;10057;323;1134;2035;5950;2358;7084
240460;201812;2835;8303;2637;7985;257;825;2083;6282;2340;7107
240470;201812;3511;10776;2764;9205;386;1326;1506;4999;1892;6325
240480;201812;530;1485;390;1193;36;119;176;520;212;639
240485;201812;2032;5961;1702;5316;169;557;1097;3410;1266;3967
240490;201812;1718;4338;1378;3731;52;119;1109;3013;1161;3132
240500;201812;2126;5759;1871;5388;41;149;1617;4615;1658;4764
240510;201812;1636;4383;1471;4151;87;282;1217;3363;1304;3645
240520;201812;1268;3327;1055;3028;38;143;855;2399;893;2542
240530;201812;1931;5965;1782;5698;105;362;1421;4511;1526;4873
240540;201812;2185;5580;1931;5191;89;220;1641;4400;1730;4620
240550;201812;651;1859;601;1766;33;116;459;1307;492;1423
240560;201812;3197;8556;2749;7955;271;711;2024;5947;2295;6658
240570;201812;2800;7444;1884;5380;250;768;842;2195;1092;2963
240580;201812;7516;22321;6859;21145;512;1619;5558;17114;6070;18733
240590;201812;672;1819;572;1644;11;44;452;1266;463;1310
240600;201812;1733;4749;1279;3802;61;224;840;2385;901;2609
240610;201812;4205;11592;3562;10404;138;482;2728;7816;2866;8298
240615;201812;1069;2984;860;2558;66;233;586;1652;652;1885
240620;201812;1836;5233;1575;4764;85;247;1255;3765;1340;4012
240630;201812;1973;5762;1779;5427;131;329;1247;3933;1378;4262
240640;201812;898;2467;728;2187;29;126;535;1564;564;1690
240650;201812;3791;10675;3353;9901;210;614;2614;7691;2824;8305
240660;201812;2783;7482;2514;7128;59;227;2286;6390;2345;6617
240670;201812;2387;6816;1975;5976;143;465;1285;3789;1428;4254
240680;201812;1587;4319;1267;3751;65;236;926;2641;991;2877
240690;201812;907;2349;723;2024;18;72;584;1575;602;1647
240700;201812;2302;6735;1924;6051;65;263;1520;4693;1585;4956
240710;201812;15605;41203;13225;37010;2243;6082;7538;21423;9781;27505
240720;201812;5003;13018;4342;11975;514;1554;2940;7919;3454;9473
240725;201812;1056;3066;818;2563;34;109;557;1700;591;1809
240730;201812;2029;5845;1737;5258;85;276;1353;4014;1438;4290
240740;201812;1818;4924;1507;4341;55;216;1134;3088;1189;3304
240750;201812;2206;7423;1852;6659;278;1093;999;3616;1277;4709
240760;201812;1493;3692;1072;3031;57;146;836;2392;893;2538
240770;201812;2982;8552;2632;8042;132;527;2115;6338;2247;6865
240780;201812;5158;14209;4108;12436;523;1570;2500;7765;3023;9335
240790;201812;833;2417;695;2145;16;65;521;1568;537;1633
240800;201812;41148;104720;33268;92379;4933;14221;16156;45031;21089;59252
240810;201812;78112;211739;68733;195578;12395;35511;39377;111861;51772;147372
240820;201812;5459;16722;4727;15420;806;2691;2705;8969;3511;11660
240830;201812;8450;25031;7759;23933;295;1313;6354;19169;6649;20482
240840;201812;1120;2870;896;2477;52;142;627;1664;679;1806
240850;201812;1210;3408;888;2716;39;131;521;1563;560;1694
240860;201812;1209;3338;923;2798;21;95;694;2011;715;2106
240870;201812;1138;2868;894;2454;84;258;613;1639;697;1897
240880;201812;1261;3981;1147;3768;90;343;910;2941;1000;3284
240890;201812;4396;12126;3368;10139;511;1652;1681;4881;2192;6533
240895;201812;2606;8427;2360;8055;176;624;1963;6682;2139;7306
240910;201812;3090;8710;2678;7904;62;217;2214;6438;2276;6655
240920;201812;780;2325;673;2121;72;229;370;1198;442;1427
240930;201812;3579;8410;3020;7723;176;238;2402;6373;2578;6611
240933;201812;1750;4206;1445;3743;46;173;1240;3147;1286;3320
240940;201812;6040;15029;4816;12955;290;841;3476;9043;3766;9884
240950;201812;912;2811;796;2574;37;159;636;2001;673;2160
240960;201812;685;2107;613;1961;40;145;466;1449;506;1594
240970;201812;1796;4739;1488;4193;52;208;1245;3396;1297;3604
240980;201812;2874;9049;2627;8572;173;686;2030;6478;2203;7164
240990;201812;2491;7279;2278;6835;263;855;1616;4723;1879;5578
241000;201812;910;2454;744;2132;38;102;519;1481;557;1583
241010;201812;2694;8733;2484;8284;193;760;1808;5889;2001;6649
241020;201812;2030;5516;1505;4419;143;421;957;2738;1100;3159
241025;201812;1716;4966;1381;4310;59;225;932;2863;991;3088
241030;201812;2410;7712;1991;6822;213;761;1304;4436;1517;5197
241040;201812;2228;7156;1995;6754;97;433;1605;5390;1702;5823
241050;201812;1237;3487;1018;3057;35;117;789;2315;824;2432
241060;201812;702;2000;627;1849;43;128;446;1285;489;1413
241070;201812;628;1750;550;1605;23;82;434;1213;457;1295
241080;201812;1098;3151;843;2632;9;41;636;1967;645;2008
241090;201812;1989;5792;1602;5127;57;283;1267;3975;1324;4258
241100;201812;1128;3234;894;2714;45;152;618;1806;663;1958
241105;201812;1015;3090;833;2738;263;870;273;939;536;1809
241110;201812;893;2607;683;2125;40;156;453;1345;493;1501
241120;201812;7221;20977;6238;19198;1141;3374;3396;10928;4537;14302
241140;201812;3174;8497;2583;7322;149;440;1901;5233;2050;5673
241142;201812;737;2018;548;1643;30;111;309;861;339;972
241150;201812;5618;15220;5025;14210;177;633;4099;11319;4276;11952
241160;201812;1299;3635;1099;3302;144;417;734;2193;878;2610
241170;201812;1265;3245;1099;2973;39;143;919;2373;958;2516
241180;201812;938;2503;694;2012;68;199;408;1149;476;1348
241190;201812;1061;2862;888;2508;25;96;661;1787;686;1883
241200;201812;17895;47991;15545;44379;2820;8193;8631;24771;11451;32964
241210;201812;1287;3603;986;2988;111;357;590;1749;701;2106
241220;201812;8433;25838;7447;24093;2004;6511;3210;10896;5214;17407
241230;201812;2839;7749;2520;7207;107;384;2109;5873;2216;6257
241240;201812;1150;3321;684;2225;43;160;330;1064;373;1224
241250;201812;5360;15958;4449;14208;180;853;3343;10217;3523;11070
241255;201812;1944;6476;1712;5964;139;598;1220;4126;1359;4724
241260;201812;4743;12642;3745;10943;92;409;2925;8315;3017;8724
241270;201812;1744;5116;1455;4553;125;459;1016;3103;1141;3562
241280;201812;2075;5345;1821;4892;77;219;1545;4109;1622;4328
241290;201812;3358;8399;2600;7140;87;327;2029;5398;2116;5725
241300;201812;1414;3886;1153;3417;43;162;773;2215;816;2377
241310;201812;1977;5189;1695;4777;21;87;1443;4071;1464;4158
241320;201812;966;3143;803;2803;91;371;501;1736;592;2107
241330;201812;1735;4504;1364;4036;31;135;1173;3453;1204;3588
241335;201812;2993;8579;2695;8030;87;307;2290;6732;2377;7039
241340;201812;1617;4718;1265;3951;273;865;523;1601;796;2466
241350;201812;1927;5675;1715;5295;108;356;1314;3990;1422;4346
241355;201812;1260;3485;1041;3062;19;65;820;2378;839;2443
241360;201812;2045;5366;1589;4461;61;192;1140;3062;1201;3254
241370;201812;1326;3731;1050;3176;67;232;689;1976;756;2208
241380;201812;631;1779;494;1503;80;235;265;812;345;1047
241390;201812;2668;8114;2436;7736;219;681;1853;5904;2072;6585
241400;201812;3442;9692;3121;9222;190;614;2543;7447;2733;8061
241410;201812;2250;6846;1867;6056;350;1189;1013;3255;1363;4444
241415;201812;1593;4751;1314;4204;85;323;940;2926;1025;3249
241420;201812;2117;7043;1812;6453;475;1840;756;2672;1231;4512
241430;201812;546;1575;382;1170;25;89;234;686;259;775
241440;201812;7030;22711;6327;21419;429;1706;4933;16430;5362;18136
241445;201812;1046;2762;965;2660;25;67;889;2494;914;2561
241450;201812;2694;6825;2359;6303;276;653;1722;4653;1998;5306
241460;201812;3520;9765;2977;8609;172;581;2112;5910;2284;6491
241470;201812;1378;3685;1107;3282;32;127;914;2682;946;2809
241475;201812;1180;3386;919;2881;28;148;681;2020;709;2168
241480;201812;2638;8459;2264;7680;823;2751;631;2473;1454;5224
241490;201812;650;1588;510;1371;25;81;349;901;374;982
241500;201812;789;2285;680;2142;12;52;601;1886;613;1938
250010;201812;2560;7731;2146;6873;75;302;1575;4911;1650;5213
250020;201812;1581;4344;1133;3453;57;154;810;2444;867;2598
250030;201812;6634;18565;5998;17580;490;1479;4594;13249;5084;14728
250040;201812;3910;12272;3433;11389;233;929;2470;8025;2703;8954
250050;201812;3397;9470;3131;9073;153;536;2584;7373;2737;7909
250053;201812;1145;3345;1048;3187;83;270;762;2340;845;2610
250057;201812;627;2320;593;2271;7;46;549;2110;556;2156
250060;201812;5113;13947;4696;13418;412;1108;3698;10738;4110;11846
250070;201812;3834;11053;3407;10299;49;226;2706;7941;2755;8167
250073;201812;711;1972;586;1775;6;19;486;1421;492;1440
250077;201812;2169;5957;1623;5019;90;310;1188;3629;1278;3939
250080;201812;4334;11632;3921;11044;95;363;3384;9390;3479;9753
250090;201812;2979;7628;2644;7165;85;233;2250;6004;2335;6237
250100;201812;3629;11332;3379;10851;143;585;2763;8623;2906;9208
250110;201812;4669;13278;4284;12710;346;1243;3342;9642;3688;10885
250115;201812;523;1534;453;1415;8;43;345;1037;353;1080
250120;201812;1797;5304;1498;4809;42;186;1191;3791;1233;3977
250130;201812;5321;15176;4573;14050;89;489;3780;11399;3869;11888
250135;201812;1121;3111;1010;2935;14;53;918;2664;932;2717
250140;201812;2058;6372;1961;6230;92;446;1713;5320;1805;5766
250150;201812;4646;14933;4241;14179;165;772;3414;11147;3579;11919
250153;201812;1438;3730;1196;3372;27;96;990;2737;1017;2833
250157;201812;1688;5144;1514;4787;100;337;1168;3642;1268;3979
250160;201812;3761;9644;3054;8665;30;114;2789;7869;2819;7983
250170;201812;1720;4507;1548;4241;37;128;1344;3624;1381;3752
250180;201812;17468;45061;15559;42479;965;2874;12040;32300;13005;35174
250190;201812;3954;10949;3390;10038;402;1110;2267;6678;2669;7788
250200;201812;1808;5037;1548;4624;47;168;1326;3935;1373;4103
250205;201812;783;2552;698;2409;20;109;577;1952;597;2061
250210;201812;1525;4644;1382;4415;47;240;1109;3453;1156;3693
250215;201812;1519;4326;1253;3875;67;217;784;2412;851;2629
250220;201812;668;1913;552;1737;27;112;403;1225;430;1337
250230;201812;1572;3670;1148;3015;24;77;927;2360;951;2437
250240;201812;2089;6512;1922;6214;41;186;1653;5268;1694;5454
250250;201812;4378;12352;3832;11552;96;331;3259;9779;3355;10110
250260;201812;1683;4722;1418;4272;43;142;1136;3397;1179;3539
250270;201812;1183;3657;1059;3506;76;255;788;2700;864;2955
250280;201812;3183;9142;2775;8496;95;326;2235;6803;2330;7129
250290;201812;1562;4167;1351;3877;24;61;1106;3190;1130;3251
250300;201812;5281;14526;4928;14106;218;956;4111;11310;4329;12266
250310;201812;1130;3184;964;2896;42;142;732;2150;774;2292
250320;201812;10038;24704;8951;23367;416;1223;7680;19788;8096;21011
250330;201812;2227;6536;1919;6110;129;429;1518;4797;1647;5226
250340;201812;1070;2821;942;2640;6;24;839;2317;845;2341
250350;201812;3914;11027;3592;10540;137;369;3001;9007;3138;9376
250355;201812;1950;6012;1761;5758;29;162;1593;5164;1622;5326
250360;201812;1759;4987;1597;4741;41;152;1316;3871;1357;4023
250370;201812;11747;31929;10139;29541;378;1457;8454;24155;8832;25612
250375;201812;1102;2928;927;2715;9;30;857;2525;866;2555
250380;201812;1585;4201;1455;4025;42;163;1222;3253;1264;3416
250390;201812;1722;4538;1453;4092;165;451;1023;2885;1188;3336
250400;201812;67097;166796;48543;138036;13928;41929;14429;42804;28357;84733
250403;201812;1591;4705;1465;4537;91;441;1152;3391;1243;3832
250407;201812;1201;3093;1000;2799;70;155;735;2089;805;2244
250410;201812;579;1616;504;1489;2;14;429;1239;431;1253
250415;201812;1828;5252;1609;4887;50;207;1343;4037;1393;4244
250420;201812;1203;3461;1087;3302;12;51;1021;3102;1033;3153
250430;201812;6000;15093;5218;13990;171;544;4373;11501;4544;12045
250435;201812;1469;4149;1230;3747;22;90;952;2835;974;2925
250440;201812;4393;11924;3858;11250;71;257;3383;9814;3454;10071
250450;201812;1765;4840;1504;4486;29;108;1259;3734;1288;3842
250460;201812;7018;19297;6379;18404;371;1139;5270;15144;5641;16283
250470;201812;1516;3913;1258;3538;60;187;970;2665;1030;2852
250480;201812;3865;10734;3420;10193;22;105;3100;9319;3122;9424
250485;201812;712;1628;514;1341;31;69;381;954;412;1023
250490;201812;4637;11871;4224;11362;210;669;3637;9626;3847;10295
250500;201812;1884;5289;1690;4962;72;235;1391;4072;1463;4307
250510;201812;5304;13492;4622;12600;83;246;4123;11242;4206;11488
250520;201812;1729;4820;1506;4494;139;428;1049;3108;1188;3536
250523;201812;2169;5380;1964;5122;86;351;1672;4222;1758;4573
250527;201812;1654;4319;1507;4144;34;98;1340;3709;1374;3807
250530;201812;578;1600;505;1497;12;40;447;1319;459;1359
250535;201812;1305;3910;1204;3713;32;145;983;2941;1015;3086
250540;201812;2817;6726;2345;6185;63;145;2047;5444;2110;5589
250550;201812;803;2608;718;2453;20;94;572;1907;592;2001
250560;201812;1607;4562;1452;4346;47;174;1223;3571;1270;3745
250570;201812;2566;7783;2223;7148;75;327;1778;5576;1853;5903
250580;201812;1020;2692;935;2562;54;184;761;2050;815;2234
250590;201812;804;2298;717;2169;17;82;597;1788;614;1870
250600;201812;7990;20818;6751;19187;323;917;5622;15937;5945;16854
250610;201812;2922;8281;2666;7908;122;455;2216;6460;2338;6915
250620;201812;679;1879;582;1700;14;64;452;1282;466;1346
250625;201812;2516;7362;2281;6990;44;230;1903;5664;1947;5894
250630;201812;9190;26358;7787;23714;860;2749;5114;15130;5974;17879
250640;201812;3231;9348;2995;9022;85;402;2542;7446;2627;7848
250650;201812;875;2191;739;2008;34;100;620;1641;654;1741
250660;201812;1588;4020;1367;3705;39;103;1162;3084;1201;3187
250670;201812;2275;7191;2112;6919;52;259;1829;5844;1881;6103
250680;201812;5772;13522;5158;12811;100;389;4681;11325;4781;11714
250690;201812;6559;15336;5765;14300;127;336;5151;12605;5278;12941
250700;201812;4153;11848;3687;11142;319;963;2786;8346;3105;9309
250710;201812;4367;12678;3789;11890;291;990;2787;8761;3078;9751
250720;201812;2691;7189;2437;6825;41;200;2177;5999;2218;6199
250730;201812;3926;10642;3475;10030;127;465;2890;8098;3017;8563
250740;201812;1900;4894;1561;4432;96;299;1242;3464;1338;3763
250750;201812;92641;240711;81536;224775;7633;22847;58480;157980;66113;180827
250760;201812;2285;6024;2012;5596;114;325;1553;4203;1667;4528
250770;201812;3743;11699;3429;11283;329;1156;2514;8251;2843;9407
250780;201812;1668;4607;1400;4104;82;281;1038;2962;1120;3243
250790;201812;2360;7178;2075;6744;233;855;1365;4375;1598;5230
250800;201812;2387;6445;2084;5966;93;211;1739;5001;1832;5212
250810;201812;1217;3328;1008;3018;29;85;866;2612;895;2697
250820;201812;1793;5395;1692;5253;51;228;1555;4763;1606;4991
250830;201812;5490;16587;4674;14980;346;1305;3266;10195;3612;11500
250840;201812;786;2514;671;2274;20;90;488;1649;508;1739
250850;201812;1802;5455;1620;5143;36;186;1354;4175;1390;4361
250855;201812;947;2783;825;2581;67;236;605;1869;672;2105
250860;201812;2879;8957;2440;8171;422;1487;1384;4639;1806;6126
250870;201812;1039;2859;889;2598;30;103;729;2101;759;2204
250880;201812;1516;4018;1251;3621;145;423;854;2485;999;2908
250890;201812;9376;26058;8651;25036;477;1994;7032;19408;7509;21402
250900;201812;2703;7891;2334;7203;78;295;1944;5869;2022;6164
250905;201812;2249;6508;2076;6241;45;183;1865;5580;1910;5763
250910;201812;5670;14486;4684;13304;115;437;3947;11195;4062;11632
250915;201812;1868;4651;1416;4162;13;36;1289;3853;1302;3889
250920;201812;3330;8716;2950;8123;360;932;2118;5776;2478;6708
250930;201812;2096;5772;1927;5532;70;261;1652;4638;1722;4899
250933;201812;1106;3390;984;3163;26;134;743;2314;769;2448
250937;201812;700;1935;596;1761;25;88;431;1275;456;1363
250939;201812;1661;4617;1477;4331;57;197;1184;3412;1241;3609
250940;201812;3758;10360;3368;9805;56;236;2911;8390;2967;8626
250950;201812;1633;4218;1329;3836;28;117;1140;3249;1168;3366
250960;201812;1046;3139;944;2978;34;152;771;2349;805;2501
250970;201812;8025;21439;6982;19728;333;1084;5520;15300;5853;16384
250980;201812;2426;6617;2182;6211;48;188;1838;5086;1886;5274
250990;201812;1849;5896;1625;5448;78;337;1228;4065;1306;4402
251000;201812;2037;5757;1686;5186;32;136;1422;4334;1454;4470
251010;201812;2556;7337;2329;6970;31;136;2110;6280;2141;6416
251020;201812;1650;4442;1511;4257;34;129;1349;3747;1383;3876
251030;201812;952;2602;827;2377;33;102;590;1646;623;1748
251040;201812;1813;5293;1552;4839;49;231;1248;3816;1297;4047
251050;201812;1076;2951;886;2589;44;139;662;1871;706;2010
251060;201812;1001;2200;756;1883;11;44;636;1551;647;1595
251065;201812;426;1178;344;1049;13;34;246;719;259;753
251070;201812;724;1964;621;1824;8;29;534;1546;542;1575
251080;201812;17970;47185;14928;42645;2072;6250;9424;26922;11496;33172
251090;201812;2666;7792;2279;7079;55;204;1845;5683;1900;5887
251100;201812;790;2475;699;2319;22;95;542;1723;564;1818
251110;201812;1652;4554;1448;4182;48;133;1135;3234;1183;3367
251120;201812;6810;20170;5892;18929;268;1128;4641;14735;4909;15863
251130;201812;3728;8853;3356;8424;184;489;2932;7327;3116;7816
251140;201812;4088;11736;3740;11240;98;382;3107;9239;3205;9621
251150;201812;2567;7583;2335;7221;100;435;1899;5708;1999;6143
251160;201812;1964;6063;1763;5745;141;479;1413;4592;1554;5071
251170;201812;1490;4182;1346;4011;37;147;1196;3538;1233;3685
251180;201812;2430;6852;2077;6345;186;605;1396;4209;1582;4814
251190;201812;4274;11370;4028;11084;52;240;3691;9968;3743;10208
251200;201812;3947;12169;3635;11775;86;358;3205;10419;3291;10777
251203;201812;914;3007;865;2901;30;141;676;2197;706;2338
251207;201812;1002;2903;799;2533;21;97;579;1771;600;1868
251210;201812;7145;18916;5895;17318;249;710;4634;13716;4883;14426
251220;201812;1133;2837;889;2487;53;144;698;1966;751;2110
251230;201812;4445;12342;3935;11560;125;502;3229;9243;3354;9745
251240;201812;3492;9739;2943;8900;162;523;2226;6590;2388;7113
251250;201812;9486;26245;8510;24688;847;2483;6217;17555;7064;20038
251260;201812;463;1399;424;1321;14;72;329;987;343;1059
251270;201812;3973;12647;3610;12158;105;462;3089;10468;3194;10930
251272;201812;1297;3608;1187;3445;35;143;1031;2918;1066;3061
251274;201812;866;2490;712;2212;48;177;495;1469;543;1646
251275;201812;1196;3360;1033;3099;41;181;771;2207;812;2388
251276;201812;1285;3476;1145;3291;35;171;955;2639;990;2810
251278;201812;548;1583;492;1488;41;104;367;1120;408;1224
251280;201812;2161;6091;1947;5753;48;204;1609;4643;1657;4847
251290;201812;5474;13756;5137;13298;220;789;4465;11086;4685;11875
251300;201812;785;2410;732;2328;11;47;621;1968;632;2015
251310;201812;2715;7861;2389;7329;62;295;1931;5782;1993;6077
251315;201812;1643;5240;1515;5016;71;264;1169;3805;1240;4069
251320;201812;1618;4319;1136;3483;34;124;832;2526;866;2650
251330;201812;1951;4674;1616;4268;21;74;1498;3970;1519;4044
251335;201812;982;3075;905;2961;30;122;770;2465;800;2587
251340;201812;3533;8914;2849;7990;126;418;2123;5838;2249;6256
251350;201812;1039;3106;938;2942;29;140;789;2392;818;2532
251360;201812;1775;5140;1478;4738;22;107;1286;4122;1308;4229
251365;201812;686;1968;554;1685;13;42;430;1304;443;1346
251370;201812;21147;59560;19235;56860;2890;8641;12525;37447;15415;46088
251380;201812;1170;3401;1042;3188;24;129;885;2602;909;2731
251385;201812;704;1838;553;1563;21;68;417;1128;438;1196
251390;201812;6056;18458;5305;17164;731;2526;3144;10042;3875;12568
251392;201812;929;2609;780;2370;25;124;611;1814;636;1938
251394;201812;578;1747;480;1567;23;91;357;1140;380;1231
251396;201812;684;1878;584;1714;24;63;405;1176;429;1239
251398;201812;892;2341;648;1888;18;76;491;1394;509;1470
251400;201812;1143;2949;944;2666;28;103;735;1999;763;2102
251410;201812;1536;3693;1292;3344;22;106;1112;2781;1134;2887
251420;201812;1849;5036;1528;4658;44;185;1203;3612;1247;3797
251430;201812;1498;4722;1351;4480;37;178;1172;3842;1209;4020
251440;201812;1078;3083;879;2708;25;95;702;2148;727;2243
251445;201812;1464;4245;1372;4112;55;231;1144;3305;1199;3536
251450;201812;4184;12703;3826;12175;92;390;3227;10148;3319;10538
251455;201812;887;2709;808;2564;29;115;621;1936;650;2051
251460;201812;881;2571;784;2415;25;99;653;2002;678;2101
251465;201812;416;1249;356;1116;8;35;283;872;291;907
251470;201812;1140;3214;860;2622;75;242;525;1528;600;1770
251480;201812;925;2500;780;2255;18;84;590;1637;608;1721
251490;201812;1840;5012;1478;4507;56;200;1091;3308;1147;3508
251500;201812;1838;5439;1715;5238;60;237;1487;4477;1547;4714
251510;201812;2582;8016;2182;7196;153;567;1443;4658;1596;5225
251520;201812;924;2452;706;2025;72;192;467;1321;539;1513
251530;201812;13406;33359;11444;30864;126;674;10225;27081;10351;27755
251540;201812;2715;8198;2507;7806;106;408;2042;6237;2148;6645
251550;201812;3556;8664;2823;7716;78;218;2409;6549;2487;6767
251560;201812;567;1715;507;1625;81;271;320;982;401;1253
251570;201812;881;2569;735;2268;20;96;567;1679;587;1775
251580;201812;1847;4529;1645;4233;72;233;1416;3521;1488;3754
251590;201812;1560;4081;1348;3824;60;198;1088;2988;1148;3186
251593;201812;879;2659;820;2556;89;299;523;1578;612;1877
251597;201812;2041;5793;1876;5575;35;127;1648;4820;1683;4947
251600;201812;6180;17082;5536;16098;168;545;4669;13351;4837;13896
251610;201812;3200;9224;2761;8421;299;873;1883;5795;2182;6668
251615;201812;1189;3040;964;2670;27;69;764;2083;791;2152
251620;201812;17252;41331;13942;37400;152;424;12106;33166;12258;33590
251630;201812;4512;10935;3660;9752;202;614;2883;7570;3085;8184
251640;201812;1997;5803;1845;5522;52;236;1580;4616;1632;4852
251650;201812;4002;10693;3503;10055;136;461;3049;8697;3185;9158
251660;201812;3367;10160;2974;9460;80;386;2495;7749;2575;8135
251670;201812;4020;11475;3501;10720;49;244;3211;9701;3260;9945
251675;201812;634;1888;576;1814;86;306;377;1166;463;1472
251680;201812;2492;6855;2088;6281;50;188;1700;5081;1750;5269
251690;201812;3082;8844;2663;8064;80;253;2020;5993;2100;6246
251700;201812;1857;5691;1694;5478;45;212;1454;4605;1499;4817
251710;201812;790;2086;538;1558;48;175;309;870;357;1045
251720;201812;1313;3742;1084;3335;29;127;818;2420;847;2547
251740;201812;616;1747;495;1513;33;116;358;1055;391;1171
260005;201812;28651;61357;23575;54826;1778;4282;17966;40900;19744;45182
260010;201812;9554;25334;7964;22954;458;1394;4947;14442;5405;15836
260020;201812;6659;16055;5694;14652;138;597;4729;11942;4867;12539
260030;201812;6304;16884;5410;15504;197;683;4317;12252;4514;12935
260040;201812;7690;21142;6383;19076;622;1949;4228;12723;4850;14672
260050;201812;12623;34668;11314;33144;285;933;10068;29848;10353;30781
260060;201812;3834;10009;3304;9132;210;575;2587;7124;2797;7699
260070;201812;10049;26172;8671;24117;479;1611;6719;18253;7198;19864
260080;201812;6371;14917;5591;13779;156;492;4684;11296;4840;11788
260090;201812;4845;12627;4355;11981;695;1903;2918;8100;3613;10003
260100;201812;3094;8398;2610;7659;88;347;2122;6109;2210;6456
260105;201812;5126;13818;4558;13011;157;584;3751;10488;3908;11072
260110;201812;22120;60213;19925;57102;1130;3598;16428;46336;17558;49934
260120;201812;13724;38028;11614;34674;1570;4773;7188;21807;8758;26580
260130;201812;2916;7839;2646;7406;221;679;1956;5347;2177;6026
260140;201812;12896;29990;11075;27702;582;1603;9204;22718;9786;24321
260150;201812;3465;8363;2971;7752;130;416;2511;6426;2641;6842
260160;201812;6457;17248;5506;16014;105;402;4853;14219;4958;14621
260170;201812;17592;44876;15209;41469;1579;4188;11163;30424;12742;34612
260180;201812;3220;9099;2861;8596;110;394;2392;7062;2502;7456
260190;201812;18096;37427;15311;34153;188;532;13473;29462;13661;29994
260200;201812;10837;26623;9473;24901;503;1173;8050;21330;8553;22503
260210;201812;11711;33691;9974;30877;375;1436;7950;24433;8325;25869
260220;201812;10033;24922;9316;24007;186;638;8234;20932;8420;21570
260230;201812;10129;25966;8871;24211;246;770;7374;19805;7620;20575
260240;201812;2681;8061;2358;7492;171;587;1813;5725;1984;6312
260250;201812;2133;5758;1850;5341;97;298;1416;4020;1513;4318
260260;201812;12533;33418;11045;31115;510;1745;8636;23827;9146;25572
260270;201812;3789;9868;3348;9294;145;633;2692;7231;2837;7864
260280;201812;12710;39059;11483;37312;545;2242;9714;31170;10259;33412
260290;201812;37187;98807;32449;91573;4125;12041;21021;58758;25146;70799
260300;201812;9239;25585;8094;23941;250;1093;6713;19654;6963;20747
260310;201812;4567;12290;4101;11664;381;1039;3096;8934;3477;9973
260320;201812;7189;21296;6410;19937;282;879;5250;16366;5532;17245
260330;201812;2449;7622;2203;7118;70;262;1787;5647;1857;5909
260340;201812;2002;5433;1736;5021;30;140;1479;4170;1509;4310
260345;201812;23301;63477;19903;58283;3670;11529;9560;27288;13230;38817
260350;201812;5004;12428;4452;11734;105;323;3924;10261;4029;10584
260360;201812;2432;6476;2214;6085;51;220;1545;4165;1596;4385
260370;201812;5348;15637;4623;14378;220;775;3549;10966;3769;11741
260380;201812;4770;14512;4157;13505;194;703;3100;9931;3294;10634
260390;201812;4173;12841;3564;11593;231;810;2465;7877;2696;8687
260392;201812;3396;10914;3022;10429;122;696;2445;8395;2567;9091
260400;201812;15567;38379;13755;35951;684;2054;10740;27140;11424;29194
260410;201812;64185;163505;51216;144852;10573;31526;22733;65637;33306;97163
260415;201812;4108;11432;3509;10354;93;430;2701;7681;2794;8111
260420;201812;12496;26811;10643;24717;198;559;9547;21922;9745;22481
260430;201812;2775;8628;2389;7893;132;495;1663;5445;1795;5940
260440;201812;3519;9595;3065;8794;115;414;2465;6898;2580;7312
260450;201812;5550;14367;5051;13740;290;688;4172;11497;4462;12185
260460;201812;5012;15535;4355;14251;539;1983;2541;8103;3080;10086
260470;201812;4891;12953;4162;12090;111;279;3757;11108;3868;11387
260480;201812;4021;10814;3393;9919;312;1101;2281;6683;2593;7784
260490;201812;5186;12328;4581;11383;61;232;4086;9928;4147;10160
260500;201812;5944;15419;5073;14123;484;1267;3502;9859;3986;11126
260510;201812;9227;23066;7862;21164;161;563;6924;18404;7085;18967
260515;201812;4218;11934;3273;10082;161;550;2175;6545;2336;7095
260520;201812;17176;40728;15220;38120;986;2570;12206;30194;13192;32764
260530;201812;9415;27557;8181;25592;194;879;6964;21511;7158;22390
260540;201812;6935;15378;6170;14414;401;855;5282;12360;5683;13215
260545;201812;35;104;14;59;3;11;4;18;7;29
260550;201812;2766;8092;2350;7343;152;661;1543;4672;1695;5333
260560;201812;5913;15312;5077;14106;132;577;4265;11529;4397;12106
260570;201812;7317;20849;6523;19712;492;1583;5047;15211;5539;16794
260580;201812;4292;10507;3840;9877;35;147;3502;8922;3537;9069
260590;201812;6634;15757;5634;14606;284;712;4625;12114;4909;12826
260600;201812;29185;78005;24143;70136;1409;4431;17866;51199;19275;55630
260610;201812;6812;18553;6225;17734;428;1365;4669;13117;5097;14482
260620;201812;14949;41053;13311;38591;1578;5002;8994;25602;10572;30604
260630;201812;2296;6314;1911;5685;41;176;1555;4521;1596;4697
260640;201812;19677;46874;16939;43615;944;2670;13405;34065;14349;36735
260650;201812;5485;15506;4661;14344;172;735;3925;11918;4097;12653
260660;201812;7164;19230;6209;17957;179;758;5255;14865;5434;15623
260670;201812;2168;5710;1794;5153;82;210;1316;3743;1398;3953
260680;201812;24677;61440;20905;55747;1920;5416;13669;35772;15589;41188
260690;201812;3555;9246;2934;8307;121;418;2343;6543;2464;6961
260700;201812;5853;17233;5560;16884;21;61;5415;16559;5436;16620
260710;201812;1279;3440;1173;3308;49;164;888;2527;937;2691
260720;201812;20244;54761;17976;51488;2693;7966;11446;32502;14139;40468
260730;201812;7138;21382;6338;20218;329;1231;5233;16419;5562;17650
260740;201812;1308;3687;1100;3351;24;126;871;2634;895;2760
260750;201812;6726;19181;5881;18059;117;393;5281;16417;5398;16810
260760;201812;5469;13267;4749;12345;223;639;3853;10070;4076;10709
260765;201812;7443;22607;6599;21369;579;2403;4521;14190;5100;16593
260770;201812;3736;9793;3208;8904;91;306;2548;6969;2639;7275
260775;201812;5055;13802;4552;13040;242;920;3474;9617;3716;10537
260780;201812;3535;10747;3167;10125;319;1196;1987;6159;2306;7355
260790;201812;110895;256285;93305;232575;15205;37213;56603;140983;71808;178196
260795;201812;2977;8056;2580;7485;123;421;1958;5675;2081;6096
260800;201812;5365;12581;4836;11814;179;544;4260;10085;4439;10629
260805;201812;3509;10274;2966;9308;182;671;2124;6540;2306;7211
260810;201812;6431;17701;5758;16431;569;1594;4113;11516;4682;13110
260820;201812;4296;10473;3810;9812;184;632;3064;7641;3248;8273
260825;201812;2826;8659;2462;7997;129;480;1826;5889;1955;6369
260830;201812;4216;12454;3511;11156;485;1412;2252;7353;2737;8765
260840;201812;3952;10767;3531;10152;173;526;2955;8426;3128;8952
260845;201812;3988;10915;3626;10282;262;749;2687;7541;2949;8290
260850;201812;4661;13560;4020;12300;410;1322;2506;7470;2916;8792
260860;201812;3314;9619;2850;8787;108;391;2309;6980;2417;7371
260870;201812;4389;10742;3825;10036;105;420;3380;8671;3485;9091
260875;201812;6518;17113;5454;15452;654;1862;3628;10267;4282;12129
260880;201812;9498;27013;8375;25040;431;1289;6696;20097;7127;21386
260890;201812;12966;34411;11545;32308;904;2776;8197;22421;9101;25197
260900;201812;5060;14846;4292;13613;328;1204;2892;9034;3220;10238
260910;201812;3122;8679;2729;8059;98;354;2146;6253;2244;6607
260915;201812;5037;14973;4460;14262;82;348;4071;13022;4153;13370
260920;201812;3263;8574;2837;8058;106;326;2420;6862;2526;7188
260930;201812;3367;11094;2977;10349;163;677;2348;8023;2511;8700
260940;201812;14240;35003;12461;32377;918;2612;9288;23606;10206;26218
260950;201812;6263;17639;5089;15404;522;1811;2941;8432;3463;10243
260960;201812;62476;146894;50825;131040;6869;18637;30385;77094;37254;95731
260970;201812;5047;13912;4560;13250;157;420;3571;10431;3728;10851
260980;201812;4340;13043;3925;12499;66;256;3575;11436;3641;11692
260990;201812;17155;49430;14782;46137;843;3026;11439;35343;12282;38369
261000;201812;15559;38399;13292;35286;526;1927;10393;26962;10919;28889
261010;201812;2401;6341;2132;5982;75;207;1868;5245;1943;5452
261020;201812;6108;16875;5226;15261;291;966;4131;11655;4422;12621
261030;201812;4059;11446;3525;10550;178;558;2795;8240;2973;8798
261040;201812;5058;15188;4156;13387;197;775;3025;9556;3222;10331
261050;201812;7512;20301;6802;19093;615;1469;4739;13436;5354;14905
261060;201812;13187;34399;11714;32447;461;1465;9599;26309;10060;27774
261070;201812;57206;128187;47775;115486;3438;7837;35370;84605;38808;92442
261080;201812;5897;15293;5507;14748;178;497;5032;13466;5210;13963
261090;201812;17586;43745;15808;41395;410;1359;13570;35028;13980;36387
261100;201812;7935;22865;6919;21333;605;2025;4951;15273;5556;17298
261110;201812;56972;164499;48518;150166;9568;31127;25083;77824;34651;108951
261120;201812;3723;9389;3191;8676;85;258;2807;7612;2892;7870
261130;201812;7375;17937;6520;16829;106;340;5847;14953;5953;15293
261140;201812;3421;8202;3083;7758;208;579;2462;6064;2670;6643
261150;201812;5124;13879;4539;12957;94;374;3918;10998;4012;11372
261153;201812;1910;5670;1648;5231;75;292;1139;3586;1214;3878
261160;201812;197670;473946;164241;426851;42314;114230;64778;170772;107092;285002
261170;201812;5769;14906;5174;14008;354;933;4068;10946;4422;11879
261180;201812;9614;24743;8566;23359;522;1548;6200;16770;6722;18318
261190;201812;4597;13869;4150;13108;275;1124;3073;9367;3348;10491
261200;201812;3296;7721;2940;7247;166;432;2431;5889;2597;6321
261210;201812;1887;4636;1600;4226;62;188;1369;3568;1431;3756
261220;201812;13290;38808;11122;34609;1475;5000;6277;19302;7752;24302
261230;201812;4194;12082;3508;11148;71;305;2920;9342;2991;9647
261240;201812;4992;13083;4411;12166;253;683;3616;9897;3869;10580
261245;201812;3449;9982;2963;9125;96;441;2344;6950;2440;7391
261247;201812;2871;8695;2426;7870;163;605;1666;5330;1829;5935
261250;201812;19929;47375;17397;44379;2006;4768;12687;33195;14693;37963
261255;201812;3926;11797;3341;10661;155;695;2482;7618;2637;8313
261260;201812;12764;34558;11052;32360;413;1654;9386;27158;9799;28812
261270;201812;3832;10293;3431;9732;212;718;2799;7742;3011;8460
261280;201812;2507;7170;2217;6654;78;313;1744;5090;1822;5403
261290;201812;2887;7731;2478;7231;88;358;2010;5877;2098;6235
261300;201812;11554;33491;9888;30563;621;2336;7057;21326;7678;23662
261310;201812;8158;21767;7002;20071;874;2731;4759;13267;5633;15998
261320;201812;5839;16736;5114;15476;93;400;4285;12725;4378;13125
261330;201812;5849;14775;5334;14076;182;626;4627;11983;4809;12609
261340;201812;4079;12085;3546;11331;199;800;2770;8732;2969;9532
261350;201812;8324;24970;7564;23687;123;619;6217;19066;6340;19685
261360;201812;8122;20131;6896;18386;270;853;5495;14200;5765;15053
261370;201812;20459;53829;17587;49765;2667;7511;10643;30370;13310;37881
261380;201812;3836;12065;3466;11382;469;1705;2269;7304;2738;9009
261390;201812;15669;45840;13413;42076;1316;4460;8685;27116;10001;31576
261400;201812;4518;14607;3952;13428;169;801;2926;9660;3095;10461
261410;201812;9099;23691;7656;21360;528;1463;6038;16700;6566;18163
261420;201812;6968;21841;6374;21070;902;3418;4237;13853;5139;17271
261430;201812;3334;9564;2796;8743;89;357;2297;7074;2386;7431
261440;201812;1421;4329;1231;3963;45;227;867;2691;912;2918
261450;201812;14392;39650;12980;37334;241;981;10893;31087;11134;32068
261460;201812;7197;20051;6481;19027;210;746;5480;15982;5690;16728
261470;201812;4178;10584;3687;9922;43;199;3159;8495;3202;8694
261480;201812;4819;15164;4182;14077;236;962;3181;10466;3417;11428
261485;201812;4884;14044;4214;12976;386;1353;2880;8664;3266;10017
261500;201812;5485;14673;4848;13777;493;1256;3301;9738;3794;10994
261510;201812;1811;5543;1569;5105;67;249;1153;3780;1220;4029
261520;201812;2357;7265;2204;6961;75;273;1554;4969;1629;5242
261530;201812;10787;33061;8998;29612;1344;5023;4070;12995;5414;18018
261540;201812;7547;22208;6812;21054;1149;3498;3833;12314;4982;15812
261550;201812;3517;9482;3092;8795;233;734;2188;6094;2421;6828
261560;201812;7517;22855;6576;21446;398;1566;4886;15838;5284;17404
261570;201812;3342;9230;2744;8266;216;791;1872;5515;2088;6306
261580;201812;6454;17306;5733;16333;123;569;5159;14455;5282;15024
261590;201812;2635;6899;2125;6146;88;267;1583;4561;1671;4828
261600;201812;5036;13116;4240;11926;425;1106;2819;8192;3244;9298
261610;201812;2352;6452;1973;5846;103;378;1448;4263;1551;4641
261618;201812;2514;6460;2227;6054;81;236;1757;4719;1838;4955
261620;201812;3892;11457;3627;11058;839;2360;2179;6955;3018;9315
261630;201812;6328;17922;5416;16226;432;1610;3525;9976;3957;11586
261640;201812;35261;81479;30770;75844;1679;3643;24167;60699;25846;64342
261650;201812;4049;10336;3579;9738;146;526;2660;7154;2806;7680
270010;201812;4168;14536;3707;13695;186;1057;2881;10313;3067;11370
270020;201812;3784;9808;3362;9243;208;648;2765;7430;2973;8078
270030;201812;33137;92436;28719;85373;4272;12513;18559;55594;22831;68107
270040;201812;11093;30119;9610;28329;447;1772;7900;22950;8347;24722
270050;201812;5413;12598;4610;11699;170;430;4089;10408;4259;10838
270060;201812;1982;5232;1708;4889;135;378;1358;3913;1493;4291
270070;201812;4500;13015;3973;12267;152;655;3341;10091;3493;10746
270080;201812;1403;3942;1172;3532;54;177;880;2544;934;2721
270090;201812;1850;5732;1647;5336;72;322;1298;4067;1370;4389
270100;201812;5404;14927;4742;13912;227;892;3819;10913;4046;11805
270110;201812;3222;7924;2575;7154;137;369;2023;5801;2160;6170
270120;201812;2967;8039;2578;7541;75;299;2235;6487;2310;6786
270130;201812;5102;13620;4476;12889;183;583;3764;10892;3947;11475
270135;201812;1978;4882;1713;4574;56;172;1550;4106;1606;4278
270140;201812;9598;22418;7916;20117;527;1576;6275;15268;6802;16844
270150;201812;2655;8051;2512;7852;10;35;2450;7653;2460;7688
270160;201812;5489;15951;4854;15186;64;401;4476;13804;4540;14205
270170;201812;3394;10126;2932;9485;228;1000;2160;6723;2388;7723
270180;201812;2218;6904;2025;6644;45;209;1787;5768;1832;5977
270190;201812;1627;4951;1468;4740;60;261;1253;3997;1313;4258
270200;201812;2412;7352;2060;6858;128;506;1528;4965;1656;5471
270210;201812;5545;13573;4843;12768;144;518;4382;11368;4526;11886
270220;201812;1391;3863;1157;3526;224;723;626;1884;850;2607
270230;201812;8883;25863;7532;23721;748;2729;5167;15919;5915;18648
270235;201812;5753;17985;5058;16804;169;722;4133;13600;4302;14322
270240;201812;10233;28323;8457;26052;980;3336;6074;18610;7054;21946
270250;201812;2832;7333;2507;6883;272;679;1877;5243;2149;5922
270255;201812;4554;13188;3488;11191;166;685;2512;7876;2678;8561
270260;201812;5507;16557;5059;15828;119;597;4374;13267;4493;13864
270270;201812;1002;2707;895;2567;126;363;620;1758;746;2121
270280;201812;3780;9352;3047;8412;441;771;2146;6333;2587;7104
270290;201812;7607;24468;6897;23292;253;1144;5871;19550;6124;20694
270300;201812;4032;10969;3191;10048;184;595;2422;7747;2606;8342
270310;201812;6918;19620;6006;18265;150;759;5088;15022;5238;15781
270320;201812;5495;16204;4845;14997;576;1891;3379;10179;3955;12070
270330;201812;3707;12466;3374;11964;261;1042;2637;9305;2898;10347
270340;201812;1617;4575;1378;4250;66;202;1115;3422;1181;3624
270350;201812;1832;4499;1531;4134;201;586;1037;2824;1238;3410
270360;201812;2371;6282;2151;6023;70;188;1969;5537;2039;5725
270370;201812;1382;4325;1254;4084;46;195;1013;3254;1059;3449
270375;201812;3023;7270;2589;6767;19;55;2411;6310;2430;6365
270380;201812;5522;16279;4720;15186;442;1489;3292;10806;3734;12295
270390;201812;1168;3034;966;2777;23;120;799;2257;822;2377
270400;201812;6027;16493;5164;15135;232;760;4000;11448;4232;12208
270410;201812;4434;13305;3922;12429;208;777;3162;9860;3370;10637
270420;201812;5477;16502;5004;15818;174;756;4224;13067;4398;13823
270430;201812;132825;331521;107022;297941;22760;66322;48495;137183;71255;203505
270440;201812;4726;13035;4057;12198;107;491;3436;10179;3543;10670
270450;201812;6645;18541;5983;17732;264;1013;5018;14705;5282;15718
270460;201812;3604;8286;3176;7773;45;198;2971;7124;3016;7322
270470;201812;10594;30892;9369;29076;876;2857;6876;21429;7752;24286
270480;201812;2766;7664;2406;7117;144;551;1918;5482;2062;6033
270490;201812;947;2737;836;2599;47;174;660;2019;707;2193
270500;201812;4779;14954;4337;14313;221;904;3519;11492;3740;12396
270510;201812;5503;15265;4772;14267;429;1636;3451;9803;3880;11439
270520;201812;3885;11398;3098;10020;719;2407;1155;3928;1874;6335
270530;201812;1169;3517;1032;3294;65;201;760;2451;825;2652
270540;201812;2089;6331;1858;6024;65;323;1604;5091;1669;5414
270550;201812;6540;17569;5410;16309;516;1389;4105;12783;4621;14172
270560;201812;3054;8319;2712;7841;170;535;2114;6008;2284;6543
270570;201812;3959;11298;3383;10400;155;525;2746;8352;2901;8877
270580;201812;2224;6433;2050;6172;107;325;1765;5291;1872;5616
270590;201812;1604;4804;1486;4647;13;68;1411;4394;1424;4462
270600;201812;2684;8453;2440;8053;66;341;2142;6943;2208;7284
270610;201812;3643;9676;3087;8955;91;342;2726;7799;2817;8141
270620;201812;1218;3818;1121;3640;45;192;945;2982;990;3174
270630;201812;15461;40994;13691;38351;824;2699;11151;30698;11975;33397
270640;201812;5357;15566;4676;14530;192;815;3752;11294;3944;12109
270642;201812;2381;7857;2139;7457;140;704;1660;5552;1800;6256
270644;201812;3452;8766;2850;7983;233;630;2149;6128;2382;6758
270650;201812;3146;9444;2821;8970;429;1554;1890;5797;2319;7351
270660;201812;2108;5249;1704;4682;69;266;1294;3467;1363;3733
270670;201812;15192;37279;13064;34681;596;1798;10949;28674;11545;30472
270680;201812;5153;13068;4641;12486;142;229;4316;11793;4458;12022
270690;201812;8971;22669;7523;20896;1044;2717;5324;14931;6368;17648
270700;201812;538;1637;466;1507;37;154;336;1062;373;1216
270710;201812;5570;16948;5107;16284;253;1100;4233;13169;4486;14269
270720;201812;3278;10098;2941;9535;81;476;2574;8102;2655;8578
270730;201812;7605;18067;6922;17302;343;894;5561;14905;5904;15799
270740;201812;2315;6225;2072;5917;107;367;1700;4743;1807;5110
270750;201812;5331;14733;4721;13906;179;684;4023;11731;4202;12415
270760;201812;3264;9349;2866;8776;62;311;2460;7419;2522;7730
270770;201812;20773;51195;16450;45865;3083;8025;9230;27479;12313;35504
270780;201812;1712;5120;1614;4982;88;325;1358;4143;1446;4468
270790;201812;1516;4456;1308;4147;113;382;880;2776;993;3158
270800;201812;10427;29334;9390;27863;385;1579;8039;23230;8424;24809
270810;201812;3182;9359;2520;8184;190;771;1725;5466;1915;6237
270820;201812;1658;5034;1401;4600;74;292;1089;3495;1163;3787
270830;201812;5246;12889;4310;11715;192;679;3451;9246;3643;9925
270840;201812;8041;24137;7246;23009;199;1098;6360;19606;6559;20704
270850;201812;8610;21529;7796;20504;535;1720;6524;16673;7059;18393
270860;201812;11956;29349;9946;26920;493;1575;8104;21527;8597;23102
270870;201812;2006;5827;1741;5368;219;717;1207;3755;1426;4472
270880;201812;7862;23917;7106;22803;230;1026;5925;18653;6155;19679
270890;201812;2579;7182;2238;6701;173;594;1605;4718;1778;5312
270895;201812;2857;9422;2660;9157;82;459;2359;7922;2441;8381
270900;201812;1793;4704;1382;4053;55;193;1072;3082;1127;3275
270910;201812;3700;11063;3206;10221;105;421;2500;7843;2605;8264
270915;201812;8906;26942;7476;24447;823;3163;4919;15582;5742;18745
270920;201812;5294;16650;4884;15976;228;1059;3983;12600;4211;13659
270930;201812;16846;40650;13317;36457;2002;5085;8941;25254;10943;30339
270940;201812;5928;16970;5262;16125;245;1143;4137;12294;4382;13437
280010;201812;666;1827;557;1618;23;98;380;998;403;1096
280020;201812;4572;12141;3974;11180;562;1491;2608;7406;3170;8897
280030;201812;69722;169030;55347;148582;13825;37789;22191;62132;36016;99921
280040;201812;2997;8542;2634;7990;306;975;1761;5291;2067;6266
280050;201812;3797;10983;3300;10139;538;1723;1956;5992;2494;7715
280060;201812;5188;14286;4193;12742;765;2400;2103;6598;2868;8998
280067;201812;6828;17451;5775;15831;396;1177;4147;11121;4543;12298
280070;201812;1843;5678;1743;5496;91;328;1467;4543;1558;4871
280100;201812;3648;10287;3149;9458;343;1084;2179;6518;2522;7602
280110;201812;1311;3690;1158;3433;23;104;1009;2904;1032;3008
280120;201812;7362;21974;6687;20847;708;2048;5032;15906;5740;17954
280130;201812;8617;21194;7624;19760;599;1638;5885;15204;6484;16842
280140;201812;5411;13412;4793;12577;247;698;4024;10482;4271;11180
280150;201812;3833;10013;3396;9441;224;631;2746;7565;2970;8196
280160;201812;1186;3500;978;3128;130;435;607;1891;737;2326
280170;201812;5093;13604;4560;12891;245;685;3776;10670;4021;11355
280190;201812;1166;2703;1001;2466;53;144;806;1932;859;2076
280200;201812;1288;3443;1043;3042;100;373;729;2045;829;2418
280210;201812;14979;39460;13243;36994;1923;5687;8005;22328;9928;28015
280220;201812;1702;4636;1478;4338;41;216;1226;3561;1267;3777
280230;201812;3721;9780;3339;9234;258;679;2451;6734;2709;7413
280240;201812;3362;9056;3037;8556;65;315;2579;7064;2644;7379
280250;201812;792;2071;651;1852;72;233;384;1019;456;1252
280260;201812;2062;5172;1873;4926;44;131;1737;4568;1781;4699
280270;201812;2242;6480;2010;6108;124;455;1687;5001;1811;5456
280280;201812;3886;12307;3518;11766;476;1448;2380;8292;2856;9740
280290;201812;16518;45436;14564;42636;2038;6251;9290;27499;11328;33750
280300;201812;10822;27762;9418;26223;286;972;7440;21798;7726;22770
280310;201812;1317;3513;1103;3144;31;110;830;2286;861;2396
280320;201812;8280;23196;7225;21550;858;2627;4806;14163;5664;16790
280330;201812;4694;11863;3992;10831;276;766;2965;7952;3241;8718
280340;201812;5379;11242;4586;10371;236;468;3982;9089;4218;9557
280350;201812;23598;58215;20619;53992;1514;4206;15639;40374;17153;44580
280360;201812;5658;16298;5003;15158;876;2656;2769;8471;3645;11127
280370;201812;2154;5346;1765;4649;74;207;1433;3705;1507;3912
280380;201812;949;2704;829;2535;93;329;537;1617;630;1946
280390;201812;3468;8960;2866;7954;189;572;2195;5982;2384;6554
280400;201812;3848;10163;3352;9444;510;1369;2041;5923;2551;7292
280410;201812;2058;5953;1675;5264;182;614;1020;3129;1202;3743
280420;201812;4249;11567;3867;11036;98;348;3472;9852;3570;10200
280430;201812;1994;5035;1749;4707;71;281;1394;3629;1465;3910
280440;201812;4297;11736;3766;10923;227;759;3044;8584;3271;9343
280445;201812;2278;5891;2044;5476;54;168;1508;3860;1562;4028
280450;201812;10133;23373;8998;21853;383;761;7683;18818;8066;19579
280460;201812;6592;16206;6005;15377;481;1186;4888;12435;5369;13621
280470;201812;1706;4897;1479;4476;69;277;1098;3228;1167;3505
280480;201812;37309;94498;33007;88390;2928;8526;23792;62517;26720;71043
280490;201812;3720;10739;3213;9885;101;461;2449;7260;2550;7721
280500;201812;943;2318;795;2107;40;131;657;1720;697;1851
280510;201812;2507;6699;2174;6203;93;365;1637;4582;1730;4947
280520;201812;1585;4097;1397;3846;75;210;1132;3076;1207;3286
280530;201812;2644;6491;2280;6039;294;692;1626;4384;1920;5076
280540;201812;8861;24082;8138;23015;224;885;7169;19869;7393;20754
280550;201812;6543;15695;5393;14001;255;816;4297;10807;4552;11623
280560;201812;6914;19868;6509;19260;159;620;5732;16690;5891;17310
280570;201812;6254;15849;5089;14328;240;889;3724;10325;3964;11214
280580;201812;5308;14842;4601;13714;612;1699;3098;9391;3710;11090
280590;201812;2925;6905;2456;6324;169;590;1816;4454;1985;5044
280600;201812;3309;9245;2965;8743;194;647;2128;6233;2322;6880
280610;201812;2500;6279;2270;5957;186;458;1809;4719;1995;5177
280620;201812;5232;13418;4489;12373;434;1049;3223;9195;3657;10244
280630;201812;3697;10901;3350;10365;193;683;2669;8236;2862;8919
280640;201812;2418;6610;2182;6345;57;176;1976;5766;2033;5942
280650;201812;1217;3189;958;2802;70;244;706;1999;776;2243
280660;201812;3131;7455;2785;7045;97;269;2445;6131;2542;6400
280670;201812;18792;43377;16505;40407;1061;2769;13051;31819;14112;34588
280680;201812;2686;6698;2307;6119;195;432;1672;4422;1867;4854
280690;201812;938;2419;781;2187;36;107;585;1591;621;1698
280700;201812;1075;2809;934;2592;20;76;730;1992;750;2068
280710;201812;14750;33579;12686;31195;477;915;11086;27767;11563;28682
280720;201812;2647;6025;2152;5444;114;345;1442;3798;1556;4143
280730;201812;1063;2751;955;2586;75;237;722;1889;797;2126
280740;201812;13747;34343;11784;31299;1401;3577;7788;20479;9189;24056
280750;201812;3454;9939;3070;9246;180;637;2227;6582;2407;7219
280760;201812;6028;16863;5354;15794;590;1699;3581;10835;4171;12534
290010;201812;3097;6643;2117;5104;9;31;1733;3988;1742;4019
290020;201812;5282;14319;4898;13788;373;732;4144;12039;4517;12771
290030;201812;4082;10150;3475;9444;183;466;2910;7964;3093;8430
290035;201812;5147;11492;4153;10199;306;527;3309;8447;3615;8974
290040;201812;4211;10389;3578;9618;130;396;2812;7766;2942;8162
290050;201812;2076;6661;1733;5946;146;590;1169;3913;1315;4503
290060;201812;1278;3187;961;2658;91;320;644;1698;735;2018
290070;201812;33731;78275;29298;72581;2257;5738;21312;52569;23569;58307
290080;201812;5319;15945;4531;14750;528;1805;3059;10051;3587;11856
290090;201812;2189;4214;1580;3562;34;91;1427;3187;1461;3278
290100;201812;9501;25737;7985;23392;1051;2910;4789;14448;5840;17358
290110;201812;5009;13709;4535;12877;449;1312;3162;8890;3611;10202
290115;201812;4153;12176;3542;11150;244;846;2658;8286;2902;9132
290120;201812;6613;16443;5496;15019;143;501;4754;12763;4897;13264
290130;201812;4503;11194;3610;10070;112;424;2899;7970;3011;8394
290135;201812;4195;10039;3423;8774;220;574;2598;6476;2818;7050
290140;201812;4529;12231;3632;11076;109;407;3109;9409;3218;9816
290150;201812;2395;6499;2121;6146;176;566;1577;4502;1753;5068
290160;201812;3079;7485;2794;7114;305;676;2135;5485;2440;6161
290170;201812;3104;8398;2781;8014;99;349;2502;7175;2601;7524
290180;201812;2923;8014;2410;7207;86;308;1937;5713;2023;6021
290190;201812;4064;11902;3602;11261;155;635;2933;9010;3088;9645
290195;201812;2294;5876;1835;5204;44;201;1512;4240;1556;4441
290200;201812;3936;11209;3294;10164;236;778;2521;7740;2757;8518
290205;201812;3377;8788;3001;8251;147;535;2361;6284;2508;6819
290210;201812;12976;36931;11565;34818;1028;2750;8777;27207;9805;29957
290220;201812;2701;7021;2443;6691;173;505;1954;5273;2127;5778
290225;201812;3463;7368;2825;6696;25;66;2670;6324;2695;6390
290230;201812;2410;6600;2191;6347;46;178;1935;5580;1981;5758
290240;201812;3563;9144;2934;8332;121;410;2414;6782;2535;7192
290250;201812;4010;11762;3505;11055;154;499;2877;9309;3031;9808
290260;201812;5273;13402;4369;12098;215;765;3542;9607;3757;10372
290265;201812;3567;10485;2932;9286;147;560;2184;6819;2331;7379
290270;201812;11200;38443;10611;37394;627;2710;8502;29499;9129;32209
290280;201812;5875;17706;5137;16347;364;1326;3702;11595;4066;12921
290290;201812;9844;29191;8087;25898;815;2821;5465;17301;6280;20122
290300;201812;4174;11550;3128;9563;173;600;2208;6722;2381;7322
290310;201812;1470;3862;1244;3558;84;322;939;2603;1023;2925
290320;201812;23194;62947;19052;56563;4543;13531;9004;27820;13547;41351
290323;201812;3665;10041;3221;9380;78;280;2650;7641;2728;7921
290327;201812;4120;12002;3547;10897;280;840;2544;7792;2824;8632
290330;201812;2031;4428;1638;3989;43;100;1449;3519;1492;3619
290340;201812;5561;14834;4438;13408;560;1826;3125;9469;3685;11295
290350;201812;4522;12853;3765;11574;289;944;2678;8229;2967;9173
290360;201812;4933;13269;4327;12453;133;411;3745;10755;3878;11166
290370;201812;5277;12986;3951;11257;201;494;2964;8599;3165;9093
290380;201812;5474;14884;4707;13823;114;365;4121;12175;4235;12540
290390;201812;13742;39726;11789;36793;1281;4006;8054;25540;9335;29546
290395;201812;2711;8139;2278;7386;66;315;1794;5732;1860;6047
290400;201812;3536;9810;2871;8724;93;383;2185;6487;2278;6870
290405;201812;4566;13451;3836;12171;265;859;2715;8737;2980;9596
290410;201812;5581;15621;4430;13718;121;591;3401;10139;3522;10730
290420;201812;2941;8356;2421;7521;109;382;1887;5827;1996;6209
290430;201812;3044;8649;2520;7794;305;983;1622;4982;1927;5965
290440;201812;2711;6984;2016;5889;48;162;1463;4317;1511;4479
290450;201812;3200;8664;2635;7830;139;468;2029;5942;2168;6410
290460;201812;11327;32085;9806;29191;2330;7114;4304;12731;6634;19845
290470;201812;4275;11115;3204;9551;354;1199;1823;5470;2177;6669
290475;201812;6234;18403;5333;16759;103;523;4348;13329;4451;13852
290480;201812;1708;4483;1464;4115;123;396;960;2543;1083;2939
290485;201812;4436;13233;3914;12447;119;629;3351;10416;3470;11045
290490;201812;8809;21276;7942;20092;516;1236;6216;15881;6732;17117
290500;201812;3859;11810;3005;9961;519;1795;1357;4370;1876;6165
290510;201812;3282;8558;2798;7910;85;304;2410;6715;2495;7019
290515;201812;3708;10057;3146;9348;62;180;2775;8443;2837;8623
290520;201812;10960;32160;8502;27271;472;1768;5401;16957;5873;18725
290530;201812;4880;14019;4198;12908;149;535;3495;10744;3644;11279
290540;201812;3532;9493;3181;9063;73;268;2911;8227;2984;8495
290550;201812;4281;11208;3769;10600;21;72;3523;10005;3544;10077
290560;201812;6430;17021;5008;14864;457;1623;3322;9560;3779;11183
290570;201812;41684;106029;37903;101154;2799;7753;30219;80065;33018;87818
290580;201812;7691;23260;6795;21912;680;2182;4980;16379;5660;18561
290590;201812;6873;21498;5965;19880;150;630;4899;16292;5049;16922
290600;201812;17934;51188;16256;48559;740;2358;13060;38964;13800;41322
290610;201812;2465;7924;1976;6913;101;418;1371;4716;1472;5134
290620;201812;6509;18260;5627;16780;211;633;4748;14040;4959;14673
290630;201812;8873;21916;7119;19602;602;1654;5508;15206;6110;16860
290640;201812;2696;7155;2004;6033;91;288;1521;4539;1612;4827
290650;201812;11983;31694;10891;30312;2884;7709;5982;17691;8866;25400
290660;201812;3614;9377;3053;8571;67;178;2322;6778;2389;6956
290670;201812;6480;18587;5643;17202;435;1290;4344;13364;4779;14654
290680;201812;10354;29403;8904;27246;224;1145;7267;21644;7491;22789
290682;201812;4529;12168;4002;11405;136;332;3394;9715;3530;10047
290685;201812;3523;7976;2367;6362;218;555;1492;4247;1710;4802
290687;201812;6546;18103;5268;15982;760;2272;3253;10121;4013;12393
290689;201812;2743;7919;2236;7021;134;460;1660;5215;1794;5675
290690;201812;5530;14563;4519;13157;461;1329;3125;9057;3586;10386
290700;201812;2600;7232;2331;6871;85;318;1945;5727;2030;6045
290710;201812;8486;24080;7211;22302;197;789;6128;18831;6325;19620
290720;201812;18653;51077;17132;48829;961;3038;13977;39414;14938;42452
290730;201812;7034;17369;6031;16178;257;608;4737;12730;4994;13338
290740;201812;1047;2906;798;2468;39;165;600;1838;639;2003
290750;201812;10341;26972;9087;24772;866;2509;6446;17107;7312;19616
290755;201812;2079;5886;1673;5137;88;287;1197;3665;1285;3952
290760;201812;3802;11156;3024;9645;271;794;1917;6343;2188;7137
290770;201812;2547;8402;2337;8142;55;276;1957;6869;2012;7145
290780;201812;8161;20523;7047;18993;328;758;5614;15310;5942;16068
290790;201812;4412;12379;3918;11713;140;441;3344;10057;3484;10498
290800;201812;7112;14968;5187;12738;351;819;3850;9605;4201;10424
290810;201812;5505;14936;4455;13315;116;450;3346;10004;3462;10454
290820;201812;4931;13277;4406;12507;233;738;3267;9312;3500;10050
290830;201812;4518;10506;4057;9900;62;174;3510;8427;3572;8601
290840;201812;16201;44549;14274;41543;1835;4679;9415;28697;11250;33376
290850;201812;6195;15829;5623;15187;392;882;4672;12973;5064;13855
290860;201812;5697;17252;5008;16408;232;831;4214;14016;4446;14847
290870;201812;4736;13136;3654;11185;110;380;2657;8064;2767;8444
290880;201812;1379;3519;1083;3113;77;203;754;2217;831;2420
290890;201812;8292;17881;7504;16965;182;446;6991;15693;7173;16139
290900;201812;2254;6042;1732;5159;102;294;1135;3325;1237;3619
290910;201812;4977;12380;3859;10660;46;185;3192;8672;3238;8857
290920;201812;5083;12624;4676;12124;59;146;4411;11443;4470;11589
290930;201812;7799;22044;6379;19552;208;928;5065;15035;5273;15963
290940;201812;3624;10333;3033;9481;173;640;2411;7539;2584;8179
290950;201812;1449;3759;1213;3402;59;159;882;2487;941;2646
290960;201812;5265;14354;4754;13700;134;429;4069;11704;4203;12133
290970;201812;3487;10196;2882;9162;150;508;2192;6926;2342;7434
290980;201812;10879;27468;9292;24909;1014;2854;5466;14321;6480;17175
290990;201812;9017;24878;7957;23135;350;1315;6504;18322;6854;19637
291000;201812;3307;8946;2649;8112;221;619;2049;6399;2270;7018
291005;201812;14565;36105;13030;34147;786;2168;10764;28003;11550;30171
291010;201812;2964;9012;2393;7817;140;497;1597;5118;1737;5615
291020;201812;1254;3167;1014;2713;23;75;718;1824;741;1899
291030;201812;2385;5993;1648;4643;89;255;1071;2916;1160;3171
291040;201812;5173;14785;4466;13746;178;730;3594;10897;3772;11627
291050;201812;7111;19698;6178;18308;917;2948;4034;11756;4951;14704
291060;201812;5632;18411;4904;17361;380;1656;3629;12681;4009;14337
291070;201812;15353;42336;13044;38719;513;1839;10550;31034;11063;32873
291072;201812;22560;60353;16690;49630;3420;10615;6698;20132;10118;30747
291075;201812;4998;13210;4443;12308;124;410;3650;9885;3774;10295
291077;201812;1551;4136;1226;3548;52;149;858;2488;910;2637
291080;201812;80917;222085;67203;201036;24946;76634;12242;39006;37188;115640
291085;201812;5597;14336;4692;13005;180;565;3972;10932;4152;11497
291090;201812;1878;3689;1418;3178;174;235;1052;2483;1226;2718
291100;201812;3095;6892;2128;5733;117;383;1622;4259;1739;4642
291110;201812;5677;17581;4904;16224;417;1653;3565;11362;3982;13015
291120;201812;7555;18930;6570;17622;384;1092;4987;13326;5371;14418
291125;201812;2129;3795;1561;3163;128;190;1182;2496;1310;2686
291130;201812;3063;9071;2346;7655;90;430;1686;5288;1776;5718
291140;201812;4623;12868;3457;10630;471;1280;2174;6785;2645;8065
291150;201812;2155;5014;1824;4632;17;46;1696;4288;1713;4334
291160;201812;4895;13962;4146;12845;400;1342;2806;8581;3206;9923
291165;201812;2134;5932;1669;5050;35;139;1238;3637;1273;3776
291170;201812;20055;51570;17046;46647;1025;3032;11137;30201;12162;33233
291180;201812;5723;14009;4466;12209;437;1171;3270;8998;3707;10169
291185;201812;3071;8580;2709;7943;87;289;2135;6163;2222;6452
291190;201812;7462;18784;6262;17148;372;1096;4911;13395;5283;14491
291200;201812;2843;7964;2123;6599;110;355;1294;3967;1404;4322
291210;201812;6745;15051;5215;13231;166;501;3920;9950;4086;10451
291220;201812;3880;11377;3505;10788;246;880;2686;8155;2932;9035
291230;201812;4393;9695;3388;8568;75;153;3037;7786;3112;7939
291240;201812;4124;10826;3616;9957;60;205;3130;8481;3190;8686
291250;201812;3360;9985;2657;8707;175;578;1747;5756;1922;6334
291260;201812;1367;3242;1154;2956;34;104;968;2483;1002;2587
291270;201812;4961;13892;4048;12445;801;2427;2406;7582;3207;10009
291280;201812;2380;6258;1790;5296;177;602;1061;3026;1238;3628
291290;201812;5799;15568;4628;13729;432;1336;3118;9196;3550;10532
291300;201812;3903;10624;2949;9026;134;434;2187;6635;2321;7069
291310;201812;4984;13638;4299;12345;132;452;3581;10073;3713;10525
291320;201812;5832;16998;4602;14603;1082;3200;2207;7347;3289;10547
291330;201812;1776;4547;1507;4102;73;199;1123;2974;1196;3173
291340;201812;4075;10738;3430;9669;83;302;2669;7368;2752;7670
291345;201812;2936;9080;2704;8725;124;434;2220;7177;2344;7611
291350;201812;6647;17074;5174;15141;97;296;4408;13087;4505;13383
291360;201812;33591;81990;27351;73997;3525;9867;16709;46062;20234;55929
291370;201812;7768;21514;7007;20411;533;1701;5269;15180;5802;16881
291380;201812;3266;9448;2936;8931;101;447;2433;7242;2534;7689
291390;201812;12556;28546;10047;25690;453;1246;8120;20682;8573;21928
291400;201812;13369;35736;11361;32698;1713;4532;6796;20821;8509;25353
291410;201812;2829;7489;2160;6351;57;269;1607;4582;1664;4851
291420;201812;1883;4747;1521;4290;43;185;1300;3610;1343;3795
291430;201812;2917;8232;2529;7629;93;404;2021;5929;2114;6333
291440;201812;6292;18349;5438;16906;320;1088;4307;13426;4627;14514
291450;201812;8565;22362;7221;20765;128;245;6356;18829;6484;19074
291460;201812;14691;40229;12997;37670;799;2557;9724;28014;10523;30571
291465;201812;8625;22368;6952;20397;230;1002;5825;16895;6055;17897
291470;201812;15021;36022;12839;33525;600;1526;9711;26013;10311;27539
291480;201812;38629;88126;28692;74512;3870;10580;14943;38844;18813;49424
291490;201812;5139;13509;4544;12766;189;611;4008;11220;4197;11831
291500;201812;5006;12398;4199;11300;63;271;3800;10142;3863;10413
291510;201812;3667;10070;2911;8989;95;470;2343;7157;2438;7627
291520;201812;4307;10176;3344;8897;535;1277;2163;5910;2698;7187
291530;201812;2188;5255;1608;4477;304;771;930;2804;1234;3575
291535;201812;3067;9384;2846;9004;177;532;2196;7059;2373;7591
291540;201812;2218;5005;1550;4209;54;214;1328;3488;1382;3702
291550;201812;5284;12532;4170;11047;413;981;2762;7436;3175;8417
291560;201812;18893;43263;13221;36355;952;2482;8925;25632;9877;28114
291570;201812;2270;5494;1845;4977;79;179;1527;4222;1606;4401
291580;201812;6055;16338;4812;14639;297;1049;3499;10428;3796;11477
291590;201812;1819;5027;1642;4777;127;400;1320;3808;1447;4208
291600;201812;5026;12680;3781;10697;496;1528;2301;6286;2797;7814
291610;201812;5454;15161;5137;14806;85;326;4799;13802;4884;14128
291620;201812;3149;6995;2276;6028;115;306;1745;4726;1860;5032
291630;201812;3189;7404;2397;6377;242;726;1780;4655;2022;5381
291640;201812;14773;38179;11428;33166;1849;5331;4876;14941;6725;20272
291650;201812;8779;23248;7806;22030;478;1051;6595;18969;7073;20020
291660;201812;2032;5014;1493;4160;133;436;997;2636;1130;3072
291670;201812;1993;5275;1702;4876;104;271;1346;3895;1450;4166
291680;201812;3936;10099;3236;9014;312;868;2332;6443;2644;7311
291685;201812;4525;11061;3663;9954;250;522;2786;7904;3036;8426
291690;201812;4069;9326;2915;7639;191;473;2288;5937;2479;6410
291700;201812;8387;24776;7511;23203;434;1503;6140;18715;6574;20218
291710;201812;5020;12494;3797;10727;312;982;2641;7290;2953;8272
291720;201812;4286;13399;3611;12000;464;1640;2307;7475;2771;9115
291730;201812;6213;16563;5387;15457;253;870;4460;12688;4713;13558
291733;201812;2896;7537;2442;6915;72;241;1829;5377;1901;5618
291735;201812;2935;7608;2421;6790;80;230;1952;5451;2032;5681
291740;201812;3769;9842;2910;8378;102;311;2222;6294;2324;6605
291750;201812;19114;46807;15559;41442;1679;4559;10215;27233;11894;31792
291760;201812;10006;29968;7991;26551;2551;9574;2014;6692;4565;16266
291770;201812;6754;18941;5676;16961;522;1654;4044;11834;4566;13488
291780;201812;4941;13495;4476;12802;102;363;3909;11031;4011;11394
291790;201812;2587;7490;2399;7229;248;665;1807;5550;2055;6215
291800;201812;28228;73210;21770;63275;3349;9466;11726;34992;15075;44458
291810;201812;10281;25362;8666;23326;242;788;7568;20165;7810;20953
291820;201812;3731;10081;3273;9421;110;368;2602;7503;2712;7871
291830;201812;4136;10238;3547;9417;218;573;2852;7606;3070;8179
291835;201812;6221;18848;4889;16222;804;2761;2748;9347;3552;12108
291840;201812;44966;125212;39177;116939;4831;14990;26893;80746;31724;95736
291845;201812;2386;6493;1958;5963;107;341;1610;4929;1717;5270
291850;201812;3949;11391;3260;10223;292;834;2332;7524;2624;8358
291855;201812;2073;4302;1641;3797;53;138;1445;3320;1498;3458
291860;201812;2229;5903;1549;4575;35;120;1048;2979;1083;3099
291870;201812;1284;3272;866;2529;50;153;585;1640;635;1793
291875;201812;2586;7869;2302;7328;101;385;1764;5464;1865;5849
291880;201812;5452;15992;4723;14663;321;1008;3412;10578;3733;11586
291890;201812;1479;3212;983;2617;166;407;620;1647;786;2054
291900;201812;1168;2987;908;2564;22;86;728;2000;750;2086
291905;201812;2610;6598;2032;5646;81;276;1538;4146;1619;4422
291910;201812;2779;7266;2379;6772;72;246;2046;5817;2118;6063
291915;201812;7194;20839;5963;18718;268;1015;4461;13944;4729;14959
291920;201812;24161;66202;21104;61885;2645;8195;14053;40627;16698;48822
291930;201812;2369;6720;2043;6195;242;794;1348;4011;1590;4805
291940;201812;3726;9878;2513;7740;245;734;1435;4344;1680;5078
291950;201812;8746;27012;7559;24692;499;1815;5029;16369;5528;18184
291955;201812;13951;36142;12635;34433;1251;3420;9724;26809;10975;30229
291960;201812;3079;8331;2515;7529;152;466;1918;5862;2070;6328
291970;201812;4176;11245;3604;10466;182;672;2706;7810;2888;8482
291980;201812;9985;28451;7934;25238;662;2044;5369;17295;6031;19339
291990;201812;2054;5589;1853;5363;23;108;1764;5092;1787;5200
291992;201812;4130;10105;3069;8621;266;674;2395;6810;2661;7484
291995;201812;2119;5808;1710;5181;53;242;1376;4067;1429;4309
292000;201812;2526;6228;2041;5607;135;503;1524;4085;1659;4588
292010;201812;5909;13853;4881;12411;221;638;4013;10022;4234;10660
292020;201812;4473;13262;3752;11974;253;913;2742;8519;2995;9432
292030;201812;1681;5370;1612;5252;203;674;905;2867;1108;3541
292040;201812;4143;11008;3373;9884;251;695;2627;7868;2878;8563
292045;201812;3923;10495;2916;8989;45;97;2600;8183;2645;8280
292050;201812;6307;18068;5088;15807;331;1174;3224;9854;3555;11028
292060;201812;11915;27632;11087;26608;611;1409;9560;22669;10171;24078
292070;201812;5616;14963;4964;14161;276;841;4267;12113;4543;12954
292080;201812;3147;8044;2608;7356;94;287;2289;6454;2383;6741
292090;201812;4456;9802;3260;8387;256;667;2499;6526;2755;7193
292100;201812;9988;25542;8610;23731;1232;3552;5327;14640;6559;18192
292105;201812;3278;8653;2903;8098;73;252;2415;6658;2488;6910
292110;201812;6024;15246;4317;12422;1039;3034;1932;5549;2971;8583
292120;201812;6709;17582;5493;15480;409;1200;4059;11250;4468;12450
292130;201812;3249;8047;2695;7362;154;469;2073;5618;2227;6087
292140;201812;5030;12048;4191;10843;269;666;3362;8670;3631;9336
292145;201812;2282;6819;1927;6164;82;303;1441;4607;1523;4910
292150;201812;12956;36513;11600;34415;264;1173;9760;28464;10024;29637
292160;201812;2811;7196;2201;6396;64;201;1841;5410;1905;5611
292170;201812;7968;21742;6682;19564;516;1595;4771;13829;5287;15424
292180;201812;2767;7635;2023;6314;277;837;1180;3651;1457;4488
292190;201812;2830;7620;2431;7035;165;492;1800;5264;1965;5756
292200;201812;7547;20010;5785;17375;989;3059;3138;9559;4127;12618
292205;201812;3831;10717;3267;9842;71;334;2897;8565;2968;8899
292210;201812;6087;14817;5032;13426;95;426;4490;11763;4585;12189
292220;201812;2035;5096;1796;4745;96;274;1376;3545;1472;3819
292225;201812;3116;9216;2790;8726;76;322;2354;7234;2430;7556
292230;201812;8199;19964;7377;18895;176;639;6279;15721;6455;16360
292240;201812;4786;13931;4109;12637;353;1044;2782;8580;3135;9624
292250;201812;5060;14073;4615;13373;613;1675;3074;9093;3687;10768
292260;201812;3263;8804;2916;8344;132;351;2535;7315;2667;7666
292265;201812;3298;9282;2789;8470;77;376;2194;6496;2271;6872
292270;201812;4119;9766;3319;8793;202;568;2682;7102;2884;7670
292273;201812;2534;5629;2047;5029;60;111;1586;4071;1646;4182
292275;201812;1629;4294;1282;3784;59;146;997;2983;1056;3129
292280;201812;2529;6159;2101;5671;102;235;1733;4832;1835;5067
292285;201812;2498;6153;1980;5421;91;222;1557;4316;1648;4538
292290;201812;7009;19422;5779;17617;184;704;4726;14337;4910;15041
292300;201812;9785;25690;7789;23111;920;2977;5097;15121;6017;18098
292303;201812;2825;8217;2493;7693;68;192;2141;6637;2209;6829
292305;201812;2446;6575;2264;6309;45;216;2015;5497;2060;5713
292310;201812;6524;17054;5612;15920;186;631;4792;13462;4978;14093
292320;201812;6116;16799;4978;14689;299;949;3711;10664;4010;11613
292330;201812;2692;6051;2135;5418;108;259;1665;4312;1773;4571
292335;201812;4650;12185;4163;11482;277;707;3459;9614;3736;10321
292340;201812;5686;15940;4831;14312;224;714;3651;10629;3875;11343
292350;201812;2477;6693;2040;6116;82;304;1686;5051;1768;5355
292360;201812;4801;12958;4046;11626;336;1076;2794;7818;3130;8894
292370;201812;10827;24776;9429;22883;128;422;8709;20693;8837;21115
292380;201812;6722;19061;6031;17842;412;1230;4584;13448;4996;14678
292390;201812;4298;8513;3135;7142;468;587;2379;5900;2847;6487
292400;201812;21183;62268;18646;58023;1847;6108;12983;40270;14830;46378
292405;201812;4264;10560;3543;9515;166;409;2870;7698;3036;8107
292410;201812;2101;5144;1826;4798;60;181;1610;4228;1670;4409
292420;201812;3558;10910;3287;10477;155;701;2761;8616;2916;9317
292430;201812;4595;14042;3564;12208;290;1052;2367;8129;2657;9181
292440;201812;8302;26780;7679;25816;126;651;6959;23322;7085;23973
292450;201812;3745;11113;3049;9712;139;510;2350;7433;2489;7943
292460;201812;4730;13355;3918;11948;370;1083;2796;8545;3166;9628
292465;201812;2485;6701;2069;6125;93;238;1450;4528;1543;4766
292467;201812;1742;5098;1581;4878;234;665;1082;3460;1316;4125
292470;201812;2946;7509;2298;6477;68;168;1810;5107;1878;5275
292480;201812;6367;15275;5121;13750;78;292;4595;12146;4673;12438
292490;201812;2048;5503;1712;4997;100;293;1306;3835;1406;4128
292500;201812;6310;17728;5156;15627;585;1800;3379;10172;3964;11972
292510;201812;12234;33595;9858;29999;554;2036;7239;21920;7793;23956
292520;201812;6515;16680;5775;15571;641;1735;4215;11362;4856;13097
292525;201812;5623;13586;4667;12465;117;341;4103;10982;4220;11323
292530;201812;25348;68904;20143;60210;5523;16668;7077;21978;12600;38646
292540;201812;3933;7907;3148;7053;119;236;2769;6210;2888;6446
292550;201812;7698;21331;6042;19217;428;1475;4471;14567;4899;16042
292560;201812;4201;10804;3590;9941;94;345;2969;8169;3063;8514
292570;201812;3772;9890;3229;9031;70;253;2831;7782;2901;8035
292575;201812;6789;20137;6295;19444;281;970;5300;16291;5581;17261
292580;201812;7310;19015;6235;17408;165;529;5242;14505;5407;15034
292590;201812;7224;19314;6384;17986;276;898;5416;14921;5692;15819
292593;201812;2766;6878;2319;6132;77;193;1927;5072;2004;5265
292595;201812;5292;14141;4588;13260;173;592;3867;11021;4040;11613
292600;201812;10710;29444;9308;27369;450;1231;7324;21615;7774;22846
292610;201812;4203;11101;3549;9961;217;507;2559;7355;2776;7862
292620;201812;6274;17584;5340;16492;72;192;5055;15764;5127;15956
292630;201812;8414;20830;6920;18446;533;1413;4790;12799;5323;14212
292640;201812;8045;24159;7090;22614;216;920;5122;16297;5338;17217
292650;201812;4526;11139;4106;10584;132;386;3726;9472;3858;9858
292660;201812;10791;29933;9362;27820;496;1598;7350;21748;7846;23346
292665;201812;2159;6481;1934;6201;83;243;1646;5380;1729;5623
292670;201812;3482;9481;2695;8028;118;420;1856;5419;1974;5839
292680;201812;3890;10589;3137;9185;180;545;2288;6525;2468;7070
292690;201812;2578;6859;1836;5629;174;503;1125;3609;1299;4112
292700;201812;9620;26591;8417;24775;820;2312;5743;17346;6563;19658
292710;201812;2393;7633;2203;7367;53;182;1974;6653;2027;6835
292720;201812;9115;22057;7695;20463;288;783;6235;16743;6523;17526
292730;201812;4302;10398;4056;10088;198;348;3534;8894;3732;9242
292740;201812;308395;774573;276489;726304;45648;121677;166793;434773;212441;556450
292750;201812;6105;16451;5304;15268;278;810;4039;11732;4317;12542
292760;201812;3794;11085;3364;10344;248;827;2453;7486;2701;8313
292770;201812;5777;15943;4730;14398;773;2463;2829;8905;3602;11368
292780;201812;1885;3916;1422;3336;104;202;1111;2572;1215;2774
292790;201812;4056;8715;3175;7755;235;476;2644;6559;2879;7035
292800;201812;10686;27212;9295;25072;365;994;7702;20564;8067;21558
292805;201812;3360;8402;2658;7444;193;512;1975;5551;2168;6063
292810;201812;10285;27857;8184;24615;247;990;6134;18032;6381;19022
292820;201812;7341;20273;5376;17150;550;1883;3663;11495;4213;13378
292830;201812;2850;6705;2427;6172;75;257;2139;5395;2214;5652
292840;201812;8732;23045;7625;21538;174;637;6633;18319;6807;18956
292850;201812;2484;6746;2083;6115;139;466;1461;4167;1600;4633
292860;201812;16065;37334;14434;35295;761;1865;11919;28943;12680;30808
292870;201812;16446;42776;14454;39913;1066;3251;9640;26270;10706;29521
292880;201812;11065;30334;9601;28167;325;1366;7544;21333;7869;22699
292890;201812;6260;18228;5580;17160;248;964;4674;14216;4922;15180
292895;201812;2922;6430;2161;5299;102;263;1683;4085;1785;4348
292900;201812;2613;7243;2423;6936;57;257;1972;5470;2029;5727
292905;201812;4195;11400;3320;10071;195;675;2367;7097;2562;7772
292910;201812;4816;13423;4396;12772;286;927;3299;9467;3585;10394
292920;201812;9624;26757;9073;25984;259;1006;7936;22306;8195;23312
292925;201812;5246;15031;4576;13870;261;814;3396;10144;3657;10958
292930;201812;6281;19038;5460;17434;459;1711;3411;10561;3870;12272
292935;201812;2235;5947;1778;5429;35;184;1569;4797;1604;4981
292937;201812;3043;7338;2668;6883;68;204;2388;6153;2456;6357
292940;201812;2969;7664;2398;6771;175;409;1735;5037;1910;5446
292950;201812;9494;24628;8421;23020;425;1129;6439;17419;6864;18548
292960;201812;5179;12561;4420;11520;109;320;3582;9132;3691;9452
292970;201812;3775;11174;3315;10468;114;506;2746;8658;2860;9164
292975;201812;4416;9692;3918;9117;186;340;3503;8263;3689;8603
292980;201812;3238;7984;2598;7004;105;328;2072;5490;2177;5818
292990;201812;11170;30894;9444;27804;705;2274;7020;20489;7725;22763
293000;201812;2516;6113;2213;5702;34;127;1765;4592;1799;4719
293010;201812;17737;46230;14508;41030;2102;6076;8708;24507;10810;30583
293015;201812;7663;24227;6162;21219;457;1913;4219;14379;4676;16292
293020;201812;9570;28435;8682;27178;140;659;7754;24463;7894;25122
293030;201812;5283;14374;4067;12496;598;1704;2275;7416;2873;9120
293040;201812;3863;10976;3382;10309;93;342;2946;8958;3039;9300
293050;201812;21146;53123;18946;49964;1332;3647;13994;36752;15326;40399
293060;201812;3377;8950;2782;7950;201;618;2047;5724;2248;6342
293070;201812;24022;59894;20396;55013;2844;7789;13111;35944;15955;43733
293075;201812;3239;10542;2903;10006;216;882;2284;7833;2500;8715
293076;201812;3533;8895;3151;8410;96;244;2696;7279;2792;7523
293077;201812;5867;16607;4776;14942;486;1576;3092;9970;3578;11546
293080;201812;4754;14185;4159;13172;131;583;3315;10259;3446;10842
293090;201812;3101;9188;2408;8022;263;929;1530;5099;1793;6028
293100;201812;5599;15306;4545;13418;314;971;3459;10118;3773;11089
293105;201812;3603;11489;3154;10586;215;755;2311;7669;2526;8424
293110;201812;2425;6026;2064;5531;72;290;1727;4461;1799;4751
293120;201812;4265;11863;3808;11123;130;338;3157;9250;3287;9588
293130;201812;3710;10350;3306;9825;94;403;2847;8350;2941;8753
293135;201812;28262;68505;21000;58345;3870;11792;9137;25441;13007;37233
293140;201812;2269;5326;2001;4993;79;204;1668;4121;1747;4325
293150;201812;5262;16128;4373;14417;420;1416;2981;9871;3401;11287
293160;201812;3819;9468;3265;8825;251;482;2676;7550;2927;8032
293170;201812;4286;9802;3763;9109;109;307;3180;7594;3289;7901
293180;201812;4529;12477;3716;11084;113;492;3005;8693;3118;9185
293190;201812;13625;38049;12096;35813;229;1013;10574;31048;10803;32061
293200;201812;7839;19852;6529;17869;224;827;5185;13895;5409;14722
293210;201812;5098;13585;4326;12328;312;853;3340;9540;3652;10393
293220;201812;4776;12887;3624;10880;854;2590;1409;4399;2263;6989
293230;201812;3799;10086;2888;8754;256;842;1957;6003;2213;6845
293240;201812;4338;11603;3535;10286;97;272;2706;8072;2803;8344
293245;201812;3824;10424;3458;9908;175;525;2925;8290;3100;8815
293250;201812;5423;13358;4641;12284;237;641;3769;9940;4006;10581
293260;201812;4307;12083;3568;10936;118;374;2534;7723;2652;8097
293270;201812;6740;15710;5467;14324;491;877;4198;11696;4689;12573
293280;201812;4768;12628;4102;11708;262;671;3172;9100;3434;9771
293290;201812;12870;39781;11616;37709;2377;7702;6550;21940;8927;29642
293300;201812;5794;14048;4958;12886;315;759;3627;9551;3942;10310
293305;201812;3915;9871;3466;9266;44;124;3130;8332;3174;8456
293310;201812;2088;5440;1731;4826;68;204;1337;3666;1405;3870
293315;201812;4047;9928;3320;8814;167;423;2685;7087;2852;7510
293317;201812;2410;6088;2160;5715;178;408;1638;4363;1816;4771
293320;201812;10354;27130;9580;26192;420;1212;8379;22855;8799;24067
293325;201812;1663;4316;1328;3831;192;569;847;2456;1039;3025
293330;201812;41501;129079;35822;118824;7949;26740;16110;54608;24059;81348
293340;201812;2315;6511;1875;5747;123;431;1279;3872;1402;4303
293345;201812;3187;9021;2627;8206;292;701;1871;6223;2163;6924
293350;201812;6617;18905;5866;18055;58;226;5440;17012;5498;17238
293360;201812;14960;38892;12841;36164;480;1782;11114;30779;11594;32561
310010;201812;818;1974;567;1602;82;273;238;620;320;893
310020;201812;2264;6480;1666;5376;354;1257;268;799;622;2056
310030;201812;1997;5849;1555;5055;239;860;946;2956;1185;3816
310040;201812;929;2446;754;2159;40;153;532;1437;572;1590
310050;201812;1514;4761;1339;4447;185;755;776;2483;961;3238
310060;201812;3217;9222;2817;8712;127;540;2312;7034;2439;7574
310070;201812;353;807;242;638;7;18;185;482;192;500
310080;201812;804;2197;541;1652;70;252;222;628;292;880
310090;201812;4403;12177;3625;10876;307;999;2608;7694;2915;8693
310100;201812;3204;9177;2728;8385;95;419;2190;6507;2285;6926
310110;201812;4658;12618;3683;10870;750;2422;1648;4641;2398;7063
310120;201812;623;1552;388;1144;66;240;204;526;270;766
310130;201812;360;998;304;909;40;154;193;531;233;685
310140;201812;218;686;157;566;31;135;49;148;80;283
310150;201812;4560;12902;3506;10890;613;2099;1425;4255;2038;6354
310160;201812;6779;18055;5048;15159;1132;3741;1594;4685;2726;8426
310163;201812;935;2766;761;2451;232;845;210;589;442;1434
310170;201812;8726;23068;7119;20531;705;2113;5003;14390;5708;16503
310180;201812;1632;4240;1251;3615;104;370;860;2371;964;2741
310190;201812;2819;8686;2286;7635;536;1975;307;939;843;2914
310200;201812;1690;5171;1258;4292;239;894;503;1685;742;2579
310205;201812;1045;2924;769;2470;174;619;262;820;436;1439
310210;201812;2607;6968;2145;6214;113;334;1638;4693;1751;5027
310220;201812;1093;3034;882;2676;106;351;601;1779;707;2130
310230;201812;2219;6396;1833;5648;225;823;1090;3118;1315;3941
310240;201812;878;2847;754;2621;58;262;523;1768;581;2030
310250;201812;987;2680;805;2393;42;169;581;1685;623;1854
310260;201812;2654;7215;1647;5412;478;1795;315;772;793;2567
310270;201812;2612;6684;2039;5888;115;444;1637;4649;1752;5093
310280;201812;2284;5491;1780;4755;307;876;966;2446;1273;3322
310285;201812;1829;6113;1579;5669;156;676;979;3479;1135;4155
310290;201812;1110;2995;931;2670;207;679;487;1251;694;1930
310300;201812;1403;4352;1240;4060;185;738;645;1909;830;2647
310310;201812;308;797;209;616;34;107;111;321;145;428
310320;201812;502;1313;315;988;30;115;154;456;184;571
310330;201812;477;1150;287;796;41;133;126;312;167;445
310340;201812;7484;21010;6021;18493;978;2950;2993;9487;3971;12437
310350;201812;11691;29127;7968;22984;1858;5696;2759;7729;4617;13425
310360;201812;481;1167;372;1029;10;34;275;749;285;783
310370;201812;1250;4013;1037;3592;249;912;287;1020;536;1932
310375;201812;817;2181;548;1758;100;344;216;682;316;1026
310380;201812;384;902;201;575;38;103;76;201;114;304
310390;201812;439;1340;352;1176;86;309;87;231;173;540
310400;201812;9113;22850;6416;18660;939;3090;3354;9439;4293;12529
310410;201812;767;2253;471;1688;104;391;126;409;230;800
310420;201812;3855;10173;2452;7338;435;1471;728;1931;1163;3402
310430;201812;1396;3906;897;2949;189;685;269;818;458;1503
310440;201812;560;1440;382;1126;23;103;231;659;254;762
310445;201812;1311;3870;992;3238;57;195;697;2236;754;2431
310450;201812;4595;11897;3471;10093;203;718;2588;7325;2791;8043
310460;201812;1544;4214;1048;3260;212;700;295;897;507;1597
310470;201812;3798;8375;3024;7356;324;896;2251;5378;2575;6274
310480;201812;976;2658;749;2243;107;364;468;1347;575;1711
310490;201812;2817;8026;2193;6907;324;1205;1068;3094;1392;4299
310500;201812;1395;4035;1005;3297;200;717;463;1491;663;2208
310510;201812;1800;4911;1161;3686;233;816;376;1197;609;2013
310520;201812;1276;3249;917;2641;130;359;523;1490;653;1849
310530;201812;735;1931;405;1244;60;208;98;231;158;439
310540;201812;3191;9299;2635;8305;648;2145;1086;3291;1734;5436
310550;201812;1229;3228;856;2581;80;305;504;1422;584;1727
310560;201812;13513;36612;9942;30377;2025;6934;3536;9749;5561;16683
310570;201812;1097;2979;882;2666;91;361;580;1674;671;2035
310590;201812;4027;11065;3277;9727;282;967;1881;5291;2163;6258
310600;201812;1367;4138;1121;3625;167;604;543;1630;710;2234
310610;201812;485;1313;309;1021;58;217;159;477;217;694
310620;201812;153613;407866;112881;333178;21515;71729;46168;121558;67683;193287
310630;201812;4349;12218;3585;10773;268;953;2428;7083;2696;8036
310640;201812;969;2984;803;2645;193;702;279;863;472;1565
310650;201812;2371;7059;1766;5895;209;783;1000;3210;1209;3993
310660;201812;1218;3364;1032;3129;46;168;844;2507;890;2675
310665;201812;1305;3461;1038;3077;49;186;842;2454;891;2640
310670;201812;48384;130642;40562;116634;5166;16826;25328;69108;30494;85934
310680;201812;652;1640;555;1507;26;76;438;1156;464;1232
310690;201812;1658;4565;1232;3833;135;495;689;2035;824;2530
310700;201812;471;1085;361;956;36;119;248;624;284;743
310710;201812;5081;15081;3610;12880;842;3505;444;1488;1286;4993
310720;201812;897;2285;713;2035;47;164;517;1417;564;1581
310730;201812;9101;25721;7860;23656;496;1866;5580;16429;6076;18295
310740;201812;5066;14485;3422;10956;650;2252;980;2917;1630;5169
310750;201812;1184;2931;838;2421;131;443;365;963;496;1406
310760;201812;541;1465;398;1236;34;119;186;587;220;706
310770;201812;1047;2937;705;2411;108;413;333;1082;441;1495
310780;201812;3941;10073;3222;8928;143;440;2357;6402;2500;6842
310790;201812;1750;5578;1534;5125;407;1438;503;1682;910;3120
310800;201812;2175;6600;1554;5329;385;1584;90;269;475;1853
310810;201812;1105;2887;885;2487;53;187;601;1621;654;1808
310820;201812;1100;2947;670;2139;152;514;136;431;288;945
310825;201812;2418;7788;1986;7027;84;480;1562;5302;1646;5782
310830;201812;1451;4285;1016;3393;215;787;400;1265;615;2052
310840;201812;1834;5100;1295;4145;320;1129;317;887;637;2016
310850;201812;1518;4207;1281;3883;65;313;995;2868;1060;3181
310855;201812;3184;8680;2487;7556;214;746;1711;5057;1925;5803
310860;201812;6676;19755;5386;17160;565;1852;3285;10507;3850;12359
310870;201812;1039;2515;781;2130;87;243;556;1521;643;1764
310880;201812;1005;3051;788;2607;90;312;464;1497;554;1809
310890;201812;2180;6221;1395;4704;290;1081;165;460;455;1541
310900;201812;4086;11545;3026;9502;460;1608;1364;3915;1824;5523
310910;201812;1705;4442;1099;3351;124;446;162;426;286;872
310920;201812;1815;4920;1400;4261;261;814;697;2111;958;2925
310925;201812;925;2668;777;2404;101;336;502;1510;603;1846
310930;201812;5674;15415;4136;12894;777;2537;2046;6506;2823;9043
310940;201812;6112;15634;4928;13836;265;939;3558;9669;3823;10608
310945;201812;1177;3164;974;2863;101;350;584;1661;685;2011
310950;201812;1786;5416;1221;4154;226;864;422;1296;648;2160
310960;201812;713;1866;419;1316;56;190;149;478;205;668
310970;201812;1141;3457;793;2693;193;706;167;512;360;1218
310980;201812;327;782;216;601;22;63;136;361;158;424
310990;201812;1195;3523;925;2970;203;677;378;1170;581;1847
311000;201812;3923;11272;2916;9517;905;3063;943;2967;1848;6030
311010;201812;748;2344;597;2003;241;868;161;513;402;1381
311020;201812;962;2563;648;1970;76;261;300;881;376;1142
311030;201812;1440;3812;968;2959;239;816;360;983;599;1799
311040;201812;324;1032;254;861;71;241;68;207;139;448
311050;201812;2357;6243;1796;5378;411;1367;758;2156;1169;3523
311060;201812;2727;7371;1868;5609;301;1063;726;1940;1027;3003
311070;201812;1904;5142;1384;4269;181;689;656;1899;837;2588
311080;201812;959;2384;795;2100;58;231;573;1399;631;1630
311090;201812;1977;6528;1555;5732;371;1499;426;1517;797;3016
311100;201812;2011;5929;1254;4384;284;1114;181;564;465;1678
311110;201812;3512;7576;2014;5414;454;1338;755;2021;1209;3359
311115;201812;1240;3091;1011;2766;63;213;808;2149;871;2362
311120;201812;6245;16860;4658;13873;811;2748;1592;4197;2403;6945
311130;201812;1812;4903;1403;4319;128;520;760;2225;888;2745
311140;201812;1330;3324;988;2830;77;258;637;1829;714;2087
311150;201812;1487;4787;1200;4247;189;759;633;2153;822;2912
311160;201812;3516;10522;2458;8540;677;2605;660;2231;1337;4836
311170;201812;829;2259;661;2010;40;127;412;1285;452;1412
311180;201812;1276;2956;808;2261;188;557;332;925;520;1482
311190;201812;979;2724;725;2225;111;410;299;831;410;1241
311200;201812;1712;4712;1190;3702;292;997;325;891;617;1888
311205;201812;867;2694;713;2382;53;237;413;1326;466;1563
311210;201812;980;2963;865;2815;124;400;626;2082;750;2482
311220;201812;717;2066;591;1838;79;272;315;907;394;1179
311230;201812;7416;22775;5572;19074;1046;3766;1922;6788;2968;10554
311240;201812;935;2580;720;2277;179;626;353;1093;532;1719
311250;201812;832;2408;656;2096;147;483;301;930;448;1413
311260;201812;2319;5815;1502;4420;295;912;525;1466;820;2378
311265;201812;1208;3247;923;2778;63;226;645;1875;708;2101
311270;201812;2923;8959;2577;8402;198;925;1877;5770;2075;6695
311280;201812;1135;3060;540;1755;93;331;85;250;178;581
311290;201812;1847;5787;1701;5462;185;634;1153;3658;1338;4292
311300;201812;4485;13045;3764;11843;216;934;2905;8896;3121;9830
311310;201812;536;1574;455;1417;61;205;224;657;285;862
311320;201812;3032;9566;2597;8574;417;1559;1174;3590;1591;5149
311330;201812;4617;12796;3829;11473;447;1486;2129;6420;2576;7906
311340;201812;9617;28260;7665;24591;2249;7791;1860;5793;4109;13584
311350;201812;2139;5573;1535;4454;153;524;819;2133;972;2657
311360;201812;1047;2661;654;2016;208;707;176;515;384;1222
311370;201812;4248;10943;3188;9155;168;675;1998;5442;2166;6117
311380;201812;369;1143;296;997;69;238;105;361;174;599
311390;201812;1650;5247;1328;4812;559;2332;329;1013;888;3345
311400;201812;1346;3901;958;3115;133;506;397;1144;530;1650
311410;201812;1550;4733;1295;4376;229;852;679;2320;908;3172
311420;201812;1513;4562;1020;3491;177;641;168;444;345;1085
311430;201812;3313;9129;2165;6792;417;1342;617;1959;1034;3301
311440;201812;2355;6904;1649;5637;374;1460;520;1720;894;3180
311450;201812;1685;5256;1247;4407;326;1277;287;866;613;2143
311455;201812;928;2186;635;1729;175;483;237;658;412;1141
311460;201812;476;1538;322;1214;76;367;90;300;166;667
311470;201812;423;1361;305;1073;70;288;54;168;124;456
311480;201812;1135;3196;991;2995;45;124;826;2535;871;2659
311490;201812;213;649;172;567;45;173;73;216;118;389
311500;201812;401;1060;295;882;28;91;177;522;205;613
311510;201812;2759;7578;1833;5870;341;1222;633;1862;974;3084
311520;201812;552;1665;505;1566;112;394;272;804;384;1198
311530;201812;8317;20030;5249;14920;1303;4072;1373;3850;2676;7922
311535;201812;717;1995;482;1550;96;348;131;388;227;736
311540;201812;493;1579;437;1478;89;303;247;842;336;1145
311545;201812;1971;5681;1714;5321;94;365;1313;3994;1407;4359
311547;201812;1456;3808;1273;3520;38;128;931;2587;969;2715
311550;201812;2626;7574;2079;6522;326;1150;825;2463;1151;3613
311560;201812;271;622;187;502;27;78;105;251;132;329
311570;201812;1807;4283;1307;3584;62;181;1022;2864;1084;3045
311580;201812;2103;3997;1373;3146;165;318;884;2098;1049;2416
311590;201812;466;1325;380;1199;61;226;203;620;264;846
311600;201812;1664;3875;1393;3536;53;158;1194;2965;1247;3123
311610;201812;2319;7877;1938;7011;323;1174;938;3395;1261;4569
311615;201812;2877;8680;2381;7838;163;658;1780;5732;1943;6390
311620;201812;393;1093;338;1014;24;83;267;788;291;871
311630;201812;1334;3705;1075;3206;97;306;705;2027;802;2333
311640;201812;532;1564;418;1350;81;305;191;559;272;864
311650;201812;1846;4925;1565;4482;123;437;1069;2916;1192;3353
311660;201812;2620;7639;1908;6310;374;1347;424;1191;798;2538
311670;201812;1519;4039;1142;3406;190;640;491;1482;681;2122
311680;201812;2033;5988;1557;5141;311;1053;879;2896;1190;3949
311690;201812;545;1206;423;1057;44;108;302;792;346;900
311700;201812;2189;5378;1720;4728;31;130;1433;3823;1464;3953
311710;201812;1455;4292;996;3390;261;950;324;1100;585;2050
311720;201812;411;1267;329;1107;39;162;176;564;215;726
311730;201812;3956;10162;2496;7502;780;2589;385;1142;1165;3731
311740;201812;798;2323;694;2190;39;113;611;1955;650;2068
311750;201812;3739;11710;3072;10558;492;1815;1537;5049;2029;6864
311760;201812;584;1726;487;1547;84;332;199;522;283;854
311770;201812;1895;5675;1460;4842;278;1000;567;1781;845;2781
311780;201812;1212;3651;830;2834;160;630;222;652;382;1282
311783;201812;2112;6060;1758;5439;52;237;1424;4293;1476;4530
311787;201812;674;2004;478;1547;71;252;180;507;251;759
311790;201812;1403;3735;906;2861;221;767;308;940;529;1707
311800;201812;4557;14130;3728;12276;708;2576;626;1873;1334;4449
311810;201812;940;2940;741;2571;65;264;441;1510;506;1774
311820;201812;703;1875;551;1599;78;256;329;900;407;1156
311830;201812;7772;23021;5356;17651;1450;5111;607;1872;2057;6983
311840;201812;3086;8350;2625;7667;286;907;1877;5428;2163;6335
311850;201812;298;845;246;762;21;68;155;472;176;540
311860;201812;52845;138308;40749;117649;6573;20138;22390;62622;28963;82760
311870;201812;1791;4929;1226;3902;225;802;463;1312;688;2114
311880;201812;6054;16276;5169;15027;342;924;3932;11530;4274;12454
311890;201812;1512;3888;1188;3407;118;394;786;2166;904;2560
311900;201812;689;1834;526;1598;56;201;349;1030;405;1231
311910;201812;4065;10654;3075;9358;593;1806;1571;4892;2164;6698
311920;201812;1919;5513;1549;4918;142;454;922;2947;1064;3401
311930;201812;3058;7744;2359;6723;862;2628;700;1856;1562;4484
311940;201812;13369;36659;9926;29998;1492;4955;4549;12867;6041;17822
311950;201812;2088;5967;1574;5052;90;410;1075;3353;1165;3763
311960;201812;545;1355;443;1192;30;142;290;643;320;785
311970;201812;429;1410;288;1056;57;231;60;201;117;432
311980;201812;412;1163;223;764;30;105;63;214;93;319
311990;201812;521;1292;349;1047;78;270;151;424;229;694
311995;201812;962;2730;507;1670;21;71;56;126;77;197
312000;201812;561;1528;463;1379;33;112;330;985;363;1097
312010;201812;859;2459;657;2107;64;230;392;1212;456;1442
312015;201812;1289;3938;1151;3686;68;304;879;2705;947;3009
312020;201812;1105;3464;901;3079;228;820;312;1035;540;1855
312030;201812;1980;5012;1746;4740;29;126;1604;4303;1633;4429
312040;201812;767;2481;583;2058;63;254;248;838;311;1092
312050;201812;1211;3933;946;3378;212;878;244;760;456;1638
312060;201812;820;2099;544;1729;140;461;243;767;383;1228
312070;201812;853;2524;594;1997;67;261;308;987;375;1248
312080;201812;2662;6723;1979;5673;143;472;1241;3361;1384;3833
312083;201812;838;2286;639;1972;74;249;401;1183;475;1432
312087;201812;2249;6159;1877;5599;71;253;1462;4363;1533;4616
312090;201812;8986;24813;6891;21308;1309;4372;3083;9424;4392;13796
312100;201812;1541;4670;1107;3874;150;642;501;1646;651;2288
312110;201812;969;3115;807;2767;218;835;235;712;453;1547
312120;201812;688;1954;489;1597;144;544;152;409;296;953
312125;201812;1529;4187;1288;3808;140;453;907;2601;1047;3054
312130;201812;868;2201;648;1837;63;207;262;693;325;900
312140;201812;739;2240;614;1972;129;445;250;734;379;1179
312150;201812;451;1293;381;1133;12;56;274;751;286;807
312160;201812;7540;22161;5856;19078;901;3333;2550;7818;3451;11151
312170;201812;828;2304;659;1998;40;133;443;1302;483;1435
312180;201812;1326;3703;1062;3180;155;494;549;1566;704;2060
312190;201812;546;1642;388;1317;78;276;78;255;156;531
312200;201812;4533;12539;3672;11009;783;2433;1869;5568;2652;8001
312210;201812;1312;3138;944;2593;58;208;657;1728;715;1936
312220;201812;1818;5721;1570;5271;118;439;977;3265;1095;3704
312230;201812;11156;30286;7350;23133;2049;7058;1181;3268;3230;10326
312235;201812;1690;4623;1384;4172;110;401;981;2881;1091;3282
312240;201812;642;2103;476;1746;95;365;141;504;236;869
312245;201812;2463;6623;2057;6013;74;274;1668;4829;1742;5103
312247;201812;857;2224;605;1837;134;440;289;872;423;1312
312250;201812;924;2440;596;1800;102;310;233;700;335;1010
312260;201812;882;2531;711;2251;55;217;505;1547;560;1764
312270;201812;685;1916;531;1616;28;119;287;794;315;913
312280;201812;415;1241;316;1054;100;346;36;112;136;458
312290;201812;708;2197;576;1935;123;454;182;585;305;1039
312300;201812;876;2642;599;1989;160;574;102;273;262;847
312310;201812;726;2455;611;2221;93;397;275;959;368;1356
312320;201812;1713;4570;1258;3760;372;1170;213;599;585;1769
312330;201812;840;2511;682;2197;74;253;456;1423;530;1676
312340;201812;236;639;176;544;39;141;60;162;99;303
312350;201812;270;578;209;513;25;74;141;329;166;403
312352;201812;1592;4777;1393;4423;126;421;866;2893;992;3314
312360;201812;2363;7123;1752;5832;366;1305;440;1419;806;2724
312370;201812;1669;4686;1385;4177;247;848;679;1942;926;2790
312380;201812;2137;4982;1799;4555;17;49;1620;4075;1637;4124
312385;201812;1277;3613;990;3071;223;758;412;1186;635;1944
312390;201812;1838;5508;1392;4661;230;834;472;1437;702;2271
312400;201812;2738;8275;2183;7195;746;2577;604;2017;1350;4594
312410;201812;11094;32037;9142;28569;1802;5853;4505;13830;6307;19683
312420;201812;3543;10167;2996;9175;575;1880;1547;4616;2122;6496
312430;201812;7836;21117;6285;18377;578;1887;4127;11845;4705;13732
312440;201812;885;2882;672;2363;351;1291;62;187;413;1478
312450;201812;1114;3395;843;2881;244;883;278;970;522;1853
312460;201812;418;1100;280;883;39;146;159;513;198;659
312470;201812;473;1186;304;894;52;194;113;275;165;469
312480;201812;1130;2873;780;2377;113;375;409;1198;522;1573
312490;201812;2002;4986;1519;4240;234;661;752;2042;986;2703
312500;201812;838;2183;673;1939;58;201;437;1225;495;1426
312510;201812;3430;9466;2608;7903;637;1871;858;2596;1495;4467
312520;201812;153;483;135;449;40;129;62;205;102;334
312530;201812;554;1453;477;1355;18;57;423;1201;441;1258
312540;201812;1438;4262;933;3134;178;626;419;1375;597;2001
312550;201812;732;2009;545;1609;40;124;353;965;393;1089
312560;201812;1896;4978;1565;4490;80;291;1221;3481;1301;3772
312570;201812;2091;5528;1627;4900;504;1579;568;1758;1072;3337
312580;201812;559;1663;426;1369;59;214;185;553;244;767
312590;201812;1583;4793;1284;4202;151;603;694;2117;845;2720
312595;201812;1558;4942;1407;4668;306;968;815;2845;1121;3813
312600;201812;931;2305;514;1678;73;282;188;601;261;883
312610;201812;6199;16241;3927;11924;609;2049;1241;3536;1850;5585
312620;201812;2415;6308;1758;5400;60;276;1374;4260;1434;4536
312630;201812;261;829;192;690;36;154;76;267;112;421
312640;201812;564;1553;373;1229;49;164;128;437;177;601
312650;201812;2040;5434;1376;4118;84;286;926;2618;1010;2904
312660;201812;1302;3232;993;2750;96;328;670;1769;766;2097
312670;201812;4853;13321;3971;11939;247;1064;2764;7912;3011;8976
312675;201812;1193;3364;966;2984;69;285;748;2241;817;2526
312680;201812;1349;3894;1128;3557;65;288;889;2718;954;3006
312690;201812;2336;5553;1852;4932;108;348;1472;3816;1580;4164
312695;201812;913;2720;780;2481;55;165;597;1900;652;2065
312700;201812;2017;5455;1463;4450;154;524;821;2397;975;2921
312705;201812;1291;3370;1075;3028;24;92;903;2497;927;2589
312707;201812;1350;4093;1044;3506;80;398;636;1993;716;2391
312710;201812;6037;14013;3526;10107;1028;3234;904;2695;1932;5929
312720;201812;996;2864;730;2399;89;335;394;1241;483;1576
312730;201812;1611;3911;1191;3340;86;287;732;1985;818;2272
312733;201812;1421;3790;1073;3136;37;130;722;2019;759;2149
312735;201812;639;1756;544;1578;87;292;354;918;441;1210
312737;201812;804;1911;547;1527;80;258;293;739;373;997
312738;201812;556;1513;396;1221;66;240;176;493;242;733
312740;201812;406;1017;225;707;59;198;50;124;109;322
312750;201812;1312;4233;1062;3740;175;687;436;1453;611;2140
312760;201812;1784;5450;1295;4427;246;882;413;1354;659;2236
312770;201812;41129;101178;25645;74732;5922;18286;7862;22477;13784;40763
312780;201812;2381;7483;2019;6848;212;813;1315;4426;1527;5239
312790;201812;256;644;157;510;14;63;52;139;66;202
312800;201812;4686;13862;3649;11775;750;2633;1503;4697;2253;7330
312810;201812;1659;4543;1080;3536;269;982;330;955;599;1937
312820;201812;1748;4852;1438;4261;57;214;1028;2958;1085;3172
312825;201812;1305;3177;1127;2940;30;104;949;2443;979;2547
312830;201812;2150;6289;1386;4797;343;1308;307;1031;650;2339
312840;201812;1094;3340;864;2871;134;546;354;1075;488;1621
312850;201812;821;2100;582;1724;55;222;311;823;366;1045
312860;201812;1294;3331;842;2601;225;732;220;660;445;1392
312870;201812;6191;17356;3716;12240;599;2178;861;2634;1460;4812
312880;201812;1358;3555;1086;3126;51;193;609;1759;660;1952
312890;201812;1952;5216;1343;4123;175;553;556;1737;731;2290
312900;201812;1158;3117;931;2818;78;255;559;1768;637;2023
312910;201812;1453;2725;797;1862;127;281;384;898;511;1179
312920;201812;990;2738;683;2209;139;516;308;923;447;1439
312930;201812;2073;5512;1667;4881;369;1105;701;2027;1070;3132
312940;201812;869;2509;696;2229;99;356;331;1036;430;1392
312950;201812;2962;7573;1939;5873;506;1643;639;1869;1145;3512
312960;201812;1857;4986;1557;4537;105;292;1156;3455;1261;3747
312965;201812;1620;4834;1387;4404;127;416;889;2802;1016;3218
312970;201812;1040;3063;809;2673;171;661;366;1109;537;1770
312980;201812;21139;61190;17485;54397;2954;10286;9200;27118;12154;37404
312990;201812;426;1158;267;877;50;196;109;339;159;535
313000;201812;405;1223;320;1072;39;168;166;520;205;688
313005;201812;2520;7406;2152;6771;151;523;1569;4809;1720;5332
313010;201812;4500;13067;3679;11636;658;2351;2144;6517;2802;8868
313020;201812;871;2702;571;2009;88;332;90;266;178;598
313030;201812;1164;2871;778;2266;94;344;450;1226;544;1570
313040;201812;755;2398;613;2076;53;227;334;1055;387;1282
313050;201812;1692;4935;1204;4196;223;928;340;1029;563;1957
313055;201812;1760;5033;1600;4792;49;152;1363;4065;1412;4217
313060;201812;917;2377;619;1876;200;676;131;339;331;1015
313065;201812;1610;5101;1431;4791;78;352;1067;3462;1145;3814
313070;201812;939;2503;706;2075;87;288;396;1130;483;1418
313080;201812;359;1002;256;802;70;247;73;179;143;426
313090;201812;4486;12684;3852;11538;665;2197;2223;6513;2888;8710
313100;201812;1391;3694;1059;3196;54;203;760;2258;814;2461
313110;201812;1451;3947;1019;3142;100;382;555;1569;655;1951
313115;201812;2388;7281;2014;6535;311;1118;1003;3029;1314;4147
313120;201812;3594;8704;2683;7482;289;877;1646;4549;1935;5426
313130;201812;26535;72501;20846;61596;2849;9484;11015;30686;13864;40170
313140;201812;549;1274;340;956;24;88;231;627;255;715
313150;201812;1336;3874;973;3151;268;920;256;774;524;1694
313160;201812;934;2461;720;2096;50;176;496;1391;546;1567
313170;201812;10875;32594;7666;26228;1429;5183;2744;8866;4173;14049
313180;201812;2163;5903;1507;4554;208;692;787;2294;995;2986
313190;201812;4060;12013;2981;9742;550;1886;1014;3083;1564;4969
313200;201812;1058;3055;916;2802;25;104;771;2272;796;2376
313210;201812;3714;11160;3060;9943;421;1485;1748;5508;2169;6993
313220;201812;1674;4541;1127;3483;189;672;403;1093;592;1765
313230;201812;2860;8201;2446;7680;74;239;2057;6512;2131;6751
313240;201812;8458;21738;5245;16348;978;3482;2151;6168;3129;9650
313250;201812;5594;16967;4494;14874;627;2161;2307;7522;2934;9683
313260;201812;585;1567;406;1222;48;169;191;543;239;712
313270;201812;5328;14795;4279;13087;725;2314;2515;7730;3240;10044
313280;201812;408;1194;275;905;38;129;110;359;148;488
313290;201812;792;2592;620;2318;226;909;176;640;402;1549
313300;201812;1516;4395;1105;3592;312;1060;197;566;509;1626
313310;201812;1003;3086;802;2639;135;516;194;532;329;1048
313320;201812;2063;5582;1453;4599;305;1099;621;1944;926;3043
313330;201812;3892;10856;3027;9482;219;943;1956;5904;2175;6847
313340;201812;1258;2927;890;2396;105;279;606;1634;711;1913
313350;201812;2102;6051;1430;4626;218;814;540;1592;758;2406
313360;201812;1219;3158;841;2527;141;490;424;1193;565;1683
313370;201812;1264;3771;1119;3488;132;493;652;1891;784;2384
313375;201812;1611;4282;1001;3166;193;704;236;715;429;1419
313380;201812;5437;14256;3840;11264;790;2510;1597;4235;2387;6745
313390;201812;851;2817;759;2655;62;288;494;1643;556;1931
313400;201812;3449;9070;2758;8135;169;537;2139;6159;2308;6696
313410;201812;1225;3292;947;2814;76;267;681;1982;757;2249
313420;201812;14404;32965;7298;20768;1573;4916;958;2798;2531;7714
313430;201812;828;2477;623;2067;102;389;257;784;359;1173
313440;201812;5643;12505;3686;9924;325;945;2358;6335;2683;7280
313450;201812;607;1744;440;1412;95;341;138;380;233;721
313460;201812;2067;6200;1670;5557;344;1331;769;2401;1113;3732
313470;201812;2953;7503;2356;6654;202;558;1651;4693;1853;5251
313480;201812;860;2514;477;1636;84;311;112;339;196;650
313490;201812;1441;3372;685;2216;236;898;57;188;293;1086
313500;201812;383;1166;295;958;36;123;119;358;155;481
313505;201812;9307;25402;7985;23657;307;1122;6623;19510;6930;20632
313507;201812;1439;3783;1193;3421;29;124;976;2754;1005;2878
313510;201812;11984;33914;9890;30065;1276;4147;5090;15024;6366;19171
313520;201812;12909;38207;10648;34160;765;2821;7634;24066;8399;26887
313530;201812;504;1465;399;1265;23;85;198;596;221;681
313535;201812;2293;6405;2003;5853;145;406;1428;4123;1573;4529
313540;201812;771;2413;579;1908;111;371;215;685;326;1056
313545;201812;1144;3903;977;3563;170;676;527;1829;697;2505
313550;201812;1648;5109;1410;4596;360;1290;638;1973;998;3263
313560;201812;2517;5136;1873;4354;71;155;1590;3673;1661;3828
313570;201812;933;2891;758;2549;186;678;296;958;482;1636
313580;201812;5277;14439;4074;12412;581;1878;2204;6857;2785;8735
313590;201812;932;2699;710;2362;239;872;261;873;500;1745
313600;201812;3662;10276;3075;9327;122;497;2512;7483;2634;7980
313610;201812;957;2536;772;2197;108;312;470;1295;578;1607
313620;201812;5262;14364;4229;12577;702;2278;2222;6404;2924;8682
313630;201812;7865;20074;5441;16336;699;2417;2931;8676;3630;11093
313640;201812;956;2344;600;1844;174;578;200;597;374;1175
313650;201812;1754;5379;1451;4876;96;379;956;3224;1052;3603
313652;201812;757;2538;690;2382;127;483;401;1331;528;1814
313655;201812;1068;2931;860;2633;59;203;650;1969;709;2172
313657;201812;1228;3361;953;2901;51;210;687;1978;738;2188
313660;201812;833;2437;673;2124;103;397;357;1036;460;1433
313665;201812;4378;12171;3386;10398;516;1803;1855;5428;2371;7231
313670;201812;42205;108486;27288;82219;4790;15750;10970;31269;15760;47019
313680;201812;970;2665;819;2428;67;220;528;1503;595;1723
313690;201812;796;2628;634;2296;135;518;200;698;335;1216
313695;201812;1663;4737;1282;4104;100;354;868;2763;968;3117
313700;201812;2993;9911;2611;9396;250;934;2015;7252;2265;8186
313710;201812;1326;3256;953;2707;84;243;635;1802;719;2045
313720;201812;5044;14247;3702;11583;589;2078;1574;4518;2163;6596
313730;201812;1251;2999;954;2590;79;193;631;1671;710;1864
313740;201812;1623;5820;1312;5011;314;1344;190;615;504;1959
313750;201812;1838;5165;1423;4334;313;1068;547;1532;860;2600
313753;201812;2096;5093;1395;3966;161;511;792;2165;953;2676
313760;201812;4837;13767;3574;11263;830;2819;1337;3971;2167;6790
313770;201812;3587;10373;2876;9262;237;834;1998;6481;2235;7315
313780;201812;3893;10727;2892;9006;319;1143;816;2579;1135;3722
313790;201812;463;1473;409;1370;57;203;216;688;273;891
313800;201812;1297;3126;983;2653;119;362;571;1447;690;1809
313810;201812;1546;4125;1228;3664;89;336;887;2601;976;2937
313820;201812;13536;32941;9003;24863;1472;4485;3304;8790;4776;13275
313830;201812;321;942;259;822;59;199;105;304;164;503
313835;201812;897;2755;724;2408;83;323;341;1067;424;1390
313840;201812;6114;16566;4366;13497;1106;3644;954;2969;2060;6613
313850;201812;906;2292;732;2037;124;425;387;951;511;1376
313860;201812;2508;7040;1844;5714;313;1068;698;2010;1011;3078
313862;201812;1507;3379;769;2234;63;194;393;1080;456;1274
313865;201812;2200;6168;1908;5697;128;386;1454;4269;1582;4655
313867;201812;1065;3449;893;3108;282;1023;403;1384;685;2407
313868;201812;1620;5089;1370;4598;80;367;1031;3350;1111;3717
313870;201812;755;2102;569;1781;112;377;192;547;304;924
313880;201812;1387;3761;1011;3133;186;623;427;1201;613;1824
313890;201812;1912;4450;1395;3783;106;335;939;2544;1045;2879
313900;201812;3480;10787;2633;9072;728;2721;624;2049;1352;4770
313910;201812;572;1754;419;1460;98;350;83;285;181;635
313920;201812;2820;9142;2366;8173;514;1722;1137;3990;1651;5712
313925;201812;1531;4044;1217;3454;234;620;725;2068;959;2688
313930;201812;4786;14641;3898;13043;357;1357;2548;8404;2905;9761
313940;201812;7756;23437;5582;19498;1230;4971;1134;4258;2364;9229
313950;201812;4555;10785;3367;9195;484;1724;2038;5353;2522;7077
313960;201812;5137;13091;3497;10269;748;2444;1182;3193;1930;5637
313970;201812;1291;3729;1145;3473;39;156;724;2189;763;2345
313980;201812;1284;3442;822;2674;124;468;291;902;415;1370
313990;201812;1675;5632;1239;4579;342;1402;357;1161;699;2563
314000;201812;9076;24746;7671;22309;487;1840;5258;14990;5745;16830
314010;201812;1296;3289;1046;2937;34;131;809;2201;843;2332
314015;201812;1998;5634;1535;4881;221;835;788;2408;1009;3243
314020;201812;486;1353;286;950;48;191;51;178;99;369
314030;201812;735;2219;582;1908;78;265;290;924;368;1189
314040;201812;642;1750;517;1512;102;329;245;671;347;1000
314050;201812;1609;4435;1159;3567;173;629;569;1597;742;2226
314053;201812;1702;5185;1383;4568;254;812;733;2533;987;3345
314055;201812;2256;6256;1940;5790;55;226;1586;4737;1641;4963
314060;201812;1166;3197;886;2737;44;160;610;1857;654;2017
314070;201812;4285;12170;3358;10437;754;2415;1349;4061;2103;6476
314080;201812;2084;5658;1321;4192;205;785;446;1216;651;2001
314085;201812;1990;6060;1650;5524;342;1182;796;2700;1138;3882
314090;201812;3870;11316;3292;10413;242;967;2170;6778;2412;7745
314100;201812;3075;7399;2420;6492;94;255;1890;5082;1984;5337
314110;201812;4085;12110;3376;10689;469;1683;1766;5240;2235;6923
314120;201812;729;1699;319;986;80;292;57;172;137;464
314130;201812;665;1816;365;1200;39;151;175;556;214;707
314140;201812;4422;12999;3395;10951;567;1971;1526;4793;2093;6764
314150;201812;1397;3646;1058;3056;101;326;688;1893;789;2219
314160;201812;2175;5965;1578;4878;257;842;633;1987;890;2829
314170;201812;975;2791;787;2419;75;265;476;1363;551;1628
314180;201812;5191;15001;4281;13491;413;1471;2489;7777;2902;9248
314190;201812;586;1534;415;1272;93;327;178;490;271;817
314200;201812;2792;8119;2306;7249;132;536;1635;4934;1767;5470
314210;201812;1885;5096;1519;4438;145;451;843;2419;988;2870
314220;201812;1219;3495;863;2837;212;803;278;844;490;1647
314225;201812;1092;3197;937;2947;73;235;688;2161;761;2396
314230;201812;738;1988;617;1834;93;303;369;1131;462;1434
314240;201812;1015;2807;794;2486;177;597;304;963;481;1560
314250;201812;495;1431;312;1027;51;180;112;337;163;517
314260;201812;894;2694;725;2419;162;606;343;1068;505;1674
314270;201812;3073;8988;2531;8118;95;369;1889;5970;1984;6339
314280;201812;3139;7467;1986;5587;299;932;882;2337;1181;3269
314290;201812;4318;11473;3599;10217;389;1115;2393;6686;2782;7801
314300;201812;1596;4795;1111;3697;265;955;331;1062;596;2017
314310;201812;4311;11702;3026;9434;937;3134;583;1698;1520;4832
314315;201812;875;3159;753;2884;62;296;516;1905;578;2201
314320;201812;2559;7136;1700;5523;365;1253;615;1979;980;3232
314330;201812;44386;126456;33810;108005;9995;33389;7467;24593;17462;57982
314340;201812;2192;5580;1183;3670;267;981;257;623;524;1604
314345;201812;1342;4129;1116;3717;156;539;661;2156;817;2695
314350;201812;880;2495;597;1972;121;440;157;482;278;922
314360;201812;551;1644;340;1185;59;227;88;293;147;520
314370;201812;651;1848;522;1630;24;98;397;1197;421;1295
314380;201812;1076;3114;745;2460;186;698;124;403;310;1101
314390;201812;11296;30282;7353;22768;1573;5200;2002;5567;3575;10767
314400;201812;3860;11609;3026;10092;830;2866;1087;3735;1917;6601
314410;201812;2605;7415;1772;5794;323;1173;578;1953;901;3126
314420;201812;765;1922;584;1674;18;96;434;1174;452;1270
314430;201812;6495;17043;4680;13795;857;2632;1872;5356;2729;7988
314435;201812;1414;4062;1168;3644;42;175;888;2710;930;2885
314437;201812;917;2401;638;1927;47;174;327;970;374;1144
314440;201812;561;1648;405;1334;108;401;87;239;195;640
314450;201812;1263;3498;1049;3152;115;420;644;1840;759;2260
314460;201812;3242;10144;2326;8100;583;2152;390;1326;973;3478
314465;201812;2180;6455;1904;5906;61;274;1455;4327;1516;4601
314467;201812;794;2247;678;2036;22;73;551;1624;573;1697
314470;201812;2143;6356;1726;5477;323;1147;751;2204;1074;3351
314480;201812;5626;16942;4009;13332;736;2643;1136;3405;1872;6048
314490;201812;925;2600;684;2088;79;269;403;1184;482;1453
314500;201812;1562;4030;1125;3326;215;661;449;1291;664;1952
314505;201812;1881;4830;1568;4393;102;321;1140;3122;1242;3443
314510;201812;1726;4641;1185;3806;251;885;503;1577;754;2462
314520;201812;3979;12638;2765;9829;510;1993;327;1026;837;3019
314530;201812;5367;17904;4822;16821;438;1763;3356;11513;3794;13276
314535;201812;2519;6715;2061;6036;120;449;1558;4474;1678;4923
314537;201812;1087;3179;838;2748;63;243;579;1849;642;2092
314540;201812;411;1081;285;839;26;99;144;393;170;492
314545;201812;1674;4351;1496;4115;42;109;1267;3617;1309;3726
314550;201812;612;1561;455;1332;40;163;235;610;275;773
314560;201812;3771;11874;2871;9879;482;1773;917;2963;1399;4736
314570;201812;288;815;222;694;32;110;103;324;135;434
314580;201812;425;1316;319;1101;86;310;73;260;159;570
314585;201812;638;2066;503;1755;68;293;239;774;307;1067
314587;201812;1954;5530;1489;4768;226;669;804;2632;1030;3301
314590;201812;3161;9115;2228;7263;361;1312;817;2503;1178;3815
314600;201812;1775;5073;1018;3531;212;802;106;332;318;1134
314610;201812;8176;21811;5739;18108;1146;4197;2297;7005;3443;11202
314620;201812;1966;4938;1549;4370;71;258;1245;3420;1316;3678
314625;201812;1456;4302;1248;4003;66;350;1004;3115;1070;3465
314630;201812;4920;13260;4108;12079;117;489;3415;10006;3532;10495
314640;201812;614;1535;431;1224;74;237;206;532;280;769
314650;201812;829;2057;526;1567;48;175;250;663;298;838
314655;201812;1524;4336;1090;3517;237;766;462;1467;699;2233
314660;201812;319;764;202;538;7;12;121;305;128;317
314670;201812;1614;3816;1155;3155;44;165;720;1935;764;2100
314675;201812;1661;4594;1436;4196;106;376;1096;3091;1202;3467
314690;201812;2007;5899;1531;5122;470;1705;395;1314;865;3019
314700;201812;9357;27470;5958;20418;1279;4844;1479;4869;2758;9713
314710;201812;7175;20605;5117;16290;1123;3907;1183;3336;2306;7243
314720;201812;2035;6207;1412;4893;322;1191;318;1077;640;2268
314730;201812;1955;5590;1426;4537;367;1210;344;1049;711;2259
314740;201812;2670;7708;2105;6679;281;1006;1089;3364;1370;4370
314750;201812;316;893;244;748;21;79;128;357;149;436
314760;201812;1798;5629;1214;4259;169;687;306;881;475;1568
314770;201812;1058;3183;524;1747;46;158;129;378;175;536
314780;201812;331;795;211;619;42;133;110;296;152;429
314790;201812;9073;25331;6319;20301;1724;6231;1657;4890;3381;11121
314795;201812;1391;3837;1188;3487;39;166;932;2619;971;2785
314800;201812;10263;26625;5855;18168;1176;3985;1140;3160;2316;7145
314810;201812;8035;22283;5928;18571;1688;5549;1687;5343;3375;10892
314820;201812;911;2380;700;2035;60;227;438;1215;498;1442
314830;201812;1417;4473;1196;4016;274;980;543;1788;817;2768
314840;201812;861;2830;670;2509;60;321;457;1619;517;1940
314850;201812;1807;4633;1482;4161;54;184;1279;3577;1333;3761
314860;201812;3038;9449;2558;8502;381;1423;1541;4960;1922;6383
314870;201812;5950;16076;4611;14205;361;1252;3334;10256;3695;11508
314875;201812;1692;5206;1507;4953;112;323;1223;4052;1335;4375
314880;201812;866;2149;685;1894;33;90;465;1334;498;1424
314890;201812;392;1149;287;917;43;157;111;323;154;480
314900;201812;617;1689;471;1432;109;354;173;521;282;875
314910;201812;1579;4702;1203;4088;257;1005;572;1810;829;2815
314915;201812;2164;6605;1845;6032;130;492;1262;4016;1392;4508
314920;201812;438;1132;283;903;9;34;194;613;203;647
314930;201812;4868;14523;3709;12258;770;2757;1294;4064;2064;6821
314940;201812;401;1061;338;946;38;99;200;523;238;622
314950;201812;430;1148;273;888;25;111;116;331;141;442
314960;201812;761;1982;591;1658;42;134;411;1091;453;1225
314970;201812;709;2104;574;1856;99;357;267;804;366;1161
314980;201812;1214;3309;883;2792;248;885;257;783;505;1668
314990;201812;2136;6339;1455;4748;321;1155;301;844;622;1999
314995;201812;1567;4535;1252;3975;78;325;776;2342;854;2667
315000;201812;1042;2808;752;2342;76;256;475;1428;551;1684
315010;201812;370;1061;270;866;50;198;115;327;165;525
315015;201812;2084;6149;1867;5811;191;668;1229;3808;1420;4476
315020;201812;747;2281;559;1875;68;262;242;745;310;1007
315030;201812;560;1579;360;1178;88;294;78;236;166;530
315040;201812;794;2363;684;2103;107;357;422;1292;529;1649
315050;201812;1096;2931;842;2555;72;276;459;1359;531;1635
315053;201812;1089;2938;851;2517;66;221;498;1417;564;1638
315057;201812;1570;5089;1367;4674;187;632;850;2953;1037;3585
315060;201812;555;1755;397;1420;73;267;90;319;163;586
315070;201812;554;1502;391;1205;103;357;98;263;201;620
315080;201812;2508;7728;1964;6584;393;1344;939;3115;1332;4459
315090;201812;763;2406;566;2006;103;390;192;639;295;1029
315100;201812;1088;3420;697;2462;130;527;279;874;409;1401
315110;201812;1495;3951;1138;3347;144;437;551;1634;695;2071
315120;201812;11285;27157;8088;22347;1068;2899;4165;11936;5233;14835
315130;201812;1250;3728;1001;3226;158;603;383;1147;541;1750
315140;201812;2684;7691;2068;6560;422;1506;973;2851;1395;4357
315150;201812;4043;10225;2847;8231;440;1407;1255;3514;1695;4921
315160;201812;1487;3805;953;2918;204;628;391;1169;595;1797
315170;201812;1355;4370;911;3280;222;824;155;560;377;1384
315180;201812;15435;39154;7969;24443;1189;4203;2194;5852;3383;10055
315190;201812;1993;4644;1584;4089;219;596;1150;2930;1369;3526
315200;201812;3513;10498;2548;8684;775;2832;579;1920;1354;4752
315210;201812;7618;20467;5465;15869;663;2125;2537;6699;3200;8824
315213;201812;1106;2981;949;2760;27;80;755;2174;782;2254
315217;201812;2458;7770;1964;6882;106;536;1320;4449;1426;4985
315220;201812;7689;21613;6213;19049;1649;5393;2184;6594;3833;11987
315230;201812;3028;7385;2631;6891;63;166;2292;6149;2355;6315
315240;201812;2275;7015;1979;6469;508;1764;985;3152;1493;4916
315250;201812;10002;28299;7341;23275;1249;4313;3135;9595;4384;13908
315260;201812;904;2642;497;1683;83;277;35;98;118;375
315270;201812;748;2262;512;1775;77;317;154;452;231;769
315280;201812;2720;6901;1541;4654;337;1107;242;710;579;1817
315290;201812;1146;2931;677;2176;200;702;180;583;380;1285
315300;201812;685;1690;444;1347;156;520;129;398;285;918
315310;201812;1278;3709;956;3076;85;303;535;1623;620;1926
315320;201812;670;1969;465;1571;53;237;202;629;255;866
315330;201812;737;2600;408;1658;79;344;112;406;191;750
315340;201812;3007;7609;2241;6507;144;476;1482;4258;1626;4734
315350;201812;1451;4064;1097;3451;176;618;554;1696;730;2314
315360;201812;1614;5023;1152;3969;188;696;429;1392;617;2088
315370;201812;424;1261;337;1079;71;221;137;432;208;653
315380;201812;181;568;142;478;38;144;22;52;60;196
315390;201812;1133;3386;858;2848;165;593;318;985;483;1578
315400;201812;3902;11148;3094;9657;466;1524;1540;4647;2006;6171
315410;201812;2219;5197;1749;4524;414;1161;481;1226;895;2387
315415;201812;1150;3320;927;2963;229;860;371;1163;600;2023
315420;201812;1086;3197;704;2439;137;488;87;284;224;772
315430;201812;3436;8638;2413;7022;481;1662;938;2490;1419;4152
315440;201812;954;2615;773;2296;85;311;424;1164;509;1475
315445;201812;1965;4832;1418;4035;126;395;980;2748;1106;3143
315450;201812;2128;6223;1787;5667;265;801;1106;3562;1371;4363
315460;201812;30552;89918;25356;80221;5761;19854;10879;32408;16640;52262
315470;201812;430;1245;344;1090;40;146;187;558;227;704
315480;201812;1251;3667;864;2830;170;583;256;804;426;1387
315490;201812;2900;7265;1975;5883;273;863;721;2125;994;2988
315500;201812;484;1343;293;919;35;144;131;346;166;490
315510;201812;1227;3409;1054;3137;31;143;900;2609;931;2752
315520;201812;1048;2937;822;2564;52;195;585;1775;637;1970
315530;201812;586;1805;463;1535;169;607;163;511;332;1118
315540;201812;1271;3564;862;2766;110;434;359;1110;469;1544
315550;201812;1780;4815;1211;3845;265;952;333;1003;598;1955
315560;201812;6050;19217;5256;17752;367;1260;3463;11789;3830;13049
315570;201812;1794;5195;1506;4676;123;493;854;2507;977;3000
315580;201812;2116;5443;1622;4640;346;1121;544;1527;890;2648
315590;201812;882;2400;703;2108;93;332;340;954;433;1286
315600;201812;2330;7731;1719;6510;286;1071;903;3536;1189;4607
315610;201812;876;2283;673;1892;128;433;289;690;417;1123
315620;201812;304;998;277;956;47;167;163;587;210;754
315630;201812;813;2330;664;2065;148;510;222;621;370;1131
315640;201812;319;861;269;792;30;106;166;462;196;568
315645;201812;927;2448;611;1906;151;511;157;460;308;971
315650;201812;1657;4354;1330;3878;48;199;1074;3024;1122;3223
315660;201812;2412;5958;1827;4964;115;326;1277;3352;1392;3678
315670;201812;12746;36584;9892;31276;2103;7012;4277;13052;6380;20064
315680;201812;2934;9092;2184;7609;378;1442;971;3273;1349;4715
315690;201812;2363;6337;1555;4868;357;1172;467;1588;824;2760
315700;201812;7164;20723;5476;17319;964;3213;2427;7398;3391;10611
315710;201812;1808;4678;1255;3774;68;298;877;2451;945;2749
315720;201812;4141;12055;3521;10924;185;846;2470;7330;2655;8176
315725;201812;1676;4799;1359;4265;168;541;900;2862;1068;3403
315727;201812;520;1413;383;1170;60;219;164;458;224;677
315730;201812;615;1902;538;1744;66;238;248;763;314;1001
315733;201812;1371;3586;946;2822;160;576;346;955;506;1531
315737;201812;1060;3142;853;2747;46;195;600;1867;646;2062
315740;201812;901;2591;700;2176;130;458;361;1017;491;1475
315750;201812;1189;3295;975;2940;88;286;616;1865;704;2151
315760;201812;1177;2849;1078;2729;45;105;948;2406;993;2511
315765;201812;1817;4963;1498;4547;41;155;1298;3914;1339;4069
315770;201812;958;2972;817;2778;318;1164;254;800;572;1964
315780;201812;26162;75369;22238;68141;1927;7131;14016;40906;15943;48037
315790;201812;3469;10957;2983;10028;965;3355;1220;4173;2185;7528
315800;201812;1164;4395;834;3434;161;739;184;693;345;1432
315810;201812;1274;3219;1091;2942;56;210;872;2212;928;2422
315820;201812;2412;7049;1992;6372;215;791;1350;4226;1565;5017
315830;201812;1031;3055;756;2540;55;222;344;1094;399;1316
315840;201812;788;1982;485;1407;62;220;219;568;281;788
315850;201812;1067;3291;875;2954;178;660;427;1357;605;2017
315860;201812;478;1459;334;1177;75;302;91;294;166;596
315870;201812;449;1188;356;1052;26;91;238;657;264;748
315880;201812;1080;2833;722;2207;57;227;218;608;275;835
315890;201812;1498;4535;1199;4077;350;1287;528;1724;878;3011
315895;201812;5685;15853;4395;13287;529;1823;2204;6183;2733;8006
315900;201812;821;2161;715;2015;67;195;530;1454;597;1649
315910;201812;496;1489;413;1345;68;239;260;827;328;1066
315920;201812;1552;4092;799;2486;143;483;228;653;371;1136
315930;201812;1012;2401;672;1872;128;368;292;803;420;1171
315935;201812;767;2402;630;2132;124;451;205;703;329;1154
315940;201812;581;1714;474;1520;57;188;241;755;298;943
315950;201812;1141;3217;972;2939;118;348;729;2222;847;2570
315960;201812;3713;10783;2136;7493;678;2760;142;306;820;3066
315970;201812;628;1704;482;1505;61;199;324;1027;385;1226
315980;201812;3907;8703;2133;5760;412;1177;704;1774;1116;2951
315990;201812;3457;8966;2712;7705;303;915;1588;4452;1891;5367
316000;201812;494;1376;385;1204;65;258;165;474;230;732
316010;201812;675;1949;538;1696;31;111;340;1005;371;1116
316020;201812;948;2949;778;2614;81;353;476;1471;557;1824
316030;201812;2752;7761;2029;6475;247;839;1275;4091;1522;4930
316040;201812;2496;7538;1790;6129;285;1061;446;1427;731;2488
316045;201812;1974;5361;1788;5109;110;255;1466;4302;1576;4557
316050;201812;359;1076;270;908;50;187;139;443;189;630
316060;201812;653;1800;493;1548;38;158;329;957;367;1115
316070;201812;5193;15036;4311;13322;787;2565;1949;5773;2736;8338
316080;201812;706;2261;562;1961;143;546;72;236;215;782
316090;201812;409;1246;286;981;38;154;120;383;158;537
316095;201812;1246;3947;1017;3404;239;831;389;1277;628;2108
316100;201812;2451;7516;1744;5899;314;1138;551;1698;865;2836
316105;201812;831;2263;634;1958;66;215;416;1294;482;1509
316110;201812;12295;37448;10377;34119;1106;3983;6826;22319;7932;26302
316120;201812;1036;3129;654;2154;116;404;160;432;276;836
316130;201812;1169;2670;717;1953;57;195;396;1042;453;1237
316140;201812;1055;2899;662;2163;127;434;313;1005;440;1439
316150;201812;1648;3865;1363;3464;244;749;565;1305;809;2054
316160;201812;1008;2828;816;2491;67;243;517;1516;584;1759
316165;201812;872;2233;657;1886;106;367;340;916;446;1283
316170;201812;1054;2795;781;2372;74;267;484;1393;558;1660
316180;201812;1191;3511;769;2607;159;604;125;341;284;945
316190;201812;2556;7470;1482;4849;241;804;510;1452;751;2256
316200;201812;3169;9416;2268;7667;490;1844;520;1643;1010;3487
316210;201812;3901;11728;2771;9134;853;2998;287;905;1140;3903
316220;201812;589;1801;386;1330;80;307;46;185;126;492
316225;201812;1404;3365;1065;2784;49;193;782;1895;831;2088
316230;201812;407;1098;307;939;41;126;159;499;200;625
316240;201812;5586;16533;4980;15530;429;1390;3791;11680;4220;13070
316245;201812;2882;9816;2600;9333;159;924;1972;6694;2131;7618
316250;201812;8904;22673;6286;18327;1572;4992;1868;5299;3440;10291
316255;201812;2707;7785;2366;7261;209;714;1693;5230;1902;5944
316257;201812;1172;2916;839;2384;143;413;421;1178;564;1591
316260;201812;1758;4679;1329;4001;245;806;569;1748;814;2554
316265;201812;1137;3133;883;2687;50;201;613;1801;663;2002
316270;201812;3413;10979;2930;9883;537;1939;1323;4267;1860;6206
316280;201812;2882;8724;2490;7983;369;1303;1326;4104;1695;5407
316290;201812;3199;9230;2485;7816;345;1247;955;2964;1300;4211
316292;201812;4511;12453;3729;11178;422;1461;2587;7547;3009;9008
316294;201812;752;2297;553;1952;108;436;101;330;209;766
316295;201812;2642;7645;2181;6791;117;473;1531;4533;1648;5006
316300;201812;927;2926;788;2668;55;220;527;1785;582;2005
316310;201812;935;2353;539;1682;78;275;144;399;222;674
316320;201812;562;1623;430;1380;50;195;195;600;245;795
316330;201812;1025;2881;758;2364;63;244;518;1533;581;1777
316340;201812;1005;2907;739;2390;72;292;385;1161;457;1453
316350;201812;1135;3441;978;3181;122;427;638;2040;760;2467
316360;201812;647;1717;511;1495;74;236;341;970;415;1206
316370;201812;4550;12757;3431;10627;688;2452;1099;3010;1787;5462
316380;201812;1577;3936;1226;3448;40;109;881;2471;921;2580
316390;201812;838;2291;609;1880;204;712;141;396;345;1108
316400;201812;1157;3368;773;2589;127;468;275;841;402;1309
316410;201812;1057;3205;883;2917;60;229;690;2218;750;2447
316420;201812;1682;5011;1484;4751;62;276;1211;3782;1273;4058
316430;201812;818;2264;512;1681;118;418;117;366;235;784
316440;201812;668;2142;514;1872;129;530;75;247;204;777
316443;201812;537;1565;406;1306;100;347;99;320;199;667
316447;201812;1761;4902;1548;4562;57;204;1250;3629;1307;3833
316450;201812;2172;6788;1667;5726;208;752;1002;3391;1210;4143
316460;201812;901;2415;728;2140;188;593;365;1017;553;1610
316470;201812;5886;17409;4346;14245;796;2963;1543;4629;2339;7592
316480;201812;202;578;169;521;33;112;81;231;114;343
316490;201812;284;768;206;614;25;84;91;239;116;323
316500;201812;1167;3847;746;2741;148;577;124;420;272;997
316510;201812;685;2325;539;2026;115;463;226;856;341;1319
316520;201812;986;2673;780;2316;122;430;364;1004;486;1434
316530;201812;1010;2843;744;2349;120;477;320;875;440;1352
316540;201812;705;2003;580;1804;99;366;261;756;360;1122
316550;201812;1245;3875;1105;3586;86;331;823;2614;909;2945
316553;201812;3184;9781;2183;7408;501;1820;525;1608;1026;3428
316555;201812;2484;8360;2272;8052;150;629;1743;6262;1893;6891
316556;201812;573;1411;399;1110;21;61;228;575;249;636
316557;201812;907;3031;790;2816;299;1125;222;762;521;1887
316560;201812;255;787;194;700;51;211;53;168;104;379
316570;201812;1081;3347;946;3086;273;905;321;1033;594;1938
316580;201812;384;896;238;641;45;137;100;245;145;382
316590;201812;1265;3392;916;2715;165;498;496;1406;661;1904
316600;201812;939;2983;810;2711;152;547;412;1341;564;1888
316610;201812;572;1835;476;1679;60;282;296;988;356;1270
316620;201812;1989;5648;1728;5292;90;318;1263;3900;1353;4218
316630;201812;1485;4521;1175;3913;340;1117;442;1620;782;2737
316640;201812;136;378;109;340;23;73;51;139;74;212
316650;201812;992;3272;802;2970;69;274;496;1876;565;2150
316660;201812;194;496;87;268;11;40;11;36;22;76
316670;201812;1803;4746;1350;3996;378;1211;414;1166;792;2377
316680;201812;2016;5327;1592;4612;134;448;1151;3250;1285;3698
316690;201812;1011;3116;830;2763;164;589;370;1230;534;1819
316695;201812;972;2907;813;2622;39;172;558;1771;597;1943
316700;201812;359;884;297;813;13;58;228;585;241;643
316710;201812;2701;9272;2076;7916;536;2139;742;2849;1278;4988
316720;201812;18695;53603;13863;44005;2785;9558;5427;16395;8212;25953
316730;201812;386;1113;308;948;60;212;135;360;195;572
316740;201812;665;2054;602;1958;59;259;415;1324;474;1583
316750;201812;384;1196;293;1002;64;235;111;355;175;590
316760;201812;3549;11521;2890;10118;1210;4526;721;2431;1931;6957
316770;201812;1478;3675;1195;3285;34;120;1017;2810;1051;2930
316780;201812;538;1662;418;1432;136;551;63;177;199;728
316790;201812;690;1880;483;1486;119;387;132;378;251;765
316800;201812;5728;16756;4644;14777;431;1599;2607;8001;3038;9600
316805;201812;954;2147;808;1988;17;32;719;1818;736;1850
316810;201812;554;1543;392;1247;82;317;191;577;273;894
316820;201812;319;791;159;490;14;47;49;156;63;203
316830;201812;654;1890;539;1702;84;322;326;974;410;1296
316840;201812;2591;7234;2152;6439;309;1083;1256;3562;1565;4645
316850;201812;1966;5280;1420;4297;206;699;633;1860;839;2559
316860;201812;16430;45050;12608;39204;2334;8278;5674;17163;8008;25441
316870;201812;6391;18521;4804;15350;940;3326;1840;5446;2780;8772
316880;201812;760;2089;630;1904;138;471;284;841;422;1312
316890;201812;1086;2506;677;1954;131;449;364;920;495;1369
316900;201812;2174;6084;1691;5111;364;1210;560;1514;924;2724
316905;201812;489;1511;387;1301;98;352;148;495;246;847
316910;201812;821;2238;539;1756;150;541;47;142;197;683
316920;201812;1516;3955;998;3109;183;617;424;1315;607;1932
316930;201812;7411;22705;5337;18609;998;3739;1160;3900;2158;7639
316935;201812;3689;10437;2650;8493;581;1953;873;2712;1454;4665
316940;201812;6406;19499;4861;16082;880;3238;1649;5015;2529;8253
316950;201812;1702;4223;1327;3685;51;181;1039;2817;1090;2998
316960;201812;4731;11248;3516;9515;475;1407;2237;5888;2712;7295
316970;201812;3279;9796;2859;8947;636;2088;1053;3102;1689;5190
316980;201812;693;2138;500;1740;156;601;64;231;220;832
316990;201812;9841;28056;6996;21969;1894;6300;836;2394;2730;8694
317000;201812;2520;7838;2262;7438;155;504;1655;5478;1810;5982
317005;201812;2460;7271;2013;6352;359;1158;999;3088;1358;4246
317010;201812;20984;50918;12793;38203;3206;10449;3652;11349;6858;21798
317020;201812;57087;138709;31961;93819;6050;19280;8790;23643;14840;42923
317030;201812;619;1757;496;1571;28;115;381;1177;409;1292
317040;201812;9953;26284;7089;21226;1776;5580;2506;7645;4282;13225
317043;201812;796;1910;592;1625;95;269;367;1028;462;1297
317047;201812;1140;2804;768;2199;118;306;423;1230;541;1536
317050;201812;1165;3702;808;2834;111;395;304;955;415;1350
317052;201812;2297;6770;1886;6065;265;921;1197;3788;1462;4709
317057;201812;1565;3994;1115;3202;56;213;716;1995;772;2208
317060;201812;410;1112;236;733;39;133;80;217;119;350
317065;201812;1196;3503;973;3082;63;246;630;1870;693;2116
317070;201812;7373;20817;4912;15906;1064;3849;1068;3265;2132;7114
317075;201812;838;2325;570;1810;100;340;157;457;257;797
317080;201812;5684;13967;4190;11499;1333;3878;1147;2893;2480;6771
317090;201812;4215;13265;3842;12650;379;1240;2754;9042;3133;10282
317100;201812;2309;5672;1573;4543;442;1381;546;1519;988;2900
317103;201812;1734;5515;1524;5129;162;777;993;3085;1155;3862
317107;201812;1283;3610;1014;3070;53;221;618;1661;671;1882
317110;201812;669;1493;319;967;39;141;106;334;145;475
317115;201812;1061;3112;896;2791;56;177;654;2030;710;2207
317120;201812;11556;33502;9072;29244;1365;4940;4688;14519;6053;19459
317130;201812;9241;22418;5719;16630;1152;3698;1826;5235;2978;8933
317140;201812;610;1801;505;1611;52;172;321;1043;373;1215
317150;201812;976;2452;763;2173;35;136;604;1660;639;1796
317160;201812;3492;8611;2373;6894;235;708;1378;4037;1613;4745
317170;201812;1868;4838;1296;3783;219;750;471;1174;690;1924
317180;201812;1600;5253;1230;4347;260;981;323;1070;583;2051
317190;201812;1195;3358;895;2868;112;371;534;1694;646;2065
317200;201812;4652;12675;3446;10480;891;2897;725;2056;1616;4953
317210;201812;1104;2818;867;2478;44;162;626;1818;670;1980
317220;201812;268;868;231;785;61;210;83;286;144;496
320010;201812;4306;12903;3530;11378;592;2012;2054;6467;2646;8479
320013;201812;1557;4709;1122;3715;185;586;512;1738;697;2324
320016;201812;2909;7704;2350;6890;108;316;1888;5499;1996;5815
320020;201812;3681;10204;2814;8653;692;2266;955;3036;1647;5302
320030;201812;1481;4445;1031;3484;228;847;336;1060;564;1907
320035;201812;1644;4723;1378;4259;397;1338;583;1745;980;3083
320040;201812;3410;10173;2794;8998;435;1520;1453;4558;1888;6078
320050;201812;1712;4054;1471;3680;254;722;841;2041;1095;2763
320060;201812;10056;29331;7516;24189;1297;4581;3095;9486;4392;14067
320070;201812;1309;3852;941;3092;197;704;301;959;498;1663
320080;201812;5192;13819;3733;10956;780;2420;1345;3827;2125;6247
320090;201812;6769;18701;4870;14912;1120;3679;2038;5866;3158;9545
320100;201812;2455;7274;1937;6272;441;1524;880;2773;1321;4297
320110;201812;1267;3377;990;2885;202;610;391;1136;593;1746
320115;201812;1721;5791;1498;5389;705;2628;431;1607;1136;4235
320120;201812;15757;42268;10901;33401;1979;6652;4167;12186;6146;18838
320130;201812;34741;102899;29481;93136;4734;16315;16393;50339;21127;66654
320140;201812;2741;8107;2035;6631;414;1526;759;2421;1173;3947
320150;201812;12111;32868;8557;25729;2439;7708;1436;4111;3875;11819
320160;201812;5117;15163;3892;12729;668;2323;1820;5865;2488;8188
320170;201812;1413;4266;1046;3506;291;986;368;1233;659;2219
320180;201812;678;2244;544;1969;196;754;114;400;310;1154
320190;201812;2705;8963;2060;7421;499;1895;469;1615;968;3510
320200;201812;1016;2903;730;2370;191;723;231;730;422;1453
320210;201812;4298;11352;3362;9701;564;1793;1779;4923;2343;6716
320220;201812;2540;7139;1920;6052;364;1223;944;2912;1308;4135
320225;201812;1297;4186;892;3156;328;1241;124;425;452;1666
320230;201812;4376;12786;3334;10987;844;3038;1334;4323;2178;7361
320240;201812;12928;34905;9899;29803;2177;6966;4129;12251;6306;19217
320245;201812;2769;8671;2265;7593;927;3188;503;1675;1430;4863
320250;201812;1783;5168;1189;3750;297;1074;298;831;595;1905
320255;201812;1635;5419;1439;5061;552;1957;576;2142;1128;4099
320260;201812;1007;3015;708;2287;191;674;184;503;375;1177
320265;201812;2296;7331;1936;6599;902;3209;391;1316;1293;4525
320270;201812;2077;6156;1588;5131;324;1126;728;2357;1052;3483
320280;201812;5320;15165;4331;13357;1126;3700;1559;4785;2685;8485
320290;201812;1220;3804;824;2824;241;915;178;553;419;1468
320300;201812;3398;10847;2774;9472;864;3164;551;1807;1415;4971
320305;201812;4565;13542;3632;11618;822;2798;1616;4985;2438;7783
320310;201812;1786;5115;1233;3913;258;868;513;1568;771;2436
320313;201812;2118;5603;1352;4032;345;1072;249;729;594;1801
320316;201812;1433;4209;1180;3710;216;695;646;2025;862;2720
320320;201812;19308;52684;13772;42986;3481;11443;5015;15604;8496;27047
320330;201812;2758;7855;2175;6763;571;1754;956;3081;1527;4835
320332;201812;5027;15062;4157;13491;1024;3576;2043;6506;3067;10082
320334;201812;1792;5392;1266;4240;281;1090;278;773;559;1863
320335;201812;1578;4661;1002;3332;254;902;207;630;461;1532
320340;201812;4586;12099;3831;10901;613;1816;2090;6024;2703;7840
320350;201812;4880;12457;3391;9717;490;1532;1678;4551;2168;6083
320360;201812;1418;3703;1033;2955;148;412;502;1400;650;1812
320370;201812;2316;7567;1828;6402;541;1979;618;2109;1159;4088
320380;201812;2144;6060;1810;5490;286;943;1048;3102;1334;4045
320390;201812;6990;19688;5239;16045;1129;3665;2060;6027;3189;9692
320400;201812;3138;9227;2513;7902;684;2278;977;2989;1661;5267
320405;201812;4232;11599;3236;9883;514;1671;1628;4920;2142;6591
320410;201812;4524;12330;3464;10615;552;1654;1779;5707;2331;7361
320420;201812;2617;7330;2062;6396;598;2041;572;1731;1170;3772
320425;201812;1919;4718;1481;3995;123;388;981;2526;1104;2914
320430;201812;2683;6967;2095;5829;309;916;1240;3296;1549;4212
320435;201812;2172;7026;1710;6071;598;2217;480;1738;1078;3955
320440;201812;1215;3545;898;2896;150;529;403;1262;553;1791
320450;201812;1513;4535;1201;3939;292;1054;523;1620;815;2674
320455;201812;3706;11617;2546;8803;735;2675;705;2344;1440;5019
320460;201812;2038;6314;1432;4922;351;1245;355;1151;706;2396
320465;201812;1162;3423;882;2843;106;373;513;1639;619;2012
320470;201812;3521;9976;2413;7645;618;2119;532;1557;1150;3676
320480;201812;1564;4565;1331;4114;249;865;690;2041;939;2906
320490;201812;17717;48577;13249;40500;2448;8341;5375;16202;7823;24543
320495;201812;1333;3772;905;2929;208;751;308;942;516;1693
320500;201812;44748;124503;36712;110088;6081;19563;20290;58704;26371;78267
320501;201812;4333;12912;3118;10619;866;3309;977;3206;1843;6515
320503;201812;1929;6074;1404;4906;440;1672;443;1419;883;3091
320506;201812;2556;7798;1748;5915;512;1864;133;428;645;2292
320510;201812;9132;25780;7416;22600;1086;3637;4208;12422;5294;16059
320515;201812;1667;4653;1290;3880;381;1216;380;1113;761;2329
320517;201812;1948;6178;1572;5335;552;2014;356;1188;908;3202
320520;201812;30173;82880;22728;69970;4290;14416;9412;28266;13702;42682
320530;201812;27802;77144;21912;66460;2642;9433;13009;37065;15651;46498
330010;201812;18666;52452;15430;46814;2817;8971;8707;25945;11524;34916
330015;201812;1391;3615;1093;3105;189;606;581;1564;770;2170
330020;201812;18756;48789;16474;45497;2334;7386;11646;31171;13980;38557
330022;201812;1882;5120;1439;4372;240;753;850;2548;1090;3301
330023;201812;4027;10096;2790;8252;594;1866;1246;3611;1840;5477
330025;201812;4595;11567;3096;9022;936;2934;942;2704;1878;5638
330030;201812;9373;26732;7234;22897;913;3352;4222;12601;5135;15953
330040;201812;12254;33625;10086;29802;1260;4193;6561;18645;7821;22838
330045;201812;78507;192518;65966;175732;7003;17933;49817;131921;56820;149854
330050;201812;2218;6049;1673;5124;380;1236;748;2184;1128;3420
330060;201812;4682;12919;3914;11626;864;2807;1671;4635;2535;7442
330070;201812;20365;54843;16876;49424;3139;9858;9135;26405;12274;36263
330080;201812;8213;21881;7177;20306;973;2928;4707;13108;5680;16036
330090;201812;3326;7085;2172;5542;201;556;1390;3488;1591;4044
330093;201812;2328;6068;1724;5112;176;548;1201;3565;1377;4113
330095;201812;1074;3248;865;2832;83;335;471;1397;554;1732
330100;201812;63120;175078;53841;160912;4022;14262;39742;116728;43764;130990
330110;201812;1898;5698;1686;5351;308;1085;853;2604;1161;3689
330115;201812;1971;5163;1501;4443;273;847;839;2436;1112;3283
330120;201812;3226;7571;2437;6515;200;606;1761;4594;1961;5200
330130;201812;3381;9726;2840;8897;472;1578;1719;5364;2191;6942
330140;201812;3229;8902;2672;8047;429;1460;1614;4687;2043;6147
330150;201812;1969;5474;1534;4754;337;1104;649;1950;986;3054
330160;201812;1259;3550;1001;3109;193;672;515;1511;708;2183
330170;201812;89841;241273;76460;222328;11568;33658;49726;145634;61294;179292
330180;201812;2045;5280;1610;4593;113;380;1106;3057;1219;3437
330185;201812;8877;24107;7379;21629;796;2723;5286;14959;6082;17682
330187;201812;3654;9667;2950;8582;444;1416;1828;5254;2272;6670
330190;201812;28592;73256;25100;68276;2267;6584;19581;52547;21848;59131
330200;201812;13572;37190;11495;34470;2469;7081;6974;21536;9443;28617
330205;201812;1990;5086;1533;4314;111;369;1053;2856;1164;3225
330210;201812;3240;8533;2351;6854;453;1417;877;2350;1330;3767
330220;201812;10238;26820;7345;21702;1724;5542;2194;5899;3918;11441
330225;201812;3244;8818;2607;7843;220;812;1831;5343;2051;6155
330227;201812;15730;40678;13728;38048;880;2710;11363;31014;12243;33724
330230;201812;1607;3771;1158;3180;70;211;828;2243;898;2454
330240;201812;19871;54012;16065;47642;2890;9271;9014;25946;11904;35217
330245;201812;1598;4084;957;3000;238;782;257;819;495;1601
330250;201812;32756;89180;27974;81752;6484;19163;14139;41944;20623;61107
330260;201812;3989;10884;3179;9641;491;1647;1824;5294;2315;6941
330270;201812;24232;51153;14711;37296;2707;7470;6122;15150;8829;22620
330280;201812;2257;6112;1697;5109;209;689;953;2747;1162;3436
330285;201812;19703;49944;15963;44490;1711;5383;11097;29978;12808;35361
330290;201812;3311;8740;2680;7774;395;1241;1583;4450;1978;5691
330300;201812;5067;12704;3627;10511;416;1363;2260;6382;2676;7745
330310;201812;2151;5694;1647;4825;103;299;1091;3205;1194;3504
330320;201812;13817;35217;11404;32020;1665;4745;7908;22341;9573;27086
330330;201812;29110;70077;23768;62488;2839;8181;16490;42251;19329;50432
330340;201812;13081;34099;9668;28522;1847;5992;4590;12891;6437;18883
330350;201812;97905;249363;83557;230638;7795;22694;64046;175836;71841;198530
330360;201812;7320;18332;6294;17110;350;1031;5236;14115;5586;15146
330370;201812;4431;13073;3276;11008;796;2814;1233;4250;2029;7064
330380;201812;4758;13547;3684;11631;785;2739;1591;4827;2376;7566
330385;201812;3791;11551;3164;10569;830;3054;1376;4594;2206;7648
330390;201812;22155;64987;17641;56296;3125;11038;8897;27039;12022;38077
330395;201812;3062;8017;2585;7375;228;710;1750;4892;1978;5602
330400;201812;2847;8006;2508;7406;195;709;1807;5021;2002;5730
330410;201812;2735;7719;2039;6450;432;1459;874;2614;1306;4073
330411;201812;2534;7081;2044;6143;167;579;1424;4105;1591;4684
330412;201812;1396;4253;1143;3793;165;600;629;1945;794;2545
330414;201812;21890;57466;18016;52058;2153;6213;12342;35556;14495;41769
330415;201812;3447;9758;2694;8460;387;1222;1488;4770;1875;5992
330420;201812;9203;23456;6079;18187;931;3069;2533;7169;3464;10238
330430;201812;8356;21555;7242;19876;586;1933;5337;14060;5923;15993
330440;201812;1939;5481;1484;4749;338;1208;670;2035;1008;3243
330450;201812;1261;3807;1031;3373;159;570;509;1606;668;2176
330452;201812;14063;37384;11150;32726;2011;6386;6257;17862;8268;24248
330455;201812;512412;1270193;393145;1090107;65658;192325;231945;632162;297603;824487
330460;201812;1131;3282;878;2881;186;642;418;1338;604;1980
330470;201812;4413;11576;3294;9790;928;2841;1242;3723;2170;6564
330475;201812;8378;22685;6762;20469;1409;4687;3894;11527;5303;16214
330480;201812;5691;15560;4888;14288;548;1795;3170;8978;3718;10773
330490;201812;109318;263122;92050;238689;10426;29000;65489;166762;75915;195762
330500;201812;5792;15689;4950;14450;687;2197;3429;9835;4116;12032
330510;201812;35062;94205;27951;83832;6943;21535;14322;42657;21265;64192
330513;201812;1207;3260;961;2876;265;853;395;1146;660;1999
330515;201812;2394;6738;1982;6065;534;1720;886;2622;1420;4342
330520;201812;10235;28648;8473;25627;1356;4541;4700;13666;6056;18207
330530;201812;1633;4127;1190;3375;250;770;515;1392;765;2162
330540;201812;2734;7501;2132;6421;629;1934;758;2267;1387;4201
330550;201812;7446;22071;6178;20027;2145;7388;1833;5835;3978;13223
330555;201812;12659;30636;10625;27981;1339;3857;7415;19582;8754;23439
330560;201812;4160;11468;3409;10151;478;1483;2034;5864;2512;7347
330570;201812;2783;7887;2291;7021;410;1369;1334;4011;1744;5380
330575;201812;5204;13984;4506;12749;372;1182;3427;9345;3799;10527
330580;201812;12731;36219;9831;30675;2222;7454;4276;12798;6498;20252
330590;201812;1442;4099;1264;3878;169;519;869;2703;1038;3222
330600;201812;10940;30355;8633;26370;1299;4169;4790;14450;6089;18619
330610;201812;8737;24413;7324;22190;758;2679;4791;14078;5549;16757
330615;201812;1962;5564;1506;4915;326;1178;877;2856;1203;4034
330620;201812;3554;10898;2902;9703;838;3034;993;3091;1831;6125
330630;201812;22972;60633;18165;52700;1823;6209;12344;34344;14167;40553
350010;201812;1827;4976;897;2838;220;719;96;229;316;948
350020;201812;662;1742;343;1091;43;149;126;362;169;511
350030;201812;3593;10494;2642;8628;683;2371;819;2564;1502;4935
350040;201812;619;1877;374;1332;58;230;115;337;173;567
350050;201812;877;2367;614;1865;132;471;198;465;330;936
350055;201812;746;1995;631;1829;47;156;496;1424;543;1580
350060;201812;105;283;78;235;15;48;38;107;53;155
350070;201812;3540;9483;2162;6845;415;1387;693;1993;1108;3380
350075;201812;592;1834;437;1515;173;626;49;152;222;778
350080;201812;595;1613;367;1154;46;165;160;456;206;621
350090;201812;616;1509;350;1007;77;230;110;297;187;527
350100;201812;1995;5483;1313;4203;165;613;653;1960;818;2573
350110;201812;380;1080;298;922;23;87;194;578;217;665
350115;201812;1270;3783;1023;3233;187;652;510;1463;697;2115
350120;201812;655;1608;348;992;53;164;169;457;222;621
350130;201812;2975;8255;2380;7098;374;1197;1239;3488;1613;4685
350140;201812;614;1871;450;1560;31;144;250;794;281;938
350150;201812;500;1573;411;1386;97;322;102;324;199;646
350160;201812;10272;25944;6683;19490;835;2890;3943;10769;4778;13659
350170;201812;1713;5174;1313;4227;260;873;465;1405;725;2278
350180;201812;1068;2685;539;1650;115;371;174;499;289;870
350190;201812;2711;7841;1887;6109;416;1531;699;1858;1115;3389
350200;201812;397;1111;314;954;23;74;220;631;243;705
350210;201812;5083;12066;3362;9410;637;1863;1827;4952;2464;6815
350220;201812;2711;7497;1827;5760;392;1315;661;1900;1053;3215
350230;201812;909;2535;753;2278;150;483;385;1132;535;1615
350240;201812;671;2019;437;1452;77;262;149;476;226;738
350250;201812;2244;7022;1696;6009;598;2303;286;1049;884;3352
350260;201812;767;1905;485;1389;63;187;269;744;332;931
350270;201812;4476;12599;3556;10756;604;1991;1770;4988;2374;6979
350275;201812;2226;6360;1769;5518;316;1090;923;2704;1239;3794
350280;201812;18136;41370;10690;29211;2015;5892;3829;10092;5844;15984
350290;201812;2901;8201;1944;6212;380;1341;733;2188;1113;3529
350300;201812;638;1782;456;1393;86;278;183;507;269;785
350310;201812;759;2267;567;1830;87;329;234;669;321;998
350315;201812;539;1469;364;1143;45;164;154;429;199;593
350320;201812;11885;32217;9136;27227;2308;7421;2699;7774;5007;15195
350330;201812;13044;33202;9332;25768;1287;3839;5410;14156;6697;17995
350335;201812;341;979;260;828;17;59;167;521;184;580
350340;201812;1059;2814;622;1978;114;388;217;678;331;1066
350350;201812;730;1977;560;1766;90;322;298;896;388;1218
350360;201812;928;2913;763;2527;231;756;231;778;462;1534
350370;201812;574;1507;381;1128;114;319;84;247;198;566
350380;201812;4218;11561;2778;8730;720;2298;717;2303;1437;4601
350390;201812;8988;25190;7243;22068;1894;6000;2805;8324;4699;14324
350395;201812;408;1056;185;611;21;65;53;160;74;225
350400;201812;7393;19143;5178;15339;1347;4354;1478;4139;2825;8493
350410;201812;8594;25060;6234;20281;1453;5289;2032;6069;3485;11358
350420;201812;611;1747;450;1440;86;320;94;271;180;591
350430;201812;659;1854;541;1640;61;215;339;944;400;1159
350440;201812;1615;4346;1294;3823;150;512;796;2281;946;2793
350450;201812;6079;17714;4809;15332;1109;3817;1814;5479;2923;9296
350460;201812;1565;4030;781;2433;136;477;160;433;296;910
350470;201812;250;635;186;518;6;25;122;311;128;336
350480;201812;824;2243;542;1671;113;388;83;213;196;601
350490;201812;1702;4741;1229;3869;295;957;389;1124;684;2081
350500;201812;647;1775;500;1504;91;304;234;661;325;965
350510;201812;1017;2789;724;2216;89;303;382;1105;471;1408
350520;201812;1849;5962;1398;4967;272;1079;587;1918;859;2997
350530;201812;2439;6315;1765;4980;278;870;951;2533;1229;3403
350535;201812;1397;3986;1218;3722;154;551;804;2379;958;2930
350540;201812;1635;4306;1177;3548;207;660;606;1820;813;2480
350550;201812;8726;21620;5768;16674;678;2266;2991;8122;3669;10388
350560;201812;3617;10578;2888;9166;279;976;1767;5417;2046;6393
350570;201812;20398;59499;16498;51662;3717;12635;7398;21955;11115;34590
350580;201812;1747;4886;922;2998;218;766;118;295;336;1061
350590;201812;4201;11918;3061;9338;540;1877;1627;4542;2167;6419
350600;201812;35605;85764;22418;61551;3072;9373;11051;27783;14123;37156
350610;201812;6230;17647;4551;14254;941;3116;1924;5844;2865;8960
350620;201812;403;1000;247;766;31;112;129;371;160;483
350630;201812;1426;3820;1028;3091;77;295;618;1733;695;2028
350635;201812;7342;19160;5571;16268;1014;3323;3034;8349;4048;11672
350640;201812;882;2449;483;1515;63;206;159;433;222;639
350650;201812;7385;20460;4857;15157;993;3351;1517;4359;2510;7710
350660;201812;4303;11765;3361;10147;639;1967;1654;5016;2293;6983
350670;201812;1705;4720;1406;4276;186;601;868;2642;1054;3243
350680;201812;1079;2962;696;2212;138;463;297;910;435;1373
350690;201812;1097;3088;814;2547;147;486;413;1237;560;1723
350700;201812;4748;12176;2992;9383;597;2085;1141;3344;1738;5429
350710;201812;2510;7195;2125;6501;295;1022;1223;3584;1518;4606
350715;201812;853;2453;696;2141;88;323;318;866;406;1189
350720;201812;165;416;120;339;24;72;49;124;73;196
350730;201812;482;1472;377;1252;40;168;233;719;273;887
350740;201812;1532;4334;1009;3188;175;583;275;793;450;1376
350745;201812;515;1411;317;1001;34;116;136;385;170;501
350750;201812;8640;24018;6770;20505;1273;4368;2855;7690;4128;12058
350760;201812;12494;32732;8805;26182;2223;7119;2511;6699;4734;13818
350770;201812;744;1944;511;1518;63;194;316;916;379;1110
350775;201812;656;1653;462;1332;61;190;194;537;255;727
350780;201812;1880;4956;1331;4081;287;970;412;1402;699;2372
350790;201812;1595;4378;975;3161;178;637;203;570;381;1207
350800;201812;3053;9297;2628;8519;424;1452;1380;4380;1804;5832
350810;201812;2312;5939;1847;5290;281;840;1040;3046;1321;3886
350820;201812;796;1952;452;1301;47;146;228;606;275;752
350830;201812;830;2380;457;1528;55;202;138;397;193;599
350840;201812;2637;8140;1958;6778;509;1898;679;2196;1188;4094
350850;201812;6265;18415;4771;15496;1235;4240;1564;4953;2799;9193
350860;201812;3093;8822;2773;8352;142;558;2090;6157;2232;6715
350870;201812;2619;7573;1908;6382;328;1233;970;3112;1298;4345
350880;201812;1148;3448;920;2941;209;681;313;967;522;1648
350890;201812;560;1505;345;1050;46;155;126;330;172;485
350900;201812;6000;17205;3824;12322;1139;3966;673;2024;1812;5990
350910;201812;817;2174;700;1963;112;364;460;1245;572;1609
350920;201812;11271;29372;9638;26557;572;1874;7568;19965;8140;21839
350925;201812;4219;12030;3003;9663;616;2081;1243;3616;1859;5697
350930;201812;1403;3620;933;2725;121;377;497;1375;618;1752
350940;201812;1942;5512;1549;4777;201;675;958;2873;1159;3548
350945;201812;838;2430;632;2009;119;420;270;779;389;1199
350950;201812;75817;204807;59160;171579;8771;28030;34327;94465;43098;122495
350960;201812;5321;15266;4134;12974;662;2345;2251;6661;2913;9006
350970;201812;3303;10079;2443;8222;796;2933;354;1025;1150;3958
350980;201812;545;1602;442;1400;149;488;158;494;307;982
350990;201812;1653;4964;1252;4266;312;1191;411;1302;723;2493
350995;201812;741;2400;662;2224;44;193;452;1436;496;1629
351000;201812;2548;6798;1776;5365;411;1380;489;1374;900;2754
351010;201812;293;729;173;506;19;59;88;243;107;302
351015;201812;689;2140;560;1884;80;313;269;824;349;1137
351020;201812;8852;24863;6716;21229;1321;4395;3429;10563;4750;14958
351030;201812;2390;7382;1935;6437;301;1136;993;3174;1294;4310
351040;201812;4356;11490;3709;10447;245;856;2899;7848;3144;8704
351050;201812;16009;40050;10699;31417;2367;7424;4116;11875;6483;19299
351060;201812;42885;112130;33063;94875;4437;13814;20640;57264;25077;71078
351070;201812;1275;3360;744;2382;221;746;96;297;317;1043
351080;201812;2464;6519;1812;5674;345;1230;968;2796;1313;4026
351090;201812;322;981;220;780;43;160;51;190;94;350
351100;201812;2288;6382;1462;4658;357;1222;385;1241;742;2463
351110;201812;5637;14835;3647;11093;741;2466;1378;3848;2119;6314
351120;201812;695;1863;479;1453;75;247;205;579;280;826
351130;201812;993;2583;453;1486;89;304;74;217;163;521
351140;201812;1703;5068;1202;4065;318;1186;322;942;640;2128
351150;201812;1837;5492;1124;3822;224;807;334;1016;558;1823
351160;201812;1062;3490;845;2978;199;740;265;831;464;1571
351170;201812;1321;3854;1141;3481;134;445;713;2088;847;2533
351190;201812;824;2385;572;1815;113;349;223;650;336;999
351200;201812;1546;3862;1171;3281;76;249;782;2095;858;2344
351210;201812;1494;3761;848;2435;85;280;467;1217;552;1497
351220;201812;2954;8778;2539;8025;363;1202;1606;5007;1969;6209
351230;201812;1712;4916;1261;4086;277;1018;495;1411;772;2429
351240;201812;1860;4941;1219;3571;241;762;539;1441;780;2203
351250;201812;1064;2831;581;1827;71;239;216;679;287;918
351260;201812;899;2413;663;1975;159;472;221;662;380;1134
351270;201812;369;1086;302;968;56;222;158;433;214;655
351280;201812;3823;10567;2964;8872;514;1693;1407;3974;1921;5667
351290;201812;974;2573;660;1988;118;361;303;890;421;1251
351300;201812;13976;39901;9575;31096;2014;6963;3571;11476;5585;18439
351310;201812;2986;7921;2284;6741;227;815;1480;4060;1707;4875
351320;201812;858;2622;638;2086;105;377;231;702;336;1079
351330;201812;605;1867;524;1717;45;124;394;1317;439;1441
351340;201812;6008;17909;4784;15685;1280;4336;1866;6128;3146;10464
351350;201812;11091;29412;9312;26329;1048;3203;6811;18695;7859;21898
351360;201812;3702;10323;3057;9255;778;2553;1034;2884;1812;5437
351370;201812;2063;5991;1377;4508;350;1175;443;1302;793;2477
351380;201812;42831;108671;30947;86844;5010;14856;16226;43801;21236;58657
351385;201812;275;704;158;480;34;93;50;153;84;246
351390;201812;1313;3335;825;2594;122;454;466;1361;588;1815
351400;201812;882;2571;698;2169;165;509;350;1070;515;1579
351410;201812;2195;6363;1640;5256;318;1035;693;2190;1011;3225
351420;201812;343;828;177;522;36;96;70;198;106;294
351430;201812;748;2267;677;2133;57;203;519;1593;576;1796
351440;201812;3144;8484;2033;6109;396;1291;520;1315;916;2606
351450;201812;1670;4427;1111;3407;242;810;229;616;471;1426
351460;201812;733;2019;589;1768;169;490;282;855;451;1345
351470;201812;1127;3000;864;2534;85;291;520;1434;605;1725
351480;201812;2499;7672;2035;6843;325;1207;934;2982;1259;4189
351490;201812;1772;5320;1537;4856;88;350;1142;3441;1230;3791
351492;201812;331;915;268;779;14;47;170;474;184;521
351495;201812;179;519;133;409;19;59;69;197;88;256
351500;201812;33345;86133;24649;70518;4700;14328;12739;34774;17439;49102
351510;201812;11182;29215;8199;23798;1222;4013;4807;13265;6029;17278
351512;201812;467;1313;305;936;47;150;96;262;143;412
351515;201812;3016;7040;1788;4998;347;1093;468;1304;815;2397
351518;201812;2205;5747;1417;4340;196;687;753;2088;949;2775
351519;201812;584;1689;366;1192;57;188;69;196;126;384
351520;201812;1106;2821;417;1325;61;222;159;430;220;652
351530;201812;345;976;192;618;37;131;60;144;97;275
351535;201812;1998;4933;1431;3972;192;610;803;2086;995;2696
351540;201812;2015;5185;1304;3956;401;1380;262;648;663;2028
351550;201812;5676;14870;3835;11244;464;1586;2078;5601;2542;7187
351560;201812;392;1180;317;1029;72;266;92;280;164;546
351565;201812;173;536;135;463;34;122;42;136;76;258
351570;201812;17628;49050;13224;39519;1700;5518;8031;22949;9731;28467
351580;201812;270;716;154;483;16;46;55;187;71;233
351590;201812;491;1133;262;713;32;106;146;355;178;461
351600;201812;1467;3919;1122;3285;133;428;658;1782;791;2210
351610;201812;721;1742;471;1306;24;80;248;620;272;700
351620;201812;18918;53695;14109;44427;2488;8857;5814;16376;8302;25233
351630;201812;24586;68537;20101;60407;3549;11180;11941;34925;15490;46105
351640;201812;14957;41401;11632;34946;1430;4845;7444;21393;8874;26238
351650;201812;401;1098;172;566;25;76;36;115;61;191
351660;201812;747;2219;452;1483;80;292;84;244;164;536
351670;201812;4989;13965;3583;10830;709;2202;1673;4713;2382;6915
351680;201812;401;1203;246;796;51;152;61;177;112;329
351685;201812;418;1265;330;1101;84;288;103;323;187;611
351690;201812;985;2575;570;1710;107;348;211;554;318;902
351700;201812;1016;2716;817;2353;123;358;449;1232;572;1590
351710;201812;710;1967;467;1485;49;188;211;599;260;787
351720;201812;1367;3705;882;2768;158;539;339;990;497;1529
351730;201812;884;2445;731;2157;83;294;430;1185;513;1479
351740;201812;3532;9141;2741;7610;508;1478;1227;3142;1735;4620
351750;201812;1225;3432;738;2497;144;526;238;804;382;1330
351760;201812;3215;9330;2256;7271;493;1754;777;2286;1270;4040
351770;201812;1775;5370;1435;4694;350;1172;627;2038;977;3210
351780;201812;1365;3577;682;2124;116;427;194;560;310;987
351790;201812;1200;3005;961;2669;163;438;573;1617;736;2055
351800;201812;525;1242;258;737;35;106;82;195;117;301
351810;201812;948;2578;775;2294;49;120;566;1622;615;1742
351820;201812;2365;6851;1613;5299;399;1423;303;956;702;2379
351830;201812;4011;11263;3111;9632;367;1330;1793;5290;2160;6620
351840;201812;7209;21214;5509;17989;930;3374;2553;7872;3483;11246
351850;201812;1749;4667;1075;3388;209;742;298;834;507;1576
351860;201812;2692;8097;2134;6985;402;1394;1109;3596;1511;4990
351870;201812;21220;56868;16467;48856;5337;16370;5642;17398;10979;33768
351880;201812;107305;296946;80754;247868;22767;75527;25964;75226;48731;150753
351885;201812;721;2147;599;1894;95;308;338;1026;433;1334
351890;201812;620;1816;472;1539;100;317;64;180;164;497
351900;201812;954;2697;744;2359;149;487;344;1082;493;1569
351905;201812;370;1056;246;792;24;85;89;246;113;331
351907;201812;20546;55338;16061;47177;1687;5490;10635;30235;12322;35725
351910;201812;1170;3137;823;2425;112;381;439;1149;551;1530
351920;201812;852;2284;616;1825;78;255;302;827;380;1082
351925;201812;891;2539;691;2143;111;374;320;930;431;1304
351930;201812;2942;8639;2704;8159;325;1130;2053;6022;2378;7152
351940;201812;1034;2730;744;2205;104;348;397;1129;501;1477
351950;201812;1365;3312;1048;2867;53;172;722;1927;775;2099
351960;201812;4902;12998;3617;10687;814;2598;1520;4182;2334;6780
351970;201812;5636;18135;4764;16507;844;3290;2544;8415;3388;11705
351980;201812;1005;2468;643;1840;79;268;368;978;447;1246
351990;201812;1340;3305;936;2657;96;348;394;1016;490;1364
352000;201812;2359;7077;2012;6347;251;923;1250;3617;1501;4540
352010;201812;1985;5684;1588;4939;402;1354;282;920;684;2274
352020;201812;1438;4042;1119;3483;197;653;535;1573;732;2226
352030;201812;5228;14405;4149;12642;854;2800;2120;6319;2974;9119
352040;201812;2320;6469;1455;4648;257;867;393;1093;650;1960
352042;201812;3041;7630;1796;5415;367;1182;693;2088;1060;3270
352044;201812;1914;5385;1099;3742;184;656;205;647;389;1303
352050;201812;11444;31569;7306;23037;1792;6354;1136;3099;2928;9453
352060;201812;694;1961;506;1593;71;248;229;667;300;915
352070;201812;766;1606;525;1283;74;207;285;655;359;862
352080;201812;447;1173;270;807;37;124;97;249;134;373
352090;201812;1367;4213;1079;3542;159;583;407;1198;566;1781
352100;201812;2881;8373;2402;7449;595;1985;1061;3112;1656;5097
352110;201812;537;1686;417;1405;88;316;160;507;248;823
352115;201812;495;1465;406;1314;77;283;214;675;291;958
352120;201812;850;2635;670;2235;76;279;368;1140;444;1419
352130;201812;1791;5152;1131;3466;222;710;415;1188;637;1898
352140;201812;1230;3372;802;2498;133;447;373;1125;506;1572
352150;201812;798;2221;606;1869;134;431;306;934;440;1365
352160;201812;944;2395;683;1984;91;309;345;935;436;1244
352170;201812;2870;8049;2264;6781;434;1424;1135;3138;1569;4562
352180;201812;2561;7119;2035;6105;481;1622;635;1655;1116;3277
352190;201812;1111;3071;830;2609;135;459;362;1139;497;1598
352200;201812;354;1098;241;846;29;112;85;292;114;404
352210;201812;17016;42237;13438;37188;1406;4233;9697;26466;11103;30699
352215;201812;528;1442;455;1340;53;161;315;907;368;1068
352220;201812;15597;41347;10538;31776;2754;8687;3280;9569;6034;18256
352230;201812;11843;36342;9005;30724;2310;8621;2965;9494;5275;18115
352240;201812;10645;28346;7899;23541;1779;6009;3130;8403;4909;14412
352250;201812;20905;60986;17004;53849;3744;12556;8867;27539;12611;40095
352260;201812;4681;12329;3198;9316;537;1831;1713;4510;2250;6341
352265;201812;890;2605;781;2416;67;258;552;1642;619;1900
352270;201812;1434;4462;1056;3618;234;887;333;1032;567;1919
352280;201812;2282;6041;1759;5249;192;710;956;2635;1148;3345
352290;201812;1023;3111;850;2755;147;513;407;1191;554;1704
352300;201812;928;2583;642;1988;94;327;295;813;389;1140
352310;201812;42143;114420;31185;94962;8224;25432;13046;39948;21270;65380
352320;201812;5891;16307;4550;13598;774;2550;2197;5868;2971;8418
352330;201812;2000;5669;1550;5007;315;1198;717;2164;1032;3362
352340;201812;4736;13195;3439;10786;729;2518;1426;4146;2155;6664
352350;201812;1912;5706;1536;4868;191;740;819;2317;1010;3057
352360;201812;1113;3058;953;2792;106;391;688;1909;794;2300
352370;201812;996;2993;866;2752;36;162;650;1999;686;2161
352380;201812;792;2280;611;1941;146;495;197;588;343;1083
352390;201812;15269;38396;10273;29706;1648;5253;5545;15131;7193;20384
352400;201812;3344;9348;2804;8374;472;1754;1711;4689;2183;6443
352410;201812;2916;7910;2229;6715;270;961;1316;3785;1586;4746
352420;201812;853;2118;585;1692;112;334;199;547;311;881
352430;201812;6883;18269;4946;14793;1364;4462;1899;5334;3263;9796
352440;201812;16151;45897;12368;38353;2812;9199;4997;14889;7809;24088
352450;201812;778;2056;379;1263;51;175;106;329;157;504
352460;201812;2774;7973;1881;6212;410;1497;610;1889;1020;3386
352470;201812;3373;8604;2438;7039;305;1018;1365;3648;1670;4666
352480;201812;3307;8242;2202;6221;367;1148;1045;2703;1412;3851
352490;201812;692;2156;535;1825;107;407;225;713;332;1120
352500;201812;9396;25022;6614;19792;3058;9862;811;1503;3869;11365
352510;201812;3224;9104;2392;7601;567;1975;894;2651;1461;4626
352520;201812;2370;6820;1843;5838;437;1533;853;2480;1290;4013
352530;201812;8547;23803;5474;17257;1195;4259;955;2258;2150;6517
352540;201812;516;1552;379;1239;71;238;91;269;162;507
352550;201812;939;2797;652;2202;125;472;179;554;304;1026
352560;201812;530;1534;371;1176;65;224;129;369;194;593
352570;201812;1912;5755;1217;4237;304;1120;182;556;486;1676
352580;201812;711;1979;573;1726;93;316;282;804;375;1120
352585;201812;233;692;177;575;19;82;91;277;110;359
352590;201812;12837;34796;8980;27070;2743;8877;3446;9572;6189;18449
352600;201812;1869;5290;1408;4342;237;785;710;2060;947;2845
352610;201812;2896;8398;2157;7045;477;1696;771;2388;1248;4084
352620;201812;5404;14671;4236;12821;1315;4051;1486;4530;2801;8581
352630;201812;800;1998;605;1704;100;335;280;711;380;1046
352640;201812;2838;7590;2078;6267;189;615;1287;3747;1476;4362
352650;201812;562;1654;395;1254;60;220;142;418;202;638
352660;201812;965;3009;782;2642;164;572;328;1079;492;1651
352670;201812;7889;22410;4983;16301;1376;4844;567;1801;1943;6645
352680;201812;3144;9685;2218;7446;399;1533;972;2988;1371;4521
352690;201812;27000;69945;19893;56939;1874;6139;12667;34431;14541;40570
352700;201812;546;1422;400;1205;159;531;88;213;247;744
352710;201812;4729;12660;3373;10103;859;2835;1335;3689;2194;6524
352720;201812;7598;22078;5918;18619;2741;8812;832;2296;3573;11108
352725;201812;484;1260;246;752;18;61;106;300;124;361
352730;201812;2616;7555;2245;6707;366;1242;1287;3504;1653;4746
352740;201812;2110;5180;1579;4362;219;672;859;2263;1078;2935
352750;201812;399;998;210;644;44;128;66;177;110;305
352760;201812;1365;4010;1081;3381;154;521;546;1647;700;2168
352770;201812;889;2426;578;1796;117;368;209;618;326;986
352780;201812;635;1900;448;1524;86;312;140;452;226;764
352790;201812;512;1383;337;1022;39;121;119;310;158;431
352800;201812;1192;3801;862;2986;206;749;155;470;361;1219
352810;201812;1058;2576;630;1761;98;301;334;865;432;1166
352820;201812;498;1307;319;992;77;241;67;214;144;455
352830;201812;579;1511;251;793;38;135;46;116;84;251
352840;201812;3692;11131;3065;9932;1072;3750;930;2844;2002;6594
352850;201812;9592;24739;6415;19458;1778;5740;1870;5383;3648;11123
352860;201812;995;2812;703;2244;139;481;222;677;361;1158
352870;201812;864;2208;593;1629;49;160;376;981;425;1141
352880;201812;1798;4414;1239;3388;182;529;692;1731;874;2260
352885;201812;260;766;190;629;26;96;111;358;137;454
352890;201812;692;1695;419;1114;52;148;218;496;270;644
352900;201812;16783;44919;11248;33858;2008;6607;4968;13895;6976;20502
352910;201812;459;1223;216;680;25;72;51;147;76;219
352920;201812;2487;6628;1777;5299;159;551;1119;3166;1278;3717
352930;201812;5352;15073;3964;12258;746;2469;1698;4910;2444;7379
352940;201812;21251;61351;15873;49548;4056;13953;4876;14214;8932;28167
352950;201812;471;1247;262;829;58;196;31;82;89;278
352960;201812;672;1869;339;1111;53;191;64;196;117;387
352965;201812;259;703;147;488;41;134;29;83;70;217
352970;201812;2874;6993;2199;5917;229;628;1474;3939;1703;4567
352980;201812;1344;3782;1050;3296;247;829;465;1398;712;2227
352990;201812;3904;11167;3196;9993;613;2137;1668;4995;2281;7132
353000;201812;453;1252;217;697;33;117;49;137;82;254
353010;201812;2446;6316;1618;4782;396;1278;516;1394;912;2672
353020;201812;3546;9372;2048;6200;289;962;724;2001;1013;2963
353030;201812;3966;10578;2703;8182;664;2119;588;1745;1252;3864
353040;201812;567;1390;420;1145;57;177;228;569;285;746
353050;201812;4833;14580;3572;11922;787;2820;1484;4716;2271;7536
353060;201812;44204;117303;36410;104530;3064;10548;26333;72567;29397;83115
353070;201812;8851;25812;6208;20257;1369;4775;2017;6211;3386;10986
353080;201812;3917;11378;2721;8958;590;2152;876;2605;1466;4757
353090;201812;506;1632;410;1424;47;188;221;727;268;915
353100;201812;298;819;119;390;19;64;33;91;52;155
353110;201812;6841;19750;5694;17996;993;3324;3303;10548;4296;13872
353120;201812;424;1090;287;824;41;123;126;315;167;438
353130;201812;2241;5648;1495;4449;439;1429;463;1295;902;2724
353140;201812;2185;5686;1627;4634;154;501;995;2637;1149;3138
353150;201812;1389;3606;985;2910;226;694;396;1089;622;1783
353160;201812;554;1481;387;1197;82;285;156;423;238;708
353170;201812;489;1420;391;1273;77;303;184;551;261;854
353180;201812;9269;23547;7315;20434;950;2976;5055;13688;6005;16664
353190;201812;3223;8965;2549;7576;292;983;1545;4261;1837;5244
353200;201812;1995;5400;878;2893;108;389;205;600;313;989
353205;201812;302;988;256;875;55;204;113;376;168;580
353210;201812;949;2276;587;1654;26;89;378;1025;404;1114
353215;201812;386;1121;307;958;44;153;132;361;176;514
353220;201812;700;1920;425;1338;103;311;71;211;174;522
353230;201812;772;2264;643;2060;172;620;253;710;425;1330
353240;201812;2136;6048;1721;5269;246;884;995;2901;1241;3785
353250;201812;1247;2833;721;1951;108;306;351;930;459;1236
353260;201812;1031;2486;579;1710;115;382;222;614;337;996
353270;201812;628;1712;501;1461;49;150;313;869;362;1019
353280;201812;700;1952;486;1496;86;269;164;463;250;732
353282;201812;1756;5138;1511;4651;174;601;915;2659;1089;3260
353284;201812;365;909;183;543;28;103;74;191;102;294
353286;201812;144;372;85;269;22;79;25;74;47;153
353290;201812;1491;3966;890;2717;94;351;457;1278;551;1629
353300;201812;1656;4625;1220;3728;211;736;527;1430;738;2166
353310;201812;368;926;250;703;24;89;145;378;169;467
353320;201812;573;1542;489;1391;20;65;392;1107;412;1172
353325;201812;581;1795;407;1395;90;305;135;452;225;757
353330;201812;538;1417;322;962;40;132;161;446;201;578
353340;201812;2635;7287;1817;5697;484;1637;659;2019;1143;3656
353350;201812;3049;8408;2038;6185;436;1467;405;1035;841;2502
353360;201812;561;1651;445;1431;58;208;225;692;283;900
353370;201812;521;1624;426;1454;38;138;278;908;316;1046
353380;201812;257;797;203;682;33;119;93;294;126;413
353390;201812;5272;13647;3892;11157;605;1879;1939;5245;2544;7124
353400;201812;379;1123;289;937;54;200;63;158;117;358
353410;201812;502;1395;396;1205;81;274;199;580;280;854
353420;201812;444;1211;257;795;43;123;22;49;65;172
353430;201812;2118;6103;1532;4971;371;1325;537;1590;908;2915
353440;201812;58694;166532;41380;131209;8171;27425;19529;59267;27700;86692
353450;201812;375;992;252;770;38;140;115;314;153;454
353460;201812;3204;8831;2315;7078;205;715;1050;3155;1255;3870
353470;201812;7110;19333;4872;15016;934;3184;1789;5046;2723;8230
353475;201812;1322;3558;939;2745;135;428;441;1182;576;1610
353480;201812;1569;4320;1251;3715;74;251;855;2448;929;2699
353490;201812;929;2560;615;1887;119;390;265;766;384;1156
353500;201812;943;2303;744;2003;185;507;394;1077;579;1584
353510;201812;772;2359;554;1804;144;484;108;307;252;791
353520;201812;1076;2888;691;2169;73;249;323;963;396;1212
353530;201812;2369;6475;1820;5391;245;825;921;2545;1166;3370
353540;201812;1945;5608;1608;5023;316;1013;829;2528;1145;3541
353550;201812;5528;14999;4376;13005;920;2887;2118;5986;3038;8873
353560;201812;1964;5754;1461;4898;501;1812;337;1044;838;2856
353570;201812;509;1402;371;1146;63;204;204;591;267;795
353580;201812;1949;5287;1532;4511;371;1116;681;1926;1052;3042
353590;201812;681;1906;424;1345;109;373;120;372;229;745
353600;201812;1695;4359;1334;3689;177;508;700;1861;877;2369
353610;201812;535;1680;387;1358;95;382;89;278;184;660
353620;201812;2518;6989;1770;5600;372;1295;534;1518;906;2813
353625;201812;491;1231;316;920;31;110;191;536;222;646
353630;201812;1123;3628;873;3032;207;765;248;787;455;1552
353640;201812;1319;3494;1036;3025;115;378;620;1771;735;2149
353650;201812;8772;24342;6255;18998;851;2886;3342;9392;4193;12278
353657;201812;295;850;229;733;29;111;114;323;143;434
353660;201812;1107;2440;748;1913;302;783;197;458;499;1241
353670;201812;3475;10230;2804;8860;650;2254;1314;3819;1964;6073
353680;201812;681;1927;513;1666;94;318;272;861;366;1179
353690;201812;450;1182;173;566;15;48;20;56;35;104
353700;201812;1794;5069;1522;4542;186;614;998;2852;1184;3466
353710;201812;3927;8963;2139;5796;250;674;1216;3038;1466;3712
353715;201812;438;1165;274;848;18;68;88;256;106;324
353720;201812;1841;5129;1454;4531;195;662;929;2807;1124;3469
353730;201812;3969;11019;2884;8858;444;1480;1352;3884;1796;5364
353740;201812;1830;4956;1216;3774;294;1017;350;1007;644;2024
353750;201812;777;2439;540;1956;128;495;89;333;217;828
353760;201812;11508;28326;9048;24806;1418;4170;5543;14809;6961;18979
353770;201812;723;2177;343;1173;57;194;40;106;97;300
353780;201812;4534;13543;3477;11322;873;3127;1125;3346;1998;6473
353790;201812;2374;7474;1757;6147;522;2093;352;1027;874;3120
353800;201812;15829;44291;12301;38161;2166;7229;6060;18667;8226;25896
353810;201812;1029;2811;677;2120;111;404;267;781;378;1185
353820;201812;1656;4787;1168;3744;243;830;394;1228;637;2058
353830;201812;573;1455;422;1197;63;182;202;540;265;722
353850;201812;1568;4539;1192;3790;322;1001;355;1167;677;2168
353860;201812;2420;7130;1908;6104;480;1663;770;2291;1250;3954
353870;201812;26380;71561;18233;55415;2722;9173;8745;24283;11467;33456
353880;201812;2767;8084;2204;6953;226;818;1275;3854;1501;4672
353890;201812;2345;5262;1543;4107;153;453;1014;2554;1167;3007
353900;201812;633;1793;462;1456;93;323;184;556;277;879
353910;201812;1696;5048;1426;4592;215;794;908;2858;1123;3652
353920;201812;2056;5709;1379;4358;286;1050;333;897;619;1947
353930;201812;3894;10607;2582;8272;589;2053;759;2202;1348;4255
353940;201812;1020;3062;680;2323;143;499;197;628;340;1127
353950;201812;2869;8198;2289;7078;453;1534;1191;3385;1644;4919
353960;201812;698;1941;454;1426;94;295;149;448;243;743
353970;201812;673;1694;495;1414;47;151;293;797;340;948
353980;201812;13526;35978;10512;30476;1182;3685;6846;19195;8028;22880
353990;201812;891;2209;533;1534;67;226;271;717;338;943
354000;201812;2393;5965;1299;3867;270;838;206;622;476;1460
354010;201812;343;933;255;779;30;90;162;483;192;573
354020;201812;3305;9729;2590;8116;684;2301;891;2514;1575;4815
354025;201812;717;1995;454;1458;86;316;90;261;176;577
354030;201812;477;1056;230;617;40;101;94;248;134;349
354040;201812;761;1848;475;1350;33;109;307;837;340;946
354050;201812;898;2703;626;2159;153;563;177;603;330;1166
354060;201812;3539;10423;2389;7894;582;2009;671;2060;1253;4069
354070;201812;3057;8737;2137;6888;476;1696;634;1760;1110;3456
354075;201812;2149;6656;1675;5766;286;1140;837;2787;1123;3927
354080;201812;1384;3926;877;2890;162;558;225;683;387;1241
354085;201812;412;884;323;774;3;12;217;484;220;496
354090;201812;1415;4064;1239;3700;106;360;921;2696;1027;3056
354100;201812;15546;45308;11278;37542;2698;9676;4526;14976;7224;24652
354105;201812;1257;3375;918;2720;117;357;529;1542;646;1899
354110;201812;401;1110;304;953;67;211;103;326;170;537
354120;201812;1439;4019;953;2931;199;629;303;824;502;1453
354130;201812;5428;14676;3491;10824;995;3344;182;338;1177;3682
354140;201812;18354;45593;11940;33918;2401;7321;4551;11931;6952;19252
354150;201812;3081;7662;2262;6270;460;1355;961;2552;1421;3907
354160;201812;3038;9118;2247;7410;647;2255;666;2072;1313;4327
354165;201812;563;1701;425;1416;83;316;198;612;281;928
354170;201812;1457;4271;1178;3677;91;313;722;2130;813;2443
354180;201812;430;1236;307;963;60;201;108;301;168;502
354190;201812;1398;4037;993;3202;99;346;377;1204;476;1550
354200;201812;866;2248;666;1926;83;247;358;973;441;1220
354210;201812;632;1837;520;1621;50;177;331;949;381;1126
354220;201812;3004;8358;2189;6691;410;1344;985;2837;1395;4181
354230;201812;670;1769;516;1569;45;173;342;989;387;1162
354240;201812;1456;4215;933;3086;165;582;266;770;431;1352
354250;201812;502;1312;322;1019;95;304;94;311;189;615
354260;201812;7692;21169;5889;17983;1372;4378;2135;6421;3507;10799
354270;201812;1017;3157;812;2755;183;614;289;977;472;1591
354280;201812;729;1924;610;1748;75;284;366;969;441;1253
354290;201812;841;2757;698;2426;125;427;322;1125;447;1552
354300;201812;3529;10721;3058;9853;1001;3306;979;3037;1980;6343
354310;201812;657;1999;512;1685;103;357;164;481;267;838
354320;201812;871;2238;536;1619;84;309;211;553;295;862
354323;201812;489;1252;323;931;44;119;131;370;175;489
354325;201812;1187;3643;842;2865;147;523;336;1094;483;1617
354330;201812;7385;19569;5071;14757;771;2681;2862;7643;3633;10324
354340;201812;25111;66682;17129;52156;3716;12352;7247;21098;10963;33450
354350;201812;1132;3060;901;2611;127;399;565;1551;692;1950
354360;201812;528;1454;308;1032;59;195;47;155;106;350
354370;201812;956;2983;801;2688;152;548;418;1370;570;1918
354380;201812;772;2083;523;1645;88;327;128;330;216;657
354390;201812;12596;31691;7800;22966;1509;4692;2618;7304;4127;11996
354400;201812;1484;4910;1151;4110;203;794;399;1397;602;2191
354410;201812;4988;14337;3802;11926;917;3102;1599;4755;2516;7857
354420;201812;1393;3818;1007;3043;136;449;580;1675;716;2124
354425;201812;2353;5990;1681;4773;408;1195;624;1816;1032;3011
354430;201812;1461;4063;1147;3532;175;617;591;1701;766;2318
354440;201812;533;1473;327;1031;41;137;140;403;181;540
354450;201812;391;1045;209;685;28;89;59;177;87;266
354460;201812;896;2355;575;1759;88;286;277;807;365;1093
354470;201812;495;1274;319;907;26;83;160;409;186;492
354480;201812;1023;2359;700;1859;62;180;465;1174;527;1354
354490;201812;757;2285;534;1788;112;390;198;605;310;995
354500;201812;1954;5685;1631;5197;538;1884;372;1144;910;3028
354510;201812;724;2024;586;1720;70;212;311;831;381;1043
354515;201812;282;867;204;703;39;153;74;240;113;393
354520;201812;6218;17920;4044;12846;642;2277;2117;6242;2759;8519
354530;201812;3819;11593;2930;9730;721;2467;1071;3511;1792;5978
354540;201812;1240;3409;897;2758;220;728;278;867;498;1595
354550;201812;525;1419;397;1173;58;175;236;666;294;841
354560;201812;1951;4986;1040;3065;149;461;504;1423;653;1884
354570;201812;1116;2891;470;1393;77;239;80;227;157;466
354580;201812;8954;23967;5709;17628;923;3146;2610;7624;3533;10770
354600;201812;1646;4722;1276;4017;177;628;741;2217;918;2845
354610;201812;386;1029;205;640;34;117;72;217;106;334
354620;201812;433;1259;269;921;40;148;104;312;144;460
354625;201812;302;851;177;599;23;78;48;142;71;220
354630;201812;1743;5363;1411;4681;613;2160;150;476;763;2636
354640;201812;3024;8982;2178;7170;371;1384;658;1984;1029;3368
354650;201812;885;2395;713;2084;75;235;405;1162;480;1397
354660;201812;2679;6821;1702;5152;142;510;1068;3117;1210;3627
354670;201812;1053;3004;715;2260;141;499;275;791;416;1290
354680;201812;4424;12366;3557;10894;878;2774;1765;5481;2643;8255
354690;201812;564;1798;384;1371;94;370;102;343;196;713
354700;201812;890;2399;603;1808;104;342;265;707;369;1049
354710;201812;508;1417;360;1106;53;190;156;414;209;604
354720;201812;318;784;135;406;41;120;29;90;70;210
354730;201812;8973;26070;6637;21474;1010;3563;3582;11167;4592;14730
354740;201812;308;840;120;414;14;57;21;64;35;121
354750;201812;2385;6491;1529;4815;287;1012;572;1601;859;2613
354760;201812;1862;5223;1276;4041;354;1240;333;978;687;2218
354765;201812;284;778;123;405;18;70;24;70;42;140
354770;201812;2219;5636;1567;4502;317;1010;674;1797;991;2807
354780;201812;50225;131640;38127;106929;5391;16786;21570;56603;26961;73389
354790;201812;930;2694;750;2385;102;350;417;1274;519;1624
354800;201812;2469;6746;1911;5759;491;1544;767;2176;1258;3720
354805;201812;1288;3162;858;2427;113;341;400;996;513;1337
354810;201812;582;1736;338;1196;57;221;88;283;145;504
354820;201812;900;2715;633;2160;118;468;150;439;268;907
354830;201812;461;1155;296;854;76;215;105;293;181;508
354840;201812;945;2411;497;1470;63;181;234;675;297;856
354850;201812;19569;53227;13554;41881;1930;6911;7603;21995;9533;28906
354860;201812;1462;4255;986;3277;189;670;314;929;503;1599
354870;201812;49450;128366;38752;108469;5144;15704;22536;60064;27680;75768
354880;201812;5531;14101;2496;7310;321;1046;825;1912;1146;2958
354890;201812;15633;40648;12113;34538;1771;5594;6950;19123;8721;24717
354900;201812;416;1122;270;850;34;111;71;212;105;323
354910;201812;4812;13250;2752;9251;584;2098;292;910;876;3008
354920;201812;444;1188;177;606;22;93;37;112;59;205
354925;201812;273;816;141;506;18;71;32;90;50;161
354930;201812;367;909;211;634;25;87;96;256;121;343
354940;201812;1851;5811;1315;4569;430;1614;169;523;599;2137
354950;201812;1441;4017;1139;3540;78;342;753;2198;831;2540
354960;201812;815;2225;621;1927;97;344;311;916;408;1260
354970;201812;3754;11074;2934;9535;431;1494;1689;5368;2120;6862
354980;201812;28433;69738;18545;52116;2305;7642;10161;26524;12466;34166
354990;201812;56222;148030;41315;120123;4628;15072;24611;67930;29239;83002
354995;201812;2398;5977;1798;5110;259;829;1133;3046;1392;3875
355000;201812;1416;3866;1112;3368;191;661;421;1146;612;1807
355010;201812;2833;8295;1866;6073;668;2283;149;492;817;2775
355020;201812;3303;9632;2378;7873;751;2733;591;1834;1342;4567
355030;201812;1244683;3134152;896915;2436563;157568;467791;428408;1071078;585976;1538869
355040;201812;2718;7386;2200;6630;386;1220;1359;4076;1745;5296
355050;201812;947;2417;681;1975;201;577;179;485;380;1062
355060;201812;5095;14581;3778;12028;657;2372;1825;5250;2482;7622
355070;201812;7609;20676;6045;18043;787;2726;3608;10044;4395;12770
355080;201812;808;2392;486;1724;101;384;47;137;148;521
355090;201812;1093;3274;812;2726;205;676;240;824;445;1500
355100;201812;19911;54244;15704;47917;2933;9573;9260;27766;12193;37339
355110;201812;940;2736;706;2329;236;821;124;427;360;1248
355120;201812;615;1670;434;1366;53;183;161;478;214;661
355130;201812;708;1619;317;838;23;59;182;447;205;506
355140;201812;1497;3819;1302;3531;123;410;1000;2602;1123;3012
355150;201812;3986;11016;3167;9528;427;1380;1815;5248;2242;6628
355160;201812;1716;4957;1265;4126;315;1180;293;908;608;2088
355170;201812;8589;22906;6718;19669;1633;5135;3204;9118;4837;14253
355180;201812;2674;7525;1901;6164;413;1523;615;1762;1028;3285
355190;201812;1762;4786;1384;4164;367;1130;657;2074;1024;3204
355200;201812;773;2513;664;2331;218;865;218;687;436;1552
355210;201812;2755;7869;2286;6893;321;1113;1301;3699;1622;4812
355220;201812;41147;113241;32127;95441;8558;26959;11910;32359;20468;59318
355230;201812;1113;2813;579;1706;106;302;164;473;270;775
355240;201812;21112;56712;14367;43185;2280;7422;7008;20250;9288;27672
355250;201812;33217;91954;24255;74372;6253;20378;8534;24954;14787;45332
355255;201812;820;2139;418;1294;80;265;134;400;214;665
355260;201812;1320;3418;930;2748;120;431;548;1524;668;1955
355270;201812;1193;3634;899;2991;244;828;270;873;514;1701
355280;201812;26209;70346;18546;55142;3111;9968;8313;23353;11424;33321
355290;201812;806;2295;581;1843;119;366;234;703;353;1069
355300;201812;1172;3506;926;3007;181;620;309;969;490;1589
355310;201812;998;2827;739;2367;99;348;383;1230;482;1578
355320;201812;509;1380;369;1102;65;220;139;350;204;570
355330;201812;2095;5828;1589;4882;156;572;1073;3135;1229;3707
355340;201812;3386;7684;2743;6782;363;867;1801;4470;2164;5337
355350;201812;1261;3809;929;3093;194;687;303;991;497;1678
355360;201812;1275;3396;1000;2944;104;333;678;1980;782;2313
355365;201812;357;988;180;628;34;108;27;97;61;205
355370;201812;5629;14528;4229;12426;1069;3112;1740;5503;2809;8615
355380;201812;2840;7829;2093;6305;361;1196;675;1745;1036;2941
355385;201812;1312;3672;1075;3301;129;484;619;1725;748;2209
355390;201812;731;2070;537;1649;122;378;210;602;332;980
355395;201812;1845;5389;1296;4161;197;681;526;1547;723;2228
355400;201812;8478;25939;6808;22399;1916;6975;2062;6129;3978;13104
355410;201812;20330;57002;13346;43537;3184;11418;3054;9911;6238;21329
355420;201812;639;2179;522;1918;144;604;113;395;257;999
355430;201812;3470;8985;2650;7565;716;2017;1107;3180;1823;5197
355440;201812;831;2334;482;1550;94;321;135;402;229;723
355450;201812;3275;8760;2068;6345;366;1190;774;2180;1140;3370
355460;201812;538;1355;331;992;50;176;154;413;204;589
355465;201812;372;1066;266;848;57;198;93;279;150;477
355470;201812;1130;2996;603;1889;174;572;164;478;338;1050
355475;201812;279;691;252;646;26;69;195;501;221;570
355480;201812;3486;10246;2872;9242;421;1568;1790;5551;2211;7119
355490;201812;928;2526;479;1533;44;150;222;676;266;826
355495;201812;764;2278;566;1899;78;291;193;617;271;908
355500;201812;6372;17184;3671;11550;575;1949;1071;3067;1646;5016
355510;201812;1273;3346;785;2380;112;387;283;763;395;1150
355520;201812;350;798;166;466;25;71;58;144;83;215
355530;201812;422;964;131;390;20;70;51;126;71;196
355535;201812;494;1389;380;1201;87;308;145;411;232;719
355540;201812;9107;24620;7429;21988;1454;4576;4218;12147;5672;16723
355550;201812;630;1917;508;1675;66;220;244;784;310;1004
355560;201812;1079;2919;564;1839;123;433;31;95;154;528
355570;201812;221;639;122;411;20;62;25;72;45;134
355580;201812;1189;2971;774;2281;97;335;388;1074;485;1409
355590;201812;177;450;133;385;16;47;81;224;97;271
355600;201812;1421;3616;936;2759;220;687;371;1048;591;1735
355610;201812;1682;4371;1112;3307;147;431;511;1449;658;1880
355620;201812;4241;11969;3148;9708;429;1552;1615;4532;2044;6084
355630;201812;2138;6098;1470;4761;273;910;674;2149;947;3059
355635;201812;899;2745;681;2315;111;433;262;835;373;1268
355640;201812;2576;7676;1757;5962;417;1475;360;1220;777;2695
355645;201812;4129;12186;3167;10434;423;1547;1830;5931;2253;7478
355650;201812;6143;17061;4979;14889;1389;4358;2177;6020;3566;10378
355660;201812;1251;3425;866;2666;121;482;283;851;404;1333
355670;201812;3178;9111;2132;6583;317;1159;1018;2729;1335;3888
355680;201812;3157;9009;1164;3932;328;1154;113;398;441;1552
355690;201812;721;2225;469;1691;129;507;21;59;150;566
355695;201812;217;657;122;417;14;51;14;25;28;76
355700;201812;6280;18806;5074;16022;1060;3382;2338;7109;3398;10491
355710;201812;7858;18869;4850;13346;862;2562;1993;4951;2855;7513
355715;201812;465;1243;240;764;51;185;47;123;98;308
355720;201812;1385;4187;1080;3581;202;718;500;1513;702;2231
355730;201812;902;2649;698;2217;173;562;242;714;415;1276
410010;201812;1189;3367;901;2749;197;665;203;597;400;1262
410020;201812;966;3043;764;2550;269;847;202;684;471;1531
410030;201812;1381;4053;1180;3690;180;666;605;1859;785;2525
410040;201812;10372;30382;7815;25339;1721;6006;2506;7581;4227;13587
410045;201812;908;2419;597;1828;96;334;179;506;275;840
410050;201812;2421;6135;1484;4415;347;1125;309;821;656;1946
410060;201812;1991;5934;1529;4918;389;1295;417;1311;806;2606
410070;201812;1703;4517;1216;3551;208;649;439;1215;647;1864
410080;201812;1318;3591;935;2870;159;513;381;1183;540;1696
410090;201812;973;2725;871;2541;110;316;478;1469;588;1785
410100;201812;1876;5595;1287;4148;175;671;243;736;418;1407
410105;201812;449;1214;236;739;38;139;52;153;90;292
410110;201812;2973;7878;2035;5940;299;941;794;2218;1093;3159
410115;201812;540;1386;378;1097;59;192;131;362;190;554
410120;201812;2344;7253;2042;6711;678;2364;628;2040;1306;4404
410130;201812;1085;3059;946;2799;271;906;376;983;647;1889
410140;201812;13607;33708;8093;23558;1625;5079;1696;4462;3321;9541
410150;201812;15794;38193;7336;20927;1351;4221;1525;4092;2876;8313
410160;201812;2779;7937;2258;7001;446;1533;834;2569;1280;4102
410165;201812;702;1978;575;1688;61;202;332;908;393;1110
410170;201812;2404;6508;1552;4570;379;1211;125;374;504;1585
410180;201812;13287;38727;10413;32400;1634;5565;5374;15620;7008;21185
410185;201812;439;1224;315;973;51;166;101;283;152;449
410190;201812;2126;5541;1550;4477;324;946;413;1153;737;2099
410200;201812;4643;11357;2474;7311;439;1515;524;1513;963;3028
410210;201812;2712;6990;1686;5038;298;1035;525;1296;823;2331
410220;201812;502;1356;321;972;44;163;60;178;104;341
410230;201812;1453;4104;1172;3553;176;634;641;1808;817;2442
410240;201812;4164;11701;3119;9612;840;2898;252;722;1092;3620
410250;201812;2477;6178;1777;4947;183;619;807;2140;990;2759
410260;201812;1718;4450;1107;3296;223;703;447;1302;670;2005
410270;201812;433;1145;313;911;35;109;137;378;172;487
410275;201812;646;1899;418;1373;59;205;189;574;248;779
410280;201812;2126;5874;1346;4215;232;790;475;1395;707;2185
410290;201812;2874;8385;2082;6664;498;1624;660;2085;1158;3709
410300;201812;615;1584;476;1333;59;181;226;591;285;772
410302;201812;357;941;180;574;29;94;82;243;111;337
410304;201812;1082;3110;911;2749;131;416;508;1485;639;1901
410305;201812;1608;4056;1115;3298;189;586;596;1715;785;2301
410310;201812;2425;7254;1900;6105;400;1404;680;2155;1080;3559
410315;201812;679;1699;333;1089;107;355;72;227;179;582
410320;201812;1085;3091;689;2201;106;398;111;342;217;740
410322;201812;482;1329;262;827;22;75;116;353;138;428
410330;201812;1463;3720;1018;2848;171;513;280;778;451;1291
410335;201812;808;2298;648;1957;85;276;289;807;374;1083
410337;201812;782;1952;541;1476;51;158;248;631;299;789
410340;201812;471;1296;319;922;32;119;152;369;184;488
410345;201812;2153;5738;1090;3353;252;778;234;660;486;1438
410347;201812;669;1710;474;1357;56;198;136;376;192;574
410350;201812;1271;3445;901;2735;92;312;397;1131;489;1443
410360;201812;3837;9579;3045;8236;224;718;1968;5087;2192;5805
410370;201812;10792;29347;7145;21086;963;3196;2732;7156;3695;10352
410380;201812;1363;3663;999;2914;118;404;420;1136;538;1540
410390;201812;2407;6505;1559;4820;372;1268;362;1029;734;2297
410395;201812;838;2535;675;2174;133;472;293;922;426;1394
410400;201812;4803;13384;3591;11050;642;2041;1501;4476;2143;6517
410405;201812;764;1929;593;1672;151;461;244;638;395;1099
410410;201812;1128;3251;1089;3194;171;612;667;2012;838;2624
410420;201812;7352;21755;5608;18066;1085;3904;1706;4948;2791;8852
410425;201812;2735;8069;1978;6513;349;1234;663;2006;1012;3240
410430;201812;12273;31629;8301;23983;1409;4391;2757;7570;4166;11961
410440;201812;2297;7078;1962;6414;347;1260;991;3177;1338;4437
410442;201812;2174;6902;1807;6026;537;1821;542;1786;1079;3607
410445;201812;2149;6528;1700;5620;374;1373;446;1538;820;2911
410450;201812;1419;3798;1006;3015;192;646;273;727;465;1373
410460;201812;1727;4478;1319;3837;187;584;588;1628;775;2212
410465;201812;2458;7471;1902;6256;399;1327;580;1804;979;3131
410470;201812;1729;5195;1255;4180;375;1396;179;601;554;1997
410480;201812;32366;79678;17345;52134;2898;9726;3241;8362;6139;18088
410490;201812;10129;29099;7142;22651;1452;4999;2463;7343;3915;12342
410500;201812;1631;4603;1141;3574;271;969;268;713;539;1682
410510;201812;1969;5001;1260;3598;239;667;380;1096;619;1763
410520;201812;2921;9559;2650;9008;778;2679;1070;3703;1848;6382
410530;201812;1398;3708;695;2076;121;366;107;240;228;606
410540;201812;2372;6629;1730;5372;263;869;888;2752;1151;3621
410550;201812;6357;17463;4023;12136;713;2353;994;2637;1707;4990
410560;201812;1379;3662;1049;3012;219;669;409;1032;628;1701
410570;201812;2417;7014;1821;5870;519;1971;130;447;649;2418
410580;201812;22345;60406;16659;49619;3400;11034;6967;19275;10367;30309
410590;201812;1391;4090;885;2778;158;521;233;654;391;1175
410600;201812;1729;4776;1293;3900;290;831;457;1435;747;2266
410610;201812;711;1934;511;1539;52;176;220;625;272;801
410620;201812;1909;5893;1222;4187;293;1069;190;585;483;1654
410630;201812;2211;6129;1404;4361;296;984;231;608;527;1592
410640;201812;4354;10704;2802;8006;676;2185;400;1097;1076;3282
410645;201812;990;3031;818;2778;306;1063;301;1045;607;2108
410650;201812;1904;5476;1333;4255;316;1052;394;1155;710;2207
410655;201812;886;2239;616;1745;55;190;281;727;336;917
410657;201812;616;1678;382;1178;64;235;154;404;218;639
410660;201812;2994;7927;1630;4905;324;1039;327;930;651;1969
410670;201812;1007;2510;580;1660;104;303;267;720;371;1023
410680;201812;2669;8258;1897;6328;485;1569;456;1573;941;3142
410685;201812;548;1442;433;1235;93;303;201;526;294;829
410690;201812;112767;290370;73519;214455;12883;42414;24570;62829;37453;105243
410700;201812;2252;5895;1911;5352;323;962;949;2527;1272;3489
410710;201812;797;2084;519;1555;56;176;271;773;327;949
410712;201812;636;1933;537;1709;142;484;185;541;327;1025
410715;201812;846;2587;503;1753;103;366;152;526;255;892
410720;201812;2981;8011;2137;6291;305;1063;430;1092;735;2155
410725;201812;1075;2737;627;1880;121;374;111;295;232;669
410730;201812;566;1506;407;1216;82;281;91;252;173;533
410740;201812;908;2596;643;2078;115;407;246;767;361;1174
410750;201812;1606;4258;1301;3709;210;658;529;1453;739;2111
410752;201812;341;890;153;470;26;86;59;165;85;251
410753;201812;211;646;150;511;11;38;30;96;41;134
410754;201812;1082;2890;876;2560;57;147;578;1793;635;1940
410755;201812;580;1521;416;1184;54;181;199;492;253;673
410760;201812;3138;8375;2306;6880;665;2171;537;1534;1202;3705
410765;201812;11638;34023;9006;28650;1465;5124;1469;4328;2934;9452
410770;201812;934;2314;648;1824;79;250;299;820;378;1070
410773;201812;1234;3358;1084;3106;125;396;722;2010;847;2406
410775;201812;1367;3624;1190;3345;103;334;664;1807;767;2141
410780;201812;583;1468;344;964;64;186;84;236;148;422
410785;201812;710;2068;572;1793;97;320;213;641;310;961
410790;201812;583;1710;455;1439;118;419;52;114;170;533
410800;201812;3065;7141;2454;6166;94;294;1510;3660;1604;3954
410810;201812;356;997;263;816;40;137;118;339;158;476
410820;201812;732;2173;386;1222;74;242;71;202;145;444
410830;201812;27901;71403;19286;56433;4511;14888;6371;17557;10882;32445
410832;201812;961;2560;775;2217;103;346;428;1130;531;1476
410840;201812;7086;19005;4204;13113;882;3045;750;2031;1632;5076
410845;201812;1106;3000;883;2616;169;548;322;920;491;1468
410850;201812;2208;6647;1922;6110;350;1188;864;2731;1214;3919
410855;201812;689;1766;462;1331;38;114;209;553;247;667
410860;201812;3690;9725;2853;8146;522;1629;1061;2823;1583;4452
410865;201812;1327;4206;1175;3868;210;754;641;2143;851;2897
410870;201812;1218;3397;1042;3104;47;153;772;2277;819;2430
410880;201812;3965;11282;2845;9078;497;1769;421;1417;918;3186
410890;201812;922;2689;663;2136;148;500;179;566;327;1066
410895;201812;921;3101;759;2704;291;1096;115;395;406;1491
410900;201812;882;2423;567;1772;91;292;118;299;209;591
410910;201812;359;874;186;530;12;39;111;284;123;323
410920;201812;784;1916;528;1499;81;275;234;644;315;919
410930;201812;1363;3779;1012;3106;255;927;236;711;491;1638
410940;201812;20317;58427;14793;47891;3338;11780;3882;12499;7220;24279
410950;201812;1868;5558;1674;5254;65;266;1370;4200;1435;4466
410960;201812;6687;17761;4266;13351;1048;3677;1458;4402;2506;8079
410965;201812;923;2533;687;2069;108;336;359;1054;467;1390
410970;201812;3621;10076;2559;8016;601;2269;329;863;930;3132
410975;201812;1247;3295;949;2751;156;507;346;991;502;1498
410980;201812;6563;17204;4155;12605;547;1827;1646;4734;2193;6561
410990;201812;1183;3055;755;2312;239;846;159;395;398;1241
411000;201812;500;1382;344;1055;52;188;96;245;148;433
411005;201812;416;1159;264;822;51;164;48;143;99;307
411007;201812;2106;6197;1737;5509;398;1359;549;1732;947;3091
411010;201812;4022;12399;3157;10512;797;2850;281;840;1078;3690
411020;201812;2288;6710;1885;6005;567;1910;515;1571;1082;3481
411030;201812;688;1774;452;1263;50;163;212;535;262;698
411040;201812;780;2044;364;1084;46;143;100;271;146;414
411050;201812;1747;5705;1446;4975;390;1425;196;580;586;2005
411060;201812;1610;4331;1028;3134;180;665;198;545;378;1210
411065;201812;331;918;237;729;33;100;103;316;136;416
411070;201812;6137;16577;4838;14210;900;2909;2045;5801;2945;8710
411080;201812;2070;5707;1649;4930;423;1385;420;1223;843;2608
411090;201812;840;2233;500;1536;44;163;121;340;165;503
411095;201812;1487;3586;1012;2795;119;397;363;942;482;1339
411100;201812;1048;2802;707;2167;82;290;198;622;280;912
411110;201812;591;1568;247;791;27;63;18;44;45;107
411120;201812;1187;3457;921;2875;324;1135;187;464;511;1599
411125;201812;4639;13988;4276;13342;957;3094;2036;6510;2993;9604
411130;201812;664;1871;472;1470;91;288;172;547;263;835
411140;201812;2157;6817;1775;5920;471;1695;589;1945;1060;3640
411150;201812;3544;9500;2442;7177;473;1596;195;415;668;2011
411155;201812;931;2431;537;1636;56;183;246;692;302;875
411160;201812;333;789;210;600;24;73;50;146;74;219
411170;201812;689;2130;499;1669;111;376;162;525;273;901
411180;201812;5076;13982;3894;11781;684;2269;1646;4694;2330;6963
411190;201812;1389;3707;993;2944;180;559;300;829;480;1388
411200;201812;4722;13158;3231;10185;889;3056;648;1878;1537;4934
411210;201812;2398;5640;1644;4451;388;1228;364;902;752;2130
411220;201812;830;2247;603;1766;131;415;179;510;310;925
411230;201812;784;2180;526;1660;104;347;198;624;302;971
411240;201812;1531;3779;883;2494;79;259;433;1152;512;1411
411250;201812;1979;5486;1471;4525;343;1212;439;1329;782;2541
411260;201812;307;816;204;612;31;97;80;212;111;309
411270;201812;1789;5062;1373;4174;236;739;605;1783;841;2522
411275;201812;1278;3132;901;2473;149;469;382;968;531;1437
411280;201812;1291;3550;824;2619;173;565;105;307;278;872
411290;201812;699;1957;477;1504;55;169;231;733;286;902
411295;201812;1106;2817;823;2261;76;245;415;1083;491;1328
411300;201812;982;2478;611;1720;68;209;231;560;299;769
411310;201812;852;2052;635;1724;47;132;288;773;335;905
411320;201812;5104;13850;3643;11040;798;2526;1249;3470;2047;5996
411325;201812;1462;4265;1227;3836;227;705;645;2071;872;2776
411330;201812;3073;8673;2258;7090;558;1928;624;1996;1182;3924
411340;201812;839;2348;504;1567;61;209;198;579;259;788
411342;201812;927;2293;571;1601;92;261;254;701;346;962
411345;201812;1017;2765;760;2322;93;315;513;1565;606;1880
411350;201812;2342;6665;1568;5035;416;1466;157;474;573;1940
411360;201812;608;1509;420;1212;53;172;135;372;188;544
411370;201812;45746;116156;32761;93532;2933;10017;18688;49892;21621;59909
411373;201812;1293;3445;1058;3065;115;376;524;1550;639;1926
411375;201812;1029;2663;730;2083;117;360;277;735;394;1095
411380;201812;1007;2419;691;1770;53;159;413;966;466;1125
411390;201812;1569;4479;1200;3638;195;653;450;1227;645;1880
411400;201812;2060;5369;1596;4485;230;784;746;1972;976;2756
411410;201812;1961;5642;1441;4473;335;1150;286;836;621;1986
411420;201812;3775;9645;2097;6293;306;1048;380;925;686;1973
411430;201812;3183;8952;2519;7722;534;1808;970;2703;1504;4511
411435;201812;402;1177;258;856;48;150;89;255;137;405
411440;201812;2435;7247;1986;6307;424;1481;684;2151;1108;3632
411450;201812;2478;6745;1870;5704;268;788;985;3045;1253;3833
411460;201812;3562;9611;1991;6329;368;1362;316;902;684;2264
411470;201812;684;1906;493;1497;88;285;150;410;238;695
411480;201812;4149;11698;2915;9241;568;2037;808;2361;1376;4398
411490;201812;1498;4046;1133;3391;160;555;408;1083;568;1638
411500;201812;1349;3674;869;2635;126;451;243;664;369;1115
411510;201812;2109;5696;1679;4897;357;1207;376;1120;733;2327
411520;201812;26920;66558;14856;42958;2031;6633;5094;13182;7125;19815
411530;201812;893;2435;546;1738;120;426;87;245;207;671
411535;201812;453;1349;199;699;19;68;30;78;49;146
411540;201812;2623;6833;1796;5141;279;888;682;1890;961;2778
411545;201812;914;2736;763;2461;73;244;499;1611;572;1855
411550;201812;669;1764;470;1374;77;248;79;227;156;475
411560;201812;1810;4917;1043;3254;158;574;68;165;226;739
411570;201812;6516;15938;4420;12487;949;2959;1196;3349;2145;6308
411573;201812;746;2083;637;1893;81;259;367;1063;448;1322
411575;201812;1712;4874;1298;4006;266;882;338;999;604;1881
411580;201812;4047;9689;2253;6785;270;996;318;826;588;1822
411585;201812;640;1903;285;968;81;280;37;108;118;388
411590;201812;362;1048;250;786;29;108;136;388;165;496
411600;201812;275;747;163;543;40;139;56;187;96;326
411605;201812;1459;3504;864;2437;117;403;437;1185;554;1588
411610;201812;2202;5661;1516;4245;126;405;888;2364;1014;2769
411620;201812;2748;7620;2348;6980;398;1308;1327;3856;1725;5164
411630;201812;690;1804;449;1324;80;267;135;347;215;614
411640;201812;520;1444;343;1015;51;152;122;327;173;479
411650;201812;199;584;130;431;26;86;26;87;52;173
411660;201812;887;2288;631;1798;54;153;330;910;384;1063
411670;201812;1169;3025;805;2221;113;326;315;806;428;1132
411680;201812;1500;4138;1179;3514;118;392;615;1828;733;2220
411690;201812;3350;9040;2583;7693;538;1674;777;2407;1315;4081
411695;201812;580;1803;426;1438;57;211;158;532;215;743
411700;201812;1543;4141;1013;3114;243;820;123;331;366;1151
411705;201812;1805;5836;1523;5317;319;1092;815;3012;1134;4104
411710;201812;1744;4611;1233;3660;335;1047;148;433;483;1480
411720;201812;1034;2541;709;1919;106;315;301;753;407;1068
411721;201812;844;2235;624;1809;126;382;136;394;262;776
411722;201812;679;1881;383;1178;54;193;143;385;197;578
411725;201812;1171;3469;775;2599;178;611;161;554;339;1165
411727;201812;1391;4003;897;2905;255;854;112;336;367;1190
411729;201812;656;1610;427;1171;48;164;147;359;195;523
411730;201812;5052;14062;3740;11342;998;3160;1241;3665;2239;6825
411740;201812;525;1411;263;836;49;169;50;145;99;314
411745;201812;736;2158;467;1501;59;205;84;216;143;421
411750;201812;4644;12584;3306;9805;461;1495;1569;4376;2030;5871
411760;201812;6680;18316;5104;15402;1794;5666;934;3071;2728;8737
411770;201812;2924;8776;2094;6850;537;1866;261;789;798;2655
411780;201812;2821;8216;2407;7369;665;2135;828;2530;1493;4665
411790;201812;2756;6925;1472;4432;334;1132;186;457;520;1589
411800;201812;941;2701;630;1958;104;327;122;374;226;701
411810;201812;1543;4046;1141;3278;186;575;553;1473;739;2048
411820;201812;9942;30435;8167;26855;2457;8499;2891;9307;5348;17806
411830;201812;581;1458;391;1115;85;259;79;243;164;502
411840;201812;10939;29763;7075;21470;1286;4267;1816;5048;3102;9315
411845;201812;412;1201;212;703;39;157;18;51;57;208
411850;201812;6961;18667;4937;14899;1407;4699;673;1820;2080;6519
411860;201812;707;2097;516;1675;99;353;131;386;230;739
411870;201812;636;1974;428;1438;86;317;93;277;179;594
411880;201812;1969;5241;1428;4282;284;920;324;954;608;1874
411885;201812;978;2580;704;2082;101;349;244;706;345;1055
411890;201812;1079;3008;726;2273;121;433;53;137;174;570
411900;201812;782;2287;455;1519;114;393;47;164;161;557
411910;201812;918;2867;656;2240;182;670;170;543;352;1213
411915;201812;14806;37412;9180;26849;1588;5150;2878;7533;4466;12683
411920;201812;948;3012;798;2655;204;735;228;715;432;1450
411925;201812;490;1311;329;1005;76;258;104;297;180;555
411930;201812;4949;15985;4193;14436;1893;7069;238;940;2131;8009
411940;201812;3039;9485;2317;7705;580;1964;589;1773;1169;3737
411950;201812;12609;35542;10287;31511;1943;6554;5251;15475;7194;22029
411960;201812;5372;15019;4405;13003;942;3044;1534;4243;2476;7287
411965;201812;412;1175;293;927;49;178;109;318;158;496
411970;201812;970;2388;748;2069;152;400;330;1024;482;1424
411980;201812;1419;3739;1051;3070;261;823;392;1061;653;1884
411990;201812;33013;92656;22344;71126;4628;16259;7383;22233;12011;38492
411995;201812;2713;7156;2052;6083;581;1922;576;1574;1157;3496
412000;201812;1998;4676;1443;3737;59;204;968;2340;1027;2544
412010;201812;608;1917;412;1443;57;236;105;294;162;530
412015;201812;552;1587;456;1408;54;187;258;786;312;973
412020;201812;428;1217;248;807;36;134;97;306;133;440
412030;201812;619;1805;424;1413;76;254;128;421;204;675
412033;201812;811;2234;558;1676;76;225;189;535;265;760
412035;201812;761;2066;491;1576;71;266;234;702;305;968
412040;201812;554;1538;343;1080;66;219;56;154;122;373
412050;201812;1687;4378;1157;3382;204;676;279;809;483;1485
412060;201812;6804;21302;5744;19089;1698;6226;1391;4359;3089;10585
412065;201812;588;1650;428;1327;84;264;131;414;215;678
412070;201812;1099;2868;825;2289;116;335;349;937;465;1272
412080;201812;1802;5310;1110;3703;183;654;118;338;301;992
412085;201812;278;738;93;311;14;44;9;22;23;66
412090;201812;5428;14504;4316;12444;1200;3546;1672;4925;2872;8471
412100;201812;1670;4687;1242;3911;374;1265;237;799;611;2064
412110;201812;821;2278;595;1777;108;337;192;559;300;896
412120;201812;1772;5486;1385;4644;295;1103;401;1171;696;2274
412125;201812;629;1905;459;1505;98;319;153;479;251;798
412130;201812;653;1743;452;1333;70;226;109;330;179;556
412135;201812;579;1581;254;771;45;139;84;229;129;368
412140;201812;1510;3879;953;2846;205;716;148;387;353;1103
412150;201812;2778;7538;2318;6690;330;1053;1417;3937;1747;4990
412160;201812;979;3117;595;2100;135;528;82;268;217;796
412170;201812;4030;11711;3387;10546;756;2528;1388;4008;2144;6536
412175;201812;1236;3837;1033;3435;259;866;380;1290;639;2156
412180;201812;1664;4670;1200;3781;171;650;499;1407;670;2057
412190;201812;3188;8211;2355;6682;316;1001;1051;2968;1367;3969
412200;201812;1693;5227;1201;3992;331;1169;186;582;517;1751
412210;201812;592;1513;326;988;63;217;91;237;154;454
412215;201812;3542;9655;2844;8305;807;2334;1093;3609;1900;5943
412217;201812;974;2617;819;2368;66;205;546;1527;612;1732
412220;201812;5604;16126;4513;14008;1147;3578;1408;4591;2555;8169
412230;201812;2527;7859;2031;6808;377;1430;549;1567;926;2997
412240;201812;6235;16341;3936;11752;714;2343;1062;2915;1776;5258
412250;201812;1916;5100;1466;4230;379;1098;258;730;637;1828
412260;201812;1189;3322;835;2542;133;411;248;694;381;1105
412265;201812;758;2234;638;1980;123;414;283;839;406;1253
412270;201812;743;2165;489;1574;68;239;191;559;259;798
412280;201812;452;1339;355;1168;86;291;102;314;188;605
412290;201812;954;2470;634;1852;107;324;202;566;309;890
412300;201812;1373;3875;1078;3282;266;850;241;723;507;1573
412310;201812;744;2078;613;1842;50;224;334;957;384;1181
412320;201812;800;2090;552;1611;72;289;199;555;271;844
412330;201812;1395;3865;938;2921;166;540;348;1106;514;1646
412340;201812;982;2852;613;1985;107;379;117;343;224;722
412350;201812;2611;7073;1704;5213;357;1084;353;1110;710;2194
412360;201812;236;653;143;448;14;49;66;196;80;245
412370;201812;732;2160;510;1699;96;366;37;129;133;495
412380;201812;1489;4187;1019;3159;275;895;150;498;425;1393
412382;201812;504;1295;333;984;52;175;107;272;159;447
412385;201812;2096;5965;1714;5191;583;1698;485;1601;1068;3299
412390;201812;2316;5937;1867;5216;353;1057;805;2223;1158;3280
412395;201812;663;1898;458;1442;57;182;198;602;255;784
412400;201812;863;2365;616;1861;140;439;154;496;294;935
412402;201812;1713;4432;1226;3593;316;1018;138;405;454;1423
412405;201812;3019;8305;1928;6044;449;1642;54;166;503;1808
412410;201812;5107;13990;3664;11303;763;2658;980;2789;1743;5447
412420;201812;465;1236;277;821;31;103;105;278;136;381
412430;201812;529;1390;345;1027;31;98;159;448;190;546
412440;201812;2641;7523;1751;5711;503;1775;272;907;775;2682
412450;201812;354;1093;231;775;41;132;20;48;61;180
412460;201812;953;2637;761;2302;133;450;310;923;443;1373
412470;201812;1609;5268;1289;4497;336;1230;303;1102;639;2332
412480;201812;892;2494;559;1728;95;312;119;315;214;627
412490;201812;1091;2859;897;2478;103;282;490;1301;593;1583
412500;201812;1770;4655;1334;3798;305;874;313;834;618;1708
412510;201812;1902;5960;1305;4378;292;1036;103;305;395;1341
412520;201812;1281;3420;675;2053;153;461;43;127;196;588
412530;201812;645;1761;467;1388;66;222;119;347;185;569
412535;201812;758;2050;510;1543;118;398;95;257;213;655
412540;201812;1206;3258;829;2457;103;369;249;742;352;1111
412545;201812;672;1779;443;1297;73;236;121;326;194;562
412550;201812;28068;78302;19231;59715;3695;12339;6515;18722;10210;31061
412555;201812;230;621;145;436;22;67;36;80;58;147
412560;201812;4623;13885;3395;10937;625;2188;982;3106;1607;5294
412570;201812;3659;9845;2186;6848;484;1635;309;1054;793;2689
412575;201812;919;2438;749;2104;83;256;440;1153;523;1409
412580;201812;1280;3450;884;2668;145;488;394;1150;539;1638
412590;201812;394;1064;199;653;38;139;18;54;56;193
412600;201812;1345;3894;987;3111;164;585;395;1188;559;1773
412610;201812;784;2156;500;1495;56;181;235;624;291;805
412620;201812;1238;3433;908;2817;186;655;272;781;458;1436
412625;201812;7811;21439;4877;15352;738;2594;303;907;1041;3501
412627;201812;1003;2872;658;2140;162;606;171;531;333;1137
412630;201812;2738;8116;1958;6335;381;1246;635;1850;1016;3096
412635;201812;330;885;218;625;38;117;63;155;101;272
412640;201812;1021;2837;555;1744;80;289;128;345;208;634
412650;201812;1480;4246;1164;3558;217;737;407;1073;624;1810
412660;201812;2412;6544;1683;5063;293;973;504;1347;797;2320
412665;201812;505;1264;295;867;56;166;112;308;168;474
412667;201812;1687;4550;1246;3651;177;584;485;1328;662;1912
412670;201812;747;1867;497;1426;83;281;181;495;264;776
412680;201812;1463;4101;937;3014;132;485;377;1083;509;1568
412690;201812;847;2392;617;1886;110;360;196;560;306;920
412700;201812;2005;5454;1596;4787;259;934;745;2113;1004;3047
412710;201812;5625;17043;4394;14388;938;3368;1267;3842;2205;7210
412720;201812;1192;3548;863;2757;148;483;174;468;322;951
412730;201812;1948;5443;1106;3581;218;779;193;588;411;1367
412740;201812;1657;4752;1087;3487;188;646;165;555;353;1201
412750;201812;3716;10333;3190;9512;387;1355;2041;5783;2428;7138
412760;201812;2775;7773;2309;6935;363;1201;1284;3693;1647;4894
412770;201812;9321;24266;4823;14957;706;2292;967;2647;1673;4939
412780;201812;1182;3302;916;2808;203;677;338;998;541;1675
412785;201812;1865;4846;1325;3864;218;657;695;1976;913;2633
412788;201812;1272;3723;1032;3241;247;778;437;1337;684;2115
412790;201812;1210;3278;644;2060;129;470;179;474;308;944
412795;201812;1286;3445;659;2042;125;414;113;332;238;746
412796;201812;2266;6845;1867;5965;400;1345;608;1813;1008;3158
412800;201812;3214;8159;2148;6088;278;891;895;2267;1173;3158
412810;201812;10093;26082;6024;17597;843;2802;2013;5142;2856;7944
412820;201812;6149;17389;4396;13801;1034;3408;1307;4129;2341;7537
412830;201812;335;965;221;697;39;110;43;138;82;248
412840;201812;1741;4606;1243;3610;167;519;423;1173;590;1692
412850;201812;2770;7518;2030;6175;348;1139;726;2126;1074;3265
412853;201812;1619;4272;1327;3646;156;467;686;1714;842;2181
412855;201812;1149;3135;742;2228;154;517;189;516;343;1033
412860;201812;751;2024;547;1648;79;269;247;710;326;979
412862;201812;690;1662;446;1238;69;208;204;554;273;762
412863;201812;1169;3651;1079;3502;116;376;781;2546;897;2922
412865;201812;699;2010;506;1626;99;337;172;545;271;882
412870;201812;858;2340;648;1995;202;714;132;423;334;1137
412880;201812;820;2294;510;1617;94;315;72;204;166;519
420005;201812;436;1321;234;838;31;111;100;372;131;483
420010;201812;3352;8489;2207;6441;190;614;1548;4485;1738;5099
420020;201812;463;1448;275;958;46;180;44;125;90;305
420030;201812;75;265;51;215;19;85;12;48;31;133
420040;201812;551;1731;322;1199;52;218;16;40;68;258
420050;201812;627;1546;397;1125;48;156;249;667;297;823
420055;201812;152;460;76;272;14;60;24;78;38;138
420060;201812;113;327;66;207;10;37;17;35;27;72
420070;201812;772;2503;574;2011;121;445;203;684;324;1129
420075;201812;83;233;40;127;7;21;10;19;17;40
420080;201812;327;992;254;835;83;281;73;233;156;514
420090;201812;393;1289;243;902;60;225;51;192;111;417
420100;201812;1105;3093;953;2864;49;170;776;2305;825;2475
420110;201812;238;793;215;746;45;175;86;273;131;448
420120;201812;395;1165;261;856;54;208;103;300;157;508
420125;201812;307;1011;239;859;61;239;111;380;172;619
420127;201812;270;784;92;329;17;66;20;67;37;133
420130;201812;2043;6025;1516;5004;294;1130;651;1961;945;3091
420140;201812;3124;8741;2239;7143;611;2242;272;817;883;3059
420150;201812;545;1423;333;1057;62;215;153;457;215;672
420160;201812;235;607;109;347;13;47;36;103;49;150
420165;201812;154;459;91;308;23;78;26;79;49;157
420170;201812;244;749;146;509;21;73;24;75;45;148
420180;201812;181;561;103;362;12;44;36;112;48;156
420190;201812;159;528;92;353;33;139;15;50;48;189
420195;201812;1219;3327;892;2785;259;918;107;279;366;1197
420200;201812;3194;8531;1821;5767;310;1214;631;1703;941;2917
420205;201812;1244;3485;900;2873;155;517;489;1573;644;2090
420207;201812;1486;4079;943;3008;199;736;346;1059;545;1795
420208;201812;363;1031;204;754;35;153;83;305;118;458
420209;201812;141;484;89;323;24;105;30;95;54;200
420210;201812;2249;6117;1466;4814;338;1236;617;1940;955;3176
420213;201812;730;2361;610;2114;146;542;283;965;429;1507
420215;201812;209;641;144;495;42;146;27;77;69;223
420220;201812;217;667;128;460;28;123;54;167;82;290
420230;201812;3916;11166;2947;9331;420;1458;1564;4802;1984;6260
420240;201812;10707;29616;6718;20821;920;3368;3407;9309;4327;12677
420243;201812;374;1097;297;940;51;180;160;479;211;659
420245;201812;1192;3277;828;2602;89;356;465;1376;554;1732
420250;201812;405;1200;350;1093;75;270;176;503;251;773
420253;201812;496;1285;360;1076;29;100;194;561;223;661
420257;201812;177;468;104;332;21;73;51;155;72;228
420260;201812;1008;2854;737;2428;122;450;425;1380;547;1830
420270;201812;415;1130;191;596;19;66;72;213;91;279
420280;201812;1173;3379;803;2650;167;613;219;702;386;1315
420285;201812;94;253;49;161;6;27;8;18;14;45
420287;201812;440;1119;298;889;94;300;90;259;184;559
420290;201812;3624;10542;2740;8569;441;1593;1393;3918;1834;5511
420300;201812;6107;17632;3484;11445;711;2638;913;2631;1624;5269
420310;201812;795;1916;373;1055;71;211;167;427;238;638
420315;201812;787;2412;550;1913;138;530;189;641;327;1171
420320;201812;3783;11188;2970;9683;929;3346;656;1947;1585;5293
420325;201812;235;715;172;596;41;134;57;194;98;328
420330;201812;810;2481;529;1846;116;441;175;542;291;983
420340;201812;896;2668;640;2131;145;504;57;179;202;683
420350;201812;1280;3499;896;2745;104;354;559;1680;663;2034
420360;201812;2372;6812;1244;4226;237;866;128;430;365;1296
420370;201812;1044;2933;836;2567;101;377;564;1662;665;2039
420380;201812;4473;12287;2902;9203;630;2142;940;2842;1570;4984
420390;201812;1018;2569;659;1796;109;355;298;609;407;964
420395;201812;915;2716;591;2006;86;294;66;208;152;502
420400;201812;859;2566;552;1863;111;416;164;531;275;947
420410;201812;493;1403;369;1142;39;144;226;657;265;801
420415;201812;285;879;212;716;70;256;62;217;132;473
420417;201812;593;1839;481;1588;120;405;167;565;287;970
420419;201812;149;538;117;450;37;154;9;29;46;183
420420;201812;9783;26745;6604;20822;2187;7597;1521;4377;3708;11974
420425;201812;646;1744;447;1369;37;138;202;597;239;735
420430;201812;2731;7806;1698;5447;424;1474;501;1414;925;2888
420435;201812;253;668;106;369;18;79;43;142;61;221
420440;201812;660;1956;380;1277;118;433;94;269;212;702
420445;201812;295;787;169;514;36;116;54;147;90;263
420450;201812;624;1908;449;1508;89;363;151;449;240;812
420455;201812;1885;4898;1395;4097;186;624;712;1991;898;2615
420460;201812;8058;22290;5990;18441;1005;3530;2851;8331;3856;11861
420470;201812;565;1559;321;1053;63;242;81;232;144;474
420475;201812;44;130;26;90;9;29;4;15;13;44
420480;201812;4665;12294;3018;9379;634;2159;951;2863;1585;5022
420490;201812;354;1075;234;805;56;222;74;246;130;468
420500;201812;1252;3755;881;3011;179;638;325;1096;504;1734
420510;201812;169;491;91;308;17;62;27;83;44;145
420515;201812;50;132;31;87;2;3;16;46;18;49
420517;201812;743;2068;641;1892;54;155;488;1432;542;1587
420519;201812;295;708;191;552;26;84;85;248;111;332
420520;201812;358;962;153;539;19;59;13;48;32;107
420530;201812;784;2335;540;1804;113;429;160;467;273;896
420535;201812;184;525;80;281;21;74;18;69;39;143
420540;201812;24673;60673;15470;44090;2731;8703;5527;13433;8258;22136
420543;201812;213;650;164;521;22;71;83;253;105;324
420545;201812;1020;3120;770;2561;168;593;284;916;452;1509
420550;201812;3193;9218;2088;7128;458;1730;858;2954;1316;4684
420555;201812;283;829;187;625;37;138;85;259;122;397
420560;201812;416;1086;287;879;63;183;150;457;213;640
420570;201812;1958;5713;1480;4766;312;1114;542;1622;854;2736
420580;201812;1582;4192;1146;3516;242;776;539;1648;781;2424
420590;201812;2708;7431;1564;4875;299;1072;373;874;672;1946
420600;201812;908;2779;692;2321;143;537;293;932;436;1469
420610;201812;309;933;182;635;46;167;46;160;92;327
420620;201812;475;1286;353;1074;108;340;123;368;231;708
420630;201812;845;2562;607;1942;125;441;274;773;399;1214
420640;201812;485;1403;228;810;57;208;19;56;76;264
420650;201812;2812;7865;1639;5246;268;931;619;1733;887;2664
420660;201812;334;957;230;740;61;206;56;174;117;380
420665;201812;499;1346;311;1006;54;188;124;360;178;548
420670;201812;1332;3713;870;2822;144;584;331;940;475;1524
420675;201812;123;369;77;271;24;101;15;39;39;140
420680;201812;314;762;174;550;28;96;88;269;116;365
420690;201812;783;2476;473;1646;73;283;103;296;176;579
420700;201812;2567;7117;1970;6049;290;1024;1007;2943;1297;3967
420710;201812;662;2025;505;1667;76;321;257;743;333;1064
420720;201812;1261;3539;902;2949;219;700;382;1233;601;1933
420730;201812;2551;6991;1972;6057;328;1063;1100;3279;1428;4342
420740;201812;608;1859;372;1334;98;373;38;149;136;522
420750;201812;1678;5077;1104;3708;193;731;410;1254;603;1985
420757;201812;57;160;26;103;4;18;10;36;14;54
420760;201812;330;999;139;459;37;127;21;69;58;196
420765;201812;356;1142;194;697;25;89;78;278;103;367
420768;201812;1143;3572;989;3277;176;575;648;2144;824;2719
420770;201812;468;1297;215;779;40;163;80;272;120;435
420775;201812;370;1096;230;789;53;208;43;121;96;329
420780;201812;925;2674;535;1812;118;419;119;370;237;789
420785;201812;189;526;135;410;20;66;51;135;71;201
420790;201812;944;3074;706;2535;159;641;337;1137;496;1778
420800;201812;693;1794;320;1023;86;273;67;225;153;498
420810;201812;1400;4697;1143;4125;354;1424;296;910;650;2334
420820;201812;9361;24374;6393;19390;1336;4588;2730;7416;4066;12004
420830;201812;2871;8090;2160;6767;468;1588;826;2526;1294;4114
420840;201812;508;1562;231;860;62;225;42;156;104;381
420845;201812;1834;4918;1063;3502;223;828;348;1116;571;1944
420850;201812;1024;3426;625;2343;142;588;91;286;233;874
420860;201812;255;669;144;465;39;143;30;83;69;226
420870;201812;770;2134;613;1876;177;641;259;734;436;1375
420880;201812;846;2666;663;2272;139;524;215;659;354;1183
420890;201812;7378;20135;4076;13175;672;2419;1186;3207;1858;5626
420895;201812;154;464;88;288;28;99;28;84;56;183
420900;201812;1310;3407;775;2438;111;420;325;900;436;1320
420910;201812;23892;65000;14739;46826;2410;8615;5401;15447;7811;24062
420915;201812;514;1928;365;1475;64;256;163;666;227;922
420917;201812;329;890;170;500;28;91;74;212;102;303
420920;201812;80;227;29;110;3;12;2;9;5;21
420930;201812;16233;43627;11576;35338;2085;7009;5291;15379;7376;22388
420940;201812;2139;5549;1301;4020;306;1052;179;436;485;1488
420945;201812;121;360;92;294;28;104;29;79;57;183
420950;201812;307;925;168;578;27;102;46;133;73;235
420960;201812;900;2351;607;1793;110;378;244;638;354;1016
420970;201812;2369;6992;1588;5362;443;1532;240;845;683;2377
420980;201812;295;924;237;835;119;419;66;258;185;677
420985;201812;283;847;148;527;27;108;52;160;79;268
420990;201812;387;1185;194;720;40;154;31;95;71;249
421000;201812;455;1506;299;1105;68;277;67;205;135;482
421003;201812;438;1049;140;442;17;53;22;63;39;116
421005;201812;53;179;48;172;11;41;20;74;31;115
421010;201812;3274;9170;2318;7436;483;1696;535;1521;1018;3217
421020;201812;352;1096;281;974;28;114;170;578;198;692
421030;201812;710;2269;552;1916;170;654;153;474;323;1128
421040;201812;664;1594;400;1184;34;116;246;712;280;828
421050;201812;1044;2984;661;2111;132;460;229;665;361;1125
421055;201812;168;462;81;254;14;49;30;75;44;124
421060;201812;525;1597;335;1101;62;231;132;393;194;624
421070;201812;497;1533;276;966;57;208;40;135;97;343
421080;201812;439;1317;393;1239;53;175;251;805;304;980
421085;201812;350;1057;138;518;26;106;19;51;45;157
421090;201812;278;752;159;504;21;70;48;153;69;223
421100;201812;879;2041;367;1101;82;273;53;140;135;413
421105;201812;1302;3651;1025;3207;153;471;589;1896;742;2367
421110;201812;1017;2977;855;2725;43;128;607;2018;650;2146
421120;201812;866;2800;597;2128;81;326;193;624;274;950
421125;201812;249;694;203;619;72;242;69;167;141;409
421130;201812;3639;11190;3085;10100;702;2540;1662;5253;2364;7793
421140;201812;270;762;175;569;33;110;53;150;86;260
421145;201812;444;1278;264;855;53;198;118;352;171;550
421150;201812;511;1407;267;907;49;187;86;285;135;472
421160;201812;544;1452;338;1076;50;174;196;607;246;781
421165;201812;186;577;123;426;27;92;52;181;79;273
421170;201812;1016;2802;808;2467;130;390;512;1587;642;1977
421175;201812;1019;2715;664;2126;125;469;258;738;383;1207
421180;201812;343;931;179;589;45;185;43;133;88;318
421185;201812;302;813;201;607;31;95;106;313;137;408
421187;201812;289;848;182;577;32;100;66;195;98;295
421189;201812;336;1010;254;830;45;147;85;264;130;411
421190;201812;8786;24329;5629;18381;1200;4268;1387;4302;2587;8570
421200;201812;616;1911;505;1677;86;298;257;827;343;1125
421205;201812;183;511;136;435;27;98;69;209;96;307
421210;201812;1020;2752;626;2032;154;507;204;658;358;1165
421220;201812;1268;4047;1003;3442;225;852;232;695;457;1547
421223;201812;360;1049;235;800;55;180;102;347;157;527
421225;201812;854;2677;739;2451;152;550;410;1369;562;1919
421227;201812;954;2549;554;1747;95;326;248;777;343;1103
421230;201812;555;1504;345;1100;93;321;102;315;195;636
421240;201812;303;935;121;460;18;93;14;51;32;144
421250;201812;1420;3813;956;3034;148;522;412;1272;560;1794
421260;201812;164;470;39;142;9;34;8;32;17;66
421265;201812;576;1706;539;1654;16;54;489;1508;505;1562
421270;201812;396;1063;175;645;28;105;66;238;94;343
421280;201812;1465;4411;1110;3747;235;943;474;1484;709;2427
421290;201812;722;1993;398;1259;73;240;81;257;154;497
421300;201812;229;635;132;427;19;65;39;130;58;195
421310;201812;155;482;119;396;20;71;57;189;77;260
421315;201812;188;550;117;384;34;111;21;65;55;176
421320;201812;586;1716;294;966;42;145;49;109;91;254
421330;201812;603;1800;418;1423;96;366;115;368;211;734
421335;201812;336;1059;271;934;52;201;106;354;158;555
421340;201812;1219;3602;909;3006;208;745;360;1165;568;1910
421350;201812;1101;3134;777;2529;152;588;321;970;473;1558
421360;201812;2140;6047;1288;4269;277;1078;444;1293;721;2371
421370;201812;470;1585;280;1064;65;265;67;233;132;498
421380;201812;777;2174;664;1975;97;332;391;1119;488;1451
421390;201812;176;476;62;209;11;32;18;52;29;84
421400;201812;239;799;163;611;32;142;77;261;109;403
421410;201812;249;688;105;375;18;66;38;136;56;202
421415;201812;220;683;129;433;37;126;29;87;66;213
421420;201812;494;1438;415;1278;73;250;239;696;312;946
421430;201812;114;383;85;311;12;50;32;103;44;153
421440;201812;575;1536;363;1182;78;251;177;583;255;834
421450;201812;339;1057;214;734;31;130;39;146;70;276
421460;201812;317;927;197;683;46;172;50;152;96;324
421470;201812;236;729;139;496;32;139;49;172;81;311
421480;201812;2510;6894;1624;5218;396;1414;500;1432;896;2846
421490;201812;107;343;70;243;12;48;16;42;28;90
421500;201812;1930;5928;1335;4649;373;1440;285;914;658;2354
421505;201812;279;841;250;792;37;135;144;428;181;563
421507;201812;363;1117;217;758;65;245;65;211;130;456
421510;201812;252;737;143;463;32;102;63;190;95;292
421520;201812;504;1358;313;930;44;158;174;469;218;627
421530;201812;304;967;184;658;37;166;46;134;83;300
421535;201812;383;1067;244;795;35;131;127;383;162;514
421540;201812;187;477;108;345;17;62;39;109;56;171
421545;201812;643;1937;469;1593;95;361;215;707;310;1068
421550;201812;1835;5372;1519;4855;344;1171;727;2258;1071;3429
421555;201812;184;570;62;231;10;41;10;25;20;66
421560;201812;88;283;52;194;11;45;14;50;25;95
421565;201812;831;2250;593;1856;140;475;186;609;326;1084
421567;201812;447;1566;285;1071;124;487;50;165;174;652
421568;201812;346;1034;242;799;34;126;110;344;144;470
421569;201812;183;546;68;243;19;68;25;95;44;163
421570;201812;900;2585;632;2057;170;609;142;429;312;1038
421575;201812;272;839;229;718;49;184;87;215;136;399
421580;201812;2759;8153;1851;6190;374;1459;599;1737;973;3196
421590;201812;129;420;100;340;30;108;26;74;56;182
421600;201812;501;1426;339;1067;80;270;87;231;167;501
421605;201812;704;1901;481;1514;105;322;164;519;269;841
421610;201812;1057;2943;645;2117;123;427;150;495;273;922
421620;201812;3618;10087;2068;7096;522;1962;515;1712;1037;3674
421625;201812;194;536;79;254;21;61;12;35;33;96
421630;201812;2281;6298;1325;4249;232;885;319;882;551;1767
421635;201812;214;606;143;439;14;43;78;220;92;263
421640;201812;641;1807;445;1469;96;330;126;414;222;744
421650;201812;2051;5899;1293;4369;311;1187;294;816;605;2003
421660;201812;7017;20566;5238;17139;871;3226;2088;6280;2959;9506
421670;201812;718;2137;508;1637;108;405;233;722;341;1127
421680;201812;859;2624;661;2207;188;673;257;784;445;1457
421690;201812;1119;3423;787;2662;168;634;243;808;411;1442
421700;201812;438;1371;223;804;43;180;53;163;96;343
421710;201812;208;664;92;317;22;79;27;87;49;166
421715;201812;101;295;72;227;18;57;48;145;66;202
421720;201812;1815;5129;1017;3394;280;1029;258;759;538;1788
421725;201812;188;461;95;288;22;75;39;90;61;165
421730;201812;324;978;185;596;28;98;74;214;102;312
421740;201812;579;1718;396;1301;119;414;92;275;211;689
421750;201812;784;1906;387;1166;77;247;152;436;229;683
421755;201812;172;497;98;312;16;60;45;128;61;188
421760;201812;810;2310;471;1590;85;319;140;387;225;706
421770;201812;1997;5548;1481;4628;390;1225;519;1768;909;2993
421775;201812;231;622;142;441;22;76;66;183;88;259
421780;201812;733;2328;492;1776;100;396;184;626;284;1022
421790;201812;629;1700;381;1255;91;317;179;564;270;881
421795;201812;207;614;130;409;21;78;50;141;71;219
421800;201812;2207;6422;1652;5359;304;1092;828;2554;1132;3646
421810;201812;583;1631;403;1278;54;211;224;666;278;877
421820;201812;765;2283;395;1344;77;291;82;251;159;542
421825;201812;1251;3625;1131;3440;128;444;795;2344;923;2788
421830;201812;1863;5978;1587;5440;349;1297;627;2050;976;3347
421835;201812;208;565;116;390;12;53;50;145;62;198
421840;201812;200;633;129;470;33;126;26;82;59;208
421850;201812;345;1038;192;685;39;161;57;148;96;309
421860;201812;270;812;176;601;23;105;59;156;82;261
421870;201812;3200;8420;2207;6475;466;1567;949;2512;1415;4079
421875;201812;204;610;100;357;18;70;23;58;41;128
421880;201812;465;1323;337;1079;98;373;66;209;164;582
421885;201812;181;542;128;441;37;129;25;76;62;205
421890;201812;711;2303;558;1976;113;446;247;804;360;1250
421895;201812;351;981;296;902;36;127;203;618;239;745
421900;201812;904;2356;637;1845;99;327;304;801;403;1128
421910;201812;306;945;209;720;49;200;39;105;88;305
421915;201812;370;1057;201;661;47;155;25;73;72;228
421917;201812;520;1356;318;1074;120;448;63;212;183;660
421920;201812;419;1318;302;1079;137;497;88;322;225;819
421930;201812;2117;5662;985;3348;272;1012;146;462;418;1474
421935;201812;417;1365;321;1135;63;235;169;573;232;808
421940;201812;287;882;117;408;26;109;33;103;59;212
421950;201812;2857;7268;1393;4430;285;997;295;826;580;1823
421960;201812;151;394;97;310;19;78;20;55;39;133
421970;201812;1773;4722;971;3061;214;710;271;756;485;1466
421985;201812;256;682;147;455;14;55;52;168;66;223
422000;201812;1521;4250;1269;3812;165;597;814;2412;979;3009
430003;201812;493;1445;336;1144;72;270;125;419;197;689
430005;201812;254;696;156;506;45;147;60;193;105;340
430010;201812;1569;4172;1247;3590;171;543;817;2269;988;2812
430020;201812;573;1370;442;1190;73;232;256;637;329;869
430030;201812;976;2397;552;1623;165;497;156;429;321;926
430040;201812;9122;22908;5420;16047;1390;4524;402;1286;1792;5810
430045;201812;534;1392;357;1046;38;121;195;536;233;657
430047;201812;236;528;93;273;18;55;25;74;43;129
430050;201812;900;2378;498;1517;115;382;104;298;219;680
430055;201812;254;649;109;337;12;37;56;159;68;196
430057;201812;93;209;29;82;6;23;8;20;14;43
430060;201812;15248;43337;11967;37946;2944;9994;4988;15731;7932;25725
430063;201812;863;2448;674;2025;129;385;369;1102;498;1487
430064;201812;936;2716;707;2191;199;647;220;653;419;1300
430066;201812;107;245;75;194;4;11;55;130;59;141
430070;201812;703;1796;102;339;10;36;11;26;21;62
430080;201812;729;1917;436;1310;93;306;186;496;279;802
430085;201812;844;2002;479;1383;80;241;197;544;277;785
430087;201812;518;1434;417;1287;81;249;235;746;316;995
430090;201812;549;1454;181;600;18;76;54;176;72;252
430100;201812;523;1336;307;920;59;188;111;302;170;490
430105;201812;935;2592;591;2001;112;421;276;951;388;1372
430107;201812;170;509;115;375;20;69;28;73;48;142
430110;201812;2020;5071;1456;4232;254;779;804;2300;1058;3079
430120;201812;1315;4021;804;2671;156;531;352;1190;508;1721
430130;201812;3309;8076;2513;6932;1013;2788;511;1620;1524;4408
430140;201812;857;2532;577;1935;155;502;216;742;371;1244
430150;201812;526;1403;292;920;57;191;94;286;151;477
430155;201812;249;665;120;377;21;68;28;76;49;144
430160;201812;16783;42924;13454;37881;2797;8318;6075;17360;8872;25678
430163;201812;2325;5907;1645;4832;144;487;1078;3126;1222;3613
430165;201812;335;792;75;241;12;31;10;23;22;54
430170;201812;881;2392;306;1076;66;236;60;200;126;436
430175;201812;640;2009;527;1748;134;433;250;819;384;1252
430180;201812;631;1655;500;1412;74;238;340;918;414;1156
430185;201812;428;1048;257;726;39;121;122;314;161;435
430187;201812;605;1548;426;1271;69;222;214;636;283;858
430190;201812;1349;3793;1089;3336;249;815;476;1384;725;2199
430192;201812;122;360;49;153;8;27;13;36;21;63
430195;201812;385;1159;61;220;9;31;6;21;15;52
430200;201812;1026;3226;864;2905;289;1031;245;826;534;1857
430205;201812;483;1305;393;1121;13;42;326;897;339;939
430210;201812;4639;11922;3175;8962;606;1825;1147;2634;1753;4459
430215;201812;299;801;186;552;38;122;69;196;107;318
430220;201812;646;1612;168;571;34;132;36;106;70;238
430222;201812;171;500;139;436;16;57;59;173;75;230
430223;201812;241;673;201;596;34;105;109;315;143;420
430225;201812;15;35;12;30;1;2;9;15;10;17
430230;201812;1618;4726;1465;4505;173;497;1117;3504;1290;4001
430235;201812;238;711;175;561;36;115;51;141;87;256
430237;201812;519;1287;350;986;19;68;238;635;257;703
430240;201812;1082;2479;647;1790;62;208;373;994;435;1202
430245;201812;660;2005;505;1684;168;561;219;738;387;1299
430250;201812;928;2489;729;2174;213;691;32;80;245;771
430258;201812;100;280;76;232;6;17;40;121;46;138
430260;201812;597;1628;429;1296;76;240;226;668;302;908
430265;201812;194;577;144;488;28;97;44;147;72;244
430270;201812;2652;6916;2118;6069;311;1000;1363;3767;1674;4767
430280;201812;4683;11619;3322;9144;689;1983;1381;3747;2070;5730
430290;201812;2023;4969;1770;4633;62;188;1519;3912;1581;4100
430300;201812;8323;22724;6541;19352;1223;3915;3233;9393;4456;13308
430310;201812;9057;23540;6010;17559;887;2998;2858;7706;3745;10704
430320;201812;913;2488;508;1602;77;207;263;869;340;1076
430330;201812;584;1500;384;1081;76;242;179;441;255;683
430340;201812;660;1523;344;1016;67;209;182;523;249;732
430350;201812;5865;16357;4476;13591;1031;3214;1968;5875;2999;9089
430355;201812;279;717;102;342;23;70;12;40;35;110
430360;201812;709;1812;506;1453;109;346;186;487;295;833
430367;201812;340;851;172;521;46;153;58;174;104;327
430370;201812;482;1337;217;706;43;149;61;174;104;323
430380;201812;672;1702;336;1072;69;256;72;234;141;490
430390;201812;2827;7098;1507;4523;280;911;115;265;395;1176
430400;201812;1070;2357;808;1967;85;221;581;1354;666;1575
430410;201812;551;1376;367;1064;56;180;207;577;263;757
430420;201812;2602;7343;1966;5894;605;1902;667;1902;1272;3804
430430;201812;645;1698;305;954;73;231;65;203;138;434
430435;201812;1450;3798;1094;3209;253;802;455;1319;708;2121
430440;201812;3473;10081;2591;8297;468;1635;1366;4328;1834;5963
430450;201812;6420;16812;5111;14463;683;2213;2941;8078;3624;10291
430460;201812;26650;71236;18935;58157;4032;13750;8052;23406;12084;37156
430461;201812;393;994;108;344;22;71;29;83;51;154
430462;201812;241;667;146;486;16;56;50;178;66;234
430463;201812;4426;12672;3489;10990;658;2274;1752;5435;2410;7709
430465;201812;457;1251;379;1087;62;193;232;645;294;838
430466;201812;3687;9545;2929;8253;759;2233;1310;3484;2069;5717
430467;201812;473;1203;333;968;54;198;159;424;213;622
430468;201812;1278;3239;1013;2843;131;393;608;1682;739;2075
430469;201812;640;1802;75;261;10;31;10;18;20;49
430470;201812;5224;14051;3594;11074;1133;3764;822;2434;1955;6198
430471;201812;489;1499;412;1332;71;227;193;605;264;832
430480;201812;815;2164;403;1270;64;211;83;220;147;431
430485;201812;155;422;58;194;8;22;10;36;18;58
430490;201812;405;1068;223;665;32;108;101;277;133;385
430495;201812;353;998;210;698;35;123;75;228;110;351
430500;201812;1000;2657;705;2140;221;733;211;571;432;1304
430510;201812;21636;58239;15337;45402;3158;10346;6082;16493;9240;26839
430511;201812;318;942;113;397;15;51;15;44;30;95
430512;201812;873;2090;689;1798;176;465;224;598;400;1063
430513;201812;765;1952;354;1024;67;192;159;441;226;633
430515;201812;391;1107;276;867;45;129;139;442;184;571
430517;201812;846;2721;723;2461;138;467;373;1323;511;1790
430520;201812;1239;3298;634;1976;118;358;123;356;241;714
430530;201812;1021;2631;364;1129;77;231;85;259;162;490
430535;201812;2865;7737;2010;6084;314;970;968;2904;1282;3874
430537;201812;309;1122;281;1029;34;112;216;793;250;905
430540;201812;554;1350;322;966;55;164;144;419;199;583
430543;201812;626;1231;374;929;57;128;213;561;270;689
430544;201812;605;1839;432;1423;101;357;199;629;300;986
430545;201812;1795;4951;1343;4240;272;876;657;2139;929;3015
430550;201812;397;1141;237;773;43;144;70;213;113;357
430558;201812;108;246;49;136;8;21;17;44;25;65
430560;201812;323;720;134;399;10;37;45;125;55;162
430570;201812;776;1857;555;1506;81;262;340;850;421;1112
430580;201812;933;2325;633;1851;167;538;258;708;425;1246
430583;201812;188;467;35;108;1;4;5;15;6;19
430585;201812;216;529;115;318;15;38;58;141;73;179
430587;201812;187;560;129;424;20;66;50;164;70;230
430590;201812;1367;3364;1176;3067;60;188;1014;2595;1074;2783
430593;201812;17;59;11;40;2;8;6;21;8;29
430595;201812;395;940;83;280;6;23;18;49;24;72
430597;201812;336;934;207;632;23;73;74;172;97;245
430600;201812;1719;4550;786;2390;139;446;214;611;353;1057
430605;201812;1057;3029;787;2478;117;443;304;903;421;1346
430607;201812;578;1338;426;1101;34;89;293;763;327;852
430610;201812;5287;13237;3590;10514;1011;3249;585;1826;1596;5075
430613;201812;254;604;75;225;6;18;19;47;25;65
430620;201812;523;1401;408;1171;85;279;193;518;278;797
430630;201812;399;1132;120;389;17;56;24;63;41;119
430632;201812;503;1361;235;720;31;103;107;312;138;415
430635;201812;507;1346;375;1086;59;180;253;725;312;905
430637;201812;434;1127;338;970;40;126;194;527;234;653
430640;201812;1046;2728;602;1806;96;301;205;567;301;868
430642;201812;332;919;253;743;44;122;134;384;178;506
430645;201812;231;499;77;201;16;44;12;31;28;75
430650;201812;1505;4626;1258;4187;340;1144;576;1970;916;3114
430655;201812;232;554;135;365;13;40;72;176;85;216
430660;201812;4445;12022;3404;10160;765;2493;1538;4508;2303;7001
430670;201812;577;1491;442;1245;41;137;285;811;326;948
430673;201812;563;1325;223;680;43;134;76;227;119;361
430675;201812;192;563;55;193;18;73;14;45;32;118
430676;201812;4091;10639;3155;9091;474;1472;1819;5116;2293;6588
430680;201812;931;2516;559;1753;158;494;139;416;297;910
430690;201812;2939;8240;2385;7216;760;2392;635;1856;1395;4248
430692;201812;201;634;155;558;11;33;113;417;124;450
430693;201812;971;2583;553;1689;110;395;118;323;228;718
430695;201812;478;1210;284;828;32;93;159;442;191;535
430697;201812;377;972;277;806;59;176;144;430;203;606
430700;201812;6386;16305;3422;10674;825;2761;377;1175;1202;3936
430705;201812;365;922;171;536;28;96;66;196;94;292
430710;201812;1624;3664;1141;2964;177;528;617;1572;794;2100
430720;201812;712;1744;372;1135;55;156;162;493;217;649
430730;201812;1051;2882;717;2239;117;339;347;1100;464;1439
430740;201812;546;1515;287;950;48;172;84;292;132;464
430745;201812;438;1234;231;743;38;135;61;177;99;312
430750;201812;1283;3417;908;2752;187;614;468;1352;655;1966
430755;201812;447;1108;285;776;17;52;157;397;174;449
430760;201812;1867;4818;1436;4141;349;1047;603;1688;952;2735
430770;201812;5687;14633;4338;12551;678;2187;2611;7275;3289;9462
430780;201812;1966;4930;1106;3444;221;731;331;1046;552;1777
430781;201812;385;1110;219;718;52;177;47;133;99;310
430783;201812;411;965;234;679;22;74;131;353;153;427
430786;201812;36;123;20;78;4;14;1;8;5;22
430790;201812;4197;10899;2865;8391;458;1500;1535;4190;1993;5690
430800;201812;713;1796;520;1439;54;167;331;900;385;1067
430805;201812;425;1170;254;773;21;72;152;428;173;500
430807;201812;299;712;192;545;16;55;102;273;118;328
430810;201812;800;1965;256;845;39;147;72;216;111;363
430820;201812;1244;3377;657;2183;138;468;141;487;279;955
430825;201812;269;696;88;247;16;43;19;47;35;90
430830;201812;1577;4717;1311;4206;78;304;896;2853;974;3157
430840;201812;883;2426;701;2094;115;365;437;1284;552;1649
430843;201812;112;271;33;100;5;14;16;41;21;55
430845;201812;359;893;236;679;77;239;62;156;139;395
430850;201812;2167;5905;1612;4823;302;966;744;2202;1046;3168
430860;201812;770;1836;415;1197;68;237;187;469;255;706
430865;201812;500;1311;408;1148;80;234;202;538;282;772
430870;201812;624;1666;265;848;45;157;90;249;135;406
430880;201812;1164;2808;775;2202;178;528;346;956;524;1484
430885;201812;200;486;90;295;7;35;51;153;58;188
430890;201812;980;2649;652;2010;56;261;112;307;168;568
430900;201812;2848;6597;1929;5200;194;617;1173;2965;1367;3582
430905;201812;740;1970;464;1424;91;310;163;476;254;786
430910;201812;1331;3651;899;2748;159;545;380;1052;539;1597
430912;201812;473;1324;315;1020;28;80;204;676;232;756
430915;201812;478;1504;357;1268;93;333;118;431;211;764
430920;201812;21649;56488;16505;47827;2477;7975;9543;26800;12020;34775
430925;201812;135;302;49;140;8;25;19;56;27;81
430930;201812;9212;22174;5566;16421;1286;4056;1965;6007;3251;10063
430940;201812;1083;3050;596;1875;182;610;67;155;249;765
430950;201812;681;1712;422;1213;74;232;225;592;299;824
430955;201812;211;556;59;185;15;47;11;26;26;73
430957;201812;178;622;164;589;31;112;87;304;118;416
430960;201812;1251;2977;771;2147;165;516;357;970;522;1486
430965;201812;1650;4098;1247;3441;73;226;936;2537;1009;2763
430970;201812;358;921;178;551;29;109;87;247;116;356
430975;201812;470;1477;354;1189;90;320;141;458;231;778
430980;201812;387;951;209;637;36;113;85;249;121;362
430990;201812;534;1579;315;1020;40;145;157;505;197;650
430995;201812;551;1454;392;1182;61;183;188;560;249;743
431000;201812;1273;3013;501;1460;91;293;29;65;120;358
431010;201812;1995;5340;1164;3775;184;684;116;321;300;1005
431020;201812;7957;17964;4827;13020;1136;3341;1544;3759;2680;7100
431030;201812;312;866;135;465;23;85;25;82;48;167
431033;201812;2905;7296;1850;5579;489;1519;555;1752;1044;3271
431036;201812;352;782;69;210;12;28;16;48;28;76
431040;201812;897;2382;578;1766;91;332;251;707;342;1039
431041;201812;452;1067;338;901;38;102;202;522;240;624
431043;201812;390;959;209;650;64;213;69;208;133;421
431046;201812;105;285;42;133;4;14;11;34;15;48
431050;201812;1351;3433;973;2826;173;524;517;1500;690;2024
431053;201812;510;1452;313;1024;74;257;97;299;171;556
431055;201812;579;1459;489;1321;37;87;371;991;408;1078
431057;201812;265;775;123;423;17;59;33;102;50;161
431060;201812;4646;12968;3390;10667;963;3276;671;2198;1634;5474
431065;201812;456;1219;303;938;64;201;98;296;162;497
431070;201812;427;1283;243;833;69;264;31;94;100;358
431075;201812;219;671;142;483;26;93;41;138;67;231
431080;201812;571;1605;392;1236;84;290;112;327;196;617
431085;201812;680;1859;478;1389;79;232;249;702;328;934
431087;201812;456;1320;360;1103;30;88;245;769;275;857
431090;201812;386;919;138;445;27;93;33;104;60;197
431100;201812;3019;7025;2171;5845;356;1023;1041;2797;1397;3820
431110;201812;1329;3188;929;2467;219;577;409;1039;628;1616
431112;201812;485;1490;409;1333;83;296;208;644;291;940
431113;201812;327;951;285;862;71;237;143;421;214;658
431115;201812;1037;3022;816;2603;134;472;455;1394;589;1866
431120;201812;2242;6494;1566;5074;520;1876;356;1041;876;2917
431123;201812;379;1079;235;774;50;141;116;406;166;547
431125;201812;1030;3109;765;2525;307;994;217;776;524;1770
431127;201812;254;671;61;198;9;28;9;20;18;48
431130;201812;2914;7912;2073;6343;429;1431;896;2685;1325;4116
431140;201812;4637;11243;2564;7246;354;1094;1068;2669;1422;3763
431142;201812;475;1315;352;1091;53;160;213;665;266;825
431150;201812;988;2735;688;2135;150;485;271;822;421;1307
431160;201812;658;1905;471;1502;96;306;153;494;249;800
431162;201812;464;1154;214;672;22;89;84;239;106;328
431164;201812;197;465;43;139;9;31;5;18;14;49
431170;201812;512;1429;348;1092;97;287;92;289;189;576
431171;201812;623;1561;514;1417;67;183;335;917;402;1100
431173;201812;371;1023;278;868;98;326;79;244;177;570
431175;201812;996;2509;606;1805;139;417;141;419;280;836
431177;201812;672;1985;505;1700;160;576;226;749;386;1325
431179;201812;300;645;63;193;14;45;14;32;28;77
431180;201812;2113;5554;1275;3896;358;1118;229;699;587;1817
431190;201812;442;1213;227;730;26;80;49;134;75;214
431198;201812;298;944;260;870;97;348;68;242;165;590
431200;201812;376;978;83;266;12;32;2;6;14;38
431205;201812;179;518;79;280;18;65;31;106;49;171
431210;201812;606;1594;486;1411;124;341;234;713;358;1054
431213;201812;239;703;177;588;14;61;91;302;105;363
431215;201812;499;1232;227;690;28;91;95;257;123;348
431217;201812;156;448;103;340;9;30;59;181;68;211
431220;201812;590;1576;338;1070;29;119;175;504;204;623
431225;201812;1460;3655;1095;3026;115;349;704;1920;819;2269
431230;201812;654;1946;473;1475;77;259;267;793;344;1052
431235;201812;134;340;23;71;3;8;3;9;6;17
431237;201812;346;1055;272;912;46;182;144;461;190;643
431238;201812;23;61;19;51;6;14;6;15;12;29
431240;201812;3607;9427;2837;8168;603;1913;1256;3483;1859;5396
431242;201812;291;828;240;730;61;193;109;334;170;527
431244;201812;320;781;148;423;22;86;49;102;71;188
431245;201812;1271;3050;800;2201;100;290;387;1014;487;1304
431247;201812;214;597;101;332;18;66;22;58;40;124
431250;201812;1499;4151;1143;3611;260;806;535;1775;795;2581
431260;201812;206;584;113;398;14;63;41;128;55;191
431261;201812;236;753;188;660;21;81;93;301;114;382
431262;201812;380;1081;173;580;14;48;110;366;124;414
431265;201812;1409;3343;561;1639;89;293;181;444;270;737
431267;201812;234;658;139;419;5;21;96;260;101;281
431270;201812;2494;5884;1329;3860;349;1103;363;1059;712;2162
431275;201812;140;402;69;226;14;49;8;18;22;67
431280;201812;241;671;66;231;6;19;5;14;11;33
431290;201812;291;845;198;636;30;94;62;167;92;261
431295;201812;68;182;24;74;3;13;5;13;8;26
431300;201812;371;932;51;181;5;22;9;29;14;51
431301;201812;214;630;53;189;7;17;4;11;11;28
431303;201812;550;1488;313;951;30;109;120;340;150;449
431306;201812;2070;4989;1240;3556;191;637;478;1190;669;1827
431308;201812;23;73;20;63;13;44;4;8;17;52
431310;201812;513;1497;328;1041;49;173;145;439;194;612
431320;201812;561;1533;257;869;48;155;36;116;84;271
431330;201812;1590;3857;731;2248;196;659;175;488;371;1147
431333;201812;211;587;109;326;15;37;37;108;52;145
431335;201812;39;113;23;78;6;14;4;8;10;22
431337;201812;2458;6737;1713;5419;472;1669;570;1687;1042;3356
431339;201812;384;997;289;832;69;202;136;392;205;594
431340;201812;18607;47189;13032;37528;2613;8254;4868;13146;7481;21400
431342;201812;453;1034;328;845;23;68;280;709;303;777
431344;201812;383;1001;225;674;11;35;149;432;160;467
431346;201812;256;655;95;317;15;47;29;98;44;145
431349;201812;620;1655;323;979;67;217;120;336;187;553
431350;201812;3703;10043;2713;8295;448;1504;1293;3915;1741;5419
431360;201812;543;1311;306;870;76;232;102;267;178;499
431365;201812;1659;4286;1393;3891;145;473;1037;2852;1182;3325
431370;201812;3926;10321;2917;8574;749;2366;1235;3699;1984;6065
431380;201812;725;2087;615;1888;45;158;395;1205;440;1363
431390;201812;2303;5799;1316;3914;225;762;498;1309;723;2071
431395;201812;1171;3186;846;2666;218;698;331;1087;549;1785
431400;201812;330;954;169;549;30;94;45;135;75;229
431402;201812;827;1978;582;1554;85;243;366;920;451;1163
431403;201812;172;485;137;423;21;85;84;227;105;312
431405;201812;4184;11301;3341;9980;413;1434;1984;5726;2397;7160
431406;201812;415;1304;344;1156;96;298;159;554;255;852
431407;201812;442;1234;280;871;57;187;128;386;185;573
431410;201812;14293;37998;9132;28250;1714;5984;3716;10702;5430;16686
431413;201812;174;448;52;169;5;16;9;29;14;45
431415;201812;668;1702;408;1261;66;244;161;433;227;677
431417;201812;560;1293;378;1008;65;185;198;505;263;690
431420;201812;1384;3393;1089;2956;200;564;510;1412;710;1976
431430;201812;503;1305;240;758;39;128;60;165;99;293
431440;201812;23951;59480;17359;48578;3623;10832;6027;16463;9650;27295
431442;201812;97;276;47;161;8;27;6;15;14;42
431445;201812;420;1198;127;441;19;61;12;40;31;101
431446;201812;306;860;207;658;50;173;80;239;130;412
431447;201812;599;1669;394;1233;94;315;143;444;237;759
431449;201812;701;1881;423;1248;75;220;176;500;251;720
431450;201812;2018;4442;1663;3939;108;286;1273;2889;1381;3175
431454;201812;42;128;39;121;8;28;15;52;23;80
431455;201812;561;1376;288;803;44;145;141;340;185;485
431460;201812;2756;7126;2031;5765;553;1638;587;1686;1140;3324
431470;201812;1422;4087;1029;3256;199;637;438;1384;637;2021
431475;201812;245;705;26;106;0;0;2;10;2;10
431477;201812;405;1061;249;744;42;124;114;311;156;435
431478;201812;241;614;57;178;17;53;4;11;21;64
431480;201812;2918;7525;2267;6495;390;1193;1300;3675;1690;4868
431490;201812;93548;233882;76093;206366;6791;21190;55478;145635;62269;166825
431500;201812;465;1234;340;980;69;192;175;491;244;683
431505;201812;341;824;217;628;21;60;134;386;155;446
431507;201812;338;807;142;409;33;110;48;119;81;229
431510;201812;1449;3880;1033;3059;234;729;388;1141;622;1870
431513;201812;228;533;118;330;8;17;86;246;94;263
431514;201812;79;212;40;132;6;18;18;60;24;78
431515;201812;480;1253;321;945;69;215;154;423;223;638
431517;201812;71;206;55;166;13;35;17;51;30;86
431520;201812;424;1051;157;510;30;105;54;154;84;259
431530;201812;3777;8247;2267;6088;633;1744;384;1072;1017;2816
431531;201812;190;527;125;388;17;53;52;159;69;212
431532;201812;524;1285;328;922;75;224;133;372;208;596
431535;201812;238;638;96;314;20;77;15;43;35;120
431540;201812;1674;5518;1563;5335;63;247;1262;4309;1325;4556
431545;201812;344;906;63;203;6;23;17;49;23;72
431550;201812;1837;5012;1492;4317;289;910;680;1887;969;2797
431555;201812;668;1560;415;1121;30;99;251;659;281;758
431560;201812;19418;50180;12750;39110;2943;9627;3508;11423;6451;21050
431570;201812;4470;11075;3537;9769;543;1682;2211;5890;2754;7572
431575;201812;199;584;144;461;23;68;32;96;55;164
431580;201812;504;1369;289;910;47;179;134;386;181;565
431590;201812;667;1804;475;1405;113;337;171;522;284;859
431595;201812;311;893;209;664;38;115;84;250;122;365
431600;201812;1247;3123;910;2617;267;803;320;949;587;1752
431610;201812;1300;3529;895;2687;131;364;446;1396;577;1760
431620;201812;551;1509;234;716;45;149;97;272;142;421
431630;201812;1186;3125;559;1760;133;447;171;470;304;917
431640;201812;5692;14928;5017;13929;631;1843;3581;9933;4212;11776
431642;201812;456;1126;296;822;30;73;157;418;187;491
431643;201812;310;763;133;384;16;43;46;135;62;178
431645;201812;1657;4108;1332;3600;118;356;968;2591;1086;2947
431647;201812;205;527;101;289;12;39;23;54;35;93
431650;201812;152;448;105;352;17;62;38;117;55;179
431660;201812;800;2169;415;1369;71;272;89;267;160;539
431670;201812;1118;2760;743;2094;114;360;389;1031;503;1391
431673;201812;235;619;87;308;15;47;13;38;28;85
431675;201812;520;1268;108;340;9;35;28;71;37;106
431680;201812;6831;18349;5017;14794;1332;4084;1843;5391;3175;9475
431690;201812;19447;50387;13366;39182;3205;9972;4645;13786;7850;23758
431695;201812;148;385;93;280;16;56;40;93;56;149
431697;201812;459;1118;348;934;58;145;186;513;244;658
431700;201812;1366;3663;1156;3270;173;479;664;1863;837;2342
431710;201812;10636;27967;8082;24075;1929;6044;3370;10503;5299;16547
431720;201812;5333;14003;3355;9990;915;2873;529;1437;1444;4310
431725;201812;25;72;17;54;4;13;4;11;8;24
431730;201812;3456;8877;2247;6821;581;1872;672;2134;1253;4006
431740;201812;4676;11788;3154;9100;942;3046;618;1502;1560;4548
431750;201812;6619;18132;5578;16472;1027;3308;2911;8588;3938;11896
431755;201812;299;797;63;220;7;26;11;40;18;66
431760;201812;5255;12258;3377;9202;353;1196;2006;5076;2359;6272
431770;201812;1690;4269;1360;3797;111;345;997;2733;1108;3078
431775;201812;203;540;95;296;21;75;17;41;38;116
431780;201812;1798;4690;1192;3553;222;718;424;1242;646;1960
431790;201812;851;2345;600;1825;128;396;252;731;380;1127
431795;201812;219;571;103;313;24;79;29;81;53;160
431800;201812;6827;18116;4786;14583;1456;4934;600;1874;2056;6808
431805;201812;285;663;82;267;6;20;31;89;37;109
431810;201812;3197;7854;2034;5667;382;1202;828;2133;1210;3335
431820;201812;2058;5950;1687;5296;439;1430;658;2110;1097;3540
431830;201812;8286;19109;6189;16032;1586;4575;2135;5550;3721;10125
431840;201812;2338;6526;1922;5797;360;1132;1108;3326;1468;4458
431842;201812;653;1628;219;674;31;108;66;187;97;295
431843;201812;303;837;236;696;29;90;114;319;143;409
431844;201812;194;522;65;215;17;63;20;58;37;121
431845;201812;505;1352;351;1031;26;84;216;622;242;706
431846;201812;247;708;220;666;19;54;180;546;199;600
431848;201812;152;382;78;235;9;30;12;23;21;53
431849;201812;399;953;59;172;8;17;5;11;13;28
431850;201812;3813;10687;2999;9011;751;2443;875;2540;1626;4983
431860;201812;638;1627;388;1118;82;246;194;529;276;775
431861;201812;111;289;46;143;4;15;15;40;19;55
431862;201812;415;1329;338;1193;80;301;170;595;250;896
431870;201812;15766;43097;12913;38152;2074;6963;6945;19679;9019;26642
431880;201812;3870;10222;2730;8158;499;1704;1160;3295;1659;4999
431890;201812;3821;10067;2387;7189;753;2481;310;1003;1063;3484
431900;201812;947;2490;592;1793;106;365;287;809;393;1174
431910;201812;781;1926;282;822;49;145;78;190;127;335
431912;201812;435;1264;346;1087;78;257;198;613;276;870
431915;201812;927;2500;757;2202;55;177;538;1525;593;1702
431920;201812;1134;2914;961;2648;50;167;812;2186;862;2353
431930;201812;659;1873;471;1523;132;403;223;741;355;1144
431935;201812;71;208;43;147;12;41;6;18;18;59
431936;201812;288;871;166;563;35;123;43;139;78;262
431937;201812;174;444;105;296;27;84;37;85;64;169
431940;201812;2622;6466;1539;4410;246;833;693;1852;939;2685
431950;201812;1675;4648;1387;4170;377;1165;591;1780;968;2945
431960;201812;2598;6705;1959;5506;537;1557;532;1492;1069;3049
431970;201812;376;991;149;481;33;98;33;97;66;195
431971;201812;56;144;30;98;3;11;5;14;8;25
431973;201812;444;1454;360;1285;40;138;256;927;296;1065
431975;201812;97;201;17;57;4;13;3;6;7;19
431980;201812;1020;2759;791;2356;178;578;349;998;527;1576
431990;201812;5384;13545;3506;10608;571;1923;1384;4046;1955;5969
432000;201812;9681;24544;7145;20410;1810;5403;3043;8685;4853;14088
432010;201812;1827;4840;1395;4041;210;676;792;2197;1002;2873
432020;201812;1737;4361;1198;3401;284;850;516;1375;800;2225
432023;201812;481;1194;247;717;43;143;115;296;158;439
432026;201812;990;2888;724;2335;169;545;295;940;464;1485
432030;201812;313;842;191;592;35;114;104;314;139;428
432032;201812;385;1022;264;782;26;91;139;375;165;466
432035;201812;671;1954;599;1837;216;690;202;619;418;1309
432040;201812;1039;2420;360;1147;65;236;108;306;173;542
432045;201812;167;481;99;333;24;81;30;106;54;187
432050;201812;479;1278;356;1045;91;256;129;387;220;643
432055;201812;654;1759;413;1273;136;450;115;321;251;771
432057;201812;251;651;179;485;41;94;75;192;116;286
432060;201812;417;1011;130;421;25;100;49;131;74;231
432065;201812;221;628;153;472;32;98;53;158;85;256
432067;201812;690;2093;586;1837;74;263;377;1131;451;1394
432070;201812;1752;4752;1084;3371;234;794;273;743;507;1537
432080;201812;3655;9494;2885;8182;681;2202;1179;3210;1860;5412
432085;201812;379;991;244;775;89;270;79;273;168;543
432090;201812;1213;3256;875;2622;188;607;399;1142;587;1749
432100;201812;950;2565;419;1387;89;325;44;105;133;430
432110;201812;2062;5740;1368;4414;334;1242;89;305;423;1547
432120;201812;2594;7447;2100;6553;593;1997;541;1650;1134;3647
432130;201812;2374;6424;2026;5901;711;2181;758;2222;1469;4403
432132;201812;174;517;101;350;22;78;39;117;61;195
432135;201812;899;2283;597;1691;50;169;421;1160;471;1329
432140;201812;1482;4621;1107;3858;185;673;594;2093;779;2766
432143;201812;1273;3501;1001;3071;90;321;629;1910;719;2231
432145;201812;1278;3529;712;2249;113;393;175;486;288;879
432146;201812;107;308;70;234;22;80;13;37;35;117
432147;201812;425;1309;276;969;77;283;55;187;132;470
432149;201812;357;957;208;628;26;79;99;289;125;368
432150;201812;2730;7475;2011;6093;490;1678;606;1762;1096;3440
432160;201812;4505;12765;3458;10958;977;3319;1099;3403;2076;6722
432162;201812;263;586;33;97;5;12;5;16;10;28
432163;201812;141;369;26;81;1;3;1;2;2;5
432166;201812;499;1481;384;1227;71;235;129;376;200;611
432170;201812;1239;3488;781;2573;169;613;214;664;383;1277
432180;201812;2501;6374;1323;4001;255;843;394;1058;649;1901
432183;201812;328;972;212;694;56;211;55;164;111;375
432185;201812;777;2070;448;1401;30;107;248;738;278;845
432190;201812;1941;4910;1203;3576;272;924;451;1228;723;2152
432195;201812;919;2338;570;1701;165;470;214;662;379;1132
432200;201812;2886;7963;2074;6490;421;1355;996;3194;1417;4549
432210;201812;317;897;214;692;44;164;93;281;137;445
432215;201812;616;1856;550;1752;53;158;393;1270;446;1428
432218;201812;248;628;122;348;17;48;52;136;69;184
432220;201812;3626;8869;2691;7321;376;1162;1616;4225;1992;5387
432225;201812;86;256;64;206;16;52;29;94;45;146
432230;201812;695;1735;363;1069;51;152;161;433;212;585
432232;201812;482;1224;317;929;63;194;123;356;186;550
432234;201812;295;770;128;387;33;95;19;46;52;141
432235;201812;87;242;30;96;8;24;8;28;16;52
432237;201812;352;893;300;803;17;43;226;578;243;621
432240;201812;12845;35475;10000;31281;896;3190;6259;20305;7155;23495
432250;201812;3928;12574;3375;11466;1039;3654;1182;4119;2221;7773
432252;201812;416;1083;263;759;43;134;112;302;155;436
432253;201812;1014;3161;567;1969;136;504;31;92;167;596
432254;201812;826;2045;153;496;31;111;13;36;44;147
432255;201812;122;306;56;173;5;18;24;66;29;84
432260;201812;4627;12220;3393;9891;921;2760;969;2801;1890;5561
432270;201812;1796;5274;1454;4569;441;1481;245;745;686;2226
432280;201812;1061;2795;582;1803;102;352;222;609;324;961
432285;201812;189;586;18;64;0;0;2;5;2;5
432290;201812;348;1019;188;636;60;202;39;112;99;314
432300;201812;23944;63929;18546;54821;2795;9179;10892;31146;13687;40325
432310;201812;706;2002;520;1651;61;197;331;1054;392;1251
432320;201812;210;502;67;198;8;34;27;67;35;101
432330;201812;223;566;80;259;16;53;20;58;36;111
432335;201812;172;499;53;204;5;19;13;56;18;75
432340;201812;306;732;127;391;21;77;36;89;57;166
432345;201812;570;1404;511;1333;26;90;403;1032;429;1122
432350;201812;319;872;159;535;29;98;50;160;79;258
432360;201812;210;620;37;118;3;14;11;31;14;45
432370;201812;298;766;193;565;15;39;121;343;136;382
432375;201812;482;1235;368;1022;65;160;197;545;262;705
432377;201812;206;661;33;113;6;19;4;7;10;26
432380;201812;1430;4076;903;3013;182;684;406;1279;588;1963
500020;201812;2140;5788;1517;4694;301;1014;737;2238;1038;3252
500025;201812;1173;2700;729;1957;67;192;434;1133;501;1325
500060;201812;6019;17484;4536;14891;658;2249;2665;9138;3323;11387
500070;201812;3741;10017;2664;8175;542;1677;1161;3722;1703;5399
500080;201812;1161;3104;816;2499;157;552;377;1070;534;1622
500085;201812;1922;4835;1300;3850;293;937;617;1755;910;2692
500090;201812;1792;4959;1235;3945;226;748;487;1608;713;2356
500100;201812;3292;8610;2503;7297;325;1032;1356;3802;1681;4834
500110;201812;6621;18081;4291;14235;948;3380;1292;4979;2240;8359
500124;201812;1879;5866;1548;5267;311;1043;846;3037;1157;4080
500150;201812;1123;2608;696;1951;181;539;231;605;412;1144
500190;201812;4138;10145;2968;8454;734;2175;1144;3338;1878;5513
500200;201812;2050;4936;1528;4086;185;532;926;2338;1111;2870
500210;201812;4257;11518;3212;9981;864;2752;1372;4316;2236;7068
500215;201812;1325;3798;913;2995;101;379;478;1544;579;1923
500220;201812;2531;7235;1788;5893;322;1159;674;2195;996;3354
500230;201812;1970;4842;1486;4123;197;550;931;2539;1128;3089
500240;201812;3350;10451;2302;8166;399;1598;674;2456;1073;4054
500260;201812;2930;6429;1768;4772;233;607;923;2442;1156;3049
500270;201812;122243;296605;70950;205652;13754;43327;23267;63923;37021;107250
500280;201812;1183;3063;826;2500;103;346;496;1454;599;1800
500290;201812;3463;8092;1886;5617;341;1099;672;1878;1013;2977
500295;201812;2797;7044;1635;4827;290;949;617;1604;907;2553
500310;201812;846;1953;603;1634;100;250;320;904;420;1154
500315;201812;3129;9384;2591;8494;280;927;1771;5969;2051;6896
500320;201812;16485;48126;11797;39943;3184;11491;3758;13453;6942;24944
500325;201812;3939;9240;2675;7389;290;863;1558;4307;1848;5170
500330;201812;6395;15078;4111;11529;547;1741;2102;5945;2649;7686
500345;201812;1870;4657;1207;3597;300;918;405;1182;705;2100
500348;201812;2481;6402;1878;5395;249;757;1101;3205;1350;3962
500350;201812;1242;3442;646;2120;81;281;256;851;337;1132
500370;201812;21579;58169;14683;46332;2359;8386;6936;21850;9295;30236
500375;201812;2240;6219;1563;4774;332;1144;517;1503;849;2647
500380;201812;3338;8473;2296;6763;642;1987;789;2352;1431;4339
500390;201812;488;1028;289;765;43;116;150;394;193;510
500400;201812;1064;2903;726;2197;145;474;240;670;385;1144
500410;201812;2274;5984;1673;5024;225;677;958;2935;1183;3612
500430;201812;2395;6274;1618;5043;262;941;627;2051;889;2992
500440;201812;1042;2557;662;1933;108;315;253;785;361;1100
500450;201812;1300;3352;700;2187;133;431;126;361;259;792
500460;201812;3260;9140;2043;6750;425;1552;553;1840;978;3392
500470;201812;2259;6315;1413;4523;438;1522;272;761;710;2283
500480;201812;2122;6342;1827;5903;158;537;1245;4208;1403;4745
500490;201812;908;2224;526;1631;138;502;154;460;292;962
500500;201812;3981;11079;2632;8862;881;3395;564;1932;1445;5327
500510;201812;639;1627;416;1229;25;87;252;720;277;807
500515;201812;1836;4669;1445;4076;119;341;1004;2815;1123;3156
500520;201812;2865;9696;2346;8664;680;2647;907;3417;1587;6064
500525;201812;846;2596;691;2346;80;308;423;1453;503;1761
500540;201812;4051;10806;2413;7814;707;2706;203;569;910;3275
500560;201812;4914;14633;4088;13475;350;1256;3044;10169;3394;11425
500568;201812;4027;9098;2440;6747;601;1847;765;2095;1366;3942
500570;201812;6909;16723;3913;11394;869;2773;1010;2725;1879;5498
500580;201812;2955;8118;2254;6904;467;1515;1112;3383;1579;4898
500600;201812;2870;7325;1991;5966;370;1170;856;2589;1226;3759
500620;201812;6882;19023;4705;14737;1029;3350;1824;5650;2853;9000
500625;201812;478;1353;263;867;49;184;102;310;151;494
500627;201812;705;1829;428;1308;68;214;138;417;206;631
500630;201812;5498;13572;3332;9869;785;2533;1012;3044;1797;5577
500635;201812;2614;8753;2071;7976;147;612;1520;6204;1667;6816
500640;201812;1609;3717;1031;2850;40;136;741;1954;781;2090
500660;201812;15039;42792;10710;35741;3799;14032;2328;7871;6127;21903
500690;201812;2101;5982;1475;4987;593;2262;91;223;684;2485
500710;201812;2769;7876;2088;6607;609;2032;559;1696;1168;3728
500720;201812;4714;12342;2941;9292;699;2438;738;2355;1437;4793
500730;201812;869;2319;564;1733;91;259;229;734;320;993
500740;201812;4373;10678;3083;8549;330;989;1753;4894;2083;5883
500750;201812;916;2411;638;1915;90;290;242;656;332;946
500755;201812;822;2300;476;1614;102;364;67;208;169;572
500769;201812;4596;11695;2395;7306;454;1542;348;804;802;2346
500770;201812;1449;4029;887;2958;156;555;297;999;453;1554
500780;201812;1192;3017;760;2253;175;548;211;578;386;1126
500790;201812;7345;19658;5853;17235;1107;3573;3175;9362;4282;12935
500793;201812;1723;4558;1177;3620;382;1207;249;677;631;1884
500795;201812;2374;6426;1972;5885;132;374;1631;5020;1763;5394
500797;201812;660;1783;436;1354;109;350;157;470;266;820
500800;201812;2586;6264;1710;4957;571;1877;257;817;828;2694
500830;201812;16387;41879;11256;32571;1819;5724;5328;14662;7147;20386
500840;201812;1349;3414;768;2274;95;297;301;846;396;1143
510010;201812;1778;4302;1187;3479;173;495;698;2085;871;2580
510020;201812;3422;8971;1780;5562;407;1314;332;924;739;2238
510025;201812;6363;16649;3893;12161;678;2352;1325;3914;2003;6266
510030;201812;2100;4860;1366;3799;340;941;475;1387;815;2328
510035;201812;1185;3069;707;2305;101;322;403;1403;504;1725
510040;201812;2106;4950;1524;4139;140;394;973;2641;1113;3035
510050;201812;1869;4455;1260;3526;220;704;756;1981;976;2685
510060;201812;1333;3451;990;2913;181;598;400;1123;581;1721
510080;201812;1148;3189;756;2473;225;789;211;601;436;1390
510100;201812;617;1491;388;1092;54;167;201;530;255;697
510120;201812;250;462;139;332;9;30;102;238;111;268
510125;201812;2097;5303;1630;4596;218;796;747;1906;965;2702
510130;201812;1369;3550;978;2911;219;718;286;842;505;1560
510140;201812;2729;7523;1897;6418;686;2672;656;2031;1342;4703
510160;201812;1634;4344;1208;3785;208;643;815;2571;1023;3214
510170;201812;4359;11988;3206;10053;784;2584;1302;4103;2086;6687
510180;201812;12585;30518;7686;22512;1912;6051;2188;7211;4100;13262
510185;201812;1550;4280;1048;3543;403;1349;340;1379;743;2728
510190;201812;1971;5717;1337;4612;439;1621;306;1119;745;2740
510250;201812;13521;36736;11072;33240;2240;7005;6187;19214;8427;26219
510260;201812;2037;8388;1643;7637;261;1271;962;4947;1223;6218
510263;201812;2761;7921;1706;5753;323;1163;211;656;534;1819
510267;201812;4488;13116;2735;9175;579;2033;503;1711;1082;3744
510268;201812;1307;3341;897;2613;134;402;476;1334;610;1736
510269;201812;1023;2889;648;2151;157;574;226;709;383;1283
510270;201812;2737;8267;1993;6907;376;1405;765;2621;1141;4026
510279;201812;1647;4512;1132;3565;207;733;565;1683;772;2416
510285;201812;1062;2933;744;2383;215;766;178;538;393;1304
510300;201812;3389;8839;2534;7659;355;1015;1525;4875;1880;5890
510305;201812;1421;4071;875;3002;181;669;241;912;422;1581
510310;201812;906;2377;641;1915;209;658;197;603;406;1261
510320;201812;3489;9186;2513;7461;610;1949;675;2019;1285;3968
510325;201812;4360;13242;3410;11634;995;3484;1323;4670;2318;8154
510330;201812;2789;8540;1887;6881;368;1383;682;2789;1050;4172
510335;201812;4431;12930;3321;11302;431;1612;1912;6794;2343;8406
510336;201812;446;1322;327;1120;64;215;151;542;215;757
510337;201812;1552;4702;1045;3748;410;1578;150;554;560;2132
510340;201812;80757;185716;48364;136564;13957;45796;11686;30591;25643;76387
510343;201812;934;2714;645;2142;132;479;224;700;356;1179
510345;201812;1204;3568;895;2952;166;549;376;1188;542;1737
510350;201812;2697;7311;1749;5669;418;1406;690;2242;1108;3648
510360;201812;1767;3878;1112;3068;54;160;823;2351;877;2511
510370;201812;1598;4916;1170;4120;207;796;613;2214;820;3010
510380;201812;480;1240;255;810;70;255;62;187;132;442
510385;201812;1005;3598;743;3045;78;367;462;1990;540;2357
510390;201812;1005;3067;766;2722;203;708;349;1369;552;2077
510395;201812;711;1640;466;1273;31;93;263;770;294;863
510410;201812;4110;12112;3111;10255;722;2459;1594;5425;2316;7884
510420;201812;2006;4582;1423;3770;164;468;834;2225;998;2693
510450;201812;486;1224;282;840;77;230;40;130;117;360
510452;201812;624;1778;410;1362;74;246;193;643;267;889
510454;201812;780;2300;591;1957;54;175;369;1291;423;1466
510455;201812;877;2572;617;1989;99;376;225;662;324;1038
510460;201812;1791;4548;1292;3807;136;477;794;2224;930;2701
510480;201812;4453;11220;2887;8134;575;1773;1124;3033;1699;4806
510490;201812;1573;4480;1178;3922;252;878;584;1973;836;2851
510500;201812;1512;3980;909;2921;180;626;317;1007;497;1633
510510;201812;3118;9663;2364;8163;728;2733;580;2144;1308;4877
510515;201812;5201;14057;3334;10433;720;2505;916;2611;1636;5116
510517;201812;1071;3173;820;2726;226;846;160;473;386;1319
510520;201812;1957;4093;1141;3094;67;198;647;1853;714;2051
510523;201812;963;2568;721;2159;143;410;409;1230;552;1640
510525;201812;5529;15854;4105;12929;713;2484;1784;5236;2497;7720
510530;201812;536;1391;397;1181;30;117;271;775;301;892
510550;201812;2456;7496;1792;6275;453;1634;685;2449;1138;4083
510558;201812;1958;5440;1528;4798;171;600;799;2671;970;3271
510560;201812;1513;4471;864;3177;203;828;221;859;424;1687
510562;201812;4942;13543;3539;10832;848;2805;1258;3887;2106;6692
510590;201812;2878;7502;2068;6448;301;969;1291;4109;1592;5078
510600;201812;1473;3486;919;2598;188;515;375;1081;563;1596
510610;201812;2629;6525;1801;5354;172;596;1094;3237;1266;3833
510615;201812;1936;5484;1437;4567;258;815;801;2619;1059;3434
510617;201812;906;2660;665;2260;102;371;389;1389;491;1760
510618;201812;1190;3291;834;2643;168;601;438;1337;606;1938
510619;201812;695;1821;392;1243;64;236;83;239;147;475
510620;201812;1374;3171;649;2026;145;526;49;121;194;647
510621;201812;1327;3709;827;2729;181;642;240;775;421;1417
510622;201812;3770;11049;2644;8456;963;3335;403;1143;1366;4478
510623;201812;2516;6631;1788;5415;399;1435;502;1443;901;2878
510624;201812;1475;3916;648;2222;82;306;123;354;205;660
510625;201812;2365;5905;1325;4013;292;1010;271;806;563;1816
510626;201812;1524;3637;901;2686;256;869;198;592;454;1461
510627;201812;572;1493;330;1006;83;246;70;233;153;479
510628;201812;1511;3491;1020;2841;158;416;610;1807;768;2223
510629;201812;1475;4487;1121;3787;271;987;359;1231;630;2218
510630;201812;3133;9091;1819;6444;413;1591;289;1106;702;2697
510631;201812;509;1270;369;1069;21;59;272;792;293;851
510637;201812;3111;7936;2283;6613;689;2220;601;1646;1290;3866
510642;201812;4788;14541;3857;13111;1036;3797;1568;5527;2604;9324
510645;201812;820;1817;479;1353;118;338;167;460;285;798
510650;201812;6682;18375;5429;17005;698;2049;3905;13052;4603;15101
510665;201812;1725;4020;991;2791;171;525;391;1141;562;1666
510670;201812;406;868;226;601;28;86;124;327;152;413
510675;201812;5437;15765;3917;12863;1153;4110;644;2071;1797;6181
510677;201812;2042;5436;1421;4461;204;683;730;2262;934;2945
510680;201812;623;1699;374;1210;96;324;50;153;146;477
510682;201812;1510;4750;1122;4036;349;1356;231;836;580;2192
510685;201812;639;1878;469;1531;73;242;218;690;291;932
510700;201812;3476;9066;2470;7543;408;1313;1510;4669;1918;5982
510704;201812;9092;22580;5941;16959;1214;3795;1650;4513;2864;8308
510706;201812;1754;5370;1251;4555;223;874;667;2579;890;3453
510710;201812;2370;6376;1621;4890;343;1093;560;1598;903;2691
510715;201812;618;1432;445;1175;51;129;202;555;253;684
510718;201812;2351;5315;1307;4037;584;1811;226;975;810;2786
510719;201812;388;840;232;631;37;105;122;315;159;420
510720;201812;920;2303;607;1801;148;475;199;549;347;1024
510724;201812;662;1837;453;1466;83;300;203;622;286;922
510726;201812;1134;2063;575;1357;73;174;295;697;368;871
510729;201812;609;1462;282;858;40;138;64;197;104;335
510730;201812;2841;7132;1932;5689;403;1289;777;2240;1180;3529
510735;201812;973;2970;737;2623;81;322;519;1850;600;2172
510740;201812;899;2277;577;1674;80;222;290;869;370;1091
510757;201812;555;1804;449;1620;167;662;139;464;306;1126
510760;201812;37610;84076;21658;59854;6305;19359;4994;12653;11299;32012
510770;201812;3945;9374;2882;8037;313;810;1930;5631;2243;6441
510774;201812;328;925;219;697;39;130;112;378;151;508
510775;201812;572;1597;389;1289;93;343;79;243;172;586
510776;201812;445;1190;300;896;85;263;90;272;175;535
510777;201812;1593;4389;1170;3809;160;652;740;2334;900;2986
510779;201812;566;1589;441;1375;62;172;257;853;319;1025
510780;201812;3479;9479;2597;8132;653;2059;1023;3573;1676;5632
510785;201812;1966;5259;1123;3690;278;994;163;592;441;1586
510787;201812;2310;6653;1564;5103;637;2186;94;288;731;2474
510788;201812;679;1631;465;1303;82;224;177;594;259;818
510790;201812;13841;37484;8416;26823;1992;7226;1286;3534;3278;10760
510792;201812;7889;21550;4983;16026;1011;3573;1138;3520;2149;7093
510794;201812;1139;3165;741;2430;244;898;152;425;396;1323
510795;201812;6941;19360;4690;15177;1135;4018;1133;3675;2268;7693
510800;201812;1591;4144;1054;3252;300;948;225;657;525;1605
510805;201812;1583;4416;1038;3348;214;725;336;970;550;1695
510810;201812;635;1380;414;1070;106;295;196;494;302;789
510820;201812;768;1502;418;1060;45;146;199;499;244;645
510830;201812;770;1962;543;1635;72;214;334;1053;406;1267
510835;201812;500;1296;341;1051;53;181;169;507;222;688
510840;201812;44422;101046;31730;84982;6049;15785;16661;48205;22710;63990
510850;201812;1785;4428;1005;3145;282;987;128;314;410;1301
510860;201812;2399;6615;1534;5110;487;1885;160;515;647;2400
510880;201812;635;1892;478;1582;127;437;204;690;331;1127
510885;201812;552;1415;380;1158;71;241;127;381;198;622
510890;201812;633;1921;489;1679;109;405;229;785;338;1190
510895;201812;1150;3066;769;2395;195;693;281;792;476;1485
520005;201812;2029;5530;1611;5007;402;1155;769;2725;1171;3880
520010;201812;2114;6312;1512;5049;400;1494;372;1077;772;2571
520013;201812;2476;6719;1742;5287;423;1338;431;1410;854;2748
520015;201812;516;1340;390;1164;98;306;125;402;223;708
520017;201812;1041;2820;790;2422;125;413;468;1399;593;1812
520020;201812;351;867;277;762;53;169;160;416;213;585
520025;201812;30943;88849;27216;83600;3236;10350;19170;58810;22406;69160
520030;201812;4901;13389;3952;11966;467;1530;2515;7571;2982;9101
520050;201812;399;939;254;689;19;40;149;429;168;469
520055;201812;1133;3003;813;2375;51;152;481;1360;532;1512
520060;201812;1323;3871;1013;3294;264;931;250;813;514;1744
520080;201812;1776;4718;1349;4121;241;733;616;2067;857;2800
520082;201812;922;2378;754;2085;91;225;415;1201;506;1426
520085;201812;693;1935;534;1671;115;358;205;601;320;959
520090;201812;785;1612;545;1342;96;195;363;949;459;1144
520110;201812;35766;99850;25278;82434;8294;30379;1721;5096;10015;35475
520120;201812;189;475;106;333;13;50;35;109;48;159
520130;201812;3595;9284;2911;8175;555;1644;1355;3837;1910;5481
520140;201812;34882;99080;25502;82534;9355;32849;2648;8942;12003;41791
520145;201812;504;1212;339;967;67;204;147;377;214;581
520150;201812;557;1359;414;1171;78;224;221;636;299;860
520160;201812;765;1810;555;1488;91;241;273;739;364;980
520170;201812;4872;10247;3457;8585;194;523;2734;6694;2928;7217
520180;201812;1880;5376;1540;4820;391;1303;650;1992;1041;3295
520215;201812;1875;4559;1351;3730;300;900;551;1443;851;2343
520235;201812;587;1425;370;1087;50;154;136;386;186;540
520250;201812;1365;3619;1006;3061;292;997;202;636;494;1633
520260;201812;809;1924;490;1366;100;302;187;520;287;822
520280;201812;624;1646;496;1420;133;389;190;585;323;974
520310;201812;1168;2685;777;2089;196;564;297;827;493;1391
520320;201812;1647;4669;1297;4084;139;467;715;2258;854;2725
520330;201812;3402;9765;2462;8125;470;1812;1055;3389;1525;5201
520340;201812;2162;5007;1443;3981;159;384;912;2620;1071;3004
520350;201812;2711;6860;1983;5674;678;2058;604;1667;1282;3725
520355;201812;1719;4846;1293;4027;315;1079;472;1388;787;2467
520357;201812;758;1936;592;1664;31;85;440;1256;471;1341
520360;201812;673;1821;505;1522;153;464;133;440;286;904
520380;201812;1244;3199;747;2230;79;284;386;1063;465;1347
520390;201812;932;2091;520;1565;168;542;131;418;299;960
520393;201812;514;1239;359;993;44;146;174;435;218;581
520396;201812;769;2135;647;1913;82;260;392;1127;474;1387
520400;201812;1480;3875;1184;3459;200;608;740;2162;940;2770
520410;201812;1598;3536;980;2641;118;320;559;1504;677;1824
520420;201812;376;910;283;732;29;87;204;498;233;585
520425;201812;1340;3267;881;2513;227;653;307;883;534;1536
520430;201812;2129;5042;1144;3456;198;714;39;102;237;816
520440;201812;3000;7393;1876;5401;470;1444;482;1350;952;2794
520450;201812;10864;27081;7112;21013;2341;7504;740;2287;3081;9791
520455;201812;625;1760;458;1495;117;397;135;441;252;838
520460;201812;869;2257;737;2074;106;268;541;1566;647;1834
520465;201812;798;2101;638;1862;111;346;396;1107;507;1453
520470;201812;1854;5342;1569;4963;385;1213;810;2722;1195;3935
520480;201812;822;2352;550;1861;156;558;117;413;273;971
520485;201812;1508;4309;1269;3975;223;698;797;2491;1020;3189
520490;201812;3784;10825;2958;9549;866;2812;1285;4309;2151;7121
520495;201812;1458;3362;1133;2922;59;160;887;2309;946;2469
520500;201812;1363;3667;948;2886;215;730;340;1018;555;1748
520505;201812;718;1732;515;1451;87;257;276;757;363;1014
520510;201812;6806;17765;4669;14494;1076;3729;1205;3975;2281;7704
520520;201812;1098;2871;819;2423;200;592;266;817;466;1409
520530;201812;1902;5809;1419;4949;507;1818;364;1447;871;3265
520540;201812;2780;7480;1702;5245;352;1138;388;1179;740;2317
520545;201812;859;2385;663;2061;130;398;237;748;367;1146
520547;201812;700;1989;548;1698;155;488;230;711;385;1199
520549;201812;11147;31954;9264;28859;1863;6069;5218;16176;7081;22245
520551;201812;4130;11707;3509;10785;455;1666;2393;7147;2848;8813
520552;201812;809;2195;698;2051;118;326;480;1479;598;1805
520570;201812;602;1428;390;1109;103;282;136;408;239;690
520580;201812;2367;5509;1768;4767;152;445;1219;3279;1371;3724
520590;201812;1178;3192;834;2567;238;733;141;428;379;1161
520620;201812;7824;21768;6267;19451;1588;5027;2884;9149;4472;14176
520630;201812;792;2033;494;1526;93;288;122;373;215;661
520640;201812;2404;6049;1819;5036;462;1281;694;1984;1156;3265
520650;201812;871;2155;609;1737;112;313;297;883;409;1196
520660;201812;521;1262;249;763;49;155;51;166;100;321
520670;201812;919;2621;779;2418;77;249;512;1532;589;1781
520680;201812;685;1721;509;1451;108;292;230;677;338;969
520690;201812;353;831;239;672;80;212;69;209;149;421
520710;201812;473;1139;315;874;10;24;207;560;217;584
520725;201812;1544;3769;1096;3020;131;397;695;1845;826;2242
520735;201812;703;1785;489;1416;102;277;170;520;272;797
520740;201812;1863;4509;1460;3986;256;691;838;2372;1094;3063
520750;201812;634;1598;459;1320;88;236;222;664;310;900
520753;201812;1354;3627;1045;3029;191;568;425;1161;616;1729
520760;201812;1144;2508;1027;2357;71;131;862;2056;933;2187
520780;201812;1510;3712;1129;3155;120;339;589;1623;709;1962
520790;201812;3304;7912;2310;6373;240;664;1361;3991;1601;4655
520800;201812;13870;37423;11207;33630;2193;6682;6437;20052;8630;26734
520810;201812;1272;2728;904;2303;186;518;480;1253;666;1771
520815;201812;589;1766;427;1436;106;371;83;298;189;669
520830;201812;1742;3919;1247;3343;59;134;994;2649;1053;2783
520840;201812;2208;6161;1814;5640;770;2508;505;1687;1275;4195
520850;201812;620;1695;438;1410;159;583;91;294;250;877
520860;201812;5508;15685;4304;13723;1083;3721;1655;5252;2738;8973
520870;201812;84969;205573;58685;166140;15586;47760;17953;49825;33539;97585
520880;201812;5816;16966;4599;14856;1319;4526;1389;4465;2708;8991
520890;201812;3632;9259;2535;7491;554;1761;1074;3147;1628;4908
520910;201812;4242;10976;2698;8227;721;2429;494;1524;1215;3953
520915;201812;601;1695;392;1248;70;254;140;422;210;676
520920;201812;4341;10300;2929;8336;429;1279;1510;4345;1939;5624
520929;201812;727;1786;502;1403;107;276;218;656;325;932
520940;201812;981;2684;789;2407;49;164;606;1820;655;1984
520945;201812;485;1126;385;973;31;78;265;652;296;730
520960;201812;1000;2610;794;2268;104;319;491;1351;595;1670
520970;201812;2308;6714;1888;5984;559;1923;451;1483;1010;3406
520980;201812;757;1921;573;1655;124;383;229;636;353;1019
520990;201812;2859;8257;2407;7612;286;947;1584;5042;1870;5989
520993;201812;1013;2424;683;1901;40;125;476;1295;516;1420
520995;201812;2192;5693;1695;5013;371;1102;674;2034;1045;3136
521000;201812;7610;20821;5377;16779;1294;4228;1520;4730;2814;8958
521010;201812;3618;9544;2718;8007;342;992;1509;4437;1851;5429
521015;201812;674;1731;522;1487;56;167;331;914;387;1081
521020;201812;2769;7361;1687;5200;495;1627;153;486;648;2113
521030;201812;473;1059;325;849;43;83;168;485;211;568
521040;201812;7182;17786;5374;14984;1365;4003;2101;5968;3466;9971
521056;201812;823;2258;637;1968;192;611;189;631;381;1242
521060;201812;995;2582;739;2150;68;207;363;1068;431;1275
521080;201812;1033;2330;523;1477;67;199;188;452;255;651
521090;201812;3284;8697;2254;6793;618;1988;291;919;909;2907
521100;201812;1725;4057;1243;3386;236;625;675;1876;911;2501
521120;201812;4622;10921;3222;9162;282;732;1580;5128;1862;5860
521130;201812;869;2086;574;1573;32;116;334;918;366;1034
521140;201812;1212;3214;887;2653;153;491;357;1058;510;1549
521150;201812;11250;25553;7283;20031;1519;4753;3125;8736;4644;13489
521160;201812;597;1326;420;1045;58;142;246;584;304;726
521170;201812;1046;2491;750;2037;81;220;493;1303;574;1523
521180;201812;6421;18978;5376;17041;1039;3557;2399;7354;3438;10911
521190;201812;9997;26066;5701;18270;1407;4823;1081;3614;2488;8437
521200;201812;708;1783;491;1410;58;168;274;777;332;945
521205;201812;603;1559;452;1306;23;53;330;939;353;992
521210;201812;685;1771;380;1155;94;307;45;96;139;403
521220;201812;3801;9454;2504;7364;548;1746;694;1879;1242;3625
521225;201812;313;718;242;634;39;101;150;391;189;492
521230;201812;1232;3484;1132;3345;424;1238;570;1762;994;3000
521250;201812;28907;81151;23133;72846;9223;30233;6779;22718;16002;52951
521260;201812;577;1351;424;1101;62;166;251;640;313;806
521270;201812;1777;4593;1523;4285;100;247;1173;3333;1273;3580
521280;201812;1827;5067;1379;4269;381;1273;470;1484;851;2757
521290;201812;444;1124;321;958;51;167;168;487;219;654
521295;201812;1083;2384;850;2125;74;165;657;1744;731;1909
521300;201812;1847;4725;1478;4214;289;776;891;2608;1180;3384
521305;201812;691;1772;487;1431;65;179;268;787;333;966
521308;201812;4547;12554;3282;10060;482;1505;1743;5258;2225;6763
521310;201812;7742;20499;5189;15959;1278;4272;1735;5126;3013;9398
521340;201812;398;939;289;777;18;46;217;573;235;619
521350;201812;2017;5218;1561;4523;173;572;1047;2913;1220;3485
521370;201812;1168;3037;717;2269;178;632;139;457;317;1089
521375;201812;1338;3406;956;2863;238;714;329;1060;567;1774
521377;201812;1437;3154;1064;2691;74;145;884;2296;958;2441
521380;201812;5671;15462;3784;11869;403;1396;929;3070;1332;4466
521385;201812;589;1474;470;1318;93;262;230;698;323;960
521390;201812;668;1719;490;1451;161;505;155;489;316;994
521400;201812;2402;5546;1860;4913;174;465;1406;3818;1580;4283
521405;201812;1262;3259;942;2735;191;561;420;1199;611;1760
521410;201812;741;2012;586;1767;123;350;290;947;413;1297
521440;201812;1287;3366;946;2818;286;918;254;741;540;1659
521450;201812;3687;11296;2768;9388;693;2355;764;2748;1457;5103
521460;201812;5556;15178;4095;12536;1437;4618;846;2518;2283;7136
521470;201812;611;1698;363;1149;57;182;106;310;163;492
521480;201812;345;903;198;615;39;132;46;127;85;259
521483;201812;2434;5923;1683;4709;434;1293;576;1564;1010;2857
521486;201812;1626;3913;1242;3376;70;203;951;2557;1021;2760
521487;201812;444;1122;320;939;59;174;144;437;203;611
521490;201812;829;2291;610;1911;42;180;430;1301;472;1481
521500;201812;1712;4468;1254;3715;93;341;870;2498;963;2839
521520;201812;744;1710;504;1354;83;225;210;579;293;804
521523;201812;10646;35050;9182;32565;3126;11851;2347;8589;5473;20440
521525;201812;1032;2424;765;2039;87;248;533;1403;620;1651
521530;201812;2184;5750;1256;3801;257;836;316;1002;573;1838
521540;201812;846;2170;542;1644;91;325;222;678;313;1003
521550;201812;1225;3153;749;2232;163;520;217;682;380;1202
521560;201812;3925;10934;2785;9367;581;2310;1335;4639;1916;6949
521565;201812;612;1536;485;1351;97;247;275;765;372;1012
521570;201812;3516;9466;2342;7256;486;1692;312;1039;798;2731
521580;201812;480;1187;272;810;34;106;62;155;96;261
521590;201812;586;1497;447;1276;114;367;200;530;314;897
521600;201812;378;1066;232;734;44;119;51;167;95;286
521630;201812;1568;3591;948;2628;192;563;301;797;493;1360
521640;201812;1845;4446;1327;3707;307;903;474;1288;781;2191
521645;201812;558;1506;361;1139;87;261;96;308;183;569
521680;201812;1105;3437;874;2963;266;955;96;355;362;1310
521690;201812;496;1326;429;1207;66;199;257;699;323;898
521710;201812;2835;7460;1892;5800;349;1179;412;1217;761;2396
521720;201812;2026;4969;1430;4070;192;585;785;2182;977;2767
521730;201812;3482;10296;2715;8875;862;3127;494;1361;1356;4488
521740;201812;3721;10118;2867;8846;882;2924;905;2929;1787;5853
521760;201812;13097;38468;10650;34565;3255;11541;3533;11837;6788;23378
521770;201812;2785;7072;1961;5680;612;1894;431;1229;1043;3123
521800;201812;5501;15671;4384;13814;1238;4046;1446;4964;2684;9010
521805;201812;532;1273;382;1056;134;339;152;446;286;785
521810;201812;676;1589;457;1269;80;236;220;613;300;849
521830;201812;5040;14474;4119;13083;405;1470;2760;8616;3165;10086
521839;201812;629;1634;456;1329;91;278;195;524;286;802
521850;201812;4823;12444;3312;9895;642;2125;355;961;997;3086
521860;201812;1695;4454;1159;3529;194;650;383;1134;577;1784
521870;201812;673;1942;471;1552;106;357;128;401;234;758
521878;201812;576;1567;425;1282;70;243;193;527;263;770
521880;201812;17211;42299;11582;33687;3076;9372;3659;11004;6735;20376
521890;201812;2959;8163;2006;6292;508;1705;260;756;768;2461
521900;201812;1575;3785;948;2846;241;717;198;628;439;1345
521910;201812;1115;2547;768;2127;79;214;458;1323;537;1537
521920;201812;419;1210;307;987;62;217;112;373;174;590
521925;201812;708;1970;527;1665;112;354;201;610;313;964
521930;201812;4401;11270;3121;9358;912;2702;1081;3539;1993;6241
521935;201812;835;2111;601;1689;75;222;341;905;416;1127
521940;201812;1233;2854;814;2285;188;594;319;853;507;1447
521945;201812;503;1429;402;1241;90;272;187;610;277;882
521950;201812;621;1524;481;1343;75;245;315;837;390;1082
521960;201812;695;1917;454;1419;66;217;208;621;274;838
521970;201812;2446;6277;2064;5823;121;318;1661;4779;1782;5097
521971;201812;709;1770;490;1427;135;406;124;351;259;757
521973;201812;1099;2998;889;2693;59;219;604;1784;663;2003
521975;201812;11402;30935;9665;28551;1687;5163;5949;17611;7636;22774
521980;201812;2515;6181;1971;5462;204;527;1434;4008;1638;4535
521990;201812;1092;3053;889;2736;130;399;436;1376;566;1775
522000;201812;2756;7762;2190;7030;243;748;1437;4817;1680;5565
522005;201812;329;821;250;710;51;134;117;344;168;478
522010;201812;3691;9297;2665;7644;742;2255;701;1954;1443;4209
522015;201812;921;2489;657;2059;156;518;239;744;395;1262
522020;201812;4996;12239;3332;9537;808;2415;1405;4112;2213;6527
522026;201812;623;1782;477;1523;89;294;198;626;287;920
522028;201812;465;1257;339;997;97;271;108;307;205;578
522040;201812;2863;6547;2026;5454;255;748;1344;3538;1599;4286
522045;201812;15700;45832;11716;38161;2900;10028;2854;9064;5754;19092
522050;201812;1008;2735;693;2186;144;490;277;829;421;1319
522060;201812;2416;6797;1947;6066;255;853;1107;3548;1362;4401
522068;201812;1702;4674;1382;4277;170;478;975;3109;1145;3587
522070;201812;575;1531;474;1369;34;126;358;985;392;1111
522100;201812;582;1566;415;1296;61;203;218;670;279;873
522108;201812;884;2442;697;2145;44;202;558;1636;602;1838
522119;201812;1496;3933;1167;3487;189;590;613;1876;802;2466
522130;201812;369;922;265;781;54;169;142;439;196;608
522140;201812;15251;41532;11150;34269;3285;10740;2191;6482;5476;17222
522145;201812;829;2059;591;1712;146;380;285;886;431;1266
522150;201812;885;2202;661;1856;214;577;208;629;422;1206
522155;201812;850;2258;664;1937;143;411;303;886;446;1297
522157;201812;517;1347;447;1252;26;92;346;956;372;1048
522160;201812;5543;14885;3710;11427;1045;3504;280;938;1325;4442
522170;201812;2506;6631;1820;5536;445;1381;756;2332;1201;3713
522180;201812;428;1065;271;792;59;175;29;105;88;280
522185;201812;15394;39751;11619;34734;5069;16324;2526;8280;7595;24604
522190;201812;694;1699;517;1428;99;273;206;582;305;855
522200;201812;1608;4809;1018;3486;180;640;85;273;265;913
522205;201812;1563;3750;1192;3231;120;350;826;2229;946;2579
522220;201812;1273;3350;971;2886;161;466;504;1533;665;1999
522230;201812;1133;3019;948;2751;210;689;501;1404;711;2093
530010;201812;148848;428097;125748;390867;24457;83545;67114;204648;91571;288193
