ibge;anomes;bpc_ben;bpc_pcd_ben;bpc_idoso_ben;bpc_pcd_val;bpc_idoso_val;bpc_val
110001;201801;512;406;106;386340.34;100478.96;486819.3
110002;201801;2774;1659;1115;1580806.2;1062803.5;2643609.8
110003;201801;94;74;20;70596.0;19080.0;89676.0
110004;201801;1989;1265;724;1203909.0;690400.25;1894309.2
110005;201801;434;349;85;332660.0;81080.46;413740.47
110006;201801;446;342;104;325981.8;99196.92;425178.72
110007;201801;82;65;17;62010.0;16218.0;78228.0
110008;201801;240;137;103;129462.9;98262.0;227724.9
110009;201801;785;532;253;505335.2;241163.0;746498.2
110010;201801;1776;1098;678;1046259.0;646670.5;1692929.5
110011;201801;1886;1449;437;1380815.2;416868.34;1797683.5
110012;201801;4118;2391;1727;2273557.2;1646286.5;3919843.8
110013;201801;747;563;184;537092.44;175536.0;712628.44
110014;201801;364;309;55;294765.88;52465.23;347231.12
110015;201801;1422;1144;278;1088948.9;264620.53;1353569.4
110018;201801;1113;661;452;630280.0;431195.22;1061475.2
110020;201801;15311;8995;6316;8536984.0;6015128.5;1,46E+14
110025;201801;646;473;173;449244.12;165033.0;614277.1
110026;201801;43;29;14;27666.0;13356.0;41022.0
110028;201801;1638;1187;451;1127549.6;426661.44;1554211.0
110029;201801;139;122;17;116388.0;16218.0;132606.0
110030;201801;2473;1661;812;1581879.2;773747.44;2355626.8
110032;201801;396;304;92;289707.0;87764.0;377471.0
110033;201801;661;499;162;473043.0;154544.0;627587.0
110034;201801;360;269;91;254314.0;86147.0;340461.0
110037;201801;103;84;19;80136.0;18126.0;98262.0
110040;201801;329;221;108;210834.0;103032.0;313866.0
110045;201801;931;614;317;584210.0;300714.38;884924.4
110050;201801;95;77;18;73458.0;17172.0;90630.0
110060;201801;86;45;41;42930.0;39114.0;82044.0
110070;201801;128;76;52;72504.0;49322.0;121826.0
110080;201801;395;235;160;221967.19;152591.27;374558.44
110090;201801;32;27;5;25758.0;4770.0;30528.0
110092;201801;110;62;48;59148.0;45722.0;104870.0
110094;201801;196;137;59;130698.0;56286.0;186984.0
110100;201801;27;22;5;20988.0;4770.0;25758.0
110110;201801;72;45;27;42930.0;25758.0;68688.0
110120;201801;73;60;13;57240.0;12402.0;69642.0
110130;201801;302;243;59;230327.12;56286.0;286613.12
110140;201801;246;159;87;151400.6;82988.46;234389.05
110143;201801;46;39;7;37206.0;6678.0;43884.0
110145;201801;29;20;9;19080.0;8586.0;27666.0
110146;201801;22;11;11;10494.0;10494.0;20988.0
110147;201801;39;30;9;28620.0;8586.0;37206.0
110148;201801;39;27;12;25706.57;11448.0;37154.57
110149;201801;296;213;83;202915.8;79182.0;282097.8
110150;201801;84;57;27;54378.0;25491.89;79869.89
110155;201801;8;7;1;6678.0;954.0;7632.0
110160;201801;71;59;12;56286.0;11448.0;67734.0
110170;201801;210;170;40;162180.0;38160.0;200340.0
110175;201801;33;25;8;23850.0;7632.0;31482.0
110180;201801;93;81;12;77274.0;11448.0;88722.0
120001;201801;132;89;43;84864.0;40992.12;125856.12
120005;201801;191;120;71;114437.12;67734.0;182171.12
120010;201801;1006;648;358;611828.4;339299.16;951127.5
120013;201801;138;95;43;89943.94;40656.16;130600.1
120017;201801;92;59;33;56177.48;31439.12;87616.6
120020;201801;3512;2793;719;2634945.8;682319.7;3317265.2
120025;201801;601;337;264;319463.22;250815.03;570278.25
120030;201801;1021;853;168;805625.7;159514.12;965139.8
120032;201801;48;40;8;38138.12;7632.0;45770.12
120033;201801;213;187;26;178050.75;24804.0;202854.75
120034;201801;157;114;43;106826.12;40978.24;147804.36
120035;201801;31;21;10;20034.0;9540.0;29574.0
120038;201801;388;244;144;231951.88;137332.23;369284.12
120039;201801;23;21;2;20034.0;1908.0;21942.0
120040;201801;14001;9693;4308;9110829.0;4070573.8;1,32E+14
120042;201801;43;37;6;35298.0;5724.0;41022.0
120043;201801;13;3;10;2862.0;9540.0;12402.0
120045;201801;536;344;192;326095.38;182902.6;508997.97
120050;201801;1253;957;296;906187.0;282007.28;1188194.2
120060;201801;1405;1137;268;1068341.9;251578.72;1319920.6
120070;201801;503;361;142;337902.44;134126.55;472028.97
120080;201801;159;103;56;97054.3;52879.18;149933.48
130002;201801;149;104;45;99216.0;42930.0;142146.0
130006;201801;75;43;32;41022.0;30528.0;71550.0
130008;201801;144;77;67;72737.72;63195.96;135933.69
130010;201801;140;74;66;70596.0;62964.0;133560.0
130014;201801;240;175;65;166950.0;62010.0;228960.0
130020;201801;89;49;40;46746.0;38160.0;84906.0
130030;201801;886;541;345;516114.0;329120.47;845234.44
130040;201801;329;165;164;157410.0;155502.28;312912.28
130050;201801;553;307;246;292591.8;234684.0;527275.8
130060;201801;885;605;280;572021.2;264299.25;836320.44
130063;201801;550;287;263;273798.0;250880.12;524678.1
130068;201801;187;121;66;115434.0;62677.8;178111.8
130070;201801;1329;923;406;867044.6;382340.12;1249384.8
130080;201801;659;430;229;409838.4;218457.0;628295.4
130083;201801;70;38;32;36252.0;30528.0;66780.0
130090;201801;375;195;180;184350.95;171720.0;356070.97
130100;201801;1106;515;591;491310.0;563527.8;1054837.8
130110;201801;702;315;387;300360.0;369198.0;669558.0
130115;201801;173;69;104;65826.0;99216.0;165042.0
130120;201801;1619;1009;610;962586.0;581940.0;1544526.0
130130;201801;610;416;194;396864.0;185076.0;581940.0
130140;201801;1533;1153;380;1099299.0;361566.2;1460865.2
130150;201801;427;361;66;344394.0;62964.0;407358.0
130160;201801;468;261;207;248994.0;197478.0;446472.0
130165;201801;24;17;7;16218.0;6678.0;22896.0
130170;201801;943;667;276;636247.4;263304.0;899551.4
130180;201801;151;91;60;86337.0;57240.0;143577.0
130185;201801;2230;1159;1071;1103757.9;1021142.94;2124900.8
130190;201801;3609;2261;1348;2152766.8;1284404.0;3437170.8
130195;201801;291;233;58;222282.0;55332.0;277614.0
130200;201801;178;81;97;77264.46;92538.0;169802.45
130210;201801;77;37;40;35298.0;38160.0;73458.0
130220;201801;187;128;59;122112.0;56286.0;178398.0
130230;201801;335;211;124;201294.0;118296.0;319590.0
130240;201801;1463;918;545;874432.4;519352.84;1393785.2
130250;201801;4694;3027;1667;2882221.0;1590165.5;4472386.5
130255;201801;425;209;216;199386.0;205777.8;405163.8
130260;201801;53013;25317;27696;2,41E+14;2,64E+14;5,05E+14
130270;201801;1490;956;534;911547.0;509436.0;1420983.0
130280;201801;114;69;45;65826.0;42930.0;108756.0
130290;201801;2084;1509;575;1439586.0;548263.8;1987849.8
130300;201801;428;306;122;291637.8;116388.0;408025.8
130310;201801;892;474;418;452196.0;398772.0;850968.0
130320;201801;443;236;207;224190.0;197478.0;421668.0
130330;201801;704;428;276;408312.0;263017.8;671329.8
130340;201801;3233;1957;1276;1862399.2;1215873.2;3078272.5
130350;201801;477;301;176;287132.12;167904.0;455036.12
130353;201801;776;320;456;304994.0;435024.0;740018.0
130356;201801;755;344;411;328176.0;391807.8;719983.8
130360;201801;69;40;29;38160.0;27666.0;65826.0
130370;201801;680;499;181;476046.0;172674.0;648720.0
130380;201801;631;433;198;413082.0;188892.0;601974.0
130390;201801;485;390;95;372060.0;90630.0;462690.0
130395;201801;182;41;141;39114.0;134514.0;173628.0
130400;201801;68;46;22;43884.0;20988.0;64872.0
130406;201801;2085;1315;770;1250896.2;733655.75;1984552.0
130410;201801;502;215;287;205110.0;273778.9;478888.9
130420;201801;3184;2555;629;2433683.2;600066.0;3033749.2
130423;201801;163;76;87;72504.0;82998.0;155502.0
130426;201801;141;83;58;79182.0;55332.0;134514.0
130430;201801;407;268;139;255672.0;132606.0;388278.0
130440;201801;198;71;127;67734.0;121158.0;188892.0
140002;201801;36;14;22;13356.0;20988.0;34344.0
140005;201801;203;123;80;117103.5;76320.0;193423.5
140010;201801;10241;6920;3321;6568984.0;3165413.8;9734398.0
140015;201801;154;69;85;65826.0;81090.0;146916.0
140017;201801;110;76;34;72504.0;32436.0;104940.0
140020;201801;476;323;153;307188.0;145962.0;453150.0
140023;201801;25;16;9;15045.0;8586.0;23631.0
140028;201801;17;12;5;11448.0;4770.0;16218.0
140030;201801;359;255;104;243270.0;98614.98;341884.97
140040;201801;55;38;17;36252.0;16122.6;52374.6
140045;201801;246;115;131;109042.2;124974.0;234016.2
140047;201801;556;370;186;350968.38;176681.0;527649.4
140050;201801;151;99;52;93633.0;49608.0;143241.0
140060;201801;34;23;11;21207.42;10494.0;31701.42
140070;201801;32;29;3;27666.0;2862.0;30528.0
150010;201801;4709;2914;1795;2777237.5;1710311.1;4487548.5
150013;201801;146;99;47;94446.0;44838.0;139284.0
150020;201801;1077;571;506;544734.0;482724.0;1027458.0
150030;201801;739;301;438;287154.0;417852.0;705006.0
150034;201801;191;119;72;113526.0;68688.0;182214.0
150040;201801;1389;822;567;784188.0;540918.0;1325106.0
150050;201801;702;414;288;393954.8;274552.0;668506.8
150060;201801;4725;3064;1661;2919488.8;1584165.1;4503654.0
150070;201801;315;146;169;139284.0;161226.0;300510.0
150080;201801;14562;7323;7239;6975922.5;6897791.5;1,39E+14
150085;201801;371;233;138;222272.45;131652.0;353924.47
150090;201801;760;647;113;617238.0;107802.0;725040.0
150095;201801;345;209;136;198616.12;128923.56;327539.7
150100;201801;55;39;16;37206.0;15264.0;52470.0
150110;201801;169;82;87;78228.0;82998.0;161226.0
150120;201801;436;324;112;309096.0;106848.0;415944.0
150125;201801;54;23;31;21942.0;29574.0;51516.0
150130;201801;1901;1011;890;964494.0;849055.25;1813549.2
150140;201801;54649;25438;29211;2,42E+14;2,79E+13;5,21E+14
150145;201801;176;102;74;97308.0;70596.0;167904.0
150150;201801;2822;1257;1565;1198960.5;1489065.6;2688026.0
150157;201801;436;302;134;288108.0;127831.23;415939.22
150160;201801;123;99;24;94446.0;22896.0;117342.0
150170;201801;3672;2718;954;2589633.0;909829.8;3499462.8
150172;201801;317;217;100;207018.0;95400.0;302418.0
150175;201801;90;56;34;53424.0;32436.0;85860.0
150178;201801;750;498;252;475092.0;240408.0;715500.0
150180;201801;3034;1453;1581;1385351.6;1507964.0;2893315.5
150190;201801;336;215;121;205110.0;115434.0;320544.0
150195;201801;119;58;61;55332.0;58194.0;113526.0
150200;201801;208;98;110;93492.0;104940.0;198432.0
150210;201801;3163;2561;602;2442135.8;574065.5;3016201.2
150215;201801;501;331;170;315774.0;162180.0;477954.0
150220;201801;3929;2654;1275;2530356.8;1214232.4;3744589.0
150230;201801;1139;914;225;871376.06;214650.0;1086026.0
150240;201801;5767;3367;2400;3208676.8;2289591.0;5498267.5
150250;201801;33;16;17;15264.0;16218.0;31482.0
150260;201801;72;43;29;41022.0;27666.0;68688.0
150270;201801;2338;1531;807;1459282.4;769019.8;2228302.0
150275;201801;578;352;226;335808.0;215604.0;551412.0
150276;201801;103;45;58;42930.0;55332.0;98262.0
150277;201801;752;327;425;311939.47;405450.0;717389.44
150280;201801;342;211;131;201294.0;124974.0;326268.0
150285;201801;74;37;37;35298.0;35298.0;70596.0
150290;201801;961;589;372;561610.25;354602.0;916212.25
150293;201801;681;314;367;299228.9;350118.0;649346.94
150295;201801;460;204;256;194616.0;244071.44;438687.44
150300;201801;80;41;39;39114.0;37206.0;76320.0
150304;201801;139;91;48;86814.0;45792.0;132606.0
150307;201801;398;329;69;313866.0;65826.0;379692.0
150309;201801;550;396;154;377784.0;146916.0;524700.0
150310;201801;253;171;82;163134.0;78228.0;241362.0
150320;201801;1802;1242;560;1184586.6;534240.0;1718826.6
150330;201801;2070;1191;879;1135546.2;838566.0;1974112.2
150340;201801;198;132;66;125689.5;62964.0;188653.5
150345;201801;602;326;276;310822.75;263304.0;574126.75
150350;201801;417;323;94;305747.47;89676.0;395423.47
150360;201801;4466;2854;1612;2719048.2;1537828.9;4256877.0
150370;201801;755;540;215;514364.0;204814.8;719178.8
150375;201801;192;101;91;96354.0;86814.0;183168.0
150380;201801;1280;849;431;809946.0;410888.0;1220834.0
150390;201801;742;421;321;401634.0;306225.0;707859.0
150400;201801;99;82;17;78228.0;16218.0;94446.0
150405;201801;1257;831;426;792017.5;405831.6;1197849.1
150410;201801;140;90;50;85840.92;47700.0;133540.92
150420;201801;7393;4040;3353;3852501.5;3196812.5;7049314.0
150430;201801;487;328;159;312912.0;151686.0;464598.0
150440;201801;594;349;245;332183.0;233730.0;565913.0
150442;201801;2120;1124;996;1070636.0;949893.0;2020529.1
150445;201801;522;326;196;311004.0;186030.0;497034.0
150450;201801;272;127;145;121158.0;138330.0;259488.0
150460;201801;767;581;186;552447.06;177424.92;729872.0
150470;201801;1343;806;537;768638.0;512298.0;1280936.0
150475;201801;37;26;11;24804.0;10494.0;35298.0
150480;201801;1244;866;378;826164.0;360325.8;1186489.8
150490;201801;617;335;282;319590.0;269028.0;588618.0
150495;201801;328;228;100;217512.0;95400.0;312912.0
150497;201801;297;202;95;192708.0;90620.46;283328.47
150500;201801;428;288;140;274752.0;133560.0;408312.0
150503;201801;853;405;448;386084.0;427374.0;813458.0
150506;201801;1030;668;362;637272.0;345338.47;982610.44
150510;201801;1236;695;541;662744.0;516114.0;1178858.0
150520;201801;271;181;90;172674.0;85860.0;258534.0
150530;201801;1574;849;725;806798.3;690409.8;1497208.1
150540;201801;240;167;73;159318.0;69642.0;228960.0
150543;201801;693;390;303;371468.53;288775.8;660244.3
150548;201801;500;346;154;330084.0;146916.0;477000.0
150549;201801;60;40;20;38160.0;19080.0;57240.0
150550;201801;2897;1513;1384;1442449.0;1319818.0;2762267.0
150553;201801;3047;1810;1237;1725214.6;1180088.5;2905303.0
150555;201801;142;74;68;70596.0;64872.0;135468.0
150560;201801;54;41;13;39114.0;12402.0;51516.0
150563;201801;72;39;33;37206.0;31482.0;68688.0
150565;201801;169;101;68;96354.0;64872.0;161226.0
150570;201801;402;268;134;255652.92;127836.0;383488.9
150580;201801;1510;637;873;607030.2;832842.0;1439872.2
150590;201801;778;475;303;453150.0;289062.0;742212.0
150600;201801;460;274;186;261396.0;177444.0;438840.0
150610;201801;145;125;20;118401.0;19080.0;137481.0
150611;201801;129;90;39;85860.0;37206.0;123066.0
150613;201801;3151;1927;1224;1838358.0;1167687.0;3006045.0
150616;201801;485;300;185;285962.0;176490.0;462452.0
150618;201801;1136;627;509;597929.56;485586.0;1083515.6
150619;201801;393;300;93;286200.0;88722.0;374922.0
150620;201801;1277;740;537;705960.0;512011.8;1217971.8
150630;201801;315;212;103;202248.0;98262.0;300510.0
150635;201801;495;207;288;197478.0;274752.0;472230.0
150640;201801;62;30;32;28620.0;30528.0;59148.0
150650;201801;2321;1347;974;1285000.4;928905.0;2213905.2
150655;201801;248;185;63;176490.0;60102.0;236592.0
150658;201801;104;59;45;56286.0;42930.0;99216.0
150660;201801;482;336;146;320544.0;139284.0;459828.0
150670;201801;993;359;634;342190.8;604817.44;947008.25
150680;201801;9868;5375;4493;5120478.5;4283986.5;9404465.0
150690;201801;53;34;19;32436.0;18126.0;50562.0
150700;201801;543;349;194;332755.2;185076.0;517831.2
150710;201801;272;163;109;155502.0;103986.0;259488.0
150715;201801;872;530;342;504637.9;326239.38;830877.3
150720;201801;443;338;105;322452.0;99883.8;422335.8
150730;201801;907;482;425;459819.0;405163.8;864982.8
150740;201801;233;163;70;155502.0;66780.0;222282.0
150745;201801;768;411;357;392094.0;340578.0;732672.0
150746;201801;53;32;21;30528.0;20034.0;50562.0
150747;201801;269;208;61;198432.0;58194.0;256626.0
150750;201801;130;75;55;71550.0;52470.0;124020.0
150760;201801;1707;1105;602;1054170.0;574308.0;1628478.0
150770;201801;367;190;177;181260.0;168682.95;349942.94
150775;201801;90;40;50;38160.0;47700.0;85860.0
150780;201801;187;100;87;95400.0;82998.0;178398.0
150790;201801;896;488;408;465552.0;389232.0;854784.0
150795;201801;1435;835;600;796590.0;572400.0;1368990.0
150796;201801;403;231;172;220374.0;164088.0;384462.0
150797;201801;282;156;126;148824.0;120204.0;269028.0
150800;201801;1419;854;565;813757.25;539010.0;1352767.2
150803;201801;599;494;105;471276.0;100170.0;571446.0
150805;201801;188;119;69;113526.0;65812.46;179338.45
150808;201801;980;534;446;509436.0;425484.0;934920.0
150810;201801;3361;2315;1046;2205067.0;997312.0;3202379.0
150812;201801;428;223;205;212742.0;195570.0;408312.0
150815;201801;968;637;331;606319.5;315774.0;922093.5
150820;201801;1571;962;609;916793.5;580966.94;1497760.4
150830;201801;833;585;248;557136.0;236592.0;793728.0
150835;201801;189;111;78;105894.0;74412.0;180306.0
150840;201801;1306;829;477;790866.0;455058.0;1245924.0
160005;201801;53;31;22;29574.0;20988.0;50562.0
160010;201801;194;119;75;113526.0;71546.0;185072.0
160015;201801;119;68;51;64872.0;48654.0;113526.0
160020;201801;128;73;55;69642.0;52470.0;122112.0
160021;201801;41;21;20;20034.0;19080.0;39114.0
160023;201801;110;63;47;60102.0;44838.0;104940.0
160025;201801;33;14;19;13356.0;18126.0;31482.0
160027;201801;1441;822;619;780658.7;589772.0;1370430.8
160030;201801;15530;7963;7567;7587245.0;7214175.5;1,48E+13
160040;201801;316;180;136;171720.0;129744.0;301464.0
160050;201801;653;339;314;323406.0;299269.8;622675.8
160053;201801;322;184;138;175250.0;131652.0;306902.0
160055;201801;23;18;5;17172.0;4770.0;21942.0
160060;201801;6329;3299;3030;3136870.0;2889662.2;6026532.0
160070;201801;165;101;64;96354.0;61056.0;157410.0
160080;201801;80;40;40;38160.0;38160.0;76320.0
170025;201801;23;15;8;14310.0;7632.0;21942.0
170030;201801;225;180;45;171523.0;42930.0;214453.0
170035;201801;227;111;116;104940.0;110664.0;215604.0
170040;201801;191;147;44;139951.8;41976.0;181927.8
170070;201801;325;192;133;183168.0;126882.0;310050.0
170100;201801;375;268;107;255672.0;102078.0;357750.0
170105;201801;61;50;11;47700.0;10494.0;58194.0
170110;201801;103;63;40;60102.0;38160.0;98262.0
170130;201801;73;34;39;32436.0;36920.0;69356.0
170190;201801;105;66;39;62964.0;37206.0;100170.0
170200;201801;391;261;130;248317.2;123915.76;372232.97
170210;201801;6005;3105;2900;2954742.5;2763338.8;5718081.5
170215;201801;88;44;44;41976.0;41976.0;83952.0
170220;201801;1426;1046;380;995689.8;362234.0;1357923.8
170230;201801;154;99;55;94446.0;52470.0;146916.0
170240;201801;553;366;187;349164.0;178398.0;527562.0
170255;201801;1111;888;223;846942.1;212455.8;1059397.9
170270;201801;38;29;9;27666.0;8395.2;36061.2
170290;201801;75;56;19;53424.0;18126.0;71550.0
170300;201801;80;53;27;49798.8;25758.0;75556.8
170305;201801;41;33;8;31482.0;7632.0;39114.0
170307;201801;63;46;17;43884.0;16218.0;60102.0
170310;201801;102;56;46;53424.0;43884.0;97308.0
170320;201801;17;13;4;12402.0;3816.0;16218.0
170330;201801;19;16;3;15264.0;2862.0;18126.0
170360;201801;25;15;10;14310.0;9540.0;23850.0
170370;201801;122;65;57;62010.0;54378.0;116388.0
170380;201801;80;57;23;54378.0;21942.0;76320.0
170382;201801;47;42;5;40068.0;4770.0;44838.0
170384;201801;127;92;35;87768.0;33390.0;121158.0
170386;201801;62;28;34;26712.0;32436.0;59148.0
170388;201801;47;16;31;15264.0;29574.0;44838.0
170389;201801;24;18;6;17172.0;5724.0;22896.0
170390;201801;51;30;21;28620.0;20034.0;48654.0
170410;201801;33;22;11;20988.0;10494.0;31482.0
170460;201801;17;12;5;11448.0;4770.0;16218.0
170510;201801;27;20;7;19080.0;6678.0;25758.0
170550;201801;1478;837;641;798498.0;610751.0;1409249.0
170555;201801;109;75;34;71550.0;32436.0;103986.0
170560;201801;97;70;27;66780.0;25758.0;92538.0
170600;201801;39;19;20;18126.0;19080.0;37206.0
170610;201801;191;100;91;95242.59;86796.0;182038.6
170625;201801;38;19;19;18126.0;18126.0;36252.0
170650;201801;85;63;22;60102.0;20988.0;81090.0
170700;201801;556;418;138;397246.3;131652.0;528898.3
170710;201801;154;94;60;89676.0;57231.0;146907.0
170720;201801;84;68;16;64872.0;15264.0;80136.0
170730;201801;59;35;24;33390.0;22896.0;56286.0
170740;201801;76;57;19;54378.0;18126.0;72504.0
170755;201801;71;37;34;34678.0;32436.0;67114.0
170765;201801;143;69;74;65206.0;70596.0;135802.0
170770;201801;228;129;99;121968.9;94446.0;216414.9
170820;201801;594;389;205;371106.0;195141.0;566247.0
170825;201801;30;19;11;18126.0;10494.0;28620.0
170830;201801;75;54;21;51325.2;20034.0;71359.2
170900;201801;201;152;49;145008.0;46746.0;191754.0
170930;201801;806;416;390;396540.0;371488.0;768028.0
170950;201801;3031;1322;1709;1258833.0;1626838.5;2885671.5
170980;201801;17;9;8;8586.0;7632.0;16218.0
171050;201801;131;100;31;95400.0;29574.0;124974.0
171070;201801;35;28;7;26712.0;6678.0;33390.0
171090;201801;37;27;10;25758.0;9540.0;35298.0
171110;201801;21;14;7;13356.0;6678.0;20034.0
171150;201801;39;18;21;17172.0;20034.0;37206.0
171180;201801;22;10;12;9540.0;11448.0;20988.0
171190;201801;134;79;55;75366.0;52470.0;127836.0
171195;201801;63;49;14;46746.0;13356.0;60102.0
171200;201801;46;19;27;18126.0;25758.0;43884.0
171215;201801;2;2;0;1908.0;0.0;1908.0
171240;201801;54;44;10;41976.0;9540.0;51516.0
171245;201801;47;43;4;41022.0;3816.0;44838.0
171250;201801;71;37;34;35298.0;32426.46;67724.46
171270;201801;17;13;4;12402.0;3816.0;16218.0
171280;201801;38;35;3;33247.0;2862.0;36109.0
171320;201801;994;563;431;537102.0;410220.0;947322.0
171330;201801;427;203;224;193662.0;213696.0;407358.0
171360;201801;85;63;22;60102.0;20988.0;81090.0
171370;201801;24;13;11;12402.0;10494.0;22896.0
171380;201801;133;108;25;103032.0;23620.09;126652.09
171395;201801;55;33;22;31482.0;20988.0;52470.0
171420;201801;307;202;105;192708.0;99883.8;292591.8
171430;201801;63;50;13;47700.0;12402.0;60102.0
171488;201801;208;110;98;104940.0;93492.0;198432.0
171500;201801;59;32;27;30528.0;25758.0;56286.0
171510;201801;68;45;23;42930.0;21942.0;64872.0
171515;201801;43;37;6;35298.0;5724.0;41022.0
171525;201801;31;26;5;24804.0;4770.0;29574.0
171550;201801;13;7;6;6678.0;5724.0;12402.0
171570;201801;60;30;30;28620.0;28620.0;57240.0
171575;201801;341;209;132;199243.0;125918.46;325161.47
171610;201801;1692;845;847;804231.5;806461.56;1610693.1
171620;201801;132;90;42;85306.68;40068.0;125374.68
171630;201801;52;27;25;25758.0;23850.0;49608.0
171650;201801;275;179;96;170766.0;91584.0;262350.0
171660;201801;260;138;122;131652.0;116384.0;248036.0
171665;201801;46;30;16;28620.0;15264.0;43884.0
171670;201801;432;252;180;238345.95;171147.6;409493.56
171700;201801;64;56;8;53424.0;7632.0;61056.0
171720;201801;24;7;17;6678.0;16218.0;22896.0
171750;201801;102;55;47;52470.0;44838.0;97308.0
171780;201801;70;57;13;54378.0;12402.0;66780.0
171790;201801;80;66;14;62964.0;13356.0;76320.0
171800;201801;36;28;8;26712.0;7632.0;34344.0
171820;201801;2058;1163;895;1108793.8;849222.8;1958016.5
171830;201801;34;28;6;26712.0;5724.0;32436.0
171840;201801;61;34;27;32436.0;25758.0;58194.0
171845;201801;32;20;12;19080.0;11448.0;30528.0
171850;201801;38;26;12;24804.0;11448.0;36252.0
171855;201801;76;59;17;56286.0;16218.0;72504.0
171865;201801;8;7;1;6678.0;954.0;7632.0
171870;201801;30;22;8;20988.0;7632.0;28620.0
171875;201801;77;52;25;49608.0;23850.0;73458.0
171880;201801;26;19;7;18126.0;6678.0;24804.0
171884;201801;46;23;23;21942.0;21942.0;43884.0
171886;201801;115;40;75;38160.0;71263.8;109423.8
171888;201801;24;18;6;17172.0;5724.0;22896.0
171889;201801;19;15;4;14310.0;3816.0;18126.0
171890;201801;56;46;10;43884.0;9540.0;53424.0
171900;201801;43;30;13;28620.0;12402.0;41022.0
172000;201801;41;35;6;33390.0;5724.0;39114.0
172010;201801;39;32;7;29717.1;6678.0;36395.1
172015;201801;26;16;10;15264.0;9253.8;24517.8
172020;201801;127;79;48;75366.0;45792.0;121158.0
172025;201801;32;21;11;20034.0;10494.0;30528.0
172030;201801;36;20;16;19080.0;15264.0;34344.0
172049;201801;74;44;30;41976.0;28620.0;70596.0
172065;201801;149;97;52;92538.0;49608.0;142146.0
172080;201801;90;64;26;59873.84;24804.0;84677.84
172085;201801;26;13;13;12402.0;12402.0;24804.0
172090;201801;402;304;98;290016.0;92729.0;382745.0
172093;201801;25;18;7;17172.0;6678.0;23850.0
172097;201801;16;8;8;7632.0;7346.0;14978.0
172100;201801;4661;2615;2046;2489717.8;1949415.0;4439133.0
172110;201801;82;54;28;51516.0;26712.0;78228.0
172120;201801;1725;1476;249;1401987.6;236438.4;1638426.0
172125;201801;2;2;0;1908.0;0.0;1908.0
172130;201801;16;13;3;12402.0;2862.0;15264.0
172208;201801;195;123;72;117342.0;68688.0;186030.0
172210;201801;444;211;233;201294.0;221996.0;423290.0
210005;201801;2930;1830;1100;1742767.2;1046540.0;2789307.2
210010;201801;195;98;97;93492.0;92538.0;186030.0
210015;201801;28;19;9;18126.0;8586.0;26712.0
210020;201801;347;177;170;168858.0;162180.0;331038.0
210030;201801;340;212;128;202248.0;122103.0;324351.0
210040;201801;156;120;36;114480.0;34344.0;148824.0
210043;201801;251;167;84;159318.0;80136.0;239454.0
210047;201801;619;312;307;297266.4;292868.47;590134.9
210050;201801;296;215;81;205110.0;77274.0;282384.0
210055;201801;41;31;10;29574.0;9540.0;39114.0
210060;201801;573;445;128;424530.0;122112.0;546642.0
210070;201801;415;304;111;290016.0;105894.0;395910.0
210080;201801;105;97;8;92538.0;7632.0;100170.0
210083;201801;310;130;180;124020.0;171720.0;295740.0
210087;201801;45;33;12;31482.0;11448.0;42930.0
210090;201801;492;338;154;322452.0;146916.0;469368.0
210095;201801;494;352;142;335798.47;135468.0;471266.47
210100;201801;685;516;169;491930.1;160272.02;652202.1
210110;201801;148;79;69;75366.0;65826.0;141192.0
210120;201801;5494;4106;1388;3909635.2;1322898.6;5232534.0
210125;201801;215;119;96;113526.0;91584.0;205110.0
210130;201801;556;285;271;270936.0;258514.92;529450.94
210135;201801;34;20;14;19080.0;13356.0;32436.0
210140;201801;4232;3314;918;3158362.8;875534.0;4033896.8
210150;201801;354;222;132;211788.0;125928.0;337716.0
210160;201801;3356;2811;545;2678834.8;519644.0;3198478.8
210170;201801;1132;877;255;836658.0;243270.0;1079928.0
210173;201801;119;98;21;93492.0;20034.0;113526.0
210177;201801;467;226;241;215604.0;229914.0;445518.0
210180;201801;32;18;14;17172.0;13356.0;30528.0
210190;201801;410;261;149;248994.0;142146.0;391140.0
210193;201801;1;1;0;954.0;0.0;954.0
210197;201801;81;54;27;51516.0;25758.0;77274.0
210200;201801;642;506;136;482724.0;129744.0;612468.0
210203;201801;264;176;88;167904.0;83952.0;251856.0
210207;201801;379;291;88;277614.0;83952.0;361566.0
210210;201801;771;699;72;666846.0;68688.0;735534.0
210215;201801;76;63;13;60102.0;12402.0;72504.0
210220;201801;397;324;73;309096.0;69355.8;378451.8
210230;201801;302;223;79;212742.0;75366.0;288108.0
210232;201801;1481;933;548;889796.0;522792.0;1412588.0
210235;201801;153;118;35;112382.0;33390.0;145772.0
210237;201801;46;25;21;23850.0;20034.0;43884.0
210240;201801;95;77;18;73458.0;17172.0;90630.0
210250;201801;181;143;38;136422.0;36252.0;172674.0
210255;201801;329;239;90;228006.0;85860.0;313866.0
210260;201801;428;261;167;248994.0;159318.0;408312.0
210270;201801;699;442;257;421668.0;245178.0;666846.0
210275;201801;42;33;9;31482.0;8586.0;40068.0
210280;201801;1022;650;372;617285.3;353552.5;970837.8
210290;201801;498;319;179;304326.0;170766.0;475092.0
210300;201801;6134;3566;2568;3397327.2;2448661.2;5845988.5
210310;201801;102;69;33;65826.0;31482.0;97308.0
210312;201801;128;79;49;75366.0;46746.0;122112.0
210315;201801;118;85;33;81090.0;31482.0;112572.0
210317;201801;123;88;35;83952.0;33390.0;117342.0
210320;201801;2389;1961;428;1869083.9;408312.0;2277395.8
210325;201801;131;88;43;82998.0;40736.0;123734.0
210330;201801;5615;2832;2783;2696896.0;2654972.5;5351868.5
210340;201801;1415;1007;408;959878.0;389161.06;1349039.1
210350;201801;606;493;113;470083.5;107802.0;577885.5
210355;201801;132;106;26;101124.0;24804.0;125928.0
210360;201801;2666;1660;1006;1580493.6;959438.0;2539931.5
210370;201801;1263;533;730;508482.0;695752.2;1204234.2
210375;201801;188;98;90;92949.0;85860.0;178809.0
210380;201801;728;542;186;517068.0;177444.0;694512.0
210390;201801;202;165;37;157410.0;35298.0;192708.0
210400;201801;405;338;67;322452.0;63918.0;386370.0
210405;201801;1000;658;342;627128.1;326268.0;953396.1
210407;201801;56;44;12;41976.0;11448.0;53424.0
210408;201801;63;56;7;53424.0;6678.0;60102.0
210409;201801;312;260;52;248040.0;49608.0;297648.0
210410;201801;436;338;98;322452.0;93483.0;415935.0
210420;201801;194;157;37;149778.0;35298.0;185076.0
210430;201801;34;26;8;24804.0;7632.0;32436.0
210440;201801;379;225;154;214650.0;146916.0;361566.0
210450;201801;145;107;38;102078.0;36252.0;138330.0
210455;201801;209;113;96;107802.0;91584.0;199386.0
210460;201801;346;216;130;206064.0;124020.0;330084.0
210462;201801;60;50;10;47700.0;9540.0;57240.0
210465;201801;176;125;51;119250.0;48654.0;167904.0
210467;201801;523;371;152;353934.0;145008.0;498942.0
210470;201801;46;34;12;32436.0;11448.0;43884.0
210480;201801;1303;914;389;871956.0;371106.0;1243062.0
210490;201801;226;135;91;128790.0;86814.0;215604.0
210500;201801;563;291;272;277614.0;259488.0;537102.0
210510;201801;554;428;126;408312.0;120204.0;528516.0
210515;201801;449;242;207;230868.0;197478.0;428346.0
210520;201801;400;347;53;330751.8;50562.0;381313.8
210530;201801;9338;5007;4331;4765383.5;4126609.8;8891993.0
210535;201801;132;94;38;89676.0;36252.0;125928.0
210540;201801;1537;918;619;874627.8;589095.0;1463722.8
210542;201801;1154;583;571;555800.4;544734.0;1100534.4
210545;201801;13;12;1;11448.0;954.0;12402.0
210547;201801;137;118;19;112572.0;18126.0;130698.0
210550;201801;746;519;227;493578.0;216558.0;710136.0
210560;201801;176;145;31;138330.0;29574.0;167904.0
210565;201801;30;21;9;20034.0;8586.0;28620.0
210570;201801;1367;1067;300;1017918.0;286200.0;1304118.0
210580;201801;104;90;14;85860.0;13356.0;99216.0
210590;201801;772;602;170;573544.8;162180.0;735724.8
210592;201801;31;27;4;25758.0;3816.0;29574.0
210594;201801;102;84;18;80136.0;17172.0;97308.0
210596;201801;83;70;13;66780.0;12402.0;79182.0
210598;201801;124;92;32;87768.0;30528.0;118296.0
210600;201801;339;285;54;271890.0;51516.0;323406.0
210610;201801;246;228;18;216558.0;17172.0;233730.0
210620;201801;47;28;19;26712.0;18126.0;44838.0
210630;201801;62;58;4;55332.0;3816.0;59148.0
210632;201801;1126;741;385;706914.0;366561.44;1073475.5
210635;201801;16;13;3;12402.0;2862.0;15264.0
210637;201801;106;74;32;70596.0;30528.0;101124.0
210640;201801;586;508;78;484632.0;74412.0;559044.0
210650;201801;406;325;81;309124.62;76320.0;385444.62
210660;201801;402;284;118;270269.0;112448.0;382717.0
210663;201801;17;10;7;9540.0;6678.0;16218.0
210667;201801;118;37;81;35298.0;77274.0;112572.0
210670;201801;270;238;32;226337.0;30528.0;256865.0
210675;201801;569;291;278;277614.0;265212.0;542826.0
210680;201801;215;135;80;128790.0;76320.0;205110.0
210690;201801;643;505;138;481770.0;131652.0;613422.0
210700;201801;193;140;53;133560.0;50562.0;184122.0
210710;201801;304;168;136;160028.77;129744.0;289772.78
210720;201801;123;102;21;97308.0;20034.0;117342.0
210725;201801;65;57;8;54378.0;7632.0;62010.0
210730;201801;23;18;5;17172.0;4770.0;21942.0
210735;201801;415;275;140;262350.0;133274.0;395624.0
210740;201801;542;458;84;436932.0;80136.0;517068.0
210745;201801;153;108;45;103032.0;42930.0;145962.0
210750;201801;2416;1080;1336;1028365.0;1274524.9;2302890.0
210760;201801;273;198;75;188892.0;71535.69;260427.69
210770;201801;397;306;91;291924.0;86527.8;378451.8
210780;201801;421;302;119;288108.0;113526.0;401634.0
210790;201801;182;140;42;133560.0;40068.0;173628.0
210800;201801;136;102;34;97308.0;32436.0;129744.0
210805;201801;42;38;4;36252.0;3816.0;40068.0
210810;201801;488;368;120;350404.2;114480.0;464884.2
210820;201801;2311;1818;493;1726256.5;470322.0;2196578.5
210825;201801;171;87;84;82998.0;80136.0;163134.0
210830;201801;810;485;325;461736.0;309096.0;770832.0
210840;201801;217;143;74;136422.0;70596.0;207018.0
210845;201801;251;156;95;148824.0;90630.0;239454.0
210850;201801;863;550;313;524700.0;298602.0;823302.0
210860;201801;4170;2125;2045;2026009.8;1950624.8;3976634.5
210870;201801;466;348;118;331992.0;112572.0;444564.0
210880;201801;56;38;18;36252.0;17172.0;53424.0
210890;201801;337;277;60;264258.0;57240.0;321498.0
210900;201801;566;368;198;351072.0;188892.0;539964.0
210905;201801;73;35;38;33390.0;36252.0;69642.0
210910;201801;1996;1461;535;1393076.2;510390.0;1903466.2
210920;201801;230;66;164;62964.0;156456.0;219420.0
210923;201801;79;55;24;52470.0;22896.0;75366.0
210927;201801;440;178;262;169812.0;249948.0;419760.0
210930;201801;58;45;13;42930.0;12402.0;55332.0
210940;201801;93;69;24;65826.0;22896.0;88722.0
210945;201801;195;88;107;83952.0;102078.0;186030.0
210950;201801;503;360;143;343440.0;136417.23;479857.22
210955;201801;75;49;26;46746.0;24804.0;71550.0
210960;201801;2464;1025;1439;976228.4;1372520.0;2348748.5
210970;201801;115;99;16;94446.0;15264.0;109710.0
210975;201801;88;79;9;75366.0;8586.0;83952.0
210980;201801;1248;528;720;503597.53;686594.0;1190191.5
210990;201801;4402;2711;1691;2585182.2;1613214.0;4198396.0
211000;201801;1379;1085;294;1034804.0;280190.0;1314994.0
211003;201801;918;626;292;597204.0;278559.0;875763.0
211010;201801;467;407;60;388278.0;57240.0;445518.0
211020;201801;1605;575;1030;548550.0;982400.56;1530950.6
211023;201801;26;22;4;20701.8;3816.0;24517.8
211027;201801;62;38;24;36252.0;22896.0;59148.0
211030;201801;384;255;129;243270.0;123066.0;366336.0
211040;201801;316;237;79;225812.0;75366.0;301178.0
211050;201801;1193;745;448;710730.0;427101.22;1137831.2
211060;201801;685;579;106;551125.8;101124.0;652249.8
211065;201801;24;20;4;19080.0;3816.0;22896.0
211070;201801;912;736;176;700532.75;167904.0;868436.75
211080;201801;90;86;4;82044.0;3816.0;85860.0
211085;201801;59;31;28;29288.0;26712.0;56000.0
211090;201801;94;76;18;72504.0;17172.0;89676.0
211100;201801;504;401;103;382554.0;98262.0;480816.0
211102;201801;263;173;90;165042.0;85860.0;250902.0
211105;201801;214;145;69;138330.0;65826.0;204156.0
211107;201801;136;77;59;73458.0;56286.0;129744.0
211110;201801;821;530;291;505048.0;277605.0;782653.0
211120;201801;5842;2429;3413;2312004.5;3254910.2;5566915.0
211125;201801;33;26;7;24804.0;6678.0;31482.0
211130;201801;46126;18909;27217;1,80E+14;2,60E+14;4,40E+14
211140;201801;432;363;69;345344.0;65826.0;411170.0
211150;201801;1254;785;469;748556.1;447136.0;1195692.1
211153;201801;167;97;70;92538.0;66780.0;159318.0
211157;201801;58;42;16;40068.0;15264.0;55332.0
211160;201801;707;586;121;558077.5;115434.0;673511.5
211163;201801;0;0;0;0.0;0.0;0.0
211167;201801;5;3;2;2862.0;1908.0;4770.0
211170;201801;443;307;136;292878.0;129744.0;422622.0
211172;201801;122;84;38;80136.0;36252.0;116388.0
211174;201801;285;163;122;155502.0;116388.0;271890.0
211176;201801;522;372;150;354888.0;143100.0;497988.0
211178;201801;98;62;36;59148.0;34344.0;93492.0
211180;201801;210;163;47;155502.0;44675.82;200177.81
211190;201801;63;58;5;55332.0;4770.0;60102.0
211195;201801;25;16;9;15264.0;8586.0;23850.0
211200;201801;157;134;23;127492.56;21942.0;149434.56
211210;201801;535;325;210;309382.2;200340.0;509722.2
211220;201801;3972;2223;1749;2112899.5;1661259.6;3774159.0
211223;201801;97;90;7;85678.74;6678.0;92356.74
211227;201801;69;47;22;44838.0;20988.0;65826.0
211230;201801;781;629;152;599922.9;144988.92;744911.8
211240;201801;420;313;107;298602.0;102078.0;400680.0
211245;201801;215;93;122;88722.0;116388.0;205110.0
211250;201801;1644;1398;246;1332521.5;234684.0;1567205.5
211260;201801;805;633;172;603882.0;164088.0;767970.0
211270;201801;2100;1633;467;1557882.0;444564.2;2002446.2
211280;201801;1824;1085;739;1033183.4;705006.0;1738189.4
211285;201801;211;119;92;113526.0;87768.0;201294.0
211290;201801;692;460;232;438649.2;221328.0;659977.2
211300;201801;808;617;191;588340.06;182214.0;770554.06
211400;201801;1609;898;711;856692.0;678294.0;1534986.0
220005;201801;18;17;1;16218.0;954.0;17172.0
220010;201801;89;68;21;64872.0;19747.8;84619.8
220020;201801;589;459;130;437281.84;124020.0;561301.8
220025;201801;106;102;4;97308.0;3816.0;101124.0
220027;201801;35;28;7;26712.0;6678.0;33390.0
220030;201801;95;77;18;73458.0;17172.0;90630.0
220040;201801;1109;822;287;782928.75;273798.0;1056726.8
220045;201801;39;28;11;26712.0;10494.0;37206.0
220050;201801;647;525;122;499838.97;116368.92;616207.9
220060;201801;173;147;26;140238.0;24804.0;165042.0
220070;201801;92;83;9;79182.0;8586.0;87768.0
220080;201801;9;8;1;7632.0;954.0;8586.0
220090;201801;33;27;6;25472.0;5724.0;31196.0
220095;201801;2;1;1;954.0;954.0;1908.0
220100;201801;28;24;4;22896.0;3816.0;26712.0
220105;201801;36;33;3;31482.0;2862.0;34344.0
220110;201801;207;191;16;181927.8;15264.0;197191.8
220115;201801;47;44;3;41976.0;2862.0;44838.0
220117;201801;19;18;1;17172.0;954.0;18126.0
220120;201801;1526;1049;477;1000117.3;455038.9;1455156.2
220130;201801;26;25;1;23850.0;954.0;24804.0
220140;201801;97;77;20;72504.0;19080.0;91584.0
220150;201801;450;319;131;304326.0;124974.0;429300.0
220155;201801;4;4;0;3816.0;0.0;3816.0
220157;201801;16;13;3;12402.0;2862.0;15264.0
220160;201801;73;63;10;60102.0;9540.0;69642.0
220170;201801;33;31;2;29574.0;1908.0;31482.0
220173;201801;7;7;0;6678.0;0.0;6678.0
220177;201801;5;5;0;4770.0;0.0;4770.0
220180;201801;67;66;1;62959.23;954.0;63913.23
220190;201801;1062;950;112;906300.0;106084.8;1012384.8
220191;201801;42;37;5;35298.0;4770.0;40068.0
220192;201801;60;57;3;54378.0;2862.0;57240.0
220194;201801;29;25;4;23850.0;3816.0;27666.0
220196;201801;103;85;18;81090.0;17172.0;98262.0
220198;201801;6;4;2;3816.0;1908.0;5724.0
220200;201801;431;349;82;333773.0;78228.0;412001.0
220202;201801;37;33;4;31482.0;3816.0;35298.0
220205;201801;39;34;5;32436.0;4770.0;37206.0
220207;201801;19;18;1;17172.0;954.0;18126.0
220208;201801;83;43;40;41022.0;38160.0;79182.0
220209;201801;32;29;3;27666.0;2862.0;30528.0
220210;201801;14;13;1;12402.0;954.0;13356.0
220211;201801;35;35;0;33390.0;0.0;33390.0
220213;201801;41;37;4;35298.0;3530.0;38828.0
220217;201801;36;28;8;26712.0;7632.0;34344.0
220220;201801;1997;1266;731;1204158.6;695971.94;1900130.6
220225;201801;16;9;7;8586.0;6678.0;15264.0
220230;201801;930;739;191;704557.6;181574.81;886132.44
220240;201801;143;131;12;124974.0;11448.0;136422.0
220245;201801;35;32;3;29538.84;2862.0;32400.84
220250;201801;106;94;12;89676.0;11448.0;101124.0
220253;201801;45;37;8;35298.0;7632.0;42930.0
220255;201801;28;25;3;23850.0;2862.0;26712.0
220260;201801;690;502;188;478908.0;179352.0;658260.0
220265;201801;15;11;4;10494.0;3816.0;14310.0
220270;201801;661;587;74;559272.94;70119.0;629391.94
220271;201801;47;39;8;37206.0;7632.0;44838.0
220272;201801;26;25;1;23850.0;954.0;24804.0
220273;201801;15;13;2;12402.0;1908.0;14310.0
220275;201801;53;42;11;40068.0;10494.0;50562.0
220277;201801;11;9;2;8586.0;1908.0;10494.0
220280;201801;12;10;2;9540.0;1908.0;11448.0
220285;201801;42;39;3;37206.0;2862.0;40068.0
220290;201801;1380;1178;202;1121284.0;192661.0;1313945.0
220300;201801;56;54;2;51516.0;1908.0;53424.0
220310;201801;312;264;48;251852.0;45783.0;297635.0
220320;201801;430;395;35;375400.0;33390.0;408790.0
220323;201801;0;0;0;0.0;0.0;0.0
220325;201801;14;9;5;8586.0;4770.0;13356.0
220327;201801;11;10;1;9540.0;954.0;10494.0
220330;201801;197;133;64;126882.0;61056.0;187938.0
220335;201801;140;123;17;117342.0;16218.0;133560.0
220340;201801;20;11;9;10494.0;8586.0;19080.0
220342;201801;56;47;9;44838.0;8586.0;53424.0
220345;201801;83;75;8;71550.0;7632.0;79182.0
220350;201801;428;377;51;357035.4;48654.0;405689.4
220360;201801;43;31;12;29574.0;11448.0;41022.0
220370;201801;1094;866;228;825210.0;217225.8;1042435.8
220375;201801;26;24;2;22896.0;1908.0;24804.0
220380;201801;32;25;7;23850.0;6678.0;30528.0
220385;201801;28;24;4;22896.0;3816.0;26712.0
220390;201801;2222;1264;958;1201965.9;912549.5;2114515.2
220400;201801;28;26;2;24804.0;1908.0;26712.0
220410;201801;14;13;1;12402.0;954.0;13356.0
220415;201801;12;11;1;10494.0;954.0;11448.0
220420;201801;124;103;21;98262.0;19747.8;118009.8
220430;201801;132;119;13;111857.8;12402.0;124259.8
220435;201801;22;16;6;15260.0;5724.0;20984.0
220440;201801;290;247;43;235638.0;41022.0;276660.0
220450;201801;328;168;160;159106.98;152640.0;311746.97
220455;201801;53;51;2;48654.0;1908.0;50562.0
220460;201801;17;17;0;15550.2;0.0;15550.2
220465;201801;109;69;40;65826.0;38160.0;103986.0
220470;201801;240;211;29;201294.0;27666.0;228960.0
220480;201801;71;60;11;57240.0;10494.0;67734.0
220490;201801;86;75;11;71550.0;10494.0;82044.0
220500;201801;96;83;13;79182.0;12402.0;91584.0
220510;201801;380;302;78;287345.0;74221.2;361566.2
220515;201801;21;17;4;16218.0;3816.0;20034.0
220520;201801;368;331;37;314214.0;35279.0;349493.0
220525;201801;25;17;8;16218.0;7632.0;23850.0
220527;201801;37;29;8;27666.0;6822.0;34488.0
220530;201801;33;12;21;11448.0;20034.0;31482.0
220535;201801;13;12;1;11448.0;954.0;12402.0
220540;201801;60;47;13;44838.0;12402.0;57240.0
220545;201801;62;40;22;38160.0;20988.0;59148.0
220550;201801;632;480;152;457156.8;145008.0;602164.8
220551;201801;26;19;7;18126.0;6678.0;24804.0
220552;201801;8;8;0;7632.0;0.0;7632.0
220553;201801;47;43;4;41022.0;3816.0;44838.0
220554;201801;13;8;5;7345.8;4770.0;12115.8
220555;201801;22;18;4;17172.0;3816.0;20988.0
220556;201801;56;52;4;49608.0;3816.0;53424.0
220557;201801;55;49;6;46746.0;5724.0;52470.0
220558;201801;7;2;5;1908.0;4770.0;6678.0
220559;201801;7;6;1;5724.0;954.0;6678.0
220560;201801;55;35;20;33199.2;19080.0;52279.2
220570;201801;791;468;323;444982.12;308142.0;753124.1
220580;201801;571;522;49;497988.0;46059.92;544047.94
220585;201801;6;5;1;4770.0;954.0;5724.0
220590;201801;14;14;0;13356.0;0.0;13356.0
220595;201801;59;44;15;41976.0;14310.0;56286.0
220600;201801;19;10;9;9540.0;8586.0;18126.0
220605;201801;21;20;1;19080.0;954.0;20034.0
220610;201801;60;51;9;48654.0;8586.0;57240.0
220620;201801;559;436;123;415705.5;117342.0;533047.5
220630;201801;7;5;2;4770.0;1908.0;6678.0
220635;201801;37;33;4;31482.0;3816.0;35298.0
220640;201801;98;77;21;73458.0;20034.0;93492.0
220650;201801;113;107;6;102078.0;5724.0;107802.0
220660;201801;28;23;5;21942.0;4770.0;26712.0
220665;201801;4;4;0;3816.0;0.0;3816.0
220667;201801;10;10;0;9540.0;0.0;9540.0
220669;201801;24;21;3;20034.0;2862.0;22896.0
220670;201801;71;55;16;52279.2;15264.0;67543.2
220672;201801;58;39;19;37206.0;18126.0;55332.0
220675;201801;34;26;8;24804.0;7632.0;32436.0
220680;201801;34;29;5;27666.0;4770.0;32436.0
220690;201801;48;45;3;42930.0;2862.0;45792.0
220695;201801;62;30;32;28620.0;30528.0;59148.0
220700;201801;1508;1156;352;1100982.8;335808.0;1436790.8
220710;201801;3;1;2;954.0;1908.0;2862.0
220720;201801;113;92;21;87529.5;19890.9;107420.4
220730;201801;19;18;1;17172.0;954.0;18126.0
220735;201801;3;1;2;954.0;1908.0;2862.0
220740;201801;42;39;3;37206.0;2862.0;40068.0
220750;201801;98;78;20;74412.0;19080.0;93492.0
220755;201801;14;14;0;13356.0;0.0;13356.0
220760;201801;50;47;3;44838.0;2862.0;47700.0
220770;201801;5754;2863;2891;2726092.8;2752163.5;5478256.0
220775;201801;28;14;14;13356.0;13356.0;26712.0
220777;201801;15;14;1;13356.0;954.0;14310.0
220779;201801;18;14;4;13356.0;3816.0;17172.0
220780;201801;872;743;129;708154.2;122780.0;830934.2
220785;201801;10;5;5;4770.0;4770.0;9540.0
220790;201801;1005;797;208;757936.0;198432.0;956368.0
220793;201801;13;13;0;12402.0;0.0;12402.0
220795;201801;22;21;1;20034.0;954.0;20988.0
220800;201801;3894;2968;926;2829829.2;882427.9;3712257.2
220810;201801;57;51;6;48654.0;5724.0;54378.0
220820;201801;238;216;22;206064.0;20988.0;227052.0
220830;201801;1155;980;175;934915.25;166931.0;1101846.2
220840;201801;2410;1588;822;1502459.8;782090.0;2284549.8
220850;201801;52;41;11;39114.0;10494.0;49608.0
220855;201801;14;9;5;8586.0;4770.0;13356.0
220860;201801;8;7;1;6678.0;954.0;7632.0
220865;201801;22;20;2;19080.0;1908.0;20988.0
220870;201801;56;54;2;51516.0;1908.0;53424.0
220880;201801;318;241;77;229246.2;73172.0;302418.2
220885;201801;45;39;6;37206.0;5724.0;42930.0
220887;201801;19;18;1;17172.0;954.0;18126.0
220890;201801;103;91;12;86814.0;11448.0;98262.0
220900;201801;46;26;20;24804.0;19080.0;43884.0
220910;201801;54;45;9;42930.0;8586.0;51516.0
220915;201801;10;9;1;8586.0;954.0;9540.0
220920;201801;35;32;3;30528.0;2862.0;33390.0
220930;201801;43;42;1;40068.0;954.0;41022.0
220935;201801;14;14;0;13356.0;0.0;13356.0
220937;201801;45;42;3;40068.0;2862.0;42930.0
220940;201801;49;45;4;42930.0;3816.0;46746.0
220945;201801;0;0;0;0.0;0.0;0.0
220950;201801;45;41;4;39114.0;3816.0;42930.0
220955;201801;32;29;3;27666.0;2862.0;30528.0
220960;201801;1;1;0;954.0;0.0;954.0
220965;201801;29;25;4;23850.0;3816.0;27666.0
220970;201801;46;39;7;37206.0;6678.0;43884.0
220975;201801;9;8;1;7632.0;954.0;8586.0
220980;201801;34;32;2;30528.0;1908.0;32436.0
220985;201801;62;56;6;53424.0;5724.0;59148.0
220987;201801;31;30;1;28620.0;954.0;29574.0
220990;201801;13;12;1;11448.0;954.0;12402.0
220995;201801;42;35;7;33390.0;6678.0;40068.0
220997;201801;38;32;6;30528.0;5724.0;36252.0
221000;201801;1115;1004;111;953747.6;105607.8;1059355.4
221005;201801;66;59;7;56286.0;6678.0;62964.0
221010;201801;15;12;3;11448.0;2862.0;14310.0
221020;201801;46;44;2;41976.0;1908.0;43884.0
221030;201801;28;22;6;20988.0;5724.0;26712.0
221035;201801;19;19;0;18126.0;0.0;18126.0
221037;201801;12;6;6;5724.0;5724.0;11448.0
221038;201801;24;22;2;20988.0;1908.0;22896.0
221039;201801;22;22;0;20988.0;0.0;20988.0
221040;201801;249;214;35;204156.0;33390.0;237546.0
221050;201801;230;194;36;185076.0;34344.0;219420.0
221060;201801;1705;1496;209;1425668.8;199386.0;1625054.8
221062;201801;29;28;1;26712.0;954.0;27666.0
221063;201801;14;10;4;9540.0;3816.0;13356.0
221065;201801;48;41;7;39114.0;6678.0;45792.0
221070;201801;142;122;20;116388.0;19080.0;135468.0
221080;201801;375;331;44;315774.0;41689.8;357463.8
221090;201801;37;36;1;34344.0;954.0;35298.0
221093;201801;57;38;19;36252.0;18126.0;54378.0
221095;201801;11;10;1;9540.0;954.0;10494.0
221097;201801;22;19;3;18126.0;2862.0;20988.0
221100;201801;24371;13967;10404;1,33E+14;9920707.0;2,32E+13
221110;201801;1022;747;275;712352.0;262350.0;974702.0
221120;201801;522;389;133;370820.0;126882.0;497702.0
221130;201801;924;751;173;715214.8;165042.0;880256.8
221135;201801;34;31;3;29574.0;2862.0;32436.0
221140;201801;39;31;8;29574.0;7632.0;37206.0
221150;201801;14;11;3;10494.0;2862.0;13356.0
221160;201801;10;10;0;9540.0;0.0;9540.0
221170;201801;13;13;0;12402.0;0.0;12402.0
230010;201801;160;149;11;142146.0;10494.0;152640.0
230015;201801;114;93;21;88722.0;20034.0;108756.0
230020;201801;1521;1300;221;1237625.0;209946.88;1447571.9
230030;201801;1602;1152;450;1093439.0;429300.0;1522739.0
230040;201801;197;173;24;164088.0;22896.0;186984.0
230050;201801;206;150;56;143100.0;53424.0;196524.0
230060;201801;145;119;26;112762.8;24804.0;137566.8
230070;201801;285;253;32;241362.0;30528.0;271890.0
230075;201801;791;691;100;657211.0;95113.8;752324.8
230080;201801;174;151;23;144054.0;21942.0;165996.0
230090;201801;92;62;30;58384.8;28620.0;87004.8
230100;201801;1929;1150;779;1094813.0;743166.0;1837979.0
230110;201801;2627;1679;948;1598127.4;903819.8;2501947.2
230120;201801;931;736;195;699760.25;186011.0;885771.25
230125;201801;137;112;25;106848.0;23850.0;130698.0
230130;201801;457;408;49;389232.0;46746.0;435978.0
230140;201801;203;175;28;166950.0;26712.0;193662.0
230150;201801;156;120;36;114480.0;34344.0;148824.0
230160;201801;901;783;118;746267.0;112572.0;858839.0
230170;201801;577;533;44;504668.7;41976.0;546644.7
230180;201801;80;75;5;71550.0;4770.0;76320.0
230185;201801;403;346;57;328718.84;54378.0;383096.84
230190;201801;2173;1755;418;1670004.5;398455.0;2068459.5
230195;201801;484;422;62;402588.0;59148.0;461736.0
230200;201801;366;319;47;303362.47;44838.0;348200.47
230205;201801;351;219;132;207156.33;125928.0;333084.34
230210;201801;1245;993;252;945995.3;239644.8;1185640.1
230220;201801;1380;963;417;917938.8;397818.0;1315756.8
230230;201801;893;786;107;748190.7;102078.0;850268.7
230240;201801;1617;1394;223;1327941.8;212742.0;1540683.8
230250;201801;1752;1441;311;1370703.1;296535.0;1667238.1
230260;201801;2913;1738;1175;1652859.1;1119977.8;2772836.8
230270;201801;1332;1071;261;1019134.4;247801.5;1266935.9
230280;201801;2665;1981;684;1884439.4;651868.2;2536307.8
230290;201801;395;359;36;335395.4;34344.0;369739.4
230300;201801;509;374;135;355536.72;128790.0;484326.72
230310;201801;419;313;106;298454.12;101124.0;399578.12
230320;201801;898;766;132;726780.6;125928.0;852708.6
230330;201801;297;240;57;228196.8;54188.0;282384.8
230340;201801;452;362;90;344395.0;85860.0;430255.0
230350;201801;3013;1891;1122;1803994.9;1067527.1;2871522.0
230360;201801;252;213;39;202292.0;37206.0;239498.0
230365;201801;132;105;27;99455.0;25758.0;125213.0
230370;201801;9628;4694;4934;4469313.5;4703150.0;9172464.0
230380;201801;460;397;63;378452.0;59148.6;437600.6
230390;201801;495;273;222;258638.94;211788.0;470426.94
230393;201801;269;224;45;212842.8;42930.0;255772.8
230395;201801;332;271;61;258286.0;58194.0;316480.0
230400;201801;600;476;124;452196.0;117799.92;569995.94
230410;201801;2593;1615;978;1535082.8;932726.0;2467808.8
230420;201801;5847;3809;2038;3615510.8;1939671.0;5555182.0
230423;201801;306;265;41;252810.0;39114.0;291924.0
230425;201801;341;284;57;270936.0;54378.0;325314.0
230426;201801;106;96;10;90858.96;9253.8;100112.76
230427;201801;78;75;3;71550.0;2862.0;74412.0
230428;201801;1334;689;645;657077.06;615330.0;1272407.0
230430;201801;439;354;85;337522.0;81090.0;418612.0
230435;201801;775;541;234;514572.22;221996.61;736568.8
230440;201801;83027;36557;46470;3,48E+14;4,43E+14;7,91E+14
230445;201801;267;182;85;173437.2;81090.0;254527.2
230450;201801;537;435;102;414990.0;97308.0;512298.0
230460;201801;58;48;10;45792.0;9540.0;55332.0
230465;201801;294;239;55;228006.0;52470.0;280476.0
230470;201801;1825;1416;409;1350864.0;389079.1;1739943.1
230480;201801;146;141;5;134227.8;4770.0;138997.8
230490;201801;279;226;53;215604.0;50562.0;266166.0
230495;201801;432;326;106;310150.0;101124.0;411274.0
230500;201801;938;706;232;671616.0;221319.0;892935.0
230510;201801;43;35;8;33390.0;7632.0;41022.0
230520;201801;387;305;82;290970.0;78228.0;369198.0
230523;201801;1969;1246;723;1187201.8;689294.0;1876495.8
230526;201801;290;241;49;229914.0;45955.0;275869.0
230530;201801;664;499;165;473033.6;156456.2;629489.8
230533;201801;181;173;8;165042.0;7632.0;172674.0
230535;201801;340;255;85;243270.0;81090.0;324360.0
230540;201801;1820;1596;224;1519941.0;213123.8;1733064.9
230550;201801;3601;2310;1291;2195510.0;1229992.2;3425502.2
230560;201801;577;442;135;419569.8;127836.0;547405.8
230565;201801;188;137;51;130698.0;48654.0;179352.0
230570;201801;303;269;34;256626.0;32436.0;289062.0
230580;201801;1095;807;288;768418.4;273511.8;1041930.2
230590;201801;937;725;212;687407.1;201771.0;889178.1
230600;201801;250;228;22;216768.06;20988.0;237756.06
230610;201801;333;267;66;254528.0;62964.0;317492.0
230620;201801;163;134;29;126882.0;27666.0;154548.0
230625;201801;715;514;201;488973.5;190600.69;679574.2
230630;201801;1231;974;257;929196.0;244796.4;1173992.4
230640;201801;3439;2972;467;2828053.5;444759.56;3272813.0
230650;201801;391;341;50;324482.7;47700.0;372182.7
230655;201801;626;543;83;517068.8;79102.07;596170.9
230660;201801;331;275;56;262350.0;53137.8;315487.8
230670;201801;421;374;47;356796.0;44838.0;401634.0
230680;201801;200;184;16;175536.0;15264.0;190800.0
230690;201801;856;746;110;711684.0;104940.0;816624.0
230700;201801;694;588;106;560932.94;100551.6;661484.5
230710;201801;732;692;40;659978.0;38160.0;698138.0
230720;201801;145;122;23;115996.86;21942.0;137938.86
230725;201801;226;178;48;169812.0;45783.0;215595.0
230730;201801;11574;6274;5300;5968616.5;5048122.0;1,10E+14
230740;201801;656;525;131;500564.0;124283.46;624847.44
230750;201801;793;678;115;645620.3;109710.0;755330.3
230760;201801;1289;1117;172;1061571.2;164088.0;1225659.2
230763;201801;320;264;56;249900.95;53424.0;303324.94
230765;201801;6769;3172;3597;3020376.8;3429532.0;6449908.5
230770;201801;4957;2549;2408;2421895.5;2294525.5;4716421.0
230780;201801;672;591;81;560674.1;77259.69;637933.8
230790;201801;189;154;35;146916.0;32589.4;179505.4
230800;201801;1104;806;298;768900.1;284292.0;1053192.1
230810;201801;1264;1127;137;1074156.2;130507.2;1204663.5
230820;201801;327;236;91;224191.0;86814.0;311005.0
230830;201801;930;806;124;765410.44;118296.0;883706.44
230835;201801;276;237;39;225144.0;36491.0;261635.0
230837;201801;164;138;26;131652.0;24804.0;156456.0
230840;201801;888;709;179;675146.5;169526.0;844672.5
230850;201801;1469;1282;187;1222741.8;178112.0;1400853.8
230860;201801;302;224;78;213696.0;73458.5;287154.5
230870;201801;1786;1516;270;1445310.0;256244.8;1701554.8
230880;201801;33;25;8;23850.0;7632.0;31482.0
230890;201801;565;518;47;494049.8;44824.0;538873.8
230900;201801;269;205;64;195570.0;60859.0;256429.0
230910;201801;198;161;37;152830.8;35298.0;188128.8
230920;201801;395;312;83;297648.0;79182.0;376830.0
230930;201801;913;646;267;613422.6;254718.0;868140.6
230940;201801;820;658;162;627732.0;154358.0;782090.0
230945;201801;459;383;76;365192.0;72504.0;437696.0
230950;201801;377;321;56;306234.0;53424.0;359658.0
230960;201801;2476;1676;800;1592176.9;762914.0;2355090.8
230970;201801;1726;976;750;930193.9;714622.3;1644816.2
230980;201801;210;179;31;170766.0;29574.0;200340.0
230990;201801;138;110;28;104940.0;25955.47;130895.47
231000;201801;207;187;20;176490.0;19080.0;195570.0
231010;201801;132;104;28;98643.6;26712.0;125355.6
231020;201801;1261;877;384;835037.0;366336.0;1201373.0
231025;201801;939;703;236;668498.2;223598.8;892097.0
231030;201801;1142;958;184;913928.0;175250.0;1089178.0
231040;201801;138;94;44;88931.88;41245.0;130176.88
231050;201801;978;871;107;829169.9;102078.0;931247.9
231060;201801;139;123;16;117342.0;15264.0;132606.0
231070;201801;1405;992;413;945223.3;394002.0;1339225.2
231080;201801;261;243;18;231011.1;17172.0;248183.1
231085;201801;540;339;201;322453.0;191754.0;514207.0
231090;201801;236;195;41;186030.0;39114.0;225144.0
231095;201801;163;129;34;123066.0;32436.0;155502.0
231100;201801;122;102;20;97308.0;17839.8;115147.8
231110;201801;342;296;46;281675.0;43884.0;325559.0
231120;201801;296;255;41;242311.86;38924.0;281235.88
231123;201801;131;125;6;119250.0;5724.0;124974.0
231126;201801;275;238;37;227052.0;35298.0;262350.0
231130;201801;4545;3530;1015;3357712.5;967251.25;4324964.0
231135;201801;198;171;27;163134.0;24492.4;187626.4
231140;201801;3030;2236;794;2129476.0;756483.8;2885959.8
231150;201801;349;334;15;318636.0;14310.0;332946.0
231160;201801;1203;941;262;894661.7;249719.05;1144380.8
231170;201801;535;352;183;335808.0;174582.0;510390.0
231180;201801;1589;1342;247;1279504.8;235638.0;1515142.8
231190;201801;199;177;22;168858.0;20988.0;189846.0
231195;201801;213;184;29;174812.0;27666.0;202478.0
231200;201801;820;676;144;644904.0;136116.0;781020.0
231210;201801;601;499;102;475092.8;97308.0;572400.8
231220;201801;1019;740;279;704987.94;266166.0;971153.94
231230;201801;1375;1103;272;1051060.0;258724.8;1309784.9
231240;201801;1352;981;371;935587.8;352694.2;1288282.0
231250;201801;110;102;8;97308.0;7632.0;104940.0
231260;201801;291;187;104;178398.0;98930.0;277328.0
231270;201801;990;830;160;786590.7;152640.0;939230.7
231280;201801;55;43;12;41022.0;11448.0;52470.0
231290;201801;7138;3965;3173;3773702.8;3024640.2;6798343.0
231300;201801;620;572;48;545688.0;45792.0;591480.0
231310;201801;691;641;50;610297.0;47700.0;657997.0
231320;201801;556;432;124;411652.0;118296.0;529948.0
231325;201801;88;78;10;74412.0;9540.0;83952.0
231330;201801;2002;1547;455;1469832.6;431114.6;1900947.2
231335;201801;242;214;28;204156.0;26712.0;230868.0
231340;201801;1580;1159;421;1103970.1;401348.0;1505318.1
231350;201801;1136;928;208;885312.0;197860.0;1083172.0
231355;201801;389;335;54;319590.0;51516.0;371106.0
231360;201801;468;372;96;352178.2;91584.0;443762.2
231370;201801;88;72;16;68688.0;15264.0;83952.0
231375;201801;283;204;79;194616.0;75366.0;269982.0
231380;201801;443;359;84;340890.7;79945.2;420835.88
231390;201801;195;160;35;152640.0;33390.0;186030.0
231395;201801;721;439;282;417508.56;268909.4;686417.94
231400;201801;1045;865;180;822638.8;171377.38;994016.25
231410;201801;1286;1037;249;984673.4;236593.0;1221266.4
240010;201801;386;180;206;170568.27;196515.0;367083.25
240020;201801;2179;1696;483;1616190.9;460778.0;2076968.9
240030;201801;138;117;21;111618.0;20034.0;131652.0
240040;201801;32;32;0;30528.0;0.0;30528.0
240050;201801;505;433;72;412228.44;68688.0;480916.44
240060;201801;67;63;4;60102.0;3816.0;63918.0
240070;201801;174;134;40;127836.0;38160.0;165996.0
240080;201801;430;286;144;272840.0;137376.0;410216.0
240090;201801;103;92;11;87462.72;10494.0;97956.72
240100;201801;1428;1344;84;1279203.5;79945.2;1359148.8
240110;201801;961;604;357;575244.25;340578.0;915822.25
240120;201801;139;117;22;111618.0;20988.0;132606.0
240130;201801;286;268;18;254955.55;17172.0;272127.53
240140;201801;79;62;17;59148.0;16218.0;75366.0
240145;201801;673;593;80;565197.3;76110.12;641307.44
240150;201801;20;15;5;14310.0;4755.69;19065.69
240160;201801;44;38;6;36252.0;5724.0;41976.0
240165;201801;34;28;6;26474.0;5724.0;32198.0
240170;201801;92;71;21;67734.0;20034.0;87768.0
240180;201801;77;63;14;60102.0;13356.0;73458.0
240185;201801;42;38;4;36242.46;3816.0;40058.46
240190;201801;14;12;2;11448.0;1908.0;13356.0
240200;201801;2986;1688;1298;1604181.6;1237053.0;2841234.8
240210;201801;161;127;34;121158.0;32436.0;153594.0
240220;201801;1103;791;312;754471.0;297638.47;1052109.5
240230;201801;816;756;60;718390.06;56592.0;774982.06
240240;201801;117;84;33;80136.0;31482.0;111618.0
240250;201801;92;81;11;77274.0;10494.0;87768.0
240260;201801;1781;1320;461;1258593.1;438811.38;1697404.5
240270;201801;190;168;22;159890.4;20988.0;180878.4
240280;201801;43;33;10;31482.0;9540.0;41022.0
240290;201801;51;49;2;46746.0;1908.0;48654.0
240300;201801;180;99;81;94446.0;77274.0;171720.0
240310;201801;1980;1082;898;1023362.4;853455.56;1876818.0
240320;201801;210;199;11;189846.0;10494.0;200340.0
240325;201801;4291;2625;1666;2497238.5;1587195.2;4084433.8
240330;201801;64;61;3;58194.0;2862.0;61056.0
240340;201801;101;72;29;68688.0;27666.0;96354.0
240350;201801;91;80;11;76320.0;10494.0;86814.0
240360;201801;373;268;105;255672.0;100170.0;355842.0
240370;201801;36;34;2;32436.0;1908.0;34344.0
240375;201801;72;41;31;39114.0;29574.0;68688.0
240380;201801;235;191;44;181300.0;41881.0;223181.0
240390;201801;15;13;2;12402.0;1908.0;14310.0
240400;201801;78;74;4;70596.0;3816.0;74412.0
240410;201801;10;6;4;5724.0;3816.0;9540.0
240420;201801;880;684;196;651135.5;185934.6;837070.1
240430;201801;264;249;15;235285.1;14310.0;249595.1
240440;201801;69;36;33;34344.0;31482.0;65826.0
240450;201801;206;138;68;131079.8;64872.0;195951.8
240460;201801;59;46;13;43884.0;12402.0;56286.0
240470;201801;234;203;31;193104.86;29574.0;222678.86
240480;201801;14;14;0;13260.6;0.0;13260.6
240485;201801;71;61;10;57908.0;9540.0;67448.0
240490;201801;44;44;0;41766.12;0.0;41766.12
240500;201801;83;66;17;62964.0;16218.0;79182.0
240510;201801;51;36;15;34344.0;14310.0;48654.0
240520;201801;125;119;6;113526.0;5724.0;119250.0
240530;201801;50;45;5;42930.0;4770.0;47700.0
240540;201801;76;65;11;62010.0;10494.0;72504.0
240550;201801;15;13;2;12402.0;1908.0;14310.0
240560;201801;369;273;96;259815.23;91584.0;351399.22
240570;201801;460;285;175;270752.34;166950.0;437702.34
240580;201801;1256;1016;240;963779.9;227802.2;1191582.1
240590;201801;30;28;2;26712.0;1908.0;28620.0
240600;201801;112;111;1;105894.0;954.0;106848.0
240610;201801;514;428;86;407955.7;81281.0;489236.7
240615;201801;22;21;1;20034.0;954.0;20988.0
240620;201801;95;91;4;85860.0;3816.0;89676.0
240630;201801;34;32;2;30528.0;1908.0;32436.0
240640;201801;27;23;4;21942.0;3816.0;25758.0
240650;201801;234;197;37;187079.9;35298.0;222377.9
240660;201801;97;84;13;80136.0;12402.0;92538.0
240670;201801;288;171;117;161035.3;111618.0;272653.3
240680;201801;48;37;11;35298.0;10494.0;45792.0
240690;201801;50;47;3;44838.0;2862.0;47700.0
240700;201801;190;158;32;150732.0;30528.0;181260.0
240710;201801;1905;1218;687;1161539.6;655388.44;1816928.0
240720;201801;1034;756;278;720260.7;265212.0;985472.7
240725;201801;66;63;3;60102.0;2862.0;62964.0
240730;201801;131;115;16;109710.0;15264.0;124974.0
240740;201801;241;204;37;193251.78;34308.02;227559.8
240750;201801;34;21;13;20034.0;12402.0;32436.0
240760;201801;32;28;4;26712.0;3816.0;30528.0
240770;201801;147;112;35;106848.0;33390.0;140238.0
240780;201801;694;579;115;550925.44;109710.0;660635.44
240790;201801;37;36;1;34344.0;954.0;35298.0
240800;201801;8514;5766;2748;5462102.0;2614382.2;8076484.5
240810;201801;19912;10934;8978;1,04E+14;8554709.0;1,89E+14
240820;201801;195;129;66;122392.03;62964.0;185356.03
240830;201801;1589;1302;287;1235583.1;272844.0;1508427.1
240840;201801;76;67;9;63918.0;8586.0;72504.0
240850;201801;84;73;11;69642.0;10494.0;80136.0
240860;201801;113;110;3;104940.0;2862.0;107802.0
240870;201801;56;49;7;46746.0;6678.0;53424.0
240880;201801;29;26;3;24794.46;2862.0;27656.46
240890;201801;1147;676;471;640995.2;449330.0;1090325.1
240895;201801;42;32;10;30528.0;9540.0;40068.0
240910;201801;153;138;15;131652.0;14310.0;145962.0
240920;201801;15;11;4;10494.0;3816.0;14310.0
240930;201801;376;340;36;323406.0;34344.0;357750.0
240933;201801;28;20;8;19080.0;7632.0;26712.0
240940;201801;2421;2139;282;2027041.5;266146.9;2293188.5
240950;201801;49;47;2;44838.0;1908.0;46746.0
240960;201801;32;25;7;23850.0;6678.0;30528.0
240970;201801;133;96;37;91584.0;34544.0;126128.0
240980;201801;188;151;37;144054.0;35298.0;179352.0
240990;201801;120;81;39;77274.0;37206.0;114480.0
241000;201801;72;66;6;62964.0;5724.0;68688.0
241010;201801;56;45;11;42930.0;10494.0;53424.0
241020;201801;114;107;7;102078.0;6678.0;108756.0
241025;201801;9;3;6;2862.0;5724.0;8586.0
241030;201801;120;98;22;93492.0;20988.0;114480.0
241040;201801;32;28;4;26712.0;3816.0;30528.0
241050;201801;90;78;12;74412.0;11448.0;85860.0
241060;201801;27;24;3;22896.0;2862.0;25758.0
241070;201801;15;15;0;14310.0;0.0;14310.0
241080;201801;65;57;8;54091.8;7632.0;61723.8
241090;201801;48;40;8;38160.0;7617.69;45777.69
241100;201801;74;65;9;62010.0;8586.0;70596.0
241105;201801;6;2;4;1908.0;3816.0;5724.0
241110;201801;49;47;2;44838.0;1908.0;46746.0
241120;201801;1419;1103;316;1049276.8;300700.8;1349977.6
241140;201801;224;182;42;172675.0;40068.0;212743.0
241142;201801;42;41;1;39114.0;954.0;40068.0
241150;201801;1206;1059;147;1007568.0;140238.0;1147806.0
241160;201801;23;22;1;20988.0;954.0;21942.0
241170;201801;42;39;3;37206.0;2862.0;40068.0
241180;201801;51;42;9;39893.42;8586.0;48479.42
241190;201801;38;37;1;35298.0;954.0;36252.0
241200;201801;3822;2093;1729;1992722.9;1647545.6;3640268.5
241210;201801;72;60;12;57240.0;10590.0;67830.0
241220;201801;1355;903;452;860939.06;431174.9;1292114.0
241230;201801;245;207;38;197287.2;36252.0;233539.2
241240;201801;52;40;12;38160.0;11448.0;49608.0
241250;201801;1069;994;75;947990.0;71264.0;1019254.0
241255;201801;47;38;9;36252.0;8586.0;44838.0
241260;201801;627;494;133;471271.22;126882.0;598153.25
241270;201801;46;32;14;30528.0;13356.0;43884.0
241280;201801;99;87;12;82998.0;11448.0;94446.0
241290;201801;109;81;28;77274.0;26712.0;103986.0
241300;201801;76;53;23;50562.0;21942.0;72504.0
241310;201801;51;38;13;36109.0;12402.0;48511.0
241320;201801;26;14;12;13356.0;11448.0;24804.0
241330;201801;60;54;6;51516.0;5724.0;57240.0
241335;201801;60;53;7;49989.6;6678.0;56667.6
241340;201801;188;142;46;135468.0;43884.0;179352.0
241350;201801;57;52;5;49608.0;4770.0;54378.0
241355;201801;41;38;3;36252.0;2862.0;39114.0
241360;201801;46;46;0;43884.0;0.0;43884.0
241370;201801;44;36;8;34219.98;7632.0;41851.98
241380;201801;40;38;2;36252.0;1908.0;38160.0
241390;201801;77;62;15;58957.2;14310.0;73267.2
241400;201801;188;155;33;147202.2;31482.0;178684.2
241410;201801;175;159;16;151686.0;15168.6;166854.6
241415;201801;93;74;19;70596.0;18126.0;88722.0
241420;201801;94;73;21;69642.0;19694.0;89336.0
241430;201801;28;27;1;25758.0;954.0;26712.0
241440;201801;451;384;67;366322.0;63918.0;430240.0
241445;201801;36;34;2;32436.0;1908.0;34344.0
241450;201801;274;224;50;213569.0;47700.0;261269.0
241460;201801;137;125;12;119012.0;11448.0;130460.0
241470;201801;44;37;7;35298.0;6678.0;41976.0
241475;201801;65;61;4;58194.0;3816.0;62010.0
241480;201801;97;70;27;65477.53;25758.0;91235.53
241490;201801;9;8;1;7632.0;954.0;8586.0
241500;201801;46;35;11;33390.0;10494.0;43884.0
250010;201801;100;87;13;82854.9;12402.0;95256.9
250020;201801;25;22;3;20988.0;2862.0;23850.0
250030;201801;808;594;214;565331.2;203107.6;768438.8
250040;201801;325;271;54;258534.0;51516.0;310050.0
250050;201801;224;185;39;175913.6;37206.0;213119.6
250053;201801;54;42;12;40068.0;11448.0;51516.0
250057;201801;0;0;0;0.0;0.0;0.0
250060;201801;446;341;105;325314.0;99883.8;425197.8
250070;201801;689;582;107;553210.0;102078.0;655288.0
250073;201801;7;7;0;6678.0;0.0;6678.0
250077;201801;205;152;53;144616.86;50562.0;195178.86
250080;201801;420;328;92;311291.2;87768.0;399059.2
250090;201801;201;135;66;127836.4;62944.92;190781.31
250100;201801;466;380;86;362520.0;81663.0;444183.0
250110;201801;486;368;118;349288.03;112572.0;461860.03
250115;201801;27;8;19;7632.0;18126.0;25758.0
250120;201801;111;84;27;80136.0;25758.0;105894.0
250130;201801;586;462;124;440748.0;118106.0;558854.0
250135;201801;14;8;6;7632.0;5724.0;13356.0
250140;201801;75;66;9;62964.0;8586.0;71550.0
250150;201801;562;415;147;393742.0;139923.19;533665.2
250153;201801;11;10;1;9540.0;954.0;10494.0
250157;201801;29;24;5;22896.0;4770.0;27666.0
250160;201801;209;164;45;156456.0;42930.0;199386.0
250170;201801;68;48;20;45792.0;19080.0;64872.0
250180;201801;3982;2678;1304;2540633.0;1238918.0;3779551.0
250190;201801;904;597;307;567868.5;292162.5;860031.0
250200;201801;51;43;8;41022.0;7632.0;48654.0
250205;201801;21;19;2;18126.0;1908.0;20034.0
250210;201801;90;78;12;74412.0;11448.0;85860.0
250215;201801;62;54;8;51516.0;7632.0;59148.0
250220;201801;27;21;6;20034.0;5724.0;25758.0
250230;201801;74;67;7;63914.0;6678.0;70592.0
250240;201801;244;203;41;192851.1;39114.0;231965.1
250250;201801;385;331;54;315774.0;51516.0;367290.0
250260;201801;31;26;5;24804.0;4770.0;29574.0
250270;201801;57;45;12;42930.0;11448.0;54378.0
250280;201801;384;322;62;307188.0;59148.0;366336.0
250290;201801;94;89;5;84619.8;4770.0;89389.8
250300;201801;553;379;174;360918.72;165983.0;526901.7
250310;201801;47;41;6;39114.0;5724.0;44838.0
250320;201801;1919;1316;603;1249051.1;573689.0;1822740.1
250330;201801;82;73;9;69642.0;8586.0;78228.0
250340;201801;25;21;4;20034.0;3816.0;23850.0
250350;201801;138;88;50;83665.8;47127.6;130793.4
250355;201801;28;23;5;21942.0;4770.0;26712.0
250360;201801;198;161;37;153594.0;35060.0;188654.0
250370;201801;2362;1601;761;1521442.8;724437.8;2245880.5
250375;201801;19;15;4;14310.0;3816.0;18126.0
250380;201801;52;36;16;34344.0;15264.0;49608.0
250390;201801;42;35;7;33390.0;6678.0;40068.0
250400;201801;15552;7876;7676;7488665.5;7315952.5;1,48E+14
250403;201801;420;341;79;325304.47;75366.0;400670.47
250407;201801;53;46;7;43884.0;6678.0;50562.0
250410;201801;28;23;5;21942.0;4770.0;26712.0
250415;201801;42;28;14;26712.0;13336.92;40048.92
250420;201801;46;38;8;36252.0;7632.0;43884.0
250430;201801;1656;1397;259;1330545.0;247086.0;1577631.0
250435;201801;15;12;3;11448.0;2862.0;14310.0
250440;201801;687;595;92;564937.4;87768.0;652705.4
250450;201801;87;73;14;69642.0;13356.0;82998.0
250460;201801;412;279;133;266166.0;126872.46;393038.47
250470;201801;88;65;23;62010.0;21942.0;83952.0
250480;201801;319;252;67;240408.0;63918.0;304326.0
250485;201801;2;1;1;954.0;954.0;1908.0
250490;201801;204;166;38;158364.0;36252.0;194616.0
250500;201801;74;54;20;51516.0;19080.0;70596.0
250510;201801;731;572;159;544352.6;150677.44;695030.0
250520;201801;174;121;53;115414.92;50557.23;165972.16
250523;201801;110;92;18;87768.0;17172.0;104940.0
250527;201801;104;80;24;76315.23;22896.0;99211.23
250530;201801;8;6;2;5724.0;1908.0;7632.0
250535;201801;25;21;4;20034.0;3816.0;23850.0
250540;201801;125;95;30;89914.5;28620.0;118534.5
250550;201801;69;66;3;62964.0;2862.0;65826.0
250560;201801;35;29;6;27666.0;5724.0;33390.0
250570;201801;153;122;31;116388.0;29574.0;145962.0
250580;201801;133;103;30;97975.8;28620.0;126595.8
250590;201801;20;16;4;15264.0;3816.0;19080.0
250600;201801;1320;896;424;851924.25;404400.6;1256324.9
250610;201801;153;132;21;125928.0;20034.0;145962.0
250620;201801;21;17;4;16218.0;3816.0;20034.0
250625;201801;59;45;14;42930.0;13356.0;56286.0
250630;201801;2997;1919;1078;1822678.9;1027344.75;2850023.5
250640;201801;203;168;35;160272.0;33390.0;193662.0
250650;201801;31;21;10;20034.0;9540.0;29574.0
250660;201801;42;32;10;30528.0;9540.0;40068.0
250670;201801;58;38;20;36252.0;19080.0;55332.0
250680;201801;386;316;70;301464.0;66780.0;368244.0
250690;201801;1809;1245;564;1184291.5;537674.8;1721966.4
250700;201801;954;839;115;795944.94;109500.12;905445.0
250710;201801;443;343;100;327222.0;95400.0;422622.0
250720;201801;102;80;22;76320.0;20988.0;97308.0
250730;201801;371;311;60;295740.6;57240.0;352980.6
250740;201801;51;47;4;44838.0;3816.0;48654.0
250750;201801;20151;12055;8096;1,14E+14;7714808.5;1,92E+13
250760;201801;68;51;17;48654.0;16218.0;64872.0
250770;201801;349;232;117;219386.14;110449.55;329835.7
250780;201801;58;45;13;42930.0;12402.0;55332.0
250790;201801;484;314;170;296694.9;161464.5;458159.4
250800;201801;150;139;11;131890.5;10494.0;142384.5
250810;201801;79;59;20;56286.0;19080.0;75366.0
250820;201801;158;127;31;121158.0;29574.0;150732.0
250830;201801;429;289;140;274704.5;133560.0;408264.5
250840;201801;53;51;2;48654.0;1908.0;50562.0
250850;201801;54;42;12;39381.12;11448.0;50829.12
250855;201801;13;11;2;10494.0;1908.0;12402.0
250860;201801;206;146;60;139284.0;56953.8;196237.8
250870;201801;32;29;3;27666.0;2862.0;30528.0
250880;201801;79;60;19;57182.76;18126.0;75308.76
250890;201801;2369;1749;620;1667210.4;590616.75;2257827.2
250900;201801;112;95;17;90630.0;16218.0;106848.0
250905;201801;128;99;29;94446.0;27666.0;122112.0
250910;201801;1173;835;338;795427.3;322165.8;1117593.1
250915;201801;111;76;35;72504.0;33390.0;105894.0
250920;201801;138;106;32;101124.0;30528.0;131652.0
250930;201801;160;100;60;95400.0;57240.0;152640.0
250933;201801;0;0;0;0.0;0.0;0.0
250937;201801;6;5;1;4770.0;954.0;5724.0
250939;201801;30;22;8;20988.0;7632.0;28620.0
250940;201801;104;78;26;74412.0;24804.0;99216.0
250950;201801;72;47;25;44838.0;23850.0;68688.0
250960;201801;93;51;42;48654.0;40068.0;88722.0
250970;201801;1206;859;347;817865.0;330751.8;1148616.8
250980;201801;90;63;27;60102.0;25758.0;85860.0
250990;201801;165;129;36;122622.39;34301.07;156923.45
251000;201801;72;66;6;62773.2;5724.0;68497.2
251010;201801;94;74;20;70592.0;18301.53;88893.53
251020;201801;81;70;11;65969.1;10494.0;76463.1
251030;201801;42;32;10;30528.0;9540.0;40068.0
251040;201801;54;39;15;37206.0;14310.0;51516.0
251050;201801;24;22;2;20988.0;1908.0;22896.0
251060;201801;50;40;10;37206.0;9540.0;46746.0
251065;201801;3;3;0;2862.0;0.0;2862.0
251070;201801;25;20;5;19071.0;4770.0;23841.0
251080;201801;4697;2279;2418;2161900.2;2300219.0;4462119.5
251090;201801;196;168;28;160272.0;26712.0;186984.0
251100;201801;19;18;1;17172.0;954.0;18126.0
251110;201801;46;36;10;34344.0;9540.0;43884.0
251120;201801;1766;1056;710;1002514.2;677340.0;1679854.2
251130;201801;353;286;67;272844.0;63918.0;336762.0
251140;201801;506;329;177;312722.8;168689.34;481412.12
251150;201801;289;251;38;238682.0;36252.0;274934.0
251160;201801;92;77;15;73454.0;14310.0;87764.0
251170;201801;98;79;19;75337.38;18121.23;93458.61
251180;201801;290;183;107;174573.23;102069.23;276642.47
251190;201801;192;131;61;124645.83;58194.0;182839.83
251200;201801;256;207;49;197478.0;46746.0;244224.0
251203;201801;33;31;2;29574.0;1908.0;31482.0
251207;201801;93;77;16;73458.0;15264.0;88722.0
251210;201801;1256;897;359;854184.5;342104.4;1196288.9
251220;201801;45;34;11;32436.0;10494.0;42930.0
251230;201801;471;394;77;375876.0;73458.0;449334.0
251240;201801;100;72;28;67734.0;26712.0;94446.0
251250;201801;1326;950;376;903273.9;358561.0;1261834.9
251260;201801;13;8;5;7632.0;4770.0;12402.0
251270;201801;343;253;90;241362.0;85717.0;327079.0
251272;201801;67;61;6;58194.0;5724.0;63918.0
251274;201801;28;23;5;21942.0;4770.0;26712.0
251275;201801;22;15;7;14310.0;6678.0;20988.0
251276;201801;18;14;4;13356.0;3816.0;17172.0
251278;201801;9;7;2;6678.0;1908.0;8586.0
251280;201801;95;91;4;86814.0;3816.0;90630.0
251290;201801;696;527;169;502758.0;161226.0;663984.0
251300;201801;17;15;2;14310.0;1908.0;16218.0
251310;201801;361;260;101;248036.0;96354.0;344390.0
251315;201801;18;17;1;16218.0;954.0;17172.0
251320;201801;60;49;11;46746.0;10494.0;57240.0
251330;201801;79;70;9;66780.0;8586.0;75366.0
251335;201801;10;6;4;5724.0;3816.0;9540.0
251340;201801;688;406;282;387324.0;268003.25;655327.25
251350;201801;34;32;2;30528.0;1908.0;32436.0
251360;201801;65;57;8;54171.94;7632.0;61803.94
251365;201801;14;14;0;13356.0;0.0;13356.0
251370;201801;5257;3573;1684;3404066.2;1605202.0;5009268.5
251380;201801;49;39;10;37206.0;9540.0;46746.0
251385;201801;2;2;0;1908.0;0.0;1908.0
251390;201801;660;526;134;500660.2;126596.0;627256.2
251392;201801;31;21;10;20034.0;9540.0;29574.0
251394;201801;9;9;0;8586.0;0.0;8586.0
251396;201801;20;15;5;14310.0;4770.0;19080.0
251398;201801;17;15;2;14310.0;1908.0;16218.0
251400;201801;38;31;7;29574.0;6678.0;36252.0
251410;201801;35;30;5;28620.0;4770.0;33390.0
251420;201801;108;81;27;77274.0;25758.0;103032.0
251430;201801;38;36;2;34344.0;1908.0;36252.0
251440;201801;35;22;13;20988.0;12402.0;33390.0
251445;201801;52;47;5;44838.0;4770.0;49608.0
251450;201801;417;368;49;349416.8;46746.0;396162.8
251455;201801;2;1;1;954.0;954.0;1908.0
251460;201801;17;13;4;12402.0;3816.0;16218.0
251465;201801;5;2;3;1908.0;2862.0;4770.0
251470;201801;45;36;9;34344.0;8586.0;42930.0
251480;201801;24;22;2;20988.0;1908.0;22896.0
251490;201801;129;91;38;86337.0;35299.0;121636.0
251500;201801;116;94;22;89676.0;20225.0;109901.0
251510;201801;34;26;8;24804.0;7632.0;32436.0
251520;201801;25;25;0;23850.0;0.0;23850.0
251530;201801;4529;3173;1356;3021028.2;1293328.2;4314356.5
251540;201801;73;65;8;62010.0;7632.0;69642.0
251550;201801;411;318;93;302418.2;88198.0;390616.2
251560;201801;21;16;5;15264.0;4770.0;20034.0
251570;201801;18;18;0;17172.0;0.0;17172.0
251580;201801;119;97;22;92538.0;20988.0;113526.0
251590;201801;128;94;34;89676.0;32436.0;122112.0
251593;201801;18;10;8;9540.0;7632.0;17172.0
251597;201801;60;50;10;47700.0;9540.0;57240.0
251600;201801;1104;786;318;748543.25;301763.9;1050307.2
251610;201801;210;158;52;150064.2;48941.0;199005.2
251615;201801;2;2;0;1908.0;0.0;1908.0
251620;201801;4239;2839;1400;2698283.0;1332835.2;4031118.2
251630;201801;448;329;119;313866.0;113230.8;427096.8
251640;201801;149;107;42;102078.0;40068.0;142146.0
251650;201801;263;191;72;180381.1;68688.0;249069.1
251660;201801;218;200;18;189846.1;16981.2;206827.3
251670;201801;360;283;77;268286.0;73458.0;341744.0
251675;201801;3;3;0;2862.0;0.0;2862.0
251680;201801;88;80;8;76320.0;7632.0;83952.0
251690;201801;337;283;54;269028.0;51165.89;320193.88
251700;201801;282;235;47;223603.3;44823.69;268426.97
251710;201801;19;12;7;11448.0;6678.0;18126.0
251720;201801;33;22;11;20988.0;10208.0;31196.0
251740;201801;10;8;2;7632.0;1908.0;9540.0
260005;201801;3098;1762;1336;1670516.8;1273377.1;2943894.0
260010;201801;1417;1015;402;964589.56;381505.3;1346094.9
260020;201801;430;377;53;359658.0;50562.0;410220.0
260030;201801;571;412;159;392280.97;151686.0;543967.0
260040;201801;856;519;337;494038.44;321345.38;815383.8
260050;201801;1119;800;319;762962.0;303754.0;1066716.0
260060;201801;410;372;38;354124.8;36252.0;390376.8
260070;201801;1442;901;541;855451.0;514098.38;1369549.4
260080;201801;724;574;150;546642.1;143100.0;689742.1
260090;201801;569;353;216;336534.12;206064.0;542598.1
260100;201801;225;155;70;146869.2;66780.0;213649.2
260105;201801;234;131;103;124974.0;98262.0;223236.0
260110;201801;2724;2032;692;1938509.5;659358.0;2597867.5
260120;201801;2903;1466;1437;1388846.0;1368610.1;2757456.0
260130;201801;148;101;47;96354.0;44838.0;141192.0
260140;201801;2086;1370;716;1298490.0;681519.44;1980009.4
260150;201801;228;149;79;142146.0;75366.0;217512.0
260160;201801;293;253;40;241362.0;38160.0;279522.0
260170;201801;3332;2033;1299;1933390.6;1238148.9;3171539.5
260180;201801;135;115;20;109710.0;19080.0;128790.0
260190;201801;2251;1607;644;1529927.9;614376.0;2144304.0
260200;201801;891;736;155;701369.06;147584.0;848953.06
260210;201801;1404;989;415;943355.25;394661.12;1338016.4
260220;201801;713;654;59;623127.0;56286.0;679413.0
260230;201801;1190;901;289;857363.0;275706.0;1133069.0
260240;201801;216;163;53;154328.58;50562.0;204890.58
260250;201801;71;56;15;53424.0;14310.0;67734.0
260260;201801;987;708;279;675432.0;266166.0;941598.0
260270;201801;432;351;81;333471.2;76987.8;410459.0
260280;201801;1239;860;379;819866.6;361280.0;1181146.6
260290;201801;6338;3360;2978;3186636.2;2834283.0;6020919.5
260300;201801;835;734;101;698167.6;96068.0;794235.6
260310;201801;499;397;102;377359.47;97308.0;474667.47
260320;201801;876;662;214;631261.2;204156.0;835417.2
260330;201801;32;27;5;25758.0;4770.0;30528.0
260340;201801;66;48;18;45792.0;17172.0;62964.0
260345;201801;5598;3140;2458;2989097.5;2343645.5;5332743.0
260350;201801;465;340;125;322616.1;118297.0;440913.1
260360;201801;280;141;139;134514.0;132606.0;267120.0
260370;201801;643;419;224;397116.4;213556.0;610672.4
260380;201801;601;431;170;411174.0;161035.56;572209.56
260390;201801;292;250;42;237421.98;39114.0;276535.97
260392;201801;93;81;12;77274.0;11448.0;88722.0
260400;201801;4077;2337;1740;2219068.2;1659598.2;3878666.5
260410;201801;14169;7674;6495;7306244.5;6193499.0;1,35E+14
260415;201801;123;111;12;105894.0;11448.0;117342.0
260420;201801;1765;1046;719;992368.2;684129.6;1676497.9
260430;201801;191;174;17;164784.66;16218.0;181002.66
260440;201801;230;167;63;158594.0;60102.0;218696.0
260450;201801;477;345;132;327845.0;125928.0;453773.0
260460;201801;856;457;399;433308.8;380641.22;813950.0
260470;201801;373;229;144;217702.8;136184.1;353886.9
260480;201801;203;126;77;120204.0;73458.0;193662.0
260490;201801;206;166;40;158364.0;38160.0;196524.0
260500;201801;1121;749;372;712258.2;353791.8;1066050.0
260510;201801;731;581;150;554274.0;142146.0;696420.0
260515;201801;258;230;28;219420.0;26235.0;245655.0
260520;201801;3284;1946;1338;1848081.9;1274535.9;3122617.8
260530;201801;772;623;149;591522.6;142146.0;733668.6
260540;201801;573;430;143;410220.0;135468.72;545688.75
260545;201801;14;10;4;9540.0;3816.0;13356.0
260550;201801;341;212;129;202248.0;123066.0;325314.0
260560;201801;514;387;127;368607.0;120871.8;489478.8
260570;201801;1007;831;176;789769.8;167617.8;957387.6
260580;201801;269;241;28;229914.0;26712.0;256626.0
260590;201801;651;369;282;350614.1;269028.0;619642.06
260600;201801;8186;4157;4029;3942312.8;3840417.8;7782730.5
260610;201801;493;328;165;312912.0;157123.8;470035.8
260620;201801;3611;1876;1735;1778014.8;1650197.8;3428212.5
260630;201801;70;67;3;63918.0;2862.0;66780.0
260640;201801;3619;1974;1645;1879877.6;1568959.0;3448836.5
260650;201801;337;232;105;221328.0;100127.07;321455.06
260660;201801;492;335;157;319208.4;149157.9;468366.3
260670;201801;101;76;25;72504.0;23850.0;96354.0
260680;201801;3673;2041;1632;1929276.8;1555897.8;3485174.5
260690;201801;121;93;28;88722.0;26712.0;115434.0
260700;201801;326;199;127;189082.8;120324.0;309406.8
260710;201801;36;33;3;31482.0;2862.0;34344.0
260720;201801;2200;1323;877;1256254.5;835580.0;2091834.4
260730;201801;586;442;144;421668.0;135181.8;556849.8
260740;201801;61;57;4;54378.0;3816.0;58194.0
260750;201801;638;444;194;423251.62;185076.0;608327.6
260760;201801;623;343;280;327222.0;266803.0;594025.0
260765;201801;993;521;472;494091.8;450049.5;944141.3
260770;201801;223;167;56;159318.0;53424.0;212742.0
260775;201801;814;482;332;458445.8;316719.0;775164.8
260780;201801;271;173;98;165042.0;93358.44;258400.44
260790;201801;12419;6801;5618;6459320.5;5352289.0;1,18E+13
260795;201801;157;108;49;101868.12;46746.0;148614.12
260800;201801;284;233;51;221805.0;48654.0;270459.0
260805;201801;177;114;63;108027.14;60102.0;168129.14
260810;201801;739;643;96;612172.25;91584.0;703756.25
260820;201801;315;211;104;199964.8;99216.0;299180.78
260825;201801;207;142;65;135090.98;62010.0;197100.98
260830;201801;262;168;94;160128.9;89676.0;249804.9
260840;201801;229;166;63;157697.0;59816.0;217513.0
260845;201801;210;147;63;139951.8;60102.0;200053.8
260850;201801;506;368;138;349408.1;131652.0;481060.1
260860;201801;254;190;64;181062.34;61056.0;242118.34
260870;201801;366;259;107;247086.0;102078.0;349164.0
260875;201801;690;482;208;458714.7;198432.0;657146.7
260880;201801;1553;949;604;903387.06;576025.2;1479412.2
260890;201801;2429;1695;734;1610589.4;699283.0;2309872.2
260900;201801;1030;701;329;667451.8;313866.0;981317.8
260910;201801;278;217;61;207018.0;58194.0;265212.0
260915;201801;306;203;103;193662.0;98142.0;291804.0
260920;201801;173;98;75;93492.0;71550.0;165042.0
260930;201801;389;333;56;317682.0;53324.14;371006.12
260940;201801;2746;1503;1243;1429380.9;1185097.9;2614478.8
260950;201801;1970;1145;825;1085023.9;787050.0;1872073.9
260960;201801;14200;7375;6825;6999887.5;6503575.5;1,35E+14
260970;201801;435;373;62;355842.0;59148.0;414990.0
260980;201801;197;173;24;164756.0;22896.0;187652.0
260990;201801;2551;2103;448;2005756.4;426724.2;2432480.5
261000;201801;4311;2547;1764;2416605.8;1681244.5;4097850.2
261010;201801;189;138;51;131652.0;47836.23;179488.23
261020;201801;603;449;154;428203.0;146105.1;574308.1
261030;201801;219;161;58;153594.0;55126.89;208720.89
261040;201801;360;324;36;309096.0;33771.8;342867.8
261050;201801;467;412;55;393048.0;52470.0;445518.0
261060;201801;1315;864;451;822110.75;430254.0;1252364.8
261070;201801;9008;4613;4395;4376327.0;4184934.5;8561261.0
261080;201801;384;295;89;280658.0;84906.0;365564.0
261090;201801;2207;1694;513;1607496.0;488630.0;2096126.0
261100;201801;1086;770;316;732243.6;299594.16;1031837.75
261110;201801;8036;4927;3109;4695408.5;2963695.8;7659104.5
261120;201801;278;230;48;219420.0;45787.23;265207.22
261130;201801;573;331;242;315440.9;230868.0;546308.9
261140;201801;188;119;69;113526.0;65826.0;179352.0
261150;201801;659;387;272;369198.0;258820.2;628018.2
261153;201801;74;71;3;66780.31;2862.0;69642.31
261160;201801;76620;38820;37800;3,69E+13;3,60E+14;7,29E+14
261170;201801;451;337;114;320582.38;108756.0;429338.38
261180;201801;1767;1079;688;1023823.9;656352.0;1680175.9
261190;201801;616;425;191;405053.9;182205.0;587258.94
261200;201801;212;187;25;177680.3;23850.0;201530.3
261210;201801;36;32;4;30528.0;3816.0;34344.0
261220;201801;2500;1767;733;1679851.0;698137.8;2377988.8
261230;201801;318;238;80;227052.0;76305.69;303357.7
261240;201801;443;384;59;362322.94;56286.0;418608.94
261245;201801;222;186;36;177444.0;34344.0;211788.0
261247;201801;151;113;38;107802.0;36252.0;144054.0
261250;201801;2848;1435;1413;1368417.8;1346891.9;2715309.8
261255;201801;253;231;22;220374.0;20988.0;241362.0
261260;201801;848;729;119;695466.0;113526.0;808992.0
261270;201801;173;134;39;127836.0;37206.0;165042.0
261280;201801;157;128;29;122112.0;27666.0;149778.0
261290;201801;129;90;39;85621.5;37206.0;122827.5
261300;201801;1236;874;362;833796.0;345348.0;1179144.0
261310;201801;757;508;249;484632.0;236925.9;721557.9
261320;201801;539;367;172;350118.0;164088.0;514206.0
261330;201801;814;647;167;614239.5;158472.45;772711.94
261340;201801;309;173;136;165042.0;129744.0;294786.0
261350;201801;784;562;222;535194.2;211788.0;746982.2
261360;201801;1200;772;428;736086.4;408312.0;1144398.4
261370;201801;4954;3041;1913;2886141.8;1821782.9;4707924.5
261380;201801;572;420;152;398781.62;144722.0;543503.6
261390;201801;3412;2283;1129;2173202.8;1073205.2;3246408.2
261400;201801;276;251;25;238881.6;23850.0;262731.6
261410;201801;1053;697;356;664938.0;339619.22;1004557.25
261420;201801;877;543;334;517041.47;318617.47;835658.94
261430;201801;328;298;30;283446.0;28333.8;311779.8
261440;201801;106;95;11;90630.0;10494.0;101124.0
261450;201801;2489;2067;422;1969448.2;401577.03;2371025.2
261460;201801;714;568;146;540918.0;139284.0;680202.0
261470;201801;245;188;57;178542.0;54378.0;232920.0
261480;201801;344;283;61;268743.0;58190.0;326933.0
261485;201801;338;205;133;194902.2;126882.0;321784.2
261500;201801;632;425;207;405450.0;197478.0;602928.0
261510;201801;40;28;12;26712.0;11448.0;38160.0
261520;201801;155;140;15;133560.0;14310.0;147870.0
261530;201801;4166;2635;1531;2505593.0;1459320.8;3964913.8
261540;201801;1075;662;413;631084.4;394002.0;1025086.4
261550;201801;285;140;145;132178.0;138310.92;270488.9
261560;201801;782;522;260;494746.2;246751.6;741497.8
261570;201801;364;285;79;271890.0;75366.0;347256.0
261580;201801;372;291;81;276850.0;77274.0;354124.0
261590;201801;191;154;37;146916.0;35298.0;182214.0
261600;201801;288;230;58;218657.0;54855.0;273512.0
261610;201801;104;89;15;84551.69;14310.0;98861.69
261618;201801;64;50;14;47700.0;13356.0;61056.0
261620;201801;203;122;81;116388.0;77274.0;193662.0
261630;201801;589;452;137;428847.6;130698.0;559545.6
261640;201801;6281;3342;2939;3179953.0;2800955.0;5980908.0
261650;201801;474;295;179;280752.66;170766.0;451518.66
270010;201801;521;457;64;435692.0;60293.0;495985.0
270020;201801;302;239;63;228002.0;60102.0;288104.0
270030;201801;9113;5810;3303;5529171.0;3148610.0;8677781.0
270040;201801;1930;1180;750;1125138.0;713973.6;1839111.6
270050;201801;175;128;47;122112.0;44838.0;166950.0
270060;201801;118;65;53;62010.0;50562.0;112572.0
270070;201801;905;657;248;624763.1;236287.27;861050.4
270080;201801;40;34;6;32436.0;5724.0;38160.0
270090;201801;20;16;4;15264.0;3816.0;19080.0
270100;201801;1260;826;434;784843.3;411889.7;1196733.0
270110;201801;154;114;40;108756.0;38160.0;146916.0
270120;201801;223;182;41;172776.55;39031.2;211807.75
270130;201801;261;182;79;173341.8;75079.8;248421.6
270135;201801;96;59;37;56286.0;35298.0;91584.0
270140;201801;1265;762;503;726755.25;478613.0;1205368.2
270150;201801;265;213;52;203202.0;49608.0;252810.0
270160;201801;513;380;133;362520.0;126214.2;488734.2
270170;201801;702;449;253;427201.2;240551.1;667752.3
270180;201801;72;55;17;52152.04;16008.12;68160.16
270190;201801;103;90;13;85860.0;12402.0;98262.0
270200;201801;107;96;11;91393.2;10494.0;101887.2
270210;201801;482;246;236;234684.0;224857.8;459541.8
270220;201801;189;149;40;142146.0;38160.0;180306.0
270230;201801;2078;1240;838;1177926.8;796596.2;1974522.9
270235;201801;740;553;187;527253.44;178032.95;705286.4
270240;201801;3086;2382;704;2260817.0;668537.8;2929354.8
270250;201801;172;120;52;114480.0;49608.0;164088.0
270255;201801;222;192;30;183168.0;28238.4;211406.4
270260;201801;322;256;66;244224.0;62964.0;307188.0
270270;201801;115;48;67;45783.0;63918.0;109701.0
270280;201801;210;131;79;124974.0;75366.0;200340.0
270290;201801;1165;871;294;829856.75;279589.9;1109446.8
270300;201801;265;166;99;158364.0;94159.8;252523.8
270310;201801;923;737;186;700859.8;176720.05;877579.9
270320;201801;887;754;133;718248.8;126595.8;844844.6
270330;201801;268;223;45;211788.0;42930.0;254718.0
270340;201801;60;47;13;44838.0;12402.0;57240.0
270350;201801;93;48;45;45267.3;42930.0;88197.3
270360;201801;72;38;34;36252.0;32436.0;68688.0
270370;201801;52;39;13;37206.0;12402.0;49608.0
270375;201801;62;33;29;31482.0;27662.0;59144.0
270380;201801;1080;605;475;576216.0;453150.0;1029366.0
270390;201801;196;105;91;100170.0;86814.0;186984.0
270400;201801;704;510;194;485325.28;185067.0;670392.25
270410;201801;698;496;202;472667.53;192698.45;665366.0
270420;201801;398;259;139;245388.0;132521.38;377909.38
270430;201801;31987;22778;9209;2,17E+14;8776679.0;3,05E+14
270440;201801;493;384;109;365525.1;103699.8;469224.9
270450;201801;764;397;367;378499.5;348878.66;727378.2
270460;201801;197;148;49;141192.0;46746.0;187938.0
270470;201801;1341;886;455;844890.7;434070.0;1278960.8
270480;201801;527;423;104;400461.88;98500.5;498962.38
270490;201801;25;21;4;20034.0;3816.0;23850.0
270500;201801;512;420;92;400680.0;87768.0;488448.0
270510;201801;734;450;284;429300.0;270936.0;700236.0
270520;201801;387;235;152;223837.9;145008.0;368845.9
270530;201801;64;56;8;53424.0;7632.0;61056.0
270540;201801;124;95;29;90630.0;27666.0;118296.0
270550;201801;1713;1298;415;1237015.2;395905.22;1632920.5
270560;201801;315;143;172;136422.0;164088.0;300510.0
270570;201801;446;294;152;279648.66;145008.0;424656.66
270580;201801;77;55;22;52470.0;20988.0;73458.0
270590;201801;82;68;14;64872.0;13356.0;78228.0
270600;201801;176;146;30;139284.0;28620.0;167904.0
270610;201801;175;139;36;132597.0;34344.0;166941.0
270620;201801;30;29;1;27666.0;954.0;28620.0
270630;201801;3829;2904;925;2759558.5;880294.94;3639853.5
270640;201801;902;659;243;626982.6;231507.8;858490.4
270642;201801;208;175;33;166950.0;31482.0;198432.0
270644;201801;281;193;88;183931.73;83947.23;267878.97
270650;201801;236;136;100;129744.0;95400.0;225144.0
270660;201801;257;207;50;197478.0;47700.0;245178.0
270670;201801;3159;2395;764;2274012.8;726887.25;3000900.0
270680;201801;463;268;195;255663.0;186025.23;441688.22
270690;201801;1115;696;419;662251.75;399716.47;1061968.2
270700;201801;36;27;9;25758.0;8586.0;34344.0
270710;201801;868;650;218;618481.3;207972.0;826453.3
270720;201801;245;185;60;176490.0;56953.8;233443.8
270730;201801;1871;1086;785;1033803.4;746784.2;1780587.6
270740;201801;46;29;17;27666.0;16218.0;43884.0
270750;201801;630;460;170;438650.0;161513.0;600163.0
270760;201801;309;225;84;214650.0;80136.0;294786.0
270770;201801;2692;1695;997;1609756.2;950184.0;2559940.2
270780;201801;92;57;35;54373.23;33372.46;87745.69
270790;201801;272;182;90;173628.0;85860.0;259488.0
270800;201801;1977;1568;409;1494914.0;389441.88;1884355.9
270810;201801;319;250;69;238485.69;65817.23;304302.9
270820;201801;155;99;56;94446.0;53329.0;147775.0
270830;201801;949;683;266;650819.0;253478.0;904297.0
270840;201801;1410;1023;387;975035.7;367530.0;1342565.8
270850;201801;1704;1037;667;984476.56;636299.44;1620776.0
270860;201801;2443;1578;865;1502406.2;822312.56;2324718.8
270870;201801;123;67;56;63918.0;53424.0;117342.0
270880;201801;906;659;247;626850.1;234744.58;861594.75
270890;201801;361;263;98;250453.62;93487.23;343940.84
270895;201801;72;62;10;59148.0;9540.0;68688.0
270900;201801;107;83;24;79182.0;22896.0;102078.0
270910;201801;324;257;67;244033.2;63918.0;307951.2
270915;201801;1803;1072;731;1017810.25;696655.1;1714465.4
270920;201801;473;394;79;375876.0;75366.0;451242.0
270930;201801;6206;4464;1742;4252570.5;1658802.5;5911373.0
270940;201801;2371;1786;585;1702622.9;557118.0;2259741.0
280010;201801;44;39;5;37206.0;4770.0;41976.0
280020;201801;699;599;100;569507.0;94446.0;663953.0
280030;201801;19060;12182;6878;1,15E+14;6533678.5;1,81E+13
280040;201801;339;214;125;204156.0;117819.0;321975.0
280050;201801;377;292;85;278281.8;81090.0;359371.8
280060;201801;323;214;109;201909.44;103986.0;305895.44
280067;201801;980;687;293;652639.94;278568.25;931208.2
280070;201801;128;106;22;101124.0;20988.0;122112.0
280100;201801;616;485;131;459850.28;124784.0;584634.25
280110;201801;75;71;4;67734.0;3816.0;71550.0
280120;201801;624;502;122;478908.0;116388.0;595296.0
280130;201801;1337;830;507;790389.8;483534.9;1273924.8
280140;201801;465;374;91;355937.4;85573.8;441511.2
280150;201801;314;231;83;219694.1;79182.0;298876.1
280160;201801;99;84;15;80136.0;14310.0;94446.0
280170;201801;582;390;192;370577.56;182357.1;552934.7
280190;201801;27;25;2;23850.0;1908.0;25758.0
280200;201801;23;15;8;14310.0;7632.0;21942.0
280210;201801;2742;1934;808;1827380.1;765196.9;2592577.0
280220;201801;40;31;9;29574.0;8586.0;38160.0
280230;201801;309;254;55;241481.62;52470.0;293951.62
280240;201801;112;106;6;100980.9;5724.0;106704.9
280250;201801;21;12;9;11448.0;8586.0;20034.0
280260;201801;77;68;9;64872.0;8586.0;73458.0
280270;201801;158;123;35;117342.0;33390.0;150732.0
280280;201801;197;125;72;119250.0;68688.0;187938.0
280290;201801;3041;2202;839;2086661.4;799095.25;2885756.8
280300;201801;1087;822;265;782523.25;252046.8;1034570.06
280310;201801;105;100;5;94932.22;4770.0;99702.22
280320;201801;657;447;210;426429.0;200340.0;626769.0
280330;201801;355;255;100;243270.0;95275.98;338545.97
280340;201801;412;330;82;313348.56;77465.0;390813.56
280350;201801;3381;2606;775;2477110.5;736610.2;3213720.8
280360;201801;465;295;170;281430.0;161226.0;442656.0
280370;201801;99;87;12;82998.0;11448.0;94446.0
280380;201801;56;41;15;39114.0;14310.0;53424.0
280390;201801;186;154;32;146916.0;30528.0;177444.0
280400;201801;346;232;114;220469.8;108756.0;329225.8
280410;201801;291;234;57;222074.0;54368.46;276442.47
280420;201801;176;147;29;140238.0;27666.0;167904.0
280430;201801;106;78;28;74412.0;26603.63;101015.63
280440;201801;671;514;157;486446.9;149577.66;636024.56
280445;201801;113;105;8;100170.0;7632.0;107802.0
280450;201801;1058;903;155;858123.0;147870.0;1005993.0
280460;201801;732;530;202;498759.44;192708.0;691467.44
280470;201801;190;173;17;165042.0;15265.0;180307.0
280480;201801;2234;1588;646;1500157.5;612338.06;2112495.5
280490;201801;362;332;30;315219.0;28620.0;343839.0
280500;201801;45;40;5;38160.0;4770.0;42930.0
280510;201801;147;115;32;109409.2;30242.0;139651.2
280520;201801;55;41;14;39114.0;13356.0;52470.0
280530;201801;77;54;23;51516.0;21942.0;73458.0
280540;201801;500;400;100;381600.0;95113.8;476713.8
280550;201801;701;648;53;615576.6;50562.0;666138.6
280560;201801;470;407;63;385272.9;60102.0;445374.9
280570;201801;1771;1346;425;1280355.5;404595.38;1684950.9
280580;201801;595;453;142;430494.6;135373.0;565867.6
280590;201801;161;97;64;92258.48;61056.0;153314.48
280600;201801;353;296;57;281639.88;54378.0;336017.88
280610;201801;145;110;35;104734.0;33390.0;138124.0
280620;201801;544;443;101;421369.25;95400.9;516770.12
280630;201801;165;136;29;129744.0;27666.0;157410.0
280640;201801;209;166;43;157535.0;41022.0;198557.0
280650;201801;78;52;26;49608.0;24804.0;74412.0
280660;201801;128;92;36;87768.0;34105.5;121873.5
280670;201801;1597;1001;596;949875.75;564839.94;1514715.8
280680;201801;178;151;27;142271.02;25758.0;168029.02
280690;201801;48;41;7;39114.0;6678.0;45792.0
280700;201801;17;17;0;16218.0;0.0;16218.0
280710;201801;1410;1063;347;1006359.8;330370.2;1336730.0
280720;201801;107;73;34;68036.4;32436.0;100472.4
280730;201801;25;21;4;20034.0;3816.0;23850.0
280740;201801;2370;1743;627;1657983.8;596099.25;2254083.0
280750;201801;291;251;40;239454.0;38160.0;277614.0
280760;201801;873;594;279;565531.2;266022.9;831554.1
290010;201801;196;130;66;124020.0;62964.0;186984.0
290020;201801;177;164;13;156456.0;12402.0;168858.0
290030;201801;588;379;209;360898.2;199386.0;560284.2
290035;201801;141;114;27;105551.7;25758.0;131309.7
290040;201801;267;169;98;161226.0;93492.0;254718.0
290050;201801;72;53;19;50562.0;18126.0;68688.0
290060;201801;255;111;144;105607.8;137376.0;242983.8
290070;201801;5550;2730;2820;2596981.8;2686518.8;5283500.5
290080;201801;501;229;272;218160.72;259469.0;477629.72
290090;201801;382;166;216;158364.0;206064.0;364428.0
290100;201801;1582;1037;545;984915.1;519357.8;1504272.9
290110;201801;753;441;312;419088.2;297409.5;716497.7
290115;201801;212;196;16;186030.0;15264.0;201294.0
290120;201801;782;507;275;483010.2;262350.0;745360.2
290130;201801;420;248;172;236296.27;164088.0;400384.25
290135;201801;295;225;70;213972.66;66780.0;280752.66
290140;201801;298;244;54;232776.0;51325.2;284101.2
290150;201801;127;95;32;90630.0;30528.0;121158.0
290160;201801;245;190;55;180020.58;52470.0;232490.58
290170;201801;89;63;26;60102.0;24804.0;84906.0
290180;201801;152;119;33;113526.0;31482.0;145008.0
290190;201801;451;365;86;347924.0;81757.8;429681.8
290195;201801;300;173;127;165042.0;121158.0;286200.0
290200;201801;285;241;44;229914.0;41976.0;271890.0
290205;201801;137;84;53;80136.0;50562.0;130698.0
290210;201801;1111;807;304;768734.2;290016.0;1058750.2
290220;201801;216;118;98;112095.0;93492.0;205587.0
290225;201801;278;104;174;99216.0;165996.0;265212.0
290230;201801;64;41;23;39114.0;21942.0;61056.0
290240;201801;308;122;186;116101.8;177444.0;293545.8
290250;201801;271;245;26;233034.0;24804.0;257838.0
290260;201801;275;228;47;216749.0;44838.0;261587.0
290265;201801;183;150;33;142283.0;31482.0;173765.0
290270;201801;1376;1133;243;1078878.2;230959.0;1309837.2
290280;201801;466;347;119;331038.0;113526.0;444564.0
290290;201801;1203;698;505;661372.3;481770.0;1143142.2
290300;201801;449;381;68;362944.72;64872.0;427816.72
290310;201801;319;140;179;133560.0;170766.0;304326.0
290320;201801;3927;2444;1483;2328873.8;1411921.0;3740794.8
290323;201801;184;159;25;151400.0;23850.0;175250.0
290327;201801;148;117;31;111346.11;29574.0;140920.11
290330;201801;70;35;35;33390.0;33390.0;66780.0
290340;201801;907;359;548;341513.0;522251.1;863764.06
290350;201801;585;347;238;330275.0;227052.0;557327.0
290360;201801;365;274;91;259489.69;86814.0;346303.7
290370;201801;918;354;564;337716.0;538056.0;875772.0
290380;201801;302;185;117;176490.0;111618.0;288108.0
290390;201801;2469;1532;937;1458555.6;891990.0;2350545.5
290395;201801;242;133;109;126357.8;103986.0;230343.8
290400;201801;277;205;72;195128.0;68688.0;263816.0
290405;201801;258;222;36;211788.0;34344.0;246132.0
290410;201801;555;473;82;449190.9;78228.0;527418.9
290420;201801;231;179;52;170766.0;49608.0;220374.0
290430;201801;504;314;190;299556.0;181260.0;480816.0
290440;201801;71;62;9;59148.0;7949.96;67097.96
290450;201801;232;178;54;169812.0;51516.0;221328.0
290460;201801;1864;1105;759;1052219.0;723609.5;1775828.5
290470;201801;1443;603;840;574133.25;801045.4;1375178.6
290475;201801;589;552;37;525893.0;35298.0;561191.0
290480;201801;289;162;127;154548.0;121158.0;275706.0
290485;201801;220;206;14;196524.0;13356.0;209880.0
290490;201801;1142;816;326;778464.0;310050.2;1088514.2
290500;201801;662;331;331;314820.0;315774.0;630594.0
290510;201801;217;165;52;156457.0;49608.0;206065.0
290515;201801;135;78;57;74412.0;54378.0;128790.0
290520;201801;1374;879;495;836944.6;468988.4;1305933.0
290530;201801;312;283;29;269982.0;27666.0;297648.0
290540;201801;93;56;37;53424.0;35298.0;88722.0
290550;201801;150;128;22;122112.0;20635.02;142747.02
290560;201801;3365;1359;2006;1295474.8;1913529.6;3209004.2
290570;201801;5802;2993;2809;2850710.8;2676971.0;5527682.0
290580;201801;1229;710;519;676099.8;494410.5;1170510.2
290590;201801;530;439;91;418043.0;86814.0;504857.0
290600;201801;1713;1188;525;1128392.9;500821.38;1629214.2
290610;201801;218;196;22;186527.0;20988.0;207515.0
290620;201801;320;282;38;269028.0;35679.6;304707.6
290630;201801;2110;893;1217;847237.6;1155396.1;2002633.8
290640;201801;150;123;27;117342.0;25758.0;143100.0
290650;201801;1698;802;896;764145.0;854784.0;1618929.0
290660;201801;279;226;53;215604.0;50562.0;266166.0
290670;201801;982;513;469;488830.0;447080.38;935910.4
290680;201801;1179;947;232;902484.0;220374.0;1122858.0
290682;201801;291;212;79;201261.3;75347.46;276608.75
290685;201801;228;145;83;137376.0;79182.0;216558.0
290687;201801;935;619;316;587139.6;299432.2;886571.75
290689;201801;127;74;53;70582.0;50547.69;121129.69
290690;201801;648;270;378;257551.92;359732.8;617284.75
290700;201801;241;114;127;108756.0;121158.0;229914.0
290710;201801;690;454;236;433116.0;225144.0;658260.0
290720;201801;1019;832;187;793728.0;177921.0;971649.0
290730;201801;1109;633;476;602021.7;453150.0;1055171.8
290740;201801;15;12;3;11448.0;2862.0;14310.0
290750;201801;1339;607;732;577745.06;696216.1;1273961.1
290755;201801;69;61;8;58194.0;7632.0;65826.0
290760;201801;297;258;39;246132.0;37206.0;283338.0
290770;201801;185;173;12;165032.45;11448.0;176480.45
290780;201801;970;779;191;741222.7;180401.4;921624.06
290790;201801;372;260;112;247461.0;106848.0;354309.0
290800;201801;2619;1046;1573;995714.06;1499525.9;2495239.8
290810;201801;437;303;134;288776.0;127836.0;416612.0
290820;201801;378;234;144;222268.0;137376.0;359644.0
290830;201801;390;261;129;248994.0;123066.0;372060.0
290840;201801;1664;1021;643;971602.8;611342.5;1582945.2
290850;201801;755;416;339;396673.2;322452.0;719125.2
290860;201801;653;290;363;276660.0;346016.0;622676.0
290870;201801;658;479;179;456031.8;170766.0;626797.8
290880;201801;125;68;57;64872.0;54378.0;119250.0
290890;201801;322;228;94;217512.0;89676.0;307188.0
290900;201801;169;128;41;122112.0;39114.0;161226.0
290910;201801;358;271;87;258534.0;82998.0;341532.0
290920;201801;229;194;35;185076.0;33390.0;218466.0
290930;201801;806;610;196;581940.0;186965.0;768905.0
290940;201801;251;205;46;194806.8;43884.0;238690.8
290950;201801;170;98;72;93492.0;68688.0;162180.0
290960;201801;436;291;145;276374.25;138043.8;414418.03
290970;201801;252;221;31;210643.2;29277.0;239920.2
290980;201801;1471;1042;429;989899.75;408217.2;1398117.0
290990;201801;366;310;56;295711.9;53368.38;349080.3
291000;201801;854;237;617;226098.0;588045.6;814143.6
291005;201801;2069;881;1188;838985.75;1132575.0;1971560.8
291010;201801;157;142;15;135468.0;14310.0;149778.0
291020;201801;103;81;22;77274.0;20988.0;98262.0
291030;201801;91;66;25;62964.0;23850.0;86814.0
291040;201801;583;290;293;276660.0;279522.0;556182.0
291050;201801;1333;754;579;717671.25;552079.8;1269751.0
291060;201801;1479;814;665;775888.2;634410.0;1410298.2
291070;201801;1889;1396;493;1325161.9;468298.3;1793460.1
291072;201801;7271;2674;4597;2547647.5;4383059.5;6930707.0
291075;201801;198;159;39;151686.0;37206.0;188892.0
291077;201801;49;33;16;31482.0;15264.0;46746.0
291080;201801;19309;8404;10905;7994822.0;1,04E+14;1,84E+14
291085;201801;288;230;58;219420.0;55327.23;274747.22
291090;201801;304;115;189;109424.0;180296.45;289720.47
291100;201801;687;198;489;188892.0;466506.0;655398.0
291110;201801;400;305;95;290950.9;90630.0;381580.9
291120;201801;2500;1170;1330;1116037.0;1266841.9;2382879.0
291125;201801;59;31;28;29574.0;26712.0;56286.0
291130;201801;212;185;27;176490.0;25758.0;202248.0
291140;201801;121;90;31;85860.0;29288.0;115148.0
291150;201801;378;148;230;141192.0;219420.0;360612.0
291160;201801;359;301;58;286200.5;55332.0;341532.5
291165;201801;22;18;4;17172.0;3816.0;20988.0
291170;201801;2864;1443;1421;1372854.1;1352581.8;2725436.0
291180;201801;1317;508;809;484435.38;771652.7;1256088.0
291185;201801;74;72;2;68688.0;1908.0;70596.0
291190;201801;1243;527;716;501225.44;682520.8;1183746.2
291200;201801;164;118;46;112572.0;43884.0;156456.0
291210;201801;2187;849;1338;806807.3;1274640.1;2081447.5
291220;201801;261;196;65;186030.64;62010.0;248040.64
291230;201801;1027;343;684;326364.0;652536.0;978900.0
291240;201801;439;417;22;396578.0;20988.0;417566.0
291250;201801;425;347;78;331038.0;74412.0;405450.0
291260;201801;40;30;10;28620.0;9540.0;38160.0
291270;201801;1202;487;715;464598.0;681585.8;1146183.8
291280;201801;375;171;204;162943.2;194320.27;357263.47
291290;201801;1737;870;867;828835.2;826070.0;1654905.2
291300;201801;224;177;47;168190.2;44838.0;213028.2
291310;201801;228;204;24;194330.0;22896.0;217226.0
291320;201801;1385;990;395;941598.0;375781.28;1317379.2
291330;201801;125;106;19;100265.4;18126.0;118391.4
291340;201801;140;80;60;76320.0;57240.0;133560.0
291345;201801;127;83;44;79182.0;41976.0;121158.0
291350;201801;1565;492;1073;468891.0;1023451.3;1492342.2
291360;201801;8563;4197;4366;3992650.5;4161880.5;8154531.0
291370;201801;1078;592;486;564482.0;463644.0;1028126.0
291380;201801;254;201;53;191754.0;50562.0;242316.0
291390;201801;3875;1674;2201;1592544.0;2097942.0;3690486.0
291400;201801;2073;1477;596;1403907.4;566901.5;1970808.9
291410;201801;154;135;19;127836.0;18126.0;145962.0
291420;201801;106;77;29;73458.0;27666.0;101124.0
291430;201801;172;95;77;89923.0;72504.53;162427.53
291440;201801;489;391;98;370576.5;93492.0;464068.5
291450;201801;880;546;334;518691.7;317682.0;836373.7
291460;201801;1719;1402;317;1335027.6;302418.0;1637445.6
291465;201801;2197;1020;1177;972711.06;1122576.1;2095287.2
291470;201801;2765;1401;1364;1332768.5;1300526.0;2633294.5
291480;201801;11840;5222;6618;4970535.5;6302480.5;1,13E+14
291490;201801;541;221;320;210834.0;305280.0;516114.0
291500;201801;369;200;169;190800.0;161226.0;352026.0
291510;201801;1230;457;773;434817.0;737155.8;1171972.8
291520;201801;957;433;524;413082.0;499886.47;912968.44
291530;201801;1009;270;739;257580.0;704700.94;962280.94
291535;201801;114;96;18;91584.0;17172.0;108756.0
291540;201801;362;110;252;104940.0;239454.6;344394.6
291550;201801;1175;548;627;520886.1;597567.8;1118453.9
291560;201801;5533;2840;2693;2696442.2;2556715.5;5253157.5
291570;201801;204;105;99;100170.0;94446.0;194616.0
291580;201801;1203;731;472;696607.44;450274.22;1146881.8
291590;201801;76;30;46;28476.9;43884.0;72360.9
291600;201801;1371;618;753;588618.0;718058.0;1306676.0
291610;201801;1385;627;758;596874.9;723076.0;1319950.9
291620;201801;576;267;309;254718.0;294404.4;549122.4
291630;201801;494;161;333;153594.0;317682.0;471276.0
291640;201801;3888;1940;1948;1844418.9;1857025.0;3701444.0
291650;201801;416;275;141;261215.73;133607.73;394823.47
291660;201801;440;174;266;165303.95;252666.9;417970.88
291670;201801;221;140;81;132988.0;77274.0;210262.0
291680;201801;705;401;304;382554.0;289921.0;672475.0
291685;201801;570;302;268;287870.0;255481.2;543351.2
291690;201801;554;283;271;269982.0;257580.0;527562.0
291700;201801;910;720;190;686150.2;180306.0;866456.2
291710;201801;1708;788;920;751056.25;876803.06;1627859.4
291720;201801;397;265;132;252805.23;125928.0;378733.22
291730;201801;928;537;391;510771.8;373004.47;883776.25
291733;201801;255;177;78;168571.8;74412.0;242983.8
291735;201801;65;49;16;46746.0;15264.0;62010.0
291740;201801;340;256;84;244224.0;80136.0;324360.0
291750;201801;1932;1285;647;1218418.8;615586.0;1834004.8
291760;201801;3068;1644;1424;1561736.5;1356111.0;2917847.5
291770;201801;804;542;262;514969.25;249948.0;764917.25
291780;201801;46;26;20;24804.0;19080.0;43884.0
291790;201801;166;77;89;73458.0;84906.0;158364.0
291800;201801;9904;3917;5987;3725466.5;5707402.0;9432868.0
291810;201801;1142;817;325;778841.0;310050.0;1088891.0
291820;201801;263;190;73;181260.0;69642.0;250902.0
291830;201801;1066;397;669;377517.0;637263.0;1014780.0
291835;201801;614;561;53;534717.0;50562.0;585279.0
291840;201801;4619;2377;2242;2262865.8;2138020.5;4400886.0
291845;201801;302;104;198;99216.0;188863.38;288079.38
291850;201801;322;280;42;266881.5;40068.0;306949.5
291855;201801;270;110;160;104940.0;152640.0;257580.0
291860;201801;177;109;68;103032.0;64872.0;167904.0
291870;201801;83;33;50;31482.0;47700.0;79182.0
291875;201801;182;165;17;157410.0;16218.0;173628.0
291880;201801;488;381;107;362664.0;102078.0;464742.0
291890;201801;246;79;167;75356.46;157601.0;232957.45
291900;201801;56;31;25;29574.0;23850.0;53424.0
291905;201801;141;95;46;90344.0;43884.0;134228.0
291910;201801;176;143;33;136422.0;31482.0;167904.0
291915;201801;391;347;44;329370.0;41976.0;371346.0
291920;201801;4901;2538;2363;2418563.5;2252393.2;4670957.0
291930;201801;181;105;76;99216.55;72504.0;171720.55
291940;201801;313;171;142;162437.58;134514.0;296951.6
291950;201801;1135;927;208;883595.0;198432.0;1082027.0
291955;201801;1002;595;407;567630.0;387849.0;955479.0
291960;201801;176;120;56;114480.0;53424.0;167904.0
291970;201801;782;594;188;566676.0;179352.0;746028.0
291980;201801;1498;1323;175;1258729.8;165996.4;1424726.1
291990;201801;122;113;9;107802.0;8586.0;116388.0
291992;201801;164;84;80;79372.8;76320.0;155692.8
291995;201801;149;105;44;100170.0;41976.0;142146.0
292000;201801;381;289;92;274292.94;87768.0;362060.94
292010;201801;278;200;78;190133.0;73458.0;263591.0
292020;201801;269;197;72;187938.0;68688.0;256626.0
292030;201801;139;109;30;103986.0;28620.0;132606.0
292040;201801;626;316;310;301464.0;295740.0;597204.0
292045;201801;90;81;9;77274.0;8586.0;85860.0
292050;201801;882;604;278;575206.9;265212.0;840418.9
292060;201801;938;771;167;734580.5;159318.0;893898.5
292070;201801;50;21;29;20034.0;27666.0;47700.0
292080;201801;113;78;35;74412.0;33390.0;107802.0
292090;201801;497;174;323;165805.2;308142.0;473947.2
292100;201801;1390;599;791;569872.7;754585.94;1324458.6
292105;201801;201;169;32;161226.0;30528.0;191754.0
292110;201801;2109;777;1332;740933.6;1268702.9;2009636.5
292120;201801;632;508;124;483499.78;118296.0;601795.8
292130;201801;445;262;183;249948.0;174582.0;424530.0
292140;201801;198;155;43;147870.0;40890.26;188760.27
292145;201801;156;83;73;79182.0;69613.38;148795.38
292150;201801;1404;1125;279;1073250.0;265138.16;1338388.1
292160;201801;181;148;33;140905.8;31482.0;172387.8
292170;201801;1215;1065;150;1014317.3;143042.77;1157360.1
292180;201801;198;139;59;132606.0;56286.0;188892.0
292190;201801;157;96;61;91584.0;58194.0;149778.0
292200;201801;1278;462;816;439605.72;777815.56;1217421.2
292205;201801;115;104;11;98929.8;10494.0;109423.8
292210;201801;364;251;113;238071.0;107086.5;345157.5
292220;201801;22;16;6;15264.0;5724.0;20988.0
292225;201801;39;36;3;34344.0;2862.0;37206.0
292230;201801;909;733;176;696775.0;167904.0;864679.0
292240;201801;617;438;179;416755.0;170766.0;587521.0
292250;201801;1672;1058;614;1009332.0;585756.0;1595088.0
292260;201801;435;242;193;230868.0;183358.8;414226.8
292265;201801;270;189;81;180019.8;77274.0;257293.8
292270;201801;770;333;437;317014.2;415944.8;732959.0
292273;201801;200;112;88;106070.49;83952.0;190022.48
292275;201801;163;78;85;74412.0;80803.8;155215.8
292280;201801;135;95;40;90630.0;38160.0;128790.0
292285;201801;60;50;10;47032.2;9540.0;56572.2
292290;201801;547;364;183;344766.47;174296.0;519062.47
292300;201801;1618;618;1000;588999.8;953166.56;1542166.4
292303;201801;98;67;31;63918.0;29574.0;93492.0
292305;201801;110;78;32;74412.0;30528.0;104940.0
292310;201801;796;497;299;473776.0;283857.53;757633.5
292320;201801;652;492;160;469081.8;152640.0;621721.8
292330;201801;190;98;92;93492.0;87768.0;181260.0
292335;201801;274;210;64;200340.0;61056.0;261396.0
292340;201801;568;392;176;373228.84;167904.0;541132.9
292350;201801;265;141;124;133703.1;118009.8;251712.9
292360;201801;701;530;171;503903.0;163134.0;667037.0
292370;201801;780;594;186;566676.0;177444.0;744120.0
292380;201801;649;501;148;476046.62;141192.0;617238.6
292390;201801;504;187;317;178398.0;300653.5;479051.5
292400;201801;3349;2059;1290;1945968.4;1226779.8;3172748.2
292405;201801;264;175;89;166473.0;84619.8;251092.8
292410;201801;152;89;63;84906.0;60102.0;145008.0
292420;201801;304;261;43;248707.8;41022.0;289729.8
292430;201801;519;403;116;384462.0;110187.0;494649.0
292440;201801;576;492;84;468147.0;79849.8;547996.8
292450;201801;244;189;55;180306.0;52470.0;232776.0
292460;201801;584;433;151;412509.8;144054.0;556563.8
292465;201801;191;160;31;152640.0;28836.09;181476.1
292467;201801;99;58;41;55332.0;39114.0;94446.0
292470;201801;251;170;81;162180.0;77274.0;239454.0
292480;201801;318;213;105;202248.5;99884.0;302132.5
292490;201801;218;142;76;135468.0;72504.0;207972.0
292500;201801;1172;506;666;482513.0;634906.25;1117419.2
292510;201801;3301;1482;1819;1412874.1;1732598.8;3145472.8
292520;201801;1048;499;549;474849.5;523737.0;998586.5
292525;201801;385;274;111;261391.23;105894.0;367285.22
292530;201801;4205;1721;2484;1638868.9;2367922.0;4006790.8
292540;201801;482;260;222;248040.0;211788.0;459828.0
292550;201801;1059;566;493;539222.75;469836.8;1009059.56
292560;201801;317;298;19;284292.0;18126.0;302418.0
292570;201801;300;229;71;218137.0;67734.0;285871.0
292575;201801;456;292;164;278282.0;156456.0;434738.0
292580;201801;896;565;331;537579.0;315488.0;853067.0
292590;201801;506;436;70;415641.6;66780.0;482421.6
292593;201801;143;112;31;106848.0;29574.0;136422.0
292595;201801;176;135;41;128790.0;39114.0;167904.0
292600;201801;1237;921;316;878317.0;300796.2;1179113.2
292610;201801;125;95;30;90630.0;28362.42;118992.42
292620;201801;519;431;88;410879.0;83952.0;494831.0
292630;201801;1355;784;571;746348.0;543112.7;1289460.6
292640;201801;766;534;232;509102.1;221328.0;730430.1
292650;201801;174;149;25;141710.0;23850.0;165560.0
292660;201801;1987;1425;562;1353626.9;531087.94;1884714.8
292665;201801;137;100;37;95400.0;35298.0;130698.0
292670;201801;393;319;74;304322.0;70596.0;374918.0
292680;201801;249;193;56;184122.0;52947.0;237069.0
292690;201801;179;137;42;130698.0;40068.0;170766.0
292700;201801;911;599;312;570492.8;297648.0;868140.8
292710;201801;97;85;12;81090.0;11192.0;92282.0
292720;201801;833;469;364;446624.62;347066.0;793690.6
292730;201801;202;95;107;89676.5;102078.0;191754.5
292740;201801;65787;32555;33232;3,10E+14;3,17E+14;6,27E+14
292750;201801;369;263;106;249948.94;100313.57;350262.5
292760;201801;316;257;59;244167.5;56286.0;300453.5
292770;201801;780;331;449;315468.0;428346.0;743814.0
292780;201801;422;160;262;152412.48;249948.0;402360.47
292790;201801;731;355;376;338670.0;358465.5;697135.5
292800;201801;1136;697;439;663251.9;418806.0;1082057.9
292805;201801;423;122;301;115863.3;287154.0;403017.3
292810;201801;1460;847;613;807179.8;584506.44;1391686.2
292820;201801;744;598;146;568584.9;138988.8;707573.7
292830;201801;102;81;21;77274.0;20034.0;97308.0
292840;201801;651;535;116;509913.0;110649.69;620562.7
292850;201801;132;89;43;84902.0;41022.0;125924.0
292860;201801;2108;1233;875;1172211.0;834750.0;2006961.0
292870;201801;3352;2240;1112;2135697.8;1060828.9;3196526.8
292880;201801;1425;940;485;892993.9;462690.0;1355683.9
292890;201801;473;405;68;386342.0;64872.0;451214.0
292895;201801;137;90;47;84501.5;44838.0;129339.5
292900;201801;386;287;99;273798.0;94446.0;368244.0
292905;201801;442;226;216;215604.0;205874.0;421478.0
292910;201801;392;300;92;285867.0;87768.0;373635.0
292920;201801;531;234;297;223236.0;283338.0;506574.0
292925;201801;507;471;36;448656.66;34325.0;482981.66
292930;201801;553;341;212;325314.0;202248.0;527562.0
292935;201801;296;127;169;121158.0;161226.0;282384.0
292937;201801;239;162;77;154548.0;73458.0;228006.0
292940;201801;190;144;46;137376.0;43884.0;181260.0
292950;201801;1097;568;529;539726.5;503713.0;1043439.5
292960;201801;540;361;179;344394.0;170766.0;515160.0
292970;201801;274;190;84;180593.0;80136.0;260729.0
292975;201801;156;90;66;85860.0;62774.0;148634.0
292980;201801;258;174;84;164212.44;80136.0;244348.44
292990;201801;1302;959;343;907549.9;327034.94;1234584.8
293000;201801;103;74;29;70596.0;27656.46;98252.46
293010;201801;2652;1627;1025;1546396.9;973813.0;2520210.0
293015;201801;647;508;139;484414.5;131967.0;616381.5
293020;201801;333;273;60;260442.0;57240.0;317682.0
293030;201801;621;540;81;513634.44;77274.0;590908.44
293040;201801;337;265;72;252810.0;68688.0;321498.0
293050;201801;2702;1579;1123;1496858.9;1067212.4;2564071.2
293060;201801;254;204;50;193429.0;46746.8;240175.8
293070;201801;3362;1697;1665;1611085.6;1587189.9;3198275.5
293075;201801;90;58;32;55332.0;30528.0;85860.0
293076;201801;72;46;26;43884.0;24804.0;68688.0
293077;201801;428;263;165;246387.47;157410.0;403797.47
293080;201801;443;393;50;374922.0;47700.0;422622.0
293090;201801;129;111;18;105894.0;16854.04;122748.04
293100;201801;517;364;153;347256.0;145962.0;493218.0
293105;201801;338;229;109;218180.0;103986.0;322166.0
293110;201801;168;118;50;112572.0;47700.0;160272.0
293120;201801;319;214;105;204156.0;99979.2;304135.2
293130;201801;248;164;84;156456.0;80136.0;236592.0
293135;201801;7900;3134;4766;2983395.2;4538222.0;7521617.0
293140;201801;178;115;63;109710.0;59339.0;169049.0
293150;201801;328;278;50;263781.2;47700.0;311481.2
293160;201801;430;242;188;230868.0;179352.0;410220.0
293170;201801;190;132;58;125642.0;54474.0;180116.0
293180;201801;462;314;148;299270.0;141192.0;440462.0
293190;201801;1269;881;388;835824.75;370152.0;1205976.8
293200;201801;526;464;62;441576.0;59148.0;500724.0
293210;201801;337;245;92;233578.0;87052.5;320630.5
293220;201801;2689;1083;1606;1031248.44;1529930.5;2561179.0
293230;201801;1770;637;1133;606267.8;1080596.0;1686863.8
293240;201801;220;201;19;191754.0;18126.0;209880.0
293245;201801;109;92;17;87768.0;16218.0;103986.0
293250;201801;736;274;462;261148.0;439794.2;700942.2
293260;201801;313;261;52;248040.17;49608.0;297648.16
293270;201801;1173;552;621;524700.7;592434.0;1117134.6
293280;201801;235;131;104;124974.0;99216.0;224190.0
293290;201801;3070;2000;1070;1905848.8;1020481.0;2926329.8
293300;201801;691;489;202;464173.5;191181.6;655355.1
293305;201801;152;130;22;124020.0;20988.0;145008.0
293310;201801;136;102;34;97308.0;32436.0;129744.0
293315;201801;156;120;36;114480.0;34344.0;148824.0
293317;201801;97;68;29;64872.0;27666.0;92538.0
293320;201801;958;543;415;517068.5;395910.0;912978.5
293325;201801;181;65;116;62010.0;110625.84;172635.84
293330;201801;12823;5976;6847;5690187.5;6524224.5;1,22E+14
293340;201801;254;182;72;173628.0;67734.0;241362.0
293345;201801;244;193;51;184122.0;48654.0;232776.0
293350;201801;622;324;298;309096.0;282813.3;591909.3
293360;201801;1575;1123;452;1070102.0;429968.7;1500070.8
310010;201801;151;74;77;70596.0;73172.0;143768.0
310020;201801;1053;578;475;549027.2;451059.97;1000087.2
310030;201801;323;261;62;247868.88;58861.8;306730.7
310040;201801;51;32;19;30528.0;18126.0;48654.0
310050;201801;180;116;64;109710.4;60770.0;170480.4
310060;201801;234;163;71;155025.0;67734.0;222759.0
310070;201801;16;8;8;7632.0;7632.0;15264.0
310080;201801;50;27;23;25758.0;21942.0;47700.0
310090;201801;955;500;455;471754.7;432925.6;904680.25
310100;201801;296;221;75;210834.0;71550.0;282384.0
310110;201801;732;391;341;371979.1;324360.0;696339.1
310120;201801;381;213;168;202534.2;159897.94;362432.12
310130;201801;33;20;13;19080.0;12402.0;31482.0
310140;201801;28;16;12;15264.0;11448.0;26712.0
310150;201801;1282;879;403;834370.6;383889.8;1218260.4
310160;201801;2106;1064;1042;1006949.5;991683.4;1998632.9
310163;201801;91;50;41;47700.0;39114.0;86814.0
310170;201801;2542;1041;1501;992990.0;1429378.6;2422368.5
310180;201801;129;48;81;45792.0;76892.4;122684.4
310190;201801;485;324;161;309096.0;153021.6;462117.6
310200;201801;504;317;187;302418.0;178398.0;480816.0
310205;201801;61;45;16;42930.0;15264.0;58194.0
310210;201801;278;225;53;214650.0;50562.0;265212.0
310220;201801;53;32;21;30528.0;20034.0;50562.0
310230;201801;261;184;77;175345.2;73458.0;248803.2
310240;201801;105;92;13;87529.5;12402.0;99931.5
310250;201801;99;80;19;76320.0;18126.0;94446.0
310260;201801;800;430;370;406595.7;352245.4;758841.1
310270;201801;269;181;88;172121.0;83952.0;256073.0
310280;201801;366;273;93;259775.0;88722.0;348497.0
310285;201801;221;157;64;149469.86;61056.0;210525.86
310290;201801;255;146;109;139284.0;103986.0;243270.0
310300;201801;155;128;27;122112.0;25758.0;147870.0
310310;201801;7;5;2;4770.0;1908.0;6678.0
310320;201801;22;14;8;13356.0;7632.0;20988.0
310330;201801;30;22;8;20988.0;7632.0;28620.0
310340;201801;1695;1093;602;1034979.9;572782.5;1607762.4
310350;201801;2814;1519;1295;1444304.0;1234848.8;2679152.8
310360;201801;41;33;8;31482.0;7632.0;39114.0
310370;201801;122;100;22;95400.0;20702.0;116102.0
310375;201801;102;36;66;34344.0;62945.0;97289.0
310380;201801;53;31;22;28668.0;20988.0;49656.0
310390;201801;100;70;30;66780.0;28620.0;95400.0
310400;201801;2302;1487;815;1414688.0;777204.8;2191892.8
310410;201801;128;69;59;65826.0;56286.0;122112.0
310420;201801;670;361;309;342104.1;293823.06;635927.2
310430;201801;332;219;113;208639.8;107802.0;316441.8
310440;201801;67;40;27;38160.0;25758.0;63918.0
310445;201801;84;67;17;63918.0;16218.0;80136.0
310450;201801;857;539;318;513538.2;303372.0;816910.2
310460;201801;267;192;75;183168.0;71550.0;254718.0
310470;201801;491;308;183;293832.0;174582.0;468414.0
310480;201801;77;53;24;50562.0;22896.0;73458.0
310490;201801;485;226;259;214650.2;247086.0;461736.2
310500;201801;128;56;72;53424.0;68688.0;122112.0
310510;201801;606;395;211;375590.6;201275.45;576866.06
310520;201801;131;87;44;82998.0;41976.0;124974.0
310530;201801;89;41;48;39114.0;45505.8;84619.8
310540;201801;451;280;171;264736.6;163134.0;427870.6
310550;201801;86;56;30;53424.0;28620.0;82044.0
310560;201801;2916;2006;910;1903243.0;866561.1;2769804.2
310570;201801;137;92;45;87768.0;42930.0;130698.0
310590;201801;342;223;119;211208.7;113511.69;324720.38
310600;201801;158;91;67;85049.7;63918.0;148967.7
310610;201801;59;21;38;20034.0;36252.0;56286.0
310620;201801;45467;21729;23738;2,07E+14;2,26E+14;4,33E+14
310630;201801;589;377;212;356939.6;200754.88;557694.5
310640;201801;136;114;22;108565.2;20988.0;129553.2
310650;201801;159;139;20;131652.0;19080.0;150732.0
310660;201801;90;57;33;54378.0;31482.0;85860.0
310665;201801;55;40;15;38160.0;14310.0;52470.0
310670;201801;6286;2922;3364;2778746.2;3204478.2;5983224.5
310680;201801;54;36;18;34344.0;17172.0;51516.0
310690;201801;588;427;161;403152.66;153594.0;556746.7
310700;201801;63;40;23;38160.0;21798.9;59958.9
310710;201801;1240;826;414;786750.25;394383.8;1181134.0
310720;201801;86;28;58;26712.0;55332.0;82044.0
310730;201801;1367;943;424;899336.0;404496.0;1303832.0
310740;201801;1011;566;445;536626.4;424282.47;960908.9
310750;201801;243;142;101;134514.19;96354.0;230868.19
310760;201801;68;52;16;49608.0;15264.0;64872.0
310770;201801;93;45;48;42930.0;45792.0;88722.0
310780;201801;400;326;74;310995.0;70596.0;381591.0
310790;201801;98;80;18;76320.0;17172.0;93492.0
310800;201801;458;222;236;211311.0;224857.8;436168.8
310810;201801;166;116;50;109508.2;46746.0;156254.2
310820;201801;359;283;76;269982.0;72217.8;342199.8
310825;201801;192;158;34;150732.0;32436.0;183168.0
310830;201801;463;222;241;211127.94;229656.0;440783.94
310840;201801;386;219;167;208926.0;159318.0;368244.0
310850;201801;109;88;21;83952.0;20034.0;103986.0
310855;201801;376;296;80;282384.0;76320.0;358704.0
310860;201801;1392;1039;353;985818.1;335026.9;1320845.0
310870;201801;55;42;13;40068.0;12402.0;52470.0
310880;201801;81;63;18;59815.8;17172.0;76987.8
310890;201801;313;184;129;175536.0;123066.0;298602.0
310900;201801;641;293;348;276598.06;331686.8;608284.9
310910;201801;250;171;79;161799.2;75366.0;237165.2
310920;201801;486;290;196;272845.2;186030.4;458875.6
310925;201801;37;30;7;28620.0;6392.0;35012.0
310930;201801;1094;656;438;625421.3;417757.06;1043178.4
310940;201801;681;348;333;331391.8;317682.0;649073.8
310945;201801;117;72;45;68688.0;42930.0;111618.0
310950;201801;249;195;54;186030.0;51516.0;237546.0
310960;201801;84;31;53;29574.0;50558.0;80132.0
310970;201801;168;105;63;100170.0;59179.76;159349.77
310980;201801;46;24;22;22896.0;20988.0;43884.0
310990;201801;152;86;66;81758.0;62964.0;144722.0
311000;201801;833;422;411;399059.7;392085.0;791144.7
311010;201801;40;33;7;31482.0;6678.0;38160.0
311020;201801;41;26;15;24804.0;14310.0;39114.0
311030;201801;392;231;161;218466.0;153594.0;372060.0
311040;201801;38;33;5;31482.0;4770.0;36252.0
311050;201801;469;196;273;186412.0;259869.6;446281.6
311060;201801;753;433;320;411651.4;304994.0;716645.4
311070;201801;329;147;182;140238.0;173628.0;313866.0
311080;201801;105;57;48;54378.0;45792.0;100170.0
311090;201801;398;188;210;178112.0;200340.0;378452.0
311100;201801;615;365;250;347923.8;238213.8;586137.6
311110;201801;681;469;212;447139.8;202239.0;649378.8
311115;201801;66;48;18;45792.0;17172.0;62964.0
311120;201801;1026;536;490;510340.8;466839.9;977180.7
311130;201801;406;235;171;223999.2;163134.0;387133.2
311140;201801;160;76;84;72504.0;79325.1;151829.1
311150;201801;354;231;123;220374.0;117103.5;337477.5
311160;201801;743;534;209;507051.4;198909.0;705960.4
311170;201801;79;58;21;55332.0;19747.8;75079.8
311180;201801;340;226;114;215317.8;108470.0;323787.8
311190;201801;35;18;17;17172.0;16218.0;33390.0
311200;201801;337;233;104;220660.6;99216.0;319876.6
311205;201801;29;19;10;18126.0;9158.4;27284.4
311210;201801;50;41;9;38828.0;8586.0;47414.0
311220;201801;16;14;2;13356.0;1908.0;15264.0
311230;201801;1633;1057;576;1004011.94;549504.0;1553516.0
311240;201801;169;106;63;100920.33;60102.0;161022.33
311250;201801;73;31;42;29574.0;40068.0;69642.0
311260;201801;556;350;206;333900.0;196524.0;530424.0
311265;201801;112;77;35;73458.0;33390.0;106848.0
311270;201801;281;203;78;193662.0;74412.0;268074.0
311280;201801;213;97;116;92538.0;110091.6;202629.6
311290;201801;110;88;22;83952.0;20416.0;104368.0
311300;201801;546;344;202;327222.97;192422.0;519644.97
311310;201801;23;18;5;17172.0;4770.0;21942.0
311320;201801;673;504;169;479862.0;161226.0;641088.0
311330;201801;1035;760;275;724706.5;261396.4;986102.9
311340;201801;2609;1858;751;1765771.2;716044.9;2481816.0
311350;201801;273;211;62;201294.0;59148.0;260442.0
311360;201801;177;106;71;101124.0;67734.0;168858.0
311370;201801;1199;483;716;458788.5;682491.6;1141280.1
311380;201801;7;6;1;5724.0;954.0;6678.0
311390;201801;282;149;133;142146.0;126405.2;268551.2
311400;201801;151;99;52;94446.0;49599.0;144045.0
311410;201801;96;55;41;52470.0;39114.0;91584.0
311420;201801;293;160;133;151629.56;126882.0;278511.56
311430;201801;852;553;299;526514.0;285246.0;811760.0
311440;201801;485;338;147;322452.0;139951.8;462403.8
311450;201801;319;198;121;188892.0;115434.0;304326.0
311455;201801;304;204;100;194320.8;95113.8;289434.6
311460;201801;127;51;76;48654.0;71698.27;120352.27
311470;201801;20;10;10;9540.0;9540.0;19080.0
311480;201801;24;9;15;8586.0;14310.0;22896.0
311490;201801;16;10;6;9540.0;5724.0;15264.0
311500;201801;19;10;9;9540.0;8586.0;18126.0
311510;201801;624;439;185;416863.7;176203.8;593067.5
311520;201801;45;33;12;30814.2;11448.0;42262.2
311530;201801;1808;1346;462;1275213.5;440748.0;1715961.5
311535;201801;67;51;16;48654.0;15264.0;63918.0
311540;201801;33;29;4;27666.0;3816.0;31482.0
311545;201801;183;135;48;128790.0;45792.0;174582.0
311547;201801;30;21;9;20034.0;8586.0;28620.0
311550;201801;612;278;334;265212.0;318617.47;583829.44
311560;201801;43;28;15;26712.0;14310.0;41022.0
311570;201801;304;201;103;191181.6;98262.0;289443.6
311580;201801;303;177;126;168571.8;120204.0;288775.8
311590;201801;32;28;4;26712.0;3816.0;30528.0
311600;201801;91;72;19;68688.0;18126.0;86814.0
311610;201801;261;228;33;216240.55;31482.0;247722.55
311615;201801;97;80;17;75680.82;16218.0;91898.82
311620;201801;19;11;8;10494.0;7632.0;18126.0
311630;201801;84;71;13;67734.0;12402.0;80136.0
311640;201801;117;66;51;62964.0;48654.0;111618.0
311650;201801;128;95;33;89914.5;31482.0;121396.5
311660;201801;408;194;214;185076.0;204156.0;389232.0
311670;201801;164;105;59;99925.0;56286.0;156211.0
311680;201801;222;162;60;153646.95;56476.8;210123.75
311690;201801;18;11;7;10494.0;6678.0;17172.0
311700;201801;197;136;61;129457.8;58194.0;187651.8
311710;201801;217;139;78;132606.0;74412.0;207018.0
311720;201801;38;28;10;26712.0;9540.0;36252.0
311730;201801;550;360;190;342868.0;181260.0;524128.0
311740;201801;37;26;11;24804.0;10494.0;35298.0
311750;201801;706;484;222;459828.8;211788.0;671616.8
311760;201801;65;36;29;34344.0;27666.0;62010.0
311770;201801;401;192;209;181260.62;199386.0;380646.62
311780;201801;168;96;72;91584.0;68371.0;159955.0
311783;201801;79;70;9;66780.0;8586.0;75366.0
311787;201801;37;17;20;16218.0;19080.0;35298.0
311790;201801;264;125;139;119250.0;132606.0;251856.0
311800;201801;634;436;198;412558.3;188224.2;600782.5
311810;201801;44;36;8;34344.0;7632.0;41976.0
311820;201801;108;90;18;85860.0;17172.0;103032.0
311830;201801;1863;1189;674;1128698.5;639657.8;1768356.2
311840;201801;1012;562;450;531856.9;427704.44;959561.4
311850;201801;8;5;3;4770.0;2862.0;7632.0
311860;201801;9455;4324;5131;4108525.8;4886485.5;8995011.0
311870;201801;151;84;67;80136.0;63918.0;144054.0
311880;201801;948;707;241;672942.8;229914.0;902856.8
311890;201801;219;110;109;104940.0;103986.0;208926.0
311900;201801;90;37;53;35298.0;50562.0;85860.0
311910;201801;1376;854;522;811807.1;495746.3;1307553.4
311920;201801;226;149;77;141908.0;73458.0;215366.0
311930;201801;904;525;379;500564.0;361328.0;861892.0
311940;201801;2426;1246;1180;1186347.8;1123191.9;2309539.5
311950;201801;31;22;9;20988.0;8586.0;29574.0
311960;201801;68;48;20;45792.0;19080.0;64872.0
311970;201801;22;12;10;11448.0;9540.0;20988.0
311980;201801;43;32;11;30528.0;10494.0;41022.0
311990;201801;59;43;16;41022.0;15264.0;56286.0
311995;201801;61;42;19;40068.0;18126.0;58194.0
312000;201801;33;22;11;20701.8;10494.0;31195.8
312010;201801;85;62;23;59148.0;21942.0;81090.0
312015;201801;95;70;25;66494.0;23850.0;90344.0
312020;201801;138;85;53;81090.0;50562.0;131652.0
312030;201801;41;34;7;31483.0;6678.0;38161.0
312040;201801;80;51;29;48654.0;27666.0;76320.0
312050;201801;225;117;108;111618.0;103032.0;214650.0
312060;201801;65;40;25;38160.0;23182.2;61342.2
312070;201801;75;44;31;41976.0;29574.0;71550.0
312080;201801;526;228;298;217512.0;284292.0;501804.0
312083;201801;48;35;13;33390.0;12402.0;45792.0
312087;201801;109;87;22;82998.0;20988.0;103986.0
312090;201801;2829;1609;1220;1519323.5;1160069.0;2679392.5
312100;201801;160;114;46;108756.0;43102.0;151858.0
312110;201801;116;73;43;69642.0;41022.0;110664.0
312120;201801;141;103;38;98262.0;36252.0;134514.0
312125;201801;94;54;40;51325.2;38160.0;89485.2
312130;201801;121;80;41;76320.0;39114.0;115434.0
312140;201801;132;105;27;100170.0;25758.0;125928.0
312150;201801;43;35;8;33390.0;7632.0;41022.0
312160;201801;1530;1018;512;968215.2;487036.47;1455251.6
312170;201801;11;9;2;8586.0;1908.0;10494.0
312180;201801;100;60;40;56525.0;37874.0;94399.0
312190;201801;32;28;4;26712.0;3816.0;30528.0
312200;201801;727;626;101;595248.7;96354.0;691602.7
312210;201801;98;63;35;60102.0;33390.0;93492.0
312220;201801;120;90;30;85622.0;28620.0;114242.0
312230;201801;3456;1692;1764;1610382.1;1681217.1;3291599.2
312235;201801;138;91;47;86814.0;44838.0;131652.0
312240;201801;111;72;39;68688.0;37206.0;105894.0
312245;201801;159;105;54;100166.0;51516.0;151682.0
312247;201801;55;39;16;36443.0;15264.0;51707.0
312250;201801;184;87;97;82521.0;92538.0;175059.0
312260;201801;104;69;35;64968.2;33390.0;98358.2
312270;201801;136;85;51;81090.0;48654.0;129744.0
312280;201801;25;15;10;14310.0;9540.0;23850.0
312290;201801;162;111;51;105607.8;47701.0;153308.8
312300;201801;201;133;68;126882.0;64872.0;191754.0
312310;201801;58;53;5;50562.0;4770.0;55332.0
312320;201801;423;265;158;250902.0;149444.5;400346.5
312330;201801;86;75;11;70787.0;10207.8;80994.8
312340;201801;36;16;20;15264.0;19080.0;34344.0
312350;201801;16;10;6;9540.0;5724.0;15264.0
312352;201801;96;65;31;62010.0;29574.0;91584.0
312360;201801;560;254;306;241362.0;291924.0;533286.0
312370;201801;296;176;120;167617.8;114480.0;282097.8
312380;201801;137;87;50;82998.0;47700.0;130698.0
312385;201801;180;146;34;139284.0;32436.0;171720.0
312390;201801;297;188;109;179352.0;103319.0;282671.0
312400;201801;379;286;93;272844.0;88246.0;361090.0
312410;201801;857;275;582;261873.0;554652.0;816525.0
312420;201801;608;487;121;463930.2;115434.0;579364.2
312430;201801;853;627;226;595537.06;214650.2;810187.25
312440;201801;45;34;11;32436.0;10494.0;42930.0
312450;201801;212;129;83;123066.0;79182.0;202248.0
312460;201801;58;29;29;27666.0;27666.0;55332.0
312470;201801;55;35;20;33390.0;19080.0;52470.0
312480;201801;211;128;83;122112.0;79182.0;201294.0
312490;201801;255;174;81;165996.0;77274.0;243270.0
312500;201801;32;18;14;17172.0;13356.0;30528.0
312510;201801;419;156;263;148824.0;250286.39;399110.38
312520;201801;40;14;26;13356.0;24804.0;38160.0
312530;201801;49;37;12;35298.0;11448.0;46746.0
312540;201801;99;87;12;82998.0;11448.0;94446.0
312550;201801;41;32;9;30528.0;8586.0;39114.0
312560;201801;199;143;56;136136.0;53137.8;189273.8
312570;201801;436;263;173;250234.2;164350.45;414584.66
312580;201801;84;44;40;41976.0;38160.0;80136.0
312590;201801;275;216;59;205683.0;56286.0;261969.0
312595;201801;145;130;15;124020.0;14310.0;138330.0
312600;201801;74;45;29;42501.0;27666.0;70167.0
312610;201801;1626;850;776;804033.75;738587.6;1542621.4
312620;201801;189;131;58;124974.0;55327.23;180301.23
312630;201801;64;54;10;51516.0;9540.0;61056.0
312640;201801;46;13;33;12402.0;31482.0;43884.0
312650;201801;146;118;28;112286.0;26426.0;138712.0
312660;201801;69;52;17;49322.0;16218.0;65540.0
312670;201801;866;567;299;539344.9;285032.3;824377.2
312675;201801;41;31;10;29574.0;9540.0;39114.0
312680;201801;86;60;26;56858.4;24804.0;81662.4
312690;201801;240;128;112;122102.46;106561.8;228664.27
312695;201801;31;24;7;22896.0;6678.0;29574.0
312700;201801;208;121;87;115434.0;82998.0;198432.0
312705;201801;72;60;12;57240.0;11448.0;68688.0
312707;201801;94;70;24;66277.75;22896.0;89173.75
312710;201801;1855;988;867;941064.0;826907.0;1767971.0
312720;201801;66;33;33;31482.0;31482.0;62964.0
312730;201801;289;171;118;162180.0;112285.8;274465.8
312733;201801;51;44;7;41690.0;6678.0;48368.0
312735;201801;22;16;6;15264.0;5724.0;20988.0
312737;201801;67;36;31;34344.0;29574.0;63918.0
312738;201801;52;37;15;35298.0;14310.0;49608.0
312740;201801;70;48;22;45792.0;20988.0;66780.0
312750;201801;71;51;20;48654.0;19080.0;67734.0
312760;201801;269;195;74;186030.0;70596.0;256626.0
312770;201801;7661;3540;4121;3354272.0;3922770.8;7277043.0
312780;201801;434;336;98;320257.8;93492.0;413749.8
312790;201801;20;15;5;14310.0;4770.0;19080.0
312800;201801;1591;1120;471;1060094.9;448151.62;1508246.5
312810;201801;373;239;134;227720.0;127836.0;355556.0
312820;201801;193;145;48;138330.0;45792.0;184122.0
312825;201801;27;19;8;18126.0;7632.0;25758.0
312830;201801;285;163;122;154263.0;115749.0;270012.0
312840;201801;148;109;39;103986.0;37206.0;141192.0
312850;201801;23;21;2;20034.0;1908.0;21942.0
312860;201801;170;106;64;100838.0;61056.0;161894.0
312870;201801;983;517;466;490420.34;444564.0;934984.3
312880;201801;149;103;46;98118.9;43788.6;141907.5
312890;201801;163;113;50;107802.0;47700.0;155502.0
312900;201801;211;156;55;148156.2;52470.0;200626.2
312910;201801;184;92;92;86599.72;87768.0;174367.72
312920;201801;155;86;69;82044.0;65826.0;147870.0
312930;201801;340;246;94;234684.0;89676.0;324360.0
312940;201801;103;70;33;66780.0;31482.0;98262.0
312950;201801;703;464;239;441320.6;228006.0;669326.6
312960;201801;176;132;44;125928.0;41976.0;167904.0
312965;201801;51;45;6;42930.0;5724.0;48654.0
312970;201801;282;227;55;215604.2;52470.0;268074.2
312980;201801;2310;1238;1072;1176084.2;1022111.6;2198195.8
312990;201801;50;29;21;27666.0;20034.0;47700.0
313000;201801;39;25;14;23850.0;13356.0;37206.0
313005;201801;166;127;39;120166.5;36920.0;157086.5
313010;201801;936;390;546;370819.8;520588.8;891408.6
313020;201801;187;98;89;93015.0;84906.0;177921.0
313030;201801;208;134;74;125929.0;70596.0;196525.0
313040;201801;60;22;38;20988.0;36252.0;57240.0
313050;201801;295;206;89;195570.2;84906.0;280476.2
313055;201801;46;33;13;31482.0;12402.0;43884.0
313060;201801;127;84;43;80136.0;40735.8;120871.8
313065;201801;59;39;20;37206.0;19080.0;56286.0
313070;201801;153;82;71;78228.0;67734.0;145962.0
313080;201801;42;18;24;17172.0;22896.0;40068.0
313090;201801;703;483;220;459494.3;209880.0;669374.3
313100;201801;165;64;101;61056.0;96346.0;157402.0
313110;201801;125;73;52;69642.0;49608.0;119250.0
313115;201801;157;86;71;81843.66;67734.0;149577.66
313120;201801;760;415;345;395624.0;327603.8;723227.8
313130;201801;5189;2795;2394;2640645.5;2274471.8;4915117.0
313140;201801;161;85;76;81090.0;72504.0;153594.0
313150;201801;315;251;64;239454.0;60769.8;300223.8
313160;201801;191;136;55;129744.0;52470.0;182214.0
313170;201801;1332;941;391;885648.1;372623.4;1258271.5
313180;201801;330;195;135;185381.28;128790.0;314171.28
313190;201801;725;427;298;404591.4;283529.0;688120.4
313200;201801;23;22;1;20988.0;954.0;21942.0
313210;201801;1036;872;164;828885.2;156451.23;985336.4
313220;201801;235;161;74;152640.0;69880.5;222520.5
313230;201801;269;198;71;187939.0;67734.0;255673.0
313240;201801;1910;1021;889;970973.94;844730.56;1815704.5
313250;201801;1239;913;326;866329.8;309097.8;1175427.6
313260;201801;91;54;37;51516.0;35298.0;86814.0
313270;201801;952;557;395;527323.3;376830.0;904153.3
313280;201801;61;52;9;49131.0;8586.0;57717.0
313290;201801;226;183;43;174296.0;40068.8;214364.8
313300;201801;373;186;187;175536.8;178398.0;353934.8
313310;201801;225;117;108;111618.0;103032.0;214650.0
313320;201801;368;285;83;269935.1;79182.0;349117.1
313330;201801;1357;811;546;772263.2;519692.5;1291955.8
313340;201801;336;230;106;219420.0;101124.0;320544.0
313350;201801;524;352;172;333900.1;164088.0;497988.1
313360;201801;113;66;47;62964.0;44552.0;107516.0
313370;201801;188;69;119;65826.0;113526.0;179352.0
313375;201801;273;163;110;155502.0;104940.0;260442.0
313380;201801;1277;650;627;618211.06;597868.0;1216079.1
313390;201801;48;40;8;37206.8;7632.0;44838.8
313400;201801;418;272;146;259488.0;138998.0;398486.0
313410;201801;22;12;10;11448.0;9540.0;20988.0
313420;201801;4665;2406;2259;2286331.0;2148114.0;4434445.0
313430;201801;134;62;72;59148.0;68688.0;127836.0
313440;201801;1454;977;477;930580.3;454200.0;1384780.2
313450;201801;63;27;36;25758.0;34057.8;59815.8
313460;201801;377;176;201;166464.0;191754.0;358218.0
313470;201801;533;242;291;230868.0;276946.2;507814.2
313480;201801;161;109;52;103033.0;49608.0;152641.0
313490;201801;511;250;261;238495.23;248947.0;487442.22
313500;201801;20;12;8;11448.0;7632.0;19080.0
313505;201801;954;742;212;706977.5;201961.8;908939.3
313507;201801;93;55;38;52470.0;36252.0;88722.0
313510;201801;2758;1773;985;1685677.8;938736.0;2624413.8
313520;201801;3594;2807;787;2665334.8;750794.0;3416128.8
313530;201801;42;29;13;27666.0;12402.0;40068.0
313535;201801;104;83;21;78515.0;20034.0;98549.0
313540;201801;70;53;17;50562.0;16218.0;66780.0
313545;201801;108;88;20;83952.0;19080.0;103032.0
313550;201801;234;191;43;182214.0;40736.0;222950.0
313560;201801;330;173;157;165042.0;149778.0;314820.0
313570;201801;59;31;28;29574.0;26712.0;56286.0
313580;201801;1288;698;590;663306.3;561143.4;1224449.8
313590;201801;81;48;33;45792.0;31482.0;77274.0
313600;201801;689;413;276;394002.0;262446.0;656448.0
313610;201801;56;44;12;41356.8;11448.0;52804.8
313620;201801;1343;710;633;667448.94;600410.0;1267858.9
313630;201801;1632;1251;381;1191928.0;363188.0;1555116.0
313640;201801;125;71;54;67734.0;51516.0;119250.0
313650;201801;234;108;126;103032.0;120204.0;223236.0
313652;201801;15;14;1;13356.0;954.0;14310.0
313655;201801;54;31;23;29574.0;21942.0;51516.0
313657;201801;46;42;4;40068.0;3816.0;43884.0
313660;201801;132;92;40;87768.0;38160.0;125928.0
313665;201801;636;314;322;299556.0;306949.5;606505.5
313670;201801;10208;7087;3121;6736983.0;2976575.8;9713559.0
313680;201801;41;30;11;28620.0;10494.0;39114.0
313690;201801;159;122;37;116388.0;35298.0;151686.0
313695;201801;65;49;16;46746.0;15264.0;62010.0
313700;201801;288;231;57;220088.0;54378.0;274466.0
313710;201801;151;102;49;97308.0;46746.0;144054.0
313720;201801;1050;497;553;471636.5;526217.9;997854.4
313730;201801;60;42;18;40068.0;17172.0;57240.0
313740;201801;162;129;33;123066.0;31482.0;154548.0
313750;201801;441;323;118;307855.8;112572.0;420427.8
313753;201801;240;168;72;159604.2;68688.0;228292.2
313760;201801;1217;441;776;420714.0;737567.5;1158281.5
313770;201801;357;255;102;243270.0;97308.0;340578.0
313780;201801;754;385;369;367290.0;351739.8;719029.8
313790;201801;27;26;1;24804.0;954.0;25758.0
313800;201801;143;88;55;83952.0;52470.0;136422.0
313810;201801;65;37;28;35298.0;26712.0;62010.0
313820;201801;1282;632;650;601974.2;619123.2;1221097.4
313830;201801;67;50;17;47700.0;16218.0;63918.0
313835;201801;51;46;5;43884.0;4770.0;48654.0
313840;201801;1671;1027;644;974131.5;613136.0;1587267.5
313850;201801;180;62;118;59148.0;111992.06;171140.06
313860;201801;483;377;106;356177.3;100170.1;456347.4
313862;201801;173;113;60;107802.0;57240.0;165042.0
313865;201801;83;66;17;62964.0;16218.0;79182.0
313867;201801;49;37;12;35298.0;11448.0;46746.0
313868;201801;26;17;9;15455.0;8586.0;24041.0
313870;201801;124;65;59;62010.0;56286.0;118296.0
313880;201801;338;215;123;204824.0;116769.8;321593.8
313890;201801;316;169;147;160463.8;139665.6;300129.4
313900;201801;914;495;419;470609.5;399679.0;870288.5
313910;201801;136;96;40;91584.0;37206.2;128790.2
313920;201801;610;429;181;409075.2;172674.0;581749.2
313925;201801;35;30;5;28620.0;4770.0;33390.0
313930;201801;800;614;186;585756.0;177421.0;763177.0
313940;201801;1751;1101;650;1046824.4;619432.4;1666256.8
313950;201801;937;603;334;573450.6;318349.8;891800.4
313960;201801;1380;792;588;751304.3;559712.0;1311016.2
313970;201801;122;83;39;79182.0;37206.0;116388.0
313980;201801;209;136;73;129506.0;69642.0;199148.0
313990;201801;364;218;146;207685.8;139204.81;346890.62
314000;201801;908;615;293;583229.9;279517.22;862747.1
314010;201801;77;50;27;47700.0;25758.0;73458.0
314015;201801;50;15;35;14310.0;33390.0;47700.0
314020;201801;49;33;16;31482.0;15168.6;46650.6
314030;201801;88;41;47;38713.67;44838.0;83551.67
314040;201801;43;30;13;28620.0;12402.0;41022.0
314050;201801;314;184;130;175250.0;122541.3;297791.3
314053;201801;103;68;35;63918.4;33390.0;97308.4
314055;201801;295;172;123;164088.0;117342.0;281430.0
314060;201801;146;124;22;117342.0;20988.0;138330.0
314070;201801;951;468;483;442435.12;459876.0;902311.1
314080;201801;214;140;74;133560.0;69546.88;203106.88
314085;201801;124;81;43;77274.0;41022.0;118296.0
314090;201801;347;252;95;240408.0;90625.23;331033.22
314100;201801;474;389;85;367291.0;80518.0;447809.0
314110;201801;693;375;318;355851.53;302656.6;658508.1
314120;201801;97;54;43;51516.0;41022.0;92538.0
314130;201801;26;12;14;11448.0;13356.0;24804.0
314140;201801;1089;653;436;620558.1;414036.66;1034594.75
314150;201801;165;103;62;98262.0;59148.0;157410.0
314160;201801;355;262;93;247086.8;88532.0;335618.8
314170;201801;70;52;18;48844.8;17172.0;66016.8
314180;201801;722;631;91;601688.0;85860.5;687548.5
314190;201801;100;57;43;54378.0;41022.0;95400.0
314200;201801;586;404;182;383859.4;172674.0;556533.4
314210;201801;276;208;68;197478.0;64586.0;262064.0
314220;201801;311;235;76;222283.0;72218.0;294501.0
314225;201801;65;45;20;42930.0;19080.0;62010.0
314230;201801;102;46;56;43884.0;53424.0;97308.0
314240;201801;139;105;34;100170.0;32436.0;132606.0
314250;201801;60;36;24;34344.0;22896.0;57240.0
314260;201801;187;96;91;91584.0;86814.0;178398.0
314270;201801;331;257;74;244415.0;70310.0;314725.0
314280;201801;683;381;302;363465.0;288108.0;651573.0
314290;201801;552;445;107;423290.5;101791.8;525082.3
314300;201801;415;297;118;280402.0;112525.0;392927.0
314310;201801;1432;956;476;910032.25;453797.97;1363830.2
314315;201801;33;26;7;24804.0;6678.0;31482.0
314320;201801;596;378;218;360039.8;207046.62;567086.44
314330;201801;10670;5366;5304;5108073.5;5055551.0;1,02E+14
314340;201801;571;266;305;253191.8;290398.0;543589.8
314345;201801;27;21;6;20034.0;5724.0;25758.0
314350;201801;189;117;72;111618.0;68688.0;180306.0
314360;201801;77;46;31;43884.0;29574.0;73458.0
314370;201801;58;48;10;45792.0;9540.0;55332.0
314380;201801;91;65;26;62010.0;24804.0;86814.0
314390;201801;3194;2015;1179;1918017.5;1121809.4;3039827.0
314400;201801;686;492;194;466498.2;185076.0;651574.2
314410;201801;424;271;153;258534.0;145962.0;404496.0
314420;201801;20;9;11;8586.0;10494.0;19080.0
314430;201801;2504;895;1609;849893.3;1532302.8;2382196.0
314435;201801;269;155;114;147583.8;107802.0;255385.8
314437;201801;26;20;6;19080.0;5724.0;24804.0
314440;201801;98;70;28;66780.0;26712.0;93492.0
314450;201801;152;116;36;110664.0;34344.0;145008.0
314460;201801;655;301;354;287154.0;337716.0;624870.0
314465;201801;80;56;24;53424.0;22896.0;76320.0
314467;201801;68;58;10;55323.0;9540.0;64863.0
314470;201801;383;197;186;184486.52;176490.5;360977.03
314480;201801;1039;504;535;480816.0;510199.2;991015.2
314490;201801;87;66;21;62964.0;20034.0;82998.0
314500;201801;317;208;109;198432.0;103986.0;302418.0
314505;201801;129;81;48;77274.0;45792.0;123066.0
314510;201801;228;184;44;175250.0;41976.0;217226.0
314520;201801;1230;633;597;596636.7;567582.9;1164219.6
314530;201801;700;551;149;525168.0;142146.0;667314.0
314535;201801;209;131;78;123924.6;74161.01;198085.61
314537;201801;62;37;25;35298.0;23850.0;59148.0
314540;201801;13;9;4;8586.0;3816.0;12402.0
314545;201801;50;33;17;31482.0;16218.0;47700.0
314550;201801;79;42;37;40068.0;35298.0;75366.0
314560;201801;805;434;371;411842.0;353934.0;765776.0
314570;201801;22;17;5;16218.0;4770.0;20988.0
314580;201801;18;9;9;8586.0;8586.0;17172.0
314585;201801;20;14;6;13356.0;5724.0;19080.0
314587;201801;83;72;11;68688.0;10494.0;79182.0
314590;201801;547;405;142;386370.0;135468.0;521838.0
314600;201801;996;648;348;613510.9;329702.8;943213.7
314610;201801;938;517;421;490642.9;400489.2;891132.1
314620;201801;148;110;38;103317.6;36252.0;139569.6
314625;201801;96;72;24;68116.0;22896.0;91012.0
314630;201801;1229;631;598;600495.3;570205.8;1170701.1
314640;201801;90;60;30;57240.0;28620.0;85860.0
314650;201801;206;120;86;113432.6;81567.0;194999.6
314655;201801;65;51;14;48654.0;13356.0;62010.0
314660;201801;20;15;5;14310.0;4770.0;19080.0
314670;201801;183;145;38;138044.0;36252.0;174296.0
314675;201801;211;119;92;113526.0;87768.0;201294.0
314690;201801;538;298;240;284292.0;228960.0;513252.0
314700;201801;2425;1328;1097;1261476.2;1045636.9;2307113.0
314710;201801;1634;954;680;905158.9;647818.1;1552977.0
314720;201801;411;243;168;230419.62;160272.0;390691.62
314730;201801;506;273;233;259012.0;222273.0;481285.0
314740;201801;685;338;347;320782.5;331038.0;651820.5
314750;201801;22;19;3;18126.0;2862.0;20988.0
314760;201801;316;153;163;145962.0;155492.45;301454.47
314770;201801;120;83;37;79182.0;35298.0;114480.0
314780;201801;21;6;15;5724.0;14310.0;20034.0
314790;201801;2326;1450;876;1376615.8;835026.7;2211642.2
314795;201801;50;43;7;40784.0;6678.0;47462.0
314800;201801;2909;1703;1206;1619376.0;1148893.2;2768269.2
314810;201801;1498;826;672;785667.5;639467.0;1425134.5
314820;201801;91;51;40;48654.0;38160.0;86814.0
314830;201801;210;164;46;155740.5;43598.0;199338.5
314840;201801;83;49;34;46746.0;32436.0;79182.0
314850;201801;350;170;180;162180.0;171720.0;333900.0
314860;201801;704;529;175;502662.88;165423.7;668086.56
314870;201801;1444;740;704;705006.0;671616.0;1376622.0
314875;201801;59;51;8;48654.0;7632.0;56286.0
314880;201801;46;33;13;31482.0;12402.0;43884.0
314890;201801;52;31;21;29574.0;20034.0;49608.0
314900;201801;30;25;5;23850.0;4770.0;28620.0
314910;201801;257;172;85;163801.8;81090.0;244891.8
314915;201801;153;134;19;127598.0;18126.0;145724.0
314920;201801;121;75;46;71550.0;43597.8;115147.8
314930;201801;1024;520;504;494222.0;480529.8;974751.8
314940;201801;53;41;12;39114.0;11448.0;50562.0
314950;201801;38;27;11;25758.0;10494.0;36252.0
314960;201801;61;44;17;41976.0;16218.0;58194.0
314970;201801;136;68;68;64300.0;64872.0;129172.0
314980;201801;304;199;105;187604.1;99216.0;286820.1
314990;201801;464;256;208;244224.0;197526.5;441750.5
314995;201801;199;65;134;62010.0;127826.46;189836.45
315000;201801;87;70;17;66780.0;16218.0;82998.0
315010;201801;47;31;16;29574.0;15264.0;44838.0
315015;201801;169;138;31;130926.96;29574.0;160500.95
315020;201801;66;56;10;53424.0;9540.0;62964.0
315030;201801;118;91;27;85860.0;25758.0;111618.0
315040;201801;65;49;16;46746.0;15264.0;62010.0
315050;201801;196;116;80;110664.0;76320.0;186984.0
315053;201801;40;35;5;33390.0;4770.0;38160.0
315057;201801;97;80;17;75938.4;16218.0;92156.4
315060;201801;70;63;7;58195.16;6678.0;64873.16
315070;201801;104;58;46;55332.0;43884.0;99216.0
315080;201801;371;305;66;290970.0;62964.0;353934.0
315090;201801;107;64;43;61056.0;41022.0;102078.0
315100;201801;74;38;36;36252.0;34344.0;70596.0
315110;201801;290;161;129;152736.0;123066.0;275802.0
315120;201801;1637;831;806;788816.2;767732.0;1556548.2
315130;201801;338;246;92;234684.0;87768.0;322452.0
315140;201801;537;313;224;296980.2;213696.0;510676.2
315150;201801;975;455;520;433117.0;495794.0;928911.0
315160;201801;211;108;103;103032.0;98262.0;201294.0
315170;201801;343;222;121;210835.0;115147.8;325982.8
315180;201801;3198;1355;1843;1289094.2;1755028.2;3044122.5
315190;201801;309;177;132;168477.0;125928.0;294405.0
315200;201801;1176;664;512;631644.2;487589.4;1119233.6
315210;201801;1547;876;671;831317.9;637714.2;1469032.1
315213;201801;45;27;18;25758.0;17172.0;42930.0
315217;201801;197;155;42;147870.0;40068.0;187938.0
315220;201801;1511;1155;356;1101250.6;339528.6;1440779.2
315230;201801;171;124;47;118010.0;44838.0;162848.0
315240;201801;420;271;149;258534.0;140944.5;399478.5
315250;201801;2542;1255;1287;1196411.6;1227216.6;2423628.2
315260;201801;148;92;56;86432.4;53424.0;139856.4
315270;201801;127;86;41;81471.6;38388.96;119860.56
315280;201801;686;446;240;425103.0;228950.45;654053.44
315290;201801;196;115;81;109710.0;76320.49;186030.48
315300;201801;71;46;25;43884.0;23850.0;67734.0
315310;201801;64;57;7;54378.0;6678.0;61056.0
315320;201801;159;89;70;84906.0;66780.0;151686.0
315330;201801;55;47;8;44838.0;7632.0;52470.0
315340;201801;419;294;125;279236.62;119250.0;398486.62
315350;201801;144;86;58;82044.0;55332.0;137376.0
315360;201801;96;51;45;48654.0;42930.0;91584.0
315370;201801;56;32;24;30528.0;22752.9;53280.9
315380;201801;12;7;5;6678.0;4770.0;11448.0
315390;201801;56;13;43;12402.0;41022.0;53424.0
315400;201801;818;613;205;579364.6;194902.2;774266.8
315410;201801;351;212;139;201962.0;132320.0;334282.0
315415;201801;58;44;14;41976.0;13356.0;55332.0
315420;201801;203;152;51;144245.0;48654.0;192899.0
315430;201801;675;398;277;378738.2;263781.8;642520.0
315440;201801;81;57;24;54378.0;22896.0;77274.0
315445;201801;255;204;51;194301.19;48654.0;242955.19
315450;201801;181;137;44;130698.0;41976.0;172674.0
315460;201801;3356;1704;1652;1620985.8;1573567.1;3194553.0
315470;201801;45;23;22;21656.0;20988.0;42644.0
315480;201801;62;23;39;21942.0;37206.0;59148.0
315490;201801;612;379;233;359514.9;222282.0;581796.9
315500;201801;21;13;8;12402.0;7632.0;20034.0
315510;201801;152;99;53;94446.0;50562.0;145008.0
315520;201801;71;62;9;59148.0;8586.0;67734.0
315530;201801;52;28;24;26712.0;22896.0;49608.0
315540;201801;240;157;83;149778.0;79182.0;228960.0
315550;201801;178;142;36;135468.0;34344.0;169812.0
315560;201801;747;594;153;565336.8;145962.0;711298.8
315570;201801;310;166;144;155741.7;137376.0;293117.7
315580;201801;656;429;227;409266.0;216558.0;625824.0
315590;201801;211;108;103;103032.0;98262.0;201294.0
315600;201801;294;215;79;204156.0;75176.0;279332.0
315610;201801;98;48;50;45792.0;47700.0;93492.0
315620;201801;35;28;7;26712.0;6678.0;33390.0
315630;201801;142;93;49;88722.0;46746.0;135468.0
315640;201801;56;32;24;30528.0;22896.0;53424.0
315645;201801;63;45;18;42930.0;16695.0;59625.0
315650;201801;167;121;46;115148.0;43884.0;159032.0
315660;201801;477;203;274;193662.0;261396.0;455058.0
315670;201801;2321;1186;1135;1128659.4;1081617.6;2210277.0
315680;201801;855;573;282;543076.7;268302.97;811379.6
315690;201801;698;475;223;452075.66;212742.0;664817.7
315700;201801;1900;1002;898;952036.4;856692.0;1808728.4
315710;201801;323;82;241;78228.0;229914.0;308142.0
315720;201801;426;273;153;260442.0;145962.0;406404.0
315725;201801;202;162;40;154548.0;38160.0;192708.0
315727;201801;42;22;20;20988.0;19080.0;40068.0
315730;201801;41;39;2;37206.0;1908.0;39114.0
315733;201801;86;55;31;52470.0;29574.0;82044.0
315737;201801;51;38;13;36252.0;12402.0;48654.0
315740;201801;44;39;5;37206.0;4770.0;41976.0
315750;201801;160;126;34;120204.0;32436.0;152640.0
315760;201801;47;32;15;30528.0;14310.0;44838.0
315765;201801;118;77;41;73458.0;39114.0;112572.0
315770;201801;228;136;92;129744.0;87482.0;217226.0
315780;201801;3265;1700;1565;1615075.5;1490626.6;3105702.0
315790;201801;210;162;48;154548.0;45219.6;199767.6
315800;201801;282;204;78;194616.0;74412.0;269028.0
315810;201801;96;56;40;53424.0;37874.0;91298.0
315820;201801;797;574;223;545307.3;212742.0;758049.3
315830;201801;143;82;61;78228.0;58194.0;136422.0
315840;201801;91;63;28;60102.0;26712.0;86814.0
315850;201801;259;189;70;180306.0;66780.0;247086.0
315860;201801;12;4;8;3816.0;7632.0;11448.0
315870;201801;34;27;7;25758.0;6678.0;32436.0
315880;201801;104;69;35;65826.0;33390.0;99216.0
315890;201801;81;60;21;57240.0;20034.0;77274.0
315895;201801;433;285;148;270651.0;140620.0;411271.0
315900;201801;70;33;37;31482.0;35298.0;66780.0
315910;201801;38;24;14;22657.5;13356.0;36013.5
315920;201801;184;120;64;114480.0;60102.9;174582.9
315930;201801;39;14;25;13356.0;23850.0;37206.0
315935;201801;146;114;32;108756.0;30519.0;139275.0
315940;201801;89;67;22;63918.0;20988.0;84906.0
315950;201801;65;46;19;43884.0;18126.0;62010.0
315960;201801;556;258;298;245483.48;283719.8;529203.25
315970;201801;37;29;8;27666.0;7632.0;35298.0
315980;201801;693;322;371;305619.2;353924.47;659543.7
315990;201801;248;150;98;143100.0;93206.0;236306.0
316000;201801;49;31;18;29574.0;17172.0;46746.0
316010;201801;75;63;12;60102.0;11448.0;71550.0
316020;201801;109;89;20;84906.0;19080.0;103986.0
316030;201801;398;207;191;197478.0;181690.0;379168.0
316040;201801;498;220;278;208926.2;264926.0;473852.2
316045;201801;59;52;7;49608.0;6678.0;56286.0
316050;201801;16;14;2;13356.0;1908.0;15264.0
316060;201801;93;60;33;56953.8;31482.0;88435.8
316070;201801;1036;667;369;629788.5;351263.0;981051.5
316080;201801;103;62;41;59148.0;39114.0;98262.0
316090;201801;42;26;16;24136.2;15264.0;39400.2
316095;201801;70;58;12;55056.0;11448.0;66504.0
316100;201801;308;181;127;171863.3;121158.0;293021.3
316105;201801;35;24;11;22896.0;10494.0;33390.0
316110;201801;1914;1534;380;1454898.5;361852.2;1816750.8
316120;201801;79;59;20;56286.0;18793.8;75079.8
316130;201801;138;106;32;100457.0;30528.0;130985.0
316140;201801;27;20;7;19080.0;6678.0;25758.0
316150;201801;202;141;61;133798.5;58194.0;191992.5
316160;201801;87;51;36;48654.0;34344.0;82998.0
316165;201801;65;47;18;44648.0;16456.5;61104.5
316170;201801;203;136;67;128790.0;63918.0;192708.0
316180;201801;198;91;107;86480.1;102078.0;188558.1
316190;201801;139;98;41;92538.0;39114.0;131652.0
316200;201801;697;389;308;371106.0;293259.8;664365.8
316210;201801;758;507;251;483332.34;239454.0;722786.3
316220;201801;116;78;38;74412.0;36252.0;110664.0
316225;201801;23;14;9;13356.0;8586.0;21942.0
316230;201801;33;19;14;18126.0;13356.0;31482.0
316240;201801;613;498;115;474138.2;109710.0;583848.2
316245;201801;99;82;17;78228.0;16218.0;94446.0
316250;201801;1510;1053;457;996197.0;434508.9;1430705.9
316255;201801;113;90;23;85478.4;21942.0;107420.4
316257;201801;182;95;87;90630.0;82711.8;173341.8
316260;201801;244;162;82;153251.06;78133.0;231384.06
316265;201801;25;16;9;15264.0;8586.0;23850.0
316270;201801;675;468;207;443705.6;197478.0;641183.6
316280;201801;543;338;205;320894.8;194902.6;515797.4
316290;201801;697;471;226;445535.97;215604.0;661140.0
316292;201801;492;194;298;185076.0;284054.0;469130.0
316294;201801;105;62;43;59148.0;41022.0;100170.0
316295;201801;278;120;158;113032.0;150732.0;263764.0
316300;201801;105;74;31;70596.0;29574.0;100170.0
316310;201801;35;18;17;17172.0;16218.0;33390.0
316320;201801;41;25;16;23850.0;15264.0;39114.0
316330;201801;129;82;47;77274.5;44551.8;121826.3
316340;201801;142;94;48;89676.0;45792.0;135468.0
316350;201801;191;138;53;131486.0;50562.0;182048.0
316360;201801;23;18;5;17172.0;4770.0;21942.0
316370;201801;1055;561;494;531398.5;470980.25;1002378.75
316380;201801;123;93;30;88722.0;28620.0;117342.0
316390;201801;121;87;34;82998.0;32436.0;115434.0
316400;201801;138;105;33;100170.0;31482.0;131652.0
316410;201801;305;225;80;213266.7;76320.0;289586.7
316420;201801;196;140;56;132844.5;53424.0;186268.5
316430;201801;158;78;80;74412.0;76320.0;150732.0
316440;201801;98;47;51;44838.0;48654.0;93492.0
316443;201801;36;34;2;32436.0;1908.0;34344.0
316447;201801;63;49;14;46746.0;13356.0;60102.0
316450;201801;221;167;54;159318.0;51516.0;210834.0
316460;201801;66;28;38;26712.0;36252.0;62964.0
316470;201801;1594;1147;447;1086532.5;424910.75;1511443.2
316480;201801;13;10;3;9540.0;2862.0;12402.0
316490;201801;18;7;11;6678.0;10494.0;17172.0
316500;201801;150;100;50;95113.8;47700.0;142813.8
316510;201801;169;124;45;117294.3;42930.0;160224.3
316520;201801;192;117;75;111045.6;71550.0;182595.6
316530;201801;152;110;42;104940.0;39781.8;144721.8
316540;201801;142;79;63;74412.0;60102.0;134514.0
316550;201801;141;100;41;95400.0;39114.0;134514.0
316553;201801;235;112;123;106339.33;117342.0;223681.33
316555;201801;32;23;9;21942.0;8586.0;30528.0
316556;201801;9;6;3;5724.0;2862.0;8586.0
316557;201801;17;14;3;13356.0;2862.0;16218.0
316560;201801;58;45;13;42930.0;12402.0;55332.0
316570;201801;246;224;22;213458.0;20988.0;234446.0
316580;201801;21;15;6;14310.0;5724.0;20034.0
316590;201801;115;99;16;94446.0;15264.0;109710.0
316600;201801;182;148;34;140906.0;32436.0;173342.0
316610;201801;65;45;20;42643.8;19080.0;61723.8
316620;201801;133;103;30;98262.0;28620.0;126882.0
316630;201801;37;27;10;25758.0;9540.0;35298.0
316640;201801;16;10;6;9540.0;5724.0;15264.0
316650;201801;64;50;14;47700.0;13356.0;61056.0
316660;201801;6;4;2;3816.0;1908.0;5724.0
316670;201801;437;155;282;147851.0;268455.8;416306.8
316680;201801;160;110;50;104940.0;47510.0;152450.0
316690;201801;190;120;70;114480.0;66780.0;181260.0
316695;201801;59;52;7;49608.0;6678.0;56286.0
316700;201801;13;7;6;6678.0;5724.0;12402.0
316710;201801;714;521;193;496796.0;184122.0;680918.0
316720;201801;4864;2472;2392;2343795.0;2278025.5;4621820.5
316730;201801;14;13;1;12402.0;954.0;13356.0
316740;201801;134;84;50;80136.0;47700.0;127836.0
316750;201801;19;13;6;12402.0;5724.0;18126.0
316760;201801;324;261;63;248994.0;60102.0;309096.0
316770;201801;139;80;59;76320.0;56286.0;132606.0
316780;201801;69;41;28;38808.72;26712.0;65520.72
316790;201801;56;43;13;41022.0;12402.0;53424.0
316800;201801;1790;1097;693;1044248.8;659406.2;1703655.0
316805;201801;18;9;9;8586.0;8586.0;17172.0
316810;201801;64;41;23;39114.0;21656.0;60770.0
316820;201801;37;18;19;17172.0;18126.0;35298.0
316830;201801;90;39;51;37206.0;47414.0;84620.0
316840;201801;500;303;197;288299.0;186030.0;474329.0
316850;201801;345;224;121;212312.7;115434.0;327746.7
316860;201801;5945;2636;3309;2500492.0;3153581.5;5654073.5
316870;201801;1444;932;512;880744.7;483680.0;1364424.8
316880;201801;113;65;48;61723.8;45792.0;107515.8
316890;201801;251;166;85;158171.0;81090.0;239261.0
316900;201801;414;285;129;269343.28;123066.0;392409.28
316905;201801;17;10;7;9540.0;6678.0;16218.0
316910;201801;50;26;24;24804.0;22896.0;47700.0
316920;201801;137;106;31;100409.0;29574.0;129983.0
316930;201801;1919;967;952;916748.3;906009.94;1822758.2
316935;201801;853;512;341;486540.72;324360.0;810900.75
316940;201801;1095;629;466;599112.4;443982.25;1043094.7
316950;201801;188;98;90;93492.0;85860.0;179352.0
316960;201801;1091;606;485;576788.8;462394.47;1039183.25
316970;201801;637;496;141;473184.0;134514.0;607698.0
316980;201801;113;69;44;65826.0;41966.46;107792.46
316990;201801;2175;1426;749;1353012.1;712867.94;2065880.1
317000;201801;327;253;74;241076.0;70596.0;311672.0
317005;201801;247;175;72;166950.0;68688.0;235638.0
317010;201801;6249;3429;2820;3251605.0;2688372.5;5939977.5
317020;201801;16058;7100;8958;6741541.0;8527736.0;1,53E+14
317030;201801;85;33;52;31482.0;49391.26;80873.26
317040;201801;3117;1931;1186;1839999.9;1128392.6;2968392.5
317043;201801;70;50;20;47700.0;19080.0;66780.0
317047;201801;35;17;18;16218.0;17168.0;33386.0
317050;201801;181;135;46;128790.0;43884.0;172674.0
317052;201801;123;96;27;91584.0;25758.0;117342.0
317057;201801;198;149;49;142146.0;46174.0;188320.0
317060;201801;55;36;19;34344.0;17839.8;52183.8
317065;201801;60;48;12;45792.0;11448.0;57240.0
317070;201801;1954;924;1030;876727.7;980521.6;1857249.2
317075;201801;107;55;52;52470.0;49608.0;102078.0
317080;201801;820;432;388;410950.88;369962.0;780912.9
317090;201801;629;504;125;478479.5;119250.0;597729.5
317100;201801;408;305;103;289062.2;98262.0;387324.2
317103;201801;109;94;15;89676.0;14310.0;103986.0
317107;201801;36;32;4;30528.0;3816.0;34344.0
317110;201801;94;39;55;37206.0;52470.0;89676.0
317115;201801;39;33;6;31482.0;5724.0;37206.0
317120;201801;1788;902;886;852604.6;844787.0;1697391.6
317130;201801;1898;1215;683;1156161.4;650915.0;1807076.4
317140;201801;6;5;1;4770.0;954.0;5724.0
317150;201801;271;163;108;155502.0;102268.8;257770.8
317160;201801;318;233;85;221965.0;81090.0;303055.0
317170;201801;206;143;63;136422.0;60102.0;196524.0
317180;201801;430;307;123;292162.5;117342.0;409504.5
317190;201801;253;169;84;161226.0;79596.53;240822.53
317200;201801;791;560;231;521848.0;220136.0;741984.0
317210;201801;153;87;66;82044.2;62964.0;145008.2
317220;201801;21;14;7;13356.0;6678.0;20034.0
320010;201801;616;457;159;432640.5;151686.0;584326.5
320013;201801;132;98;34;93492.0;32436.0;125928.0
320016;201801;282;178;104;169812.0;99216.0;269028.0
320020;201801;716;430;286;407670.75;270201.75;677872.5
320030;201801;150;112;38;106848.0;35918.1;142766.1
320035;201801;133;98;35;93492.0;33390.0;126882.0
320040;201801;500;261;239;247849.6;228006.0;475855.6
320050;201801;114;87;27;82998.0;25758.0;108756.0
320060;201801;1517;706;811;673477.0;773017.6;1446494.6
320070;201801;100;70;30;66780.0;28620.0;95400.0
320080;201801;759;434;325;411205.0;310050.0;721255.0
320090;201801;1193;832;361;790374.9;343535.6;1133910.5
320100;201801;314;178;136;169812.0;129744.0;299556.0
320110;201801;140;89;51;83189.2;48654.0;131843.2
320115;201801;112;92;20;87768.0;19080.0;106848.0
320120;201801;3272;1840;1432;1743163.0;1364450.6;3107613.8
320130;201801;7271;3479;3792;3298520.5;3610228.2;6908748.5
320140;201801;416;266;150;252429.2;142856.0;395285.2
320150;201801;1867;1093;774;1034936.0;738355.44;1773291.5
320160;201801;694;314;380;297543.84;361167.28;658711.1
320170;201801;114;88;26;83189.0;24804.0;107993.0
320180;201801;53;30;23;28620.0;21942.0;50562.0
320190;201801;234;158;76;149959.27;72218.0;222177.27
320200;201801;56;42;14;40068.0;13356.0;53424.0
320210;201801;841;475;366;451624.6;348192.0;799816.6
320220;201801;302;113;189;107802.0;180020.0;287822.0
320225;201801;73;60;13;57240.0;12402.0;69642.0
320230;201801;546;351;195;333518.4;185220.0;518738.4
320240;201801;3112;1568;1544;1493392.8;1470309.8;2963702.5
320245;201801;450;315;135;299365.4;128790.0;428155.4
320250;201801;221;116;105;109710.6;100170.0;209880.6
320255;201801;146;116;30;109357.02;28477.0;137834.02
320260;201801;175;123;52;117342.0;49560.3;166902.3
320265;201801;160;128;32;121302.0;30528.0;151830.0
320270;201801;151;125;26;119250.0;24804.0;144054.0
320280;201801;940;570;370;538152.4;351864.03;890016.44
320290;201801;65;55;10;52470.0;9540.0;62010.0
320300;201801;535;380;155;361061.3;146602.1;507663.4
320305;201801;656;354;302;337716.0;287918.0;625634.0
320310;201801;210;119;91;112006.28;86058.0;198064.28
320313;201801;300;152;148;145008.0;140906.0;285914.0
320316;201801;109;90;19;85860.0;18126.0;103986.0
320320;201801;3305;1505;1800;1429799.8;1714211.0;3144010.8
320330;201801;259;191;68;181551.3;62964.91;244516.2
320332;201801;882;536;346;509201.6;329035.3;838236.9
320334;201801;238;145;93;138044.0;88722.0;226766.0
320335;201801;146;105;41;98977.9;39114.0;138091.9
320340;201801;591;410;181;389996.0;172007.0;562003.0
320350;201801;963;414;549;392476.88;523220.47;915697.4
320360;201801;165;92;73;87482.0;69642.0;157124.0
320370;201801;244;187;57;176706.0;53345.0;230051.0
320380;201801;283;192;91;181737.8;86814.0;268551.8
320390;201801;1111;680;431;648348.0;409351.94;1057699.9
320400;201801;323;234;89;222283.0;84906.0;307189.0
320405;201801;885;376;509;358700.0;485273.9;843973.94
320410;201801;962;491;471;466725.4;448963.34;915688.75
320420;201801;479;246;233;234207.4;222282.0;456489.4
320425;201801;194;104;90;99216.0;85860.0;185076.0
320430;201801;393;223;170;211120.7;162180.0;373300.7
320435;201801;165;111;54;105073.56;51516.0;156589.56
320440;201801;200;122;78;116101.8;74126.0;190227.8
320450;201801;129;76;53;72504.0;50562.0;123066.0
320455;201801;245;198;47;187939.0;44838.0;232777.0
320460;201801;242;154;88;146916.0;83952.0;230868.0
320465;201801;113;76;37;72141.48;35298.0;107439.48
320470;201801;629;400;229;381296.25;218462.0;599758.25
320480;201801;173;115;58;109710.0;55332.0;165042.0
320490;201801;2997;1497;1500;1423750.8;1428102.5;2851853.2
320495;201801;88;56;32;53405.0;30528.0;83933.0
320500;201801;9329;4727;4602;4484341.5;4378278.0;8862619.0
320501;201801;540;275;265;262350.0;252810.0;515160.0
320503;201801;274;197;77;186984.2;73458.0;260442.2
320506;201801;252;193;59;184122.0;56286.0;240408.0
320510;201801;925;444;481;420667.3;457348.1;878015.4
320515;201801;79;66;13;62010.9;12402.0;74412.9
320517;201801;203;143;60;136422.0;57240.0;193662.0
320520;201801;6744;3009;3735;2856368.5;3554855.2;6411224.0
320530;201801;5198;2619;2579;2489784.0;2457125.2;4946909.0
330010;201801;2995;1559;1436;1479626.5;1367146.4;2846773.0
330015;201801;156;62;94;57884.78;89676.0;147560.78
330020;201801;3533;1539;1994;1464964.9;1901704.0;3366668.8
330022;201801;212;119;93;112811.0;87768.8;200579.8
330023;201801;522;184;338;174343.8;322452.0;496795.8
330025;201801;535;121;414;115434.0;394383.8;509817.8
330030;201801;1918;1221;697;1156539.2;661669.7;1818209.0
330040;201801;2297;1165;1132;1109306.1;1078641.0;2187947.0
330045;201801;8261;2600;5661;2471989.2;5394461.0;7866450.0
330050;201801;797;504;293;480816.0;279522.0;760338.0
330060;201801;878;547;331;518023.9;315125.28;833149.2
330070;201801;3422;1310;2112;1244276.5;2013533.5;3257810.0
330080;201801;1482;701;781;663491.3;743834.4;1407325.8
330090;201801;351;213;138;203202.0;131652.0;334854.0
330093;201801;288;129;159;123066.0;151650.0;274716.0
330095;201801;101;53;48;50562.0;45792.0;96354.0
330100;201801;9461;4886;4575;4652773.5;4360687.0;9013460.0
330110;201801;475;212;263;201532.5;250902.0;452434.5
330115;201801;522;308;214;293832.0;204156.0;497988.0
330120;201801;375;193;182;182977.2;172864.8;355842.0
330130;201801;1504;425;1079;404724.97;1029330.0;1434055.0
330140;201801;593;311;282;296676.0;268075.0;564751.0
330150;201801;448;266;182;251856.0;172674.0;424530.0
330160;201801;204;126;78;120204.0;74412.0;194616.0
330170;201801;26615;9413;17202;8959011.0;1,64E+14;2,54E+13
330180;201801;234;147;87;136737.5;82282.5;219020.0
330185;201801;771;327;444;310422.8;422308.8;732731.6
330187;201801;278;91;187;86814.0;178398.0;265212.0
330190;201801;5543;2220;3323;2107993.2;3166846.8;5274840.0
330200;201801;4369;1533;2836;1457660.1;2700863.8;4158524.0
330205;201801;388;240;148;228530.7;140906.0;369436.7
330210;201801;995;604;391;570687.6;371439.9;942127.5
330220;201801;2513;1506;1007;1433338.5;959724.2;2393062.8
330225;201801;550;307;243;292239.0;231154.2;523393.2
330227;201801;2465;795;1670;755272.44;1592824.2;2348096.8
330230;201801;198;122;76;115721.0;72504.0;188225.0
330240;201801;3604;1883;1721;1790851.2;1638817.6;3429669.0
330245;201801;152;64;88;61056.0;83188.8;144244.8
330250;201801;6450;3364;3086;3198248.0;2934900.5;6133148.5
330260;201801;562;169;393;161226.0;374922.0;536148.0
330270;201801;3313;1229;2084;1171609.0;1987565.2;3159174.2
330280;201801;439;287;152;270861.28;144999.0;415860.28
330285;201801;6994;2326;4668;2214982.5;4450948.5;6665931.0
330290;201801;571;223;348;211789.0;331992.0;543781.0
330300;201801;745;503;242;476046.7;230850.0;706896.7
330310;201801;408;237;171;224190.7;163134.0;387324.7
330320;201801;8050;3016;5034;2869350.8;4796504.0;7665855.0
330330;201801;9246;3618;5628;3445717.5;5364707.0;8810425.0
330340;201801;2635;1581;1054;1506071.0;1005496.94;2511568.0
330350;201801;17772;7027;10745;6677803.5;1,02E+14;1,69E+13
330360;201801;2595;1276;1319;1216140.4;1258317.0;2474457.5
330370;201801;965;533;432;507718.8;410125.6;917844.4
330380;201801;841;367;474;349392.97;451576.8;800969.75
330385;201801;604;317;287;301465.0;273798.0;575263.0
330390;201801;5134;2856;2278;2710798.8;2170650.5;4881449.0
330395;201801;245;155;90;146153.1;84095.2;230248.3
330400;201801;653;335;318;316156.6;301477.84;617634.44
330410;201801;506;360;146;341772.0;138508.12;480280.12
330411;201801;235;135;100;128609.0;95352.3;223961.3
330412;201801;253;108;145;102746.0;138330.0;241076.0
330414;201801;6188;2509;3679;2389714.8;3507786.2;5897501.0
330415;201801;559;266;293;253764.0;278568.8;532332.8
330420;201801;2269;1200;1069;1141648.9;1017147.0;2158796.0
330430;201801;1799;823;976;783807.0;928733.0;1712540.0
330440;201801;261;121;140;115434.0;133560.0;248994.0
330450;201801;120;48;72;45792.0;68688.0;114480.0
330452;201801;1687;787;900;749084.2;858295.9;1607380.0
330455;201801;110256;39377;70879;3,75E+14;6,76E+12;1,05E+16
330460;201801;262;105;157;100170.0;149778.0;249948.0
330470;201801;1235;675;560;637657.0;534230.44;1171887.5
330475;201801;1385;377;1008;357694.16;961059.6;1318753.8
330480;201801;745;397;348;378070.2;331038.8;709109.0
330490;201801;13465;4745;8720;4519924.0;8312261.5;1,28E+14
330500;201801;1336;613;723;584802.0;689361.0;1274163.0
330510;201801;11230;3744;7486;3564058.0;7134953.5;1,07E+14
330513;201801;103;51;52;48654.0;49608.0;98262.0
330515;201801;852;353;499;332737.8;475665.0;808402.8
330520;201801;2438;915;1523;872691.0;1452798.9;2325490.0
330530;201801;226;118;108;112572.0;102842.0;215414.0
330540;201801;350;175;175;166950.0;166473.0;333423.0
330550;201801;3101;1099;2002;1045728.2;1907857.2;2953585.5
330555;201801;744;275;469;262331.0;446472.8;708803.8
330560;201801;548;209;339;199386.0;323388.0;522774.0
330570;201801;249;171;78;163134.0;74412.0;237546.0
330575;201801;808;334;474;318398.0;450141.5;768539.5
330580;201801;3355;1888;1467;1794296.0;1397754.2;3192050.2
330590;201801;306;154;152;146916.0;145008.0;291924.0
330600;201801;1093;706;387;671387.25;367510.38;1038897.6
330610;201801;1520;841;679;795142.44;643617.9;1438760.4
330615;201801;188;140;48;133560.0;45792.0;179352.0
330620;201801;953;449;504;425963.4;479385.8;905349.2
330630;201801;3762;2386;1376;2260657.2;1305166.5;3565824.0
350010;201801;590;384;206;364980.2;196524.0;561504.2
350020;201801;40;21;19;20034.0;18126.0;38160.0
350030;201801;521;337;184;320354.0;174346.66;494700.66
350040;201801;126;47;79;44494.56;75366.0;119860.56
350050;201801;290;161;129;153594.0;122809.46;276403.47
350055;201801;84;46;38;43884.0;36252.0;80136.0
350060;201801;73;28;45;26712.0;42930.0;69642.0
350070;201801;795;467;328;441213.12;311245.56;752458.7
350075;201801;66;43;23;41022.0;21942.0;62964.0
350080;201801;51;32;19;29891.96;18126.0;48017.96
350090;201801;99;56;43;53424.0;41017.23;94441.23
350100;201801;297;185;112;175774.5;106848.0;282622.5
350110;201801;59;37;22;35298.0;20988.0;56286.0
350115;201801;152;93;59;88054.2;56286.0;144340.2
350120;201801;112;75;37;71550.0;35298.0;106848.0
350130;201801;359;173;186;164470.0;177444.0;341914.0
350140;201801;34;20;14;18317.0;13356.0;31673.0
350150;201801;72;57;15;54378.0;14310.0;68688.0
350160;201801;2457;950;1507;903231.2;1436336.6;2339567.8
350170;201801;397;244;153;230582.0;145676.0;376258.0
350180;201801;185;97;88;92538.0;83952.0;176490.0
350190;201801;963;490;473;465458.62;450941.5;916400.1
350200;201801;71;26;45;24804.0;42665.08;67469.08
350210;201801;1350;760;590;718293.1;562342.7;1280635.8
350220;201801;668;574;94;543458.75;89676.0;633134.75
350230;201801;79;57;22;54378.0;20988.0;75366.0
350240;201801;62;47;15;44838.0;14310.0;59148.0
350250;201801;1214;614;600;579084.4;571676.06;1150760.4
350260;201801;93;66;27;62964.0;25758.0;88722.0
350270;201801;827;543;284;516944.6;269486.9;786431.5
350275;201801;293;115;178;109329.0;169812.0;279141.0
350280;201801;4680;2384;2296;2262177.0;2186607.8;4448784.5
350290;201801;397;187;210;178107.23;199767.8;377875.03
350300;201801;45;25;20;23850.0;19080.0;42930.0
350310;201801;96;69;27;65540.0;25758.0;91298.0
350315;201801;39;24;15;22896.0;14310.0;37206.0
350320;201801;3251;1608;1643;1529502.8;1566889.2;3096392.0
350330;201801;1670;888;782;843051.94;744724.06;1587776.0
350335;201801;21;14;7;13356.0;6678.0;20034.0
350340;201801;129;62;67;59148.0;63918.0;123066.0
350350;201801;96;47;49;44838.0;46746.0;91584.0
350360;201801;128;88;40;83948.0;37977.0;121925.0
350370;201801;97;57;40;53741.96;38150.46;91892.42
350380;201801;737;310;427;295072.2;406594.8;701667.0
350390;201801;1407;574;833;546800.4;793537.4;1340337.8
350395;201801;26;19;7;18126.0;6678.0;24804.0
350400;201801;1693;908;785;856626.9;745338.2;1601965.0
350410;201801;2225;998;1227;949002.94;1170239.0;2119242.0
350420;201801;235;145;90;137727.0;85860.0;223587.0
350430;201801;74;44;30;41404.0;28620.0;70024.0
350440;201801;152;112;40;105846.5;38160.0;144006.5
350450;201801;1599;1005;594;951550.94;566581.0;1518132.0
350460;201801;335;121;214;115434.0;203869.8;319303.8
350470;201801;14;10;4;9540.0;3816.0;13356.0
350480;201801;158;88;70;83952.0;66780.0;150732.0
350490;201801;245;121;124;114480.8;118296.0;232776.8
350500;201801;38;18;20;17172.0;19080.0;36252.0
350510;201801;167;112;55;106848.0;52470.0;159318.0
350520;201801;448;207;241;194297.95;229277.95;423575.9
350530;201801;452;213;239;203202.0;228006.0;431208.0
350535;201801;62;49;13;46202.22;12402.0;58604.22
350540;201801;374;189;185;179492.05;176204.0;355696.03
350550;201801;2728;1602;1126;1520442.9;1073195.1;2593638.0
350560;201801;627;436;191;415939.22;181856.25;597795.5
350570;201801;4199;1742;2457;1656398.0;2341471.2;3997869.2
350580;201801;365;173;192;164089.0;183154.45;347243.47
350590;201801;897;487;410;464598.0;390186.0;854784.0
350600;201801;6150;3091;3059;2934613.2;2914831.8;5849445.0
350610;201801;1542;779;763;737568.6;727893.0;1465461.6
350620;201801;39;27;12;25758.0;11448.0;37206.0
350630;201801;240;137;103;129744.96;97309.0;227053.95
350635;201801;845;332;513;316442.0;488755.22;805197.2
350640;201801;121;88;33;83952.0;31482.0;115434.0
350650;201801;1881;1239;642;1178282.1;610832.75;1789114.9
350660;201801;753;343;410;326582.8;390182.0;716764.8
350670;201801;314;162;152;154310.0;145008.0;299318.0
350680;201801;174;96;78;91584.0;74412.0;165996.0
350690;201801;194;96;98;91584.0;93492.0;185076.0
350700;201801;693;343;350;323887.94;333900.0;657787.94
350710;201801;320;131;189;124401.6;180306.0;304707.6
350715;201801;50;43;7;41022.0;6678.0;47700.0
350720;201801;17;13;4;12402.0;3816.0;16218.0
350730;201801;42;26;16;24804.0;15264.0;40068.0
350740;201801;207;115;92;109414.26;87768.0;197182.27
350745;201801;22;12;10;11424.0;9540.0;20964.0
350750;201801;2124;1372;752;1300600.8;716771.94;2017372.8
350760;201801;3721;1611;2110;1535273.4;2010736.5;3546009.8
350770;201801;60;40;20;38160.0;19080.0;57240.0
350775;201801;48;35;13;33390.0;12393.0;45783.0
350780;201801;419;207;212;197478.0;202248.0;399726.0
350790;201801;369;159;210;151686.0;200340.0;352026.0
350800;201801;431;240;191;228960.0;182214.0;411174.0
350810;201801;513;410;103;390187.0;98262.0;488449.0
350820;201801;85;51;34;48654.0;32436.0;81090.0
350830;201801;80;46;34;43884.0;32436.0;76320.0
350840;201801;708;325;383;310050.0;364142.0;674192.0
350850;201801;1749;1009;740;956578.3;705690.44;1662268.8
350860;201801;573;335;238;317664.72;227052.0;544716.75
350870;201801;438;298;140;284292.0;133273.8;417565.8
350880;201801;284;154;130;144056.1;123352.2;267408.3
350890;201801;43;26;17;24804.0;16218.0;41022.0
350900;201801;1461;474;987;450209.94;940834.8;1391044.8
350910;201801;28;18;10;17172.0;9540.0;26712.0
350920;201801;596;333;263;317364.03;250902.0;568266.06
350925;201801;1162;626;536;594162.3;509913.4;1104075.8
350930;201801;96;58;38;55332.0;36252.0;91584.0
350940;201801;705;395;310;375303.6;293899.6;669203.2
350945;201801;106;79;27;74830.0;25758.0;100588.0
350950;201801;15122;7295;7827;6931967.0;7456877.5;1,44E+14
350960;201801;1289;602;687;569626.94;655394.0;1225021.0
350970;201801;1127;609;518;578127.94;493876.47;1072004.4
350980;201801;97;65;32;62010.0;30528.0;92538.0
350990;201801;358;129;229;122181.63;218179.8;340361.44
350995;201801;34;17;17;16218.0;16218.0;32436.0
351000;201801;639;456;183;432800.06;174582.0;607382.06
351010;201801;52;30;22;28620.0;20988.0;49608.0
351015;201801;58;42;16;40068.0;15264.0;55332.0
351020;201801;1657;958;699;912226.25;664747.4;1576973.6
351030;201801;332;230;102;216844.2;97308.0;314152.2
351040;201801;846;458;388;435978.0;369198.66;805176.7
351050;201801;3254;1571;1683;1491698.8;1603710.0;3095408.8
351060;201801;4912;2035;2877;1930867.9;2741624.0;4672491.5
351070;201801;418;268;150;253451.14;143100.0;396551.12
351080;201801;814;583;231;556182.0;219420.0;775602.0
351090;201801;63;27;36;25758.0;34344.0;60102.0
351100;201801;463;264;199;249634.48;189832.23;439466.72
351110;201801;2111;1024;1087;971649.75;1034361.7;2006011.4
351120;201801;73;39;34;37121.09;32436.0;69557.09
351130;201801;174;59;115;56286.0;109710.0;165996.0
351140;201801;334;233;101;220754.64;96354.0;317108.62
351150;201801;394;202;192;192135.8;183168.0;375303.8
351160;201801;245;160;85;152640.0;81090.0;233730.0
351170;201801;181;94;87;89676.0;82235.0;171911.0
351190;201801;91;62;29;59148.0;27666.0;86814.0
351200;201801;379;249;130;236942.05;124020.0;360962.03
351210;201801;131;61;70;57939.38;66780.0;124719.38
351220;201801;524;316;208;297604.9;198432.0;496036.9
351230;201801;276;202;74;192071.95;70576.92;262648.88
351240;201801;229;99;130;94255.2;124020.0;218275.2
351250;201801;70;49;21;46522.0;19844.0;66366.0
351260;201801;152;111;41;105894.0;38828.0;144722.0
351270;201801;49;20;29;19080.0;27666.0;46746.0
351280;201801;1101;504;597;477003.4;569014.4;1046017.8
351290;201801;224;100;124;95400.0;118010.0;213410.0
351300;201801;3725;1750;1975;1663017.1;1883543.0;3546560.2
351310;201801;760;392;368;373253.0;351072.0;724325.0
351320;201801;106;65;41;62010.0;39114.0;101124.0
351330;201801;41;29;12;27666.0;11448.0;39114.0
351340;201801;1220;763;457;720393.06;434994.22;1155387.4
351350;201801;2437;1320;1117;1257706.8;1065327.0;2323033.8
351360;201801;782;391;391;371106.0;371879.97;742986.0
351370;201801;366;191;175;182209.23;166313.95;348523.2
351380;201801;8876;4062;4814;3860460.2;4583605.0;8444065.0
351385;201801;30;20;10;19080.0;9540.0;28620.0
351390;201801;292;214;78;203202.0;74412.0;277614.0
351400;201801;65;40;25;38160.0;23804.46;61964.46
351410;201801;422;267;155;253206.98;147458.0;400665.0
351420;201801;62;50;12;47700.0;11448.0;59148.0
351430;201801;77;40;37;38160.0;35298.0;73458.0
351440;201801;792;550;242;522505.75;230864.0;753369.75
351450;201801;252;126;126;120204.0;120204.0;240408.0
351460;201801;121;55;66;51755.0;62964.0;114719.0
351470;201801;140;74;66;70587.0;62964.0;133551.0
351480;201801;519;290;229;275420.97;218346.75;493767.72
351490;201801;297;105;192;100170.0;183168.0;283338.0
351492;201801;32;23;9;21942.0;8586.0;30528.0
351495;201801;28;18;10;17172.0;9540.0;26712.0
351500;201801;3554;1537;2017;1460507.8;1919306.4;3379814.0
351510;201801;1769;738;1031;703765.8;981370.25;1685136.0
351512;201801;22;18;4;17172.0;3816.0;20988.0
351515;201801;194;111;83;105894.0;79182.0;185076.0
351518;201801;734;448;286;426434.0;272561.16;698995.2
351519;201801;75;48;27;45792.0;25758.0;71550.0
351520;201801;143;87;56;82361.96;53424.0;135785.95
351530;201801;19;13;6;12402.0;5724.0;18126.0
351535;201801;135;73;62;69642.0;59148.0;128790.0
351540;201801;460;331;129;313391.0;123066.0;436457.0
351550;201801;1311;798;513;756829.94;489202.06;1246032.0
351560;201801;74;38;36;36252.0;34344.0;70596.0
351565;201801;12;7;5;6678.0;4770.0;11448.0
351570;201801;2574;1328;1246;1264588.4;1188017.6;2452606.0
351580;201801;39;35;4;33390.0;3816.0;37206.0
351590;201801;68;45;23;42930.0;21942.0;64872.0
351600;201801;189;142;47;135468.0;44838.0;180306.0
351610;201801;61;30;31;28620.0;29574.0;58194.0
351620;201801;5947;3422;2525;3254559.2;2406627.0;5661186.5
351630;201801;2514;1298;1216;1232977.4;1157865.2;2390842.8
351640;201801;1652;804;848;765131.4;807465.8;1572597.1
351650;201801;30;25;5;23850.0;4770.0;28620.0
351660;201801;158;101;57;95207.0;54378.0;149585.0
351670;201801;746;468;278;444136.0;265212.0;709348.0
351680;201801;75;61;14;58194.0;13356.0;71550.0
351685;201801;43;28;15;26712.0;14310.0;41022.0
351690;201801;310;221;89;208968.94;84906.0;293874.94
351700;201801;162;115;47;109710.0;44838.0;154548.0
351710;201801;74;53;21;50562.0;20034.0;70596.0
351720;201801;133;60;73;57240.0;69642.0;126882.0
351730;201801;100;73;27;68401.96;25753.23;94155.19
351740;201801;716;481;235;457634.97;224185.23;681820.2
351750;201801;365;154;211;145962.05;201294.0;347256.03
351760;201801;799;623;176;594581.0;167768.0;762349.0
351770;201801;289;247;42;235638.0;40068.0;275706.0
351780;201801;169;94;75;89667.0;71550.0;161217.0
351790;201801;242;129;113;123066.0;107802.0;230868.0
351800;201801;54;35;19;33390.0;18126.0;51516.0
351810;201801;123;81;42;77274.0;40068.0;117342.0
351820;201801;889;642;247;607891.4;235347.23;843238.6
351830;201801;503;183;320;173818.8;305280.0;479098.8
351840;201801;1863;943;920;890678.0;876178.94;1766857.0
351850;201801;227;168;59;159652.8;56286.0;215938.8
351860;201801;752;495;257;466444.84;244887.23;711332.06
351870;201801;5624;2653;2971;2521264.8;2828043.8;5349308.5
351880;201801;18908;8305;10603;7900588.0;1,01E+14;1,80E+14
351885;201801;89;61;28;57479.0;26712.0;84191.0
351890;201801;72;61;11;58194.0;10494.0;68688.0
351900;201801;224;133;91;126215.0;86814.0;213029.0
351905;201801;75;34;41;32436.0;39114.0;71550.0
351907;201801;3101;1351;1750;1285349.0;1667707.8;2953056.8
351910;201801;177;73;104;69642.0;99216.0;168858.0
351920;201801;135;79;56;75366.0;53401.69;128767.69
351925;201801;87;60;27;57240.0;25758.0;82998.0
351930;201801;386;264;122;251760.6;116388.0;368148.6
351940;201801;231;107;124;102078.0;118296.0;220374.0
351950;201801;145;84;61;80136.0;58194.0;138330.0
351960;201801;840;392;448;373786.72;425522.38;799309.06
351970;201801;1902;1009;893;960439.8;851627.0;1812066.9
351980;201801;145;73;72;67734.0;68688.0;136422.0
351990;201801;279;188;91;178398.0;86012.64;264410.62
352000;201801;356;214;142;203774.4;135468.0;339242.4
352010;201801;351;210;141;200340.0;134514.0;334854.0
352020;201801;192;68;124;64872.0;118296.0;183168.0
352030;201801;1004;518;486;493456.5;462053.97;955510.44
352040;201801;571;250;321;238500.0;306234.0;544734.0
352042;201801;278;96;182;91584.0;173056.0;264640.0
352044;201801;391;236;155;223989.86;147870.0;371859.88
352050;201801;3142;1281;1861;1214238.0;1774295.2;2988533.2
352060;201801;105;65;40;62010.0;38160.0;100170.0
352070;201801;103;73;30;68372.0;28620.0;96992.0
352080;201801;65;40;25;37206.0;23850.0;61056.0
352090;201801;170;117;53;111618.0;50562.0;162180.0
352100;201801;252;124;128;118292.0;120960.0;239252.0
352110;201801;113;34;79;32436.0;75366.0;107802.0
352115;201801;72;28;44;26712.0;41976.0;68688.0
352120;201801;97;65;32;62010.0;30528.0;92538.0
352130;201801;221;185;36;176299.2;34344.0;210643.2
352140;201801;181;75;106;71073.0;101124.0;172197.0
352150;201801;119;66;53;62010.04;50562.0;112572.04
352160;201801;130;87;43;82998.0;41022.0;124020.0
352170;201801;373;253;120;240408.05;114480.0;354888.03
352180;201801;616;415;201;394956.5;191750.0;586706.5
352190;201801;260;101;159;96344.46;151647.84;247992.3
352200;201801;33;18;15;17172.0;14310.0;31482.0
352210;201801;3748;1556;2192;1476176.8;2086014.4;3562191.0
352215;201801;53;29;24;27666.0;22438.08;50104.08
352220;201801;6913;2729;4184;2598538.5;3989044.5;6587583.0
352230;201801;3170;2022;1148;1915904.0;1089482.9;3005387.0
352240;201801;2208;1299;909;1236766.5;864602.9;2101369.2
352250;201801;2590;1352;1238;1285867.8;1177989.6;2463857.2
352260;201801;1091;600;491;570583.25;468128.0;1038711.25
352265;201801;60;27;33;25758.0;31482.0;57240.0
352270;201801;407;234;173;222282.92;164986.0;387268.9
352280;201801;394;246;148;233413.0;141187.23;374600.22
352290;201801;173;110;63;104368.0;60102.0;164470.0
352300;201801;101;76;25;72504.0;23850.0;96354.0
352310;201801;5758;2817;2941;2674232.8;2799405.5;5473638.5
352320;201801;951;502;449;476269.38;426295.1;902564.5
352330;201801;530;236;294;224810.1;280190.0;505000.1
352340;201801;1391;682;709;647976.0;674336.5;1322312.5
352350;201801;329;207;122;197478.0;116102.0;313580.0
352360;201801;232;96;136;90677.7;126861.32;217539.02
352370;201801;102;69;33;65826.0;31482.0;97308.0
352380;201801;120;75;45;71550.0;42930.0;114480.0
352390;201801;2426;1107;1319;1052577.4;1256133.6;2308711.0
352400;201801;469;203;266;192708.0;253477.8;446185.8
352410;201801;752;539;213;509701.88;202726.0;712427.9
352420;201801;100;64;36;61056.0;34344.0;95400.0
352430;201801;1752;780;972;739037.8;924587.56;1663625.4
352440;201801;3081;1589;1492;1507583.1;1420466.6;2928049.8
352450;201801;189;160;29;152640.0;27666.0;180306.0
352460;201801;566;290;276;276102.7;262589.2;538691.9
352470;201801;588;197;391;187938.0;373005.0;560943.0
352480;201801;1365;763;602;726629.94;573735.8;1300365.8
352490;201801;83;31;52;29574.0;49608.0;79182.0
352500;201801;1212;542;670;515829.0;638023.06;1153852.1
352510;201801;730;395;335;375876.97;319590.0;695466.94
352520;201801;535;238;297;227052.0;283194.9;510246.9
352530;201801;1708;895;813;853162.2;775220.6;1628382.8
352540;201801;76;51;25;48654.0;23850.0;72504.0
352550;201801;183;105;78;100170.0;73744.2;173914.2
352560;201801;49;39;10;37206.0;9540.0;46746.0
352570;201801;661;344;317;327573.0;302418.0;629991.0
352580;201801;57;38;19;35298.65;18126.0;53424.65
352585;201801;16;5;11;4770.0;10494.0;15264.0
352590;201801;4291;2173;2118;2066828.5;2019671.4;4086500.0
352600;201801;359;251;108;238500.95;103032.0;341532.97
352610;201801;930;437;493;414182.56;470322.0;884504.56
352620;201801;962;390;572;371106.2;544482.0;915588.2
352630;201801;219;83;136;79182.0;129495.96;208677.95
352640;201801;559;397;162;376322.4;154548.0;530870.4
352650;201801;87;58;29;55332.0;27666.0;82998.0
352660;201801;82;48;34;45792.0;32436.0;78228.0
352670;201801;1651;900;751;855106.75;715360.6;1570467.4
352680;201801;884;570;314;539594.56;298094.03;837688.6
352690;201801;4332;2004;2328;1903495.1;2216760.5;4120255.8
352700;201801;108;62;46;58861.8;43884.0;102745.8
352710;201801;1351;715;636;680202.0;603594.75;1283796.8
352720;201801;1298;640;658;608016.2;627441.25;1235457.4
352725;201801;25;23;2;21942.0;1908.0;23850.0
352730;201801;361;179;182;169587.81;173628.0;343215.8
352740;201801;414;260;154;246085.69;146916.0;393001.7
352750;201801;23;15;8;14023.8;7632.0;21655.8
352760;201801;195;140;55;133560.0;52470.0;186030.0
352770;201801;81;63;18;60102.0;17172.0;77274.0
352780;201801;80;45;35;42930.0;33390.0;76320.0
352790;201801;28;23;5;21942.0;4770.0;26712.0
352800;201801;249;167;82;159318.0;77941.8;237259.8
352810;201801;165;108;57;100521.42;54378.0;154899.42
352820;201801;65;52;13;49608.0;12402.0;62010.0
352830;201801;89;62;27;59148.0;25758.0;84906.0
352840;201801;589;306;283;290637.2;269982.0;560619.2
352850;201801;1349;485;864;462022.2;824256.0;1286278.2
352860;201801;131;86;45;81408.0;42930.0;124338.0
352870;201801;43;27;16;25758.0;15264.0;41022.0
352880;201801;187;127;60;121138.92;57240.0;178378.92
352885;201801;29;20;9;19080.0;8586.0;27666.0
352890;201801;56;39;17;37206.0;15932.0;53138.0
352900;201801;4904;2380;2524;2252760.8;2400661.0;4653421.5
352910;201801;39;31;8;29574.0;7632.0;37206.0
352920;201801;716;442;274;420714.0;261396.0;682110.0
352930;201801;1263;611;652;581471.4;619039.25;1200510.6
352940;201801;6314;2744;3570;2605870.2;3402423.8;6008294.0
352950;201801;90;35;55;33390.0;52470.0;85860.0
352960;201801;70;46;24;43884.0;22896.0;66780.0
352965;201801;20;8;12;7632.0;11448.0;19080.0
352970;201801;464;350;114;329738.97;107803.0;437541.97
352980;201801;175;92;83;87768.0;79182.0;166950.0
352990;201801;933;426;507;404447.28;482387.1;886834.4
353000;201801;67;31;36;29574.0;34344.0;63918.0
353010;201801;554;347;207;331038.0;197458.92;528496.94
353020;201801;285;210;75;200340.0;71550.0;271890.0
353030;201801;1166;526;640;501480.47;609873.7;1111354.1
353040;201801;88;53;35;50562.0;33390.0;83952.0
353050;201801;1299;816;483;770819.0;460686.6;1231505.6
353060;201801;7837;3602;4235;3421682.8;4033983.2;7455666.0
353070;201801;1646;1035;611;980836.44;581603.4;1562439.9
353080;201801;1302;689;613;654755.56;584798.0;1239553.5
353090;201801;56;34;22;32436.0;20988.0;53424.0
353100;201801;62;51;11;48654.0;10494.0;59148.0
353110;201801;1967;610;1357;580208.9;1291942.2;1872151.1
353120;201801;75;40;35;38160.0;33390.0;71550.0
353130;201801;867;438;429;416879.47;409172.75;826052.25
353140;201801;574;226;348;215543.0;331992.0;547535.0
353150;201801;358;198;160;187938.0;152630.45;340568.47
353160;201801;102;84;18;80136.0;17172.0;97308.0
353170;201801;194;63;131;60102.0;124946.46;185048.45
353180;201801;953;434;519;411742.7;494602.0;906344.7
353190;201801;471;334;137;317483.9;130412.0;447895.9
353200;201801;185;94;91;89676.0;86814.0;176490.0
353205;201801;26;18;8;17172.0;7632.0;24804.0
353210;201801;83;51;32;48654.0;30528.0;79182.0
353215;201801;55;32;23;30528.0;21942.0;52470.0
353220;201801;85;49;36;46746.0;33390.27;80136.27
353230;201801;161;60;101;57240.0;96354.0;153594.0
353240;201801;285;160;125;152640.0;119250.0;271890.0
353250;201801;198;103;95;98262.0;90630.0;188892.0
353260;201801;451;323;128;307007.5;122102.46;429109.97
353270;201801;68;49;19;46746.0;17458.2;64204.2
353280;201801;96;48;48;45315.0;45792.0;91107.0
353282;201801;120;89;31;84906.0;29574.0;114480.0
353284;201801;21;17;4;16218.0;3816.0;20034.0
353286;201801;1;1;0;954.0;0.0;954.0
353290;201801;81;48;33;45792.0;31473.0;77265.0
353300;201801;397;221;176;209292.45;167904.0;377196.47
353310;201801;50;44;6;41976.0;5724.0;47700.0
353320;201801;62;39;23;37206.0;21942.0;59148.0
353325;201801;56;36;20;34335.0;18776.0;53111.0
353330;201801;68;52;16;49465.0;15264.0;64729.0
353340;201801;620;192;428;183168.0;407444.25;590612.25
353350;201801;916;425;491;404630.62;466875.9;871506.56
353360;201801;112;89;23;84588.04;21656.0;106244.04
353370;201801;120;70;50;65826.1;47700.0;113526.1
353380;201801;29;21;8;20030.0;7632.0;27662.0
353390;201801;1046;501;545;477954.0;519930.0;997884.0
353400;201801;51;31;20;29574.0;19080.0;48654.0
353410;201801;122;77;45;73458.0;42883.0;116341.0
353420;201801;58;25;33;23850.0;31482.0;55332.0
353430;201801;548;364;184;343535.3;175249.8;518785.1
353440;201801;10185;4452;5733;4235090.0;5462975.0;9698065.0
353450;201801;57;31;26;29574.0;24804.0;54378.0
353460;201801;605;332;273;313559.1;259717.5;573276.6
353470;201801;2139;1166;973;1108411.9;925827.25;2034239.1
353475;201801;241;162;79;151858.95;75366.0;227224.95
353480;201801;190;151;39;144054.0;37206.0;181260.0
353490;201801;233;140;93;133560.0;88722.0;222282.0
353500;201801;185;110;75;103700.96;71550.0;175250.95
353510;201801;101;73;28;69623.46;26702.46;96325.92
353520;201801;211;143;68;136422.0;64872.0;201294.0
353530;201801;473;257;216;245178.0;206064.0;451242.0
353540;201801;353;235;118;223867.27;112572.0;336439.28
353550;201801;741;501;240;474104.88;228960.0;703064.9
353560;201801;636;269;367;255060.69;349518.06;604578.75
353570;201801;57;30;27;28620.0;25758.0;54378.0
353580;201801;356;272;84;259011.0;80136.0;339147.0
353590;201801;83;56;27;53106.04;25758.0;78864.04
353600;201801;266;148;118;140875.0;111936.0;252811.0
353610;201801;114;59;55;56286.0;52470.0;108756.0
353620;201801;565;307;258;290891.5;245845.8;536737.3
353625;201801;51;29;22;27666.0;20988.0;48654.0
353630;201801;238;172;66;159757.16;62964.0;222721.16
353640;201801;125;87;38;82521.0;36252.0;118773.0
353650;201801;847;332;515;314629.2;491310.0;805939.2
353657;201801;22;16;6;15264.0;5724.0;20988.0
353660;201801;257;142;115;135468.0;109423.8;244891.8
353670;201801;749;445;304;423576.2;290016.0;713592.2
353680;201801;99;70;29;66780.0;27666.0;94446.0
353690;201801;47;37;10;35298.0;9540.0;44838.0
353700;201801;284;198;86;188892.0;82044.0;270936.0
353710;201801;412;195;217;185076.8;206732.0;391808.8
353715;201801;47;35;12;33103.8;11448.0;44551.8
353720;201801;358;168;190;160254.0;181260.0;341514.0
353730;201801;1130;694;436;659166.9;415657.8;1074824.8
353740;201801;653;362;291;345061.8;277614.0;622675.8
353750;201801;92;58;34;54800.14;32436.0;87236.14
353760;201801;2725;1035;1690;985331.1;1608657.2;2593988.5
353770;201801;100;81;19;76797.0;18126.0;94923.0
353780;201801;1103;558;545;530615.94;518022.0;1048638.0
353790;201801;506;288;218;272683.1;204967.34;477650.44
353800;201801;3252;1660;1592;1575610.8;1516388.8;3091999.5
353810;201801;238;133;105;126028.71;100143.0;226171.7
353820;201801;183;91;92;86814.0;87143.41;173957.4
353830;201801;47;40;7;38160.0;6678.0;44838.0
353850;201801;168;87;81;82998.0;77274.0;160272.0
353860;201801;458;206;252;195808.5;240121.8;435930.3
353870;201801;4975;2491;2484;2360279.8;2358407.5;4718687.0
353880;201801;664;474;190;450860.4;180306.12;631166.5
353890;201801;592;334;258;318064.0;245846.0;563910.0
353900;201801;135;66;69;62964.0;65826.0;128790.0
353910;201801;177;88;89;83952.0;84906.0;168858.0
353920;201801;452;249;203;236354.4;193219.16;429573.56
353930;201801;996;597;399;567368.8;379411.8;946780.56
353940;201801;188;104;84;98452.8;79278.0;177730.8
353950;201801;513;317;196;302131.8;186975.0;489106.8
353960;201801;71;59;12;56286.0;11448.0;67734.0
353970;201801;73;47;26;44838.0;24804.0;69642.0
353980;201801;1517;754;763;716656.94;726963.75;1443620.8
353990;201801;78;43;35;41022.0;33390.0;74412.0
354000;201801;373;178;195;169145.0;185835.2;354980.2
354010;201801;95;51;44;48654.0;41499.0;90153.0
354020;201801;547;345;202;328176.0;192708.0;520884.0
354025;201801;52;41;11;39114.0;10494.0;49608.0
354030;201801;65;35;30;33390.0;28620.0;62010.0
354040;201801;92;66;26;62582.4;24804.0;87386.4
354050;201801;192;107;85;101792.0;81090.0;182882.0
354060;201801;773;373;400;355842.0;379359.4;735201.4
354070;201801;883;514;369;488190.0;352026.0;840216.0
354075;201801;210;115;95;109615.0;89676.8;199291.8
354080;201801;293;127;166;120871.8;158364.0;279235.8
354085;201801;19;12;7;11448.0;6678.0;18126.0
354090;201801;314;175;139;166869.0;132606.0;299475.0
354100;201801;5433;2250;3183;2136467.0;3030191.0;5166658.0
354105;201801;80;39;41;37206.0;39114.0;76320.0
354110;201801;48;22;26;20988.0;24804.0;45792.0
354120;201801;150;104;46;99076.97;43884.0;142960.97
354130;201801;695;468;227;446234.0;216268.0;662502.0
354140;201801;3156;1480;1676;1407953.4;1597607.0;3005560.5
354150;201801;641;396;245;377498.0;232299.0;609797.0
354160;201801;701;443;258;421429.5;245846.0;667275.5
354165;201801;19;12;7;11448.0;6678.0;18126.0
354170;201801;171;116;55;109996.2;52470.0;162466.2
354180;201801;63;39;24;36880.0;22896.0;59776.0
354190;201801;217;100;117;93778.2;111618.0;205396.2
354200;201801;129;70;59;66303.0;56286.0;122589.0
354210;201801;71;35;36;33390.0;34344.0;67734.0
354220;201801;641;399;242;378579.16;229342.16;607921.3
354230;201801;158;65;93;62010.0;87768.6;149778.6
354240;201801;315;204;111;193662.48;105257.96;298920.44
354250;201801;91;55;36;52470.0;34344.0;86814.0
354260;201801;1896;880;1016;828901.94;967924.0;1796826.0
354270;201801;97;72;25;68688.0;23850.0;92538.0
354280;201801;34;18;16;17172.0;15264.0;32436.0
354290;201801;145;100;45;94589.1;42930.0;137519.1
354300;201801;419;285;134;271573.0;127678.0;399251.0
354310;201801;104;75;29;70596.2;27666.0;98262.2
354320;201801;180;95;85;90630.0;81090.0;171720.0
354323;201801;16;14;2;13356.0;1908.0;15264.0
354325;201801;109;62;47;58342.0;44838.0;103180.0
354330;201801;2538;859;1679;814851.25;1599596.0;2414447.2
354340;201801;10536;5133;5403;4883521.5;5148588.0;1,00E+14
354350;201801;131;87;44;82998.0;41832.9;124830.9
354360;201801;87;48;39;45792.0;37206.0;82998.0
354370;201801;268;143;125;136422.0;119250.0;255672.0
354380;201801;210;127;83;120372.0;79182.0;199554.0
354390;201801;2760;997;1763;950187.94;1680527.0;2630715.0
354400;201801;322;170;152;161226.8;144435.8;305662.6
354410;201801;608;295;313;279804.44;297648.2;577452.6
354420;201801;271;171;100;163134.0;95400.0;258534.0
354425;201801;319;181;138;172674.0;131652.0;304326.0
354430;201801;185;116;69;109089.9;65062.8;174152.7
354440;201801;40;28;12;26712.0;11448.0;38160.0
354450;201801;52;37;15;35298.0;14310.0;49608.0
354460;201801;101;59;42;56286.0;40068.0;96354.0
354470;201801;37;26;11;24804.0;10494.0;35298.0
354480;201801;118;61;57;58185.0;54368.46;112553.46
354490;201801;147;93;54;88562.97;51516.0;140078.97
354500;201801;398;198;200;188892.0;190800.0;379692.0
354510;201801;103;71;32;67734.0;30528.0;98262.0
354515;201801;37;13;24;12402.0;22896.0;35298.0
354520;201801;1609;715;894;679399.2;852437.56;1531836.8
354530;201801;647;340;307;322639.1;292020.2;614659.3
354540;201801;273;156;117;148824.0;111613.23;260437.23
354550;201801;42;23;19;21942.0;18126.0;40068.0
354560;201801;162;97;65;92252.0;62000.46;154252.45
354570;201801;140;92;48;87768.0;45792.0;133560.0
354580;201801;1959;931;1028;885311.0;980412.25;1865723.2
354600;201801;277;147;130;137984.12;124005.69;261989.81
354610;201801;71;64;7;61056.0;6678.0;67734.0
354620;201801;64;21;43;20034.0;41022.0;61056.0
354625;201801;17;11;6;10494.0;5720.0;16214.0
354630;201801;318;207;111;196972.55;105894.0;302866.56
354640;201801;785;503;282;475936.38;269028.0;744964.4
354650;201801;71;39;32;36911.0;30499.92;67410.92
354660;201801;819;607;212;575056.44;202248.0;777304.44
354670;201801;284;101;183;95401.0;173629.0;269030.0
354680;201801;1243;469;774;447426.0;737919.0;1185345.0
354690;201801;91;62;29;58195.0;27666.0;85861.0
354700;201801;77;57;20;54378.0;19080.0;73458.0
354710;201801;58;40;18;37523.96;17172.0;54695.96
354720;201801;20;19;1;18126.0;954.0;19080.0
354730;201801;1906;804;1102;763859.2;1051117.2;1814976.4
354740;201801;59;43;16;41022.0;15264.0;56286.0
354750;201801;445;263;182;250893.0;173628.0;424521.0
354760;201801;515;317;198;300036.0;188319.8;488355.8
354765;201801;11;5;6;4770.0;5724.0;10494.0
354770;201801;329;227;102;215613.03;96544.8;312157.84
354780;201801;8116;3315;4801;3149056.8;4574354.5;7723411.0
354790;201801;114;68;46;64872.0;43884.0;108756.0
354800;201801;414;230;184;219420.0;175231.0;394651.0
354805;201801;103;53;50;49926.0;47700.0;97626.0
354810;201801;137;80;57;76033.8;54378.0;130411.8
354820;201801;186;81;105;77065.0;100170.0;177235.0
354830;201801;41;21;20;20034.0;19080.0;39114.0
354840;201801;55;37;18;35298.0;17172.0;52470.0
354850;201801;4555;2017;2538;1916430.2;2416975.0;4333405.5
354860;201801;330;160;170;152640.0;159785.52;312425.53
354870;201801;11776;5326;6450;5052766.0;6143065.0;1,12E+14
354880;201801;2994;1125;1869;1071612.5;1781430.9;2853043.2
354890;201801;2823;1558;1265;1480816.6;1205637.4;2686454.0
354900;201801;59;39;20;37206.0;19080.0;56286.0
354910;201801;1217;638;579;605752.25;552366.0;1158118.2
354920;201801;52;44;8;41976.0;7632.0;49608.0
354925;201801;12;7;5;6678.0;4770.0;11448.0
354930;201801;30;27;3;25488.0;2862.0;28350.0
354940;201801;788;578;210;549459.2;200340.0;749799.2
354950;201801;219;145;74;137720.0;70596.0;208316.0
354960;201801;170;63;107;60102.0;101792.0;161894.0
354970;201801;843;551;292;520795.1;277929.03;798724.1
354980;201801;8392;3138;5254;2985078.0;5009612.0;7994690.5
354990;201801;9174;4311;4863;4100522.8;4633223.5;8733746.0
354995;201801;513;181;332;172674.0;316126.97;488800.97
355000;201801;452;148;304;141187.23;289062.0;430249.22
355010;201801;619;391;228;373014.0;215300.48;588314.5
355020;201801;711;444;267;422617.6;254710.0;677327.56
355030;201801;202948;78603;124345;7,48E+14;1,19E+16;1,93E+16
355040;201801;715;340;375;322834.3;357559.2;680393.5
355050;201801;151;100;51;94129.77;48654.0;142783.77
355060;201801;1458;734;724;695386.94;689504.3;1384891.2
355070;201801;1469;727;742;689718.56;706875.0;1396593.6
355080;201801;200;115;85;109710.0;80202.8;189912.8
355090;201801;292;194;98;182978.0;93492.0;276470.0
355100;201801;4758;2370;2388;2240589.5;2276185.5;4516775.0
355110;201801;269;171;98;162177.0;93492.0;255669.0
355120;201801;80;55;25;52470.0;23850.0;76320.0
355130;201801;54;28;26;26712.0;24804.0;51516.0
355140;201801;182;122;60;116388.0;57240.0;173628.0
355150;201801;671;406;265;386080.2;252333.0;638413.2
355160;201801;445;213;232;200817.95;221042.0;421859.97
355170;201801;2036;1052;984;1002228.9;938716.94;1940945.8
355180;201801;623;267;356;253764.0;338789.25;592553.25
355190;201801;221;150;71;143100.0;67734.0;210834.0
355200;201801;116;68;48;64872.0;45792.0;110664.0
355210;201801;724;418;306;398772.0;291905.47;690677.44
355220;201801;6556;3526;3030;3353947.8;2881691.2;6235639.0
355230;201801;108;64;44;61056.0;41971.23;103027.23
355240;201801;4200;1844;2356;1745718.8;2243771.2;3989490.0
355250;201801;5342;2613;2729;2485444.2;2600063.0;5085507.5
355255;201801;51;30;21;28620.0;20034.0;48654.0
355260;201801;185;111;74;104921.12;70568.46;175489.58
355270;201801;166;98;68;93492.0;64157.0;157649.0
355280;201801;6279;2647;3632;2520330.5;3460226.5;5980557.0
355290;201801;78;59;19;56286.0;18126.0;74412.0
355300;201801;180;116;64;109424.6;61056.0;170480.6
355310;201801;104;58;46;55332.0;43884.0;99216.0
355320;201801;91;46;45;43884.0;41982.6;85866.6
355330;201801;270;149;121;142146.0;115434.0;257580.0
355340;201801;1461;545;916;517323.62;873122.0;1390445.6
355350;201801;142;74;68;70596.0;64872.0;135468.0
355360;201801;181;114;67;108546.12;63918.0;172464.12
355365;201801;26;21;5;20034.0;4770.0;24804.0
355370;201801;1027;581;446;548388.2;424226.1;972614.3
355380;201801;771;516;255;490818.53;242984.0;733802.5
355385;201801;59;41;18;39114.0;17172.0;56286.0
355390;201801;105;61;44;58194.0;41976.0;100170.0
355395;201801;187;113;74;106415.23;70596.0;177011.23
355400;201801;1536;958;578;909647.5;550839.8;1460487.4
355410;201801;4830;2252;2578;2130034.0;2450936.2;4580970.0
355420;201801;49;37;12;35298.0;11448.0;46746.0
355430;201801;347;214;133;202820.4;126882.0;329702.4
355440;201801;79;45;34;42930.0;32436.0;75366.0
355450;201801;428;202;226;189703.73;214554.8;404258.53
355460;201801;70;54;16;50562.42;15264.0;65826.42
355465;201801;50;31;19;29574.0;18126.0;47700.0
355470;201801;187;73;114;68688.1;108756.0;177444.1
355475;201801;12;8;4;7632.0;3816.0;11448.0
355480;201801;459;200;259;189179.0;245645.45;434824.47
355490;201801;115;82;33;78228.0;31482.0;109710.0
355495;201801;52;25;27;23850.0;25758.0;49608.0
355500;201801;1701;973;728;923366.44;694473.44;1617839.9
355510;201801;271;196;75;183525.67;71550.0;255075.67
355520;201801;36;28;8;26426.0;7632.0;34058.0
355530;201801;23;16;7;15264.0;6678.0;21942.0
355535;201801;78;39;39;37206.0;37206.0;74412.0
355540;201801;2343;935;1408;890531.5;1341019.4;2231551.0
355550;201801;63;38;25;36252.0;23850.0;60102.0
355560;201801;240;120;120;114480.0;113843.96;228323.95
355570;201801;31;20;11;19080.0;10494.0;29574.0
355580;201801;267;185;82;176490.0;77937.23;254427.23
355590;201801;23;14;9;13356.0;8586.0;21942.0
355600;201801;271;141;130;134514.0;123729.23;258243.23
355610;201801;207;136;71;129744.0;67734.0;197478.0
355620;201801;1255;583;672;555371.8;640006.0;1195377.8
355630;201801;403;290;113;275707.0;107802.0;383509.0
355635;201801;126;61;65;58194.0;61997.0;120191.0
355640;201801;569;333;236;316728.16;225144.0;541872.2
355645;201801;826;357;469;338886.0;445546.8;784432.8
355650;201801;2102;896;1206;851227.8;1150505.5;2001733.2
355660;201801;262;139;123;132606.0;117342.0;249948.0
355670;201801;485;187;298;178398.0;284292.0;462690.0
355680;201801;207;119;88;112572.58;83666.0;196238.58
355690;201801;87;40;47;38160.0;44838.0;82998.0
355695;201801;14;12;2;11448.0;1908.0;13356.0
355700;201801;1135;582;553;550158.6;526990.0;1077148.6
355710;201801;2187;1201;986;1142403.5;940043.8;2082447.4
355715;201801;20;18;2;17172.0;1908.0;19080.0
355720;201801;206;123;83;115752.08;79178.0;194930.08
355730;201801;91;52;39;48447.95;37206.0;85653.95
410010;201801;136;114;22;108756.0;20988.0;129744.0
410020;201801;105;94;11;89676.0;10494.0;100170.0
410030;201801;163;103;60;97594.4;57240.0;154834.4
410040;201801;968;528;440;503473.5;419570.0;923043.5
410045;201801;26;21;5;20034.0;4770.0;24804.0
410050;201801;467;261;206;248994.0;196047.0;445041.0
410060;201801;274;212;62;202248.0;59148.0;261396.0
410070;201801;311;257;54;245178.0;51516.0;296694.0
410080;201801;166;108;58;103032.0;55332.0;158364.0
410090;201801;77;68;9;64663.0;8586.0;73249.0
410100;201801;297;211;86;200979.19;81328.5;282307.7
410105;201801;43;25;18;23850.0;17172.0;41022.0
410110;201801;312;192;120;183168.0;114480.0;297648.0
410115;201801;25;18;7;17172.0;6678.0;23850.0
410120;201801;448;229;219;218164.8;208926.0;427090.8
410130;201801;42;26;16;24804.0;15264.0;40068.0
410140;201801;3080;1515;1565;1440385.6;1489662.0;2930047.8
410150;201801;2688;1079;1609;1028213.44;1534676.0;2562889.5
410160;201801;503;321;182;305947.8;173628.0;479575.8
410165;201801;67;45;22;42930.0;20988.0;63918.0
410170;201801;168;126;42;117966.44;40068.0;158034.44
410180;201801;2149;1247;902;1185227.2;858574.1;2043801.4
410185;201801;32;29;3;27666.0;2862.0;30528.0
410190;201801;442;276;166;263304.0;158364.0;421668.0
410200;201801;973;725;248;690800.94;236305.8;927106.75
410210;201801;556;286;270;272844.0;257008.0;529852.0
410220;201801;40;22;18;20988.0;17172.0;38160.0
410230;201801;125;69;56;65826.0;53424.0;119250.0
410240;201801;733;481;252;458301.8;240408.0;698709.8
410250;201801;379;278;101;264607.84;96349.23;360957.06
410260;201801;283;170;113;162180.0;107802.0;269982.0
410270;201801;28;17;11;16218.0;10494.0;26712.0
410275;201801;68;51;17;48654.0;16218.0;64872.0
410280;201801;322;179;143;170506.52;136422.0;306928.53
410290;201801;233;148;85;141192.0;81090.0;222282.0
410300;201801;83;67;16;63918.0;15264.0;79182.0
410302;201801;24;16;8;15264.0;7632.0;22896.0
410304;201801;45;31;14;29574.0;13356.0;42930.0
410305;201801;205;111;94;105086.2;89676.0;194762.2
410310;201801;262;168;94;160272.0;89656.92;249928.92
410315;201801;54;39;15;37182.0;14310.0;51492.0
410320;201801;139;98;41;93492.0;39114.0;132606.0
410322;201801;34;24;10;22896.0;9540.0;32436.0
410330;201801;164;116;48;110664.0;45602.0;156266.0
410335;201801;98;59;39;56286.0;37206.0;93492.0
410337;201801;38;33;5;31482.0;4770.0;36252.0
410340;201801;33;31;2;29574.0;1908.0;31482.0
410345;201801;215;137;78;130698.0;74412.0;205110.0
410347;201801;52;39;13;37206.0;12402.0;49608.0
410350;201801;231;141;90;134228.0;85860.0;220088.0
410360;201801;456;275;181;259806.4;172102.0;431908.4
410370;201801;2382;1013;1369;963760.3;1302960.6;2266721.0
410380;201801;218;143;75;136422.0;71550.0;207972.0
410390;201801;370;279;91;266162.0;86814.0;352976.0
410395;201801;34;22;12;20988.0;11067.0;32055.0
410400;201801;830;425;405;404120.4;385831.0;789951.4
410405;201801;89;65;24;62010.0;22896.0;84906.0
410410;201801;41;32;9;30528.0;8586.0;39114.0
410420;201801;1657;817;840;777323.9;799770.94;1577094.9
410425;201801;182;88;94;83762.0;89676.0;173438.0
410430;201801;2199;1285;914;1222742.0;870792.3;2093534.4
410440;201801;395;287;108;272845.0;103032.0;375877.0
410442;201801;359;241;118;228961.0;112572.0;341533.0
410445;201801;424;291;133;277614.0;126882.0;404496.0
410450;201801;410;199;211;189846.0;201294.0;391140.0
410460;201801;407;218;189;207676.8;180306.0;387982.8
410465;201801;193;125;68;118009.8;64872.0;182881.8
410470;201801;220;140;80;133560.0;76320.0;209880.0
410480;201801;5729;2831;2898;2680726.5;2758572.8;5439299.0
410490;201801;1383;915;468;871127.0;444565.0;1315692.0
410500;201801;265;154;111;146916.0;105894.0;252810.0
410510;201801;180;133;47;126882.0;44829.0;171711.0
410520;201801;262;195;67;186030.0;63918.0;249948.0
410530;201801;234;87;147;82998.0;140234.0;223232.0
410540;201801;317;228;89;216931.6;84901.23;301832.84
410550;201801;1603;698;905;665510.8;862263.4;1527774.1
410560;201801;145;114;31;108756.0;29574.0;138330.0
410570;201801;435;308;127;291744.2;121158.0;412902.2
410580;201801;3171;1427;1744;1359742.8;1662346.0;3022088.8
410590;201801;400;287;113;273798.0;107802.0;381600.0
410600;201801;182;158;24;150732.0;22896.0;173628.0
410610;201801;55;44;11;41976.0;10494.0;52470.0
410620;201801;238;172;66;164088.0;62964.0;227052.0
410630;201801;447;264;183;251856.0;173423.0;425279.0
410640;201801;973;597;376;566560.0;357097.28;923657.25
410645;201801;96;72;24;68307.0;22896.0;91203.0
410650;201801;365;251;114;238500.0;108756.0;347256.0
410655;201801;79;61;18;58194.0;17172.0;75366.0
410657;201801;44;20;24;19080.0;22896.0;41976.0
410660;201801;589;419;170;398483.0;162180.0;560663.0
410670;201801;77;63;14;60102.0;13356.0;73458.0
410680;201801;190;158;32;150732.0;30528.0;181260.0
410685;201801;16;10;6;9540.0;5724.0;15264.0
410690;201801;28443;12342;16101;1,18E+14;1,53E+14;2,71E+13
410700;201801;321;235;86;223618.0;82044.0;305662.0
410710;201801;126;101;25;96354.0;23850.0;120204.0
410712;201801;23;14;9;13356.0;8586.0;21942.0
410715;201801;83;61;22;58194.0;20988.0;79182.0
410720;201801;588;354;234;337716.0;222686.55;560402.56
410725;201801;179;129;50;123066.0;47700.0;170766.0
410730;201801;87;54;33;51516.0;31482.0;82998.0
410740;201801;112;81;31;77274.0;29574.0;106848.0
410750;201801;220;164;56;156452.0;53419.23;209871.23
410752;201801;24;15;9;14310.0;8586.0;22896.0
410753;201801;53;23;30;21269.43;28620.0;49889.43
410754;201801;33;20;13;19080.0;12402.0;31482.0
410755;201801;81;55;26;52183.8;24804.0;76987.8
410760;201801;712;405;307;386370.0;292878.0;679248.0
410765;201801;1662;799;863;756330.7;822148.44;1578479.1
410770;201801;108;91;17;86814.0;16218.0;103032.0
410773;201801;45;34;11;32436.0;10494.0;42930.0
410775;201801;175;132;43;125260.2;41022.0;166282.2
410780;201801;81;43;38;41022.0;36252.0;77274.0
410785;201801;57;45;12;42930.0;11448.0;54378.0
410790;201801;70;33;37;31482.0;35298.0;66780.0
410800;201801;291;182;109;172675.0;103986.0;276661.0
410810;201801;26;22;4;20988.0;3530.0;24518.0
410820;201801;178;132;46;125785.0;43884.0;169669.0
410830;201801;8505;3875;4630;3688284.8;4414874.0;8103159.0
410832;201801;105;72;33;68401.8;31482.0;99883.8
410840;201801;1405;779;626;740898.06;596805.7;1337703.8
410845;201801;64;39;25;37206.0;23850.0;61056.0
410850;201801;190;131;59;124688.0;56286.0;180974.0
410855;201801;47;40;7;38160.0;6678.0;44838.0
410860;201801;666;391;275;372228.75;262350.0;634578.75
410865;201801;106;82;24;78228.0;22896.0;101124.0
410870;201801;150;131;19;124974.0;17835.0;142809.0
410880;201801;1104;550;554;524189.62;528471.0;1052660.6
410890;201801;74;51;23;48654.0;21942.0;70596.0
410895;201801;74;55;19;52470.0;18126.0;70596.0
410900;201801;19;13;6;12402.0;5724.0;18126.0
410910;201801;17;15;2;14310.0;1908.0;16218.0
410920;201801;33;22;11;20988.0;10494.0;31482.0
410930;201801;503;326;177;310792.97;168858.0;479650.97
410940;201801;4327;2576;1751;2448342.2;1667190.4;4115532.5
410950;201801;127;92;35;87768.0;33390.0;121158.0
410960;201801;763;338;425;322166.0;405260.0;727426.0
410965;201801;63;48;15;45505.8;14310.0;59815.8
410970;201801;628;444;184;423108.2;175536.0;598644.2
410975;201801;105;64;41;60545.0;39114.0;99659.0
410980;201801;1554;702;852;667161.8;811845.25;1479007.0
410990;201801;268;182;86;173459.23;81757.8;255217.05
411000;201801;62;40;22;38160.0;20988.0;59148.0
411005;201801;23;18;5;17172.0;4770.0;21942.0
411007;201801;236;136;100;129744.0;95400.0;225144.0
411010;201801;571;397;174;378738.0;165996.0;544734.0
411020;201801;287;197;90;187938.0;85860.0;273798.0
411030;201801;19;10;9;9540.0;8586.0;18126.0
411040;201801;49;34;15;32436.0;14310.0;46746.0
411050;201801;216;173;43;164364.72;40895.12;205259.84
411060;201801;522;353;169;336753.0;161226.0;497979.0
411065;201801;60;52;8;49608.0;7632.0;57240.0
411070;201801;1195;803;392;761866.0;373014.0;1134880.0
411080;201801;244;173;71;165126.0;67734.0;232860.0
411090;201801;114;86;28;82044.0;26712.0;108756.0
411095;201801;264;108;156;102555.0;148814.0;251369.0
411100;201801;112;93;19;88722.0;18126.0;106848.0
411110;201801;123;85;38;81090.0;36252.0;117342.0
411120;201801;181;135;46;128790.0;43884.0;172674.0
411125;201801;178;79;99;74717.28;94446.0;169163.28
411130;201801;123;107;16;101440.0;15264.0;116704.0
411140;201801;178;123;55;117108.12;51945.3;169053.42
411150;201801;1210;810;400;772730.44;381600.0;1154330.5
411155;201801;117;83;34;79182.0;32436.0;111618.0
411160;201801;21;10;11;9540.0;10494.0;20034.0
411170;201801;59;53;6;50275.8;5724.0;55999.8
411180;201801;924;607;317;577551.8;302413.22;879965.0
411190;201801;339;193;146;183454.2;139284.0;322738.2
411200;201801;666;443;223;421351.88;211835.9;633187.8
411210;201801;677;361;316;342844.22;301464.0;644308.2
411220;201801;147;111;36;105894.0;34344.0;140238.0
411230;201801;41;37;4;35298.0;3816.0;39114.0
411240;201801;120;81;39;77274.0;37206.0;114480.0
411250;201801;421;306;115;291924.0;109710.0;401634.0
411260;201801;22;16;6;15264.0;5724.0;20988.0
411270;201801;291;156;135;148824.0;128790.0;277614.0
411275;201801;200;176;24;167188.6;22896.0;190084.6
411280;201801;227;162;65;153277.12;62010.0;215287.12
411290;201801;57;42;15;40068.0;14310.0;54378.0
411295;201801;141;113;28;107802.0;26712.0;134514.0
411300;201801;70;36;34;34344.0;32436.0;66780.0
411310;201801;92;70;22;66780.0;20988.0;87768.0
411320;201801;756;549;207;522220.4;195875.28;718095.7
411325;201801;45;27;18;25758.0;17172.0;42930.0
411330;201801;914;584;330;555610.6;314089.6;869700.2
411340;201801;26;18;8;17172.0;7318.0;24490.0
411342;201801;76;55;21;52470.0;20034.0;72504.0
411345;201801;121;58;63;55332.0;60102.0;115434.0
411350;201801;482;385;97;366002.44;91575.2;457577.62
411360;201801;55;36;19;34344.0;18126.0;52470.0
411370;201801;14073;5763;8310;5480043.5;7915303.5;1,34E+14
411373;201801;191;141;50;134514.0;47700.0;182214.0
411375;201801;74;61;13;58194.0;12402.0;70596.0
411380;201801;95;71;24;67734.0;22896.0;90630.0
411390;201801;139;92;47;87768.0;44838.0;132606.0
411400;201801;350;264;86;251847.0;82044.0;333891.0
411410;201801;450;229;221;217798.2;210548.0;428346.2
411420;201801;1029;470;559;446090.4;532237.0;978327.4
411430;201801;399;259;140;246418.2;133551.0;379969.2
411435;201801;36;25;11;23850.0;10494.0;34344.0
411440;201801;471;374;97;355142.75;92538.0;447680.75
411450;201801;429;356;73;339624.0;69642.0;409266.0
411460;201801;739;295;444;280485.2;422293.97;702779.2
411470;201801;89;66;23;62964.0;21942.0;84906.0
411480;201801;624;350;274;332374.6;260823.6;593198.2
411490;201801;290;181;109;172674.0;103986.0;276660.0
411500;201801;111;94;17;89676.0;15837.0;105513.0
411510;201801;217;175;42;166202.06;40068.0;206270.06
411520;201801;5902;2309;3593;2197821.0;3420209.0;5618030.0
411530;201801;109;73;36;69642.0;34344.0;103986.0
411535;201801;45;18;27;17172.0;25758.0;42930.0
411540;201801;346;239;107;226983.9;102078.0;329061.9
411545;201801;57;40;17;38160.0;16218.0;54378.0
411550;201801;73;57;16;54378.0;15264.0;69642.0
411560;201801;383;179;204;170102.38;194616.0;364718.38
411570;201801;787;301;486;286859.0;463454.0;750313.0
411573;201801;37;22;15;20988.0;14310.0;35298.0
411575;201801;261;159;102;151686.0;97308.0;248994.0
411580;201801;1218;482;736;458521.03;701155.0;1159676.0
411585;201801;79;39;40;37206.0;38160.0;75366.0
411590;201801;25;17;8;16218.0;7632.0;23850.0
411600;201801;25;10;15;9540.0;14310.0;23850.0
411605;201801;238;107;131;101935.0;124974.0;226909.0
411610;201801;237;159;78;151686.0;74412.0;226098.0
411620;201801;356;200;156;190609.2;148184.81;338794.03
411630;201801;58;39;19;37206.0;18126.0;55332.0
411640;201801;35;29;6;27666.0;5724.0;33390.0
411650;201801;14;10;4;9540.0;3816.0;13356.0
411660;201801;32;26;6;24804.0;5724.0;30528.0
411670;201801;245;186;59;177444.0;56286.0;233730.0
411680;201801;155;132;23;125928.0;21942.0;147870.0
411690;201801;604;320;284;304681.44;270594.72;575276.2
411695;201801;62;46;16;43884.0;15264.0;59148.0
411700;201801;167;145;22;138330.0;20988.0;159318.0
411705;201801;101;65;36;62010.0;34344.0;96354.0
411710;201801;296;200;96;190484.14;91584.0;282068.12
411720;201801;136;87;49;82998.0;46746.0;129744.0
411721;201801;57;47;10;44838.0;9540.0;54378.0
411722;201801;97;42;55;40068.0;52470.0;92538.0
411725;201801;143;111;32;105578.0;30528.0;136106.0
411727;201801;73;56;17;53424.0;15931.8;69355.8
411729;201801;32;24;8;22896.0;7632.0;30528.0
411730;201801;546;355;191;337079.97;181928.0;519007.97
411740;201801;30;19;11;18126.0;10494.0;28620.0
411745;201801;66;44;22;41185.0;20988.0;62173.0
411750;201801;855;408;447;388135.9;425460.16;813596.06
411760;201801;1176;889;287;846857.2;273789.0;1120646.2
411770;201801;441;293;148;279502.9;141192.0;420694.9
411780;201801;368;238;130;227052.0;124020.0;351072.0
411790;201801;531;297;234;281456.47;223123.14;504579.62
411800;201801;170;133;37;126882.0;35298.0;162180.0
411810;201801;164;127;37;121158.0;35298.0;156456.0
411820;201801;2102;1026;1076;976495.5;1025780.3;2002275.9
411830;201801;12;12;0;11448.0;0.0;11448.0
411840;201801;1958;1216;742;1159110.0;707088.8;1866198.8
411845;201801;50;19;31;18126.0;29574.0;47700.0
411850;201801;1251;721;530;685344.06;503667.03;1189011.1
411860;201801;44;28;16;26426.0;15264.0;41690.0
411870;201801;64;45;19;42930.0;17839.8;60769.8
411880;201801;426;276;150;263048.0;142355.88;405403.88
411885;201801;103;69;34;65826.0;32436.0;98262.0
411890;201801;322;204;118;192422.98;112562.46;304985.44
411900;201801;69;50;19;47700.0;18126.0;65826.0
411910;201801;165;136;29;129734.46;26826.48;156560.94
411915;201801;2078;892;1186;849815.56;1130380.0;1980195.6
411920;201801;124;102;22;97308.0;20988.0;118296.0
411925;201801;14;9;5;8586.0;4770.0;13356.0
411930;201801;795;589;206;560000.0;196524.0;756524.0
411940;201801;587;421;166;401157.0;158339.56;559496.56
411950;201801;896;472;424;449620.2;403510.25;853130.44
411960;201801;970;690;280;655888.0;267120.0;923008.0
411965;201801;23;16;7;15264.0;6678.0;21942.0
411970;201801;71;64;7;61056.0;6678.0;67734.0
411980;201801;196;129;67;123066.0;63918.0;186984.0
411990;201801;4880;2852;2028;2704791.8;1932938.8;4637730.5
411995;201801;459;172;287;164088.0;273798.0;437886.0
412000;201801;289;171;118;162419.56;112562.46;274982.03
412010;201801;45;27;18;25758.0;17172.0;42930.0
412015;201801;45;32;13;30528.0;12402.0;42930.0
412020;201801;28;25;3;23563.8;2862.0;26425.8
412030;201801;64;54;10;51516.0;9540.0;61056.0
412033;201801;55;35;20;33366.0;19080.0;52446.0
412035;201801;66;42;24;40068.0;22896.0;62964.0
412040;201801;35;25;10;23564.0;9540.0;33104.0
412050;201801;201;150;51;143100.0;48654.0;191754.0
412060;201801;747;584;163;554274.75;154511.8;708786.56
412065;201801;51;36;15;34344.0;14310.0;48654.0
412070;201801;153;103;50;97594.2;47700.0;145294.2
412080;201801;279;144;135;137376.0;128790.0;266166.0
412085;201801;32;15;17;14310.0;16218.0;30528.0
412090;201801;738;465;273;441655.2;260442.0;702097.2
412100;201801;247;207;40;196525.0;38160.0;234685.0
412110;201801;71;58;13;55332.0;12402.0;67734.0
412120;201801;313;204;109;194043.6;103986.0;298029.6
412125;201801;76;45;31;42643.8;29574.0;72217.8
412130;201801;48;35;13;33390.0;12402.0;45792.0
412135;201801;28;15;13;14310.0;12402.0;26712.0
412140;201801;303;215;88;204470.81;83952.0;288422.8
412150;201801;259;174;85;165042.05;81090.0;246132.05
412160;201801;81;48;33;45792.0;31482.0;77274.0
412170;201801;633;453;180;432162.0;171720.0;603882.0
412175;201801;39;28;11;26712.0;10494.0;37206.0
412180;201801;197;156;41;148224.61;38493.9;186718.52
412190;201801;331;266;65;253091.44;62010.0;315101.44
412200;201801;190;123;67;117342.0;63918.0;181260.0
412210;201801;74;58;16;55332.0;15264.0;70596.0
412215;201801;245;166;79;158078.0;75079.8;233157.8
412217;201801;70;55;15;52470.0;14310.0;66780.0
412220;201801;822;613;209;584802.0;199386.0;784188.0
412230;201801;337;205;132;193928.2;125909.46;319837.66
412240;201801;1319;650;669;615943.2;636145.44;1252088.6
412250;201801;380;245;135;233730.0;128790.0;362520.0
412260;201801;127;93;34;88722.0;32436.0;121158.0
412265;201801;168;134;34;127836.0;32436.0;160272.0
412270;201801;84;52;32;49608.0;30528.0;80136.0
412280;201801;89;70;19;66780.0;18126.0;84906.0
412290;201801;94;64;30;61056.0;28620.0;89676.0
412300;201801;219;140;79;133560.0;75223.0;208783.0
412310;201801;43;36;7;34344.0;6678.0;41022.0
412320;201801;95;81;14;77274.0;13356.0;90630.0
412330;201801;168;149;19;142146.0;18126.0;160272.0
412340;201801;142;98;44;93492.0;41690.0;135182.0
412350;201801;595;295;300;280428.3;286200.0;566628.3
412360;201801;27;24;3;22896.0;2862.0;25758.0
412370;201801;162;138;24;130698.0;22896.0;153594.0
412380;201801;255;193;62;183835.8;58900.5;242736.3
412382;201801;47;25;22;23850.0;20988.0;44838.0
412385;201801;137;98;39;93492.0;37206.0;130698.0
412390;201801;278;207;71;197478.0;67734.0;265212.0
412395;201801;64;50;14;47700.0;13356.0;61056.0
412400;201801;71;52;19;49608.0;18126.0;67734.0
412402;201801;239;111;128;105889.23;121825.8;227715.03
412405;201801;816;326;490;309546.44;466783.66;776330.06
412410;201801;945;594;351;565150.0;334854.0;900004.0
412420;201801;15;12;3;11448.0;2862.0;14310.0
412430;201801;22;15;7;14310.0;6678.0;20988.0
412440;201801;603;324;279;306760.38;264301.97;571062.3
412450;201801;83;69;14;65826.0;13356.0;79182.0
412460;201801;80;64;16;61056.0;15264.0;76320.0
412470;201801;257;204;53;194616.0;50562.0;245178.0
412480;201801;175;135;40;127836.9;38160.0;165996.9
412490;201801;165;139;26;132606.0;24804.0;157410.0
412500;201801;477;388;89;368863.8;84906.0;453769.8
412510;201801;188;155;33;147123.0;31482.0;178605.0
412520;201801;130;69;61;65826.0;58194.0;124020.0
412530;201801;108;58;50;55332.0;47413.8;102745.8
412535;201801;109;82;27;78210.0;25758.0;103968.0
412540;201801;63;30;33;28620.0;31482.0;60102.0
412545;201801;100;73;27;69642.0;25758.0;95400.0
412550;201801;3479;1577;1902;1500254.8;1813077.9;3313332.8
412555;201801;14;9;5;8586.0;4770.0;13356.0
412560;201801;587;441;146;417857.2;139284.0;557141.2
412570;201801;734;409;325;388335.25;309764.0;698099.25
412575;201801;85;60;25;57240.0;23850.0;81090.0
412580;201801;165;111;54;105894.0;51516.0;157410.0
412590;201801;33;31;2;29574.0;1908.0;31482.0
412600;201801;173;132;41;125928.0;39114.0;165042.0
412610;201801;32;21;11;20034.0;10494.0;30528.0
412620;201801;148;129;19;123066.0;18126.0;141192.0
412625;201801;2178;1172;1006;1115218.8;957846.56;2073065.2
412627;201801;69;56;13;53424.0;12402.0;65826.0
412630;201801;429;287;142;272364.2;135182.0;407546.2
412635;201801;63;20;43;19080.0;41022.0;60102.0
412640;201801;119;79;40;75366.0;38160.0;113526.0
412650;201801;338;212;126;201961.8;120199.23;322161.03
412660;201801;483;289;194;274991.0;185076.0;460067.0
412665;201801;50;44;6;41976.0;5724.0;47700.0
412667;201801;293;198;95;187786.9;90314.92;278101.8
412670;201801;61;51;10;48654.0;9540.0;58194.0
412680;201801;286;226;60;215604.0;57240.0;272844.0
412690;201801;113;74;39;70596.0;36920.0;107516.0
412700;201801;164;110;54;104940.0;51230.0;156170.0
412710;201801;1401;870;531;824544.6;504094.75;1328639.4
412720;201801;228;155;73;147870.0;69642.0;217512.0
412730;201801;205;163;42;155502.0;39114.0;194616.0
412740;201801;412;223;189;212598.9;180306.0;392904.9
412750;201801;463;266;197;252810.0;187938.0;440748.0
412760;201801;254;130;124;124020.0;118296.0;242316.0
412770;201801;2073;1178;895;1119429.0;852286.2;1971715.1
412780;201801;149;117;32;111618.0;30528.0;142146.0
412785;201801;265;136;129;129267.0;123066.0;252333.0
412788;201801;35;20;15;19080.0;14310.0;33390.0
412790;201801;140;115;25;109042.2;23850.0;132892.2
412795;201801;157;117;40;111618.0;38160.0;149778.0
412796;201801;298;206;92;195359.19;87634.44;282993.62
412800;201801;557;363;194;345742.38;185076.0;530818.4
412810;201801;2994;1670;1324;1587629.2;1261851.0;2849480.2
412820;201801;925;604;321;566524.0;304087.88;870611.9
412830;201801;16;13;3;12402.0;2862.0;15264.0
412840;201801;217;156;61;147870.2;58194.0;206064.2
412850;201801;778;529;249;503712.0;237546.0;741258.0
412853;201801;177;94;83;89676.0;79182.0;168858.0
412855;201801;224;122;102;115276.82;97308.0;212584.81
412860;201801;91;68;23;64872.0;21942.0;86814.0
412862;201801;59;44;15;41689.8;14310.0;55999.8
412863;201801;7;6;1;5724.0;954.0;6678.0
412865;201801;42;32;10;30528.0;9540.0;40068.0
412870;201801;108;72;36;68688.0;34344.0;103032.0
412880;201801;105;79;26;75366.0;24804.0;100170.0
420005;201801;34;31;3;29574.0;2290.0;31864.0
420010;201801;366;242;124;229680.34;118296.0;347976.34
420020;201801;76;65;11;62010.0;10494.0;72504.0
420030;201801;28;25;3;23850.0;2862.0;26712.0
420040;201801;107;80;27;76320.0;25758.0;102078.0
420050;201801;55;33;22;31461.89;20947.89;52409.78
420055;201801;20;19;1;18126.0;954.0;19080.0
420060;201801;29;21;8;20034.0;7632.0;27666.0
420070;201801;104;90;14;85860.0;13346.46;99206.46
420075;201801;13;11;2;10494.0;1908.0;12402.0
420080;201801;46;40;6;37253.7;5724.0;42977.7
420090;201801;35;33;2;30704.49;1908.0;32612.49
420100;201801;159;134;25;126882.2;23850.0;150732.2
420110;201801;18;18;0;17172.0;0.0;17172.0
420120;201801;43;32;11;30528.0;10494.0;41022.0
420125;201801;82;65;17;62010.0;16218.0;78228.0
420127;201801;33;30;3;28620.0;2862.0;31482.0
420130;201801;384;247;137;235342.45;130449.96;365792.4
420140;201801;1261;742;519;706257.4;495060.0;1201317.4
420150;201801;48;41;7;39114.0;6678.0;45792.0
420160;201801;40;38;2;36252.0;1908.0;38160.0
420165;201801;18;14;4;13356.0;3816.0;17172.0
420170;201801;63;41;22;39114.0;20988.0;60102.0
420180;201801;23;22;1;20988.0;954.0;21942.0
420190;201801;31;28;3;26712.0;2862.0;29574.0
420195;201801;127;61;66;58194.0;62678.0;120872.0
420200;201801;1271;565;706;535003.6;672200.06;1207203.6
420205;201801;66;33;33;31482.0;31482.0;62964.0
420207;201801;104;59;45;56286.0;42920.46;99206.46
420208;201801;23;18;5;17172.0;3911.4;21083.4
420209;201801;20;16;4;15264.0;3816.0;19080.0
420210;201801;468;223;245;212455.8;233635.14;446090.94
420213;201801;48;38;10;36252.0;9540.0;45792.0
420215;201801;26;22;4;20988.0;3816.0;24804.0
420220;201801;70;45;25;42930.0;23850.0;66780.0
420230;201801;740;424;316;403733.0;301168.47;704901.44
420240;201801;2276;1541;735;1462546.1;700751.2;2163297.2
420243;201801;36;29;7;27666.0;6678.0;34344.0
420245;201801;100;58;42;55332.0;40068.0;95400.0
420250;201801;56;32;24;30528.0;22896.0;53424.0
420253;201801;38;30;8;28620.0;7632.0;36252.0
420257;201801;10;8;2;7632.0;1908.0;9540.0
420260;201801;99;87;12;82998.0;11448.0;94446.0
420270;201801;37;30;7;28616.0;6678.0;35294.0
420280;201801;279;204;75;192873.52;70292.1;263165.62
420285;201801;20;12;8;11448.0;7632.0;19080.0
420287;201801;50;31;19;29574.0;18126.0;47700.0
420290;201801;972;685;287;652508.94;273730.3;926239.25
420300;201801;1384;1089;295;1034614.4;278950.12;1313564.5
420310;201801;56;43;13;41022.0;12402.0;53424.0
420315;201801;34;30;4;28620.0;3816.0;32436.0
420320;201801;849;427;422;406380.16;402584.0;808964.1
420325;201801;0;0;0;0.0;0.0;0.0
420330;201801;119;81;38;77274.0;36137.52;113411.52
420340;201801;159;108;51;102070.0;48625.38;150695.38
420350;201801;247;181;66;170865.12;62964.0;233829.12
420360;201801;747;571;176;542808.2;166283.78;709091.94
420370;201801;106;69;37;65636.0;35012.0;100648.0
420380;201801;1139;817;322;775594.5;306142.03;1081736.5
420390;201801;253;163;90;154243.52;85144.5;239388.02
420395;201801;182;130;52;124020.0;49598.46;173618.45
420400;201801;245;180;65;171148.0;62010.0;233158.0
420410;201801;58;45;13;42930.0;12402.0;55332.0
420415;201801;34;31;3;29574.0;2862.0;32436.0
420417;201801;46;35;11;33390.0;10484.46;43874.46
420419;201801;11;11;0;10494.0;0.0;10494.0
420420;201801;2782;1705;1077;1615574.2;1024884.44;2640458.8
420425;201801;69;59;10;56277.0;9226.26;65503.26
420430;201801;1277;887;390;843206.75;370314.2;1213520.9
420435;201801;15;13;2;12402.0;1908.0;14310.0
420440;201801;109;74;35;69969.56;33217.6;103187.16
420445;201801;23;21;2;20034.0;1908.0;21942.0
420450;201801;77;37;40;35289.0;38160.0;73449.0
420455;201801;248;191;57;182185.92;54304.92;236490.84
420460;201801;2326;1551;775;1474969.5;739125.9;2214095.5
420470;201801;121;86;35;82044.0;33390.0;115434.0
420475;201801;6;6;0;5724.0;0.0;5724.0
420480;201801;841;624;217;588571.94;206064.2;794636.2
420490;201801;113;88;25;83952.0;23850.0;107802.0
420500;201801;680;284;396;269251.2;377784.0;647035.2
420510;201801;20;17;3;16218.0;2862.0;19080.0
420515;201801;25;20;5;19080.0;4770.0;23850.0
420517;201801;12;12;0;11448.0;0.0;11448.0
420519;201801;0;0;0;0.0;0.0;0.0
420520;201801;67;51;16;48654.0;15264.0;63918.0
420530;201801;159;108;51;102078.9;48654.0;150732.9
420535;201801;20;18;2;17172.0;1908.0;19080.0
420540;201801;4708;2774;1934;2635249.5;1840401.0;4475650.5
420543;201801;21;21;0;20034.0;0.0;20034.0
420545;201801;194;137;57;129744.0;54358.92;184102.92
420550;201801;844;674;170;641051.3;162022.73;803074.06
420555;201801;42;30;12;28620.0;11448.0;40068.0
420560;201801;62;49;13;46364.4;12402.0;58766.4
420570;201801;140;79;61;75366.0;58184.46;133550.45
420580;201801;302;134;168;127836.0;159986.0;287822.0
420590;201801;504;360;144;343153.8;137376.0;480529.8
420600;201801;94;48;46;45792.0;43884.0;89676.0
420610;201801;37;35;2;33104.0;1908.0;35012.0
420620;201801;72;59;13;56286.0;12402.0;68688.0
420630;201801;148;106;42;101120.0;40064.0;141184.0
420640;201801;91;81;10;76797.0;9540.0;86337.0
420650;201801;235;126;109;119536.2;103367.23;222903.44
420660;201801;55;41;14;38350.8;13356.0;51706.8
420665;201801;38;29;9;27380.0;8586.0;35966.0
420670;201801;317;237;80;225372.95;76125.11;301498.06
420675;201801;15;14;1;13356.0;954.0;14310.0
420680;201801;36;26;10;24804.0;9540.0;34344.0
420690;201801;176;147;29;140238.0;27666.0;167904.0
420700;201801;615;428;187;408228.3;178174.44;586402.75
420710;201801;147;87;60;82998.0;56953.8;139951.8
420720;201801;107;87;20;82998.0;19080.0;102078.0
420730;201801;523;336;187;319505.6;177093.58;496599.16
420740;201801;45;44;1;41976.0;954.0;42930.0
420750;201801;493;327;166;311671.8;158364.0;470035.8
420757;201801;17;14;3;12545.1;2862.0;15407.1
420760;201801;39;30;9;28620.0;8586.0;37206.0
420765;201801;71;59;12;56286.0;11448.0;67734.0
420768;201801;66;58;8;55332.0;7632.0;62964.0
420770;201801;85;72;13;68688.0;12402.0;81090.0
420775;201801;48;45;3;41976.0;2862.0;44838.0
420780;201801;238;186;52;177434.45;49608.0;227042.45
420785;201801;13;9;4;8586.0;3816.0;12402.0
420790;201801;175;146;29;138943.8;26684.46;165628.27
420800;201801;77;58;19;54568.8;18126.0;72694.8
420810;201801;247;212;35;202239.0;32579.1;234818.1
420820;201801;2318;1389;929;1318753.1;884731.06;2203484.2
420830;201801;550;312;238;295366.84;226088.45;521455.28
420840;201801;142;107;35;102078.0;32686.0;134764.0
420845;201801;450;200;250;190129.06;237260.0;427389.06
420850;201801;224;180;44;171720.0;41976.0;213696.0
420860;201801;62;53;9;50562.0;8586.0;59148.0
420870;201801;118;85;33;81090.0;31482.0;112572.0
420880;201801;171;117;54;110940.66;51516.0;162456.66
420890;201801;864;425;439;402362.62;418797.0;821159.6
420895;201801;10;10;0;9540.0;0.0;9540.0
420900;201801;414;325;89;307991.03;84877.92;392868.97
420910;201801;5808;3247;2561;3087138.2;2438670.5;5525809.0
420915;201801;80;73;7;69642.0;6678.0;76320.0
420917;201801;18;13;5;12402.0;4770.0;17172.0
420920;201801;23;15;8;14310.0;7632.0;21942.0
420930;201801;2608;1585;1023;1504417.1;969108.06;2473525.2
420940;201801;596;434;162;412691.6;152896.08;565587.7
420945;201801;8;6;2;5724.0;1908.0;7632.0
420950;201801;55;49;6;46746.0;5724.0;52470.0
420960;201801;115;89;26;84868.92;24795.0;109663.92
420970;201801;305;245;60;232054.84;57212.46;289267.3
420980;201801;27;26;1;24804.0;954.0;25758.0
420985;201801;65;55;10;52470.0;9540.0;62010.0
420990;201801;67;51;16;48654.0;15264.0;63918.0
421000;201801;32;21;11;20034.0;10494.0;30528.0
421003;201801;68;44;24;41976.0;22887.0;64863.0
421005;201801;8;5;3;4770.0;2862.0;7632.0
421010;201801;767;544;223;517441.6;210682.0;728123.6
421020;201801;29;24;5;22896.0;4770.0;27666.0
421030;201801;128;108;20;102699.0;19080.0;121779.0
421040;201801;68;58;10;55332.0;9540.0;64872.0
421050;201801;310;222;88;209689.2;83952.0;293641.2
421055;201801;27;23;4;21942.0;3816.0;25758.0
421060;201801;83;56;27;53424.0;25758.0;79182.0
421070;201801;51;46;5;43884.0;4770.0;48654.0
421080;201801;35;32;3;30528.0;2862.0;33390.0
421085;201801;24;19;5;18126.0;4770.0;22896.0
421090;201801;42;32;10;30528.0;9540.0;40068.0
421100;201801;123;90;33;85860.0;31482.0;117342.0
421105;201801;219;178;41;169157.34;39090.69;208248.03
421110;201801;111;91;20;86193.9;19080.0;105273.9
421120;201801;152;120;32;113984.46;30508.92;144493.38
421125;201801;14;10;4;9540.0;3816.0;13356.0
421130;201801;798;513;285;488272.06;270850.53;759122.56
421140;201801;29;21;8;19318.5;7632.0;26950.5
421145;201801;40;31;9;29574.0;8586.0;38160.0
421150;201801;108;77;31;73458.0;29574.0;103032.0
421160;201801;61;41;20;39104.46;19080.0;58184.46
421165;201801;18;16;2;15264.0;1908.0;17172.0
421170;201801;192;167;25;158290.84;23841.0;182131.84
421175;201801;147;96;51;91584.0;48615.92;140199.92
421180;201801;56;35;21;33028.0;20034.0;53062.0
421185;201801;17;14;3;13356.0;2862.0;16218.0
421187;201801;0;0;0;0.0;0.0;0.0
421189;201801;38;30;8;28620.0;7622.46;36242.46
421190;201801;1463;900;563;857360.0;536119.56;1393479.6
421200;201801;87;65;22;61057.0;20988.0;82045.0
421205;201801;24;16;8;15264.0;7622.46;22886.46
421210;201801;179;121;58;115434.0;55332.0;170766.0
421220;201801;273;216;57;205197.9;54378.0;259575.9
421223;201801;55;46;9;43884.0;8586.0;52470.0
421225;201801;60;41;19;39114.0;18126.0;57240.0
421227;201801;93;70;23;66780.0;21942.0;88722.0
421230;201801;48;35;13;33390.0;12402.0;45792.0
421240;201801;20;20;0;19080.0;0.0;19080.0
421250;201801;355;219;136;208831.0;128952.18;337783.2
421260;201801;28;23;5;21942.0;4770.0;26712.0
421265;201801;0;0;0;0.0;0.0;0.0
421270;201801;51;46;5;43884.0;4770.0;48654.0
421280;201801;329;188;141;179352.0;132796.8;312148.8
421290;201801;314;210;104;200102.0;97805.76;297907.75
421300;201801;26;21;5;20034.0;4770.0;24804.0
421310;201801;54;41;13;38446.2;12402.0;50848.2
421315;201801;28;20;8;19080.0;7632.0;26712.0
421320;201801;130;94;36;89676.0;34344.0;124020.0
421330;201801;109;85;24;79926.12;22887.0;102813.12
421335;201801;40;26;14;24804.0;13356.0;38160.0
421340;201801;292;197;95;185887.05;90630.0;276517.06
421350;201801;166;99;67;94003.0;63918.0;157921.0
421360;201801;694;512;182;482109.72;173419.45;655529.2
421370;201801;186;143;43;136422.0;40688.1;177110.1
421380;201801;130;104;26;99211.23;24804.0;124015.23
421390;201801;20;16;4;15264.0;3816.0;19080.0
421400;201801;113;95;18;90630.0;17172.0;107802.0
421410;201801;23;18;5;17172.0;4770.0;21942.0
421415;201801;20;19;1;18126.0;954.0;19080.0
421420;201801;149;123;26;116769.6;24517.8;141287.4
421430;201801;14;11;3;10494.0;2862.0;13356.0
421440;201801;61;47;14;44838.0;13356.0;58194.0
421450;201801;99;86;13;82044.0;12402.0;94446.0
421460;201801;59;51;8;47849.77;7632.0;55481.77
421470;201801;70;46;24;43884.0;22896.0;66780.0
421480;201801;634;469;165;446949.0;157401.0;604350.0
421490;201801;22;21;1;19358.0;954.0;20312.0
421500;201801;515;329;186;312778.7;177166.44;489945.12
421505;201801;25;18;7;17172.0;6678.0;23850.0
421507;201801;33;27;6;25758.0;5724.0;31482.0
421510;201801;73;47;26;44838.0;24422.4;69260.4
421520;201801;64;56;8;52661.0;7632.0;60293.0
421530;201801;53;48;5;45124.2;4770.0;49894.2
421535;201801;29;28;1;26445.0;954.0;27399.0
421540;201801;59;52;7;49608.0;6678.0;56286.0
421545;201801;98;76;22;72018.0;20988.0;93006.0
421550;201801;282;204;78;193949.0;74412.0;268361.0
421555;201801;25;20;5;19080.0;4675.0;23755.0
421560;201801;8;8;0;7632.0;0.0;7632.0
421565;201801;123;92;31;87768.0;29574.0;117342.0
421567;201801;28;23;5;21942.0;4770.0;26712.0
421568;201801;33;31;2;29574.0;1908.0;31482.0
421569;201801;8;8;0;7632.0;0.0;7632.0
421570;201801;138;93;45;88722.0;42930.0;131652.0
421575;201801;27;22;5;20725.65;4770.0;25495.65
421580;201801;717;434;283;413082.0;269028.34;682110.3
421590;201801;21;20;1;19080.0;954.0;20034.0
421600;201801;112;76;36;72504.0;33105.0;105609.0
421605;201801;101;72;29;68355.0;27666.0;96021.0
421610;201801;188;148;40;141192.0;38160.0;179352.0
421620;201801;1104;661;443;628094.94;422602.9;1050697.9
421625;201801;21;18;3;17172.0;2862.0;20034.0
421630;201801;276;177;99;168811.0;93588.0;262399.0
421635;201801;17;8;9;7632.0;8586.0;16218.0
421640;201801;100;86;14;82044.0;13356.0;95400.0
421650;201801;276;160;116;152620.92;110644.92;263265.84
421660;201801;2088;1250;838;1189564.1;798184.25;1987748.4
421670;201801;173;126;47;120204.0;44838.0;165042.0
421680;201801;166;151;15;144054.0;14301.0;158355.0
421690;201801;350;242;108;229887.0;102068.58;331955.6
421700;201801;56;34;22;32436.0;20130.0;52566.0
421710;201801;25;25;0;23850.0;0.0;23850.0
421715;201801;11;10;1;9540.0;954.0;10494.0
421720;201801;582;418;164;396155.4;154729.27;550884.7
421725;201801;14;7;7;6678.0;6678.0;13356.0
421730;201801;43;30;13;27890.24;12402.0;40292.24
421740;201801;82;39;43;37206.0;41022.0;78228.0
421750;201801;216;159;57;148954.52;54378.0;203332.52
421755;201801;24;23;1;21942.0;954.0;22896.0
421760;201801;103;73;30;69632.46;28620.0;98252.46
421770;201801;564;381;183;361267.38;174516.3;535783.7
421775;201801;25;16;9;15264.0;8586.0;23850.0
421780;201801;191;150;41;142813.8;39114.0;181927.8
421790;201801;154;129;25;122586.6;23850.0;146436.6
421795;201801;17;14;3;13356.0;2862.0;16218.0
421800;201801;461;296;165;281587.3;157410.0;438997.3
421810;201801;67;54;13;51516.0;12402.0;63918.0
421820;201801;298;202;96;192040.2;91584.0;283624.2
421825;201801;130;108;22;103032.0;20988.0;124020.0
421830;201801;128;98;30;93492.0;28620.0;122112.0
421835;201801;3;3;0;2862.0;0.0;2862.0
421840;201801;61;51;10;48645.0;9540.0;58185.0
421850;201801;78;68;10;64872.0;9536.0;74408.0
421860;201801;41;32;9;30241.8;8586.0;38827.8
421870;201801;978;738;240;695150.6;228102.98;923253.6
421875;201801;51;45;6;42930.0;5724.0;48654.0
421880;201801;162;117;45;111618.0;42644.0;154262.0
421885;201801;27;23;4;21942.0;3816.0;25758.0
421890;201801;113;79;34;75366.0;32436.0;107802.0
421895;201801;38;35;3;33390.0;2862.0;36252.0
421900;201801;149;121;28;115359.3;26667.0;142026.3
421910;201801;64;42;22;40068.0;20988.0;61056.0
421915;201801;32;26;6;24804.0;5724.0;30528.0
421917;201801;40;29;11;27666.0;10494.0;38160.0
421920;201801;32;29;3;27666.0;2862.0;30528.0
421930;201801;753;582;171;553501.25;163097.45;716598.75
421935;201801;57;50;7;47700.0;6678.0;54378.0
421940;201801;39;37;2;35298.0;1908.0;37206.0
421950;201801;830;549;281;517787.75;265578.3;783366.06
421960;201801;39;35;4;33104.0;3816.0;36920.0
421970;201801;373;235;138;223691.12;131621.12;355312.25
421985;201801;29;19;10;18126.0;9540.0;27666.0
422000;201801;0;0;0;0.0;0.0;0.0
430003;201801;205;48;157;45076.5;149778.0;194854.5
430005;201801;36;28;8;26712.0;7632.0;34344.0
430010;201801;280;197;83;187461.0;79182.0;266643.0
430020;201801;151;98;53;93206.0;49608.0;142814.0
430030;201801;126;98;28;93205.8;26712.0;119917.8
430040;201801;2981;1733;1248;1645503.2;1188962.5;2834465.8
430045;201801;69;59;10;56000.0;9540.0;65540.0
430047;201801;6;5;1;4770.0;954.0;5724.0
430050;201801;81;68;13;64872.0;12402.0;77274.0
430055;201801;17;14;3;13356.0;2862.0;16218.0
430057;201801;4;2;2;1908.0;1908.0;3816.0
430060;201801;3699;2199;1500;2090602.8;1427455.6;3518058.2
430063;201801;57;51;6;48654.0;5724.0;54378.0
430064;201801;146;123;23;117342.0;21942.0;139284.0
430066;201801;10;7;3;6678.0;2862.0;9540.0
430070;201801;45;33;12;31482.0;11448.0;42930.0
430080;201801;69;48;21;45092.33;20034.0;65126.33
430085;201801;37;11;26;10494.0;24804.0;35298.0
430087;201801;35;26;9;24661.0;8586.0;33247.0
430090;201801;71;64;7;60769.8;6678.0;67447.8
430100;201801;115;76;39;71550.0;37206.0;108756.0
430105;201801;146;73;73;69642.0;69336.72;138978.72
430107;201801;21;16;5;15264.0;4770.0;20034.0
430110;201801;409;238;171;226241.1;163076.77;389317.88
430120;201801;138;126;12;119250.9;11448.0;130698.9
430130;201801;792;499;293;475425.9;279235.8;754661.7
430140;201801;123;113;10;107802.0;9540.0;117342.0
430150;201801;112;73;39;68879.0;36252.0;105131.0
430155;201801;33;30;3;28620.0;2862.0;31482.0
430160;201801;3810;2243;1567;2119124.0;1490844.6;3609968.8
430163;201801;325;144;181;136231.94;172616.77;308848.7
430165;201801;23;16;7;15264.0;6678.0;21942.0
430170;201801;80;72;8;68688.0;7632.0;76320.0
430175;201801;81;63;18;60102.0;16504.2;76606.2
430180;201801;92;73;19;69642.0;17505.9;87147.9
430185;201801;31;23;8;21942.0;7632.0;29574.0
430187;201801;103;43;60;41022.0;56934.8;97956.8
430190;201801;222;126;96;120156.3;90907.46;211063.77
430192;201801;14;14;0;13356.0;0.0;13356.0
430195;201801;13;8;5;7632.0;4770.0;12402.0
430200;201801;162;144;18;136708.2;17172.0;153880.2
430205;201801;20;19;1;18126.0;954.0;19080.0
430210;201801;622;482;140;456107.4;132272.3;588379.7
430215;201801;16;12;4;11448.0;3816.0;15264.0
430220;201801;63;44;19;41976.0;18126.0;60102.0
430222;201801;14;7;7;6678.0;6678.0;13356.0
430223;201801;15;8;7;7632.0;6678.0;14310.0
430225;201801;4;3;1;2862.0;954.0;3816.0
430230;201801;304;188;116;178398.0;110664.0;289062.0
430235;201801;53;39;14;37206.0;13346.46;50552.46
430237;201801;29;21;8;20034.0;7632.0;27666.0
430240;201801;132;83;49;78705.0;46736.46;125441.46
430245;201801;70;59;11;56286.0;10494.0;66780.0
430250;201801;191;110;81;104930.46;77264.46;182194.92
430258;201801;13;11;2;10494.0;1908.0;12402.0
430260;201801;34;30;4;28620.0;3806.46;32426.46
430265;201801;34;29;5;27646.92;4770.0;32416.92
430270;201801;562;412;150;389658.53;141289.02;530947.56
430280;201801;1025;631;394;598243.9;373376.6;971620.44
430290;201801;380;222;158;209880.8;150732.0;360612.8
430300;201801;2109;1164;945;1104667.1;898470.8;2003137.9
430310;201801;1973;1038;935;983204.4;888872.25;1872076.6
430320;201801;48;40;8;38145.69;7632.0;45777.69
430330;201801;97;88;9;83475.0;8586.0;92061.0
430340;201801;66;59;7;56286.0;6678.0;62964.0
430350;201801;1664;1157;507;1092302.4;481933.25;1574235.6
430355;201801;25;22;3;20988.0;2862.0;23850.0
430360;201801;80;39;41;37206.0;37874.0;75080.0
430367;201801;27;20;7;19080.0;6678.0;25758.0
430370;201801;54;47;7;44838.0;6678.0;51516.0
430380;201801;130;97;33;91965.6;31482.0;123447.6
430390;201801;613;381;232;363187.8;221023.45;584211.25
430400;201801;136;106;30;99406.8;28600.92;128007.72
430410;201801;58;46;12;43884.0;11448.0;55332.0
430420;201801;491;323;168;305662.8;157726.16;463388.97
430430;201801;55;52;3;48972.63;2862.0;51834.63
430435;201801;157;120;37;113526.0;34582.5;148108.5
430440;201801;507;340;167;324360.0;159127.2;483487.2
430450;201801;1194;983;211;930246.3;201284.45;1131530.8
430460;201801;5093;2776;2317;2632423.8;2205913.0;4838337.0
430461;201801;17;15;2;14310.0;1908.0;16218.0
430462;201801;11;7;4;6678.0;3816.0;10494.0
430463;201801;1021;541;480;513681.38;457568.1;971249.5
430465;201801;28;16;12;15264.0;11448.0;26712.0
430466;201801;655;473;182;449334.2;173437.2;622771.4
430467;201801;101;60;41;55999.8;39104.46;95104.26
430468;201801;109;68;41;64872.0;38862.91;103734.91
430469;201801;23;17;6;16218.0;5724.0;21942.0
430470;201801;1174;649;525;612380.4;498894.3;1111274.8
430471;201801;48;36;12;34324.92;11448.0;45772.92
430480;201801;95;60;35;56381.4;33380.46;89761.86
430485;201801;6;6;0;5438.0;0.0;5438.0
430490;201801;90;72;18;67877.7;17172.0;85049.7
430495;201801;35;28;7;26712.0;6678.0;33390.0
430500;201801;193;131;62;124974.0;58772.46;183746.45
430510;201801;3059;2042;1017;1941705.8;969331.3;2911037.0
430511;201801;18;18;0;17172.0;0.0;17172.0
430512;201801;137;94;43;89676.0;41022.0;130698.0
430513;201801;52;46;6;43407.0;5724.0;49131.0
430515;201801;31;29;2;27666.0;1908.0;29574.0
430517;201801;169;149;20;141192.5;19060.92;160253.42
430520;201801;365;250;115;237833.0;109681.38;347514.38
430530;201801;89;52;37;49608.0;35298.0;84906.0
430535;201801;471;312;159;297448.44;151662.16;449110.6
430537;201801;10;10;0;9540.0;0.0;9540.0
430540;201801;71;47;24;44838.0;22896.0;67734.0
430543;201801;374;115;259;109710.0;247086.0;356796.0
430544;201801;43;39;4;37206.0;3816.0;41022.0
430545;201801;340;161;179;153575.0;170269.92;323844.9
430550;201801;43;35;8;33390.0;7632.0;41022.0
430558;201801;6;4;2;3816.0;1908.0;5724.0
430560;201801;46;20;26;19080.0;24804.0;43884.0
430570;201801;107;46;61;43884.0;58136.76;102020.76
430580;201801;123;96;27;91584.0;25710.3;117294.3
430583;201801;14;14;0;13356.0;0.0;13356.0
430585;201801;9;4;5;3816.0;4770.0;8586.0
430587;201801;14;8;6;7632.0;5724.0;13356.0
430590;201801;151;126;25;118963.8;23850.0;142813.8
430593;201801;4;4;0;3816.0;0.0;3816.0
430595;201801;15;10;5;9540.0;4770.0;14310.0
430597;201801;51;26;25;24804.0;23850.0;48654.0
430600;201801;215;149;66;142136.45;62677.8;204814.27
430605;201801;163;100;63;95400.0;60092.46;155492.45
430607;201801;26;21;5;20034.0;4770.0;24804.0
430610;201801;1646;768;878;729429.3;832613.75;1562043.1
430613;201801;2;2;0;1908.0;0.0;1908.0
430620;201801;111;79;32;75223.0;30518.46;105741.46
430630;201801;45;40;5;38160.0;4770.0;42930.0
430632;201801;31;26;5;24804.0;4770.0;29574.0
430635;201801;41;37;4;35298.0;3816.0;39114.0
430637;201801;55;31;24;29574.0;22896.0;52470.0
430640;201801;209;115;94;108851.4;89676.0;198527.4
430642;201801;28;26;2;24804.0;1908.0;26712.0
430645;201801;32;28;4;26712.0;3816.0;30528.0
430650;201801;255;205;50;195284.0;47652.3;242936.3
430655;201801;4;4;0;3816.0;0.0;3816.0
430660;201801;963;470;493;446805.9;468795.8;915601.7
430670;201801;71;51;20;48654.0;19080.0;67734.0
430673;201801;75;41;34;39114.0;32436.0;71550.0
430675;201801;13;10;3;9540.0;2862.0;12402.0
430676;201801;490;301;189;286429.03;180235.06;466664.12
430680;201801;251;177;74;166664.0;70596.0;237260.0
430690;201801;524;307;217;291972.3;205362.14;497334.47
430692;201801;7;5;2;4770.0;1908.0;6678.0
430693;201801;140;93;47;88722.0;44208.36;132930.36
430695;201801;73;66;7;62029.08;6678.0;68707.08
430697;201801;59;35;24;33390.0;22896.0;56286.0
430700;201801;1594;1114;480;1049943.9;457920.0;1507863.9
430705;201801;19;18;1;17172.0;954.0;18126.0
430710;201801;259;168;91;160272.0;86814.0;247086.0
430720;201801;108;92;16;87577.2;15264.0;102841.2
430730;201801;119;102;17;96354.0;16218.0;112572.0
430740;201801;65;43;22;41022.0;20988.0;62010.0
430745;201801;36;29;7;27380.0;6678.0;34058.0
430750;201801;336;227;109;215614.64;103032.0;318646.62
430755;201801;82;45;37;42930.0;35298.0;78228.0
430760;201801;369;224;145;211025.72;138301.92;349327.62
430770;201801;1472;756;716;719106.3;678607.25;1397713.6
430780;201801;318;203;115;192680.72;109643.76;302324.47
430781;201801;28;23;5;21942.0;4770.0;26712.0
430783;201801;50;40;10;37842.13;9540.0;47382.13
430786;201801;6;3;3;2862.0;2862.0;5724.0
430790;201801;486;314;172;297997.9;163792.45;461790.38
430800;201801;151;126;25;120204.0;23850.0;144054.0
430805;201801;42;38;4;36252.0;3816.0;40068.0
430807;201801;35;21;14;20034.0;13356.0;33390.0
430810;201801;72;46;26;43884.0;24804.0;68688.0
430820;201801;134;84;50;80136.0;47032.2;127168.2
430825;201801;13;11;2;10494.0;1908.0;12402.0
430830;201801;232;217;15;206712.92;14310.0;221022.92
430840;201801;124;84;40;80136.0;37492.2;117628.2
430843;201801;5;3;2;2862.0;1908.0;4770.0
430845;201801;70;39;31;37206.0;29574.0;66780.0
430850;201801;568;391;177;371840.6;168726.69;540567.25
430860;201801;155;100;55;94732.2;51792.66;146524.86
430865;201801;62;30;32;27952.2;30213.18;58165.38
430870;201801;78;63;15;60102.0;14310.0;74412.0
430880;201801;159;119;40;113506.92;38160.0;151666.92
430885;201801;7;6;1;5724.0;954.0;6678.0
430890;201801;334;203;131;192002.05;124974.0;316976.03
430900;201801;542;372;170;350690.4;161693.45;512383.88
430905;201801;81;32;49;30528.0;46746.0;77274.0
430910;201801;269;151;118;144054.0;111896.0;255950.0
430912;201801;3;3;0;2862.0;0.0;2862.0
430915;201801;34;26;8;24804.0;7345.8;32149.8
430920;201801;4170;2335;1835;2220883.8;1748780.2;3969664.0
430925;201801;5;4;1;3567.96;954.0;4521.96
430930;201801;2083;1240;843;1175244.4;803021.44;1978265.9
430940;201801;239;151;88;143376.66;83932.92;227309.58
430950;201801;158;128;30;122112.0;28620.0;150732.0
430955;201801;21;13;8;12402.0;7632.0;20034.0
430957;201801;18;17;1;16218.0;954.0;17172.0
430960;201801;233;152;81;143243.1;77274.0;220517.1
430965;201801;103;64;39;61056.0;37206.0;98262.0
430970;201801;78;65;13;62010.0;11448.0;73458.0
430975;201801;33;31;2;29574.0;1908.0;31482.0
430980;201801;43;26;17;24804.0;16218.0;41022.0
430990;201801;108;83;25;79182.0;23850.0;103032.0
430995;201801;115;111;4;104653.8;3816.0;108469.8
431000;201801;296;136;160;127597.2;152640.0;280237.2
431010;201801;340;205;135;194587.38;128790.0;323377.38
431020;201801;1926;1116;810;1056102.4;768628.25;1824730.6
431030;201801;43;34;9;32436.0;8586.0;41022.0
431033;201801;384;189;195;179495.2;186030.0;365525.2
431036;201801;16;9;7;8586.0;6678.0;15264.0
431040;201801;130;78;52;73458.0;49498.29;122956.29
431041;201801;37;25;12;23850.0;11448.0;35298.0
431043;201801;44;25;19;23850.0;18126.0;41976.0
431046;201801;12;7;5;6678.0;4770.0;11448.0
431050;201801;207;131;76;124687.8;71502.3;196190.1
431053;201801;75;44;31;41212.8;29574.0;70786.8
431055;201801;63;42;21;40068.0;20014.92;60082.92
431057;201801;17;17;0;16218.0;0.0;16218.0
431060;201801;1690;1059;631;1003056.7;600112.9;1603169.5
431065;201801;17;10;7;9540.0;6678.0;16218.0
431070;201801;72;67;5;63918.0;4770.0;68688.0
431075;201801;8;8;0;7632.0;0.0;7632.0
431080;201801;137;87;50;82711.8;47700.0;130411.8
431085;201801;30;27;3;25758.0;2862.0;28620.0
431087;201801;15;13;2;12402.0;1908.0;14310.0
431090;201801;57;45;12;42930.0;11448.0;54378.0
431100;201801;1228;732;496;687264.8;473184.0;1160448.9
431110;201801;245;153;92;145962.0;87758.46;233720.45
431112;201801;29;17;12;16218.0;11448.0;27666.0
431113;201801;30;19;11;18126.0;10494.0;28620.0
431115;201801;152;104;48;98579.87;45782.46;144362.33
431120;201801;619;365;254;346264.62;242239.84;588504.5
431123;201801;3;2;1;1908.0;954.0;2862.0
431125;201801;90;80;10;76320.0;9540.0;85860.0
431127;201801;7;3;4;2862.0;3816.0;6678.0
431130;201801;618;400;218;380359.8;207666.72;588026.5
431140;201801;729;493;236;465981.6;225067.69;691049.25
431142;201801;33;25;8;22638.0;7632.0;30270.0
431150;201801;205;152;53;145008.0;50552.46;195560.45
431160;201801;56;50;6;47700.0;5724.0;53424.0
431162;201801;19;14;5;13356.0;4770.0;18126.0
431164;201801;4;4;0;3816.0;0.0;3816.0
431170;201801;102;84;18;80136.0;17172.0;97308.0
431171;201801;49;27;22;25758.0;20978.46;46736.46
431173;201801;1;1;0;954.0;0.0;954.0
431175;201801;203;101;102;95114.0;97298.46;192412.45
431177;201801;74;56;18;53424.0;16485.92;69909.92
431179;201801;11;10;1;9540.0;954.0;10494.0
431180;201801;437;263;174;250902.0;165691.45;416593.47
431190;201801;87;66;21;62964.0;20034.0;82998.0
431198;201801;72;47;25;44838.0;23850.0;68688.0
431200;201801;20;17;3;16218.0;2862.0;19080.0
431205;201801;23;23;0;21942.0;0.0;21942.0
431210;201801;87;53;34;50229.0;32436.0;82665.0
431213;201801;27;22;5;20988.0;4770.0;25758.0
431215;201801;26;23;3;21942.0;2862.0;24804.0
431217;201801;7;6;1;5724.0;954.0;6678.0
431220;201801;67;58;9;55332.0;8586.0;63918.0
431225;201801;150;100;50;95391.0;47690.46;143081.45
431230;201801;101;88;13;83952.0;12402.0;96354.0
431235;201801;7;7;0;6678.0;0.0;6678.0
431237;201801;26;16;10;15264.0;9540.0;24804.0
431238;201801;15;11;4;10208.0;3816.0;14024.0
431240;201801;985;635;350;604130.6;333384.84;937515.5
431242;201801;34;34;0;32436.0;0.0;32436.0
431244;201801;11;8;3;7632.0;2862.0;10494.0
431245;201801;63;48;15;45792.0;14310.0;60102.0
431247;201801;13;10;3;9540.0;2862.0;12402.0
431250;201801;268;137;131;130631.22;124287.92;254919.14
431260;201801;60;43;17;41022.0;16218.0;57240.0
431261;201801;23;16;7;15264.0;6678.0;21942.0
431262;201801;16;16;0;15264.0;0.0;15264.0
431265;201801;165;86;79;82044.0;75366.0;157410.0
431267;201801;15;14;1;13356.0;954.0;14310.0
431270;201801;313;262;51;249948.0;48654.0;298602.0
431275;201801;41;39;2;37206.0;1908.0;39114.0
431280;201801;21;17;4;15383.25;3816.0;19199.25
431290;201801;20;17;3;16218.0;2862.0;19080.0
431295;201801;5;5;0;4770.0;0.0;4770.0
431300;201801;22;19;3;18126.0;2862.0;20988.0
431301;201801;7;7;0;6678.0;0.0;6678.0
431303;201801;51;34;17;32311.98;15931.8;48243.78
431306;201801;224;118;106;112115.98;101124.0;213239.98
431308;201801;6;5;1;4770.0;954.0;5724.0
431310;201801;63;53;10;50562.0;9540.0;60102.0
431320;201801;122;72;50;68688.0;47304.05;115992.05
431330;201801;178;117;61;111618.0;58194.0;169812.0
431333;201801;33;27;6;25758.0;5724.0;31482.0
431335;201801;10;5;5;4770.0;4770.0;9540.0
431337;201801;321;151;170;143224.2;161149.88;304374.1
431339;201801;20;17;3;16218.0;2862.0;19080.0
431340;201801;3060;1765;1295;1679766.8;1232333.5;2912100.2
431342;201801;45;28;17;26712.0;16218.0;42930.0
431344;201801;18;17;1;16218.0;954.0;17172.0
431346;201801;3;3;0;2862.0;0.0;2862.0
431349;201801;36;33;3;31482.0;2862.0;34344.0
431350;201801;900;531;369;502025.66;351033.84;853059.5
431360;201801;45;39;6;37206.0;5724.0;42930.0
431365;201801;313;147;166;140218.92;157398.4;297617.3
431370;201801;1322;788;534;748098.1;509248.97;1257347.1
431380;201801;98;83;15;79182.0;14310.0;93492.0
431390;201801;499;279;220;265135.88;209336.22;474472.1
431395;201801;279;120;159;114480.0;151667.0;266147.0
431400;201801;39;30;9;28620.0;8586.0;37206.0
431402;201801;94;65;29;62010.0;27666.0;89676.0
431403;201801;14;9;5;8586.0;4770.0;13356.0
431405;201801;651;353;298;335122.03;284265.0;619387.0
431406;201801;32;28;4;26712.0;3816.0;30528.0
431407;201801;51;41;10;39114.0;9540.0;48654.0
431410;201801;3216;1910;1306;1809632.2;1242881.2;3052513.5
431413;201801;15;13;2;12402.0;1908.0;14310.0
431415;201801;72;52;20;49608.0;19080.0;68688.0
431417;201801;24;12;12;11448.0;11448.0;22896.0
431420;201801;299;210;89;199684.88;84896.46;284581.34
431430;201801;42;17;25;16218.0;23850.0;40068.0
431440;201801;8936;6372;2564;6007915.0;2437409.2;8445324.0
431442;201801;27;14;13;13356.0;12402.0;25758.0
431445;201801;26;20;6;19080.0;5724.0;24804.0
431446;201801;7;6;1;5724.0;954.0;6678.0
431447;201801;84;59;25;56286.0;23850.0;80136.0
431449;201801;51;44;7;41976.0;6678.0;48654.0
431450;201801;410;284;126;269171.1;119488.5;388659.6
431454;201801;0;0;0;0.0;0.0;0.0
431455;201801;49;38;11;36252.0;10494.0;46746.0
431460;201801;522;361;161;340768.8;153307.8;494076.6
431470;201801;116;91;25;86122.54;23349.35;109471.89
431475;201801;11;10;1;9540.0;954.0;10494.0
431477;201801;36;26;10;24804.0;9540.0;34344.0
431478;201801;8;7;1;6678.0;954.0;7632.0
431480;201801;494;314;180;297944.7;171672.3;469617.0
431490;201801;28202;15992;12210;1,52E+13;1,16E+14;2,68E+14
431500;201801;79;53;26;50562.0;24804.0;75366.0
431505;201801;46;20;26;19080.0;24804.0;43884.0
431507;201801;11;9;2;8586.0;1908.0;10494.0
431510;201801;278;181;97;171958.8;91564.92;263523.72
431513;201801;22;17;5;16218.0;4770.0;20988.0
431514;201801;8;7;1;6678.0;954.0;7632.0
431515;201801;79;66;13;62964.0;12402.0;75366.0
431517;201801;3;1;2;954.0;1908.0;2862.0
431520;201801;37;33;4;31482.0;3816.0;35298.0
431530;201801;1607;716;891;682014.8;849551.94;1531566.8
431531;201801;23;21;2;20034.0;1908.0;21942.0
431532;201801;25;17;8;16218.0;7632.0;23850.0
431535;201801;25;16;9;15264.0;8586.0;23850.0
431540;201801;138;123;15;116321.22;14310.0;130631.22
431545;201801;19;17;2;16218.0;1908.0;18126.0
431550;201801;348;204;144;194616.0;137280.6;331896.6
431555;201801;12;11;1;10494.0;954.0;11448.0
431560;201801;4422;3129;1293;2955134.0;1231261.9;4186396.0
431570;201801;778;410;368;387992.2;348201.47;736193.7
431575;201801;35;24;11;22896.0;10494.0;33390.0
431580;201801;97;68;29;63918.0;27666.0;91584.0
431590;201801;139;116;23;109710.0;21942.0;131652.0
431595;201801;12;11;1;10494.0;954.0;11448.0
431600;201801;218;126;92;120204.0;87768.0;207972.0
431610;201801;128;93;35;88054.2;33390.0;121444.2
431620;201801;42;34;8;32436.0;7632.0;40068.0
431630;201801;136;116;20;110664.0;19080.0;129744.0
431640;201801;1329;829;500;786382.2;475416.44;1261798.6
431642;201801;41;37;4;34821.0;3816.0;38637.0
431643;201801;44;20;24;19080.0;22896.0;41976.0
431645;201801;300;172;128;164088.0;121158.0;285246.0
431647;201801;11;11;0;10494.0;0.0;10494.0
431650;201801;36;27;9;25758.0;8586.0;34344.0
431660;201801;278;182;96;171433.8;91584.0;263017.8
431670;201801;219;103;116;95638.5;110635.38;206273.88
431673;201801;3;3;0;2862.0;0.0;2862.0
431675;201801;29;24;5;22609.8;4770.0;27379.8
431680;201801;1096;782;314;742212.0;298507.7;1040719.7
431690;201801;4769;2918;1851;2762092.8;1760972.2;4523065.0
431695;201801;26;20;6;19080.0;5724.0;24804.0
431697;201801;0;0;0;0.0;0.0;0.0
431700;201801;169;128;41;122112.0;39114.0;161226.0
431710;201801;3987;1719;2268;1637246.0;2163183.0;3800429.0
431720;201801;1397;827;570;780794.56;542812.44;1323607.0
431725;201801;1;1;0;954.0;0.0;954.0
431730;201801;1196;810;386;765759.8;368244.0;1134003.8
431740;201801;1365;682;683;646010.75;651041.1;1297051.9
431750;201801;1880;1219;661;1151696.2;628657.94;1780354.2
431755;201801;6;5;1;4770.0;954.0;5724.0
431760;201801;1088;694;394;661694.4;375647.6;1037342.0
431770;201801;395;290;105;276650.47;100150.92;376801.38
431775;201801;27;21;6;20034.0;5724.0;25758.0
431780;201801;557;344;213;326996.22;203192.45;530188.7
431790;201801;151;112;39;105894.0;37158.3;143052.3
431795;201801;14;12;2;11448.0;1908.0;13356.0
431800;201801;3389;1775;1614;1681966.9;1532820.4;3214787.2
431805;201801;16;15;1;14310.0;954.0;15264.0
431810;201801;614;415;199;393276.97;189712.98;582989.94
431820;201801;314;175;139;166950.0;131604.3;298554.3
431830;201801;2320;1408;912;1339817.6;868787.6;2208605.2
431840;201801;518;344;174;324552.4;164756.0;489308.4
431842;201801;34;28;6;26712.0;5724.0;32436.0
431843;201801;11;7;4;6678.0;3816.0;10494.0
431844;201801;15;13;2;12402.0;1908.0;14310.0
431845;201801;30;27;3;25758.0;2862.0;28620.0
431846;201801;29;25;4;23850.0;3816.0;27666.0
431848;201801;14;12;2;11448.0;1908.0;13356.0
431849;201801;8;6;2;5724.0;1908.0;7632.0
431850;201801;801;665;136;632897.5;129505.5;762403.0
431860;201801;102;75;27;71550.0;24804.0;96354.0
431861;201801;4;2;2;1908.0;1908.0;3816.0
431862;201801;49;33;16;31482.0;15264.0;46746.0
431870;201801;3477;2049;1428;1946288.0;1360714.4;3307002.5
431880;201801;938;689;249;652508.0;236592.0;889100.0
431890;201801;1303;807;496;764841.75;471577.0;1236418.8
431900;201801;186;130;56;124020.0;52632.18;176652.19
431910;201801;57;42;15;40068.0;14310.0;54378.0
431912;201801;36;20;16;19080.0;15264.0;34344.0
431915;201801;127;102;25;97308.0;23850.0;121158.0
431920;201801;145;108;37;102745.8;35298.0;138043.8
431930;201801;86;70;16;66780.0;15264.0;82044.0
431935;201801;4;3;1;2862.0;954.0;3816.0
431936;201801;12;11;1;10494.0;954.0;11448.0
431937;201801;17;12;5;11448.0;4770.0;16218.0
431940;201801;445;296;149;279617.4;142136.45;421753.88
431950;201801;467;299;168;284006.88;160139.52;444146.4
431960;201801;715;421;294;397448.03;280314.9;677762.94
431970;201801;73;65;8;62010.0;7632.0;69642.0
431971;201801;3;3;0;2862.0;0.0;2862.0
431973;201801;19;16;3;15264.0;2862.0;18126.0
431975;201801;6;5;1;4770.0;954.0;5724.0
431980;201801;199;125;74;117723.6;70596.0;188319.6
431990;201801;1237;654;583;622443.0;556136.0;1178579.0
432000;201801;1674;897;777;848545.1;737694.06;1586239.1
432010;201801;277;185;92;175376.95;87768.0;263144.97
432020;201801;174;137;37;130698.0;35288.46;165986.45
432023;201801;20;16;4;15264.0;3816.0;19080.0
432026;201801;67;60;7;57240.0;6678.0;63918.0
432030;201801;62;28;34;26712.0;32436.0;59148.0
432032;201801;22;19;3;18126.0;2862.0;20988.0
432035;201801;47;37;10;35298.0;9540.0;44838.0
432040;201801;98;67;31;63918.0;29574.0;93492.0
432045;201801;8;7;1;6391.8;954.0;7345.8
432050;201801;71;42;29;40068.0;27666.0;67734.0
432055;201801;100;74;26;70576.92;24804.0;95380.92
432057;201801;1;0;1;0.0;954.0;954.0
432060;201801;39;36;3;33628.5;2862.0;36490.5
432065;201801;29;27;2;25758.0;1908.0;27666.0
432067;201801;93;82;11;78208.92;10494.0;88702.92
432070;201801;397;299;98;283644.2;93463.92;377108.1
432080;201801;810;557;253;529679.9;241295.3;770975.2
432085;201801;16;12;4;11448.0;3816.0;15264.0
432090;201801;261;165;96;157410.0;91584.0;248994.0
432100;201801;174;116;58;110377.8;55332.0;165709.8
432110;201801;606;415;191;389375.84;181260.0;570635.8
432120;201801;964;574;390;546928.2;372021.84;918950.06
432130;201801;498;359;139;341150.4;131923.06;473073.47
432132;201801;25;22;3;20988.0;2862.0;23850.0
432135;201801;78;65;13;62010.0;12402.0;74412.0
432140;201801;264;209;55;199090.27;52470.0;251560.27
432143;201801;186;117;69;111618.0;65826.0;177444.0
432145;201801;267;183;84;172770.2;79849.8;252620.0
432146;201801;15;14;1;13356.0;954.0;14310.0
432147;201801;140;62;78;59148.0;74388.15;133536.16
432149;201801;17;12;5;11448.0;4770.0;16218.0
432150;201801;824;523;301;497749.5;284116.84;781866.3
432160;201801;1399;728;671;692214.4;639247.5;1331461.9
432162;201801;4;3;1;2862.0;954.0;3816.0
432163;201801;18;14;4;13356.0;3816.0;17172.0
432166;201801;122;92;30;88246.0;28620.0;116866.0
432170;201801;224;122;102;115435.0;97308.0;212743.0
432180;201801;521;318;203;300224.38;193376.0;493600.38
432183;201801;9;7;2;6678.0;1908.0;8586.0
432185;201801;82;71;11;67638.6;10494.0;78132.6
432190;201801;471;259;212;245923.45;202115.52;448038.97
432195;201801;84;73;11;68926.5;10494.0;79420.5
432200;201801;410;263;147;250902.0;140190.84;391092.84
432210;201801;118;76;42;70452.9;40068.0;110520.9
432215;201801;62;58;4;55332.0;3816.0;59148.0
432218;201801;19;18;1;17172.0;954.0;18126.0
432220;201801;668;337;331;320487.62;315266.75;635754.4
432225;201801;16;10;6;9063.0;5724.0;14787.0
432230;201801;150;87;63;82759.5;60102.0;142861.5
432232;201801;15;13;2;12402.0;1908.0;14310.0
432234;201801;4;3;1;2862.0;954.0;3816.0
432235;201801;1;1;0;954.0;0.0;954.0
432237;201801;29;16;13;15264.0;12402.0;27666.0
432240;201801;4186;2336;1850;2218471.5;1757231.4;3975703.0
432250;201801;1013;643;370;610799.94;352817.8;963617.75
432252;201801;38;31;7;28829.88;6678.0;35507.88
432253;201801;60;49;11;46746.0;10494.0;57240.0
432254;201801;21;9;12;8586.0;11448.0;20034.0
432255;201801;14;13;1;12402.0;954.0;13356.0
432260;201801;842;659;183;627627.25;173628.5;801255.75
432270;201801;220;163;57;155502.0;54378.0;209880.0
432280;201801;122;88;34;83475.8;32436.0;115911.8
432285;201801;2;1;1;954.0;954.0;1908.0
432290;201801;69;62;7;57526.2;6678.0;64204.2
432300;201801;4647;2654;1993;2516250.8;1897002.5;4413253.5
432310;201801;115;91;24;86814.0;22896.0;109710.0
432320;201801;19;14;5;13356.0;4770.0;18126.0
432330;201801;15;10;5;9540.0;4770.0;14310.0
432335;201801;7;6;1;5724.0;954.0;6678.0
432340;201801;40;36;4;34344.0;3816.0;38160.0
432345;201801;86;62;24;59148.0;22896.0;82044.0
432350;201801;22;21;1;20034.0;954.0;20988.0
432360;201801;7;5;2;4770.0;1908.0;6678.0
432370;201801;25;25;0;23850.0;0.0;23850.0
432375;201801;40;34;6;32436.0;5724.0;38160.0
432377;201801;7;7;0;6678.0;0.0;6678.0
432380;201801;169;74;95;69928.2;90582.3;160510.5
500020;201801;249;136;113;129744.0;107200.98;236944.98
500025;201801;119;58;61;54378.0;58194.0;112572.0
500060;201801;1382;845;537;805557.6;511692.62;1317250.2
500070;201801;751;356;395;339273.0;376820.47;716093.44
500080;201801;136;104;32;99216.0;30528.0;129744.0
500085;201801;143;116;27;110378.0;24923.25;135301.25
500090;201801;333;160;173;152640.0;165042.0;317682.0
500100;201801;692;367;325;347923.8;309478.0;657401.8
500110;201801;2237;996;1241;949866.44;1183118.6;2132985.0
500124;201801;311;177;134;168858.0;127549.8;296407.8
500150;201801;329;132;197;125919.0;187578.0;313497.0
500190;201801;522;357;165;339891.12;156924.0;496815.12
500200;201801;201;171;30;162791.0;28620.0;191411.0
500210;201801;1459;525;934;499576.94;889873.0;1389450.0
500215;201801;242;140;102;132602.52;97308.0;229910.52
500220;201801;787;513;274;489157.84;260638.45;749796.3
500230;201801;257;178;79;169096.5;74889.0;243985.5
500240;201801;709;494;215;470512.8;204633.8;675146.6
500260;201801;565;209;356;199386.0;339624.0;539010.0
500270;201801;28334;12030;16304;1,14E+14;1,55E+14;2,70E+14
500280;201801;192;74;118;70596.0;112572.0;183168.0
500290;201801;1191;696;495;663031.0;472221.0;1135252.0
500295;201801;405;248;157;236592.0;149768.45;386360.47
500310;201801;63;20;43;19080.0;41022.0;60102.0
500315;201801;697;418;279;398762.47;265870.25;664632.75
500320;201801;3640;1817;1823;1730991.4;1737495.6;3468487.0
500325;201801;942;520;422;495603.0;401613.44;897216.44
500330;201801;1498;682;816;648406.25;778032.6;1426438.9
500345;201801;323;236;87;224181.2;82998.0;307179.2
500348;201801;242;142;100;135468.0;95381.46;230849.45
500350;201801;142;69;73;65826.0;69642.0;135468.0
500370;201801;5419;2424;2995;2304730.0;2854620.8;5159351.0
500375;201801;346;250;96;238490.45;91584.0;330074.47
500380;201801;582;330;252;314662.6;240122.45;554785.06
500390;201801;72;36;36;34344.0;34344.0;68688.0
500400;201801;220;150;70;143080.92;66771.0;209851.92
500410;201801;574;223;351;212696.16;334706.22;547402.4
500430;201801;549;379;170;361566.0;162180.0;523746.0
500440;201801;204;106;98;100351.43;93492.0;193843.44
500450;201801;413;176;237;167198.8;225743.12;392941.9
500460;201801;316;157;159;149768.45;151686.0;301454.47
500470;201801;440;344;96;326961.66;90621.0;417582.66
500480;201801;113;68;45;64872.0;42930.0;107802.0
500490;201801;108;43;65;41017.23;62010.0;103027.23
500500;201801;1451;501;950;476124.12;905706.44;1381830.5
500510;201801;47;36;11;34344.0;10485.0;44829.0
500515;201801;110;77;33;73458.0;31196.0;104654.0
500520;201801;350;197;153;186889.0;145672.0;332561.0
500525;201801;87;49;38;46746.0;35965.8;82711.8
500540;201801;888;366;522;349097.75;496977.84;846075.6
500560;201801;894;507;387;481939.03;368516.4;850455.44
500568;201801;998;578;420;547596.2;400389.22;947985.44
500570;201801;1220;685;535;650774.75;508059.6;1158834.4
500580;201801;336;172;164;163792.27;156443.0;320235.25
500600;201801;316;159;157;150975.27;149760.0;300735.28
500620;201801;908;641;267;605736.7;254527.2;860263.9
500625;201801;81;69;12;65119.19;11448.0;76567.19
500627;201801;23;10;13;9540.0;12402.0;21942.0
500630;201801;1571;828;743;788949.25;708341.0;1497290.2
500635;201801;518;295;223;281010.25;212598.9;493609.12
500640;201801;428;225;203;212076.0;193643.45;405719.47
500660;201801;5485;2103;3382;2002542.6;3222689.0;5225231.5
500690;201801;576;201;375;191406.23;356061.16;547467.44
500710;201801;357;173;184;164756.0;175240.8;339996.8
500720;201801;969;566;403;538528.25;384252.9;922781.1
500730;201801;194;112;82;106848.0;77937.03;184785.03
500740;201801;850;367;483;348822.2;460027.75;808849.94
500750;201801;134;43;91;41022.0;86618.92;127640.92
500755;201801;123;89;34;84620.0;32436.0;117056.0
500769;201801;743;416;327;396542.03;311945.0;708487.06
500770;201801;443;232;211;221318.45;201284.45;422602.9
500780;201801;173;116;57;110664.0;54378.0;165042.0
500790;201801;1033;514;519;489779.22;494799.47;984578.7
500793;201801;255;136;119;129744.0;113517.0;243261.0
500795;201801;178;127;51;121148.46;48645.0;169793.45
500797;201801;40;32;8;30528.0;7632.0;38160.0
500800;201801;413;176;237;167895.0;225811.8;393706.8
500830;201801;2176;1217;959;1158605.9;913894.4;2072500.2
500840;201801;143;106;37;101124.0;35289.0;136413.0
510010;201801;165;91;74;86804.46;70596.0;157400.45
510020;201801;484;223;261;212448.6;248181.5;460630.1
510025;201801;1662;935;727;891148.2;690726.56;1581874.8
510030;201801;638;327;311;311911.9;295930.22;607842.1
510035;201801;127;57;70;54350.46;66761.46;121111.92
510040;201801;384;169;215;161226.0;204663.27;365889.25
510050;201801;427;232;195;220587.2;185206.38;405793.6
510060;201801;115;57;58;54368.46;55322.46;109690.92
510080;201801;219;87;132;82965.69;125805.06;208770.75
510100;201801;77;35;42;33390.0;40048.92;73438.92
510120;201801;37;22;15;20988.0;14310.0;35298.0
510125;201801;398;247;151;234955.89;144030.92;378986.8
510130;201801;590;343;247;326807.28;235213.56;562020.8
510140;201801;390;128;262;122103.0;249943.23;372046.22
510160;201801;91;42;49;40068.0;46742.0;86810.0
510170;201801;865;530;335;505354.06;318956.3;824310.4
510180;201801;2878;1398;1480;1330683.4;1409950.1;2740633.5
510185;201801;12;6;6;5724.0;5724.0;11448.0
510190;201801;212;73;139;69642.0;132601.23;202243.23
510250;201801;2606;1525;1081;1453800.1;1030151.2;2483951.2
510260;201801;202;144;58;137193.84;55295.46;192489.3
510263;201801;454;249;205;236078.2;194814.6;430892.78
510267;201801;650;363;287;345746.75;273527.44;619274.2
510268;201801;56;29;27;27666.0;25758.0;53424.0
510269;201801;70;30;40;28611.0;38160.0;66771.0
510270;201801;413;210;203;200161.98;193245.48;393407.47
510279;201801;230;169;61;161189.45;57888.92;219078.38
510285;201801;168;75;93;71531.46;88722.0;160253.45
510300;201801;547;296;251;281933.06;239379.84;521312.9
510305;201801;216;99;117;94423.46;111524.22;205947.69
510310;201801;115;58;57;55332.0;54368.46;109700.46
510320;201801;853;528;325;503134.62;309614.38;812749.0
510325;201801;414;165;249;157400.45;237250.27;394650.72
510330;201801;424;239;185;227993.0;176470.92;404463.9
510335;201801;603;322;281;307141.38;267400.44;574541.8
510336;201801;49;36;13;34344.0;12402.0;46746.0
510337;201801;118;47;71;44828.46;67724.46;112552.92
510340;201801;17462;8412;9050;8001452.0;8622701.0;1,66E+14
510343;201801;70;48;22;45782.46;20988.0;66770.46
510345;201801;159;105;54;100160.46;51210.92;151371.38
510350;201801;667;373;294;354900.06;280411.38;635311.44
510360;201801;202;119;83;113517.0;79099.92;192616.92
510370;201801;137;71;66;67714.92;62832.6;130547.52
510380;201801;92;63;29;60102.0;27657.0;87759.0
510385;201801;59;27;32;25758.0;30519.0;56277.0
510390;201801;124;52;72;49608.0;68649.84;118257.84
510395;201801;41;28;13;26712.0;12402.0;39114.0
510410;201801;703;464;239;442632.0;227982.69;670614.7
510420;201801;593;287;306;272843.25;290456.28;563299.56
510450;201801;50;30;20;28620.0;19080.0;47700.0
510452;201801;40;23;17;21942.0;16218.0;38160.0
510454;201801;65;27;38;25758.0;36242.46;62000.46
510455;201801;126;80;46;76300.92;43884.0;120184.92
510460;201801;183;95;88;90163.72;83914.38;174078.1
510480;201801;738;419;319;398599.88;303978.38;702578.25
510490;201801;360;185;175;176100.8;166445.08;342545.88
510500;201801;252;189;63;180296.45;60102.0;240398.45
510510;201801;787;452;335;430322.06;319580.47;749902.5
510515;201801;1139;606;533;577287.6;508444.38;1085732.0
510517;201801;247;106;141;100551.6;134490.69;235042.3
510520;201801;228;147;81;140145.3;76954.3;217099.6
510523;201801;93;63;30;60102.0;28610.46;88712.46
510525;201801;717;408;309;388459.3;294675.3;683134.6
510530;201801;17;12;5;11448.0;4770.0;16218.0
510550;201801;272;122;150;115919.27;143091.0;259010.27
510558;201801;278;136;142;129711.15;135439.92;265151.06
510560;201801;386;240;146;228960.0;139266.0;368226.0
510562;201801;641;446;195;424153.16;185543.45;609696.6
510590;201801;827;431;396;411136.38;377765.7;788902.06
510600;201801;255;138;117;131628.92;111580.92;243209.84
510610;201801;172;82;90;78208.92;85555.46;163764.38
510615;201801;189;77;112;73438.92;106848.0;180286.92
510617;201801;17;10;7;9540.0;6678.0;16218.0
510618;201801;115;55;60;52470.0;56763.0;109233.0
510619;201801;105;73;32;69633.0;30519.0;100152.0
510620;201801;189;106;83;101114.46;79182.0;180296.45
510621;201801;193;123;70;117323.46;66752.46;184075.92
510622;201801;448;289;159;275613.84;151362.38;426976.22
510623;201801;361;240;121;228913.38;115405.38;344318.75
510624;201801;88;40;48;38151.0;45792.0;83943.0
510625;201801;532;326;206;310794.3;195926.98;506721.28
510626;201801;107;67;40;63918.0;38160.0;102078.0
510627;201801;57;42;15;40068.0;14310.0;54378.0
510628;201801;164;98;66;93445.92;62906.76;156352.69
510629;201801;254;164;90;156456.0;84896.46;241352.45
510630;201801;458;233;225;222197.22;214313.48;436510.72
510631;201801;11;3;8;2862.0;7346.0;10208.0
510637;201801;345;192;153;182822.19;145815.84;328638.03
510642;201801;980;543;437;517671.2;416755.44;934426.6
510645;201801;0;0;0;0.0;0.0;0.0
510650;201801;1513;996;517;950021.4;493106.22;1443127.6
510665;201801;87;44;43;41920.0;41022.0;82942.0
510670;201801;66;36;30;34344.0;28620.0;62964.0
510675;201801;1172;704;468;671585.0;446449.22;1118034.2
510677;201801;365;172;193;163082.84;183696.69;346779.53
510680;201801;109;64;45;61038.0;42921.0;103959.0
510682;201801;202;96;106;91262.0;101124.0;192386.0
510685;201801;51;37;14;35298.0;13356.0;48654.0
510700;201801;620;360;260;343321.9;247906.77;591228.7
510704;201801;1041;565;476;536730.75;452518.97;989249.75
510706;201801;129;61;68;58189.23;64834.92;123024.15
510710;201801;389;263;126;250704.06;120089.68;370793.75
510715;201801;64;47;17;44828.46;16218.0;61046.46
510718;201801;208;111;97;105800.76;92519.46;198320.22
510719;201801;35;19;16;18126.0;15264.0;33390.0
510720;201801;196;130;66;124011.0;62677.8;186688.8
510724;201801;88;37;51;35288.46;48621.38;83909.84
510726;201801;52;27;25;25748.46;23832.0;49580.46
510729;201801;79;38;41;36252.0;39075.84;75327.84
510730;201801;473;258;215;246114.0;204962.45;451076.47
510735;201801;109;43;66;41022.0;62964.0;103986.0
510740;201801;29;15;14;14310.0;13356.0;27666.0
510757;201801;19;15;4;14310.0;3816.0;18126.0
510760;201801;7050;3751;3299;3566682.8;3140959.2;6707642.0
510770;201801;730;346;384;329895.3;366131.75;696027.06
510774;201801;14;6;8;5724.0;7632.0;13356.0
510775;201801;113;85;28;81080.46;26702.46;107782.92
510776;201801;29;8;21;7632.0;20034.0;27666.0
510777;201801;188;84;104;80107.38;99187.38;179294.77
510779;201801;55;25;30;23841.0;28582.92;52423.92
510780;201801;297;164;133;156393.45;126798.0;283191.47
510785;201801;446;242;204;230801.77;194539.69;425341.44
510787;201801;188;95;93;90616.23;88704.23;179320.45
510788;201801;0;0;0;0.0;0.0;0.0
510790;201801;2397;1246;1151;1186584.0;1095898.0;2282482.0
510792;201801;1079;601;478;572867.56;455596.88;1028464.44
510794;201801;113;56;57;53424.0;54349.92;107773.92
510795;201801;2404;1400;1004;1328274.5;954866.6;2283141.0
510800;201801;177;107;70;102068.46;66771.0;168839.45
510805;201801;165;116;49;110664.0;46746.0;157410.0
510810;201801;93;38;55;36169.38;52346.52;88515.9
510820;201801;260;122;138;116151.46;130652.03;246803.48
510830;201801;66;40;26;38160.0;24795.0;62955.0
510835;201801;7;5;2;4770.0;1908.0;6678.0
510840;201801;9286;4604;4682;4377725.0;4458436.5;8836161.0
510850;201801;208;87;121;82988.46;115110.18;198098.64
510860;201801;388;170;218;161993.52;207281.8;369275.3
510880;201801;64;49;15;46727.46;14310.0;61037.46
510885;201801;72;44;28;41957.46;26683.38;68640.84
510890;201801;73;42;31;40068.0;29574.0;69642.0
510895;201801;189;107;82;102078.0;77919.46;179997.45
520005;201801;33;22;11;20988.0;10494.0;31482.0
520010;201801;281;127;154;121158.0;146821.0;267979.0
520013;201801;631;377;254;359630.0;242029.8;601659.8
520015;201801;51;37;14;35298.0;13356.0;48654.0
520017;201801;103;60;43;56954.0;41022.0;97976.0
520020;201801;29;15;14;14310.0;13356.0;27666.0
520025;201801;2015;1093;922;1041539.25;878720.4;1920259.6
520030;201801;801;405;396;385407.0;376209.9;761616.9
520050;201801;77;52;25;49608.0;23850.0;73458.0
520055;201801;43;29;14;27666.0;13356.0;41022.0
520060;201801;178;115;63;109710.0;60102.0;169812.0
520080;201801;589;407;182;387991.8;173628.0;561619.8
520082;201801;20;14;6;13356.0;5724.0;19080.0
520085;201801;98;72;26;68688.0;24804.0;93492.0
520090;201801;91;63;28;60102.0;26712.0;86814.0
520110;201801;9012;3895;5117;3710717.2;4877935.5;8588653.0
520120;201801;13;8;5;7431.66;4770.0;12201.66
520130;201801;758;536;222;511335.0;211779.0;723114.0
520140;201801;11778;6624;5154;6311165.0;4913982.0;1,12E+14
520145;201801;44;33;11;31482.0;10494.0;41976.0
520150;201801;190;149;41;142146.0;39114.0;181260.0
520160;201801;32;22;10;20988.0;9540.0;30528.0
520170;201801;232;143;89;136390.0;84869.0;221259.0
520180;201801;115;60;55;57240.0;52470.0;109710.0
520215;201801;209;130;79;123733.8;75079.8;198813.6
520235;201801;70;53;17;50562.0;16218.0;66780.0
520250;201801;136;82;54;78228.0;51229.8;129457.8
520260;201801;112;70;42;66780.0;39114.0;105894.0
520280;201801;47;35;12;32723.0;11448.0;44171.0
520310;201801;39;26;13;24804.0;12402.0;37206.0
520320;201801;164;106;58;101114.46;55332.0;156446.45
520330;201801;781;411;370;392048.47;352953.0;745001.44
520340;201801;352;201;151;191754.0;144035.45;335789.47
520350;201801;523;238;285;227052.0;271843.0;498895.0
520355;201801;88;49;39;46746.0;37206.0;83952.0
520357;201801;25;18;7;17172.0;6678.0;23850.0
520360;201801;0;0;0;0.0;0.0;0.0
520380;201801;137;71;66;67734.0;62964.0;130698.0
520390;201801;294;122;172;115911.0;163825.5;279736.5
520393;201801;12;9;3;8586.0;2862.0;11448.0
520396;201801;97;57;40;54378.0;38160.0;92538.0
520400;201801;229;133;96;125261.2;91584.0;216845.2
520410;201801;203;103;100;98253.0;95391.0;193644.0
520420;201801;24;16;8;15264.0;7632.0;22896.0
520425;201801;299;128;171;121159.0;162658.2;283817.2
520430;201801;452;233;219;221995.8;208870.0;430865.8
520440;201801;601;399;202;380598.3;192708.0;573306.3
520450;201801;1905;863;1042;822187.44;993412.44;1815599.9
520455;201801;57;40;17;38160.0;16218.0;54378.0
520460;201801;30;15;15;14310.0;14310.0;28620.0
520465;201801;24;20;4;19080.0;3816.0;22896.0
520470;201801;417;258;159;245826.62;151686.0;397512.62
520480;201801;83;47;36;44838.0;34299.0;79137.0
520485;201801;126;42;84;40068.0;79850.0;119918.0
520490;201801;395;292;103;278383.97;98097.92;376481.9
520495;201801;179;108;71;103032.0;67734.0;170766.0
520500;201801;176;134;42;127836.0;40068.0;167904.0
520505;201801;173;91;82;86809.23;78228.0;165037.23
520510;201801;1769;866;903;822864.75;859437.94;1682302.8
520520;201801;38;29;9;27666.0;8586.0;36252.0
520530;201801;230;168;62;157880.31;58348.54;216228.86
520540;201801;533;353;180;335455.03;171720.0;507175.03
520545;201801;161;89;72;84906.0;68688.0;153594.0
520547;201801;52;29;23;27666.0;21942.0;49608.0
520549;201801;1076;512;564;488124.0;537652.0;1025776.0
520551;201801;291;149;142;142146.0;135468.0;277614.0
520552;201801;45;27;18;25758.0;17172.0;42930.0
520570;201801;16;9;7;8586.0;6678.0;15264.0
520580;201801;284;172;112;164069.45;106848.0;270917.47
520590;201801;161;95;66;90630.0;62677.8;153307.8
520620;201801;1137;534;603;508578.47;574680.25;1083258.8
520630;201801;42;25;17;23850.0;16218.0;40068.0
520640;201801;414;235;179;224190.0;170766.0;394956.0
520650;201801;53;38;15;36252.0;14310.0;50562.0
520660;201801;35;19;16;18126.0;15264.0;33390.0
520670;201801;33;28;5;26712.0;4770.0;31482.0
520680;201801;58;38;20;36252.0;19080.0;55332.0
520690;201801;33;10;23;9540.0;21914.46;31454.46
520710;201801;37;33;4;31482.0;3816.0;35298.0
520725;201801;197;126;71;120204.0;67734.0;187938.0
520735;201801;59;42;17;40068.0;16218.0;56286.0
520740;201801;400;198;202;188177.4;192699.0;380876.4
520750;201801;37;27;10;25758.0;9540.0;35298.0
520753;201801;53;38;15;36252.0;14310.0;50562.0
520760;201801;107;72;35;68688.0;33390.0;102078.0
520780;201801;286;218;68;207972.0;64872.0;272844.0
520790;201801;167;80;87;76033.8;82998.0;159031.8
520800;201801;3482;1856;1626;1767225.5;1550526.9;3317752.5
520810;201801;161;112;49;106848.0;46746.0;153594.0
520815;201801;5;5;0;4770.0;0.0;4770.0
520830;201801;139;91;48;86814.0;45505.8;132319.8
520840;201801;345;226;119;215127.0;113526.0;328653.0
520850;201801;107;69;38;65817.0;36099.36;101916.36
520860;201801;1683;1073;610;1022221.56;580796.2;1603017.8
520870;201801;30751;15137;15614;1,44E+14;1,49E+14;2,93E+12
520880;201801;1062;591;471;563814.0;449314.9;1013128.94
520890;201801;795;457;338;434347.4;322347.47;756694.9
520910;201801;1027;537;490;508721.75;467460.0;976181.75
520915;201801;99;76;23;72504.0;21932.46;94436.46
520920;201801;404;197;207;187365.6;197478.0;384843.6
520929;201801;19;17;2;16218.0;1908.0;18126.0
520940;201801;75;47;28;44838.0;26712.0;71550.0
520945;201801;21;13;8;12402.0;7632.0;20034.0
520960;201801;47;31;16;29574.0;15264.0;44838.0
520970;201801;330;205;125;194941.0;118963.8;313904.8
520980;201801;89;65;24;62010.0;22896.0;84906.0
520990;201801;472;317;155;302418.0;147870.0;450288.0
520993;201801;127;61;66;58194.0;62955.0;121149.0
520995;201801;242;135;107;127837.0;101506.0;229343.0
521000;201801;1547;899;648;855643.4;618097.0;1473740.4
521010;201801;664;304;360;289689.38;343374.3;633063.7
521015;201801;17;10;7;9540.0;6678.0;16218.0
521020;201801;1473;1021;452;973404.9;430837.22;1404242.1
521030;201801;45;31;14;29574.0;13356.0;42930.0
521040;201801;921;562;359;535910.2;342200.0;878110.2
521056;201801;43;29;14;27666.0;13356.0;41022.0
521060;201801;131;82;49;78228.0;46746.0;124974.0
521080;201801;466;348;118;331983.0;112572.0;444555.0
521090;201801;527;316;211;301464.0;201017.34;502481.34
521100;201801;289;212;77;202239.0;73458.0;275697.0
521120;201801;1039;711;328;676481.6;312617.0;989098.6
521130;201801;360;257;103;245168.45;97376.6;342545.06
521140;201801;186;106;80;101124.0;76320.0;177444.0
521150;201801;2808;1218;1590;1160008.9;1515587.5;2675596.2
521160;201801;32;17;15;16218.0;14310.0;30528.0
521170;201801;196;114;82;108746.46;78228.0;186974.45
521180;201801;1115;702;413;668077.25;393287.2;1061364.5
521190;201801;2559;1086;1473;1036024.94;1404364.8;2440389.8
521200;201801;46;34;12;32436.0;11448.0;43884.0
521205;201801;15;11;4;10494.0;3816.0;14310.0
521210;201801;147;83;64;79182.0;61056.0;140238.0
521220;201801;812;548;264;520159.75;251800.0;771959.75
521225;201801;28;17;11;16218.0;10494.0;26712.0
521230;201801;113;74;39;70309.8;37206.0;107515.8
521250;201801;6739;3716;3023;3538624.0;2881635.2;6420259.5
521260;201801;19;14;5;13356.0;4770.0;18126.0
521270;201801;145;112;33;106848.0;31482.0;138330.0
521280;201801;435;254;181;241648.2;172674.0;414322.2
521290;201801;31;13;18;12402.0;17172.0;29574.0
521295;201801;100;67;33;63689.04;31482.0;95171.04
521300;201801;232;119;113;113508.0;107442.38;220950.38
521305;201801;36;24;12;22896.0;11448.0;34344.0
521308;201801;1085;786;299;749345.7;284951.0;1034296.7
521310;201801;1348;801;547;762869.4;520646.9;1283516.4
521340;201801;22;17;5;16218.0;4770.0;20988.0
521350;201801;132;97;35;92538.0;33390.0;125928.0
521370;201801;189;118;71;111618.0;67447.8;179065.8
521375;201801;191;107;84;102078.0;79849.8;181927.8
521377;201801;51;34;17;32436.0;16218.0;48654.0
521380;201801;1063;694;369;657928.25;352026.0;1009954.25
521385;201801;15;8;7;7632.0;6678.0;14310.0
521390;201801;107;87;20;82680.04;19080.0;101760.04
521400;201801;325;206;119;196237.8;113478.3;309716.1
521405;201801;149;75;74;71550.0;70596.0;142146.0
521410;201801;66;44;22;41976.0;20988.0;62964.0
521440;201801;210;147;63;139427.1;60102.0;199529.1
521450;201801;721;399;322;380646.0;307188.0;687834.0
521460;201801;1185;725;460;691363.8;438820.9;1130184.8
521470;201801;14;9;5;8586.0;4770.0;13356.0
521480;201801;48;32;16;30519.0;15199.0;45718.0
521483;201801;302;161;141;153308.0;134514.0;287822.0
521486;201801;288;181;107;172549.98;101411.0;273960.97
521487;201801;23;11;12;10494.0;11448.0;21942.0
521490;201801;28;16;12;15264.0;11448.0;26712.0
521500;201801;114;73;41;69642.0;39114.0;108756.0
521520;201801;41;30;11;28620.0;10494.0;39114.0
521523;201801;585;360;225;341213.78;214650.0;555863.75
521525;201801;45;30;15;28620.0;14310.0;42930.0
521530;201801;248;131;117;124974.0;111618.0;236592.0
521540;201801;31;16;15;15264.0;14310.0;29574.0
521550;201801;93;43;50;40707.92;47644.92;88352.84
521560;201801;798;547;251;521507.72;239311.0;760818.75
521565;201801;47;32;15;30528.0;14310.0;44838.0
521570;201801;488;327;161;311948.47;153499.3;465447.75
521580;201801;61;38;23;36252.0;21942.0;58194.0
521590;201801;35;19;16;18126.0;15264.0;33390.0
521600;201801;30;18;12;17172.0;11448.0;28620.0
521630;201801;237;119;118;113516.46;111581.96;225098.42
521640;201801;301;152;149;145008.0;142146.0;287154.0
521645;201801;30;16;14;15264.0;13356.0;28620.0
521680;201801;219;139;80;132606.0;76320.0;208926.0
521690;201801;3;2;1;1908.0;954.0;2862.0
521710;201801;1193;558;635;531473.8;605781.0;1137254.8
521720;201801;533;351;182;334844.47;173590.45;508434.9
521730;201801;626;305;321;290970.0;305127.56;596097.56
521740;201801;918;369;549;351997.9;522546.3;874544.25
521760;201801;1583;858;725;816954.6;691336.0;1508290.6
521770;201801;802;510;292;486540.0;278100.53;764640.56
521800;201801;2088;1294;794;1230934.5;757052.6;1987987.2
521805;201801;33;18;15;17172.0;14310.0;31482.0
521810;201801;94;58;36;54187.8;34344.0;88531.8
521830;201801;956;671;285;638512.6;271881.0;910393.6
521839;201801;93;62;31;59148.0;29574.0;88722.0
521850;201801;1105;589;516;560486.94;491939.7;1052426.6
521860;201801;346;213;133;203202.0;126596.0;329798.0
521870;201801;74;43;31;41022.0;29574.0;70596.0
521878;201801;42;20;22;19080.0;20988.0;40068.0
521880;201801;4459;1997;2462;1902847.4;2345857.8;4248705.0
521890;201801;574;397;177;378738.0;168571.8;547309.8
521900;201801;290;234;56;222599.95;53424.0;276023.97
521910;201801;154;108;46;103032.0;43884.0;146916.0
521920;201801;53;25;28;23850.0;26712.0;50562.0
521925;201801;35;21;14;20034.0;13356.0;33390.0
521930;201801;1118;639;479;609410.0;456313.34;1065723.4
521935;201801;32;25;7;23850.0;6678.0;30528.0
521940;201801;193;97;96;92538.0;91579.23;184117.23
521945;201801;14;12;2;11448.0;1908.0;13356.0
521950;201801;9;5;4;4770.0;3816.0;8586.0
521960;201801;74;55;19;52470.0;18126.0;70596.0
521970;201801;422;269;153;256339.8;145962.0;402301.8
521971;201801;96;47;49;44838.0;46746.0;91584.0
521973;201801;29;13;16;12402.0;15264.0;27666.0
521975;201801;1101;570;531;542636.2;505658.66;1048294.9
521980;201801;245;167;78;159318.0;74412.0;233730.0
521990;201801;71;52;19;49608.0;18126.0;67734.0
522000;201801;288;178;110;169812.0;104940.0;274752.0
522005;201801;21;13;8;12402.0;7632.0;20034.0
522010;201801;1116;626;490;597195.0;466878.06;1064073.0
522015;201801;54;33;21;31473.0;20034.0;51507.0
522020;201801;867;465;402;442656.2;382726.12;825382.3
522026;201801;30;22;8;20988.0;7632.0;28620.0
522028;201801;16;12;4;11448.0;3816.0;15264.0
522040;201801;747;296;451;282080.0;430199.47;712279.44
522045;201801;2054;1291;763;1230292.0;727368.8;1957660.9
522050;201801;169;81;88;77274.0;83952.0;161226.0
522060;201801;559;352;207;335521.8;197382.6;532904.4
522068;201801;136;90;46;85860.0;43884.0;129744.0
522070;201801;10;10;0;9540.0;0.0;9540.0
522100;201801;46;24;22;22628.88;20988.0;43616.88
522108;201801;40;30;10;28620.0;9540.0;38160.0
522119;201801;57;29;28;27666.0;26712.0;54378.0
522130;201801;74;25;49;23850.0;46728.0;70578.0
522140;201801;3696;1883;1813;1790760.4;1727437.9;3518198.2
522145;201801;51;30;21;28620.0;20034.0;48654.0
522150;201801;64;50;14;47700.0;13356.0;61056.0
522155;201801;58;41;17;39105.0;16218.0;55323.0
522157;201801;5;4;1;3816.0;954.0;4770.0
522160;201801;1728;1009;719;961441.2;685630.8;1647072.0
522170;201801;396;267;129;254718.0;123066.0;377784.0
522180;201801;36;20;16;19080.0;15264.0;34344.0
522185;201801;1295;542;753;514047.25;717841.0;1231888.2
522190;201801;48;27;21;25758.0;19938.6;45696.6
522200;201801;299;181;118;172674.0;112572.0;285246.0
522205;201801;166;111;55;105894.0;52470.0;158364.0
522220;201801;166;117;49;111618.0;46746.0;158364.0
522230;201801;31;24;7;22896.0;6678.0;29574.0
530010;201801;55576;28473;27103;2,70E+14;2,58E+14;5,28E+13
110001;201802;515;408;107;388248.34;101432.96;489681.3
110002;201802;2791;1674;1117;1595116.2;1064711.5;2659827.8
110003;201802;93;73;20;69642.0;19080.0;88722.0
110004;201802;1992;1272;720;1210587.0;686584.25;1897171.2
110005;201802;440;352;88;334652.9;83942.46;418595.38
110006;201802;446;343;103;326935.8;98242.92;425178.72
110007;201802;82;65;17;62010.0;16218.0;78228.0
110008;201802;238;136;102;128508.9;97308.0;225816.9
110009;201802;785;531;254;504381.2;242117.0;746498.2
110010;201802;1790;1109;681;1056753.0;649532.5;1706285.5
110011;201802;1879;1446;433;1377953.2;413052.34;1791005.5
110012;201802;4108;2391;1717;2273527.8;1636746.5;3910274.2
110013;201802;747;565;182;539000.44;173628.0;712628.44
110014;201802;366;311;55;296673.88;52465.23;349139.12
110015;201802;1421;1147;274;1091810.9;260804.52;1352615.4
110018;201802;1117;665;452;634096.0;431195.22;1065291.2
110020;201802;15327;9007;6320;8548652.0;6018370.5;1,46E+14
110025;201802;649;475;174;451152.12;165987.0;617139.1
110026;201802;42;28;14;26712.0;13356.0;40068.0
110028;201802;1645;1191;454;1131612.6;429523.44;1561136.0
110029;201802;140;123;17;117342.0;16218.0;133560.0
110030;201802;2472;1658;814;1578821.5;775655.44;2354477.0
110032;201802;395;304;91;289707.0;86810.0;376517.0
110033;201802;670;504;166;477813.0;158360.0;636173.0
110034;201802;359;267;92;252406.0;87101.0;339507.0
110037;201802;105;86;19;82044.0;18126.0;100170.0
110040;201802;333;222;111;211788.0;105894.0;317682.0
110045;201802;935;622;313;591842.0;296898.38;888740.4
110050;201802;94;76;18;72504.0;17172.0;89676.0
110060;201802;86;45;41;42930.0;39114.0;82044.0
110070;201802;125;74;51;70596.0;48368.0;118964.0
110080;201802;397;237;160;223875.19;152591.27;376466.44
110090;201802;32;27;5;25758.0;4770.0;30528.0
110092;201802;111;63;48;60102.0;45722.0;105824.0
110094;201802;200;139;61;132606.0;58194.0;190800.0
110100;201802;27;22;5;20988.0;4770.0;25758.0
110110;201802;71;44;27;41976.0;25758.0;67734.0
110120;201802;74;60;14;57240.0;13356.0;70596.0
110130;201802;303;244;59;231281.12;56286.0;287567.12
110140;201802;247;159;88;151495.2;83942.46;235437.66
110143;201802;48;40;8;38160.0;7632.0;45792.0
110145;201802;29;20;9;19080.0;8586.0;27666.0
110146;201802;23;12;11;11448.0;10494.0;21942.0
110147;201802;39;30;9;28620.0;8586.0;37206.0
110148;201802;39;27;12;25706.57;11448.0;37154.57
110149;201802;295;212;83;201961.8;79182.0;281143.8
110150;201802;84;57;27;54378.0;25491.89;79869.89
110155;201802;8;7;1;6678.0;954.0;7632.0
110160;201802;71;59;12;56286.0;11448.0;67734.0
110170;201802;210;170;40;162180.0;38160.0;200340.0
110175;201802;33;25;8;23850.0;7632.0;31482.0
110180;201802;92;80;12;76320.0;11448.0;87768.0
120001;201802;134;91;43;86772.0;40993.0;127765.0
120005;201802;190;118;72;112529.12;68688.0;181217.12
120010;201802;1012;651;361;613931.25;342161.16;956092.4
120013;201802;139;96;43;90897.94;40042.0;130939.94
120017;201802;92;59;33;56177.48;31439.12;87616.6
120020;201802;3515;2796;719;2638761.8;682319.7;3321081.2
120025;201802;600;338;262;319914.22;248866.6;568780.8
120030;201802;1017;850;167;802763.7;158560.12;961323.8
120032;201802;49;41;8;39092.12;7632.0;46724.12
120033;201802;215;189;26;179958.75;24804.0;204762.75
120034;201802;156;113;43;105872.12;40978.24;146850.36
120035;201802;30;21;9;20034.0;8586.0;28620.0
120038;201802;387;244;143;231951.88;136378.23;368330.12
120039;201802;23;21;2;20034.0;1908.0;21942.0
120040;201802;14027;9707;4320;9127854.0;4081920.2;1,32E+14
120042;201802;43;37;6;35298.0;5724.0;41022.0
120043;201802;13;3;10;2862.0;9540.0;12402.0
120045;201802;538;348;190;329911.38;180994.6;510905.97
120050;201802;1259;962;297;912181.8;282961.28;1195143.1
120060;201802;1420;1149;271;1079789.9;254591.2;1334381.1
120070;201802;502;361;141;337902.44;133172.55;471074.97
120080;201802;161;103;58;97054.3;54765.3;151819.6
130002;201802;149;104;45;99216.0;42930.0;142146.0
130006;201802;75;43;32;41022.0;30528.0;71550.0
130008;201802;144;77;67;72737.72;63195.96;135933.69
130010;201802;138;73;65;69642.0;62010.0;131652.0
130014;201802;236;172;64;164088.0;61056.0;225144.0
130020;201802;88;47;41;44838.0;39114.0;83952.0
130030;201802;892;544;348;518976.0;331982.47;850958.44
130040;201802;330;164;166;156456.0;157410.28;313866.28
130050;201802;555;307;248;292591.8;236592.0;529183.8
130060;201802;888;605;283;572021.2;267161.25;839182.44
130063;201802;546;285;261;271890.0;248972.12;520862.12
130068;201802;187;121;66;115434.0;62677.8;178111.8
130070;201802;1333;926;407;869885.6;383315.12;1253200.8
130080;201802;660;430;230;409838.4;219411.0;629249.4
130083;201802;70;38;32;36252.0;30528.0;66780.0
130090;201802;377;195;182;184350.95;173628.0;357978.97
130100;201802;1107;517;590;493218.0;562573.8;1055791.8
130110;201802;701;314;387;299406.0;369198.0;668604.0
130115;201802;172;69;103;65826.0;98262.0;164088.0
130120;201802;1625;1013;612;966402.0;583848.0;1550250.0
130130;201802;615;416;199;396864.0;189846.0;586710.0
130140;201802;1531;1151;380;1097391.0;361566.2;1458957.2
130150;201802;426;361;65;344394.0;62010.0;406404.0
130160;201802;469;262;207;249948.0;197478.0;447426.0
130165;201802;23;16;7;15264.0;6678.0;21942.0
130170;201802;942;668;274;637201.4;261396.0;898597.4
130180;201802;151;91;60;86337.0;57240.0;143577.0
130185;201802;2244;1170;1074;1114251.9;1024004.94;2138256.8
130190;201802;3612;2258;1354;2149904.8;1290128.0;3440032.8
130195;201802;291;233;58;222282.0;55332.0;277614.0
130200;201802;178;81;97;77264.46;92538.0;169802.45
130210;201802;78;39;39;37206.0;37206.0;74412.0
130220;201802;187;128;59;122112.0;56286.0;178398.0
130230;201802;333;210;123;200340.0;117342.0;317682.0
130240;201802;1459;919;540;875386.4;514582.84;1389969.2
130250;201802;4721;3041;1680;2895767.0;1602567.5;4498334.5
130255;201802;424;209;215;199386.0;204823.8;404209.8
130260;201802;53164;25421;27743;2,42E+14;2,65E+14;5,07E+14
130270;201802;1503;959;544;914409.0;518976.0;1433385.0
130280;201802;114;69;45;65826.0;42930.0;108756.0
130290;201802;2077;1504;573;1434816.0;546355.8;1981171.8
130300;201802;424;305;119;290683.8;113526.0;404209.8
130310;201802;883;467;416;445518.0;396864.0;842382.0
130320;201802;443;237;206;225144.0;196524.0;421668.0
130330;201802;705;427;278;407358.0;264925.8;672283.8
130340;201802;3249;1964;1285;1869077.2;1224459.2;3093536.5
130350;201802;472;301;171;287132.12;163134.0;450266.12
130353;201802;780;320;460;304994.0;438840.0;743834.0
130356;201802;759;347;412;331038.0;392761.8;723799.8
130360;201802;69;40;29;38160.0;27666.0;65826.0
130370;201802;677;499;178;476046.0;169812.0;645858.0
130380;201802;631;433;198;413082.0;188892.0;601974.0
130390;201802;484;390;94;372060.0;89676.0;461736.0
130395;201802;181;41;140;39114.0;133560.0;172674.0
130400;201802;69;46;23;43884.0;21942.0;65826.0
130406;201802;2077;1310;767;1246126.2;730507.75;1976634.0
130410;201802;501;214;287;204156.0;273778.9;477934.9
130420;201802;3193;2562;631;2440361.5;601974.0;3042335.5
130423;201802;161;75;86;71550.0;82044.0;153594.0
130426;201802;142;83;59;79182.0;56286.0;135468.0
130430;201802;406;268;138;255672.0;131652.0;387324.0
130440;201802;198;71;127;67734.0;121158.0;188892.0
140002;201802;36;14;22;13356.0;20988.0;34344.0
140005;201802;206;126;80;119965.5;76320.0;196285.5
140010;201802;10250;6928;3322;6576631.0;3166514.8;9743146.0
140015;201802;155;69;86;65826.0;82044.0;147870.0
140017;201802;110;76;34;72504.0;32436.0;104940.0
140020;201802;477;319;158;303372.0;150732.0;454104.0
140023;201802;26;16;10;15045.0;9540.0;24585.0
140028;201802;18;13;5;12402.0;4770.0;17172.0
140030;201802;360;256;104;244224.0;98614.98;342838.97
140040;201802;55;38;17;36252.0;16122.6;52374.6
140045;201802;247;115;132;109042.2;125928.0;234970.2
140047;201802;561;377;184;357646.38;174773.0;532419.4
140050;201802;148;97;51;91725.0;48654.0;140379.0
140060;201802;34;23;11;21207.42;10494.0;31701.42
140070;201802;31;28;3;26712.0;2862.0;29574.0
150010;201802;4719;2921;1798;2783915.5;1713280.9;4497196.5
150013;201802;146;99;47;94446.0;44838.0;139284.0
150020;201802;1074;570;504;543780.0;480816.0;1024596.0
150030;201802;736;300;436;286200.0;415944.0;702144.0
150034;201802;195;121;74;115434.0;70596.0;186030.0
150040;201802;1395;826;569;788004.0;542826.0;1330830.0
150050;201802;711;422;289;401586.8;275506.0;677092.8
150060;201802;4744;3070;1674;2925308.2;1596757.5;4522065.5
150070;201802;316;146;170;139284.0;162180.0;301464.0
150080;201802;14538;7309;7229;6961184.0;6888471.0;1,38E+14
150085;201802;372;234;138;223226.45;131652.0;354878.47
150090;201802;760;647;113;617238.0;107802.0;725040.0
150095;201802;344;210;134;199570.12;127015.56;326585.7
150100;201802;55;39;16;37206.0;15264.0;52470.0
150110;201802;173;85;88;81090.0;83952.0;165042.0
150120;201802;434;323;111;308142.0;105894.0;414036.0
150125;201802;54;23;31;21942.0;29574.0;51516.0
150130;201802;1898;1013;885;966402.0;844285.25;1810687.2
150140;201802;54570;25422;29148;2,42E+14;2,78E+14;5,20E+14
150145;201802;177;103;74;98262.0;70596.0;168858.0
150150;201802;2816;1259;1557;1200868.5;1481433.6;2682302.0
150157;201802;437;302;135;288108.0;128785.23;416893.22
150160;201802;122;98;24;93492.0;22896.0;116388.0
150170;201802;3667;2718;949;2589108.2;905059.8;3494168.0
150172;201802;322;221;101;210834.0;96354.0;307188.0
150175;201802;91;56;35;53424.0;33390.0;86814.0
150178;201802;761;507;254;482532.78;242316.0;724848.75
150180;201802;3052;1468;1584;1399661.6;1510540.0;2910201.5
150190;201802;336;215;121;205110.0;115434.0;320544.0
150195;201802;119;58;61;55332.0;58194.0;113526.0
150200;201802;207;97;110;92538.0;104940.0;197478.0
150210;201802;3172;2569;603;2449767.8;575019.5;3024787.2
150215;201802;506;332;174;316728.0;165996.0;482724.0
150220;201802;3927;2653;1274;2529402.8;1213278.4;3742681.0
150230;201802;1148;921;227;878054.06;216554.0;1094608.0
150240;201802;5791;3387;2404;3227756.8;2293407.0;5521163.5
150250;201802;33;16;17;15264.0;16218.0;31482.0
150260;201802;73;44;29;41976.0;27666.0;69642.0
150270;201802;2347;1534;813;1462144.4;774743.8;2236888.0
150275;201802;580;354;226;337716.0;215604.0;553320.0
150276;201802;104;44;60;41976.0;57240.0;99216.0
150277;201802;759;327;432;311939.47;412128.0;724067.44
150280;201802;342;210;132;200340.0;125928.0;326268.0
150285;201802;74;37;37;35298.0;35298.0;70596.0
150290;201802;966;591;375;563518.25;357464.0;920982.25
150293;201802;677;311;366;296494.47;349164.0;645658.44
150295;201802;464;206;258;196524.0;245979.44;442503.44
150300;201802;80;41;39;39114.0;37206.0;76320.0
150304;201802;141;93;48;88722.0;45792.0;134514.0
150307;201802;399;329;70;313866.0;66780.0;380646.0
150309;201802;553;398;155;379692.0;147870.0;527562.0
150310;201802;253;171;82;163134.0;78228.0;241362.0
150320;201802;1796;1236;560;1178862.6;534240.0;1713102.6
150330;201802;2073;1190;883;1134592.2;842382.0;1976974.2
150340;201802;198;133;65;126643.5;62010.0;188653.5
150345;201802;603;326;277;310822.75;264258.0;575080.75
150350;201802;418;324;94;306701.47;89676.0;396377.47
150360;201802;4500;2876;1624;2740036.2;1549286.5;4289322.5
150370;201802;755;539;216;513410.0;205768.8;719178.8
150375;201802;194;102;92;97308.0;87768.0;185076.0
150380;201802;1289;853;436;813762.0;415658.0;1229420.0
150390;201802;742;422;320;402584.0;305280.0;707864.0
150400;201802;98;81;17;77274.0;16218.0;93492.0
150405;201802;1252;827;425;788201.5;404877.6;1193079.1
150410;201802;140;90;50;85840.92;47700.0;133540.92
150420;201802;7429;4051;3378;3862995.5;3220764.8;7083760.0
150430;201802;491;330;161;314820.0;153594.0;468414.0
150440;201802;593;350;243;333137.0;231822.0;564959.0
150442;201802;2144;1150;994;1094572.0;947699.0;2042271.1
150445;201802;524;328;196;312912.0;186030.0;498942.0
150450;201802;274;128;146;122112.0;139284.0;261396.0
150460;201802;768;582;186;553401.06;177424.92;730826.0
150470;201802;1336;805;531;767684.0;506574.0;1274258.0
150475;201802;36;26;10;24804.0;9540.0;34344.0
150480;201802;1245;866;379;826164.0;361279.8;1187443.8
150490;201802;619;337;282;321498.0;269028.0;590526.0
150495;201802;330;230;100;219420.0;95400.0;314820.0
150497;201802;301;205;96;195570.0;91574.46;287144.47
150500;201802;431;290;141;276660.0;134514.0;411174.0
150503;201802;864;414;450;394670.0;429282.0;823952.0
150506;201802;1030;672;358;641088.0;341522.47;982610.44
150510;201802;1241;697;544;664652.0;518976.0;1183628.0
150520;201802;274;182;92;173628.0;87768.0;261396.0
150530;201802;1576;850;726;807752.3;691363.8;1499116.1
150540;201802;239;166;73;158364.0;69642.0;228006.0
150543;201802;695;396;299;377192.53;284959.8;662152.3
150548;201802;499;344;155;328176.0;147870.0;476046.0
150549;201802;60;40;20;38160.0;19080.0;57240.0
150550;201802;2900;1511;1389;1440541.0;1324820.0;2765361.0
150553;201802;3073;1815;1258;1729984.6;1200122.5;2930107.0
150555;201802;144;75;69;71550.0;65826.0;137376.0
150560;201802;53;40;13;38160.0;12402.0;50562.0
150563;201802;73;39;34;37206.0;32436.0;69642.0
150565;201802;167;99;68;94446.0;64872.0;159318.0
150570;201802;401;266;135;253744.92;128790.0;382534.9
150580;201802;1517;641;876;610846.2;835704.0;1446550.2
150590;201802;775;474;301;452196.0;287154.0;739350.0
150600;201802;461;276;185;263304.0;176490.0;439794.0
150610;201802;145;125;20;118401.0;19080.0;137481.0
150611;201802;126;88;38;83952.0;36252.0;120204.0
150613;201802;3188;1956;1232;1866024.0;1175319.0;3041343.0
150616;201802;486;300;186;285962.0;177444.0;463406.0
150618;201802;1139;629;510;599837.56;486540.0;1086377.6
150619;201802;396;303;93;289062.0;88722.0;377784.0
150620;201802;1278;741;537;706914.0;512011.8;1218925.8
150630;201802;310;208;102;198432.0;97308.0;295740.0
150635;201802;492;205;287;195570.0;273798.0;469368.0
150640;201802;62;30;32;28620.0;30528.0;59148.0
150650;201802;2322;1357;965;1294540.4;920319.0;2214859.2
150655;201802;244;181;63;172674.0;60102.0;232776.0
150658;201802;105;60;45;57240.0;42930.0;100170.0
150660;201802;484;338;146;322452.0;139284.0;461736.0
150670;201802;1003;364;639;346960.8;609587.44;956548.25
150680;201802;9869;5378;4491;5123441.0;4282091.0;9405532.0
150690;201802;53;34;19;32436.0;18126.0;50562.0
150700;201802;538;347;191;330847.2;182214.0;513061.2
150710;201802;275;163;112;155502.0;106848.0;262350.0
150715;201802;873;527;346;501775.9;330055.38;831831.3
150720;201802;443;338;105;322452.0;99883.8;422335.8
150730;201802;915;485;430;462681.0;409933.8;872614.8
150740;201802;234;164;70;156456.0;66780.0;223236.0
150745;201802;764;410;354;391140.0;337716.0;728856.0
150746;201802;53;32;21;30528.0;20034.0;50562.0
150747;201802;270;208;62;198432.0;59148.0;257580.0
150750;201802;131;75;56;71550.0;53424.0;124974.0
150760;201802;1708;1106;602;1055124.0;574308.0;1629432.0
150770;201802;371;192;179;183168.0;170590.95;353758.94
150775;201802;91;42;49;40068.0;46746.0;86814.0
150780;201802;187;99;88;94446.0;83952.0;178398.0
150790;201802;890;485;405;462690.0;386370.0;849060.0
150795;201802;1440;837;603;798498.0;575262.0;1373760.0
150796;201802;404;233;171;222282.0;163134.0;385416.0
150797;201802;283;158;125;150732.0;119250.0;269982.0
150800;201802;1419;857;562;816619.25;536148.0;1352767.2
150803;201802;599;492;107;469368.0;102078.0;571446.0
150805;201802;187;118;69;112572.0;65812.46;178384.45
150808;201802;984;539;445;514206.0;424530.0;938736.0
150810;201802;3385;2338;1047;2227009.0;998266.0;3225275.0
150812;201802;428;224;204;213696.0;194616.0;408312.0
150815;201802;969;636;333;605365.5;317682.0;923047.5
150820;201802;1571;961;610;915840.0;581920.94;1497760.9
150830;201802;830;582;248;554274.0;236592.0;790866.0
150835;201802;189;111;78;105894.0;74412.0;180306.0
150840;201802;1317;839;478;800406.0;456012.0;1256418.0
160005;201802;53;31;22;29574.0;20988.0;50562.0
160010;201802;191;118;73;112572.0;69638.0;182210.0
160015;201802;117;67;50;63918.0;47700.0;111618.0
160020;201802;128;73;55;69642.0;52470.0;122112.0
160021;201802;41;21;20;20034.0;19080.0;39114.0
160023;201802;110;63;47;60102.0;44838.0;104940.0
160025;201802;33;14;19;13356.0;18126.0;31482.0
160027;201802;1444;822;622;781612.7;592634.0;1374246.8
160030;201802;15516;7962;7554;7586510.5;7201777.5;1,48E+14
160040;201802;316;180;136;171720.0;129744.0;301464.0
160050;201802;656;339;317;323406.0;302131.8;625537.8
160053;201802;322;184;138;175250.0;131652.0;306902.0
160055;201802;24;18;6;17172.0;5724.0;22896.0
160060;201802;6333;3300;3033;3138558.0;2892524.2;6031082.0
160070;201802;164;101;63;96354.0;60102.0;156456.0
160080;201802;79;41;38;39114.0;36252.0;75366.0
170025;201802;24;16;8;15264.0;7632.0;22896.0
170030;201802;229;186;43;177247.0;41022.0;218269.0
170035;201802;226;110;116;104940.0;110664.0;215604.0
170040;201802;192;148;44;140905.8;41976.0;182881.8
170070;201802;321;191;130;182214.0;124020.0;306234.0
170100;201802;375;269;106;256626.0;101124.0;357750.0
170105;201802;62;51;11;48654.0;10494.0;59148.0
170110;201802;103;63;40;60102.0;38160.0;98262.0
170130;201802;72;33;39;31482.0;36920.0;68402.0
170190;201802;105;66;39;62964.0;37206.0;100170.0
170200;201802;392;261;131;248317.2;124869.76;373186.97
170210;201802;6016;3121;2895;2969043.8;2758381.8;5727425.5
170215;201802;97;46;51;43884.0;48654.0;92538.0
170220;201802;1427;1047;380;996643.8;362234.0;1358877.8
170230;201802;154;99;55;94446.0;52470.0;146916.0
170240;201802;552;365;187;348210.0;178398.0;526608.0
170255;201802;1112;891;221;849804.1;210547.8;1060351.9
170270;201802;37;28;9;26712.0;8395.2;35107.2
170290;201802;75;56;19;53424.0;18126.0;71550.0
170300;201802;81;53;28;49798.8;26712.0;76510.8
170305;201802;43;33;10;31482.0;9540.0;41022.0
170307;201802;64;47;17;44838.0;16218.0;61056.0
170310;201802;101;55;46;52470.0;43884.0;96354.0
170320;201802;17;14;3;13356.0;2862.0;16218.0
170330;201802;19;17;2;16218.0;1908.0;18126.0
170360;201802;25;15;10;14310.0;9540.0;23850.0
170370;201802;122;64;58;61056.0;55332.0;116388.0
170380;201802;81;58;23;55332.0;21942.0;77274.0
170382;201802;48;43;5;41022.0;4770.0;45792.0
170384;201802;129;94;35;89676.0;33390.0;123066.0
170386;201802;61;27;34;25758.0;32436.0;58194.0
170388;201802;46;16;30;15264.0;28620.0;43884.0
170389;201802;24;18;6;17172.0;5724.0;22896.0
170390;201802;51;30;21;28620.0;20034.0;48654.0
170410;201802;34;23;11;21942.0;10494.0;32436.0
170460;201802;17;12;5;11448.0;4770.0;16218.0
170510;201802;28;21;7;20034.0;6678.0;26712.0
170550;201802;1486;842;644;803268.0;613613.0;1416881.0
170555;201802;111;76;35;72504.0;33390.0;105894.0
170560;201802;97;70;27;66780.0;25758.0;92538.0
170600;201802;39;19;20;18126.0;19080.0;37206.0
170610;201802;192;101;91;96196.59;86796.0;182992.6
170625;201802;39;20;19;19080.0;18126.0;37206.0
170650;201802;86;64;22;61056.0;20988.0;82044.0
170700;201802;554;420;134;399326.3;127836.0;527162.3
170710;201802;154;94;60;89676.0;57231.0;146907.0
170720;201802;86;69;17;65826.0;16218.0;82044.0
170730;201802;58;34;24;32436.0;22896.0;55332.0
170740;201802;79;59;20;56286.0;19080.0;75366.0
170755;201802;70;37;33;34678.0;31482.0;66160.0
170765;201802;143;69;74;65206.0;70596.0;135802.0
170770;201802;225;129;96;121968.9;91584.0;213552.9
170820;201802;595;390;205;372060.0;195141.0;567201.0
170825;201802;30;19;11;18126.0;10494.0;28620.0
170830;201802;76;55;21;52279.2;20034.0;72313.2
170900;201802;201;152;49;145008.0;46746.0;191754.0
170930;201802;813;424;389;404172.0;370534.0;774706.0
170950;201802;3039;1325;1714;1262505.9;1631789.5;2894295.2
170980;201802;17;9;8;8586.0;7632.0;16218.0
171050;201802;132;101;31;96354.0;29574.0;125928.0
171070;201802;38;31;7;29574.0;6678.0;36252.0
171090;201802;39;29;10;27666.0;9540.0;37206.0
171110;201802;21;14;7;13356.0;6678.0;20034.0
171150;201802;39;18;21;17172.0;20034.0;37206.0
171180;201802;21;10;11;9540.0;10494.0;20034.0
171190;201802;138;81;57;77274.0;54378.0;131652.0
171195;201802;64;50;14;47700.0;13356.0;61056.0
171200;201802;46;19;27;18126.0;25758.0;43884.0
171215;201802;2;2;0;1908.0;0.0;1908.0
171240;201802;54;44;10;41976.0;9540.0;51516.0
171245;201802;51;47;4;44838.0;3816.0;48654.0
171250;201802;72;38;34;36252.0;32426.46;68678.46
171270;201802;17;13;4;12402.0;3816.0;16218.0
171280;201802;39;36;3;34201.0;2862.0;37063.0
171320;201802;991;560;431;534240.0;410220.0;944460.0
171330;201802;426;203;223;193662.0;212742.0;406404.0
171360;201802;85;63;22;60102.0;20988.0;81090.0
171370;201802;24;13;11;12402.0;10494.0;22896.0
171380;201802;134;110;24;104940.0;22666.09;127606.09
171395;201802;54;33;21;31482.0;20034.0;51516.0
171420;201802;309;205;104;195570.0;98929.8;294499.8
171430;201802;64;51;13;48654.0;12402.0;61056.0
171488;201802;207;110;97;104940.0;92538.0;197478.0
171500;201802;59;32;27;30528.0;25758.0;56286.0
171510;201802;68;45;23;42930.0;21942.0;64872.0
171515;201802;43;37;6;35298.0;5724.0;41022.0
171525;201802;31;26;5;24804.0;4770.0;29574.0
171550;201802;13;7;6;6678.0;5724.0;12402.0
171570;201802;61;30;31;28620.0;29574.0;58194.0
171575;201802;340;210;130;200340.0;124010.46;324350.47
171610;201802;1691;849;842;808047.5;801701.1;1609748.6
171620;201802;133;92;41;87214.68;39114.0;126328.68
171630;201802;51;27;24;25758.0;22896.0;48654.0
171650;201802;273;179;94;170766.0;89676.0;260442.0
171660;201802;264;140;124;133560.0;118292.0;251852.0
171665;201802;46;30;16;28620.0;15264.0;43884.0
171670;201802;433;252;181;237489.27;172101.6;409590.88
171700;201802;63;55;8;52470.0;7632.0;60102.0
171720;201802;25;8;17;7632.0;16218.0;23850.0
171750;201802;102;54;48;51516.0;45792.0;97308.0
171780;201802;70;57;13;54378.0;12402.0;66780.0
171790;201802;80;66;14;62964.0;13356.0;76320.0
171800;201802;36;28;8;26712.0;7632.0;34344.0
171820;201802;2058;1163;895;1108793.8;849222.8;1958016.5
171830;201802;37;29;8;27666.0;7632.0;35298.0
171840;201802;61;34;27;32436.0;25758.0;58194.0
171845;201802;32;20;12;19080.0;11448.0;30528.0
171850;201802;39;27;12;25758.0;11448.0;37206.0
171855;201802;77;60;17;57240.0;16218.0;73458.0
171865;201802;8;7;1;6678.0;954.0;7632.0
171870;201802;30;22;8;20988.0;7632.0;28620.0
171875;201802;77;52;25;49608.0;23850.0;73458.0
171880;201802;26;18;8;17172.0;7632.0;24804.0
171884;201802;47;24;23;22896.0;21942.0;44838.0
171886;201802;116;40;76;38160.0;72217.8;110377.8
171888;201802;24;18;6;17172.0;5724.0;22896.0
171889;201802;19;15;4;14310.0;3816.0;18126.0
171890;201802;56;46;10;43884.0;9540.0;53424.0
171900;201802;42;29;13;27666.0;12402.0;40068.0
172000;201802;41;35;6;33390.0;5724.0;39114.0
172010;201802;39;33;6;30671.1;5724.0;36395.1
172015;201802;26;16;10;15264.0;9253.8;24517.8
172020;201802;129;81;48;77274.0;45792.0;123066.0
172025;201802;32;21;11;20034.0;10494.0;30528.0
172030;201802;35;20;15;19080.0;14310.0;33390.0
172049;201802;74;44;30;41976.0;28620.0;70596.0
172065;201802;148;96;52;91584.0;49608.0;141192.0
172080;201802;90;64;26;59873.84;24804.0;84677.84
172085;201802;26;13;13;12402.0;12402.0;24804.0
172090;201802;401;304;97;290016.0;91775.0;381791.0
172093;201802;25;18;7;17172.0;6678.0;23850.0
172097;201802;16;8;8;7632.0;7346.0;14978.0
172100;201802;4676;2623;2053;2497349.8;1956093.0;4453443.0
172110;201802;81;53;28;50562.0;26712.0;77274.0
172120;201802;1725;1477;248;1402941.6;235484.4;1638426.0
172125;201802;2;2;0;1908.0;0.0;1908.0
172130;201802;16;13;3;12402.0;2862.0;15264.0
172208;201802;194;123;71;117342.0;67734.0;185076.0
172210;201802;434;210;224;200340.0;213410.0;413750.0
210005;201802;2913;1816;1097;1729411.2;1043678.0;2773089.2
210010;201802;193;98;95;93492.0;90630.0;184122.0
210015;201802;29;19;10;18126.0;9540.0;27666.0
210020;201802;347;177;170;168858.0;162180.0;331038.0
210030;201802;341;212;129;202248.0;123057.0;325305.0
210040;201802;155;120;35;114480.0;33390.0;147870.0
210043;201802;249;166;83;158364.0;79182.0;237546.0
210047;201802;616;312;304;297266.4;290006.47;587272.9
210050;201802;296;216;80;206064.0;76320.0;282384.0
210055;201802;43;32;11;30528.0;10494.0;41022.0
210060;201802;571;444;127;423576.0;121158.0;544734.0
210070;201802;415;304;111;290016.0;105894.0;395910.0
210080;201802;103;95;8;90630.0;7632.0;98262.0
210083;201802;307;130;177;124020.0;168858.0;292878.0
210087;201802;46;33;13;31482.0;12402.0;43884.0
210090;201802;490;337;153;321498.0;145962.0;467460.0
210095;201802;496;353;143;336752.47;136422.0;473174.47
210100;201802;688;520;168;495746.1;159318.02;655064.1
210110;201802;148;79;69;75366.0;65826.0;141192.0
210120;201802;5489;4109;1380;3912780.0;1315266.6;5228046.5
210125;201802;216;120;96;114480.0;91584.0;206064.0
210130;201802;551;282;269;268074.0;256606.92;524680.94
210135;201802;35;21;14;20034.0;13356.0;33390.0
210140;201802;4268;3343;925;3186028.8;882212.0;4068240.8
210150;201802;356;224;132;213696.0;125928.0;339624.0
210160;201802;3356;2813;543;2680742.8;517736.0;3198478.8
210170;201802;1139;882;257;841428.0;245178.0;1086606.0
210173;201802;120;99;21;94446.0;20034.0;114480.0
210177;201802;467;226;241;215604.0;229914.0;445518.0
210180;201802;32;18;14;17172.0;13356.0;30528.0
210190;201802;412;262;150;249948.0;143100.0;393048.0
210193;201802;1;1;0;954.0;0.0;954.0
210197;201802;82;54;28;51516.0;26712.0;78228.0
210200;201802;639;502;137;478908.0;130698.0;609606.0
210203;201802;265;177;88;168858.0;83952.0;252810.0
210207;201802;379;291;88;277614.0;83952.0;361566.0
210210;201802;771;699;72;666846.0;68688.0;735534.0
210215;201802;74;62;12;59148.0;11448.0;70596.0
210220;201802;397;325;72;310050.0;68401.8;378451.8
210230;201802;304;225;79;214650.0;75366.0;290016.0
210232;201802;1483;937;546;893612.0;520884.0;1414496.0
210235;201802;153;118;35;112382.0;33390.0;145772.0
210237;201802;46;25;21;23850.0;20034.0;43884.0
210240;201802;95;77;18;73458.0;17172.0;90630.0
210250;201802;181;143;38;136422.0;36252.0;172674.0
210255;201802;335;244;91;232776.0;86814.0;319590.0
210260;201802;424;263;161;250902.0;153594.0;404496.0
210270;201802;697;441;256;420714.0;244224.0;664938.0
210275;201802;42;33;9;31482.0;8586.0;40068.0
210280;201802;1028;653;375;620147.3;356414.5;976561.8
210290;201802;499;321;178;306234.0;169812.0;476046.0
210300;201802;6115;3560;2555;3391603.2;2436278.2;5827881.5
210310;201802;104;71;33;67734.0;31482.0;99216.0
210312;201802;126;79;47;75366.0;44838.0;120204.0
210315;201802;117;84;33;80136.0;31482.0;111618.0
210317;201802;126;90;36;85860.0;34344.0;120204.0
210320;201802;2389;1962;427;1870037.9;407358.0;2277395.8
210325;201802;132;88;44;82998.0;41690.0;124688.0
210330;201802;5583;2831;2752;2695942.0;2625398.5;5321340.5
210340;201802;1410;1008;402;960832.0;383437.06;1344269.1
210350;201802;608;496;112;472945.5;106848.0;579793.5
210355;201802;132;107;25;102078.0;23850.0;125928.0
210360;201802;2660;1656;1004;1576677.6;957530.0;2534207.5
210370;201802;1262;538;724;513252.0;690028.2;1203280.2
210375;201802;187;98;89;92949.0;84906.0;177855.0
210380;201802;728;542;186;517068.0;177444.0;694512.0
210390;201802;203;166;37;158364.0;35298.0;193662.0
210400;201802;405;338;67;322452.0;63918.0;386370.0
210405;201802;1006;660;346;629640.0;330084.0;959724.0
210407;201802;56;44;12;41976.0;11448.0;53424.0
210408;201802;64;57;7;54378.0;6678.0;61056.0
210409;201802;312;260;52;248040.0;49608.0;297648.0
210410;201802;437;339;98;323406.0;93483.0;416889.0
210420;201802;195;159;36;151686.0;34344.0;186030.0
210430;201802;35;27;8;25758.0;7632.0;33390.0
210440;201802;379;226;153;215604.0;145962.0;361566.0
210450;201802;144;106;38;101124.0;36252.0;137376.0
210455;201802;213;115;98;109710.0;93492.0;203202.0
210460;201802;347;218;129;207972.0;123066.0;331038.0
210462;201802;62;52;10;49608.0;9540.0;59148.0
210465;201802;174;125;49;119250.0;46746.0;165996.0
210467;201802;525;373;152;355842.0;145008.0;500850.0
210470;201802;46;34;12;32436.0;11448.0;43884.0
210480;201802;1304;916;388;873864.0;370152.0;1244016.0
210490;201802;226;135;91;128790.0;86814.0;215604.0
210500;201802;565;291;274;277614.0;261396.0;539010.0
210510;201802;558;433;125;413082.0;119250.0;532332.0
210515;201802;448;242;206;230868.0;196524.0;427392.0
210520;201802;403;351;52;334567.8;49608.0;384175.8
210530;201802;9343;5016;4327;4773969.5;4122126.0;8896096.0
210535;201802;131;94;37;89676.0;35298.0;124974.0
210540;201802;1543;923;620;879397.8;590049.0;1469446.8
210542;201802;1158;583;575;555800.4;547978.0;1103778.4
210545;201802;14;13;1;12402.0;954.0;13356.0
210547;201802;137;117;20;111618.0;19080.0;130698.0
210550;201802;742;518;224;492624.0;213696.0;706320.0
210560;201802;176;146;30;139284.0;28620.0;167904.0
210565;201802;30;21;9;20034.0;8586.0;28620.0
210570;201802;1371;1071;300;1021734.0;286200.0;1307934.0
210580;201802;106;92;14;87768.0;13356.0;101124.0
210590;201802;772;604;168;575452.8;160272.0;735724.8
210592;201802;31;27;4;25758.0;3816.0;29574.0
210594;201802;102;84;18;80136.0;17172.0;97308.0
210596;201802;82;69;13;65826.0;12402.0;78228.0
210598;201802;124;92;32;87768.0;30528.0;118296.0
210600;201802;338;284;54;270936.0;51516.0;322452.0
210610;201802;247;229;18;217512.0;17172.0;234684.0
210620;201802;48;29;19;27666.0;18126.0;45792.0
210630;201802;62;58;4;55332.0;3816.0;59148.0
210632;201802;1124;742;382;707868.0;363933.0;1071801.0
210635;201802;16;13;3;12402.0;2862.0;15264.0
210637;201802;106;74;32;70596.0;30528.0;101124.0
210640;201802;587;511;76;487494.0;72504.0;559998.0
210650;201802;408;327;81;311032.62;76320.0;387352.62
210660;201802;403;286;117;272177.0;111494.0;383671.0
210663;201802;17;10;7;9540.0;6678.0;16218.0
210667;201802;117;36;81;34344.0;77274.0;111618.0
210670;201802;268;236;32;224429.0;30528.0;254957.0
210675;201802;571;294;277;280476.0;264258.0;544734.0
210680;201802;214;135;79;128790.0;75366.0;204156.0
210690;201802;644;505;139;481770.0;132606.0;614376.0
210700;201802;190;138;52;131652.0;49608.0;181260.0
210710;201802;303;168;135;160081.2;128790.0;288871.2
210720;201802;125;104;21;99216.0;20034.0;119250.0
210725;201802;65;57;8;54378.0;7632.0;62010.0
210730;201802;24;18;6;17172.0;5724.0;22896.0
210735;201802;417;277;140;264258.0;133274.0;397532.0
210740;201802;543;459;84;437886.0;80136.0;518022.0
210745;201802;154;109;45;103986.0;42930.0;146916.0
210750;201802;2425;1089;1336;1036951.0;1274524.9;2311476.0
210760;201802;273;199;74;189846.0;70581.69;260427.69
210770;201802;399;306;93;291924.0;88435.8;380359.8
210780;201802;423;304;119;290016.0;113526.0;403542.0
210790;201802;183;142;41;135468.0;39114.0;174582.0
210800;201802;136;101;35;96354.0;33390.0;129744.0
210805;201802;42;38;4;36252.0;3816.0;40068.0
210810;201802;486;368;118;350404.2;112572.0;462976.2
210820;201802;2322;1829;493;1736750.5;470322.0;2207072.5
210825;201802;171;87;84;82998.0;80136.0;163134.0
210830;201802;807;485;322;461736.0;306234.0;767970.0
210840;201802;216;143;73;136422.0;69642.0;206064.0
210845;201802;251;156;95;148824.0;90630.0;239454.0
210850;201802;859;546;313;520884.0;298602.0;819486.0
210860;201802;4161;2123;2038;2023148.2;1943946.8;3967095.0
210870;201802;467;349;118;332946.0;112572.0;445518.0
210880;201802;56;38;18;36252.0;17172.0;53424.0
210890;201802;340;279;61;266166.0;58194.0;324360.0
210900;201802;570;371;199;353930.0;189846.0;543776.0
210905;201802;73;35;38;33390.0;36252.0;69642.0
210910;201802;2008;1476;532;1407386.2;507528.0;1914914.2
210920;201802;229;66;163;62964.0;155502.0;218466.0
210923;201802;80;56;24;53424.0;22896.0;76320.0
210927;201802;439;180;259;171720.0;247086.0;418806.0
210930;201802;59;46;13;43884.0;12402.0;56286.0
210940;201802;92;69;23;65826.0;21942.0;87768.0
210945;201802;194;87;107;82998.0;102078.0;185076.0
210950;201802;502;360;142;343440.0;135463.23;478903.22
210955;201802;75;49;26;46746.0;24804.0;71550.0
210960;201802;2466;1030;1436;980998.4;1369658.0;2350656.5
210970;201802;115;99;16;94446.0;15264.0;109710.0
210975;201802;89;80;9;76320.0;8586.0;84906.0
210980;201802;1238;526;712;501689.53;678962.0;1180651.5
210990;201802;4405;2722;1683;2595687.2;1605582.0;4201269.0
211000;201802;1385;1092;293;1041482.0;279235.8;1320717.8
211003;201802;923;629;294;600066.0;280467.0;880533.0
211010;201802;469;410;59;391140.0;56286.0;447426.0
211020;201802;1611;578;1033;551412.0;985262.56;1536674.6
211023;201802;26;22;4;20701.8;3816.0;24517.8
211027;201802;63;39;24;37206.0;22896.0;60102.0
211030;201802;384;256;128;244224.0;122112.0;366336.0
211040;201802;318;238;80;226766.0;76320.0;303086.0
211050;201802;1190;748;442;713592.0;421382.0;1134974.0
211060;201802;686;581;105;551793.6;100170.0;651963.6
211065;201802;24;20;4;19080.0;3816.0;22896.0
211070;201802;919;745;174;709118.75;165996.0;875114.75
211080;201802;89;85;4;81090.0;3816.0;84906.0
211085;201802;59;31;28;29288.0;26712.0;56000.0
211090;201802;94;76;18;72504.0;17172.0;89676.0
211100;201802;508;403;105;384462.0;100170.0;484632.0
211102;201802;263;174;89;165996.0;84906.0;250902.0
211105;201802;216;146;70;139284.0;66780.0;206064.0
211107;201802;134;75;59;71550.0;56286.0;127836.0
211110;201802;825;530;295;505048.0;281421.0;786469.0
211120;201802;5834;2439;3395;2321544.5;3236816.0;5558360.5
211125;201802;34;27;7;25758.0;6678.0;32436.0
211130;201802;46079;18971;27108;1,81E+14;2,58E+14;4,39E+14
211140;201802;429;360;69;342482.0;65826.0;408308.0
211150;201802;1257;793;464;756188.1;442366.0;1198554.1
211153;201802;168;97;71;92538.0;67734.0;160272.0
211157;201802;59;43;16;41022.0;15264.0;56286.0
211160;201802;712;589;123;560939.5;117342.0;678281.5
211163;201802;0;0;0;0.0;0.0;0.0
211167;201802;6;4;2;3816.0;1908.0;5724.0
211170;201802;444;307;137;292878.0;130698.0;423576.0
211172;201802;123;85;38;81090.0;36252.0;117342.0
211174;201802;284;164;120;156456.0;114480.0;270936.0
211176;201802;521;371;150;353934.0;143100.0;497034.0
211178;201802;96;62;34;59148.0;32436.0;91584.0
211180;201802;208;162;46;154548.0;43721.82;198269.81
211190;201802;63;58;5;55332.0;4770.0;60102.0
211195;201802;24;15;9;14310.0;8586.0;22896.0
211200;201802;157;134;23;127492.56;21942.0;149434.56
211210;201802;533;327;206;311290.2;196524.0;507814.2
211220;201802;3973;2223;1750;2112899.5;1662213.6;3775113.0
211223;201802;96;89;7;84724.74;6678.0;91402.74
211227;201802;70;47;23;44838.0;21942.0;66780.0
211230;201802;778;629;149;599922.9;142126.92;742049.8
211240;201802;420;313;107;298602.0;102078.0;400680.0
211245;201802;212;92;120;87768.0;114480.0;202248.0
211250;201802;1642;1398;244;1332700.1;232776.0;1565476.1
211260;201802;807;632;175;602928.0;166950.0;769878.0
211270;201802;2102;1639;463;1563606.0;440748.2;2004354.2
211280;201802;1824;1085;739;1033183.4;705006.0;1738189.4
211285;201802;209;118;91;112572.0;86814.0;199386.0
211290;201802;687;457;230;435787.2;219420.0;655207.2
211300;201802;808;619;189;590248.06;180306.0;770554.06
211400;201802;1606;897;709;855738.0;676386.0;1532124.0
220005;201802;18;17;1;16218.0;954.0;17172.0
220010;201802;88;67;21;63918.0;19747.8;83665.8
220020;201802;598;468;130;445290.53;124020.0;569310.56
220025;201802;106;102;4;97308.0;3816.0;101124.0
220027;201802;34;27;7;25758.0;6678.0;32436.0
220030;201802;97;79;18;75366.0;17172.0;92538.0
220040;201802;1117;831;286;791514.75;272844.0;1064358.8
220045;201802;38;28;10;26712.0;9540.0;36252.0
220050;201802;647;527;120;501445.97;114460.92;615906.9
220060;201802;176;150;26;143100.0;24804.0;167904.0
220070;201802;94;84;10;80136.0;9540.0;89676.0
220080;201802;10;8;2;7632.0;1908.0;9540.0
220090;201802;34;27;7;25472.0;6678.0;32150.0
220095;201802;2;1;1;954.0;954.0;1908.0
220100;201802;28;24;4;22896.0;3816.0;26712.0
220105;201802;32;30;2;28620.0;1908.0;30528.0
220110;201802;207;191;16;181927.8;15264.0;197191.8
220115;201802;47;44;3;41976.0;2862.0;44838.0
220117;201802;18;17;1;16218.0;954.0;17172.0
220120;201802;1525;1054;471;1004887.3;449314.9;1454202.2
220130;201802;26;25;1;23850.0;954.0;24804.0
220140;201802;97;77;20;72504.0;19080.0;91584.0
220150;201802;449;318;131;303372.0;124974.0;428346.0
220155;201802;4;4;0;3816.0;0.0;3816.0
220157;201802;16;13;3;12402.0;2862.0;15264.0
220160;201802;73;63;10;60102.0;9540.0;69642.0
220170;201802;33;31;2;29574.0;1908.0;31482.0
220173;201802;7;7;0;6678.0;0.0;6678.0
220177;201802;6;6;0;5724.0;0.0;5724.0
220180;201802;67;66;1;62959.23;668.0;63627.23
220190;201802;1055;944;111;900576.0;105894.0;1006470.0
220191;201802;41;36;5;34344.0;4770.0;39114.0
220192;201802;62;59;3;56286.0;2862.0;59148.0
220194;201802;32;28;4;26712.0;3816.0;30528.0
220196;201802;103;85;18;81090.0;17172.0;98262.0
220198;201802;6;4;2;3816.0;1908.0;5724.0
220200;201802;430;350;80;334727.0;76320.0;411047.0
220202;201802;36;32;4;30528.0;3816.0;34344.0
220205;201802;39;34;5;32436.0;4770.0;37206.0
220207;201802;19;18;1;17172.0;954.0;18126.0
220208;201802;84;43;41;41022.0;39114.0;80136.0
220209;201802;32;29;3;27666.0;2862.0;30528.0
220210;201802;15;13;2;12402.0;1908.0;14310.0
220211;201802;29;29;0;27666.0;0.0;27666.0
220213;201802;41;37;4;35298.0;3530.0;38828.0
220217;201802;35;27;8;25758.0;7632.0;33390.0
220220;201802;2014;1278;736;1215606.6;700741.94;1916348.6
220225;201802;16;9;7;8586.0;6678.0;15264.0
220230;201802;929;738;191;703603.6;181574.81;885178.44
220240;201802;145;133;12;126882.0;11448.0;138330.0
220245;201802;33;30;3;27647.58;2862.0;30509.58
220250;201802;105;94;11;89676.0;10494.0;100170.0
220253;201802;44;36;8;34344.0;7632.0;41976.0
220255;201802;28;25;3;23850.0;2862.0;26712.0
220260;201802;689;501;188;477954.0;179352.0;657306.0
220265;201802;16;12;4;11448.0;3816.0;15264.0
220270;201802;660;586;74;558318.94;70119.0;628437.94
220271;201802;45;37;8;35298.0;7632.0;42930.0
220272;201802;25;24;1;22896.0;954.0;23850.0
220273;201802;15;13;2;12402.0;1908.0;14310.0
220275;201802;55;44;11;41976.0;10494.0;52470.0
220277;201802;11;9;2;8586.0;1908.0;10494.0
220280;201802;14;12;2;11448.0;1908.0;13356.0
220285;201802;43;40;3;38160.0;2862.0;41022.0
220290;201802;1378;1177;201;1120330.0;191707.0;1312037.0
220300;201802;55;54;1;51516.0;954.0;52470.0
220310;201802;314;265;49;252806.0;46737.0;299543.0
220320;201802;430;396;34;376354.0;32436.0;408790.0
220323;201802;0;0;0;0.0;0.0;0.0
220325;201802;16;11;5;10494.0;4770.0;15264.0
220327;201802;11;10;1;9540.0;954.0;10494.0
220330;201802;197;134;63;127836.0;60102.0;187938.0
220335;201802;141;123;18;117342.0;17172.0;134514.0
220340;201802;20;11;9;10494.0;8586.0;19080.0
220342;201802;56;47;9;44838.0;8586.0;53424.0
220345;201802;83;75;8;71550.0;7632.0;79182.0
220350;201802;430;377;53;357035.4;50562.0;407597.4
220360;201802;43;31;12;29574.0;11448.0;41022.0
220370;201802;1104;875;229;833796.0;218179.8;1051975.8
220375;201802;27;25;2;23850.0;1908.0;25758.0
220380;201802;35;28;7;26712.0;6678.0;33390.0
220385;201802;28;24;4;22896.0;3816.0;26712.0
220390;201802;2227;1265;962;1202116.5;916365.5;2118482.0
220400;201802;28;26;2;24804.0;1908.0;26712.0
220410;201802;14;13;1;12402.0;954.0;13356.0
220415;201802;12;11;1;10494.0;954.0;11448.0
220420;201802;124;103;21;98262.0;19747.8;118009.8
220430;201802;133;120;13;112811.8;12402.0;125213.8
220435;201802;22;16;6;15260.0;5724.0;20984.0
220440;201802;291;247;44;235638.0;41976.0;277614.0
220450;201802;327;166;161;157198.98;153594.0;310792.97
220455;201802;52;50;2;47700.0;1908.0;49608.0
220460;201802;17;17;0;15550.2;0.0;15550.2
220465;201802;110;70;40;66780.0;38160.0;104940.0
220470;201802;240;211;29;201294.0;27666.0;228960.0
220480;201802;71;60;11;57240.0;10494.0;67734.0
220490;201802;86;75;11;71550.0;10494.0;82044.0
220500;201802;95;83;12;79182.0;11448.0;90630.0
220510;201802;379;302;77;287345.0;73267.2;360612.2
220515;201802;21;17;4;16218.0;3816.0;20034.0
220520;201802;368;330;38;313505.0;36233.0;349738.0
220525;201802;25;17;8;16218.0;7632.0;23850.0
220527;201802;37;29;8;27666.0;6822.0;34488.0
220530;201802;33;12;21;11448.0;20034.0;31482.0
220535;201802;13;12;1;11448.0;954.0;12402.0
220540;201802;60;47;13;44838.0;12402.0;57240.0
220545;201802;61;39;22;37206.0;20988.0;58194.0
220550;201802;644;490;154;466696.8;146916.0;613612.8
220551;201802;26;19;7;18126.0;6678.0;24804.0
220552;201802;8;8;0;7632.0;0.0;7632.0
220553;201802;47;43;4;41022.0;3816.0;44838.0
220554;201802;13;8;5;7345.8;4770.0;12115.8
220555;201802;24;20;4;19080.0;3816.0;22896.0
220556;201802;55;51;4;48654.0;3816.0;52470.0
220557;201802;55;49;6;46746.0;5724.0;52470.0
220558;201802;7;2;5;1908.0;4770.0;6678.0
220559;201802;7;6;1;5724.0;954.0;6678.0
220560;201802;56;36;20;34153.2;19080.0;53233.2
220570;201802;791;470;321;446890.12;306234.0;753124.1
220580;201802;568;519;49;495126.0;46059.92;541185.94
220585;201802;6;5;1;4770.0;954.0;5724.0
220590;201802;14;14;0;13356.0;0.0;13356.0
220595;201802;59;44;15;41976.0;14310.0;56286.0
220600;201802;20;11;9;10494.0;8586.0;19080.0
220605;201802;21;20;1;19080.0;954.0;20034.0
220610;201802;60;51;9;48654.0;8586.0;57240.0
220620;201802;561;438;123;417613.5;117342.0;534955.5
220630;201802;6;4;2;3816.0;1908.0;5724.0
220635;201802;37;33;4;31482.0;3816.0;35298.0
220640;201802;98;77;21;73458.0;20034.0;93492.0
220650;201802;114;108;6;103032.0;5724.0;108756.0
220660;201802;29;23;6;21942.0;5724.0;27666.0
220665;201802;4;4;0;3816.0;0.0;3816.0
220667;201802;11;10;1;9540.0;954.0;10494.0
220669;201802;24;21;3;20034.0;2862.0;22896.0
220670;201802;69;54;15;51325.2;14310.0;65635.2
220672;201802;59;40;19;38160.0;18126.0;56286.0
220675;201802;34;26;8;24804.0;7632.0;32436.0
220680;201802;35;29;6;27666.0;5724.0;33390.0
220690;201802;48;45;3;42930.0;2862.0;45792.0
220695;201802;61;29;32;27666.0;30528.0;58194.0
220700;201802;1522;1163;359;1107660.8;342486.0;1450146.8
220710;201802;3;1;2;954.0;1908.0;2862.0
220720;201802;113;91;22;86575.5;20844.9;107420.4
220730;201802;19;18;1;17172.0;954.0;18126.0
220735;201802;3;1;2;954.0;1908.0;2862.0
220740;201802;44;40;4;38160.0;3816.0;41976.0
220750;201802;101;81;20;77274.0;19080.0;96354.0
220755;201802;14;14;0;13356.0;0.0;13356.0
220760;201802;51;48;3;45792.0;2862.0;48654.0
220770;201802;5763;2874;2889;2736586.8;2749969.5;5486556.0
220775;201802;28;14;14;13356.0;13356.0;26712.0
220777;201802;15;14;1;13356.0;954.0;14310.0
220779;201802;18;14;4;13356.0;3816.0;17172.0
220780;201802;873;744;129;709108.2;122780.0;831888.2
220785;201802;10;5;5;4770.0;4770.0;9540.0
220790;201802;1009;802;207;762706.0;197478.0;960184.0
220793;201802;13;13;0;12402.0;0.0;12402.0
220795;201802;22;21;1;20034.0;954.0;20988.0
220800;201802;3905;2972;933;2833645.2;889105.9;3722751.2
220810;201802;57;51;6;48654.0;5724.0;54378.0
220820;201802;238;216;22;206064.0;20988.0;227052.0
220830;201802;1159;982;177;936823.25;168839.0;1105662.2
220840;201802;2426;1602;824;1515142.8;783998.0;2299140.8
220850;201802;52;41;11;39114.0;10494.0;49608.0
220855;201802;14;9;5;8586.0;4770.0;13356.0
220860;201802;8;7;1;6678.0;954.0;7632.0
220865;201802;23;21;2;20034.0;1908.0;21942.0
220870;201802;58;56;2;53424.0;1908.0;55332.0
220880;201802;317;242;75;230200.2;71264.0;301464.2
220885;201802;44;39;5;37206.0;4770.0;41976.0
220887;201802;18;17;1;16218.0;954.0;17172.0
220890;201802;102;90;12;85860.0;11448.0;97308.0
220900;201802;47;26;21;24804.0;20034.0;44838.0
220910;201802;54;46;8;43884.0;7632.0;51516.0
220915;201802;10;9;1;8586.0;954.0;9540.0
220920;201802;37;33;4;31482.0;3816.0;35298.0
220930;201802;42;41;1;39114.0;954.0;40068.0
220935;201802;15;15;0;14310.0;0.0;14310.0
220937;201802;44;41;3;39114.0;2862.0;41976.0
220940;201802;50;46;4;43884.0;3816.0;47700.0
220945;201802;0;0;0;0.0;0.0;0.0
220950;201802;46;42;4;40068.0;3816.0;43884.0
220955;201802;33;29;4;27666.0;3816.0;31482.0
220960;201802;1;1;0;954.0;0.0;954.0
220965;201802;29;25;4;23850.0;3816.0;27666.0
220970;201802;46;39;7;37206.0;6678.0;43884.0
220975;201802;8;7;1;6678.0;954.0;7632.0
220980;201802;34;32;2;30528.0;1908.0;32436.0
220985;201802;64;57;7;54378.0;6678.0;61056.0
220987;201802;32;31;1;29574.0;954.0;30528.0
220990;201802;13;12;1;11448.0;954.0;12402.0
220995;201802;40;34;6;32436.0;5724.0;38160.0
220997;201802;39;32;7;30528.0;6678.0;37206.0
221000;201802;1125;1013;112;962969.6;106561.8;1069531.4
221005;201802;66;59;7;56286.0;6678.0;62964.0
221010;201802;16;13;3;12402.0;2862.0;15264.0
221020;201802;44;42;2;40068.0;1908.0;41976.0
221030;201802;28;22;6;20988.0;5724.0;26712.0
221035;201802;19;19;0;18126.0;0.0;18126.0
221037;201802;12;6;6;5724.0;5724.0;11448.0
221038;201802;24;22;2;20988.0;1908.0;22896.0
221039;201802;22;22;0;20988.0;0.0;20988.0
221040;201802;250;215;35;205110.0;33390.0;238500.0
221050;201802;230;194;36;185076.0;34344.0;219420.0
221060;201802;1710;1499;211;1428530.8;201294.0;1629824.8
221062;201802;29;28;1;26712.0;954.0;27666.0
221063;201802;14;10;4;9540.0;3816.0;13356.0
221065;201802;49;41;8;39114.0;7632.0;46746.0
221070;201802;137;118;19;112572.0;18126.0;130698.0
221080;201802;377;334;43;318636.0;40735.8;359371.8
221090;201802;36;35;1;33390.0;954.0;34344.0
221093;201802;57;38;19;36252.0;18126.0;54378.0
221095;201802;11;10;1;9540.0;954.0;10494.0
221097;201802;22;19;3;18126.0;2862.0;20988.0
221100;201802;24454;14030;10424;1,34E+14;9939214.0;2,33E+14
221110;201802;1022;749;273;714260.0;260442.0;974702.0
221120;201802;526;391;135;372728.0;128790.0;501518.0
221130;201802;929;757;172;720938.8;164088.0;885026.8
221135;201802;34;31;3;29574.0;2862.0;32436.0
221140;201802;40;32;8;30528.0;7632.0;38160.0
221150;201802;14;11;3;10494.0;2862.0;13356.0
221160;201802;10;10;0;9540.0;0.0;9540.0
221170;201802;13;13;0;12402.0;0.0;12402.0
230010;201802;162;151;11;144054.0;10494.0;154548.0
230015;201802;115;94;21;89676.0;20034.0;109710.0
230020;201802;1534;1309;225;1246329.0;213748.88;1460077.9
230030;201802;1604;1154;450;1095347.0;429300.0;1524647.0
230040;201802;196;173;23;164088.0;21942.0;186030.0
230050;201802;210;153;57;145962.0;54378.0;200340.0
230060;201802;147;121;26;114670.8;24804.0;139474.8
230070;201802;283;252;31;240408.0;29574.0;269982.0
230075;201802;792;692;100;658165.0;95113.8;753278.8
230080;201802;177;153;24;145962.0;22896.0;168858.0
230090;201802;93;63;30;59338.8;28620.0;87958.8
230100;201802;1930;1145;785;1090043.0;748890.0;1838933.0
230110;201802;2633;1683;950;1603147.4;905727.8;2508875.2
230120;201802;925;730;195;694990.25;186011.0;881001.25
230125;201802;137;112;25;106848.0;23850.0;130698.0
230130;201802;458;409;49;390186.0;46746.0;436932.0
230140;201802;201;173;28;165042.0;26712.0;191754.0
230150;201802;160;117;43;111618.0;41022.0;152640.0
230160;201802;908;785;123;748175.0;117342.0;865517.0
230170;201802;579;535;44;506576.7;41976.0;548552.7
230180;201802;79;74;5;70596.0;4770.0;75366.0
230185;201802;408;351;57;333488.84;54378.0;387866.84
230190;201802;2182;1757;425;1672198.5;405133.0;2077331.5
230195;201802;483;421;62;401634.0;59148.0;460782.0
230200;201802;364;318;46;302408.47;43884.0;346292.47
230205;201802;353;222;131;210018.33;124974.0;334992.34
230210;201802;1249;995;254;948094.06;241552.8;1189646.9
230220;201802;1392;968;424;922708.8;404496.0;1327204.8
230230;201802;894;788;106;750098.7;101124.0;851222.7
230240;201802;1618;1394;224;1327905.8;213696.0;1541601.8
230250;201802;1765;1453;312;1382151.1;297648.0;1679799.1
230260;201802;2932;1755;1177;1669077.1;1121885.8;2790962.8
230270;201802;1336;1072;264;1020088.4;250663.5;1270751.9
230280;201802;2671;1987;684;1890163.4;651868.2;2542031.8
230290;201802;393;356;37;334250.28;35298.0;369548.28
230300;201802;511;376;135;357444.72;128790.0;486234.72
230310;201802;417;312;105;297500.12;100170.0;397670.12
230320;201802;900;767;133;727734.6;126631.11;854365.7
230330;201802;297;240;57;228196.8;54188.0;282384.8
230340;201802;448;359;89;341533.0;84906.0;426439.0
230350;201802;3022;1891;1131;1803994.9;1076113.1;2880108.0
230360;201802;257;215;42;204200.0;40068.0;244268.0
230365;201802;133;106;27;100409.0;25758.0;126167.0
230370;201802;9689;4715;4974;4489449.5;4741310.0;9230760.0
230380;201802;461;397;64;378452.0;60102.6;438554.6
230390;201802;498;277;221;262454.94;210834.0;473288.94
230393;201802;269;223;46;211888.8;43884.0;255772.8
230395;201802;333;272;61;259240.0;58194.0;317434.0
230400;201802;597;474;123;450288.0;116845.92;567133.94
230410;201802;2609;1625;984;1544622.8;938450.0;2483072.8
230420;201802;5896;3850;2046;3654696.8;1947303.0;5602000.0
230423;201802;308;267;41;254718.0;39114.0;293832.0
230425;201802;346;287;59;273798.0;56286.0;330084.0
230426;201802;105;96;9;90858.96;8299.8;99158.76
230427;201802;79;76;3;72504.0;2862.0;75366.0
230428;201802;1337;690;647;658031.06;617238.0;1275269.0
230430;201802;437;351;86;334660.0;82044.0;416704.0
230435;201802;785;550;235;523158.22;222950.61;746108.8
230440;201802;83350;36700;46650;3,49E+13;4,45E+14;7,94E+14
230445;201802;267;182;85;173437.2;81090.0;254527.2
230450;201802;538;436;102;415944.0;97308.0;513252.0
230460;201802;58;48;10;45792.0;9540.0;55332.0
230465;201802;297;242;55;230868.0;52470.0;283338.0
230470;201802;1835;1428;407;1362312.0;387171.1;1749483.1
230480;201802;149;144;5;137089.8;4770.0;141859.8
230490;201802;281;227;54;216558.0;51516.0;268074.0
230495;201802;435;328;107;312058.0;102078.0;414136.0
230500;201802;938;703;235;669708.0;224181.0;893889.0
230510;201802;46;36;10;34344.0;9540.0;43884.0
230520;201802;387;305;82;290970.0;78228.0;369198.0
230523;201802;1983;1260;723;1200557.8;689294.0;1889851.8
230526;201802;292;242;50;230868.0;46909.0;277777.0
230530;201802;666;501;165;475895.6;156456.2;632351.8
230533;201802;182;174;8;165996.0;7632.0;173628.0
230535;201802;342;257;85;245178.0;81090.0;326268.0
230540;201802;1825;1600;225;1523757.0;214077.8;1737834.9
230550;201802;3593;2307;1286;2192648.0;1225207.9;3417856.0
230560;201802;578;442;136;419569.8;128790.0;548359.8
230565;201802;192;140;52;133560.0;49608.0;183168.0
230570;201802;303;269;34;256626.0;32436.0;289062.0
230580;201802;1099;810;289;771280.4;274465.8;1045746.2
230590;201802;949;738;211;699809.1;200817.0;900626.1
230600;201802;248;226;22;214860.06;20988.0;235848.06
230610;201802;336;269;67;256436.0;63918.0;320354.0
230620;201802;163;134;29;126882.0;27666.0;154548.0
230625;201802;718;516;202;490599.5;191554.69;682154.2
230630;201802;1242;983;259;937782.0;246704.4;1184486.4
230640;201802;3467;3000;467;2854765.5;444759.56;3299525.0
230650;201802;393;343;50;326362.38;47700.0;374062.38
230655;201802;634;550;84;523746.8;80056.07;603802.9
230660;201802;331;277;54;264258.0;51229.8;315487.8
230670;201802;423;376;47;358704.0;44838.0;403542.0
230680;201802;200;184;16;175536.0;15264.0;190800.0
230690;201802;857;747;110;712638.0;104940.0;817578.0
230700;201802;692;586;106;559024.94;100837.8;659862.75
230710;201802;733;693;40;660932.0;38160.0;699092.0
230720;201802;146;123;23;116950.86;21942.0;138892.86
230725;201802;228;179;49;170766.0;46737.0;217503.0
230730;201802;11599;6288;5311;5981756.0;5058616.0;1,10E+14
230740;201802;652;521;131;496748.0;124283.46;621031.44
230750;201802;795;679;116;646574.3;110664.0;757238.3
230760;201802;1299;1126;173;1070157.2;165042.0;1235199.2
230763;201802;319;264;55;249900.95;52470.0;302370.94
230765;201802;6800;3193;3607;3040410.2;3439072.0;6479482.5
230770;201802;4959;2550;2409;2423326.5;2295506.2;4718832.5
230780;201802;676;594;82;563536.1;78213.69;641749.8
230790;201802;194;159;35;151686.0;32589.4;184275.4
230800;201802;1109;813;296;775578.1;282384.0;1057962.1
230810;201802;1274;1137;137;1083696.2;130507.2;1214203.5
230820;201802;330;239;91;227053.0;86814.0;313867.0
230830;201802;932;808;124;767318.44;118296.0;885614.44
230835;201802;276;238;38;226098.0;35537.0;261635.0
230837;201802;164;138;26;131652.0;24804.0;156456.0
230840;201802;889;710;179;676100.5;169526.0;845626.5
230850;201802;1472;1283;189;1223505.0;180020.0;1403525.0
230860;201802;300;224;76;213696.0;72504.0;286200.0
230870;201802;1791;1520;271;1449126.0;257198.8;1706324.8
230880;201802;36;25;11;23850.0;10494.0;34344.0
230890;201802;565;518;47;494049.8;44824.0;538873.8
230900;201802;270;205;65;195570.0;61813.0;257383.0
230910;201802;202;163;39;154738.8;37206.0;191944.8
230920;201802;393;310;83;295740.0;79182.0;374922.0
230930;201802;919;647;272;614376.6;259488.0;873864.6
230940;201802;823;661;162;630594.0;154358.0;784952.0
230945;201802;464;388;76;369962.0;72504.0;442466.0
230950;201802;374;319;55;304326.0;52470.0;356796.0
230960;201802;2477;1677;800;1593130.9;762914.0;2356044.8
230970;201802;1741;986;755;939733.9;719392.3;1659126.2
230980;201802;210;180;30;171720.0;28620.0;200340.0
230990;201802;139;112;27;106848.0;25001.47;131849.47
231000;201802;206;187;19;176490.0;18126.0;194616.0
231010;201802;134;105;29;99597.6;27666.0;127263.6
231020;201802;1276;886;390;843623.0;372060.0;1215683.0
231025;201802;937;702;235;667544.2;222644.8;890189.0
231030;201802;1140;956;184;912020.0;175250.0;1087270.0
231040;201802;138;94;44;88931.88;41245.0;130176.88
231050;201802;980;874;106;832031.9;101124.0;933155.9
231060;201802;138;123;15;117342.0;14310.0;131652.0
231070;201802;1413;997;416;948753.1;396864.0;1345617.1
231080;201802;265;244;21;231965.1;20034.0;251999.1
231085;201802;543;340;203;323407.0;193662.0;517069.0
231090;201802;238;197;41;187938.0;39114.0;227052.0
231095;201802;164;130;34;124020.0;32436.0;156456.0
231100;201802;123;102;21;97308.0;18793.8;116101.8
231110;201802;346;300;46;285491.0;43884.0;329375.0
231120;201802;297;256;41;243265.86;38924.0;282189.88
231123;201802;131;124;7;118296.0;6678.0;124974.0
231126;201802;276;239;37;228006.0;35298.0;263304.0
231130;201802;4553;3539;1014;3366298.5;966283.25;4332582.0
231135;201802;198;171;27;163134.0;24492.4;187626.4
231140;201802;3026;2236;790;2129499.0;752667.8;2882166.8
231150;201802;354;338;16;322452.0;15264.0;337716.0
231160;201802;1201;941;260;894661.7;247811.05;1142472.8
231170;201802;533;353;180;336762.0;171720.0;508482.0
231180;201802;1589;1345;244;1282366.8;232776.0;1515142.8
231190;201802;198;176;22;167904.0;20988.0;188892.0
231195;201802;216;186;30;176720.0;28620.0;205340.0
231200;201802;823;679;144;647766.0;136116.0;783882.0
231210;201802;602;502;100;477954.8;95400.0;573354.8
231220;201802;1031;748;283;711952.1;269982.0;981934.1
231230;201802;1379;1105;274;1052968.0;260632.8;1313600.9
231240;201802;1353;983;370;937495.8;351740.2;1289236.0
231250;201802;111;103;8;98262.0;7632.0;105894.0
231260;201802;290;187;103;178398.0;97976.0;276374.0
231270;201802;987;827;160;783728.7;152353.8;936082.5
231280;201802;55;44;11;41976.0;10494.0;52470.0
231290;201802;7148;3976;3172;3785149.8;3023743.2;6808893.0
231300;201802;624;575;49;548550.0;46746.0;595296.0
231310;201802;696;646;50;615067.0;47700.0;662767.0
231320;201802;561;436;125;415468.0;119250.0;534718.0
231325;201802;88;78;10;74412.0;9540.0;83952.0
231330;201802;2013;1556;457;1478418.6;433022.6;1911441.2
231335;201802;245;216;29;206064.0;27666.0;233730.0
231340;201802;1582;1162;420;1106832.1;400394.0;1507226.1
231350;201802;1142;932;210;889128.0;199768.0;1088896.0
231355;201802;387;334;53;318636.0;50562.0;369198.0
231360;201802;470;375;95;355040.2;90630.0;445670.2
231370;201802;90;74;16;70596.0;15264.0;85860.0
231375;201802;283;205;78;195570.0;74412.0;269982.0
231380;201802;443;359;84;340890.7;79945.2;420835.88
231390;201802;196;159;37;151686.0;35298.0;186984.0
231395;201802;720;437;283;415600.56;269982.0;685582.56
231400;201802;1043;864;179;821684.8;170423.38;992108.25
231410;201802;1289;1041;248;988489.4;235639.0;1224128.4
240010;201802;386;180;206;170568.27;196515.0;367083.25
240020;201802;2177;1697;480;1617351.9;457916.0;2075267.9
240030;201802;134;113;21;107802.0;20034.0;127836.0
240040;201802;32;32;0;30528.0;0.0;30528.0
240050;201802;506;434;72;413182.44;68688.0;481870.44
240060;201802;67;63;4;60102.0;3816.0;63918.0
240070;201802;176;136;40;129744.0;38160.0;167904.0
240080;201802;439;295;144;281426.0;137376.0;418802.0
240090;201802;102;91;11;86508.72;10494.0;97002.72
240100;201802;1427;1343;84;1278249.5;79945.2;1358194.8
240110;201802;967;610;357;580968.25;340578.0;921546.25
240120;201802;140;118;22;112572.0;20988.0;133560.0
240130;201802;289;271;18;257817.55;17172.0;274989.53
240140;201802;78;61;17;58194.0;16218.0;74412.0
240145;201802;674;594;80;566151.3;76110.12;642261.44
240150;201802;20;15;5;14310.0;4741.38;19051.38
240160;201802;44;38;6;36252.0;5724.0;41976.0
240165;201802;34;28;6;26474.0;5724.0;32198.0
240170;201802;92;71;21;67734.0;20034.0;87768.0
240180;201802;77;63;14;60102.0;13356.0;73458.0
240185;201802;41;37;4;35288.46;3816.0;39104.46
240190;201802;14;12;2;11448.0;1908.0;13356.0
240200;201802;2988;1682;1306;1598457.6;1244685.0;2843142.8
240210;201802;162;128;34;122112.0;32436.0;154548.0
240220;201802;1101;791;310;754471.0;295730.47;1050201.5
240230;201802;817;757;60;719344.06;56592.0;775936.06
240240;201802;118;85;33;81090.0;31482.0;112572.0
240250;201802;92;80;12;76320.0;11448.0;87768.0
240260;201802;1785;1324;461;1262409.1;438811.38;1701220.5
240270;201802;190;168;22;159890.4;20988.0;180878.4
240280;201802;43;33;10;31482.0;9540.0;41022.0
240290;201802;49;48;1;45792.0;954.0;46746.0
240300;201802;180;100;80;95400.0;76320.0;171720.0
240310;201802;1984;1084;900;1025310.4;855363.56;1880674.0
240320;201802;208;198;10;188892.0;9540.0;198432.0
240325;201802;4295;2631;1664;2502962.5;1585287.2;4088249.8
240330;201802;64;61;3;58194.0;2862.0;61056.0
240340;201802;102;74;28;70596.0;26712.0;97308.0
240350;201802;89;79;10;75366.0;9540.0;84906.0
240360;201802;378;270;108;257580.0;103032.0;360612.0
240370;201802;36;34;2;32436.0;1908.0;34344.0
240375;201802;71;41;30;39114.0;28620.0;67734.0
240380;201802;233;189;44;180306.0;41881.0;222187.0
240390;201802;15;13;2;12402.0;1908.0;14310.0
240400;201802;78;74;4;70596.0;3816.0;74412.0
240410;201802;10;6;4;5724.0;3816.0;9540.0
240420;201802;881;686;195;653043.5;184980.6;838024.1
240430;201802;264;249;15;235523.69;14310.0;249833.69
240440;201802;69;36;33;34344.0;31482.0;65826.0
240450;201802;208;140;68;132987.8;64872.0;197859.8
240460;201802;60;47;13;44838.0;12402.0;57240.0
240470;201802;234;203;31;193104.86;29574.0;222678.86
240480;201802;14;14;0;13260.6;0.0;13260.6
240485;201802;72;62;10;59010.0;9540.0;68550.0
240490;201802;45;45;0;42720.12;0.0;42720.12
240500;201802;84;66;18;62964.0;17172.0;80136.0
240510;201802;50;35;15;33390.0;14310.0;47700.0
240520;201802;124;118;6;112572.0;5724.0;118296.0
240530;201802;50;45;5;42930.0;4770.0;47700.0
240540;201802;78;67;11;63918.0;10494.0;74412.0
240550;201802;15;13;2;12402.0;1908.0;14310.0
240560;201802;371;275;96;261723.23;91584.0;353307.22
240570;201802;461;285;176;271031.4;167904.0;438935.4
240580;201802;1256;1015;241;962825.9;228756.2;1191582.1
240590;201802;29;27;2;25758.0;1908.0;27666.0
240600;201802;112;111;1;105894.0;954.0;106848.0
240610;201802;510;426;84;406047.7;79373.0;485420.7
240615;201802;21;20;1;19080.0;954.0;20034.0
240620;201802;95;91;4;86814.0;3816.0;90630.0
240630;201802;34;32;2;30528.0;1908.0;32436.0
240640;201802;26;22;4;20988.0;3816.0;24804.0
240650;201802;234;197;37;187079.9;35298.0;222377.9
240660;201802;97;84;13;80136.0;12402.0;92538.0
240670;201802;288;170;118;160081.3;112572.0;272653.3
240680;201802;48;37;11;35298.0;10494.0;45792.0
240690;201802;49;46;3;43884.0;2862.0;46746.0
240700;201802;193;161;32;153594.0;30528.0;184122.0
240710;201802;1908;1215;693;1158676.9;661112.44;1819789.2
240720;201802;1043;764;279;727892.7;266166.0;994058.7
240725;201802;66;63;3;60102.0;2862.0;62964.0
240730;201802;133;115;18;109710.0;17172.0;126882.0
240740;201802;239;202;37;191343.78;34344.02;225687.8
240750;201802;34;22;12;20988.0;11448.0;32436.0
240760;201802;32;28;4;26712.0;3816.0;30528.0
240770;201802;148;113;35;107802.0;33390.0;141192.0
240780;201802;700;580;120;551879.44;114480.0;666359.44
240790;201802;37;36;1;34344.0;954.0;35298.0
240800;201802;8514;5772;2742;5469828.5;2609611.2;8079440.0
240810;201802;19932;10955;8977;1,04E+13;8554159.0;1,90E+13
240820;201802;205;129;76;122392.03;72504.0;194896.03
240830;201802;1584;1295;289;1228905.1;274752.0;1503657.1
240840;201802;77;67;10;63918.0;9540.0;73458.0
240850;201802;85;74;11;70596.0;10494.0;81090.0
240860;201802;113;110;3;104940.0;2862.0;107802.0
240870;201802;56;49;7;46746.0;6678.0;53424.0
240880;201802;29;26;3;24794.46;2862.0;27656.46
240890;201802;1150;676;474;640994.75;452192.0;1093186.8
240895;201802;42;32;10;30528.0;9540.0;40068.0
240910;201802;153;138;15;131652.0;14310.0;145962.0
240920;201802;14;11;3;10494.0;2862.0;13356.0
240930;201802;379;343;36;326268.0;34344.0;360612.0
240933;201802;28;20;8;19080.0;7632.0;26712.0
240940;201802;2419;2139;280;2027113.2;264238.9;2291352.2
240950;201802;49;47;2;44838.0;1908.0;46746.0
240960;201802;32;25;7;23850.0;6678.0;30528.0
240970;201802;133;96;37;91584.0;34544.0;126128.0
240980;201802;187;151;36;144054.0;34344.0;178398.0
240990;201802;119;80;39;76320.0;37206.0;113526.0
241000;201802;72;66;6;62964.0;5724.0;68688.0
241010;201802;57;46;11;43884.0;10494.0;54378.0
241020;201802;114;107;7;102078.0;6678.0;108756.0
241025;201802;9;3;6;2862.0;5724.0;8586.0
241030;201802;120;98;22;93492.0;20988.0;114480.0
241040;201802;34;29;5;27666.0;4770.0;32436.0
241050;201802;90;78;12;74412.0;11448.0;85860.0
241060;201802;27;24;3;22896.0;2862.0;25758.0
241070;201802;15;15;0;14310.0;0.0;14310.0
241080;201802;65;57;8;54091.8;7632.0;61723.8
241090;201802;49;40;9;38160.0;8571.69;46731.69
241100;201802;73;64;9;61056.0;8586.0;69642.0
241105;201802;6;2;4;1908.0;3816.0;5724.0
241110;201802;48;46;2;43884.0;1908.0;45792.0
241120;201802;1417;1100;317;1046414.8;302418.0;1348832.8
241140;201802;225;183;42;173629.0;40068.0;213697.0
241142;201802;41;40;1;38160.0;954.0;39114.0
241150;201802;1205;1058;147;1006614.0;140238.0;1146852.0
241160;201802;22;21;1;20034.0;954.0;20988.0
241170;201802;42;39;3;37206.0;2862.0;40068.0
241180;201802;51;42;9;39893.42;8586.0;48479.42
241190;201802;38;37;1;35298.0;954.0;36252.0
241200;201802;3843;2104;1739;2003216.9;1657085.6;3660302.5
241210;201802;72;60;12;57240.0;10590.0;67830.0
241220;201802;1361;908;453;865709.06;432128.9;1297838.0
241230;201802;245;207;38;197287.2;36252.0;233539.2
241240;201802;52;40;12;38160.0;11448.0;49608.0
241250;201802;1080;1004;76;957530.0;72218.0;1029748.0
241255;201802;46;37;9;35298.0;8586.0;43884.0
241260;201802;629;497;132;474133.22;125928.0;600061.25
241270;201802;45;31;14;29574.0;13356.0;42930.0
241280;201802;98;86;12;82044.0;11448.0;93492.0
241290;201802;109;81;28;77274.0;26712.0;103986.0
241300;201802;77;54;23;51516.0;21942.0;73458.0
241310;201802;51;38;13;36109.0;12402.0;48511.0
241320;201802;26;14;12;13356.0;11448.0;24804.0
241330;201802;60;54;6;51516.0;5724.0;57240.0
241335;201802;62;55;7;51897.6;6678.0;58575.6
241340;201802;187;141;46;134514.0;43884.0;178398.0
241350;201802;57;52;5;49608.0;4770.0;54378.0
241355;201802;41;38;3;36252.0;2862.0;39114.0
241360;201802;46;46;0;43884.0;0.0;43884.0
241370;201802;45;37;8;35173.98;7632.0;42805.98
241380;201802;40;38;2;36252.0;1908.0;38160.0
241390;201802;77;62;15;58957.2;14310.0;73267.2
241400;201802;190;157;33;149110.2;31482.0;180592.2
241410;201802;177;159;18;151686.0;17076.6;168762.6
241415;201802;93;74;19;70596.0;18126.0;88722.0
241420;201802;94;72;22;68688.0;20817.0;89505.0
241430;201802;28;27;1;25758.0;954.0;26712.0
241440;201802;453;384;69;366322.0;65826.0;432148.0
241445;201802;36;34;2;32436.0;1908.0;34344.0
241450;201802;275;224;51;213569.0;48654.0;262223.0
241460;201802;137;125;12;119012.0;11448.0;130460.0
241470;201802;43;36;7;34344.0;6678.0;41022.0
241475;201802;65;61;4;58194.0;3816.0;62010.0
241480;201802;98;70;28;65540.69;26712.0;92252.69
241490;201802;9;8;1;7632.0;954.0;8586.0
241500;201802;46;35;11;33390.0;10494.0;43884.0
250010;201802;101;87;14;82854.9;13356.0;96210.9
250020;201802;26;23;3;21942.0;2862.0;24804.0
250030;201802;804;594;210;565331.2;199291.6;764622.8
250040;201802;328;275;53;262350.0;50562.0;312912.0
250050;201802;227;187;40;178041.77;38160.0;216201.77
250053;201802;54;42;12;40068.0;11448.0;51516.0
250057;201802;0;0;0;0.0;0.0;0.0
250060;201802;446;339;107;323406.0;101791.8;425197.8
250070;201802;695;581;114;552256.0;108756.0;661012.0
250073;201802;7;7;0;6678.0;0.0;6678.0
250077;201802;204;151;53;143662.86;50562.0;194224.86
250080;201802;422;330;92;313199.2;87768.0;400967.2
250090;201802;199;133;66;125928.4;62944.92;188873.31
250100;201802;469;383;86;365382.0;81663.0;447045.0
250110;201802;486;368;118;349288.03;112572.0;461860.03
250115;201802;28;9;19;8586.0;18126.0;26712.0
250120;201802;110;83;27;79182.0;25758.0;104940.0
250130;201802;582;462;120;440748.0;114290.0;555038.0
250135;201802;14;8;6;7632.0;5724.0;13356.0
250140;201802;77;68;9;64872.0;8586.0;73458.0
250150;201802;561;416;145;394696.0;138015.19;532711.2
250153;201802;10;9;1;8586.0;954.0;9540.0
250157;201802;29;24;5;22896.0;4770.0;27666.0
250160;201802;209;165;44;157410.0;41976.0;199386.0
250170;201802;68;48;20;45792.0;19080.0;64872.0
250180;201802;3999;2689;1310;2551649.0;1244642.0;3796291.0
250190;201802;908;603;305;573592.5;290254.5;863847.0
250200;201802;51;43;8;41022.0;7632.0;48654.0
250205;201802;21;19;2;18126.0;1908.0;20034.0
250210;201802;90;78;12;74412.0;11448.0;85860.0
250215;201802;63;54;9;51516.0;8586.0;60102.0
250220;201802;27;21;6;20034.0;5724.0;25758.0
250230;201802;75;68;7;64868.0;6678.0;71546.0
250240;201802;242;201;41;190943.1;39114.0;230057.1
250250;201802;387;330;57;314820.0;54378.0;369198.0
250260;201802;34;29;5;27666.0;4770.0;32436.0
250270;201802;56;45;11;42930.0;10494.0;53424.0
250280;201802;382;320;62;305280.0;59148.0;364428.0
250290;201802;94;89;5;84619.8;4770.0;89389.8
250300;201802;559;383;176;364734.72;167891.0;532625.7
250310;201802;47;41;6;39114.0;5724.0;44838.0
250320;201802;1933;1321;612;1253821.1;582275.0;1836096.1
250330;201802;80;71;9;67734.0;8586.0;76320.0
250340;201802;26;22;4;20988.0;3816.0;24804.0
250350;201802;139;89;50;84619.8;47127.6;131747.4
250355;201802;32;25;7;23850.0;6678.0;30528.0
250360;201802;200;162;38;154548.0;36014.0;190562.0
250370;201802;2377;1613;764;1533844.0;727299.8;2261143.8
250375;201802;18;14;4;13356.0;3816.0;17172.0
250380;201802;51;35;16;33390.0;15264.0;48654.0
250390;201802;42;35;7;33390.0;6678.0;40068.0
250400;201802;15546;7872;7674;7485229.0;7315497.5;1,48E+14
250403;201802;425;345;80;329120.47;76320.0;405440.47
250407;201802;54;46;8;43884.0;7632.0;51516.0
250410;201802;28;23;5;21942.0;4770.0;26712.0
250415;201802;42;28;14;26712.0;13336.92;40048.92
250420;201802;46;38;8;36252.0;7632.0;43884.0
250430;201802;1641;1388;253;1321959.0;241362.0;1563321.0
250435;201802;15;12;3;11448.0;2862.0;14310.0
250440;201802;688;595;93;564937.4;88722.0;653659.4
250450;201802;86;73;13;69642.0;12402.0;82044.0
250460;201802;415;282;133;269028.0;126872.46;395900.47
250470;201802;88;65;23;62010.0;21942.0;83952.0
250480;201802;323;254;69;242316.0;65826.0;308142.0
250485;201802;2;1;1;954.0;954.0;1908.0
250490;201802;203;165;38;157410.0;36252.0;193662.0
250500;201802;74;54;20;51516.0;19080.0;70596.0
250510;201802;730;571;159;543398.6;150677.44;694076.0
250520;201802;175;122;53;116368.92;50557.23;166926.16
250523;201802;109;91;18;86814.0;17172.0;103986.0
250527;201802;104;80;24;76315.23;22896.0;99211.23
250530;201802;7;6;1;5724.0;954.0;6678.0
250535;201802;25;21;4;20034.0;3816.0;23850.0
250540;201802;123;93;30;88006.5;28620.0;116626.5
250550;201802;68;65;3;62010.0;2862.0;64872.0
250560;201802;35;29;6;27666.0;5724.0;33390.0
250570;201802;153;122;31;116388.0;29574.0;145962.0
250580;201802;132;103;29;97975.8;27666.0;125641.8
250590;201802;20;16;4;15264.0;3816.0;19080.0
250600;201802;1326;896;430;851924.25;410124.6;1262048.9
250610;201802;153;132;21;125928.0;20034.0;145962.0
250620;201802;21;17;4;16218.0;3816.0;20034.0
250625;201802;60;45;15;42930.0;14310.0;57240.0
250630;201802;2995;1915;1080;1818867.6;1029252.75;2848120.5
250640;201802;204;169;35;161226.0;33390.0;194616.0
250650;201802;31;21;10;20034.0;9540.0;29574.0
250660;201802;43;33;10;31482.0;9540.0;41022.0
250670;201802;59;39;20;37206.0;19080.0;56286.0
250680;201802;383;314;69;299556.0;65826.0;365382.0
250690;201802;1815;1249;566;1188107.5;539582.8;1727690.4
250700;201802;955;840;115;797851.94;109500.12;907352.0
250710;201802;443;344;99;328176.0;94159.8;422335.8
250720;201802;103;81;22;77274.0;20988.0;98262.0
250730;201802;368;309;59;293832.6;56286.0;350118.6
250740;201802;50;46;4;43884.0;3816.0;47700.0
250750;201802;20233;12093;8140;1,15E+14;7756790.0;1,92E+14
250760;201802;68;51;17;48654.0;16218.0;64872.0
250770;201802;351;233;118;220374.14;111403.55;331777.7
250780;201802;58;45;13;42930.0;12402.0;55332.0
250790;201802;485;318;167;300510.9;158602.5;459113.4
250800;201802;151;140;11;132844.5;10494.0;143338.5
250810;201802;79;59;20;56286.0;19080.0;75366.0
250820;201802;156;125;31;119250.0;29574.0;148824.0
250830;201802;429;289;140;274704.5;133560.0;408264.5
250840;201802;54;52;2;49608.0;1908.0;51516.0
250850;201802;54;42;12;39381.12;11448.0;50829.12
250855;201802;13;11;2;10494.0;1908.0;12402.0
250860;201802;204;146;58;139284.0;55045.8;194329.8
250870;201802;32;29;3;27666.0;2862.0;30528.0
250880;201802;79;60;19;57182.76;18126.0;75308.76
250890;201802;2383;1762;621;1679612.4;591570.75;2271183.2
250900;201802;114;97;17;92538.0;16218.0;108756.0
250905;201802;125;96;29;91584.0;27666.0;119250.0
250910;201802;1176;836;340;796381.3;324073.8;1120455.1
250915;201802;110;75;35;71550.0;33390.0;104940.0
250920;201802;137;105;32;100170.0;30528.0;130698.0
250930;201802;158;97;61;92538.0;58194.0;150732.0
250933;201802;0;0;0;0.0;0.0;0.0
250937;201802;6;5;1;4770.0;954.0;5724.0
250939;201802;31;23;8;21942.0;7632.0;29574.0
250940;201802;106;81;25;77274.0;23850.0;101124.0
250950;201802;72;47;25;44838.0;23850.0;68688.0
250960;201802;92;50;42;47700.0;40068.0;87768.0
250970;201802;1206;861;345;819773.0;328176.0;1147949.0
250980;201802;90;63;27;60102.0;25758.0;85860.0
250990;201802;164;129;35;122608.08;33347.07;155955.16
251000;201802;73;67;6;63727.2;5724.0;69451.2
251010;201802;97;76;21;72500.0;19255.53;91755.53
251020;201802;81;70;11;65969.1;10494.0;76463.1
251030;201802;42;32;10;30528.0;9540.0;40068.0
251040;201802;54;39;15;37206.0;14310.0;51516.0
251050;201802;24;22;2;20988.0;1908.0;22896.0
251060;201802;50;40;10;37206.0;9540.0;46746.0
251065;201802;3;3;0;2862.0;0.0;2862.0
251070;201802;25;20;5;19071.0;4770.0;23841.0
251080;201802;4695;2280;2415;2162568.2;2297357.0;4459925.5
251090;201802;197;169;28;161226.0;26712.0;187938.0
251100;201802;19;18;1;17172.0;954.0;18126.0
251110;201802;47;37;10;35298.0;9540.0;44838.0
251120;201802;1774;1062;712;1008238.2;679248.0;1687486.2
251130;201802;356;289;67;275706.0;63918.0;339624.0
251140;201802;506;329;177;312722.8;168689.34;481412.12
251150;201802;290;250;40;237728.0;38160.0;275888.0
251160;201802;92;77;15;73454.0;14310.0;87764.0
251170;201802;98;79;19;75337.38;18121.23;93458.61
251180;201802;287;180;107;171711.23;102069.23;273780.47
251190;201802;194;132;62;125599.83;59148.0;184747.83
251200;201802;253;207;46;197478.0;43884.0;241362.0
251203;201802;33;31;2;29574.0;1908.0;31482.0
251207;201802;93;77;16;73458.0;15264.0;88722.0
251210;201802;1254;900;354;857046.5;337048.2;1194094.8
251220;201802;45;34;11;32436.0;10494.0;42930.0
251230;201802;470;395;75;376830.0;71550.0;448380.0
251240;201802;100;72;28;67734.0;26712.0;94446.0
251250;201802;1323;948;375;901502.9;357607.0;1259109.9
251260;201802;13;8;5;7632.0;4770.0;12402.0
251270;201802;342;252;90;240408.0;85717.0;326125.0
251272;201802;66;60;6;57240.0;5724.0;62964.0
251274;201802;29;24;5;22896.0;4770.0;27666.0
251275;201802;22;15;7;14310.0;6678.0;20988.0
251276;201802;18;14;4;13356.0;3816.0;17172.0
251278;201802;9;7;2;6678.0;1908.0;8586.0
251280;201802;97;93;4;88722.0;3816.0;92538.0
251290;201802;696;528;168;503712.0;160272.0;663984.0
251300;201802;16;14;2;13356.0;1908.0;15264.0
251310;201802;360;259;101;247082.0;96354.0;343436.0
251315;201802;18;17;1;16218.0;954.0;17172.0
251320;201802;60;49;11;46746.0;10494.0;57240.0
251330;201802;79;70;9;66780.0;8586.0;75366.0
251335;201802;11;7;4;6678.0;3816.0;10494.0
251340;201802;687;407;280;388278.0;266095.25;654373.25
251350;201802;35;33;2;31482.0;1908.0;33390.0
251360;201802;65;57;8;54171.94;7632.0;61803.94
251365;201802;14;14;0;13356.0;0.0;13356.0
251370;201802;5253;3570;1683;3401204.2;1604248.0;5005452.5
251380;201802;49;39;10;37206.0;9540.0;46746.0
251385;201802;2;2;0;1908.0;0.0;1908.0
251390;201802;663;529;134;503522.2;126596.0;630118.2
251392;201802;30;20;10;19080.0;9540.0;28620.0
251394;201802;9;9;0;8586.0;0.0;8586.0
251396;201802;19;14;5;13356.0;4770.0;18126.0
251398;201802;17;15;2;14310.0;1908.0;16218.0
251400;201802;39;32;7;30528.0;6678.0;37206.0
251410;201802;35;30;5;28620.0;4770.0;33390.0
251420;201802;108;81;27;77274.0;25758.0;103032.0
251430;201802;38;36;2;34344.0;1908.0;36252.0
251440;201802;34;22;12;20988.0;11448.0;32436.0
251445;201802;52;47;5;44838.0;4770.0;49608.0
251450;201802;419;369;50;350370.8;47700.0;398070.8
251455;201802;2;1;1;954.0;954.0;1908.0
251460;201802;17;13;4;12402.0;3816.0;16218.0
251465;201802;5;2;3;1908.0;2862.0;4770.0
251470;201802;45;36;9;34344.0;8586.0;42930.0
251480;201802;24;22;2;20988.0;1908.0;22896.0
251490;201802;130;91;39;86337.0;36253.0;122590.0
251500;201802;116;94;22;89676.0;20225.0;109901.0
251510;201802;35;27;8;25758.0;7632.0;33390.0
251520;201802;26;26;0;24804.0;0.0;24804.0
251530;201802;4528;3177;1351;3024844.2;1288558.2;4313402.5
251540;201802;73;65;8;62010.0;7632.0;69642.0
251550;201802;410;317;93;301464.2;87912.0;389376.2
251560;201802;22;17;5;16218.0;4770.0;20988.0
251570;201802;18;18;0;17172.0;0.0;17172.0
251580;201802;119;97;22;92538.0;20988.0;113526.0
251590;201802;126;94;32;89676.0;30528.0;120204.0
251593;201802;19;10;9;9540.0;8586.0;18126.0
251597;201802;59;49;10;46746.0;9540.0;56286.0
251600;201802;1105;787;318;749497.25;301763.9;1051261.2
251610;201802;212;160;52;151972.2;48941.0;200913.2
251615;201802;3;3;0;2862.0;0.0;2862.0
251620;201802;4236;2834;1402;2693795.8;1334743.2;4028539.0
251630;201802;448;330;118;314820.0;112444.36;427264.38
251640;201802;148;107;41;102078.0;39114.0;141192.0
251650;201802;263;191;72;180381.1;68688.0;249069.1
251660;201802;222;202;20;191754.1;18889.2;210643.3
251670;201802;359;282;77;267332.0;73458.0;340790.0
251675;201802;4;4;0;3816.0;0.0;3816.0
251680;201802;89;81;8;77274.0;7632.0;84906.0
251690;201802;337;283;54;269028.0;51165.89;320193.88
251700;201802;281;234;47;222649.3;44823.69;267472.97
251710;201802;19;12;7;11448.0;6678.0;18126.0
251720;201802;33;22;11;20988.0;10208.0;31196.0
251740;201802;10;8;2;7632.0;1908.0;9540.0
260005;201802;3116;1775;1341;1682251.1;1278147.1;2960398.2
260010;201802;1433;1021;412;970314.3;391045.3;1361359.6
260020;201802;429;376;53;358704.0;50562.0;409266.0
260030;201802;579;420;159;399912.97;151686.0;551599.0
260040;201802;857;521;336;495946.44;320391.38;816337.8
260050;201802;1129;812;317;774410.0;301846.0;1076256.0
260060;201802;416;378;38;359848.8;36252.0;396100.8
260070;201802;1452;911;541;864972.0;514098.38;1379070.4
260080;201802;730;578;152;550458.1;145008.0;695466.1
260090;201802;564;351;213;334626.12;203202.0;537828.1
260100;201802;225;157;68;148777.2;64872.0;213649.2
260105;201802;234;131;103;124974.0;98262.0;223236.0
260110;201802;2724;2031;693;1937565.0;660312.0;2597877.0
260120;201802;2910;1465;1445;1387892.0;1376242.1;2764134.0
260130;201802;147;102;45;97308.0;42930.0;140238.0
260140;201802;2095;1375;720;1303260.0;685335.44;1988595.4
260150;201802;228;150;78;143100.0;74412.0;217512.0
260160;201802;292;252;40;240408.0;38160.0;278568.0
260170;201802;3341;2036;1305;1936252.6;1243872.9;3180125.5
260180;201802;136;114;22;108756.0;20988.0;129744.0
260190;201802;2253;1603;650;1526111.9;620100.0;2146212.0
260200;201802;890;734;156;699461.06;148538.0;847999.06
260210;201802;1411;996;415;950033.25;394661.12;1344694.4
260220;201802;715;656;59;625035.0;56286.0;681321.0
260230;201802;1190;902;288;858317.0;274752.0;1133069.0
260240;201802;217;163;54;154328.58;51516.0;205844.58
260250;201802;72;57;15;54378.0;14310.0;68688.0
260260;201802;984;709;275;676386.0;262350.0;938736.0
260270;201802;430;348;82;330609.2;77941.8;408551.0
260280;201802;1279;869;410;828549.0;390854.0;1219403.0
260290;201802;6358;3375;2983;3200946.2;2839072.0;6040018.5
260300;201802;847;745;102;708661.6;97022.0;805683.6
260310;201802;499;397;102;377359.47;97308.0;474667.47
260320;201802;881;664;217;633169.2;207018.0;840187.2
260330;201802;33;27;6;25758.0;5724.0;31482.0
260340;201802;65;48;17;45792.0;16218.0;62010.0
260345;201802;5604;3153;2451;3002262.8;2337238.5;5339501.0
260350;201802;467;340;127;322616.1;120205.0;442821.1
260360;201802;283;143;140;136422.0;133560.0;269982.0
260370;201802;641;418;223;396162.4;212602.0;608764.4
260380;201802;598;429;169;409266.0;160081.56;569347.56
260390;201802;293;251;42;238375.98;39114.0;277489.97
260392;201802;93;81;12;77274.0;11448.0;88722.0
260400;201802;4065;2341;1724;2223075.0;1644334.2;3867409.2
260410;201802;14224;7681;6543;7312922.5;6239291.0;1,36E+14
260415;201802;123;111;12;105894.0;11448.0;117342.0
260420;201802;1768;1053;715;999242.6;680313.6;1679556.2
260430;201802;190;174;16;164784.66;15264.0;180048.66
260440;201802;230;166;64;157640.0;61056.0;218696.0
260450;201802;475;344;131;326891.0;124974.0;451865.0
260460;201802;851;454;397;430446.8;378733.22;809180.0
260470;201802;376;232;144;220564.8;136995.0;357559.8
260480;201802;204;127;77;121158.0;73458.0;194616.0
260490;201802;207;167;40;159318.0;38160.0;197478.0
260500;201802;1126;754;372;717028.2;353791.8;1070820.0
260510;201802;737;586;151;559044.0;143100.0;702144.0
260515;201802;256;229;27;218466.0;25281.0;243747.0
260520;201802;3296;1951;1345;1853668.4;1281213.9;3134882.2
260530;201802;778;630;148;598200.6;141192.0;739392.6
260540;201802;570;431;139;411174.0;131652.72;542826.75
260545;201802;14;10;4;9540.0;3816.0;13356.0
260550;201802;342;212;130;202248.0;124020.0;326268.0
260560;201802;517;389;128;370515.0;121825.8;492340.8
260570;201802;1009;831;178;789769.8;169525.8;959295.6
260580;201802;268;240;28;228960.0;26712.0;255672.0
260590;201802;655;374;281;355384.1;268074.0;623458.06
260600;201802;8171;4155;4016;3941215.5;3827300.2;7768515.5
260610;201802;494;328;166;312912.0;158077.8;470989.8
260620;201802;3625;1889;1736;1790416.8;1651151.8;3441568.5
260630;201802;72;69;3;65826.0;2862.0;68688.0
260640;201802;3616;1975;1641;1880831.6;1565143.0;3445974.5
260650;201802;337;233;104;222282.0;99173.07;321455.06
260660;201802;494;338;156;322070.4;148203.9;470274.3
260670;201802;101;76;25;72504.0;23850.0;96354.0
260680;201802;3674;2042;1632;1930230.8;1556851.8;3487082.5
260690;201802;120;93;27;88722.0;25758.0;114480.0
260700;201802;327;200;127;190036.8;120324.0;310360.8
260710;201802;39;35;4;33390.0;3816.0;37206.0
260720;201802;2210;1331;879;1263568.5;837488.0;2101056.5
260730;201802;587;442;145;421668.0;136135.8;557803.8
260740;201802;61;57;4;54378.0;3816.0;58194.0
260750;201802;640;446;194;425159.62;185076.0;610235.6
260760;201802;623;342;281;326268.0;267757.0;594025.0
260765;201802;991;520;471;493137.8;449095.5;942233.3
260770;201802;222;165;57;157410.0;54378.0;211788.0
260775;201802;816;483;333;459399.8;317673.0;777072.8
260780;201802;270;173;97;165042.0;92404.44;257446.44
260790;201802;12406;6798;5608;6457285.5;5342463.0;1,18E+14
260795;201802;158;110;48;103776.12;45792.0;149568.12
260800;201802;280;229;51;217989.0;48654.0;266643.0
260805;201802;174;111;63;105165.14;60102.0;165267.14
260810;201802;740;644;96;613126.25;91584.0;704710.25
260820;201802;314;210;104;199010.8;99216.0;298226.78
260825;201802;206;142;64;135090.98;61056.0;196146.98
260830;201802;261;168;93;160272.0;88722.0;248994.0
260840;201802;229;166;63;157697.0;59816.0;217513.0
260845;201802;208;145;63;138043.8;60102.0;198145.8
260850;201802;506;368;138;349408.1;131652.0;481060.1
260860;201802;254;189;65;180108.34;62010.0;242118.34
260870;201802;368;262;106;249948.0;101124.0;351072.0
260875;201802;688;479;209;455852.7;199386.0;655238.7
260880;201802;1558;954;604;908157.06;576025.2;1484182.2
260890;201802;2419;1689;730;1603912.0;695467.0;2299379.0
260900;201802;1029;702;327;668405.8;311958.0;980363.8
260910;201802;278;218;60;207972.0;57240.0;265212.0
260915;201802;306;203;103;193662.0;98142.0;291804.0
260920;201802;173;98;75;93492.0;71550.0;165042.0
260930;201802;387;332;55;316728.0;52384.45;369112.44
260940;201802;2742;1502;1240;1428426.9;1182463.9;2610890.8
260950;201802;1980;1151;829;1090747.9;790837.4;1881585.2
260960;201802;14226;7377;6849;7001795.5;6526471.5;1,35E+14
260970;201802;435;373;62;355842.0;59148.0;414990.0
260980;201802;196;172;24;163802.0;22896.0;186698.0
260990;201802;2549;2102;447;2004802.4;425770.2;2430572.5
261000;201802;4304;2542;1762;2411835.8;1679050.4;4090886.0
261010;201802;189;138;51;131652.0;47836.23;179488.23
261020;201802;602;448;154;427249.0;146105.1;573354.1
261030;201802;220;161;59;153594.0;56080.89;209674.89
261040;201802;361;324;37;309096.0;34868.8;343964.8
261050;201802;466;412;54;393048.0;51516.0;444564.0
261060;201802;1318;866;452;824018.75;431208.0;1255226.8
261070;201802;9030;4614;4416;4377281.0;4204129.0;8581410.0
261080;201802;381;292;89;277796.0;84906.0;362702.0
261090;201802;2223;1705;518;1617990.0;493400.0;2111390.0
261100;201802;1092;775;317;737013.6;300548.16;1037561.75
261110;201802;8026;4925;3101;4692827.0;2956067.8;7648895.0
261120;201802;276;228;48;217512.0;45787.23;263299.22
261130;201802;571;330;241;314486.9;229914.0;544400.9
261140;201802;188;119;69;113526.0;65826.0;179352.0
261150;201802;664;391;273;373014.0;259774.2;632788.2
261153;201802;74;71;3;66780.31;2862.0;69642.31
261160;201802;76752;38815;37937;3,69E+13;3,62E+14;7,31E+14
261170;201802;448;335;113;318674.38;107802.0;426476.38
261180;201802;1777;1088;689;1032549.0;657306.0;1689855.0
261190;201802;617;427;190;406961.9;181251.0;588212.94
261200;201802;212;187;25;177680.3;23850.0;201530.3
261210;201802;36;32;4;30528.0;3816.0;34344.0
261220;201802;2511;1773;738;1685625.1;702907.8;2388533.0
261230;201802;324;241;83;229914.0;79167.69;309081.7
261240;201802;443;383;60;361368.94;57240.0;418608.94
261245;201802;223;187;36;178398.0;34344.0;212742.0
261247;201802;153;115;38;109710.0;36252.0;145962.0
261250;201802;2845;1437;1408;1370325.8;1342121.9;2712447.8
261255;201802;252;230;22;219420.0;20988.0;240408.0
261260;201802;851;730;121;696420.0;115434.0;811854.0
261270;201802;171;133;38;126882.0;36252.0;163134.0
261280;201802;156;127;29;121158.0;27666.0;148824.0
261290;201802;126;89;37;84667.5;35298.0;119965.5
261300;201802;1238;876;362;835704.0;345348.0;1181052.0
261310;201802;758;507;251;483678.0;238833.9;722511.9
261320;201802;537;362;175;345328.9;166950.0;512278.9
261330;201802;821;651;170;618055.5;161334.45;779389.94
261340;201802;313;175;138;166950.0;131652.0;298602.0
261350;201802;786;564;222;537102.2;211788.0;748890.2
261360;201802;1212;783;429;746580.4;409266.0;1155846.4
261370;201802;4955;3038;1917;2883279.8;1825629.5;4708909.5
261380;201802;574;422;152;400689.62;144722.0;545411.6
261390;201802;3408;2279;1129;2169386.8;1073205.2;3242592.2
261400;201802;276;251;25;238881.6;23850.0;262731.6
261410;201802;1060;700;360;667800.0;343435.22;1011235.25
261420;201802;880;547;333;520857.47;317663.47;838520.94
261430;201802;330;300;30;285354.0;28333.8;313687.8
261440;201802;109;98;11;93492.0;10494.0;103986.0
261450;201802;2498;2078;420;1979752.2;399669.03;2379421.2
261460;201802;723;576;147;548550.0;140238.0;688788.0
261470;201802;245;188;57;178542.0;54378.0;232920.0
261480;201802;348;285;63;270651.0;60098.0;330749.0
261485;201802;341;206;135;195856.2;128790.0;324646.2
261500;201802;629;425;204;405450.0;194616.0;600066.0
261510;201802;43;30;13;28620.0;12402.0;41022.0
261520;201802;140;126;14;120204.0;13356.0;133560.0
261530;201802;4161;2638;1523;2508475.0;1451688.8;3960163.8
261540;201802;1078;664;414;632992.4;394956.0;1027948.4
261550;201802;285;140;145;132178.0;138310.92;270488.9
261560;201802;782;521;261;493792.2;247840.6;741632.8
261570;201802;365;286;79;272844.0;75366.0;348210.0
261580;201802;372;293;79;278758.0;75366.0;354124.0
261590;201802;194;156;38;148824.0;36252.0;185076.0
261600;201802;289;231;58;219611.0;54855.0;274466.0
261610;201802;106;91;15;86459.69;14310.0;100769.69
261618;201802;65;51;14;48654.0;13356.0;62010.0
261620;201802;202;122;80;116388.0;76320.0;192708.0
261630;201802;583;448;135;425031.6;128790.0;553821.6
261640;201802;6264;3328;2936;3167551.0;2798093.0;5965644.0
261650;201802;476;297;179;282660.66;170766.0;453426.66
270010;201802;524;459;65;437600.0;61247.0;498847.0
270020;201802;302;238;64;227048.0;61056.0;288104.0
270030;201802;9126;5821;3305;5540777.0;3150517.5;8691294.0
270040;201802;1928;1177;751;1122562.2;714998.5;1837560.8
270050;201802;175;128;47;122112.0;44838.0;166950.0
270060;201802;115;63;52;60102.0;49608.0;109710.0
270070;201802;908;660;248;627625.1;236287.27;863912.4
270080;201802;39;33;6;31482.0;5724.0;37206.0
270090;201802;20;16;4;15264.0;3816.0;19080.0
270100;201802;1256;824;432;782935.3;409981.7;1192917.0
270110;201802;151;111;40;105894.0;38160.0;144054.0
270120;201802;223;182;41;172776.55;39114.0;211890.55
270130;201802;258;180;78;171433.8;74125.8;245559.6
270135;201802;96;59;37;56286.0;35298.0;91584.0
270140;201802;1271;766;505;730571.25;480521.0;1211092.2
270150;201802;265;213;52;203202.0;49608.0;252810.0
270160;201802;518;385;133;367290.0;126214.2;493504.2
270170;201802;709;450;259;428155.2;246275.1;674430.3
270180;201802;72;55;17;52152.04;16008.12;68160.16
270190;201802;103;90;13;85860.0;12402.0;98262.0
270200;201802;107;96;11;91393.2;10494.0;101887.2
270210;201802;481;247;234;235638.0;222949.8;458587.8
270220;201802;187;147;40;140238.0;38160.0;178398.0
270230;201802;2086;1238;848;1176018.8;806131.44;1982150.1
270235;201802;738;553;185;527253.44;176124.95;703378.4
270240;201802;3093;2391;702;2269597.8;666916.0;2936513.8
270250;201802;171;119;52;113526.0;49608.0;163134.0
270255;201802;221;191;30;182214.0;28238.4;210452.4
270260;201802;326;259;67;247086.0;63918.0;311004.0
270270;201802;115;48;67;45783.0;63918.0;109701.0
270280;201802;211;131;80;124974.0;76320.0;201294.0
270290;201802;1165;872;293;830652.44;278645.47;1109297.9
270300;201802;271;171;100;163134.0;95113.8;258247.8
270310;201802;920;736;184;699905.8;174812.05;874717.9
270320;201802;887;756;131;720156.8;124687.8;844844.6
270330;201802;274;229;45;217512.0;42930.0;260442.0
270340;201802;60;47;13;44838.0;12402.0;57240.0
270350;201802;94;48;46;45267.3;43884.0;89151.3
270360;201802;74;39;35;37206.0;33390.0;70596.0
270370;201802;52;39;13;37206.0;12402.0;49608.0
270375;201802;67;38;29;36252.0;27666.0;63918.0
270380;201802;1080;605;475;576216.0;453150.0;1029366.0
270390;201802;193;105;88;100170.0;83952.0;184122.0
270400;201802;703;511;192;486279.28;183159.0;669438.25
270410;201802;697;496;201;472866.03;191744.45;664610.5
270420;201802;395;254;141;240618.0;134429.38;375047.38
270430;201802;32038;22818;9220;2,17E+14;8787173.0;3,05E+14
270440;201802;489;383;106;364571.1;100837.8;465408.9
270450;201802;767;400;367;381361.5;348912.66;730274.2
270460;201802;199;150;49;143100.0;46746.0;189846.0
270470;201802;1343;885;458;843936.7;436932.0;1280868.8
270480;201802;528;424;104;401414.97;98500.5;499915.47
270490;201802;25;21;4;20034.0;3816.0;23850.0
270500;201802;514;422;92;402588.0;87768.0;490356.0
270510;201802;731;449;282;428346.0;269028.0;697374.0
270520;201802;383;234;149;223027.0;142146.0;365173.0
270530;201802;65;57;8;54378.0;7632.0;62010.0
270540;201802;124;95;29;90630.0;27666.0;118296.0
270550;201802;1714;1293;421;1232245.2;401247.62;1633492.9
270560;201802;316;143;173;136422.0;165042.0;301464.0
270570;201802;449;298;151;283464.66;144054.0;427518.66
270580;201802;77;55;22;52470.0;20988.0;73458.0
270590;201802;81;67;14;63918.0;13356.0;77274.0
270600;201802;176;146;30;139284.0;28620.0;167904.0
270610;201802;177;141;36;134505.0;34344.0;168849.0
270620;201802;30;29;1;27666.0;954.0;28620.0
270630;201802;3834;2908;926;2762452.2;881248.94;3643701.2
270640;201802;900;657;243;625074.6;231507.8;856582.4
270642;201802;208;175;33;166950.0;31482.0;198432.0
270644;201802;280;193;87;183931.73;82993.23;266924.97
270650;201802;241;138;103;131652.0;98262.0;229914.0
270660;201802;256;206;50;196524.0;47700.0;244224.0
270670;201802;3157;2397;760;2275920.8;721831.5;2997752.2
270680;201802;464;268;196;255663.0;186979.23;442642.22
270690;201802;1116;698;418;664159.75;398762.47;1062922.2
270700;201802;36;27;9;25758.0;8586.0;34344.0
270710;201802;874;656;218;624205.3;207972.0;832177.3
270720;201802;245;186;59;177444.0;55999.8;233443.8
270730;201802;1881;1094;787;1041435.4;748692.2;1790127.6
270740;201802;46;29;17;27666.0;16218.0;43884.0
270750;201802;631;461;170;439604.0;161513.0;601117.0
270760;201802;310;223;87;212742.0;82998.0;295740.0
270770;201802;2689;1702;987;1615512.1;940644.0;2556156.0
270780;201802;92;57;35;54373.23;33372.46;87745.69
270790;201802;274;184;90;175536.0;85860.0;261396.0
270800;201802;1966;1562;404;1488355.2;384671.88;1873027.1
270810;201802;315;246;69;234669.69;65817.23;300486.9
270820;201802;155;99;56;94446.0;53329.0;147775.0
270830;201802;940;680;260;647957.0;247754.0;895711.0
270840;201802;1412;1026;386;977659.7;366576.0;1344235.8
270850;201802;1698;1034;664;981614.56;633437.44;1615052.0
270860;201802;2438;1576;862;1499926.2;819450.56;2319376.8
270870;201802;122;66;56;62964.0;53424.0;116388.0
270880;201802;909;663;246;630666.1;233790.58;864456.75
270890;201802;360;262;98;249499.62;93487.23;342986.84
270895;201802;70;60;10;57240.0;9540.0;66780.0
270900;201802;107;83;24;79182.0;22896.0;102078.0
270910;201802;324;258;66;244987.2;62964.0;307951.2
270915;201802;1809;1076;733;1021606.6;698563.1;1720169.8
270920;201802;477;398;79;379692.0;75366.0;455058.0
270930;201802;6209;4474;1735;4262679.0;1652141.8;5914821.0
270940;201802;2367;1783;584;1699012.9;556164.0;2255177.0
280010;201802;44;39;5;37206.0;4770.0;41976.0
280020;201802;698;600;98;570461.0;92538.0;662999.0
280030;201802;19170;12259;6911;1,16E+14;6564934.5;1,82E+14
280040;201802;338;213;125;203202.0;117819.0;321021.0
280050;201802;376;291;85;277327.8;81090.0;358417.8
280060;201802;325;216;109;203817.44;103986.0;307803.44
280067;201802;981;687;294;652639.94;279522.25;932162.2
280070;201802;130;108;22;103032.0;20988.0;124020.0
280100;201802;613;481;132;456034.28;125738.0;581772.25
280110;201802;75;71;4;67734.0;3816.0;71550.0
280120;201802;628;504;124;480816.0;118296.0;599112.0
280130;201802;1348;838;510;798021.8;486396.9;1284418.8
280140;201802;468;376;92;357845.4;86771.31;444616.72
280150;201802;316;233;83;221602.1;79182.0;300784.1
280160;201802;99;84;15;80136.0;14310.0;94446.0
280170;201802;582;387;195;367732.56;185219.1;552951.7
280190;201802;27;25;2;23850.0;1908.0;25758.0
280200;201802;23;15;8;14310.0;7632.0;21942.0
280210;201802;2741;1935;806;1828334.1;763347.0;2591681.0
280220;201802;40;31;9;29574.0;8586.0;38160.0
280230;201802;310;255;55;242435.62;52470.0;294905.62
280240;201802;112;106;6;100980.9;5724.0;106704.9
280250;201802;20;12;8;11448.0;7632.0;19080.0
280260;201802;79;70;9;66780.0;8586.0;75366.0
280270;201802;160;123;37;117342.0;35298.0;152640.0
280280;201802;197;125;72;119250.0;68688.0;187938.0
280290;201802;3053;2207;846;2092390.1;805773.25;2898163.5
280300;201802;1093;823;270;783477.25;256816.8;1040294.06
280310;201802;106;101;5;96023.29;4770.0;100793.29
280320;201802;654;444;210;423567.0;200340.0;623907.0
280330;201802;354;253;101;241362.0;96229.98;337591.97
280340;201802;414;332;82;315256.56;77465.0;392721.56
280350;201802;3389;2612;777;2483120.8;738518.2;3221639.0
280360;201802;463;293;170;279522.0;161226.0;440748.0
280370;201802;99;87;12;82998.0;11448.0;94446.0
280380;201802;55;41;14;39114.0;13356.0;52470.0
280390;201802;186;154;32;146916.0;30528.0;177444.0
280400;201802;343;233;110;221423.8;104940.0;326363.8
280410;201802;290;234;56;222074.0;53414.46;275488.47
280420;201802;176;147;29;140238.0;27666.0;167904.0
280430;201802;105;77;28;73458.0;26603.63;100061.63
280440;201802;677;520;157;492170.9;149577.66;641748.56
280445;201802;114;106;8;101124.0;7632.0;108756.0
280450;201802;1063;908;155;862893.0;147870.0;1010763.0
280460;201802;732;530;202;498759.44;192708.0;691467.44
280470;201802;192;175;17;166950.0;15265.0;182215.0
280480;201802;2233;1587;646;1499344.2;612528.9;2111873.0
280490;201802;358;329;29;312415.0;27666.0;340081.0
280500;201802;45;40;5;38160.0;4770.0;42930.0
280510;201802;148;114;34;108455.2;32150.0;140605.2
280520;201802;53;39;14;37206.0;13356.0;50562.0
280530;201802;77;54;23;51516.0;21942.0;73458.0
280540;201802;504;404;100;385416.0;95113.8;480529.8
280550;201802;703;650;53;617484.6;50562.0;668046.6
280560;201802;473;410;63;388134.9;60102.0;448236.9
280570;201802;1774;1349;425;1283217.5;404594.84;1687812.2
280580;201802;594;449;145;426678.6;138235.0;564913.6
280590;201802;162;98;64;93212.48;61056.0;154268.48
280600;201802;354;297;57;282593.88;54378.0;336971.88
280610;201802;144;108;36;102826.0;34344.0;137170.0
280620;201802;546;446;100;424231.25;94446.9;518678.12
280630;201802;163;135;28;128790.0;26712.0;155502.0
280640;201802;209;167;42;158489.0;40068.0;198557.0
280650;201802;77;51;26;48654.0;24804.0;73458.0
280660;201802;130;93;37;88722.0;35059.5;123781.5
280670;201802;1616;1010;606;957631.75;574379.94;1532011.8
280680;201802;180;153;27;144178.14;25758.0;169936.14
280690;201802;50;42;8;40068.0;7632.0;47700.0
280700;201802;17;17;0;16218.0;0.0;16218.0
280710;201802;1408;1062;346;1006072.8;329416.2;1335489.0
280720;201802;108;74;34;67817.92;32436.0;100253.92
280730;201802;25;21;4;20034.0;3816.0;23850.0
280740;201802;2380;1752;628;1665396.2;598006.44;2263402.8
280750;201802;290;250;40;238500.0;38160.0;276660.0
280760;201802;877;600;277;571255.2;264114.9;835370.1
290010;201802;198;132;66;125928.0;62964.0;188892.0
290020;201802;177;164;13;156456.0;12402.0;168858.0
290030;201802;590;382;208;363760.2;198432.0;562192.2
290035;201802;141;114;27;105551.7;25758.0;131309.7
290040;201802;265;168;97;160272.0;92538.0;252810.0
290050;201802;71;52;19;49608.0;18126.0;67734.0
290060;201802;253;112;141;106561.8;134514.0;241075.8
290070;201802;5569;2744;2825;2610337.8;2691098.8;5301436.5
290080;201802;501;229;272;218160.72;259469.0;477629.72
290090;201802;376;162;214;154548.0;204156.0;358704.0
290100;201802;1586;1042;544;989873.1;518403.8;1508276.9
290110;201802;744;443;301;420996.2;286911.5;707907.7
290115;201802;213;197;16;186984.0;15264.0;202248.0
290120;201802;780;505;275;481102.2;262350.0;743452.2
290130;201802;419;249;170;237250.27;162180.0;399430.25
290135;201802;295;225;70;213972.66;66780.0;280752.66
290140;201802;301;246;55;234684.0;52279.2;286963.2
290150;201802;127;95;32;90630.0;30528.0;121158.0
290160;201802;244;188;56;178112.58;53424.0;231536.58
290170;201802;88;62;26;59148.0;24804.0;83952.0
290180;201802;151;118;33;112572.0;31482.0;144054.0
290190;201802;449;365;84;347924.0;79849.8;427773.8
290195;201802;299;173;126;165042.0;120204.0;285246.0
290200;201802;284;240;44;228960.0;41976.0;270936.0
290205;201802;138;84;54;80136.0;51516.0;131652.0
290210;201802;1117;810;307;771596.2;292878.0;1064474.2
290220;201802;217;119;98;113049.0;93492.0;206541.0
290225;201802;281;107;174;102078.0;165996.0;268074.0
290230;201802;63;40;23;38160.0;21942.0;60102.0
290240;201802;308;122;186;116101.8;177444.0;293545.8
290250;201802;272;245;27;233034.0;25758.0;258792.0
290260;201802;275;227;48;215795.0;45792.0;261587.0
290265;201802;182;151;31;143237.0;29574.0;172811.0
290270;201802;1378;1137;241;1082838.2;229051.0;1311889.2
290280;201802;468;347;121;331038.0;115434.0;446472.0
290290;201802;1214;705;509;667477.9;485586.0;1153063.9
290300;201802;450;381;69;362944.72;65826.0;428770.72
290310;201802;321;142;179;135468.0;170766.0;306234.0
290320;201802;3934;2443;1491;2327919.8;1419553.0;3747472.8
290323;201802;184;159;25;151400.0;23850.0;175250.0
290327;201802;149;118;31;112300.11;29574.0;141874.11
290330;201802;71;37;34;35298.0;32436.0;67734.0
290340;201802;908;360;548;342467.0;522506.0;864973.0
290350;201802;583;346;237;329321.0;226098.0;555419.0
290360;201802;365;274;91;259489.69;86814.0;346303.7
290370;201802;912;355;557;338670.0;531378.0;870048.0
290380;201802;303;186;117;177444.0;111618.0;289062.0
290390;201802;2476;1542;934;1468095.6;889128.0;2357223.5
290395;201802;242;133;109;126644.0;103986.0;230630.0
290400;201802;277;204;73;194330.0;69642.0;263972.0
290405;201802;255;220;35;209880.0;33390.0;243270.0
290410;201802;561;477;84;452053.62;80136.0;532189.6
290420;201802;232;180;52;171720.0;49608.0;221328.0
290430;201802;500;311;189;296694.0;180306.0;477000.0
290440;201802;72;63;9;60102.0;7949.96;68051.96
290450;201802;231;177;54;168858.0;51516.0;220374.0
290460;201802;1870;1109;761;1056117.8;725517.5;1781635.4
290470;201802;1448;607;841;577949.25;801999.4;1379948.6
290475;201802;586;548;38;522077.0;36252.0;558329.0
290480;201802;290;163;127;155502.0;121158.0;276660.0
290485;201802;223;209;14;199386.0;13356.0;212742.0
290490;201802;1155;832;323;792964.8;307188.2;1100153.0
290500;201802;664;331;333;314820.0;317682.0;632502.0
290510;201802;219;166;53;157411.0;50562.0;207973.0
290515;201802;135;78;57;74412.0;54378.0;128790.0
290520;201802;1378;885;493;842668.6;467080.4;1309749.0
290530;201802;314;285;29;271890.0;27666.0;299556.0
290540;201802;94;57;37;54378.0;35298.0;89676.0
290550;201802;149;127;22;121158.0;20701.8;141859.8
290560;201802;3369;1362;2007;1298336.8;1914483.6;3212820.2
290570;201802;5834;3004;2830;2861204.8;2697005.0;5558210.0
290580;201802;1236;718;518;683731.8;493456.5;1177188.2
290590;201802;535;441;94;419923.0;89676.0;509599.0
290600;201802;1713;1186;527;1126614.1;502729.38;1629343.5
290610;201802;219;197;22;187481.0;20988.0;208469.0
290620;201802;323;285;38;271890.0;35896.15;307786.16
290630;201802;2108;892;1216;846397.6;1154442.1;2000839.8
290640;201802;151;123;28;117342.0;26712.0;144054.0
290650;201802;1703;805;898;767007.0;856692.0;1623699.0
290660;201802;279;226;53;215604.0;50562.0;266166.0
290670;201802;984;512;472;487876.0;449942.38;937818.4
290680;201802;1176;945;231;900576.0;219420.0;1119996.0
290682;201802;290;212;78;201261.3;74393.46;275654.75
290685;201802;228;145;83;137376.0;79182.0;216558.0
290687;201802;931;616;315;584277.6;299556.0;883833.6
290689;201802;128;75;53;71536.0;50547.69;122083.69
290690;201802;649;269;380;256597.92;361640.8;618238.75
290700;201802;241;114;127;108756.0;121158.0;229914.0
290710;201802;697;458;239;436912.9;228006.0;664918.94
290720;201802;1021;832;189;793728.0;179829.0;973557.0
290730;201802;1108;634;474;602976.5;451242.0;1054218.5
290740;201802;15;12;3;11448.0;2862.0;14310.0
290750;201802;1340;606;734;575550.9;698124.1;1273675.0
290755;201802;69;61;8;58194.0;7632.0;65826.0
290760;201802;297;258;39;246132.0;37206.0;283338.0
290770;201802;186;175;11;166940.45;10494.0;177434.45
290780;201802;972;779;193;741222.7;182309.4;923532.06
290790;201802;374;262;112;249369.0;106848.0;356217.0
290800;201802;2614;1050;1564;999530.06;1490949.4;2490479.5
290810;201802;435;301;134;286868.0;127836.0;414704.0
290820;201802;373;231;142;219406.0;135468.0;354874.0
290830;201802;396;268;128;255672.0;122112.0;377784.0
290840;201802;1676;1026;650;976372.8;618020.5;1594393.2
290850;201802;749;414;335;394765.2;318636.0;713401.2
290860;201802;649;289;360;275706.0;343154.0;618860.0
290870;201802;662;480;182;456699.8;173628.0;630327.8
290880;201802;125;67;58;63918.0;55332.0;119250.0
290890;201802;327;232;95;221328.0;90630.0;311958.0
290900;201802;169;128;41;122112.0;39114.0;161226.0
290910;201802;360;272;88;259488.0;83952.0;343440.0
290920;201802;230;195;35;186030.0;33390.0;219420.0
290930;201802;808;613;195;584802.0;186011.0;770813.0
290940;201802;251;205;46;194806.8;43884.0;238690.8
290950;201802;172;99;73;94446.0;69642.0;164088.0
290960;201802;439;293;146;278282.25;138997.8;417280.03
290970;201802;250;219;31;208735.2;29431.0;238166.2
290980;201802;1482;1049;433;996577.75;412033.2;1408611.0
290990;201802;370;313;57;298573.9;54322.38;352896.3
291000;201802;864;243;621;231822.0;591861.6;823683.6
291005;201802;2081;880;1201;837459.75;1144977.0;1982436.8
291010;201802;156;141;15;134514.0;14310.0;148824.0
291020;201802;102;80;22;76320.0;20988.0;97308.0
291030;201802;93;68;25;64872.0;23850.0;88722.0
291040;201802;580;288;292;274752.0;278568.0;553320.0
291050;201802;1334;753;581;716717.25;553987.8;1270705.0
291060;201802;1479;816;663;777796.2;632502.0;1410298.2
291070;201802;1882;1392;490;1321637.4;465436.3;1787073.8
291072;201802;7293;2677;4616;2550509.5;4401480.5;6951990.0
291075;201802;201;162;39;154548.0;37206.0;191754.0
291077;201802;48;32;16;30528.0;15264.0;45792.0
291080;201802;19380;8450;10930;8039660.0;1,04E+14;1,85E+14
291085;201802;290;230;60;219420.0;57235.23;276655.22
291090;201802;302;114;188;108470.0;179342.45;287812.47
291100;201802;682;197;485;187938.0;462690.0;650628.0
291110;201802;398;300;98;286180.9;93492.0;379672.9
291120;201802;2510;1180;1330;1125577.0;1266841.9;2392419.0
291125;201802;58;30;28;28620.0;26712.0;55332.0
291130;201802;212;185;27;176490.0;25758.0;202248.0
291140;201802;122;90;32;85860.0;30242.0;116102.0
291150;201802;377;148;229;141192.0;218466.0;359658.0
291160;201802;361;301;60;286200.5;57240.0;343440.5
291165;201802;23;19;4;18126.0;3816.0;21942.0
291170;201802;2872;1443;1429;1372854.1;1360213.6;2733067.8
291180;201802;1312;508;804;484435.38;766882.7;1251318.0
291185;201802;74;72;2;68688.0;1908.0;70596.0
291190;201802;1249;531;718;505041.44;684428.8;1189470.2
291200;201802;164;119;45;113526.0;42930.0;156456.0
291210;201802;2199;855;1344;813485.3;1280364.1;2093849.5
291220;201802;262;196;66;186030.64;62964.0;248994.64
291230;201802;1026;346;680;329226.0;648720.0;977946.0
291240;201802;438;416;22;395624.0;20988.0;416612.0
291250;201802;426;348;78;331992.0;74412.0;406404.0
291260;201802;40;30;10;28620.0;9540.0;38160.0
291270;201802;1200;486;714;463644.0;680631.8;1144275.8
291280;201802;374;169;205;161020.89;195274.27;356295.16
291290;201802;1753;882;871;839711.2;829886.0;1669597.2
291300;201802;222;175;47;166282.2;44838.0;211120.2
291310;201802;228;204;24;194329.8;22896.0;217225.8
291320;201802;1382;987;395;938736.0;375781.28;1314517.2
291330;201802;128;109;19;102173.9;18126.0;120299.9
291340;201802;142;81;61;77274.0;58194.0;135468.0
291345;201802;130;86;44;82044.0;41976.0;124020.0
291350;201802;1563;496;1067;472993.2;1017727.3;1490720.5
291360;201802;8572;4203;4369;3998373.8;4164932.5;8163306.5
291370;201802;1082;596;486;568298.0;463644.0;1031942.0
291380;201802;253;200;53;190800.0;50562.0;241362.0
291390;201802;3880;1675;2205;1593498.0;2101758.0;3695256.0
291400;201802;2079;1484;595;1410585.4;565947.5;1976532.9
291410;201802;152;133;19;125928.0;18126.0;144054.0
291420;201802;106;77;29;73458.0;27666.0;101124.0
291430;201802;171;95;76;89923.0;71550.53;161473.53
291440;201802;496;395;101;374106.3;96354.0;470460.3
291450;201802;893;556;337;528231.7;320544.0;848775.7
291460;201802;1715;1395;320;1328349.6;305280.0;1633629.6
291465;201802;2203;1020;1183;972234.06;1128300.1;2100534.2
291470;201802;2760;1395;1365;1327044.5;1301480.0;2628524.5
291480;201802;11838;5220;6618;4968830.5;6304624.5;1,13E+14
291490;201802;545;223;322;212742.0;307188.0;519930.0
291500;201802;372;202;170;192708.0;162180.0;354888.0
291510;201802;1232;465;767;442449.0;731431.8;1173880.8
291520;201802;960;436;524;415944.0;499886.47;915830.44
291530;201802;1010;272;738;259488.0;703746.75;963234.75
291535;201802;117;97;20;92538.0;19080.0;111618.0
291540;201802;361;108;253;103032.0;240408.6;343440.6
291550;201802;1176;550;626;523747.3;596613.8;1120361.1
291560;201802;5535;2823;2712;2680243.0;2574876.5;5255119.5
291570;201802;204;105;99;100170.0;94446.0;194616.0
291580;201802;1209;735;474;700423.44;452182.22;1152605.8
291590;201802;78;30;48;28476.9;45792.0;74268.9
291600;201802;1364;617;747;587664.0;712334.0;1299998.0
291610;201802;1401;639;762;608322.9;726892.0;1335214.9
291620;201802;577;266;311;253764.0;296312.4;550076.4
291630;201802;496;162;334;154548.0;318636.0;473184.0
291640;201802;3895;1955;1940;1858728.9;1849393.0;3708122.0
291650;201802;419;278;141;264077.75;133714.73;397792.47
291660;201802;444;176;268;167211.95;254574.9;421786.88
291670;201802;222;141;81;133942.0;77274.0;211216.0
291680;201802;701;400;301;381600.0;287049.47;668649.44
291685;201802;572;305;267;290732.0;254527.2;545259.2
291690;201802;557;287;270;273798.0;256617.0;530415.0
291700;201802;914;723;191;689012.2;181260.0;870272.2
291710;201802;1706;785;921;748194.25;877757.06;1625951.4
291720;201802;395;263;132;250897.23;125928.0;376825.22
291730;201802;928;537;391;510771.8;373004.47;883776.25
291733;201802;254;176;78;167617.8;74412.0;242029.8
291735;201802;65;49;16;46746.0;15264.0;62010.0
291740;201802;341;257;84;245178.0;80136.0;325314.0
291750;201802;1933;1289;644;1222422.8;613554.0;1835976.8
291760;201802;3073;1653;1420;1570322.5;1352295.0;2922617.5
291770;201802;806;542;264;514969.25;251856.0;766825.25
291780;201802;46;26;20;24804.0;19080.0;43884.0
291790;201802;164;77;87;73458.0;82998.0;156456.0
291800;201802;9928;3937;5991;3744822.5;5711218.0;9456040.0
291810;201802;1140;817;323;778841.0;308142.0;1086983.0
291820;201802;262;189;73;180306.0;69642.0;249948.0
291830;201802;1063;398;665;378471.0;633447.0;1011918.0
291835;201802;609;560;49;533763.0;46746.0;580509.0
291840;201802;4642;2384;2258;2269544.2;2153284.5;4422828.5
291845;201802;302;103;199;98262.0;189817.38;288079.38
291850;201802;323;281;42;267835.5;40068.0;307903.5
291855;201802;271;109;162;103986.0;154548.0;258534.0
291860;201802;175;110;65;103986.0;62010.0;165996.0
291870;201802;82;33;49;31482.0;46746.0;78228.0
291875;201802;186;168;18;160272.0;17172.0;177444.0
291880;201802;487;380;107;361710.0;102078.0;463788.0
291890;201802;243;79;164;75356.46;154739.0;230095.45
291900;201802;57;32;25;30528.0;23850.0;54378.0
291905;201802;138;95;43;90344.0;41022.0;131366.0
291910;201802;175;143;32;136422.0;30528.0;166950.0
291915;201802;389;346;43;328416.0;41022.0;369438.0
291920;201802;4918;2549;2369;2429057.5;2258355.2;4687413.0
291930;201802;181;105;76;100170.0;72504.0;172674.0
291940;201802;316;173;143;164345.58;135468.0;299813.6
291950;201802;1136;928;208;884549.0;198432.0;1082981.0
291955;201802;1006;595;411;567630.0;391665.0;959295.0
291960;201802;176;121;55;115434.0;52470.0;167904.0
291970;201802;779;589;190;561906.0;181260.0;743166.0
291980;201802;1498;1324;174;1259683.8;165042.4;1424726.1
291990;201802;123;114;9;108756.0;8586.0;117342.0
291992;201802;164;84;80;79372.8;76320.0;155692.8
291995;201802;150;106;44;101124.0;41976.0;143100.0
292000;201802;382;291;91;275133.8;86814.0;361947.8
292010;201802;280;200;80;190133.0;75366.0;265499.0
292020;201802;268;197;71;187938.0;67734.0;255672.0
292030;201802;138;108;30;103032.0;28620.0;131652.0
292040;201802;625;316;309;301464.0;294786.0;596250.0
292045;201802;91;82;9;78228.0;8586.0;86814.0
292050;201802;882;609;273;579976.9;260156.0;840132.9
292060;201802;942;772;170;734294.75;162180.0;896474.75
292070;201802;50;21;29;20034.0;27666.0;47700.0
292080;201802;114;79;35;75366.0;33390.0;108756.0
292090;201802;495;174;321;165805.2;306234.0;472039.2
292100;201802;1400;599;801;569872.7;764125.94;1333998.6
292105;201802;202;170;32;162180.0;30528.0;192708.0
292110;201802;2108;782;1326;745703.6;1262978.9;2008682.5
292120;201802;641;516;125;491131.78;119250.0;610381.8
292130;201802;446;264;182;251856.0;173628.0;425484.0
292140;201802;195;152;43;145008.0;40890.26;185898.27
292145;201802;157;84;73;80136.0;69613.38;149749.38
292150;201802;1413;1131;282;1078974.0;268000.16;1346974.1
292160;201802;179;147;32;139951.8;30528.0;170479.8
292170;201802;1218;1067;151;1016225.3;143996.77;1160222.1
292180;201802;198;139;59;132606.0;56286.0;188892.0
292190;201802;157;96;61;91584.0;58194.0;149778.0
292200;201802;1283;462;821;439605.72;782585.56;1222191.2
292205;201802;115;103;12;97975.8;11448.0;109423.8
292210;201802;366;254;112;240933.0;106132.5;347065.5
292220;201802;22;16;6;15264.0;5724.0;20988.0
292225;201802;38;35;3;33390.0;2862.0;36252.0
292230;201802;909;733;176;696393.0;167904.0;864297.0
292240;201802;622;444;178;422479.0;169812.0;592291.0
292250;201802;1679;1063;616;1014102.0;587664.0;1601766.0
292260;201802;437;245;192;233730.0;182404.8;416134.8
292265;201802;270;190;80;180973.8;76320.0;257293.8
292270;201802;771;334;437;318636.0;415944.8;734580.8
292273;201802;202;112;90;106070.49;85860.0;191930.48
292275;201802;162;78;84;74412.0;79849.8;154261.8
292280;201802;136;95;41;90630.0;39114.0;129744.0
292285;201802;59;50;9;47032.2;8586.0;55618.2
292290;201802;550;368;182;348582.47;173342.0;521924.47
292300;201802;1619;619;1000;589953.8;953166.56;1543120.4
292303;201802;97;66;31;62964.0;29574.0;92538.0
292305;201802;111;79;32;75366.0;30528.0;105894.0
292310;201802;799;499;300;475684.0;284902.16;760586.1
292320;201802;656;494;162;470989.8;154548.0;625537.8
292330;201802;189;98;91;93492.0;86814.0;180306.0
292335;201802;273;210;63;200340.0;60102.0;260442.0
292340;201802;570;395;175;376090.84;166950.0;543040.9
292350;201802;267;142;125;134657.1;118963.8;253620.9
292360;201802;700;529;171;502949.0;163134.0;666083.0
292370;201802;777;592;185;564768.0;176490.0;741258.0
292380;201802;642;496;146;471276.62;139284.0;610560.6
292390;201802;504;188;316;179352.0;299699.5;479051.5
292400;201802;3350;2053;1297;1940244.4;1233457.8;3173702.2
292405;201802;264;175;89;166473.0;84619.8;251092.8
292410;201802;152;90;62;85860.0;59148.0;145008.0
292420;201802;304;261;43;248707.8;41022.0;289729.8
292430;201802;518;404;114;385416.0;108279.0;493695.0
292440;201802;574;489;85;465285.0;80803.8;546088.8
292450;201802;245;189;56;180306.0;53424.0;233730.0
292460;201802;583;433;150;412509.8;143100.0;555609.8
292465;201802;195;161;34;153594.0;31698.09;185292.1
292467;201802;101;59;42;56286.0;40068.0;96354.0
292470;201802;251;169;82;161226.0;78228.0;239454.0
292480;201802;323;215;108;204156.5;102746.0;306902.5
292490;201802;219;143;76;136422.0;72504.0;208926.0
292500;201802;1167;504;663;480605.0;632044.25;1112649.2
292510;201802;3313;1486;1827;1416690.1;1740230.8;3156920.8
292520;201802;1054;501;553;476089.7;527553.0;1003642.7
292525;201802;386;275;111;262345.22;105894.0;368239.22
292530;201802;4215;1727;2488;1644724.2;2372086.0;4016810.2
292540;201802;482;261;221;248994.0;210834.0;459828.0
292550;201802;1058;568;490;541130.75;466955.72;1008086.44
292560;201802;318;299;19;285246.0;18126.0;303372.0
292570;201802;301;229;72;218137.0;68688.0;286825.0
292575;201802;459;294;165;280190.0;157410.0;437600.0
292580;201802;905;572;333;544257.0;317396.0;861653.0
292590;201802;507;436;71;415641.6;67734.0;483375.6
292593;201802;143;112;31;106848.0;29574.0;136422.0
292595;201802;180;137;43;130698.0;41022.0;171720.0
292600;201802;1239;924;315;881179.0;299842.2;1181021.2
292610;201802;126;96;30;91584.0;28362.42;119946.42
292620;201802;519;430;89;409925.0;84906.0;494831.0
292630;201802;1358;787;571;749210.0;543112.7;1292322.6
292640;201802;764;534;230;509102.1;219420.0;728522.1
292650;201802;173;148;25;140756.0;23850.0;164606.0
292660;201802;1991;1433;558;1361258.9;528134.8;1889393.6
292665;201802;139;102;37;97308.0;35298.0;132606.0
292670;201802;399;322;77;307184.0;73458.0;380642.0
292680;201802;247;191;56;182214.0;52947.0;235161.0
292690;201802;179;136;43;129744.0;41022.0;170766.0
292700;201802;910;598;312;569538.8;297648.0;867186.8
292710;201802;97;85;12;81090.0;11448.0;92538.0
292720;201802;830;467;363;444716.62;346112.0;790828.6
292730;201802;201;95;106;89676.5;101124.0;190800.5
292740;201802;65957;32647;33310;3,11E+14;3,17E+14;6,28E+14
292750;201802;368;262;106;248994.94;100313.57;349308.5
292760;201802;318;257;61;244167.5;58194.0;302361.5
292770;201802;783;334;449;318350.0;428346.0;746696.0
292780;201802;420;159;261;151458.48;248994.0;400452.47
292790;201802;730;354;376;337716.0;358465.5;696181.5
292800;201802;1136;697;439;663984.0;418806.0;1082790.0
292805;201802;423;124;299;117771.3;285246.0;403017.3
292810;201802;1464;849;615;809087.8;586414.44;1395502.2
292820;201802;744;599;145;569538.9;138034.8;707573.7
292830;201802;102;81;21;77274.0;20034.0;97308.0
292840;201802;654;538;116;512775.0;110649.69;623424.7
292850;201802;131;89;42;84902.0;40068.0;124970.0
292860;201802;2127;1242;885;1180797.0;844290.0;2025087.0
292870;201802;3373;2259;1114;2153823.8;1062736.9;3216560.8
292880;201802;1433;943;490;895855.9;466220.62;1362076.5
292890;201802;480;411;69;392066.0;65826.0;457892.0
292895;201802;133;89;44;83547.5;41976.0;125523.5
292900;201802;387;286;101;272844.0;96354.0;369198.0
292905;201802;446;228;218;217512.0;207782.0;425294.0
292910;201802;396;303;93;288729.0;88722.0;377451.0
292920;201802;536;234;302;223236.0;288108.0;511344.0
292925;201802;509;473;36;450564.66;34325.0;484889.66
292930;201802;557;344;213;328176.0;203202.0;531378.0
292935;201802;293;125;168;119250.0;160272.0;279522.0
292937;201802;235;161;74;153594.0;70596.0;224190.0
292940;201802;189;143;46;136422.0;43884.0;180306.0
292950;201802;1096;568;528;539726.5;502759.0;1042485.5
292960;201802;543;360;183;343440.0;174582.0;518022.0
292970;201802;272;189;83;179639.0;79182.0;258821.0
292975;201802;155;89;66;84906.0;62774.0;147680.0
292980;201802;258;174;84;164212.44;80136.0;244348.44
292990;201802;1306;964;342;912319.9;325794.94;1238114.8
293000;201802;103;75;28;71550.0;26712.0;98262.0
293010;201802;2647;1627;1020;1546396.9;969043.0;2515440.0
293015;201802;646;510;136;486322.5;129105.0;615427.5
293020;201802;329;270;59;257580.0;56286.0;313866.0
293030;201802;621;540;81;513634.44;77274.0;590908.44
293040;201802;338;265;73;252810.0;69642.0;322452.0
293050;201802;2704;1579;1125;1496858.9;1070007.6;2566866.5
293060;201802;253;203;50;192475.0;46746.8;239221.8
293070;201802;3368;1703;1665;1616809.6;1587189.9;3203999.5
293075;201802;90;58;32;55332.0;30528.0;85860.0
293076;201802;72;46;26;43884.0;24804.0;68688.0
293077;201802;429;262;167;245433.47;159318.0;404751.47
293080;201802;446;396;50;377784.0;47700.0;425484.0
293090;201802;129;111;18;105894.0;16854.04;122748.04
293100;201802;517;365;152;348210.0;145008.0;493218.0
293105;201802;340;231;109;220088.0;103986.0;324074.0
293110;201802;168;119;49;113526.0;46746.0;160272.0
293120;201802;319;215;104;205110.0;99025.2;304135.2
293130;201802;245;164;81;156456.0;77274.0;233730.0
293135;201802;7900;3118;4782;2969084.2;4553345.0;7522429.0
293140;201802;179;115;64;109710.0;60293.0;170003.0
293150;201802;328;278;50;263781.2;47700.0;311481.2
293160;201802;432;245;187;233730.0;178398.0;412128.0
293170;201802;189;131;58;124688.0;54474.0;179162.0
293180;201802;464;316;148;301178.0;141192.0;442370.0
293190;201802;1273;882;391;836778.75;373014.0;1209792.8
293200;201802;523;462;61;439668.0;58194.0;497862.0
293210;201802;337;245;92;233578.0;87052.5;320630.5
293220;201802;2684;1075;1609;1023616.44;1532792.5;2556409.0
293230;201802;1768;640;1128;609129.8;1075826.0;1684955.8
293240;201802;220;201;19;191754.0;18126.0;209880.0
293245;201802;110;93;17;88722.0;16218.0;104940.0
293250;201802;734;272;462;259240.0;440748.0;699988.0
293260;201802;312;261;51;248040.17;48654.0;296694.16
293270;201802;1178;558;620;530424.7;591480.0;1121904.6
293280;201802;236;131;105;124974.0;100170.0;225144.0
293290;201802;3078;2007;1071;1912526.8;1021435.0;2933961.8
293300;201802;696;493;203;467989.5;191181.6;659171.1
293305;201802;153;131;22;124974.0;20988.0;145962.0
293310;201802;137;103;34;98262.0;32436.0;130698.0
293315;201802;156;120;36;114480.0;34344.0;148824.0
293317;201802;95;66;29;62964.0;27666.0;90630.0
293320;201802;960;552;408;525654.5;389232.0;914886.5
293325;201802;183;65;118;62010.0;112533.84;174543.84
293330;201802;12835;5981;6854;5694957.5;6530883.5;1,22E+14
293340;201802;252;182;70;173628.0;65826.0;239454.0
293345;201802;244;193;51;184122.0;48654.0;232776.0
293350;201802;623;329;294;313866.0;278997.3;592863.3
293360;201802;1574;1122;452;1069148.0;429968.7;1499116.8
310010;201802;153;77;76;73458.0;72218.0;145676.0
310020;201802;1055;575;480;546165.2;456012.12;1002177.3
310030;201802;323;261;62;247868.88;58861.8;306730.7
310040;201802;50;31;19;29574.0;18126.0;47700.0
310050;201802;183;119;64;112572.4;60770.0;173342.4
310060;201802;233;162;71;154071.0;67734.0;221805.0
310070;201802;16;8;8;7632.0;7632.0;15264.0
310080;201802;51;28;23;26712.0;21942.0;48654.0
310090;201802;952;500;452;471754.7;430063.6;901818.25
310100;201802;296;222;74;211788.0;70596.0;282384.0
310110;201802;735;392;343;372933.1;326268.0;699201.1
310120;201802;387;215;172;204442.2;163713.94;368156.12
310130;201802;33;20;13;19080.0;12402.0;31482.0
310140;201802;28;16;12;15264.0;11448.0;26712.0
310150;201802;1284;882;402;835658.6;382935.8;1218594.4
310160;201802;2103;1064;1039;1006949.5;988821.4;1995770.9
310163;201802;92;51;41;48654.0;39114.0;87768.0
310170;201802;2549;1044;1505;995852.0;1433194.6;2429046.5
310180;201802;130;49;81;46746.0;76892.4;123638.4
310190;201802;489;327;162;311958.0;153975.6;465933.6
310200;201802;503;317;186;302418.0;177444.0;479862.0
310205;201802;58;44;14;41976.0;13356.0;55332.0
310210;201802;278;225;53;214650.0;50562.0;265212.0
310220;201802;53;32;21;30528.0;20034.0;50562.0
310230;201802;262;184;78;175345.2;74412.0;249757.2
310240;201802;105;92;13;87529.5;12402.0;99931.5
310250;201802;99;80;19;76320.0;18126.0;94446.0
310260;201802;800;429;371;406310.25;353199.4;759509.7
310270;201802;268;178;90;169259.0;85860.0;255119.0
310280;201802;368;274;94;260442.8;89676.0;350118.8
310285;201802;221;157;64;149469.86;61056.0;210525.86
310290;201802;255;147;108;140238.0;103032.0;243270.0
310300;201802;155;128;27;122112.0;25758.0;147870.0
310310;201802;7;5;2;4770.0;1908.0;6678.0
310320;201802;23;14;9;13356.0;8586.0;21942.0
310330;201802;30;22;8;20988.0;7632.0;28620.0
310340;201802;1693;1094;599;1036569.9;569920.5;1606490.4
310350;201802;2816;1519;1297;1444304.0;1236756.8;2681060.8
310360;201802;41;33;8;31482.0;7632.0;39114.0
310370;201802;124;102;22;97308.0;20702.0;118010.0
310375;201802;104;37;67;35298.0;63899.0;99197.0
310380;201802;53;31;22;28668.0;20988.0;49656.0
310390;201802;101;71;30;67734.0;28620.0;96354.0
310400;201802;2307;1485;822;1412780.0;783901.8;2196681.8
310410;201802;128;70;58;66780.0;55332.0;122112.0
310420;201802;670;361;309;342104.1;293823.06;635927.2
310430;201802;330;217;113;206731.8;107802.0;314533.8
310440;201802;67;41;26;39114.0;24804.0;63918.0
310445;201802;86;68;18;64872.0;17172.0;82044.0
310450;201802;856;538;318;512584.2;303372.0;815956.2
310460;201802;265;192;73;183168.0;69642.0;252810.0
310470;201802;492;310;182;295740.0;173628.0;469368.0
310480;201802;77;54;23;51516.0;21942.0;73458.0
310490;201802;494;230;264;218466.2;251856.0;470322.2
310500;201802;125;54;71;51516.0;67734.0;119250.0
310510;201802;607;394;213;374636.6;203183.45;577820.06
310520;201802;128;85;43;81090.0;41022.0;122112.0
310530;201802;87;40;47;38160.0;44551.8;82711.8
310540;201802;454;280;174;264736.6;165996.0;430732.6
310550;201802;86;56;30;53424.0;28620.0;82044.0
310560;201802;2917;2008;909;1905150.8;865607.1;2770758.0
310570;201802;133;90;43;85860.0;41022.0;126882.0
310590;201802;343;224;119;212313.8;113511.69;325825.5
310600;201802;158;90;68;84095.7;64872.0;148967.7
310610;201802;59;21;38;20034.0;36252.0;56286.0
310620;201802;45581;21803;23778;2,07E+13;2,26E+14;4,34E+14
310630;201802;589;376;213;355985.6;201708.88;557694.5
310640;201802;135;114;21;108565.2;20034.0;128599.2
310650;201802;160;140;20;132320.0;19080.0;151400.0
310660;201802;90;57;33;54378.0;31482.0;85860.0
310665;201802;55;40;15;38160.0;14310.0;52470.0
310670;201802;6317;2920;3397;2777791.2;3235674.0;6013465.5
310680;201802;55;36;19;34344.0;18126.0;52470.0
310690;201802;597;435;162;410784.16;154548.0;565332.2
310700;201802;63;40;23;38160.0;21798.9;59958.9
310710;201802;1240;823;417;783888.25;397245.8;1181134.0
310720;201802;84;28;56;26712.0;53424.0;80136.0
310730;201802;1374;953;421;907636.5;401634.0;1309270.5
310740;201802;1005;562;443;533000.4;422374.47;955374.9
310750;201802;244;142;102;134514.19;97308.0;231822.19
310760;201802;69;53;16;50562.0;15264.0;65826.0
310770;201802;93;45;48;42930.0;45792.0;88722.0
310780;201802;401;328;73;312072.44;69642.0;381714.44
310790;201802;100;81;19;77274.0;18126.0;95400.0
310800;201802;454;221;233;210357.0;221995.8;432352.8
310810;201802;167;116;51;109605.2;47700.0;157305.2
310820;201802;354;281;73;268074.0;69355.8;337429.8
310825;201802;191;157;34;149778.0;32436.0;182214.0
310830;201802;461;222;239;211127.94;228006.0;439133.94
310840;201802;385;219;166;208926.0;158364.0;367290.0
310850;201802;109;88;21;83952.0;20034.0;103986.0
310855;201802;375;296;79;282384.0;75366.0;357750.0
310860;201802;1400;1045;355;991542.1;336934.9;1328477.0
310870;201802;53;41;12;39114.0;11448.0;50562.0
310880;201802;83;65;18;61723.8;17172.0;78895.8
310890;201802;312;183;129;174582.0;123066.0;297648.0
310900;201802;637;294;343;277552.06;326916.8;604468.9
310910;201802;250;171;79;161799.2;75366.0;237165.2
310920;201802;486;290;196;272845.2;186030.4;458875.6
310925;201802;38;31;7;29574.0;6392.0;35966.0
310930;201802;1095;660;435;629237.3;414895.06;1044132.4
310940;201802;681;348;333;331391.8;317682.0;649073.8
310945;201802;118;73;45;69642.0;42930.0;112572.0
310950;201802;249;195;54;186030.0;51516.0;237546.0
310960;201802;84;31;53;29574.0;50558.0;80132.0
310970;201802;170;106;64;101124.0;60133.76;161257.77
310980;201802;46;24;22;22896.0;20988.0;43884.0
310990;201802;149;83;66;78896.0;62964.0;141860.0
311000;201802;835;419;416;396197.7;396855.0;793052.7
311010;201802;40;33;7;31482.0;6678.0;38160.0
311020;201802;41;26;15;24804.0;14310.0;39114.0
311030;201802;393;232;161;219134.0;153594.0;372728.0
311040;201802;38;33;5;31482.0;4770.0;36252.0
311050;201802;466;195;271;185458.0;257961.6;443419.6
311060;201802;752;431;321;409743.4;305948.0;715691.4
311070;201802;330;149;181;142146.0;172674.0;314820.0
311080;201802;105;57;48;54378.0;45792.0;100170.0
311090;201802;397;186;211;176204.0;201294.0;377498.0
311100;201802;614;365;249;347923.8;237259.8;585183.6
311110;201802;680;467;213;445231.8;203193.0;648424.8
311115;201802;68;49;19;46746.0;18126.0;64872.0
311120;201802;1035;540;495;513920.8;471609.9;985530.7
311130;201802;407;235;172;223999.2;164088.0;388087.2
311140;201802;161;79;82;75366.0;77417.1;152783.1
311150;201802;355;234;121;223236.0;115195.5;338431.5
311160;201802;744;533;211;506097.4;200817.0;706914.4
311170;201802;79;58;21;55332.0;19747.8;75079.8
311180;201802;342;228;114;217225.8;108470.0;325695.8
311190;201802;34;17;17;16218.0;16218.0;32436.0
311200;201802;337;235;102;222568.6;97308.0;319876.6
311205;201802;29;19;10;18126.0;9158.4;27284.4
311210;201802;50;41;9;38828.0;8586.0;47414.0
311220;201802;16;14;2;13356.0;1908.0;15264.0
311230;201802;1631;1055;576;1002103.94;549504.0;1551608.0
311240;201802;169;107;62;101874.33;59148.0;161022.33
311250;201802;74;31;43;29574.0;41022.0;70596.0
311260;201802;555;350;205;333900.0;195570.0;529470.0
311265;201802;112;77;35;73458.0;33390.0;106848.0
311270;201802;282;203;79;193662.0;75366.0;269028.0
311280;201802;212;96;116;91584.0;110091.6;201675.6
311290;201802;110;88;22;83952.0;20416.0;104368.0
311300;201802;544;342;202;325314.97;192422.0;517736.97
311310;201802;23;18;5;17172.0;4770.0;21942.0
311320;201802;674;506;168;481770.0;160272.0;642042.0
311330;201802;1035;760;275;724801.5;261396.4;986197.9
311340;201802;2618;1861;757;1767964.6;721768.9;2489733.5
311350;201802;274;210;64;200340.0;61056.0;261396.0
311360;201802;177;106;71;101124.0;67734.0;168858.0
311370;201802;1198;484;714;459742.5;680583.6;1140326.1
311380;201802;7;6;1;5724.0;954.0;6678.0
311390;201802;281;148;133;141192.0;126405.2;267597.2
311400;201802;151;99;52;94446.0;49599.0;144045.0
311410;201802;97;54;43;51516.0;41022.0;92538.0
311420;201802;296;161;135;152584.98;128790.0;281374.97
311430;201802;849;550;299;523652.0;285246.0;808898.0
311440;201802;488;339;149;323406.0;141859.8;465265.8
311450;201802;319;199;120;189846.0;114480.0;304326.0
311455;201802;300;201;99;191458.8;94159.8;285618.6
311460;201802;129;51;78;48654.0;73606.27;122260.27
311470;201802;21;11;10;10494.0;9540.0;20034.0
311480;201802;25;10;15;9540.0;14310.0;23850.0
311490;201802;17;11;6;10494.0;5724.0;16218.0
311500;201802;19;10;9;9540.0;8586.0;18126.0
311510;201802;620;438;182;415909.7;173341.8;589251.5
311520;201802;47;34;13;31768.2;12402.0;44170.2
311530;201802;1806;1348;458;1276549.8;436932.0;1713481.8
311535;201802;67;51;16;48654.0;15264.0;63918.0
311540;201802;33;29;4;27666.0;3816.0;31482.0
311545;201802;185;138;47;131652.0;44838.0;176490.0
311547;201802;30;21;9;20034.0;8586.0;28620.0
311550;201802;618;283;335;269982.0;319571.47;589553.44
311560;201802;43;28;15;26712.0;14310.0;41022.0
311570;201802;302;201;101;191181.6;96354.0;287535.6
311580;201802;306;179;127;170479.8;121158.0;291637.8
311590;201802;32;28;4;26712.0;3816.0;30528.0
311600;201802;91;72;19;68688.0;18126.0;86814.0
311610;201802;257;223;34;211788.5;32436.0;244224.5
311615;201802;97;80;17;75680.82;16218.0;91898.82
311620;201802;19;11;8;10494.0;7632.0;18126.0
311630;201802;84;71;13;67734.0;12402.0;80136.0
311640;201802;118;65;53;62010.0;50562.0;112572.0
311650;201802;129;95;34;89914.5;32436.0;122350.5
311660;201802;406;194;212;185076.0;202248.0;387324.0
311670;201802;165;106;59;100879.0;56286.0;157165.0
311680;201802;223;162;61;153646.95;57430.8;211077.75
311690;201802;18;11;7;10494.0;6678.0;17172.0
311700;201802;199;138;61;131365.8;58194.0;189559.8
311710;201802;215;138;77;131652.0;73458.0;205110.0
311720;201802;39;28;11;26712.0;10494.0;37206.0
311730;201802;551;364;187;346684.0;178398.0;525082.0
311740;201802;38;27;11;25758.0;10494.0;36252.0
311750;201802;706;482;224;457920.8;213696.0;671616.8
311760;201802;65;36;29;34344.0;27666.0;62010.0
311770;201802;403;192;211;181260.62;201294.0;382554.62
311780;201802;169;96;73;91298.0;69325.0;160623.0
311783;201802;79;70;9;66780.0;8586.0;75366.0
311787;201802;35;15;20;14310.0;19080.0;33390.0
311790;201802;262;125;137;119250.0;130698.0;249948.0
311800;201802;641;438;203;414466.3;192994.2;607460.5
311810;201802;43;35;8;33390.0;7632.0;41022.0
311820;201802;107;89;18;84906.0;17172.0;102078.0
311830;201802;1877;1194;683;1133468.5;648243.8;1781712.2
311840;201802;1009;559;450;528994.9;427831.53;956826.44
311850;201802;8;5;3;4770.0;2862.0;7632.0
311860;201802;9488;4335;5153;4119019.8;4907454.5;9026474.0
311870;201802;149;83;66;79182.0;62964.0;142146.0
311880;201802;947;706;241;671988.8;229914.0;901902.8
311890;201802;218;111;107;105894.0;102078.0;207972.0
311900;201802;90;37;53;35298.0;50562.0;85860.0
311910;201802;1379;854;525;812761.1;498751.4;1311512.5
311920;201802;228;150;78;142862.0;74412.0;217274.0
311930;201802;908;524;384;499610.0;366098.0;865708.0
311940;201802;2436;1258;1178;1197795.8;1120568.4;2318364.0
311950;201802;32;22;10;20988.0;9540.0;30528.0
311960;201802;65;46;19;43884.0;18126.0;62010.0
311970;201802;27;17;10;13928.4;9540.0;23468.4
311980;201802;41;31;10;29574.0;9540.0;39114.0
311990;201802;59;42;17;40068.0;16218.0;56286.0
311995;201802;62;43;19;41022.0;18126.0;59148.0
312000;201802;33;23;10;21655.8;9540.0;31195.8
312010;201802;84;61;23;58194.0;21942.0;80136.0
312015;201802;96;71;25;67448.0;23850.0;91298.0
312020;201802;135;83;52;79182.0;49321.8;128503.8
312030;201802;42;34;8;31483.0;7632.0;39115.0
312040;201802;79;50;29;47700.0;27666.0;75366.0
312050;201802;223;116;107;110664.0;102078.0;212742.0
312060;201802;66;41;25;39114.0;23182.2;62296.2
312070;201802;73;44;29;41976.0;27666.0;69642.0
312080;201802;525;231;294;220374.0;280476.0;500850.0
312083;201802;48;35;13;33390.0;12402.0;45792.0
312087;201802;108;86;22;82044.0;20988.0;103032.0
312090;201802;2864;1635;1229;1544552.2;1169003.4;2713555.8
312100;201802;161;114;47;108756.0;44056.0;152812.0
312110;201802;116;73;43;69642.0;41022.0;110664.0
312120;201802;139;103;36;98262.0;34344.0;132606.0
312125;201802;94;54;40;51325.2;38160.0;89485.2
312130;201802;122;81;41;77274.0;39114.0;116388.0
312140;201802;133;106;27;101124.0;25758.0;126882.0
312150;201802;44;36;8;34344.0;7632.0;41976.0
312160;201802;1527;1016;511;966593.2;486082.47;1452675.6
312170;201802;11;9;2;8586.0;1908.0;10494.0
312180;201802;100;60;40;56525.0;37874.0;94399.0
312190;201802;32;28;4;26712.0;3816.0;30528.0
312200;201802;731;632;99;600972.7;94446.0;695418.7
312210;201802;97;62;35;59148.0;33390.0;92538.0
312220;201802;122;89;33;84668.0;31482.0;116150.0
312230;201802;3467;1697;1770;1615152.1;1686972.1;3302124.2
312235;201802;142;93;49;88722.0;46746.0;135468.0
312240;201802;109;71;38;67734.0;36252.0;103986.0
312245;201802;162;108;54;103028.0;51516.0;154544.0
312247;201802;58;41;17;38351.0;16218.0;54569.0
312250;201802;183;85;98;80613.0;93492.0;174105.0
312260;201802;103;68;35;64014.2;33390.0;97404.2
312270;201802;136;85;51;81090.0;48654.0;129744.0
312280;201802;25;15;10;14310.0;9540.0;23850.0
312290;201802;162;111;51;105607.8;47701.0;153308.8
312300;201802;203;135;68;128790.0;64872.0;193662.0
312310;201802;58;53;5;50562.0;4770.0;55332.0
312320;201802;416;261;155;247086.0;146582.5;393668.5
312330;201802;85;74;11;69833.0;10207.8;80040.8
312340;201802;35;16;19;15264.0;18126.0;33390.0
312350;201802;16;10;6;9540.0;5724.0;15264.0
312352;201802;97;66;31;62964.0;29574.0;92538.0
312360;201802;561;253;308;240408.0;293832.0;534240.0
312370;201802;296;176;120;167617.8;114480.0;282097.8
312380;201802;137;87;50;82998.0;47700.0;130698.0
312385;201802;177;144;33;137376.0;31482.0;168858.0
312390;201802;301;189;112;180306.0;106181.0;286487.0
312400;201802;382;289;93;275706.0;88246.0;363952.0
312410;201802;859;276;583;262827.0;555606.0;818433.0
312420;201802;609;487;122;463930.2;116388.0;580318.2
312430;201802;858;631;227;599353.06;215604.2;814957.25
312440;201802;45;34;11;32436.0;10494.0;42930.0
312450;201802;210;128;82;122112.0;78228.0;200340.0
312460;201802;58;29;29;27666.0;27666.0;55332.0
312470;201802;54;35;19;33390.0;18126.0;51516.0
312480;201802;211;130;81;124020.0;77274.0;201294.0
312490;201802;257;176;81;167904.0;77274.0;245178.0
312500;201802;32;18;14;17172.0;13356.0;30528.0
312510;201802;425;158;267;150732.0;254102.39;404834.38
312520;201802;39;14;25;13356.0;23850.0;37206.0
312530;201802;49;37;12;35298.0;11448.0;46746.0
312540;201802;100;87;13;82998.0;12402.0;95400.0
312550;201802;41;32;9;30528.0;8586.0;39114.0
312560;201802;197;143;54;136136.0;51229.8;187365.8
312570;201802;441;267;174;254050.2;165304.45;419354.66
312580;201802;84;44;40;41976.0;38160.0;80136.0
312590;201802;274;215;59;204729.0;56286.0;261015.0
312595;201802;144;129;15;123066.0;14310.0;137376.0
312600;201802;75;46;29;43455.0;27666.0;71121.0
312610;201802;1624;853;771;804989.0;733817.6;1538806.6
312620;201802;188;132;56;125928.0;53419.23;179347.23
312630;201802;64;55;9;52470.0;8586.0;61056.0
312640;201802;47;13;34;12402.0;32436.0;44838.0
312650;201802;147;120;27;114194.0;25472.0;139666.0
312660;201802;70;53;17;50276.0;16218.0;66494.0
312670;201802;862;567;295;539344.9;281216.3;820561.2
312675;201802;42;31;11;29574.0;10494.0;40068.0
312680;201802;85;59;26;55904.4;24804.0;80708.4
312690;201802;240;129;111;123056.46;105607.8;228664.27
312695;201802;30;23;7;21942.0;6678.0;28620.0
312700;201802;208;123;85;117342.0;81090.0;198432.0
312705;201802;75;62;13;59148.0;12402.0;71550.0
312707;201802;94;70;24;66360.44;22896.0;89256.44
312710;201802;1859;991;868;943067.4;827861.0;1770928.4
312720;201802;66;33;33;31482.0;31482.0;62964.0
312730;201802;288;170;118;161226.0;112285.8;273511.8
312733;201802;51;44;7;41690.0;6678.0;48368.0
312735;201802;22;16;6;15264.0;5724.0;20988.0
312737;201802;67;36;31;34344.0;29574.0;63918.0
312738;201802;52;37;15;35298.0;14310.0;49608.0
312740;201802;72;49;23;46746.0;21942.0;68688.0
312750;201802;71;51;20;48654.0;19080.0;67734.0
312760;201802;267;195;72;186030.0;68688.0;254718.0
312770;201802;7650;3540;4110;3354978.0;3912276.8;7267255.0
312780;201802;435;335;100;319303.8;95400.0;414703.8
312790;201802;20;15;5;14310.0;4770.0;19080.0
312800;201802;1591;1121;470;1062013.2;447197.62;1509210.9
312810;201802;372;239;133;227719.8;126882.0;354601.8
312820;201802;195;147;48;140238.0;45792.0;186030.0
312825;201802;26;18;8;17172.0;7632.0;24804.0
312830;201802;282;164;118;155217.0;111933.0;267150.0
312840;201802;149;110;39;104940.0;37206.0;142146.0
312850;201802;25;22;3;20988.0;2862.0;23850.0
312860;201802;170;105;65;99884.0;62010.0;161894.0
312870;201802;984;514;470;487557.62;448380.0;935937.6
312880;201802;149;103;46;98118.9;43788.6;141907.5
312890;201802;163;113;50;107802.0;47700.0;155502.0
312900;201802;211;156;55;148156.2;52470.0;200626.2
312910;201802;184;92;92;86599.72;87768.0;174367.72
312920;201802;155;86;69;82044.0;65826.0;147870.0
312930;201802;340;246;94;234684.0;89676.0;324360.0
312940;201802;104;70;34;66780.0;32436.0;99216.0
312950;201802;702;463;239;440366.6;228006.0;668372.6
312960;201802;174;131;43;124974.0;41022.0;165996.0
312965;201802;51;46;5;43884.0;4770.0;48654.0
312970;201802;284;229;55;217512.2;52470.0;269982.2
312980;201802;2312;1238;1074;1176084.2;1024019.6;2200103.8
312990;201802;50;29;21;27666.0;20034.0;47700.0
313000;201802;39;25;14;23850.0;13356.0;37206.0
313005;201802;168;129;39;122074.5;36920.0;158994.5
313010;201802;938;389;549;369865.8;523450.8;893316.6
313020;201802;188;99;89;93969.0;84906.0;178875.0
313030;201802;209;134;75;125929.0;71550.0;197479.0
313040;201802;60;22;38;20988.0;36252.0;57240.0
313050;201802;295;206;89;195570.2;84906.0;280476.2
313055;201802;47;34;13;32436.0;12402.0;44838.0
313060;201802;129;86;43;82044.0;40735.8;122779.8
313065;201802;59;39;20;37206.0;19080.0;56286.0
313070;201802;153;84;69;80136.0;65826.0;145962.0
313080;201802;42;18;24;17172.0;22896.0;40068.0
313090;201802;705;486;219;462356.3;208926.0;671282.3
313100;201802;166;65;101;62010.0;96346.0;158356.0
313110;201802;126;74;52;70596.0;49608.0;120204.0
313115;201802;157;87;70;82797.66;66780.0;149577.66
313120;201802;755;412;343;392762.0;325775.12;718537.1
313130;201802;5230;2815;2415;2659725.5;2294438.5;4954164.0
313140;201802;160;84;76;80136.0;72504.0;152640.0
313150;201802;315;251;64;239454.0;60769.8;300223.8
313160;201802;193;139;54;132606.0;51516.0;184122.0
313170;201802;1334;939;395;883644.7;376439.4;1260084.1
313180;201802;328;195;133;185381.28;126882.0;312263.28
313190;201802;723;428;295;405545.4;280667.0;686212.4
313200;201802;23;22;1;20988.0;954.0;21942.0
313210;201802;1036;871;165;827931.2;157405.23;985336.4
313220;201802;233;159;74;150732.0;69880.5;220612.5
313230;201802;270;199;71;188893.0;67734.0;256627.0
313240;201802;1916;1025;891;974797.94;846807.8;1821605.8
313250;201802;1247;922;325;873675.6;308143.8;1181819.4
313260;201802;92;54;38;51516.0;36252.0;87768.0
313270;201802;955;560;395;530185.3;376830.0;907015.3
313280;201802;61;52;9;49131.0;8586.0;57717.0
313290;201802;224;181;43;172388.0;40068.8;212456.8
313300;201802;369;184;185;173628.8;176490.0;350118.8
313310;201802;226;118;108;112572.0;103032.0;215604.0
313320;201802;367;284;83;268981.1;79182.0;348163.1
313330;201802;1360;816;544;777033.2;517784.5;1294817.8
313340;201802;335;229;106;218466.0;101124.0;319590.0
313350;201802;523;351;172;332946.1;164088.0;497034.1
313360;201802;114;68;46;64872.0;43598.0;108470.0
313370;201802;188;71;117;67734.0;111618.0;179352.0
313375;201802;273;162;111;154548.0;105894.0;260442.0
313380;201802;1286;655;631;622981.06;601684.0;1224665.1
313390;201802;48;40;8;37206.8;7632.0;44838.8
313400;201802;418;271;147;258534.0;139952.0;398486.0
313410;201802;21;12;9;11448.0;8586.0;20034.0
313420;201802;4676;2412;2264;2291483.0;2152884.0;4444367.0
313430;201802;134;62;72;59148.0;68688.0;127836.0
313440;201802;1456;978;478;930771.1;454868.0;1385639.1
313450;201802;61;25;36;23850.0;34057.8;57907.8
313460;201802;374;176;198;166464.0;188892.0;355356.0
313470;201802;536;245;291;233730.0;276946.2;510676.2
313480;201802;160;108;52;102079.0;49608.0;151687.0
313490;201802;512;250;262;238500.0;249901.0;488401.0
313500;201802;20;12;8;11448.0;7632.0;19080.0
313505;201802;959;745;214;709840.0;203870.0;913710.0
313507;201802;92;54;38;51516.0;36252.0;87768.0
313510;201802;2765;1774;991;1686345.8;944460.0;2630805.8
313520;201802;3589;2801;788;2659610.8;751748.0;3411358.8
313530;201802;42;29;13;27666.0;12402.0;40068.0
313535;201802;105;84;21;79469.0;20034.0;99503.0
313540;201802;70;53;17;50562.0;16218.0;66780.0
313545;201802;110;90;20;85860.0;19080.0;104940.0
313550;201802;233;190;43;181260.0;40736.0;221996.0
313560;201802;330;172;158;164088.0;150732.0;314820.0
313570;201802;59;31;28;29574.0;26712.0;56286.0
313580;201802;1294;700;594;665415.0;564959.4;1230374.4
313590;201802;81;48;33;45792.0;31482.0;77274.0
313600;201802;688;409;279;389900.0;265308.0;655208.0
313610;201802;56;44;12;41356.8;11448.0;52804.8
313620;201802;1345;710;635;667448.94;601907.0;1269355.9
313630;201802;1636;1256;380;1196698.0;362234.0;1558932.0
313640;201802;126;72;54;68688.0;51516.0;120204.0
313650;201802;233;108;125;103032.0;119250.0;222282.0
313652;201802;16;15;1;14310.0;954.0;15264.0
313655;201802;55;31;24;29574.0;22896.0;52470.0
313657;201802;46;42;4;40068.0;3816.0;43884.0
313660;201802;132;93;39;88722.0;37206.0;125928.0
313665;201802;637;313;324;298602.0;308857.5;607459.5
313670;201802;10224;7083;3141;6733167.5;2995655.8;9728823.0
313680;201802;41;30;11;28620.0;10494.0;39114.0
313690;201802;155;119;36;113526.0;34344.0;147870.0
313695;201802;67;50;17;47700.0;16218.0;63918.0
313700;201802;291;233;58;221996.0;55332.0;277328.0
313710;201802;151;102;49;97308.0;46746.0;144054.0
313720;201802;1057;502;555;476427.8;528125.9;1004553.7
313730;201802;59;41;18;39114.0;17172.0;56286.0
313740;201802;164;131;33;124974.0;31482.0;156456.0
313750;201802;440;323;117;307855.8;111618.0;419473.8
313753;201802;240;170;70;161512.2;66780.0;228292.2
313760;201802;1232;448;784;427392.0;745199.5;1172591.5
313770;201802;355;252;103;240408.0;98262.0;338670.0
313780;201802;753;384;369;366336.0;351739.8;718075.8
313790;201802;27;26;1;24804.0;954.0;25758.0
313800;201802;142;87;55;82998.0;52470.0;135468.0
313810;201802;66;38;28;36252.0;26712.0;62964.0
313820;201802;1286;633;653;602928.2;621985.2;1224913.4
313830;201802;67;50;17;47700.0;16218.0;63918.0
313835;201802;54;47;7;44838.0;6678.0;51516.0
313840;201802;1671;1024;647;971269.5;615998.0;1587267.5
313850;201802;178;61;117;58194.0;111038.06;169232.06
313860;201802;485;378;107;357131.3;101124.1;458255.4
313862;201802;171;113;58;107802.0;55332.0;163134.0
313865;201802;84;66;18;62964.0;17172.0;80136.0
313867;201802;49;37;12;35298.0;11448.0;46746.0
313868;201802;27;18;9;16409.0;8586.0;24995.0
313870;201802;124;65;59;62010.0;56286.0;118296.0
313880;201802;345;221;124;210548.0;117723.8;328271.8
313890;201802;318;169;149;160463.8;141573.6;302037.4
313900;201802;910;493;417;468701.5;397771.0;866472.5
313910;201802;137;97;40;92538.0;37206.2;129744.2
313920;201802;607;430;177;410029.2;168858.0;578887.2
313925;201802;33;29;4;27666.0;3816.0;31482.0
313930;201802;801;615;186;586710.0;177421.0;764131.0
313940;201802;1759;1107;652;1052548.4;621340.4;1673888.8
313950;201802;933;598;335;568680.6;319303.8;887984.4
313960;201802;1376;793;583;752258.3;554942.0;1307200.2
313970;201802;120;82;38;78228.0;36252.0;114480.0
313980;201802;208;135;73;128552.0;69642.0;198194.0
313990;201802;366;219;147;208639.8;140158.81;348798.62
314000;201802;912;619;293;587045.9;279517.22;866563.1
314010;201802;77;50;27;47700.0;25758.0;73458.0
314015;201802;53;16;37;15264.0;35298.0;50562.0
314020;201802;50;34;16;32436.0;15168.6;47604.6
314030;201802;87;40;47;37997.82;44838.0;82835.82
314040;201802;43;30;13;28620.0;12402.0;41022.0
314050;201802;314;183;131;174296.0;123495.3;297791.3
314053;201802;100;66;34;62010.4;32436.0;94446.4
314055;201802;297;174;123;165996.0;117342.0;283338.0
314060;201802;144;122;22;115434.0;20988.0;136422.0
314070;201802;960;470;490;444575.12;466554.0;911129.1
314080;201802;216;140;76;133560.0;71454.88;205014.88
314085;201802;124;81;43;77274.0;41022.0;118296.0
314090;201802;350;253;97;241362.0;92533.23;333895.22
314100;201802;475;391;84;369199.0;79564.0;448763.0
314110;201802;690;374;316;354897.53;300748.6;655646.1
314120;201802;96;54;42;51516.0;40068.0;91584.0
314130;201802;25;12;13;11448.0;12402.0;23850.0
314140;201802;1088;653;435;620558.1;413082.66;1033640.75
314150;201802;162;102;60;97308.0;57240.0;154548.0
314160;201802;355;262;93;247086.8;88532.0;335618.8
314170;201802;69;51;18;48654.0;17172.0;65826.0
314180;201802;724;633;91;603596.0;85860.5;689456.5
314190;201802;101;57;44;54378.0;41976.0;96354.0
314200;201802;585;403;182;383010.8;172674.0;555684.8
314210;201802;278;208;70;197478.0;66494.0;263972.0
314220;201802;307;232;75;219421.0;71264.0;290685.0
314225;201802;65;45;20;42930.0;19080.0;62010.0
314230;201802;105;47;58;44838.0;55332.0;100170.0
314240;201802;141;107;34;102078.0;32436.0;134514.0
314250;201802;59;35;24;33390.0;22896.0;56286.0
314260;201802;188;96;92;91584.0;87768.0;179352.0
314270;201802;333;259;74;246323.0;70583.0;316906.0
314280;201802;682;379;303;361557.0;289062.0;650619.0
314290;201802;554;449;105;427106.5;99883.8;526990.3
314300;201802;415;296;119;279448.0;113479.0;392927.0
314310;201802;1443;966;477;919657.3;454952.97;1374610.2
314315;201802;33;26;7;24804.0;6678.0;31482.0
314320;201802;608;385;223;366717.8;211816.62;578534.44
314330;201802;10660;5360;5300;5103303.0;5051735.0;1,02E+14
314340;201802;569;265;304;252237.8;289444.0;541681.8
314345;201802;29;23;6;21942.0;5724.0;27666.0
314350;201802;191;119;72;113526.0;68688.0;182214.0
314360;201802;78;47;31;44838.0;29574.0;74412.0
314370;201802;56;46;10;43884.0;9540.0;53424.0
314380;201802;91;65;26;62010.0;24804.0;86814.0
314390;201802;3197;2012;1185;1915155.5;1127533.4;3042689.0
314400;201802;685;489;196;463636.2;186984.0;650620.2
314410;201802;427;275;152;262350.0;145008.0;407358.0
314420;201802;20;9;11;8586.0;10494.0;19080.0
314430;201802;2499;897;1602;851990.3;1525624.8;2377615.0
314435;201802;267;152;115;144721.8;108756.0;253477.8
314437;201802;26;20;6;19080.0;5724.0;24804.0
314440;201802;98;70;28;66780.0;26712.0;93492.0
314450;201802;153;117;36;111618.0;34344.0;145962.0
314460;201802;657;301;356;287154.0;339624.0;626778.0
314465;201802;81;55;26;52470.0;24804.0;77274.0
314467;201802;69;59;10;56277.0;9540.0;65817.0
314470;201802;384;197;187;184486.52;177444.5;361931.03
314480;201802;1047;504;543;480816.0;517831.2;998647.2
314490;201802;89;68;21;64872.0;20034.0;84906.0
314500;201802;316;207;109;197478.0;103986.0;301464.0
314505;201802;128;81;47;77274.0;44838.0;122112.0
314510;201802;225;181;44;172388.0;41976.0;214364.0
314520;201802;1235;633;602;596636.7;572066.9;1168703.6
314530;201802;707;557;150;530892.0;143100.0;673992.0
314535;201802;209;133;76;125832.6;72253.01;198085.61
314537;201802;62;37;25;35298.0;23850.0;59148.0
314540;201802;14;9;5;8586.0;4770.0;13356.0
314545;201802;49;32;17;30528.0;16218.0;46746.0
314550;201802;79;42;37;40068.0;35298.0;75366.0
314560;201802;806;434;372;411842.0;354888.0;766730.0
314570;201802;22;17;5;16218.0;4770.0;20988.0
314580;201802;18;9;9;8586.0;8586.0;17172.0
314585;201802;20;14;6;13356.0;5724.0;19080.0
314587;201802;84;72;12;68688.0;11448.0;80136.0
314590;201802;552;409;143;390186.0;136422.0;526608.0
314600;201802;996;649;347;614464.9;328748.8;943213.7
314610;201802;940;516;424;489688.9;403351.2;893040.1
314620;201802;149;110;39;103413.6;37206.0;140619.6
314625;201802;95;71;24;67162.0;22896.0;90058.0
314630;201802;1235;631;604;600495.3;575929.8;1176425.1
314640;201802;91;59;32;56286.0;30241.8;86527.8
314650;201802;205;119;86;112478.6;81567.0;194045.6
314655;201802;66;51;15;48654.0;14310.0;62964.0
314660;201802;20;15;5;14310.0;4770.0;19080.0
314670;201802;185;146;39;138998.0;37206.0;176204.0
314675;201802;212;121;91;115434.0;86814.0;202248.0
314690;201802;536;299;237;284959.8;226098.0;511057.8
314700;201802;2420;1322;1098;1255752.2;1046304.9;2302057.0
314710;201802;1629;954;675;905158.9;643330.1;1548489.0
314720;201802;407;242;165;229465.62;157410.0;386875.62
314730;201802;508;272;236;258058.0;225135.0;483193.0
314740;201802;688;341;347;323644.5;331038.0;654682.5
314750;201802;22;19;3;18126.0;2862.0;20988.0
314760;201802;316;151;165;144054.0;157400.45;301454.47
314770;201802;121;83;38;79182.0;36252.0;115434.0
314780;201802;21;6;15;5724.0;14310.0;20034.0
314790;201802;2333;1457;876;1384247.2;835026.7;2219273.8
314795;201802;50;43;7;40784.0;6678.0;47462.0
314800;201802;2929;1715;1214;1630824.0;1155858.2;2786682.2
314810;201802;1502;832;670;791391.5;637559.0;1428950.5
314820;201802;91;51;40;48654.0;38160.0;86814.0
314830;201802;210;165;45;155994.9;42644.0;198638.9
314840;201802;83;49;34;46746.0;32436.0;79182.0
314850;201802;350;170;180;162180.0;171720.0;333900.0
314860;201802;705;527;178;500754.88;168285.7;669040.56
314870;201802;1449;742;707;706914.0;674478.0;1381392.0
314875;201802;59;51;8;48654.0;7632.0;56286.0
314880;201802;47;34;13;32436.0;12402.0;44838.0
314890;201802;53;31;22;29574.0;20988.0;50562.0
314900;201802;30;25;5;23850.0;4770.0;28620.0
314910;201802;256;172;84;163801.8;80136.0;243937.8
314915;201802;156;135;21;128552.0;20034.0;148586.0
314920;201802;122;75;47;71550.0;44551.8;116101.8
314930;201802;1023;520;503;494555.0;479575.8;974130.8
314940;201802;53;41;12;39114.0;11448.0;50562.0
314950;201802;37;26;11;24804.0;10494.0;35298.0
314960;201802;61;45;16;42930.0;15264.0;58194.0
314970;201802;137;68;69;64300.0;65826.0;130126.0
314980;201802;300;195;105;183788.1;99216.0;283004.1
314990;201802;464;256;208;244224.0;197526.5;441750.5
314995;201802;199;65;134;62010.0;127826.46;189836.45
315000;201802;86;69;17;65826.0;16218.0;82044.0
315010;201802;47;31;16;29574.0;15264.0;44838.0
315015;201802;168;137;31;129972.96;29574.0;159546.95
315020;201802;71;61;10;58194.0;9540.0;67734.0
315030;201802;117;88;29;82998.0;27666.0;110664.0
315040;201802;66;49;17;46746.0;16218.0;62964.0
315050;201802;198;118;80;112572.0;76320.0;188892.0
315053;201802;39;34;5;32436.0;4770.0;37206.0
315057;201802;96;79;17;74984.4;16218.0;91202.4
315060;201802;69;62;7;57241.16;6678.0;63919.16
315070;201802;102;56;46;53424.0;43884.0;97308.0
315080;201802;368;302;66;288108.0;62964.0;351072.0
315090;201802;108;64;44;61056.0;41976.0;103032.0
315100;201802;78;40;38;38160.0;36252.0;74412.0
315110;201802;289;159;130;150828.0;124020.0;274848.0
315120;201802;1644;836;808;793586.2;769640.0;1563226.2
315130;201802;341;247;94;235638.0;89676.0;325314.0
315140;201802;538;315;223;298888.2;212742.0;511630.2
315150;201802;980;460;520;437887.0;495794.0;933681.0
315160;201802;211;107;104;102078.0;99216.0;201294.0
315170;201802;345;223;122;211789.0;116101.8;327890.8
315180;201802;3194;1351;1843;1285278.2;1755028.2;3040306.5
315190;201802;309;177;132;168477.0;125928.0;294405.0
315200;201802;1181;672;509;639276.2;484727.4;1124003.6
315210;201802;1560;891;669;845913.9;635806.2;1481720.1
315213;201802;46;28;18;26712.0;17172.0;43884.0
315217;201802;199;158;41;150732.0;39114.0;189846.0
315220;201802;1516;1160;356;1106020.6;339528.6;1445549.2
315230;201802;168;123;45;117056.0;42930.0;159986.0
315240;201802;422;272;150;259488.0;141898.5;401386.5
315250;201802;2538;1259;1279;1200222.9;1219107.6;2419330.5
315260;201802;148;91;57;85478.4;54378.0;139856.4
315270;201802;128;87;41;82425.6;38388.96;120814.56
315280;201802;688;448;240;427011.0;228950.45;655961.44
315290;201802;199;115;84;109710.0;79182.49;188892.48
315300;201802;71;47;24;44838.0;22896.0;67734.0
315310;201802;65;58;7;55332.0;6678.0;62010.0
315320;201802;159;89;70;84906.0;66780.0;151686.0
315330;201802;54;46;8;43884.0;7632.0;51516.0
315340;201802;419;294;125;279293.6;119250.0;398543.6
315350;201802;149;88;61;83952.0;58194.0;142146.0
315360;201802;96;51;45;48654.0;42930.0;91584.0
315370;201802;56;33;23;31482.0;21798.9;53280.9
315380;201802;12;7;5;6678.0;4770.0;11448.0
315390;201802;56;13;43;12402.0;41022.0;53424.0
315400;201802;820;613;207;579364.6;196810.2;776174.8
315410;201802;351;213;138;202916.0;131366.0;334282.0
315415;201802;59;45;14;42930.0;13356.0;56286.0
315420;201802;207;156;51;147727.1;48654.0;196381.1
315430;201802;677;395;282;375876.2;268551.8;644428.0
315440;201802;81;56;25;53424.0;23850.0;77274.0
315445;201802;255;204;51;194301.19;48654.0;242955.19
315450;201802;182;137;45;130698.0;42930.0;173628.0
315460;201802;3354;1696;1658;1614923.4;1579291.1;3194214.5
315470;201802;44;22;22;20988.0;20988.0;41976.0
315480;201802;62;23;39;21942.0;37206.0;59148.0
315490;201802;612;378;234;358560.9;223236.0;581796.9
315500;201802;22;14;8;13356.0;7632.0;20988.0
315510;201802;150;99;51;94446.0;48654.0;143100.0
315520;201802;71;62;9;59148.0;8586.0;67734.0
315530;201802;52;28;24;26712.0;22896.0;49608.0
315540;201802;239;156;83;148824.0;79182.0;228006.0
315550;201802;178;141;37;134514.0;35298.0;169812.0
315560;201802;742;591;151;562474.8;144054.0;706528.8
315570;201802;317;167;150;156695.7;143100.0;299795.7
315580;201802;652;425;227;405450.0;216558.0;622008.0
315590;201802;208;106;102;101124.0;97308.0;198432.0
315600;201802;291;214;77;204156.0;73268.0;277424.0
315610;201802;97;47;50;44838.0;47700.0;92538.0
315620;201802;33;26;7;24804.0;6678.0;31482.0
315630;201802;141;93;48;88722.0;45792.0;134514.0
315640;201802;59;35;24;33390.0;22896.0;56286.0
315645;201802;63;45;18;42930.0;16695.0;59625.0
315650;201802;166;121;45;115148.0;42930.0;158078.0
315660;201802;479;204;275;194616.0;262350.0;456966.0
315670;201802;2343;1194;1149;1136291.4;1094973.6;2231265.0
315680;201802;856;575;281;545116.4;267348.97;812465.4
315690;201802;691;473;218;450167.66;207972.0;658139.7
315700;201802;1908;1006;902;955852.4;860508.0;1816360.4
315710;201802;325;86;239;82044.0;228006.0;310050.0
315720;201802;429;274;155;261396.0;147870.0;409266.0
315725;201802;201;161;40;153594.0;38160.0;191754.0
315727;201802;42;22;20;20988.0;19080.0;40068.0
315730;201802;40;38;2;36252.0;1908.0;38160.0
315733;201802;86;57;29;54378.0;27666.0;82044.0
315737;201802;51;38;13;36252.0;12402.0;48654.0
315740;201802;45;40;5;38160.0;4770.0;42930.0
315750;201802;160;126;34;120204.0;32436.0;152640.0
315760;201802;47;32;15;30528.0;14310.0;44838.0
315765;201802;116;76;40;72504.0;38160.0;110664.0
315770;201802;226;136;90;129744.0;85574.0;215318.0
315780;201802;3271;1702;1569;1617269.5;1494442.6;3111712.0
315790;201802;211;162;49;154548.0;46173.6;200721.6
315800;201802;283;204;79;194616.0;75366.0;269982.0
315810;201802;96;55;41;52470.0;38828.0;91298.0
315820;201802;791;569;222;541491.3;211788.0;753279.3
315830;201802;144;82;62;78228.0;59148.0;137376.0
315840;201802;91;63;28;60102.0;26712.0;86814.0
315850;201802;258;190;68;181260.0;64872.0;246132.0
315860;201802;12;4;8;3816.0;7632.0;11448.0
315870;201802;34;27;7;25758.0;6678.0;32436.0
315880;201802;104;68;36;64872.0;34344.0;99216.0
315890;201802;82;61;21;58194.0;20034.0;78228.0
315895;201802;437;288;149;273703.0;141574.0;415277.0
315900;201802;70;34;36;32436.0;34344.0;66780.0
315910;201802;38;24;14;22657.5;13356.0;36013.5
315920;201802;183;120;63;114480.0;59148.9;173628.9
315930;201802;40;14;26;13356.0;24804.0;38160.0
315935;201802;147;115;32;109710.0;30519.0;140229.0
315940;201802;91;68;23;64872.0;21942.0;86814.0
315950;201802;65;47;18;44838.0;17172.0;62010.0
315960;201802;557;258;299;245435.78;284673.8;530109.56
315970;201802;37;29;8;27666.0;7632.0;35298.0
315980;201802;696;325;371;307425.62;353924.47;661350.06
315990;201802;250;151;99;143768.0;94160.0;237928.0
316000;201802;50;32;18;30528.0;17172.0;47700.0
316010;201802;75;63;12;60102.0;11448.0;71550.0
316020;201802;109;89;20;84906.0;19080.0;103986.0
316030;201802;402;211;191;201294.0;181690.0;382984.0
316040;201802;502;222;280;210834.2;266834.0;477668.2
316045;201802;58;52;6;49608.0;5724.0;55332.0
316050;201802;16;14;2;13356.0;1908.0;15264.0
316060;201802;94;61;33;58194.0;31482.0;89676.0
316070;201802;1035;669;366;631747.5;348401.0;980148.5
316080;201802;104;62;42;59148.0;40068.0;99216.0
316090;201802;41;25;16;23182.2;15264.0;38446.2
316095;201802;70;58;12;55056.0;11448.0;66504.0
316100;201802;309;180;129;170909.3;123066.0;293975.3
316105;201802;35;24;11;22896.0;10494.0;33390.0
316110;201802;1917;1539;378;1458428.4;359944.2;1818372.5
316120;201802;82;61;21;58194.0;19747.8;77941.8
316130;201802;138;106;32;100457.0;30528.0;130985.0
316140;201802;27;20;7;19080.0;6678.0;25758.0
316150;201802;204;142;62;134752.5;59148.0;193900.5
316160;201802;85;51;34;48654.0;32436.0;81090.0
316165;201802;65;47;18;44648.0;16456.5;61104.5
316170;201802;203;136;67;128790.0;63918.0;192708.0
316180;201802;197;89;108;84572.1;103032.0;187604.1
316190;201802;139;99;40;93492.0;38160.0;131652.0
316200;201802;699;389;310;371106.0;295167.6;666273.6
316210;201802;760;507;253;483332.34;241362.0;724694.3
316220;201802;115;78;37;74412.0;35298.0;109710.0
316225;201802;23;14;9;13356.0;8586.0;21942.0
316230;201802;32;19;13;18126.0;12402.0;30528.0
316240;201802;617;499;118;475092.2;112572.0;587664.2
316245;201802;101;84;17;80136.0;16218.0;96354.0
316250;201802;1508;1052;456;995958.5;433554.9;1429513.4
316255;201802;111;90;21;85478.4;20034.0;105512.4
316257;201802;183;96;87;91584.0;82711.8;174295.8
316260;201802;243;161;82;152297.06;78133.0;230430.06
316265;201802;25;16;9;15264.0;8586.0;23850.0
316270;201802;678;470;208;445613.6;198432.0;644045.6
316280;201802;542;337;205;319940.8;194902.6;514843.4
316290;201802;701;472;229;447426.97;218466.0;665893.0
316292;201802;501;199;302;189846.0;287870.0;477716.0
316294;201802;104;62;42;59148.0;40068.0;99216.0
316295;201802;281;123;158;115894.0;150732.0;266626.0
316300;201802;103;72;31;68688.0;29574.0;98262.0
316310;201802;35;18;17;17172.0;16218.0;33390.0
316320;201802;42;25;17;23850.0;16218.0;40068.0
316330;201802;132;84;48;79182.5;45505.8;124688.3
316340;201802;140;93;47;88722.0;44838.0;133560.0
316350;201802;192;139;53;132440.0;50562.0;183002.0
316360;201802;22;17;5;16218.0;4770.0;20988.0
316370;201802;1063;565;498;535214.5;474796.25;1010010.75
316380;201802;122;92;30;87768.0;28620.0;116388.0
316390;201802;121;87;34;82998.0;32436.0;115434.0
316400;201802;138;105;33;100170.0;31482.0;131652.0
316410;201802;303;222;81;210404.7;77274.0;287678.7
316420;201802;199;141;58;133798.5;55332.0;189130.5
316430;201802;160;81;79;77274.0;75366.0;152640.0
316440;201802;98;47;51;44838.0;48654.0;93492.0
316443;201802;38;35;3;33390.0;2862.0;36252.0
316447;201802;64;50;14;47700.0;13356.0;61056.0
316450;201802;220;166;54;158364.0;51516.0;209880.0
316460;201802;68;28;40;26712.0;38160.0;64872.0
316470;201802;1608;1158;450;1097026.5;427083.75;1524110.2
316480;201802;13;10;3;9540.0;2862.0;12402.0
316490;201802;18;7;11;6678.0;10494.0;17172.0
316500;201802;152;101;51;96067.8;48654.0;144721.8
316510;201802;168;124;44;117294.3;41976.0;159270.3
316520;201802;191;116;75;110091.6;71550.0;181641.6
316530;201802;155;112;43;106848.0;40735.8;147583.8
316540;201802;141;78;63;74412.0;60102.0;134514.0
316550;201802;140;99;41;94446.0;39114.0;133560.0
316553;201802;240;115;125;109201.33;119250.0;228451.33
316555;201802;32;23;9;21942.0;8586.0;30528.0
316556;201802;9;6;3;5724.0;2862.0;8586.0
316557;201802;18;15;3;14310.0;2862.0;17172.0
316560;201802;60;47;13;44838.0;12402.0;57240.0
316570;201802;246;224;22;213458.0;20988.0;234446.0
316580;201802;21;15;6;14310.0;5724.0;20034.0
316590;201802;115;99;16;94446.0;15264.0;109710.0
316600;201802;181;147;34;139952.0;32436.0;172388.0
316610;201802;64;45;19;42643.8;18126.0;60769.8
316620;201802;134;103;31;98262.0;29574.0;127836.0
316630;201802;38;28;10;26712.0;9540.0;36252.0
316640;201802;16;10;6;9540.0;5724.0;15264.0
316650;201802;64;50;14;47700.0;13356.0;61056.0
316660;201802;6;4;2;3816.0;1908.0;5724.0
316670;201802;437;156;281;148805.0;267501.8;416306.8
316680;201802;162;112;50;106848.0;47510.0;154358.0
316690;201802;192;121;71;115434.0;67734.0;183168.0
316695;201802;62;55;7;52470.0;6678.0;59148.0
316700;201802;14;7;7;6678.0;6678.0;13356.0
316710;201802;711;519;192;494888.0;183168.0;678056.0
316720;201802;4870;2475;2395;2346657.0;2279361.0;4626018.0
316730;201802;14;13;1;12402.0;954.0;13356.0
316740;201802;133;84;49;80136.0;46746.0;126882.0
316750;201802;19;13;6;12402.0;5724.0;18126.0
316760;201802;323;260;63;248040.0;60102.0;308142.0
316770;201802;139;80;59;76320.0;56286.0;132606.0
316780;201802;71;41;30;38808.72;28620.0;67428.72
316790;201802;56;43;13;41022.0;12402.0;53424.0
316800;201802;1795;1104;691;1051212.8;657498.2;1708711.0
316805;201802;18;9;9;8586.0;8586.0;17172.0
316810;201802;64;41;23;39114.0;21656.0;60770.0
316820;201802;37;18;19;17172.0;18126.0;35298.0
316830;201802;90;39;51;37206.0;47414.0;84620.0
316840;201802;504;305;199;290207.0;187938.0;478145.0
316850;201802;345;226;119;214220.7;113526.0;327746.7
316860;201802;5978;2647;3331;2510508.5;3174283.2;5684792.0
316870;201802;1450;940;510;888376.7;481772.0;1370148.8
316880;201802;114;65;49;61723.8;46746.0;108469.8
316890;201802;251;166;85;158317.0;81090.0;239407.0
316900;201802;417;287;130;271251.28;124020.0;395271.28
316905;201802;16;9;7;8586.0;6678.0;15264.0
316910;201802;50;26;24;24804.0;22896.0;47700.0
316920;201802;133;103;30;97547.0;28620.0;126167.0
316930;201802;1910;963;947;912932.3;901239.94;1814172.2
316935;201802;855;514;341;488115.72;324360.0;812475.75
316940;201802;1097;631;466;601020.4;443982.25;1045002.7
316950;201802;186;96;90;91584.0;85860.0;177444.0
316960;201802;1099;611;488;581558.8;465256.47;1046815.25
316970;201802;636;496;140;473184.0;133560.0;606744.0
316980;201802;111;68;43;64872.0;41012.46;105884.46
316990;201802;2173;1427;746;1353966.1;710005.94;2063972.1
317000;201802;328;254;74;242030.0;70596.0;312626.0
317005;201802;247;175;72;166950.0;68688.0;235638.0
317010;201802;6231;3430;2801;3251625.8;2670246.2;5921872.0
317020;201802;16065;7114;8951;6754448.5;8521910.0;1,53E+14
317030;201802;84;33;51;31482.0;48437.26;79919.26
317040;201802;3120;1940;1180;1848585.9;1122668.6;2971254.5
317043;201802;69;49;20;46746.0;19080.0;65826.0
317047;201802;37;18;19;17172.0;18122.0;35294.0
317050;201802;176;130;46;124020.0;43884.0;167904.0
317052;201802;125;97;28;92538.0;26712.0;119250.0
317057;201802;200;150;50;143100.0;47128.0;190228.0
317060;201802;55;36;19;34344.0;17839.8;52183.8
317065;201802;60;48;12;45792.0;11448.0;57240.0
317070;201802;1965;928;1037;880543.7;988153.6;1868697.2
317075;201802;107;55;52;52470.0;49608.0;102078.0
317080;201802;819;431;388;410076.9;369962.0;780038.9
317090;201802;632;506;126;480387.5;120204.0;600591.5
317100;201802;411;306;105;290016.2;100170.0;390186.2
317103;201802;109;94;15;89676.0;14310.0;103986.0
317107;201802;36;32;4;30528.0;3816.0;34344.0
317110;201802;95;40;55;38160.0;52470.0;90630.0
317115;201802;40;34;6;32436.0;5724.0;38160.0
317120;201802;1807;910;897;860236.6;855281.0;1715517.6
317130;201802;1905;1220;685;1160931.4;652823.0;1813754.4
317140;201802;7;5;2;4770.0;1908.0;6678.0
317150;201802;267;161;106;153594.0;100360.8;253954.8
317160;201802;319;232;87;221011.0;82712.0;303723.0
317170;201802;205;142;63;135468.0;60102.0;195570.0
317180;201802;428;307;121;292162.5;115434.0;407596.5
317190;201802;252;169;83;161226.0;78895.8;240121.8
317200;201802;799;564;235;525664.0;223952.0;749616.0
317210;201802;153;87;66;82044.2;62964.0;145008.2
317220;201802;20;13;7;12402.0;6678.0;19080.0
320010;201802;620;459;161;434548.5;153594.0;588142.5
320013;201802;133;99;34;94446.0;32436.0;126882.0
320016;201802;279;177;102;168858.0;97308.0;266166.0
320020;201802;716;429;287;406716.75;271155.75;677872.5
320030;201802;150;112;38;106848.0;35918.1;142766.1
320035;201802;133;98;35;93492.0;33390.0;126882.0
320040;201802;499;259;240;246514.0;228960.0;475474.0
320050;201802;115;88;27;83952.0;25758.0;109710.0
320060;201802;1523;708;815;675385.0;776833.6;1452218.6
320070;201802;100;70;30;66780.0;28620.0;95400.0
320080;201802;759;434;325;411205.0;310050.0;721255.0
320090;201802;1202;839;363;797052.9;345443.6;1142496.5
320100;201802;315;178;137;169812.0;130698.0;300510.0
320110;201802;139;89;50;82762.2;47700.0;130462.2
320115;201802;112;92;20;87768.0;19080.0;106848.0
320120;201802;3275;1833;1442;1736849.8;1373990.6;3110840.5
320130;201802;7300;3489;3811;3308224.5;3627872.8;6936097.0
320140;201802;417;267;150;253383.2;142856.0;396239.2
320150;201802;1877;1096;781;1037985.94;745064.44;1783050.4
320160;201802;688;312;376;295635.84;357351.28;652987.1
320170;201802;113;87;26;82235.0;24804.0;107039.0
320180;201802;52;30;22;28620.0;20988.0;49608.0
320190;201802;233;157;76;149005.27;72218.0;221223.27
320200;201802;54;41;13;39114.0;12402.0;51516.0
320210;201802;839;472;367;448762.6;349146.0;797908.6
320220;201802;303;112;191;106848.0;181928.0;288776.0
320225;201802;73;60;13;57240.0;12402.0;69642.0
320230;201802;550;353;197;335426.4;187128.0;522554.4
320240;201802;3124;1575;1549;1500070.8;1475079.8;2975150.5
320245;201802;455;317;138;301273.4;131652.0;432925.4
320250;201802;219;114;105;107802.6;100170.0;207972.6
320255;201802;143;114;29;107449.02;27523.0;134972.02
320260;201802;175;122;53;116388.0;50514.3;166902.3
320265;201802;159;128;31;121302.0;29574.0;150876.0
320270;201802;152;125;27;119250.0;25758.0;145008.0
320280;201802;945;570;375;538820.2;356634.03;895454.25
320290;201802;65;55;10;52470.0;9540.0;62010.0
320300;201802;535;379;156;360107.3;147556.1;507663.4
320305;201802;652;351;301;334854.0;286964.0;621818.0
320310;201802;212;121;91;113479.5;86058.0;199537.5
320313;201802;302;151;151;144054.0;143768.0;287822.0
320316;201802;109;90;19;85860.0;18126.0;103986.0
320320;201802;3303;1505;1798;1430086.0;1712303.0;3142389.0
320330;201802;258;190;68;180597.3;62964.91;243562.2
320332;201802;882;532;350;505671.6;332851.3;838522.9
320334;201802;236;143;93;136136.0;88722.0;224858.0
320335;201802;146;105;41;98977.9;39114.0;138091.9
320340;201802;590;408;182;388088.0;172961.0;561049.0
320350;201802;964;410;554;388660.88;527990.5;916651.4
320360;201802;166;92;74;87482.0;70596.0;158078.0
320370;201802;244;187;57;176706.0;53345.0;230051.0
320380;201802;283;191;92;180259.1;87768.0;268027.1
320390;201802;1113;683;430;651258.0;408646.94;1059904.9
320400;201802;320;231;89;219421.0;84906.0;304327.0
320405;201802;884;377;507;359081.6;483365.9;842447.5
320410;201802;967;492;475;467679.4;452779.34;920458.75
320420;201802;480;249;231;237069.4;220374.0;457443.4
320425;201802;192;105;87;100170.0;82998.0;183168.0
320430;201802;394;224;170;212074.7;162180.0;374254.7
320435;201802;166;111;55;105073.56;52470.0;157543.56
320440;201802;201;122;79;116101.8;75080.0;191181.8
320450;201802;130;77;53;73458.0;50562.0;124020.0
320455;201802;243;197;46;186985.0;43884.0;230869.0
320460;201802;241;153;88;145962.0;83952.0;229914.0
320465;201802;114;77;37;73095.48;35298.0;108393.48
320470;201802;630;403;227;384158.25;216554.0;600712.25
320480;201802;176;118;58;111761.1;55332.0;167093.1
320490;201802;2996;1502;1494;1428594.8;1423331.9;2851926.8
320495;201802;90;56;34;53405.0;32436.0;85841.0
320500;201802;9379;4747;4632;4501321.0;4406377.0;8907698.0
320501;201802;540;274;266;261396.0;253764.0;515160.0
320503;201802;278;200;78;189846.2;74412.0;264258.2
320506;201802;256;197;59;187938.0;56286.0;244224.0
320510;201802;929;447;482;423529.3;458302.1;881831.4
320515;201802;79;66;13;62010.9;12402.0;74412.9
320517;201802;204;144;60;137376.0;57240.0;194616.0
320520;201802;6785;3035;3750;2881172.5;3569166.0;6450338.5
320530;201802;5226;2625;2601;2495517.0;2478104.2;4973621.0
330010;201802;3047;1571;1476;1491074.5;1405306.4;2896381.0
330015;201802;156;63;93;58958.08;88722.0;147680.08
330020;201802;3555;1554;2001;1479274.9;1908382.0;3387656.8
330022;201802;213;119;94;112811.0;88722.8;201533.8
330023;201802;522;181;341;171195.8;325314.0;496509.8
330025;201802;540;122;418;116388.0;398199.8;514587.8
330030;201802;1919;1225;694;1160355.2;658807.7;1819163.0
330040;201802;2303;1170;1133;1114320.1;1079548.0;2193868.0
330045;201802;8285;2609;5676;2480858.8;5408696.0;7889555.0
330050;201802;797;503;294;479862.0;280476.0;760338.0
330060;201802;884;552;332;522793.9;316079.28;838873.2
330070;201802;3429;1308;2121;1241875.5;2022119.5;3263995.0
330080;201802;1496;702;794;664445.3;756236.4;1420681.8
330090;201802;352;213;139;203202.0;132606.0;335808.0
330093;201802;288;129;159;123066.0;151650.0;274716.0
330095;201802;100;52;48;49608.0;45792.0;95400.0
330100;201802;9472;4888;4584;4653584.0;4369531.0;9023115.0
330110;201802;472;210;262;199624.5;249948.0;449572.5
330115;201802;528;311;217;296694.0;207018.0;503712.0
330120;201802;377;196;181;185839.2;171910.8;357750.0
330130;201802;1519;425;1094;404724.97;1043640.0;1448365.0
330140;201802;599;315;284;300492.0;269983.0;570475.0
330150;201802;448;267;181;252810.0;171720.0;424530.0
330160;201802;206;127;79;121158.0;75366.0;196524.0
330170;201802;26638;9413;17225;8958489.0;1,64E+14;2,54E+13
330180;201802;239;152;87;141507.22;82282.5;223789.72
330185;201802;782;330;452;313284.8;429940.8;743225.6
330187;201802;282;91;191;86814.0;182214.0;269028.0
330190;201802;5544;2221;3323;2109998.0;3166846.8;5276844.5
330200;201802;4438;1535;2903;1459716.6;2764781.8;4224498.5
330205;201802;389;241;148;229484.7;140906.0;370390.7
330210;201802;998;608;390;574789.6;370390.9;945180.5
330220;201802;2521;1507;1014;1434292.5;966402.2;2400694.8
330225;201802;552;310;242;295101.0;230200.2;525301.2
330227;201802;2465;789;1676;749548.44;1598548.2;2348096.8
330230;201802;199;122;77;115721.0;73458.0;189179.0
330240;201802;3614;1882;1732;1790851.2;1649043.5;3439894.8
330245;201802;152;65;87;62010.0;82234.8;144244.8
330250;201802;6452;3352;3100;3186985.5;2948447.2;6135433.0
330260;201802;566;169;397;161226.0;378738.0;539964.0
330270;201802;3319;1230;2089;1172563.0;1992335.2;3164898.2
330280;201802;437;286;151;269907.28;144045.0;413952.28
330285;201802;7001;2324;4677;2213074.5;4459674.5;6672749.0
330290;201802;567;220;347;208927.0;331038.0;539965.0
330300;201802;750;503;247;476046.7;235620.0;711666.7
330310;201802;413;240;173;227052.7;165042.0;392094.7
330320;201802;8071;3040;5031;2892435.8;4793923.0;7686358.5
330330;201802;9250;3636;5614;3462136.2;5351065.0;8813201.0
330340;201802;2645;1586;1059;1510841.0;1010266.94;2521108.0
330350;201802;17847;7062;10785;6712255.0;1,03E+14;1,70E+14
330360;201802;2576;1275;1301;1215377.2;1241145.0;2456522.2
330370;201802;970;534;436;508672.8;413941.6;922614.4
330380;201802;851;370;481;352254.97;458254.8;810509.75
330385;201802;602;317;285;301465.0;271890.0;573355.0
330390;201802;5152;2867;2285;2721480.5;2177328.5;4898809.0
330395;201802;248;156;92;147107.1;86003.2;233110.3
330400;201802;661;339;322;319972.6;305293.84;625266.44
330410;201802;503;358;145;339864.0;137805.53;477669.53
330411;201802;233;133;100;126701.0;95352.3;222053.3
330412;201802;253;108;145;102746.0;138330.0;241076.0
330414;201802;6163;2498;3665;2379984.0;3494436.2;5874420.5
330415;201802;568;270;298;256367.6;283338.8;539706.4
330420;201802;2270;1201;1069;1142769.6;1017147.0;2159916.5
330430;201802;1805;830;975;789722.0;928038.06;1717760.0
330440;201802;266;123;143;117342.0;136422.0;253764.0
330450;201802;123;51;72;48654.0;68688.0;117342.0
330452;201802;1698;796;902;757670.2;860203.9;1617874.0
330455;201802;110491;39506;70985;3,76E+14;6,77E+14;1,05E+16
330460;201802;264;107;157;102078.0;149778.0;251856.0
330470;201802;1239;681;558;643381.0;532322.44;1175703.5
330475;201802;1397;379;1018;359589.62;970599.6;1330189.2
330480;201802;743;395;348;376162.2;331038.8;707201.0
330490;201802;13560;4759;8801;4533304.5;8388867.0;1,29E+14
330500;201802;1340;614;726;585612.9;692223.0;1277835.9
330510;201802;11196;3752;7444;3571730.5;7094885.5;1,07E+14
330513;201802;103;51;52;48654.0;49608.0;98262.0
330515;201802;854;356;498;335599.8;474711.0;810310.8
330520;201802;2444;922;1522;879369.0;1451844.9;2331214.0
330530;201802;227;118;109;112572.0;103796.0;216368.0
330540;201802;353;176;177;167904.0;168381.0;336285.0
330550;201802;3072;1090;1982;1037142.2;1888777.2;2925919.5
330555;201802;750;278;472;265193.0;449334.8;714527.8
330560;201802;551;206;345;196524.0;329112.0;525636.0
330570;201802;252;174;78;165996.0;74412.0;240408.0
330575;201802;808;332;476;316490.0;452049.5;768539.5
330580;201802;3356;1883;1473;1789240.0;1403477.8;3192717.8
330590;201802;306;155;151;147870.0;144054.0;291924.0
330600;201802;1096;707;389;672341.25;369418.38;1041759.6
330610;201802;1523;841;682;795142.44;646479.9;1441622.4
330615;201802;188;140;48;133560.0;45792.0;179352.0
330620;201802;975;444;531;421193.4;505143.8;926337.2
330630;201802;3773;2396;1377;2270196.8;1306268.6;3576465.2
350010;201802;593;386;207;366960.75;197478.0;564438.75
350020;201802;40;21;19;20034.0;18126.0;38160.0
350030;201802;522;339;183;322262.0;173392.66;495654.66
350040;201802;127;49;78;46402.56;74412.0;120814.56
350050;201802;292;161;131;153594.0;124717.46;278311.47
350055;201802;84;46;38;43884.0;36252.0;80136.0
350060;201802;74;28;46;26712.0;43884.0;70596.0
350070;201802;796;467;329;441237.12;312199.56;753436.7
350075;201802;65;43;22;41022.0;20988.0;62010.0
350080;201802;51;32;19;29891.96;18126.0;48017.96
350090;201802;98;56;42;53424.0;40063.23;93487.23
350100;201802;294;183;111;173866.5;105894.0;279760.5
350110;201802;59;36;23;34344.0;21942.0;56286.0
350115;201802;155;94;61;89008.2;58194.0;147202.2
350120;201802;112;75;37;71550.0;35298.0;106848.0
350130;201802;354;173;181;164470.0;172674.0;337144.0
350140;201802;35;21;14;19271.0;13356.0;32627.0
350150;201802;71;57;14;54378.0;13356.0;67734.0
350160;201802;2473;960;1513;912771.2;1442060.6;2354831.8
350170;201802;397;242;155;228960.2;147584.0;376544.2
350180;201802;185;97;88;92538.0;83952.0;176490.0
350190;201802;964;492;472;467366.62;449987.5;917354.1
350200;201802;71;26;45;24804.0;42665.08;67469.08
350210;201802;1353;761;592;718007.3;564250.7;1282258.0
350220;201802;668;574;94;543458.75;89676.0;633134.75
350230;201802;80;56;24;53424.0;22896.0;76320.0
350240;201802;62;47;15;44838.0;14310.0;59148.0
350250;201802;1215;611;604;577171.6;575492.06;1152663.6
350260;201802;93;66;27;62964.0;25758.0;88722.0
350270;201802;830;546;284;519807.0;269486.9;789293.94
350275;201802;297;115;182;109329.0;173628.0;282957.0
350280;201802;4711;2403;2308;2280565.5;2199009.8;4479575.0
350290;201802;399;189;210;180015.23;199767.8;379783.03
350300;201802;45;24;21;22896.0;20034.0;42930.0
350310;201802;98;69;29;65730.0;27666.0;93396.0
350315;201802;39;24;15;22896.0;14310.0;37206.0
350320;201802;3249;1608;1641;1529216.5;1564733.2;3093949.8
350330;201802;1671;888;783;843051.94;745678.06;1588730.0
350335;201802;21;14;7;13356.0;6678.0;20034.0
350340;201802;132;63;69;60102.0;64860.9;124962.9
350350;201802;97;47;50;44838.0;47700.0;92538.0
350360;201802;132;89;43;84902.0;41022.0;125924.0
350370;201802;96;56;40;52787.96;38150.46;90938.42
350380;201802;739;311;428;296026.2;407548.8;703575.0
350390;201802;1414;573;841;545846.4;801169.4;1347015.8
350395;201802;25;19;6;18126.0;5724.0;23850.0
350400;201802;1696;910;786;858852.0;746292.2;1605144.1
350410;201802;2232;998;1234;949002.94;1176917.0;2125920.0
350420;201802;231;142;89;134865.0;84906.0;219771.0
350430;201802;73;42;31;39496.0;29574.0;69070.0
350440;201802;151;111;40;104892.5;38160.0;143052.5
350450;201802;1613;1005;608;951550.94;579937.0;1531488.0
350460;201802;334;121;213;115434.0;202915.8;318349.8
350470;201802;14;10;4;9540.0;3816.0;13356.0
350480;201802;158;88;70;83952.0;66780.0;150732.0
350490;201802;244;120;124;113526.8;118296.0;231822.8
350500;201802;38;18;20;17172.0;19080.0;36252.0
350510;201802;163;109;54;103986.0;51516.0;155502.0
350520;201802;453;213;240;200021.95;228323.95;428345.9
350530;201802;450;211;239;201294.0;228006.0;429300.0
350535;201802;65;50;15;47381.85;14310.0;61691.85
350540;201802;373;190;183;180446.05;174296.0;354742.03
350550;201802;2740;1610;1130;1528360.8;1076916.1;2605276.8
350560;201802;631;438;193;417847.22;183764.25;601611.5
350570;201802;4189;1741;2448;1655444.0;2332885.2;3988329.2
350580;201802;364;172;192;163135.0;183154.45;346289.47
350590;201802;895;490;405;467460.0;385416.0;852876.0
350600;201802;6176;3106;3070;2948923.2;2925325.8;5874249.0
350610;201802;1538;785;753;742537.9;718353.0;1460890.9
350620;201802;37;25;12;23850.0;11448.0;35298.0
350630;201802;242;136;106;128790.96;100171.0;228961.95
350635;201802;862;340;522;324074.0;497341.22;821415.2
350640;201802;118;87;31;82998.0;29574.0;112572.0
350650;201802;1890;1245;645;1183276.2;613921.5;1797197.8
350660;201802;752;342;410;325628.8;390182.0;715810.8
350670;201802;310;161;149;153356.0;142146.0;295502.0
350680;201802;178;97;81;92538.0;77274.0;169812.0
350690;201802;196;98;98;93492.0;93492.0;186984.0
350700;201802;694;343;351;323887.94;334854.0;658741.94
350710;201802;324;131;193;124974.0;184122.0;309096.0
350715;201802;50;43;7;41022.0;6678.0;47700.0
350720;201802;18;13;5;12402.0;4770.0;17172.0
350730;201802;43;27;16;25758.0;15264.0;41022.0
350740;201802;204;115;89;109414.26;84906.0;194320.27
350745;201802;21;11;10;10470.0;9540.0;20010.0
350750;201802;2141;1377;764;1305370.8;728219.94;2033590.8
350760;201802;3722;1609;2113;1533365.4;2013598.5;3546963.8
350770;201802;59;40;19;38160.0;18126.0;56286.0
350775;201802;48;35;13;33390.0;12393.0;45783.0
350780;201802;423;210;213;200340.0;203202.0;403542.0
350790;201802;366;158;208;150732.0;198432.0;349164.0
350800;201802;433;241;192;229914.0;183168.0;413082.0
350810;201802;519;416;103;395911.0;98262.0;494173.0
350820;201802;84;50;34;47700.0;32436.0;80136.0
350830;201802;81;46;35;43884.0;33390.0;77274.0
350840;201802;723;329;394;313866.0;374636.0;688502.0
350850;201802;1750;1014;736;961348.3;701874.44;1663222.8
350860;201802;580;337;243;317265.12;231822.0;549087.1
350870;201802;436;296;140;282384.0;133273.8;415657.8
350880;201802;286;156;130;145964.1;123352.2;269316.3
350890;201802;43;26;17;24804.0;16218.0;41022.0
350900;201802;1465;473;992;449255.94;945604.8;1394860.8
350910;201802;28;18;10;17172.0;9540.0;26712.0
350920;201802;595;332;263;316410.03;250902.0;567312.06
350925;201802;1169;632;537;599886.3;510867.6;1110754.0
350930;201802;95;57;38;54378.0;36252.0;90630.0
350940;201802;715;401;314;381027.6;297715.6;678743.2
350945;201802;106;79;27;74830.0;25758.0;100588.0
350950;201802;15183;7328;7855;6962303.5;7483303.5;1,44E+14
350960;201802;1283;599;684;566764.94;652532.0;1219297.0
350970;201802;1121;607;514;576491.94;490060.47;1066552.4
350980;201802;97;65;32;62010.0;30528.0;92538.0
350990;201802;359;130;229;123324.0;218179.8;341503.8
350995;201802;34;17;17;16218.0;16218.0;32436.0
351000;201802;639;457;182;433754.06;173628.0;607382.06
351010;201802;52;30;22;28620.0;20988.0;49608.0
351015;201802;58;42;16;40068.0;15264.0;55332.0
351020;201802;1669;968;701;921762.25;666655.4;1588417.6
351030;201802;333;229;104;215890.2;99216.0;315106.2
351040;201802;850;460;390;437886.0;371106.66;808992.7
351050;201802;3270;1565;1705;1484714.4;1625522.5;3110237.0
351060;201802;4966;2047;2919;1942315.9;2781692.0;4724007.5
351070;201802;416;266;150;251543.14;143100.0;394643.12
351080;201802;811;582;229;555228.0;217512.0;772740.0
351090;201802;63;27;36;25758.0;34344.0;60102.0
351100;201802;459;262;197;247726.48;187924.23;435650.72
351110;201802;2109;1022;1087;969751.25;1034352.1;2004103.4
351120;201802;74;39;35;37121.09;33390.0;70511.09
351130;201802;175;60;115;57240.0;109710.0;166950.0
351140;201802;339;236;103;223617.64;98262.0;321879.62
351150;201802;395;203;192;193089.8;183168.0;376257.8
351160;201802;246;160;86;152640.0;82044.0;234684.0
351170;201802;183;96;87;91584.0;82235.0;173819.0
351190;201802;92;63;29;60102.0;27666.0;87768.0
351200;201802;382;250;132;237896.05;125928.0;363824.03
351210;201802;131;62;69;58893.38;65826.0;124719.38
351220;201802;527;317;210;298730.12;200340.0;499070.12
351230;201802;276;202;74;192071.95;70576.92;262648.88
351240;201802;226;98;128;93301.2;122112.0;215413.2
351250;201802;69;48;21;45314.0;19844.0;65158.0
351260;201802;153;112;41;106848.0;38828.0;145676.0
351270;201802;48;20;28;19080.0;26712.0;45792.0
351280;201802;1106;502;604;475095.4;575692.4;1050787.8
351290;201802;225;101;124;96354.0;118010.0;214364.0
351300;201802;3742;1753;1989;1665593.1;1896613.0;3562206.2
351310;201802;771;394;377;375876.0;359658.0;735534.0
351320;201802;109;66;43;62964.0;41022.0;103986.0
351330;201802;41;28;13;26712.0;12402.0;39114.0
351340;201802;1237;766;471;723259.9;448350.22;1171610.1
351350;201802;2449;1330;1119;1267246.8;1067235.0;2334481.8
351360;201802;778;390;388;370152.0;369834.03;739986.06
351370;201802;364;189;175;180301.23;166313.95;346615.2
351380;201802;8882;4065;4817;3862626.0;4586467.0;8449093.0
351385;201802;30;20;10;19080.0;9540.0;28620.0
351390;201802;290;213;77;202248.0;73458.0;275706.0
351400;201802;65;40;25;38160.0;23803.92;61963.92
351410;201802;426;266;160;252493.05;152354.0;404847.03
351420;201802;62;50;12;47700.0;11448.0;59148.0
351430;201802;76;40;36;38160.0;34344.0;72504.0
351440;201802;790;549;241;521551.75;229910.0;751461.75
351450;201802;251;126;125;120204.0;119250.0;239454.0
351460;201802;122;55;67;51755.0;63918.0;115673.0
351470;201802;139;74;65;70587.0;62010.0;132597.0
351480;201802;514;288;226;273512.97;215484.75;488997.72
351490;201802;294;105;189;100170.0;180306.0;280476.0
351492;201802;32;23;9;21942.0;8586.0;30528.0
351495;201802;28;18;10;17172.0;9540.0;26712.0
351500;201802;3550;1538;2012;1461747.8;1914536.4;3376284.0
351510;201802;1770;739;1031;704719.8;981370.25;1686090.0
351512;201802;22;18;4;17172.0;3816.0;20988.0
351515;201802;194;111;83;105894.0;79182.0;185076.0
351518;201802;736;449;287;427388.0;273798.0;701186.0
351519;201802;74;48;26;45792.0;24804.0;70596.0
351520;201802;142;87;55;82361.96;52470.0;134831.95
351530;201802;20;13;7;12402.0;6678.0;19080.0
351535;201802;133;73;60;69642.0;57240.0;126882.0
351540;201802;462;333;129;315299.0;123066.0;438365.0
351550;201802;1319;804;515;762025.94;489051.12;1251077.1
351560;201802;74;38;36;36252.0;34344.0;70596.0
351565;201802;13;8;5;7632.0;4770.0;12402.0
351570;201802;2565;1322;1243;1258864.4;1185155.6;2444020.0
351580;201802;39;35;4;33390.0;3816.0;37206.0
351590;201802;67;44;23;41976.0;21942.0;63918.0
351600;201802;190;143;47;136422.0;44838.0;181260.0
351610;201802;61;30;31;28620.0;29574.0;58194.0
351620;201802;5954;3419;2535;3251697.2;2416167.0;5667864.5
351630;201802;2516;1300;1216;1234885.4;1157865.2;2392750.8
351640;201802;1657;809;848;769901.4;806750.8;1576652.1
351650;201802;30;25;5;23850.0;4770.0;28620.0
351660;201802;156;99;57;93492.0;54378.0;147870.0
351670;201802;741;466;275;442228.0;262350.0;704578.0
351680;201802;75;61;14;58194.0;13356.0;71550.0
351685;201802;43;28;15;26712.0;14310.0;41022.0
351690;201802;309;220;89;208014.94;84906.0;292920.94
351700;201802;163;115;48;109710.0;45792.0;155502.0
351710;201802;75;54;21;51516.0;20034.0;71550.0
351720;201802;136;63;73;60102.0;69642.0;129744.0
351730;201802;101;73;28;68401.96;26707.23;95109.19
351740;201802;720;486;234;461164.75;223231.23;684396.0
351750;201802;368;155;213;147234.0;203202.0;350436.0
351760;201802;796;619;177;590765.0;168858.0;759623.0
351770;201802;287;245;42;233730.0;40068.0;273798.0
351780;201802;172;97;75;92529.0;71550.0;164079.0
351790;201802;244;129;115;123066.0;109710.0;232776.0
351800;201802;54;35;19;33390.0;18126.0;51516.0
351810;201802;124;82;42;78228.0;40068.0;118296.0
351820;201802;884;637;247;603216.4;235347.23;838563.6
351830;201802;503;183;320;173818.8;305280.0;479098.8
351840;201802;1869;945;924;892586.0;879994.94;1772581.0
351850;201802;230;169;61;160606.8;58194.0;218800.8
351860;201802;758;501;257;472232.84;244887.23;717120.06
351870;201802;5630;2657;2973;2524413.8;2829951.8;5354365.5
351880;201802;18950;8302;10648;7897862.0;1,01E+14;1,80E+14
351885;201802;90;62;28;58433.0;26712.0;85145.0
351890;201802;72;61;11;58194.0;10494.0;68688.0
351900;201802;223;133;90;126215.0;85860.0;212075.0
351905;201802;76;34;42;32436.0;40068.0;72504.0
351907;201802;3107;1360;1747;1293935.0;1664559.8;2958494.8
351910;201802;177;74;103;70596.0;98262.0;168858.0
351920;201802;134;77;57;73458.0;54355.69;127813.69
351925;201802;87;60;27;57240.0;25758.0;82998.0
351930;201802;388;264;124;251760.6;118296.0;370056.6
351940;201802;231;105;126;100170.0;120204.0;220374.0
351950;201802;145;84;61;80136.0;58194.0;138330.0
351960;201802;860;399;461;380464.72;437638.38;818103.06
351970;201802;1900;1011;889;962347.8;847811.0;1810158.9
351980;201802;145;73;72;67734.0;68688.0;136422.0
351990;201802;278;188;90;178398.0;85058.64;263456.62
352000;201802;361;218;143;207972.0;136422.0;344394.0
352010;201802;350;208;142;198432.0;135468.0;333900.0
352020;201802;197;69;128;65826.0;122112.0;187938.0
352030;201802;1011;522;489;497272.5;464915.97;962188.44
352040;201802;572;249;323;237546.0;308142.0;545688.0
352042;201802;279;95;184;90630.0;175173.0;265803.0
352044;201802;392;235;157;223035.86;149778.0;372813.88
352050;201802;3150;1286;1864;1219008.0;1776434.2;2995442.2
352060;201802;106;67;39;63918.0;37206.0;101124.0
352070;201802;104;74;30;69326.0;28620.0;97946.0
352080;201802;65;40;25;37206.0;23850.0;61056.0
352090;201802;171;116;55;110664.0;52470.0;163134.0
352100;201802;253;124;129;118292.0;121914.0;240206.0
352110;201802;111;33;78;31482.0;74412.0;105894.0
352115;201802;73;29;44;27666.0;41976.0;69642.0
352120;201802;96;64;32;61056.0;30528.0;91584.0
352130;201802;219;185;34;176299.2;32436.0;208735.2
352140;201802;181;73;108;69165.0;103032.0;172197.0
352150;201802;121;68;53;63918.04;50562.0;114480.04
352160;201802;129;86;43;82044.0;41022.0;123066.0
352170;201802;370;252;118;239454.05;112572.0;352026.03
352180;201802;615;415;200;394956.5;190796.0;585752.5
352190;201802;262;102;160;97298.46;152601.84;249900.3
352200;201802;34;18;16;17172.0;15264.0;32436.0
352210;201802;3763;1569;2194;1488587.8;2087445.4;3576033.0
352215;201802;54;30;24;28620.0;22438.08;51058.08
352220;201802;6900;2722;4178;2591860.5;3983320.5;6575181.0
352230;201802;3174;2021;1153;1914950.0;1094253.6;3009203.8
352240;201802;2217;1303;914;1240582.5;869566.2;2110148.8
352250;201802;2596;1352;1244;1285867.8;1183713.6;2469581.2
352260;201802;1085;594;491;564859.25;468128.0;1032987.25
352265;201802;60;27;33;25758.0;31482.0;57240.0
352270;201802;408;233;175;221328.92;166894.0;388222.9
352280;201802;392;245;147;232459.0;140233.23;372692.22
352290;201802;172;109;63;103986.0;60102.0;164088.0
352300;201802;101;76;25;72504.0;23850.0;96354.0
352310;201802;5760;2814;2946;2671370.0;2804175.5;5475545.5
352320;201802;954;501;453;474459.84;430111.1;904570.94
352330;201802;524;236;288;224810.1;274466.0;499276.1
352340;201802;1393;680;713;646068.0;678152.5;1324220.5
352350;201802;330;208;122;198432.0;116102.0;314534.0
352360;201802;231;96;135;90677.7;125907.32;216585.02
352370;201802;102;69;33;65826.0;31482.0;97308.0
352380;201802;120;75;45;71550.0;42930.0;114480.0
352390;201802;2428;1108;1320;1053531.4;1258042.8;2311574.0
352400;201802;470;205;265;194616.0;252523.8;447139.8
352410;201802;751;539;212;509701.88;201962.0;711663.9
352420;201802;100;64;36;61056.0;34344.0;95400.0
352430;201802;1755;783;972;741929.8;924655.5;1666585.4
352440;201802;3111;1599;1512;1516550.8;1439546.6;2956097.5
352450;201802;189;160;29;152640.0;27666.0;180306.0
352460;201802;562;288;274;274194.7;260681.2;534875.9
352470;201802;593;200;393;190800.0;374913.0;565713.0
352480;201802;1376;771;605;734261.94;576597.8;1310859.8
352490;201802;84;32;52;30528.0;49608.0;80136.0
352500;201802;1209;539;670;512967.0;638027.2;1150994.2
352510;201802;731;397;334;377784.97;318350.0;696134.94
352520;201802;537;239;298;228006.0;284148.9;512154.9
352530;201802;1717;901;816;858886.2;778082.6;1636968.8
352540;201802;75;50;25;47700.0;23850.0;71550.0
352550;201802;181;104;77;99216.0;72790.2;172006.2
352560;201802;49;39;10;37206.0;9540.0;46746.0
352570;201802;661;343;318;326619.0;303372.0;629991.0
352580;201802;57;38;19;35298.65;18126.0;53424.65
352585;201802;17;5;12;4770.0;11448.0;16218.0
352590;201802;4307;2176;2131;2069690.5;2032073.4;4101764.0
352600;201802;359;251;108;238500.95;103032.0;341532.97
352610;201802;931;438;493;416831.22;470322.0;887153.25
352620;201802;961;389;572;370152.2;544735.0;914887.2
352630;201802;220;85;135;81090.0;128541.96;209631.95
352640;201802;560;396;164;375368.4;156456.0;531824.4
352650;201802;88;57;31;54378.0;29574.0;83952.0
352660;201802;81;48;33;45792.0;31482.0;77274.0
352670;201802;1654;904;750;858922.75;714410.6;1573333.4
352680;201802;882;568;314;538640.56;298094.03;836734.6
352690;201802;4341;1997;2344;1897027.9;2232260.8;4129288.8
352700;201802;106;61;45;57907.8;42930.0;100837.8
352710;201802;1367;728;639;692604.0;606644.6;1299248.6
352720;201802;1305;638;667;606108.2;636027.25;1242135.4
352725;201802;26;24;2;22896.0;1908.0;24804.0
352730;201802;363;178;185;168633.81;176490.0;345123.8
352740;201802;417;263;154;248947.69;146916.0;395863.7
352750;201802;22;14;8;13069.8;7632.0;20701.8
352760;201802;199;142;57;135468.0;54378.0;189846.0
352770;201802;81;63;18;60102.0;17172.0;77274.0
352780;201802;80;45;35;42930.0;33390.0;76320.0
352790;201802;28;23;5;21942.0;4770.0;26712.0
352800;201802;249;167;82;159318.0;77941.8;237259.8
352810;201802;166;109;57;101475.42;54378.0;155853.42
352820;201802;65;52;13;49182.52;12402.0;61584.52
352830;201802;89;62;27;59148.0;25758.0;84906.0
352840;201802;588;305;283;289683.2;269982.0;559665.2
352850;201802;1357;485;872;462022.2;831888.0;1293910.2
352860;201802;132;86;46;81408.0;43884.0;125292.0
352870;201802;43;27;16;25758.0;15264.0;41022.0
352880;201802;187;127;60;121138.92;57240.0;178378.92
352885;201802;28;20;8;19080.0;7632.0;26712.0
352890;201802;56;39;17;37206.0;15932.0;53138.0
352900;201802;4911;2373;2538;2245581.8;2413444.5;4659026.5
352910;201802;39;31;8;29574.0;7632.0;37206.0
352920;201802;716;441;275;419760.0;262350.0;682110.0
352930;201802;1262;610;652;580507.8;619038.75;1199546.5
352940;201802;6305;2736;3569;2598238.2;3401619.2;5999857.5
352950;201802;92;37;55;35298.0;52470.0;87768.0
352960;201802;69;45;24;42930.0;22896.0;65826.0
352965;201802;20;8;12;7632.0;11448.0;19080.0
352970;201802;465;350;115;330692.97;108757.0;439449.97
352980;201802;177;94;83;89676.0;79182.0;168858.0
352990;201802;939;422;517;401585.28;492130.1;893715.4
353000;201802;67;31;36;29574.0;34344.0;63918.0
353010;201802;552;343;209;327222.0;199366.92;526588.94
353020;201802;287;212;75;202248.0;71550.0;273798.0
353030;201802;1162;526;636;501480.47;606057.7;1107538.1
353040;201802;87;52;35;49608.0;33390.0;82998.0
353050;201802;1307;825;482;779405.0;459732.6;1239137.6
353060;201802;7922;3603;4319;3423017.8;4114092.8;7537110.5
353070;201802;1636;1029;607;975112.44;577787.4;1552899.9
353080;201802;1321;704;617;669279.56;587606.9;1256886.5
353090;201802;56;34;22;32436.0;20988.0;53424.0
353100;201802;62;51;11;48654.0;10494.0;59148.0
353110;201802;1982;607;1375;577346.9;1309114.2;1886461.1
353120;201802;74;40;34;38160.0;32436.0;70596.0
353130;201802;873;437;436;415925.47;415841.75;831767.25
353140;201802;569;224;345;213635.0;329130.0;542765.0
353150;201802;364;204;160;193662.0;152630.45;346292.47
353160;201802;102;84;18;80136.0;17172.0;97308.0
353170;201802;197;65;132;62010.0;125900.46;187910.45
353180;201802;952;433;519;410788.7;494602.0;905390.7
353190;201802;475;341;134;324258.9;127550.0;451808.9
353200;201802;190;96;94;91584.0;89676.0;181260.0
353205;201802;28;20;8;19080.0;7632.0;26712.0
353210;201802;85;52;33;49608.0;31482.0;81090.0
353215;201802;55;32;23;30528.0;21942.0;52470.0
353220;201802;84;48;36;45792.0;34344.0;80136.0
353230;201802;159;61;98;58194.0;93492.0;151686.0
353240;201802;287;161;126;153594.0;120204.0;273798.0
353250;201802;200;103;97;98262.0;92538.0;190800.0
353260;201802;453;326;127;309869.5;121148.46;431017.97
353270;201802;68;49;19;46746.0;17458.2;64204.2
353280;201802;95;48;47;45315.0;44838.0;90153.0
353282;201802;122;90;32;85860.0;30528.0;116388.0
353284;201802;22;18;4;17172.0;3816.0;20988.0
353286;201802;1;1;0;954.0;0.0;954.0
353290;201802;81;48;33;45792.0;31473.0;77265.0
353300;201802;399;221;178;209292.45;169812.0;379104.47
353310;201802;53;47;6;44838.0;5724.0;50562.0
353320;201802;62;39;23;37206.0;21942.0;59148.0
353325;201802;56;36;20;34335.0;18776.0;53111.0
353330;201802;67;51;16;48511.0;15264.0;63775.0
353340;201802;622;195;427;186030.0;406486.25;592516.25
353350;201802;919;423;496;402722.62;471640.8;874363.44
353360;201802;111;88;23;83634.04;21656.0;105290.04
353370;201802;120;70;50;65826.1;47700.0;113526.1
353380;201802;28;20;8;19076.0;7632.0;26708.0
353390;201802;1055;505;550;481770.0;524700.0;1006470.0
353400;201802;53;32;21;30528.0;20034.0;50562.0
353410;201802;122;77;45;73458.0;42883.0;116341.0
353420;201802;59;25;34;23850.0;32436.0;56286.0
353430;201802;552;363;189;342581.3;180019.8;522601.1
353440;201802;10205;4470;5735;4252252.5;5464129.5;9716382.0
353450;201802;56;30;26;28620.0;24804.0;53424.0
353460;201802;610;332;278;313559.1;264487.5;578046.6
353470;201802;2146;1168;978;1110319.9;930597.25;2040917.1
353475;201802;238;161;77;150904.95;73458.0;224362.95
353480;201802;190;151;39;144054.0;37206.0;181260.0
353490;201802;236;141;95;134514.0;90630.0;225144.0
353500;201802;184;108;76;101792.96;72504.0;174296.95
353510;201802;101;72;29;68669.46;27656.46;96325.92
353520;201802;209;141;68;134514.0;64872.0;199386.0
353530;201802;473;258;215;246132.0;205110.0;451242.0
353540;201802;353;236;117;224821.27;111618.0;336439.28
353550;201802;738;500;238;473186.88;227052.0;700238.9
353560;201802;639;270;369;256014.69;351426.06;607440.75
353570;201802;57;30;27;28620.0;25758.0;54378.0
353580;201802;360;276;84;262827.0;80136.0;342963.0
353590;201802;83;56;27;53106.04;25758.0;78864.04
353600;201802;266;149;117;141829.0;110982.0;252811.0
353610;201802;115;60;55;57240.0;52470.0;109710.0
353620;201802;570;309;261;292799.5;248707.8;541507.3
353625;201802;50;28;22;26712.0;20988.0;47700.0
353630;201802;240;173;67;160711.16;63918.0;224629.16
353640;201802;126;86;40;81567.0;38160.0;119727.0
353650;201802;853;331;522;313675.2;497988.0;811663.2
353657;201802;23;17;6;16218.0;5724.0;21942.0
353660;201802;257;144;113;137376.0;107515.8;244891.8
353670;201802;750;444;306;422622.2;291924.0;714546.2
353680;201802;99;70;29;66780.0;27666.0;94446.0
353690;201802;48;38;10;36252.0;9540.0;45792.0
353700;201802;285;199;86;189846.0;82044.0;271890.0
353710;201802;415;196;219;186030.8;208640.0;394670.8
353715;201802;47;35;12;33103.8;11448.0;44551.8
353720;201802;355;165;190;157392.0;181260.0;338652.0
353730;201802;1128;692;436;657258.9;415657.8;1072916.8
353740;201802;653;359;294;342199.8;280476.0;622675.8
353750;201802;93;59;34;55754.14;32436.0;88190.14
353760;201802;2732;1038;1694;988193.1;1612473.2;2600666.5
353770;201802;101;82;19;77751.0;18126.0;95877.0
353780;201802;1115;562;553;534431.94;525654.0;1060086.0
353790;201802;509;290;219;274591.1;206041.34;480632.44
353800;201802;3266;1671;1595;1586104.8;1519250.8;3105355.5
353810;201802;238;133;105;126028.71;100143.0;226171.7
353820;201802;182;91;91;86814.0;86189.41;173003.4
353830;201802;48;41;7;39114.0;6678.0;45792.0
353850;201802;165;85;80;81090.0;76320.0;157410.0
353860;201802;463;209;254;198670.5;242029.8;440700.3
353870;201802;4996;2509;2487;2377453.8;2361269.5;4738723.0
353880;201802;671;480;191;456584.4;181260.12;637844.5
353890;201802;592;334;258;318064.0;245846.0;563910.0
353900;201802;134;66;68;62964.0;64872.0;127836.0
353910;201802;177;88;89;83952.0;84906.0;168858.0
353920;201802;454;247;207;234446.4;197035.16;431481.56
353930;201802;995;592;403;563075.8;383227.8;946303.56
353940;201802;188;103;85;97498.8;80232.0;177730.8
353950;201802;511;318;193;303085.8;184113.0;487198.8
353960;201802;70;58;12;55332.0;11448.0;66780.0
353970;201802;76;47;29;44838.0;27666.0;72504.0
353980;201802;1532;755;777;717610.94;740319.75;1457930.8
353990;201802;75;42;33;40068.0;31482.0;71550.0
354000;201802;377;181;196;172007.0;186789.2;358796.2
354010;201802;96;51;45;48654.0;42453.0;91107.0
354020;201802;546;345;201;328176.0;191754.0;519930.0
354025;201802;55;43;12;41022.0;11448.0;52470.0
354030;201802;64;35;29;33390.0;27666.0;61056.0
354040;201802;94;66;28;62582.4;26712.0;89294.4
354050;201802;191;107;84;101792.0;80136.0;181928.0
354060;201802;774;371;403;353934.0;382221.4;736155.4
354070;201802;872;506;366;480558.0;349164.0;829722.0
354075;201802;212;116;96;110569.0;90630.8;201199.8
354080;201802;293;126;167;119917.8;159318.0;279235.8
354085;201802;18;11;7;10494.0;6678.0;17172.0
354090;201802;312;174;138;165915.0;131652.0;297567.0
354100;201802;5469;2273;3196;2157938.5;3042763.0;5200701.5
354105;201802;80;41;39;39114.0;37206.0;76320.0
354110;201802;47;21;26;20034.0;24804.0;44838.0
354120;201802;149;103;46;98122.97;43884.0;142006.97
354130;201802;698;468;230;446234.0;219130.0;665364.0
354140;201802;3166;1473;1693;1401275.4;1613864.0;3015139.5
354150;201802;644;399;245;380340.9;232299.0;612639.94
354160;201802;701;446;255;424291.5;242984.0;667275.5
354165;201802;19;12;7;11448.0;6678.0;18126.0
354170;201802;174;119;55;112858.2;52470.0;165328.2
354180;201802;62;38;24;35926.0;22896.0;58822.0
354190;201802;216;99;117;92824.2;111618.0;204442.2
354200;201802;130;72;58;68211.0;55332.0;123543.0
354210;201802;70;34;36;32436.0;34344.0;66780.0
354220;201802;643;401;242;380747.16;229342.16;610089.3
354230;201802;161;66;95;62964.0;89676.6;152640.6
354240;201802;318;206;112;195570.48;106211.96;301782.44
354250;201802;91;55;36;52470.0;34344.0;86814.0
354260;201802;1912;897;1015;844833.94;966970.0;1811804.0
354270;201802;97;72;25;68688.0;23850.0;92538.0
354280;201802;35;18;17;17172.0;16218.0;33390.0
354290;201802;143;99;44;93635.1;41976.0;135611.1
354300;201802;422;286;136;272527.0;129586.0;402113.0
354310;201802;104;76;28;71550.2;26712.0;98262.2
354320;201802;183;97;86;92538.0;82044.0;174582.0
354323;201802;16;14;2;13356.0;1908.0;15264.0
354325;201802;108;62;46;58342.0;43884.0;102226.0
354330;201802;2566;866;1700;821529.25;1619630.0;2441159.2
354340;201802;10537;5127;5410;4877838.5;5154794.5;1,00E+14
354350;201802;130;87;43;82998.0;40878.9;123876.9
354360;201802;87;48;39;45792.0;37206.0;82998.0
354370;201802;268;144;124;137376.0;118296.0;255672.0
354380;201802;213;130;83;123234.0;79182.0;202416.0
354390;201802;2755;998;1757;951141.94;1674803.0;2625945.0
354400;201802;326;173;153;164088.8;145389.8;309478.6
354410;201802;609;297;312;281712.44;296694.2;578406.6
354420;201802;270;170;100;162180.0;95400.0;257580.0
354425;201802;321;183;138;174582.0;131652.0;306234.0
354430;201802;186;116;70;109089.9;66016.8;175106.7
354440;201802;40;28;12;26712.0;11448.0;38160.0
354450;201802;53;38;15;36252.0;14310.0;50562.0
354460;201802;102;60;42;57240.0;40068.0;97308.0
354470;201802;39;26;13;24804.0;12402.0;37206.0
354480;201802;120;63;57;60093.0;54368.46;114461.46
354490;201802;147;92;55;87608.97;52470.0;140078.97
354500;201802;397;197;200;187938.0;190800.0;378738.0
354510;201802;102;71;31;67734.0;29574.0;97308.0
354515;201802;39;13;26;12402.0;24804.0;37206.0
354520;201802;1616;717;899;681307.2;857207.56;1538514.8
354530;201802;650;340;310;323225.8;294882.2;618108.0
354540;201802;277;157;120;149778.0;114475.23;264253.22
354550;201802;41;23;18;21942.0;17172.0;39114.0
354560;201802;165;97;68;92252.0;64862.46;157114.45
354570;201802;138;90;48;85860.0;45792.0;131652.0
354580;201802;1956;930;1026;884357.0;978504.25;1862861.2
354600;201802;279;149;130;139892.12;124005.69;263897.8
354610;201802;72;65;7;60867.58;6678.0;67545.58
354620;201802;64;21;43;20034.0;41022.0;61056.0
354625;201802;17;11;6;10494.0;5720.0;16214.0
354630;201802;319;210;109;199834.55;103986.0;303820.56
354640;201802;790;506;284;478798.38;270936.0;749734.4
354650;201802;71;40;31;37864.8;29545.92;67410.72
354660;201802;814;603;211;571240.44;201294.0;772534.44
354670;201802;281;100;181;94161.0;171721.0;265882.0
354680;201802;1248;473;775;451242.0;738873.0;1190115.0
354690;201802;91;62;29;58195.0;27666.0;85861.0
354700;201802;76;56;20;53424.0;19080.0;72504.0
354710;201802;58;40;18;37523.96;17172.0;54695.96
354720;201802;20;19;1;18126.0;954.0;19080.0
354730;201802;1903;801;1102;760997.2;1051117.2;1812114.4
354740;201802;57;42;15;40068.0;14310.0;54378.0
354750;201802;442;261;181;248985.0;172674.0;421659.0
354760;201802;520;319;201;301944.0;191181.8;493125.8
354765;201802;11;5;6;4770.0;5724.0;10494.0
354770;201802;334;228;106;216688.03;100360.8;317048.84
354780;201802;8132;3318;4814;3151918.8;4587719.0;7739638.0
354790;201802;113;67;46;63918.0;43884.0;107802.0
354800;201802;417;232;185;221328.0;176185.0;397513.0
354805;201802;103;53;50;49926.0;47700.0;97626.0
354810;201802;137;80;57;76320.0;54378.0;130698.0
354820;201802;184;80;104;76111.0;99216.0;175327.0
354830;201802;40;21;19;20034.0;18126.0;38160.0
354840;201802;55;37;18;35298.0;17172.0;52470.0
354850;201802;4551;2015;2536;1914522.2;2414828.5;4329351.0
354860;201802;330;160;170;152640.0;159785.52;312425.53
354870;201802;11828;5352;6476;5077907.0;6167782.0;1,12E+14
354880;201802;2990;1122;1868;1068750.5;1780476.9;2849227.2
354890;201802;2831;1560;1271;1482724.6;1211494.4;2694219.0
354900;201802;59;39;20;37206.0;19080.0;56286.0
354910;201802;1227;641;586;608614.25;559044.0;1167658.2
354920;201802;50;42;8;40068.0;7632.0;47700.0
354925;201802;12;7;5;6678.0;4770.0;11448.0
354930;201802;30;27;3;25488.0;2862.0;28350.0
354940;201802;794;586;208;557091.2;198432.0;755523.2
354950;201802;221;145;76;137720.0;72504.0;210224.0
354960;201802;170;63;107;60102.0;101792.0;161894.0
354970;201802;841;549;292;518887.1;277929.03;796816.1
354980;201802;8410;3137;5273;2984458.2;5027743.0;8012201.5
354990;201802;9174;4323;4851;4111344.8;4621765.5;8733110.0
354995;201802;509;179;330;170766.0;314362.78;485128.78
355000;201802;450;146;304;139279.23;289062.0;428341.22
355010;201802;614;390;224;372060.0;211484.48;583544.5
355020;201802;714;449;265;427387.6;252802.0;680189.56
355030;201802;203336;78820;124516;7,50E+13;1,19E+16;1,94E+16
355040;201802;715;339;376;321880.3;358513.2;680393.5
355050;201802;152;100;52;94129.77;49608.0;143737.77
355060;201802;1490;749;741;709696.94;705722.3;1415419.2
355070;201802;1465;725;740;687826.4;704967.0;1392793.4
355080;201802;200;115;85;109710.0;80202.8;189912.8
355090;201802;293;193;100;182024.0;95400.0;277424.0
355100;201802;4765;2367;2398;2236966.0;2285814.2;4522780.5
355110;201802;271;171;100;162177.0;95400.0;257577.0
355120;201802;80;55;25;52470.0;23850.0;76320.0
355130;201802;54;28;26;26712.0;24804.0;51516.0
355140;201802;183;121;62;114718.5;59148.0;173866.5
355150;201802;674;406;268;386080.2;255195.0;641275.2
355160;201802;450;217;233;204633.95;221996.0;426629.97
355170;201802;2050;1065;985;1014630.9;939670.94;1954301.8
355180;201802;624;268;356;254718.0;338789.25;593507.25
355190;201802;221;150;71;143100.0;67734.0;210834.0
355200;201802;116;68;48;64872.0;45792.0;110664.0
355210;201802;721;412;309;393048.0;294767.47;687815.44
355220;201802;6601;3535;3066;3361579.8;2916187.0;6277766.5
355230;201802;106;62;44;59148.0;41971.23;101119.23
355240;201802;4213;1850;2363;1752139.1;2250514.0;4002653.0
355250;201802;5363;2621;2742;2493076.2;2612465.0;5105541.5
355255;201802;52;31;21;29574.0;20034.0;49608.0
355260;201802;186;112;74;105875.12;70568.46;176443.58
355270;201802;164;97;67;92538.0;63203.0;155741.0
355280;201802;6333;2663;3670;2535594.5;3496478.5;6032073.0
355290;201802;78;59;19;56286.0;18126.0;74412.0
355300;201802;180;116;64;109424.6;61056.0;170480.6
355310;201802;105;59;46;56286.0;43884.0;100170.0
355320;201802;92;46;46;43884.0;42936.6;86820.6
355330;201802;272;150;122;143100.0;116388.0;259488.0
355340;201802;1485;551;934;523047.62;890294.0;1413341.6
355350;201802;142;74;68;70596.0;64872.0;135468.0
355360;201802;183;116;67;110454.12;63918.0;174372.12
355365;201802;26;21;5;20034.0;4770.0;24804.0
355370;201802;1032;586;446;553167.75;424226.1;977393.8
355380;201802;767;514;253;488910.53;241076.0;729986.5
355385;201802;61;43;18;41022.0;17172.0;58194.0
355390;201802;108;62;46;59148.0;43884.0;103032.0
355395;201802;189;114;75;107434.23;71550.0;178984.23
355400;201802;1548;962;586;913463.5;557231.6;1470695.1
355410;201802;4844;2267;2577;2144441.5;2449982.2;4594423.5
355420;201802;48;36;12;34344.0;11448.0;45792.0
355430;201802;342;209;133;198050.4;126882.0;324932.4
355440;201802;79;46;33;43884.0;31482.0;75366.0
355450;201802;433;205;228;192670.19;216462.8;409133.0
355460;201802;70;54;16;50562.42;15264.0;65826.42
355465;201802;50;31;19;29574.0;18126.0;47700.0
355470;201802;185;72;113;67734.1;107802.0;175536.1
355475;201802;13;8;5;7632.0;4770.0;12402.0
355480;201802;456;200;256;189179.0;242783.45;431962.47
355490;201802;113;80;33;76320.0;31482.0;107802.0
355495;201802;54;26;28;24804.0;26712.0;51516.0
355500;201802;1681;958;723;909306.44;689703.44;1599009.9
355510;201802;269;194;75;181617.67;71550.0;253167.67
355520;201802;36;28;8;26426.0;7632.0;34058.0
355530;201802;23;16;7;15264.0;6678.0;21942.0
355535;201802;78;39;39;37206.0;37206.0;74412.0
355540;201802;2356;939;1417;894347.5;1349615.0;2243962.5
355550;201802;64;39;25;37206.0;23850.0;61056.0
355560;201802;238;120;118;114480.0;111935.96;226415.95
355570;201802;31;20;11;19080.0;10494.0;29574.0
355580;201802;271;189;82;180306.0;77937.23;258243.23
355590;201802;23;14;9;13356.0;8586.0;21942.0
355600;201802;272;140;132;133560.0;125637.23;259197.23
355610;201802;206;135;71;128790.0;67734.0;196524.0
355620;201802;1253;583;670;555371.8;638098.0;1193469.8
355630;201802;407;294;113;279523.0;107802.0;387325.0
355635;201802;125;60;65;57240.0;61997.0;119237.0
355640;201802;568;332;236;315774.16;225144.0;540918.2
355645;201802;828;357;471;339099.3;447454.8;786554.1
355650;201802;2125;893;1232;848478.8;1175309.5;2023788.2
355660;201802;261;139;122;132606.0;116388.0;248994.0
355670;201802;480;189;291;180306.0;277614.0;457920.0
355680;201802;208;119;89;112573.0;84620.0;197193.0
355690;201802;87;40;47;38160.0;44208.0;82368.0
355695;201802;14;12;2;11448.0;1908.0;13356.0
355700;201802;1141;586;555;553974.6;528898.0;1082872.6
355710;201802;2180;1200;980;1141449.5;934319.8;2075769.4
355715;201802;20;18;2;17172.0;1908.0;19080.0
355720;201802;207;124;83;116706.08;79178.0;195884.08
355730;201802;90;52;38;48447.95;36252.0;84699.95
410010;201802;137;115;22;109710.0;20988.0;130698.0
410020;201802;105;94;11;89676.0;10494.0;100170.0
410030;201802;165;105;60;99502.4;57240.0;156742.4
410040;201802;966;528;438;503473.5;417662.0;921135.5
410045;201802;26;21;5;20034.0;4770.0;24804.0
410050;201802;467;259;208;247086.0;197955.0;445041.0
410060;201802;275;212;63;202248.0;60102.0;262350.0
410070;201802;308;254;54;242316.0;51516.0;293832.0
410080;201802;166;108;58;103032.0;55332.0;158364.0
410090;201802;77;68;9;64663.0;8586.0;73249.0
410100;201802;297;214;83;203841.19;78466.5;282307.7
410105;201802;46;27;19;25758.0;18126.0;43884.0
410110;201802;312;193;119;184122.0;113526.0;297648.0
410115;201802;26;18;8;17172.0;7632.0;24804.0
410120;201802;444;227;217;216256.8;207018.0;423274.8
410130;201802;43;26;17;24804.0;16218.0;41022.0
410140;201802;3076;1514;1562;1439431.6;1486800.0;2926231.8
410150;201802;2687;1075;1612;1024397.44;1537538.0;2561935.5
410160;201802;506;320;186;304993.8;177444.0;482437.8
410165;201802;67;45;22;42930.0;20988.0;63918.0
410170;201802;167;125;42;117012.44;40068.0;157080.44
410180;201802;2137;1241;896;1179735.2;852850.1;2032585.4
410185;201802;32;29;3;27666.0;2862.0;30528.0
410190;201802;444;278;166;265212.0;158364.0;423576.0
410200;201802;967;721;246;686984.94;234578.83;921563.75
410210;201802;554;286;268;272844.0;255100.0;527944.0
410220;201802;40;22;18;20988.0;17172.0;38160.0
410230;201802;125;68;57;64872.0;54378.0;119250.0
410240;201802;743;488;255;464979.8;243270.0;708249.8
410250;201802;374;274;100;260791.84;95395.23;356187.06
410260;201802;289;172;117;164088.0;111618.0;275706.0
410270;201802;29;18;11;17172.0;10494.0;27666.0
410275;201802;68;51;17;48654.0;16218.0;64872.0
410280;201802;325;184;141;175276.52;134514.0;309790.53
410290;201802;230;145;85;138330.0;81090.0;219420.0
410300;201802;82;66;16;62964.0;15264.0;78228.0
410302;201802;24;16;8;15264.0;7632.0;22896.0
410304;201802;46;32;14;30528.0;13356.0;43884.0
410305;201802;205;111;94;105086.2;89676.0;194762.2
410310;201802;262;168;94;160272.0;89656.92;249928.92
410315;201802;52;37;15;35274.0;14310.0;49584.0
410320;201802;139;96;43;91584.0;41022.0;132606.0
410322;201802;34;24;10;22896.0;9540.0;32436.0
410330;201802;163;115;48;109710.0;45602.0;155312.0
410335;201802;100;61;39;58194.0;37206.0;95400.0
410337;201802;38;33;5;31482.0;4770.0;36252.0
410340;201802;30;28;2;26712.0;1908.0;28620.0
410345;201802;213;135;78;128790.0;74412.0;203202.0
410347;201802;51;38;13;36252.0;12402.0;48654.0
410350;201802;232;142;90;135182.0;85860.0;221042.0
410360;201802;455;274;181;258852.4;172102.0;430954.4
410370;201802;2379;1013;1366;962521.3;1300167.9;2262689.2
410380;201802;219;142;77;135468.0;73458.0;208926.0
410390;201802;370;277;93;264254.0;88722.0;352976.0
410395;201802;34;22;12;20988.0;11067.0;32055.0
410400;201802;838;430;408;408890.4;388693.0;797583.4
410405;201802;89;66;23;62964.0;21942.0;84906.0
410410;201802;40;31;9;29574.0;8586.0;38160.0
410420;201802;1653;817;836;777323.9;795954.94;1573278.9
410425;201802;181;87;94;82808.0;89676.0;172484.0
410430;201802;2194;1286;908;1223696.0;865354.3;2089050.4
410440;201802;392;287;105;272845.0;100170.0;373015.0
410442;201802;360;241;119;228961.0;113526.0;342487.0
410445;201802;422;290;132;276660.0;125928.0;402588.0
410450;201802;410;203;207;193662.0;197478.0;391140.0
410460;201802;406;218;188;207676.8;179352.0;387028.8
410465;201802;190;123;67;116101.8;63918.0;180019.8
410470;201802;218;140;78;133560.0;74412.0;207972.0
410480;201802;5747;2842;2905;2691494.5;2765255.5;5456750.0
410490;201802;1387;914;473;870281.0;449335.0;1319616.0
410500;201802;265;151;114;144054.0;108756.0;252810.0
410510;201802;180;132;48;125928.0;45783.0;171711.0
410520;201802;262;195;67;186030.0;63918.0;249948.0
410530;201802;235;87;148;82998.0;141188.0;224186.0
410540;201802;318;229;89;217885.6;84901.23;302786.84
410550;201802;1613;702;911;669326.8;867894.4;1537221.1
410560;201802;146;114;32;108756.0;30528.0;139284.0
410570;201802;431;302;129;286020.2;123066.0;409086.2
410580;201802;3182;1427;1755;1359742.8;1672840.0;3032582.8
410590;201802;400;284;116;270936.0;110664.0;381600.0
410600;201802;184;159;25;151686.0;23850.0;175536.0
410610;201802;56;45;11;42930.0;10494.0;53424.0
410620;201802;241;174;67;165996.0;63918.0;229914.0
410630;201802;444;261;183;248994.0;173423.0;422417.0
410640;201802;975;599;376;568468.0;357097.28;925565.25
410645;201802;96;72;24;68307.0;22896.0;91203.0
410650;201802;367;252;115;239454.0;109710.0;349164.0
410655;201802;78;60;18;57240.0;17172.0;74412.0
410657;201802;45;20;25;19080.0;23850.0;42930.0
410660;201802;591;418;173;397529.0;165042.0;562571.0
410670;201802;77;62;15;59148.0;14310.0;73458.0
410680;201802;189;156;33;148157.0;31482.0;179639.0
410685;201802;16;10;6;9540.0;5724.0;15264.0
410690;201802;28373;12319;16054;1,17E+14;1,53E+14;2,70E+14
410700;201802;322;235;87;223618.0;82998.0;306616.0
410710;201802;127;102;25;97308.0;23850.0;121158.0
410712;201802;25;16;9;15264.0;8586.0;23850.0
410715;201802;84;62;22;59148.0;20988.0;80136.0
410720;201802;596;361;235;344394.0;223894.8;568288.8
410725;201802;178;128;50;122112.0;47700.0;169812.0
410730;201802;87;54;33;51516.0;31482.0;82998.0
410740;201802;111;80;31;76320.0;29574.0;105894.0
410750;201802;222;166;56;158360.0;53419.23;211779.23
410752;201802;24;15;9;14310.0;8586.0;22896.0
410753;201802;53;23;30;21269.43;28620.0;49889.43
410754;201802;34;21;13;20034.0;12402.0;32436.0
410755;201802;81;55;26;52183.8;24804.0;76987.8
410760;201802;713;404;309;385416.0;294786.0;680202.0
410765;201802;1665;802;863;758729.7;822148.44;1580878.1
410770;201802;107;90;17;85860.0;16218.0;102078.0
410773;201802;45;34;11;32436.0;10494.0;42930.0
410775;201802;176;133;43;126214.2;41022.0;167236.2
410780;201802;80;43;37;41022.0;35298.0;76320.0
410785;201802;55;43;12;41022.0;11448.0;52470.0
410790;201802;70;33;37;31482.0;35298.0;66780.0
410800;201802;297;187;110;177445.0;104940.0;282385.0
410810;201802;26;22;4;20988.0;3530.0;24518.0
410820;201802;178;132;46;125785.0;43884.0;169669.0
410830;201802;8495;3871;4624;3683725.8;4408863.5;8092589.5
410832;201802;105;72;33;68401.8;31482.0;99883.8
410840;201802;1407;782;625;743760.06;595851.7;1339611.8
410845;201802;63;38;25;36252.0;23850.0;60102.0
410850;201802;190;131;59;124688.0;56286.0;180974.0
410855;201802;48;41;7;39114.0;6678.0;45792.0
410860;201802;666;390;276;371274.75;263304.0;634578.75
410865;201802;105;81;24;77274.0;22896.0;100170.0
410870;201802;154;133;21;126882.0;19743.0;146625.0
410880;201802;1109;554;555;528005.6;529425.0;1057430.6
410890;201802;75;51;24;48654.0;22896.0;71550.0
410895;201802;74;55;19;52470.0;18126.0;70596.0
410900;201802;19;11;8;10494.0;7632.0;18126.0
410910;201802;17;15;2;14310.0;1908.0;16218.0
410920;201802;33;22;11;20988.0;10494.0;31482.0
410930;201802;504;326;178;310792.97;169812.0;480604.97
410940;201802;4333;2581;1752;2453112.2;1668201.4;4121313.5
410950;201802;123;88;35;83952.0;33390.0;117342.0
410960;201802;758;338;420;322166.0;400490.0;722656.0
410965;201802;63;48;15;45505.8;14310.0;59815.8
410970;201802;632;448;184;426924.2;175536.0;602460.2
410975;201802;106;64;42;60545.0;40068.0;100613.0
410980;201802;1565;708;857;672885.8;816615.25;1489501.0
410990;201802;268;181;87;172505.23;82711.8;255217.05
411000;201802;62;40;22;38160.0;20988.0;59148.0
411005;201802;24;19;5;18126.0;4770.0;22896.0
411007;201802;234;135;99;128790.0;94446.0;223236.0
411010;201802;571;397;174;378738.0;165996.0;544734.0
411020;201802;290;200;90;190800.0;85860.0;276660.0
411030;201802;19;10;9;9540.0;8586.0;18126.0
411040;201802;50;35;15;33390.0;14310.0;47700.0
411050;201802;217;172;45;163410.72;42803.12;206213.84
411060;201802;517;350;167;333891.0;159318.0;493209.0
411065;201802;61;53;8;50562.0;7632.0;58194.0
411070;201802;1197;800;397;759004.0;377784.0;1136788.0
411080;201802;244;172;72;164172.0;68688.0;232860.0
411090;201802;117;88;29;83952.0;27666.0;111618.0
411095;201802;262;106;156;100647.0;148814.0;249461.0
411100;201802;113;94;19;89676.0;18126.0;107802.0
411110;201802;122;85;37;81090.0;35298.0;116388.0
411120;201802;182;136;46;129744.0;43884.0;173628.0
411125;201802;179;80;99;75671.28;94446.0;170117.28
411130;201802;125;107;18;101440.0;16885.8;118325.8
411140;201802;178;123;55;117320.12;51945.3;169265.42
411150;201802;1212;815;397;776832.7;378738.0;1155570.6
411155;201802;117;83;34;79182.0;32436.0;111618.0
411160;201802;21;10;11;9540.0;10494.0;20034.0
411170;201802;58;52;6;49321.8;5724.0;55045.8
411180;201802;930;611;319;581368.0;304321.22;885689.25
411190;201802;343;197;146;187270.2;139284.0;326554.2
411200;201802;668;445;223;423259.88;211835.9;635095.8
411210;201802;682;366;316;347614.22;301464.0;649078.2
411220;201802;147;112;35;106848.0;33390.0;140238.0
411230;201802;40;36;4;34344.0;3816.0;38160.0
411240;201802;120;81;39;77274.0;37206.0;114480.0
411250;201802;420;306;114;291924.0;108756.0;400680.0
411260;201802;21;15;6;14310.0;5724.0;20034.0
411270;201802;296;161;135;153594.0;128790.0;282384.0
411275;201802;201;177;24;168142.6;22896.0;191038.6
411280;201802;227;163;64;154231.12;61056.0;215287.12
411290;201802;58;43;15;41022.0;14310.0;55332.0
411295;201802;143;114;29;108756.0;27666.0;136422.0
411300;201802;70;36;34;34344.0;32436.0;66780.0
411310;201802;91;69;22;65826.0;20988.0;86814.0
411320;201802;755;550;205;523174.4;193967.28;717141.7
411325;201802;44;27;17;25758.0;16218.0;41976.0
411330;201802;919;584;335;555610.6;318859.6;874470.2
411340;201802;25;17;8;16218.0;7318.0;23536.0
411342;201802;76;55;21;52470.0;20034.0;72504.0
411345;201802;123;60;63;57240.0;60102.0;117342.0
411350;201802;480;383;97;364142.12;91575.2;455717.34
411360;201802;55;36;19;34344.0;18126.0;52470.0
411370;201802;14076;5765;8311;5481741.0;7915217.0;1,34E+14
411373;201802;192;142;50;135530.0;47700.0;183230.0
411375;201802;74;61;13;58194.0;12402.0;70596.0
411380;201802;93;69;24;65826.0;22896.0;88722.0
411390;201802;136;90;46;85860.0;43884.0;129744.0
411400;201802;351;263;88;250893.0;83952.0;334845.0
411410;201802;448;229;219;217798.2;208640.0;426438.2
411420;201802;1027;468;559;444182.4;532399.0;976581.4
411430;201802;404;261;143;248326.2;136413.0;384739.2
411435;201802;35;23;12;21942.0;11448.0;33390.0
411440;201802;474;377;97;358004.75;92538.0;450542.75
411450;201802;429;356;73;339624.0;69642.0;409266.0
411460;201802;740;295;445;280485.2;423247.97;703733.2
411470;201802;90;66;24;62964.0;22896.0;85860.0
411480;201802;624;352;272;334282.6;258915.6;593198.2
411490;201802;292;182;110;173628.0;104940.0;278568.0
411500;201802;111;94;17;89363.47;15837.0;105200.47
411510;201802;217;175;42;166202.06;40068.0;206270.06
411520;201802;5920;2308;3612;2196867.0;3437238.0;5634105.0
411530;201802;110;74;36;70596.0;34344.0;104940.0
411535;201802;45;18;27;17172.0;25758.0;42930.0
411540;201802;347;240;107;227937.9;102078.0;330015.9
411545;201802;55;39;16;37206.0;15264.0;52470.0
411550;201802;74;57;17;54378.0;16218.0;70596.0
411560;201802;384;179;205;170102.38;195570.0;365672.38
411570;201802;786;301;485;286859.0;462500.0;749359.0
411573;201802;33;20;13;19080.0;12402.0;31482.0
411575;201802;262;161;101;153594.0;96354.0;249948.0
411580;201802;1230;486;744;462337.03;707928.4;1170265.4
411585;201802;78;39;39;37206.0;37206.0;74412.0
411590;201802;24;17;7;16218.0;6678.0;22896.0
411600;201802;26;10;16;9540.0;15264.0;24804.0
411605;201802;239;108;131;102889.0;124974.0;227863.0
411610;201802;237;159;78;151686.0;74412.0;226098.0
411620;201802;358;201;157;191563.2;149139.0;340702.2
411630;201802;57;38;19;36252.0;18126.0;54378.0
411640;201802;35;29;6;27666.0;5724.0;33390.0
411650;201802;14;10;4;9540.0;3816.0;13356.0
411660;201802;31;25;6;23850.0;5724.0;29574.0
411670;201802;247;188;59;179352.0;56286.0;235638.0
411680;201802;154;132;22;125928.0;20988.0;146916.0
411690;201802;606;322;284;306589.44;270594.72;577184.2
411695;201802;62;46;16;43884.0;15264.0;59148.0
411700;201802;167;145;22;138330.0;20988.0;159318.0
411705;201802;100;65;35;62010.0;33390.0;95400.0
411710;201802;300;202;98;191641.81;93492.0;285133.8
411720;201802;136;87;49;82998.0;46746.0;129744.0
411721;201802;58;48;10;45792.0;9540.0;55332.0
411722;201802;99;43;56;41022.0;53424.0;94446.0
411725;201802;146;112;34;106532.0;32436.0;138968.0
411727;201802;72;56;16;53424.0;14977.8;68401.8
411729;201802;31;24;7;22896.0;6678.0;29574.0
411730;201802;545;354;191;336125.97;181928.0;518053.97
411740;201802;30;19;11;18126.0;10494.0;28620.0
411745;201802;66;44;22;41185.0;20988.0;62173.0
411750;201802;868;411;457;390997.9;435000.16;825998.06
411760;201802;1174;886;288;843995.2;274743.0;1118738.2
411770;201802;438;293;145;279502.9;138330.0;417832.9
411780;201802;368;238;130;227052.0;124020.0;351072.0
411790;201802;533;299;234;283364.47;223123.14;506487.62
411800;201802;173;136;37;129744.0;35298.0;165042.0
411810;201802;165;128;37;122112.0;35298.0;157410.0
411820;201802;2099;1024;1075;974587.5;1024826.3;1999413.9
411830;201802;13;13;0;12402.0;0.0;12402.0
411840;201802;1961;1221;740;1162639.8;705467.0;1868106.8
411845;201802;49;17;32;16218.0;30528.0;46746.0
411850;201802;1247;719;528;683436.06;501759.03;1185195.1
411860;201802;44;28;16;26426.0;15264.0;41690.0
411870;201802;68;49;19;46746.0;17839.8;64585.8
411880;201802;426;276;150;263048.0;142355.88;405403.88
411885;201802;104;69;35;65826.0;33390.0;99216.0
411890;201802;324;207;117;195284.98;111608.46;306893.44
411900;201802;69;50;19;47700.0;18126.0;65826.0
411910;201802;167;137;30;130688.46;27780.48;158468.94
411915;201802;2092;903;1189;860309.56;1133242.0;1993551.6
411920;201802;124;102;22;97308.0;20988.0;118296.0
411925;201802;13;8;5;7632.0;4770.0;12402.0
411930;201802;799;590;209;560954.0;199386.0;760340.0
411940;201802;586;420;166;400203.0;158339.56;558542.56
411950;201802;896;473;423;450574.2;402556.25;853130.44
411960;201802;974;691;283;656842.0;269982.0;926824.0
411965;201802;24;16;8;15264.0;7632.0;22896.0
411970;201802;70;63;7;60102.0;6678.0;66780.0
411980;201802;198;130;68;124020.0;64872.0;188892.0
411990;201802;4912;2867;2045;2718814.8;1948870.6;4667685.5
411995;201802;458;172;286;164088.0;272844.0;436932.0
412000;201802;292;174;118;164804.56;112562.46;277367.03
412010;201802;44;27;17;25758.0;16218.0;41976.0
412015;201802;44;31;13;29574.0;12402.0;41976.0
412020;201802;28;25;3;23563.8;2862.0;26425.8
412030;201802;64;54;10;51516.0;9540.0;61056.0
412033;201802;55;35;20;33366.0;19080.0;52446.0
412035;201802;66;43;23;41022.0;21942.0;62964.0
412040;201802;36;25;11;23564.0;10494.0;34058.0
412050;201802;200;149;51;142146.0;48654.0;190800.0
412060;201802;750;587;163;557136.75;154511.8;711648.56
412065;201802;51;35;16;33390.0;15264.0;48654.0
412070;201802;154;103;51;97594.2;48654.0;146248.2
412080;201802;280;147;133;140238.0;126882.0;267120.0
412085;201802;33;16;17;15264.0;16218.0;31482.0
412090;201802;741;465;276;441655.2;263304.0;704959.2
412100;201802;248;208;40;197479.0;38160.0;235639.0
412110;201802;71;57;14;54378.0;13069.8;67447.8
412120;201802;312;203;109;193089.6;103986.0;297075.6
412125;201802;75;45;30;42643.8;28620.0;71263.8
412130;201802;49;35;14;33390.0;13356.0;46746.0
412135;201802;28;15;13;14310.0;12402.0;26712.0
412140;201802;305;217;88;206378.81;83952.0;290330.8
412150;201802;259;175;84;165996.05;80136.0;246132.05
412160;201802;83;48;35;45792.0;33390.0;79182.0
412170;201802;634;452;182;430921.8;173628.0;604549.8
412175;201802;40;29;11;27666.0;10494.0;38160.0
412180;201802;198;157;41;149178.61;38493.9;187672.52
412190;201802;331;265;66;252137.44;62964.0;315101.44
412200;201802;191;123;68;117342.0;64872.0;182214.0
412210;201802;73;57;16;54378.0;15264.0;69642.0
412215;201802;244;168;76;159986.0;72217.8;232203.8
412217;201802;70;55;15;52470.0;14310.0;66780.0
412220;201802;825;618;207;589572.0;197478.0;787050.0
412230;201802;335;203;132;192020.2;125909.46;317929.66
412240;201802;1323;650;673;615657.0;639961.44;1255618.4
412250;201802;380;246;134;234684.0;127836.0;362520.0
412260;201802;126;94;32;89676.0;30528.0;120204.0
412265;201802;168;134;34;127836.0;32436.0;160272.0
412270;201802;84;52;32;49608.0;30528.0;80136.0
412280;201802;89;70;19;66780.0;18126.0;84906.0
412290;201802;92;63;29;60102.0;27666.0;87768.0
412300;201802;216;139;77;132606.0;73314.9;205920.9
412310;201802;43;36;7;34344.0;6678.0;41022.0
412320;201802;94;80;14;76320.0;13356.0;89676.0
412330;201802;170;151;19;144007.0;18126.0;162133.0
412340;201802;144;100;44;95400.0;41690.0;137090.0
412350;201802;593;294;299;279188.3;285246.0;564434.3
412360;201802;27;24;3;22896.0;2862.0;25758.0
412370;201802;160;136;24;128790.0;22896.0;151686.0
412380;201802;256;193;63;183835.8;59692.5;243528.3
412382;201802;47;25;22;23850.0;20988.0;44838.0
412385;201802;137;99;38;94446.0;36252.0;130698.0
412390;201802;277;207;70;197478.0;66780.0;264258.0
412395;201802;65;51;14;48654.0;13356.0;62010.0
412400;201802;69;50;19;47700.0;18126.0;65826.0
412402;201802;242;112;130;106843.23;123733.8;230577.03
412405;201802;819;327;492;310500.44;468691.66;779192.06
412410;201802;937;587;350;558472.0;333900.0;892372.0
412420;201802;15;12;3;11448.0;2862.0;14310.0
412430;201802;22;15;7;14310.0;6678.0;20988.0
412440;201802;599;323;276;305829.94;261439.95;567269.9
412450;201802;83;69;14;65826.0;13356.0;79182.0
412460;201802;82;65;17;62010.0;16218.0;78228.0
412470;201802;259;205;54;195570.0;51516.0;247086.0
412480;201802;174;134;40;126882.9;38160.0;165042.9
412490;201802;166;140;26;133560.0;24804.0;158364.0
412500;201802;476;389;87;369245.8;82998.0;452243.8
412510;201802;186;153;33;145215.0;31482.0;176697.0
412520;201802;131;70;61;66780.0;58194.0;124974.0
412530;201802;108;58;50;55332.0;47413.8;102745.8
412535;201802;108;80;28;76302.0;26712.0;103014.0
412540;201802;64;31;33;29574.0;31482.0;61056.0
412545;201802;99;72;27;68688.0;25758.0;94446.0
412550;201802;3498;1581;1917;1504070.8;1827387.9;3331458.8
412555;201802;13;9;4;8586.0;3816.0;12402.0
412560;201802;586;440;146;417170.2;139284.0;556454.2
412570;201802;731;408;323;387381.25;307856.0;695237.25
412575;201802;83;58;25;55332.0;23850.0;79182.0
412580;201802;163;111;52;105894.0;49608.0;155502.0
412590;201802;33;31;2;29574.0;1908.0;31482.0
412600;201802;173;131;42;124974.0;40068.0;165042.0
412610;201802;31;19;12;18126.0;11448.0;29574.0
412620;201802;147;128;19;122112.0;18126.0;140238.0
412625;201802;2179;1168;1011;1111470.2;962616.56;2074086.8
412627;201802;69;56;13;53424.0;12402.0;65826.0
412630;201802;426;285;141;270259.2;134228.0;404487.2
412635;201802;62;20;42;19080.0;40068.0;59148.0
412640;201802;118;79;39;75366.0;37206.0;112572.0
412650;201802;340;212;128;201961.8;122107.23;324069.03
412660;201802;486;293;193;278807.0;184122.0;462929.0
412665;201802;50;44;6;41976.0;5724.0;47700.0
412667;201802;288;194;94;184167.33;89360.92;273528.25
412670;201802;61;51;10;48654.0;9540.0;58194.0
412680;201802;289;227;62;216558.0;59148.0;275706.0
412690;201802;113;74;39;70596.0;36920.0;107516.0
412700;201802;165;111;54;105894.0;51230.0;157124.0
412710;201802;1403;868;535;822350.6;507910.0;1330260.6
412720;201802;229;156;73;148824.0;69642.0;218466.0
412730;201802;206;163;43;155502.0;40068.0;195570.0
412740;201802;418;225;193;214506.9;184122.0;398628.9
412750;201802;459;265;194;251856.0;185076.0;436932.0
412760;201802;256;131;125;124974.0;119250.0;244224.0
412770;201802;2080;1180;900;1121337.0;857056.2;1978393.1
412780;201802;149;118;31;112572.0;29574.0;142146.0
412785;201802;267;136;131;129267.0;124974.0;254241.0
412788;201802;35;21;14;20034.0;13356.0;33390.0
412790;201802;141;115;26;109042.2;24804.0;133846.2
412795;201802;156;117;39;111618.0;37206.0;148824.0
412796;201802;299;207;92;196313.19;87634.44;283947.62
412800;201802;559;366;193;348604.38;184122.0;532726.4
412810;201802;3003;1670;1333;1588582.5;1270437.0;2859019.5
412820;201802;919;599;320;560609.2;303133.88;863743.06
412830;201802;16;13;3;12402.0;2862.0;15264.0
412840;201802;215;154;61;145962.2;58194.0;204156.2
412850;201802;776;530;246;504666.0;234684.0;739350.0
412853;201802;174;91;83;86814.0;79182.0;165996.0
412855;201802;221;121;100;114322.82;95400.0;209722.81
412860;201802;91;68;23;64872.0;21942.0;86814.0
412862;201802;59;44;15;41689.8;14310.0;55999.8
412863;201802;7;6;1;5724.0;954.0;6678.0
412865;201802;42;32;10;30528.0;9540.0;40068.0
412870;201802;107;71;36;67734.0;34344.0;102078.0
412880;201802;103;77;26;73458.0;24804.0;98262.0
420005;201802;35;32;3;30528.0;2290.0;32818.0
420010;201802;368;241;127;228726.34;121158.0;349884.34
420020;201802;75;64;11;61056.0;10494.0;71550.0
420030;201802;28;25;3;23850.0;2862.0;26712.0
420040;201802;105;80;25;76320.0;23850.0;100170.0
420050;201802;55;33;22;31482.0;20988.0;52470.0
420055;201802;20;19;1;18126.0;954.0;19080.0
420060;201802;32;23;9;21942.0;8586.0;30528.0
420070;201802;101;87;14;82998.0;13346.46;96344.46
420075;201802;13;11;2;10494.0;1908.0;12402.0
420080;201802;49;43;6;40115.7;5724.0;45839.7
420090;201802;35;33;2;30704.49;1908.0;32612.49
420100;201802;159;133;26;125928.2;24804.0;150732.2
420110;201802;18;18;0;17172.0;0.0;17172.0
420120;201802;43;32;11;30528.0;10494.0;41022.0
420125;201802;81;64;17;61056.0;16218.0;77274.0
420127;201802;33;30;3;28620.0;2862.0;31482.0
420130;201802;385;247;138;235342.45;131403.95;366746.4
420140;201802;1264;741;523;705529.4;498876.0;1204405.4
420150;201802;48;41;7;39114.0;6678.0;45792.0
420160;201802;40;38;2;36252.0;1908.0;38160.0
420165;201802;17;13;4;12402.0;3816.0;16218.0
420170;201802;64;42;22;40068.0;20988.0;61056.0
420180;201802;23;22;1;20988.0;954.0;21942.0
420190;201802;31;28;3;26712.0;2862.0;29574.0
420195;201802;125;60;65;57240.0;61870.0;119110.0
420200;201802;1271;567;704;536911.6;670292.06;1207203.6
420205;201802;66;33;33;31482.0;31482.0;62964.0
420207;201802;108;62;46;59148.0;43874.46;103022.46
420208;201802;23;18;5;17172.0;3911.4;21083.4
420209;201802;20;16;4;15264.0;3816.0;19080.0
420210;201802;464;220;244;209593.8;232681.14;442274.94
420213;201802;47;37;10;35298.0;9540.0;44838.0
420215;201802;26;22;4;20988.0;3816.0;24804.0
420220;201802;70;45;25;42930.0;23850.0;66780.0
420230;201802;738;427;311;406595.0;296398.47;702993.44
420240;201802;2271;1534;737;1455868.1;702659.2;2158527.2
420243;201802;36;29;7;27666.0;6678.0;34344.0
420245;201802;102;58;44;55332.0;41976.0;97308.0
420250;201802;54;31;23;29574.0;21942.0;51516.0
420253;201802;40;32;8;30528.0;7632.0;38160.0
420257;201802;11;9;2;8586.0;1908.0;10494.0
420260;201802;99;87;12;82998.0;11448.0;94446.0
420270;201802;36;30;6;28616.0;5724.0;34340.0
420280;201802;280;205;75;193837.06;70292.1;264129.16
420285;201802;20;12;8;11448.0;7632.0;19080.0
420287;201802;50;31;19;29574.0;18126.0;47700.0
420290;201802;974;686;288;653458.2;274684.3;928142.5
420300;201802;1381;1086;295;1031466.4;278958.25;1310424.6
420310;201802;58;44;14;41976.0;13356.0;55332.0
420315;201802;36;32;4;30528.0;3816.0;34344.0
420320;201802;848;429;419;408288.16;399722.0;808010.1
420325;201802;0;0;0;0.0;0.0;0.0
420330;201802;119;81;38;77274.0;36137.52;113411.52
420340;201802;155;106;49;100162.0;46726.92;146888.92
420350;201802;245;179;66;169145.0;62964.0;232109.0
420360;201802;748;571;177;542808.2;167237.78;710045.94
420370;201802;107;69;38;65636.0;35966.0;101602.0
420380;201802;1139;819;320;777502.5;304234.03;1081736.5
420390;201802;252;162;90;153289.52;85144.5;238434.02
420395;201802;187;135;52;128790.0;49598.46;178388.45
420400;201802;246;181;65;172102.0;62010.0;234112.0
420410;201802;58;45;13;42930.0;12402.0;55332.0
420415;201802;35;32;3;30528.0;2862.0;33390.0
420417;201802;46;34;12;32436.0;11428.92;43864.92
420419;201802;11;11;0;10494.0;0.0;10494.0
420420;201802;2786;1703;1083;1613666.2;1030598.9;2644265.0
420425;201802;69;59;10;56277.0;9226.26;65503.26
420430;201802;1273;883;390;839390.75;370314.2;1209704.9
420435;201802;16;14;2;13356.0;1908.0;15264.0
420440;201802;108;74;34;69968.68;32263.6;102232.28
420445;201802;23;21;2;20034.0;1908.0;21942.0
420450;201802;79;37;42;35289.0;40068.0;75357.0
420455;201802;246;187;59;178369.92;56203.92;234573.84
420460;201802;2335;1557;778;1480693.5;741987.9;2222681.5
420470;201802;120;85;35;81090.0;33390.0;114480.0
420475;201802;6;6;0;5724.0;0.0;5724.0
420480;201802;848;633;215;597391.0;204156.2;801547.2
420490;201802;113;88;25;83952.0;23850.0;107802.0
420500;201802;673;285;388;270205.2;370152.0;640357.2
420510;201802;20;17;3;16218.0;2862.0;19080.0
420515;201802;25;20;5;19080.0;4770.0;23850.0
420517;201802;12;12;0;11448.0;0.0;11448.0
420519;201802;0;0;0;0.0;0.0;0.0
420520;201802;67;50;17;47700.0;16218.0;63918.0
420530;201802;162;110;52;103965.02;49608.0;153573.02
420535;201802;20;18;2;17172.0;1908.0;19080.0
420540;201802;4752;2808;1944;2666445.2;1849941.0;4516386.5
420543;201802;23;23;0;21942.0;0.0;21942.0
420545;201802;195;139;56;131652.0;53404.92;185056.92
420550;201802;843;675;168;642005.3;160114.73;802120.06
420555;201802;42;30;12;28620.0;11448.0;40068.0
420560;201802;62;49;13;46364.4;12402.0;58766.4
420570;201802;141;79;62;75366.0;59138.46;134504.45
420580;201802;303;133;170;126882.0;161894.0;288776.0
420590;201802;505;358;147;341245.8;140238.0;481483.8
420600;201802;93;47;46;44838.0;43884.0;88722.0
420610;201802;37;35;2;33104.0;1908.0;35012.0
420620;201802;72;59;13;56286.0;12402.0;68688.0
420630;201802;150;108;42;103028.0;40064.0;143092.0
420640;201802;95;84;11;79674.69;10494.0;90168.69
420650;201802;236;126;110;119536.2;104321.23;223857.44
420660;201802;55;41;14;38350.8;13356.0;51706.8
420665;201802;38;29;9;27380.0;8586.0;35966.0
420670;201802;317;238;79;226326.95;75347.46;301674.4
420675;201802;15;14;1;13356.0;954.0;14310.0
420680;201802;36;26;10;24804.0;9540.0;34344.0
420690;201802;176;147;29;140238.0;27666.0;167904.0
420700;201802;620;428;192;408228.3;182944.44;591172.75
420710;201802;146;87;59;82998.0;55999.8;138997.8
420720;201802;107;87;20;82998.0;19080.0;102078.0
420730;201802;529;338;191;321413.6;180919.12;502332.7
420740;201802;45;44;1;41976.0;954.0;42930.0
420750;201802;493;328;165;312625.8;157410.0;470035.8
420757;201802;18;15;3;13499.1;2862.0;16361.1
420760;201802;39;30;9;28620.0;8586.0;37206.0
420765;201802;71;59;12;56286.0;11448.0;67734.0
420768;201802;67;59;8;56286.0;7632.0;63918.0
420770;201802;86;72;14;68688.0;13356.0;82044.0
420775;201802;47;44;3;41022.0;2862.0;43884.0
420780;201802;237;185;52;176480.45;49608.0;226088.45
420785;201802;13;9;4;8586.0;3816.0;12402.0
420790;201802;179;149;30;141805.8;27638.46;169444.27
420800;201802;77;58;19;54568.8;18126.0;72694.8
420810;201802;249;214;35;204147.0;32579.1;236726.1
420820;201802;2308;1380;928;1310167.1;883777.06;2193944.2
420830;201802;558;316;242;299182.84;229904.45;529087.3
420840;201802;145;110;35;104940.0;32686.0;137626.0
420845;201802;451;201;250;191083.06;237260.0;428343.06
420850;201802;227;180;47;171720.0;44838.0;216558.0
420860;201802;62;53;9;50562.0;8586.0;59148.0
420870;201802;119;87;32;82998.0;30528.0;113526.0
420880;201802;171;118;53;111894.66;50562.0;162456.66
420890;201802;863;427;436;404269.84;415649.0;819918.8
420895;201802;10;10;0;9540.0;0.0;9540.0
420900;201802;417;326;91;308945.03;86785.92;395730.97
420910;201802;5810;3254;2556;3094816.2;2434015.0;5528831.5
420915;201802;80;73;7;69642.0;6678.0;76320.0
420917;201802;18;13;5;12402.0;4770.0;17172.0
420920;201802;23;15;8;14310.0;7632.0;21942.0
420930;201802;2616;1588;1028;1507269.6;973888.2;2481157.8
420940;201802;594;434;160;412691.6;150988.08;563679.7
420945;201802;8;6;2;5724.0;1908.0;7632.0
420950;201802;56;50;6;47700.0;5724.0;53424.0
420960;201802;115;89;26;84868.92;24795.0;109663.92
420970;201802;304;244;60;231100.84;57212.46;288313.3
420980;201802;25;24;1;22896.0;954.0;23850.0
420985;201802;64;55;9;52470.0;8586.0;61056.0
420990;201802;67;52;15;49608.0;14310.0;63918.0
421000;201802;32;21;11;20034.0;10494.0;30528.0
421003;201802;67;44;23;41976.0;21933.0;63909.0
421005;201802;8;5;3;4770.0;2862.0;7632.0
421010;201802;767;543;224;516494.9;211636.0;728130.94
421020;201802;29;24;5;22896.0;4770.0;27666.0
421030;201802;128;108;20;102699.0;19080.0;121779.0
421040;201802;68;58;10;55332.0;9540.0;64872.0
421050;201802;307;219;88;206827.2;83952.0;290779.2
421055;201802;25;21;4;20034.0;3816.0;23850.0
421060;201802;83;56;27;53424.0;25758.0;79182.0
421070;201802;51;46;5;43884.0;4770.0;48654.0
421080;201802;35;32;3;30528.0;2862.0;33390.0
421085;201802;24;19;5;18126.0;4770.0;22896.0
421090;201802;42;32;10;30528.0;9540.0;40068.0
421100;201802;126;93;33;88722.0;31482.0;120204.0
421105;201802;218;177;41;168428.8;39090.69;207519.48
421110;201802;111;91;20;86193.9;19080.0;105273.9
421120;201802;151;119;32;113030.46;30508.92;143539.38
421125;201802;14;10;4;9540.0;3816.0;13356.0
421130;201802;805;518;287;493042.06;272758.53;765800.56
421140;201802;29;21;8;19318.5;7632.0;26950.5
421145;201802;40;31;9;29574.0;8586.0;38160.0
421150;201802;108;78;30;74412.0;28620.0;103032.0
421160;201802;62;41;21;39104.46;20034.0;59138.46
421165;201802;19;17;2;16218.0;1908.0;18126.0
421170;201802;191;165;26;156382.84;24795.0;181177.84
421175;201802;149;97;52;92538.0;49569.92;142107.92
421180;201802;57;36;21;33982.0;20034.0;54016.0
421185;201802;17;14;3;13356.0;2862.0;16218.0
421187;201802;0;0;0;0.0;0.0;0.0
421189;201802;38;30;8;28620.0;7622.46;36242.46
421190;201802;1481;909;572;866137.0;544938.56;1411075.6
421200;201802;88;66;22;62011.0;20988.0;82999.0
421205;201802;24;16;8;15264.0;7622.46;22886.46
421210;201802;179;121;58;115434.0;55332.0;170766.0
421220;201802;275;218;57;207105.9;54378.0;261483.9
421223;201802;56;47;9;44838.0;8586.0;53424.0
421225;201802;62;43;19;41022.0;18126.0;59148.0
421227;201802;95;72;23;68688.0;21942.0;90630.0
421230;201802;49;36;13;34344.0;12402.0;46746.0
421240;201802;20;20;0;19080.0;0.0;19080.0
421250;201802;357;220;137;209785.0;129906.18;339691.2
421260;201802;28;23;5;21942.0;4770.0;26712.0
421265;201802;0;0;0;0.0;0.0;0.0
421270;201802;51;46;5;43884.0;4770.0;48654.0
421280;201802;331;187;144;178112.0;135658.8;313770.8
421290;201802;316;212;104;202010.0;97805.76;299815.75
421300;201802;25;20;5;19080.0;4770.0;23850.0
421310;201802;54;41;13;38446.2;12402.0;50848.2
421315;201802;28;20;8;19080.0;7632.0;26712.0
421320;201802;133;96;37;91584.0;35298.0;126882.0
421330;201802;110;86;24;79639.92;22887.0;102526.92
421335;201802;40;26;14;24804.0;13356.0;38160.0
421340;201802;292;198;94;187024.05;89676.0;276700.06
421350;201802;168;100;68;94957.0;64872.0;159829.0
421360;201802;689;507;182;477339.72;173419.45;650759.2
421370;201802;189;144;45;137376.0;42596.1;179972.1
421380;201802;132;106;26;101119.23;24804.0;125923.23
421390;201802;18;14;4;13356.0;3816.0;17172.0
421400;201802;113;95;18;90630.0;17172.0;107802.0
421410;201802;23;18;5;17172.0;4770.0;21942.0
421415;201802;21;20;1;19080.0;954.0;20034.0
421420;201802;148;122;26;115815.6;24517.8;140333.4
421430;201802;14;11;3;10494.0;2862.0;13356.0
421440;201802;61;47;14;44838.0;13356.0;58194.0
421450;201802;98;85;13;81090.0;12402.0;93492.0
421460;201802;60;51;9;47849.77;8586.0;56435.77
421470;201802;69;45;24;42930.0;22896.0;65826.0
421480;201802;632;467;165;445041.0;157401.0;602442.0
421490;201802;22;21;1;19358.0;954.0;20312.0
421500;201802;514;330;184;313732.7;175258.44;488991.12
421505;201802;25;18;7;17172.0;6678.0;23850.0
421507;201802;32;26;6;24804.0;5724.0;30528.0
421510;201802;72;46;26;43884.0;24422.4;68306.4
421520;201802;64;56;8;52661.0;7632.0;60293.0
421530;201802;54;49;5;46746.0;4770.0;51516.0
421535;201802;29;28;1;26445.0;954.0;27399.0
421540;201802;60;52;8;49608.0;7632.0;57240.0
421545;201802;98;76;22;72018.0;20988.0;93006.0
421550;201802;284;207;77;196811.0;73458.0;270269.0
421555;201802;27;22;5;20988.0;4675.0;25663.0
421560;201802;7;7;0;6678.0;0.0;6678.0
421565;201802;124;92;32;87768.0;30528.0;118296.0
421567;201802;29;24;5;22896.0;4770.0;27666.0
421568;201802;33;31;2;29574.0;1908.0;31482.0
421569;201802;8;8;0;7632.0;0.0;7632.0
421570;201802;141;95;46;90630.0;43884.0;134514.0
421575;201802;27;22;5;20725.65;4770.0;25495.65
421580;201802;718;435;283;413368.8;269028.34;682397.1
421590;201802;20;19;1;18126.0;954.0;19080.0
421600;201802;110;76;34;72504.0;31197.0;103701.0
421605;201802;103;74;29;70263.0;27666.0;97929.0
421610;201802;188;148;40;141192.0;38160.0;179352.0
421620;201802;1103;660;443;627140.94;422602.9;1049743.9
421625;201802;21;18;3;17172.0;2862.0;20034.0
421630;201802;276;177;99;168811.0;93588.0;262399.0
421635;201802;17;8;9;7632.0;8586.0;16218.0
421640;201802;101;87;14;82998.0;13356.0;96354.0
421650;201802;276;160;116;152620.92;110644.92;263265.84
421660;201802;2077;1248;829;1187389.2;790552.25;1977941.5
421670;201802;179;128;51;122112.0;48654.0;170766.0
421680;201802;166;151;15;144054.0;14301.0;158355.0
421690;201802;350;243;107;230841.0;101114.58;331955.6
421700;201802;57;35;22;33390.0;20130.0;53520.0
421710;201802;25;25;0;23850.0;0.0;23850.0
421715;201802;11;10;1;9540.0;954.0;10494.0
421720;201802;586;423;163;400925.4;153775.27;554700.7
421725;201802;14;7;7;6678.0;6678.0;13356.0
421730;201802;42;29;13;26936.24;12402.0;39338.24
421740;201802;83;40;43;38160.0;41022.0;79182.0
421750;201802;217;160;57;150040.28;54378.0;204418.28
421755;201802;24;23;1;21942.0;954.0;22896.0
421760;201802;101;71;30;67724.46;28620.0;96344.46
421770;201802;567;380;187;360322.38;178332.3;538654.7
421775;201802;25;16;9;15264.0;8586.0;23850.0
421780;201802;193;153;40;145962.0;38160.0;184122.0
421790;201802;153;128;25;121873.5;23850.0;145723.5
421795;201802;17;14;3;13356.0;2862.0;16218.0
421800;201802;464;300;164;285403.3;156456.0;441859.3
421810;201802;66;53;13;50562.0;12402.0;62964.0
421820;201802;298;203;95;192994.2;90630.0;283624.2
421825;201802;127;106;21;101124.0;20034.0;121158.0
421830;201802;126;97;29;92538.0;27666.0;120204.0
421835;201802;3;3;0;2862.0;0.0;2862.0
421840;201802;61;51;10;48645.0;9540.0;58185.0
421850;201802;78;68;10;64872.0;9536.0;74408.0
421860;201802;40;32;8;30311.14;7632.0;37943.14
421870;201802;978;739;239;696104.6;227148.98;923253.6
421875;201802;52;46;6;43884.0;5724.0;49608.0
421880;201802;161;117;44;111618.0;41690.0;153308.0
421885;201802;28;23;5;21942.0;4770.0;26712.0
421890;201802;111;78;33;74412.0;31482.0;105894.0
421895;201802;39;36;3;34344.0;2862.0;37206.0
421900;201802;149;123;26;117267.3;24759.0;142026.3
421910;201802;65;43;22;41022.0;20988.0;62010.0
421915;201802;32;26;6;24804.0;5724.0;30528.0
421917;201802;40;29;11;27666.0;10494.0;38160.0
421920;201802;32;29;3;27666.0;2862.0;30528.0
421930;201802;747;576;171;547777.25;163097.45;710874.75
421935;201802;57;50;7;47700.0;6678.0;54378.0
421940;201802;38;36;2;34344.0;1908.0;36252.0
421950;201802;824;544;280;513037.88;264624.3;777662.2
421960;201802;39;35;4;33104.0;3816.0;36920.0
421970;201802;375;236;139;224645.12;132575.12;357220.25
421985;201802;29;19;10;18126.0;9540.0;27666.0
422000;201802;0;0;0;0.0;0.0;0.0
430003;201802;204;48;156;45076.5;148824.0;193900.5
430005;201802;36;28;8;26712.0;7632.0;34344.0
430010;201802;280;197;83;187461.0;79182.0;266643.0
430020;201802;151;98;53;93206.0;49608.0;142814.0
430030;201802;127;99;28;94159.8;26712.0;120871.8
430040;201802;2983;1735;1248;1647125.2;1188962.5;2836087.8
430045;201802;69;59;10;56000.0;9540.0;65540.0
430047;201802;6;5;1;4770.0;954.0;5724.0
430050;201802;81;68;13;64872.0;12402.0;77274.0
430055;201802;17;14;3;13356.0;2862.0;16218.0
430057;201802;4;2;2;1908.0;1908.0;3816.0
430060;201802;3688;2195;1493;2086786.8;1420777.6;3507564.2
430063;201802;57;52;5;49608.0;4770.0;54378.0
430064;201802;146;123;23;117342.0;21942.0;139284.0
430066;201802;10;7;3;6678.0;2862.0;9540.0
430070;201802;45;33;12;31482.0;11448.0;42930.0
430080;201802;69;48;21;45092.33;20034.0;65126.33
430085;201802;37;11;26;10494.0;24804.0;35298.0
430087;201802;33;25;8;23707.0;7632.0;31339.0
430090;201802;71;64;7;60769.8;6678.0;67447.8
430100;201802;116;76;40;71550.0;38160.0;109710.0
430105;201802;145;73;72;69642.0;68382.72;138024.72
430107;201802;21;15;6;14310.0;5724.0;20034.0
430110;201802;410;237;173;225287.1;164975.22;390262.3
430120;201802;138;126;12;119250.9;11448.0;130698.9
430130;201802;797;502;295;478001.7;281143.8;759145.5
430140;201802;124;114;10;108756.0;9540.0;118296.0
430150;201802;112;73;39;68879.0;36252.0;105131.0
430155;201802;33;30;3;28620.0;2862.0;31482.0
430160;201802;3807;2246;1561;2122271.0;1485120.6;3607391.5
430163;201802;326;144;182;136231.94;173570.77;309802.7
430165;201802;24;16;8;15264.0;7632.0;22896.0
430170;201802;80;72;8;68688.0;7632.0;76320.0
430175;201802;81;63;18;60102.0;16504.2;76606.2
430180;201802;96;76;20;72504.0;18459.9;90963.9
430185;201802;31;23;8;21942.0;7632.0;29574.0
430187;201802;102;43;59;41022.0;55980.8;97002.8
430190;201802;225;127;98;121110.3;92815.46;213925.77
430192;201802;14;14;0;13356.0;0.0;13356.0
430195;201802;13;8;5;7632.0;4770.0;12402.0
430200;201802;164;146;18;138616.2;17172.0;155788.2
430205;201802;20;19;1;18126.0;954.0;19080.0
430210;201802;625;486;139;459923.4;131318.3;591241.7
430215;201802;16;12;4;11448.0;3816.0;15264.0
430220;201802;64;45;19;42930.0;18126.0;61056.0
430222;201802;14;7;7;6678.0;6678.0;13356.0
430223;201802;15;8;7;7632.0;6678.0;14310.0
430225;201802;4;3;1;2862.0;954.0;3816.0
430230;201802;303;187;116;177444.0;110664.0;288108.0
430235;201802;52;38;14;36252.0;13346.46;49598.46
430237;201802;29;21;8;20034.0;7632.0;27666.0
430240;201802;131;84;47;79904.56;44838.0;124742.56
430245;201802;70;59;11;56286.0;10494.0;66780.0
430250;201802;190;109;81;103976.46;77264.46;181240.92
430258;201802;13;11;2;10494.0;1908.0;12402.0
430260;201802;35;30;5;28620.0;4760.46;33380.46
430265;201802;34;29;5;27646.92;4770.0;32416.92
430270;201802;560;412;148;389658.53;139381.02;529039.56
430280;201802;1036;632;404;599293.25;382916.6;982209.9
430290;201802;379;221;158;208926.8;150732.0;359658.8
430300;201802;2112;1166;946;1106575.1;899424.8;2005999.9
430310;201802;1971;1038;933;983204.4;886983.25;1870187.6
430320;201802;49;41;8;39099.69;7632.0;46731.69
430330;201802;97;88;9;83475.0;8586.0;92061.0
430340;201802;66;59;7;56286.0;6678.0;62964.0
430350;201802;1667;1158;509;1093256.4;482698.6;1575955.0
430355;201802;25;22;3;20988.0;2862.0;23850.0
430360;201802;79;39;40;37206.0;37873.8;75079.8
430367;201802;26;19;7;18126.0;6678.0;24804.0
430370;201802;54;47;7;44838.0;6678.0;51516.0
430380;201802;130;98;32;92919.6;30528.0;123447.6
430390;201802;615;382;233;364141.8;221977.45;586119.25
430400;201802;136;106;30;99406.8;28600.92;128007.72
430410;201802;60;47;13;44838.0;12402.0;57240.0
430420;201802;491;322;169;304708.8;158523.62;463232.4
430430;201802;55;52;3;48972.63;2862.0;51834.63
430435;201802;158;120;38;113526.0;35536.5;149062.5
430440;201802;498;331;167;315774.0;159127.2;474901.2
430450;201802;1201;991;210;938832.1;200330.45;1139162.6
430460;201802;5104;2780;2324;2636239.8;2212533.8;4848773.5
430461;201802;17;15;2;14310.0;1908.0;16218.0
430462;201802;11;7;4;6678.0;3816.0;10494.0
430463;201802;1022;541;481;513681.38;458522.1;972203.5
430465;201802;28;16;12;15264.0;11448.0;26712.0
430466;201802;659;478;181;454104.2;172483.2;626587.4
430467;201802;100;59;41;55045.8;39104.46;94150.26
430468;201802;109;68;41;64872.0;38862.91;103734.91
430469;201802;23;17;6;16218.0;5724.0;21942.0
430470;201802;1173;646;527;609518.4;500802.3;1110320.8
430471;201802;48;36;12;34324.92;11448.0;45772.92
430480;201802;92;57;35;53519.4;33380.46;86899.86
430485;201802;6;6;0;5438.0;0.0;5438.0
430490;201802;89;71;18;66923.7;17172.0;84095.7
430495;201802;37;29;8;27666.0;7632.0;35298.0
430500;201802;192;131;61;124974.0;57818.46;182792.45
430510;201802;3070;2045;1025;1945377.8;976963.3;2922341.0
430511;201802;18;18;0;17172.0;0.0;17172.0
430512;201802;136;94;42;89676.0;40068.0;129744.0
430513;201802;53;46;7;43407.0;6678.0;50085.0
430515;201802;32;30;2;28620.0;1908.0;30528.0
430517;201802;169;149;20;141192.0;19060.92;160252.92
430520;201802;364;249;115;236879.0;109681.38;346560.38
430530;201802;90;53;37;50562.0;35298.0;85860.0
430535;201802;475;317;158;302218.44;150708.16;452926.6
430537;201802;10;10;0;9540.0;0.0;9540.0
430540;201802;70;47;23;44838.0;21942.0;66780.0
430543;201802;372;115;257;109710.0;245178.0;354888.0
430544;201802;43;39;4;37206.0;3816.0;41022.0
430545;201802;344;163;181;155483.0;172177.92;327660.9
430550;201802;42;34;8;32436.0;7632.0;40068.0
430558;201802;6;4;2;3816.0;1908.0;5724.0
430560;201802;46;20;26;19080.0;24804.0;43884.0
430570;201802;108;47;61;44838.0;58136.76;102974.76
430580;201802;125;97;28;92538.0;26664.3;119202.3
430583;201802;14;14;0;13356.0;0.0;13356.0
430585;201802;9;4;5;3816.0;4770.0;8586.0
430587;201802;14;8;6;7632.0;5724.0;13356.0
430590;201802;153;127;26;119917.8;24804.0;144721.8
430593;201802;4;4;0;3816.0;0.0;3816.0
430595;201802;17;12;5;11448.0;4770.0;16218.0
430597;201802;51;26;25;24804.0;23850.0;48654.0
430600;201802;214;149;65;142136.45;61723.8;203860.27
430605;201802;162;100;62;95400.0;59138.46;154538.45
430607;201802;26;21;5;20034.0;4770.0;24804.0
430610;201802;1645;769;876;730489.3;830705.75;1561195.1
430613;201802;2;2;0;1908.0;0.0;1908.0
430620;201802;113;81;32;77131.0;30518.46;107649.46
430630;201802;45;40;5;38160.0;4770.0;42930.0
430632;201802;31;26;5;24804.0;4770.0;29574.0
430635;201802;40;36;4;34344.0;3816.0;38160.0
430637;201802;56;31;25;29574.0;23850.0;53424.0
430640;201802;207;114;93;107897.4;88722.0;196619.4
430642;201802;28;26;2;24804.0;1908.0;26712.0
430645;201802;33;29;4;27666.0;3816.0;31482.0
430650;201802;256;206;50;196238.0;47652.3;243890.3
430655;201802;4;4;0;3816.0;0.0;3816.0
430660;201802;961;470;491;446805.9;466887.8;913693.7
430670;201802;71;51;20;48654.0;19080.0;67734.0
430673;201802;74;41;33;39114.0;31482.0;70596.0
430675;201802;13;10;3;9540.0;2862.0;12402.0
430676;201802;489;303;186;288337.03;177373.06;465710.12
430680;201802;250;176;74;165710.0;70596.0;236306.0
430690;201802;527;306;221;291018.25;209178.14;500196.38
430692;201802;7;5;2;4770.0;1908.0;6678.0
430693;201802;139;93;46;88722.0;43874.46;132596.45
430695;201802;73;66;7;62029.08;6678.0;68707.08
430697;201802;60;35;25;33390.0;23850.0;57240.0
430700;201802;1595;1117;478;1052710.4;456012.0;1508722.4
430705;201802;19;18;1;17172.0;954.0;18126.0
430710;201802;260;168;92;160272.0;87768.0;248040.0
430720;201802;109;92;17;87577.2;16218.0;103795.2
430730;201802;120;103;17;97308.0;16218.0;113526.0
430740;201802;65;43;22;41022.0;20988.0;62010.0
430745;201802;36;29;7;27380.0;6678.0;34058.0
430750;201802;338;229;109;217522.64;103032.0;320554.62
430755;201802;83;46;37;43884.0;35298.0;79182.0
430760;201802;371;225;146;211979.72;139255.92;351235.62
430770;201802;1471;756;715;719106.3;677653.25;1396759.6
430780;201802;314;200;114;189818.72;108689.76;298508.47
430781;201802;28;23;5;21942.0;4770.0;26712.0
430783;201802;50;40;10;37842.13;9540.0;47382.13
430786;201802;6;3;3;2862.0;2862.0;5724.0
430790;201802;488;315;173;299238.12;164746.45;463984.6
430800;201802;151;126;25;120204.0;23850.0;144054.0
430805;201802;42;38;4;36252.0;3816.0;40068.0
430807;201802;35;21;14;20034.0;13356.0;33390.0
430810;201802;73;47;26;44838.0;24804.0;69642.0
430820;201802;134;84;50;80136.0;47032.2;127168.2
430825;201802;13;11;2;10494.0;1908.0;12402.0
430830;201802;232;218;14;207666.92;13356.0;221022.92
430840;201802;125;84;41;80136.0;38446.2;118582.2
430843;201802;5;3;2;2862.0;1908.0;4770.0
430845;201802;69;39;30;37206.0;28620.0;65826.0
430850;201802;569;391;178;371840.6;169680.69;541521.25
430860;201802;156;99;57;93778.2;53700.66;147478.86
430865;201802;63;31;32;28906.2;30213.18;59119.38
430870;201802;78;64;14;61056.0;13356.0;74412.0
430880;201802;160;120;40;114460.92;38160.0;152620.92
430885;201802;7;6;1;5724.0;954.0;6678.0
430890;201802;333;204;129;192956.05;123066.0;316022.03
430900;201802;541;372;169;350690.4;160739.45;511429.88
430905;201802;82;32;50;30528.0;47700.0;78228.0
430910;201802;268;150;118;143100.0;111896.0;254996.0
430912;201802;3;3;0;2862.0;0.0;2862.0
430915;201802;35;27;8;25758.0;7345.8;33103.8
430920;201802;4196;2351;1845;2236775.2;1757728.5;3994503.8
430925;201802;5;4;1;3567.96;954.0;4521.96
430930;201802;2094;1243;851;1178106.4;810653.44;1988759.9
430940;201802;237;150;87;142422.66;82978.92;225401.58
430950;201802;160;130;30;124020.0;28620.0;152640.0
430955;201802;22;14;8;13356.0;7632.0;20988.0
430957;201802;18;17;1;16218.0;954.0;17172.0
430960;201802;238;157;81;147345.3;77274.0;224619.3
430965;201802;104;65;39;62010.0;37206.0;99216.0
430970;201802;78;65;13;62010.0;11448.0;73458.0
430975;201802;33;31;2;29574.0;1908.0;31482.0
430980;201802;43;26;17;24804.0;16218.0;41022.0
430990;201802;109;83;26;79182.0;24804.0;103986.0
430995;201802;113;108;5;101791.8;4770.0;106561.8
431000;201802;295;135;160;126643.2;152640.0;279283.2
431010;201802;340;205;135;194587.38;128742.3;323329.7
431020;201802;1923;1113;810;1053240.4;768628.25;1821868.6
431030;201802;43;34;9;32436.0;8586.0;41022.0
431033;201802;386;190;196;180449.2;186984.0;367433.2
431036;201802;16;9;7;8586.0;6678.0;15264.0
431040;201802;131;79;52;74412.0;49498.29;123910.29
431041;201802;37;25;12;23850.0;11448.0;35298.0
431043;201802;46;27;19;25758.0;18126.0;43884.0
431046;201802;12;7;5;6678.0;4770.0;11448.0
431050;201802;207;131;76;124687.8;71502.3;196190.1
431053;201802;74;44;30;41212.8;28620.0;69832.8
431055;201802;63;42;21;40068.0;20014.92;60082.92
431057;201802;17;17;0;16218.0;0.0;16218.0
431060;201802;1694;1063;631;1006586.7;600112.9;1606699.5
431065;201802;17;10;7;9540.0;6678.0;16218.0
431070;201802;73;68;5;64872.0;4770.0;69642.0
431075;201802;8;8;0;7632.0;0.0;7632.0
431080;201802;135;88;47;83665.8;44838.0;128503.8
431085;201802;30;27;3;25758.0;2862.0;28620.0
431087;201802;14;12;2;11448.0;1908.0;13356.0
431090;201802;56;44;12;41976.0;11448.0;53424.0
431100;201802;1223;726;497;681540.8;474138.0;1155678.9
431110;201802;245;153;92;145962.0;87758.46;233720.45
431112;201802;29;17;12;16218.0;11448.0;27666.0
431113;201802;30;20;10;19080.0;9540.0;28620.0
431115;201802;152;104;48;98579.87;45782.46;144362.33
431120;201802;619;364;255;345310.62;243193.84;588504.5
431123;201802;3;2;1;1908.0;954.0;2862.0
431125;201802;91;81;10;77274.0;9540.0;86814.0
431127;201802;7;3;4;2862.0;3816.0;6678.0
431130;201802;619;399;220;379405.8;209574.72;588980.5
431140;201802;731;497;234;470465.4;223159.69;693625.06
431142;201802;33;25;8;22638.0;7632.0;30270.0
431150;201802;205;152;53;145008.0;50552.46;195560.45
431160;201802;56;50;6;47700.0;5724.0;53424.0
431162;201802;19;14;5;13356.0;4770.0;18126.0
431164;201802;4;4;0;3816.0;0.0;3816.0
431170;201802;102;84;18;80136.0;17172.0;97308.0
431171;201802;49;27;22;25758.0;20978.46;46736.46
431173;201802;1;1;0;954.0;0.0;954.0
431175;201802;203;100;103;94160.0;98252.46;192412.45
431177;201802;75;57;18;54378.0;16485.92;70863.92
431179;201802;11;10;1;9540.0;954.0;10494.0
431180;201802;436;263;173;250902.0;164943.45;415845.47
431190;201802;87;66;21;62964.0;20034.0;82998.0
431198;201802;72;48;24;45792.0;22896.0;68688.0
431200;201802;20;17;3;16218.0;2862.0;19080.0
431205;201802;23;23;0;21942.0;0.0;21942.0
431210;201802;87;53;34;50229.0;32436.0;82665.0
431213;201802;28;23;5;21942.0;4770.0;26712.0
431215;201802;26;23;3;21942.0;2862.0;24804.0
431217;201802;5;4;1;3816.0;954.0;4770.0
431220;201802;67;58;9;55332.0;8586.0;63918.0
431225;201802;149;99;50;94437.0;47690.46;142127.45
431230;201802;99;87;12;82998.0;11448.0;94446.0
431235;201802;7;7;0;6678.0;0.0;6678.0
431237;201802;25;16;9;15264.0;8586.0;23850.0
431238;201802;15;11;4;10208.0;3816.0;14024.0
431240;201802;989;635;354;604130.6;337200.84;941331.5
431242;201802;34;34;0;32436.0;0.0;32436.0
431244;201802;11;8;3;7632.0;2862.0;10494.0
431245;201802;61;47;14;44838.0;13356.0;58194.0
431247;201802;13;10;3;9540.0;2862.0;12402.0
431250;201802;267;137;130;130631.22;123333.92;253965.14
431260;201802;60;43;17;41022.0;16218.0;57240.0
431261;201802;21;14;7;13356.0;6678.0;20034.0
431262;201802;15;15;0;14310.0;0.0;14310.0
431265;201802;163;86;77;82044.0;73458.0;155502.0
431267;201802;14;13;1;12402.0;954.0;13356.0
431270;201802;316;265;51;252810.0;48654.0;301464.0
431275;201802;41;39;2;37206.0;1908.0;39114.0
431280;201802;21;17;4;15383.25;3816.0;19199.25
431290;201802;20;17;3;16218.0;2862.0;19080.0
431295;201802;5;5;0;4770.0;0.0;4770.0
431300;201802;22;19;3;18126.0;2862.0;20988.0
431301;201802;7;7;0;6678.0;0.0;6678.0
431303;201802;51;34;17;32311.98;15931.8;48243.78
431306;201802;225;119;106;113069.98;101124.0;214193.98
431308;201802;6;5;1;4770.0;954.0;5724.0
431310;201802;62;53;9;50562.0;8586.0;59148.0
431320;201802;121;70;51;66780.0;48358.26;115138.26
431330;201802;179;118;61;112572.0;58194.0;170766.0
431333;201802;33;27;6;25758.0;5724.0;31482.0
431335;201802;10;5;5;4770.0;4770.0;9540.0
431337;201802;323;151;172;143224.2;163057.88;306282.1
431339;201802;21;18;3;17172.0;2862.0;20034.0
431340;201802;3053;1761;1292;1676070.0;1229451.9;2905521.8
431342;201802;45;28;17;26712.0;16218.0;42930.0
431344;201802;18;17;1;16218.0;954.0;17172.0
431346;201802;4;4;0;3816.0;0.0;3816.0
431349;201802;36;33;3;31482.0;2862.0;34344.0
431350;201802;902;530;372;501071.66;353228.03;854299.7
431360;201802;45;39;6;37206.0;5724.0;42930.0
431365;201802;311;148;163;141172.92;154538.45;295711.38
431370;201802;1327;786;541;746209.94;515926.97;1262136.9
431380;201802;97;84;13;80136.0;12402.0;92538.0
431390;201802;496;276;220;262273.88;209336.22;471610.1
431395;201802;282;122;160;116388.0;152621.0;269009.0
431400;201802;39;30;9;28620.0;8586.0;37206.0
431402;201802;94;65;29;62010.0;27666.0;89676.0
431403;201802;16;11;5;10494.0;4770.0;15264.0
431405;201802;650;351;299;333214.03;285219.0;618433.0
431406;201802;32;28;4;26712.0;3816.0;30528.0
431407;201802;51;41;10;39114.0;9540.0;48654.0
431410;201802;3224;1917;1307;1816024.2;1243947.9;3059972.2
431413;201802;15;13;2;12402.0;1908.0;14310.0
431415;201802;73;52;21;49608.0;20034.0;69642.0
431417;201802;22;11;11;10494.0;10494.0;20988.0
431420;201802;303;214;89;203519.95;84906.0;288425.97
431430;201802;42;17;25;16218.0;23850.0;40068.0
431440;201802;8959;6392;2567;6027030.5;2440271.2;8467302.0
431442;201802;27;14;13;13356.0;12402.0;25758.0
431445;201802;26;20;6;19080.0;5724.0;24804.0
431446;201802;7;6;1;5724.0;954.0;6678.0
431447;201802;84;59;25;56286.0;23850.0;80136.0
431449;201802;51;44;7;41976.0;6678.0;48654.0
431450;201802;412;286;126;271079.1;119488.5;390567.6
431454;201802;0;0;0;0.0;0.0;0.0
431455;201802;49;38;11;36252.0;10494.0;46746.0
431460;201802;525;363;162;343535.4;154261.8;497797.2
431470;201802;117;92;25;87076.54;23600.0;110676.54
431475;201802;11;10;1;9540.0;954.0;10494.0
431477;201802;35;25;10;23850.0;9540.0;33390.0
431478;201802;8;7;1;6678.0;954.0;7632.0
431480;201802;496;316;180;299852.7;171672.3;471525.0
431490;201802;28159;15988;12171;1,52E+14;1,16E+14;2,68E+14
431500;201802;78;52;26;49608.0;24804.0;74412.0
431505;201802;36;20;16;19080.0;15264.0;34344.0
431507;201802;11;9;2;8586.0;1908.0;10494.0
431510;201802;278;182;96;172912.8;90610.92;263523.72
431513;201802;22;17;5;16218.0;4770.0;20988.0
431514;201802;8;7;1;6678.0;954.0;7632.0
431515;201802;79;66;13;62964.0;12402.0;75366.0
431517;201802;4;2;2;1908.0;1908.0;3816.0
431520;201802;37;33;4;31482.0;3816.0;35298.0
431530;201802;1600;714;886;680106.8;844781.94;1524888.8
431531;201802;23;21;2;20034.0;1908.0;21942.0
431532;201802;25;17;8;16218.0;7632.0;23850.0
431535;201802;25;16;9;15264.0;8586.0;23850.0
431540;201802;137;122;15;115367.22;14310.0;129677.22
431545;201802;18;16;2;15264.0;1908.0;17172.0
431550;201802;349;205;144;195570.0;137280.6;332850.6
431555;201802;12;11;1;10494.0;954.0;11448.0
431560;201802;4431;3137;1294;2962708.5;1232206.4;4194915.0
431570;201802;781;413;368;390854.2;348201.47;739055.7
431575;201802;36;25;11;23850.0;10494.0;34344.0
431580;201802;96;68;28;63918.0;26712.0;90630.0
431590;201802;138;115;23;108756.0;21942.0;130698.0
431595;201802;12;11;1;10494.0;954.0;11448.0
431600;201802;220;127;93;121158.0;88722.0;209880.0
431610;201802;128;93;35;88054.2;33390.0;121444.2
431620;201802;42;34;8;32436.0;7632.0;40068.0
431630;201802;136;115;21;109710.0;20034.0;129744.0
431640;201802;1330;827;503;783520.6;478278.44;1261799.0
431642;201802;41;37;4;34821.0;3816.0;38637.0
431643;201802;44;20;24;19080.0;22896.0;41976.0
431645;201802;301;173;128;165042.0;121158.0;286200.0
431647;201802;11;11;0;10494.0;0.0;10494.0
431650;201802;37;28;9;26712.0;8586.0;35298.0
431660;201802;282;185;97;174371.05;92538.0;266909.03
431670;201802;219;104;115;96592.5;109681.38;206273.88
431673;201802;3;3;0;2862.0;0.0;2862.0
431675;201802;29;24;5;22609.8;4770.0;27379.8
431680;201802;1091;781;310;741258.0;294691.7;1035949.7
431690;201802;4760;2913;1847;2757705.2;1758110.2;4515815.5
431695;201802;26;20;6;19080.0;5724.0;24804.0
431697;201802;0;0;0;0.0;0.0;0.0
431700;201802;167;127;40;121158.0;38160.0;159318.0
431710;201802;3994;1717;2277;1635338.0;2171768.5;3807106.5
431720;201802;1393;825;568;779168.4;540904.44;1320072.9
431725;201802;1;1;0;954.0;0.0;954.0
431730;201802;1194;809;385;765091.1;367290.0;1132381.1
431740;201802;1364;683;681;646964.75;649123.56;1296088.2
431750;201802;1878;1218;660;1150742.2;627703.94;1778446.2
431755;201802;6;5;1;4770.0;954.0;5724.0
431760;201802;1087;692;395;659786.4;376601.6;1036388.0
431770;201802;393;287;106;273788.47;101104.92;374893.38
431775;201802;27;21;6;20034.0;5724.0;25758.0
431780;201802;557;343;214;326105.8;204146.45;530252.25
431790;201802;150;112;38;105894.0;36204.3;142098.3
431795;201802;14;12;2;11448.0;1908.0;13356.0
431800;201802;3388;1774;1614;1681013.4;1532838.4;3213851.8
431805;201802;16;15;1;14310.0;954.0;15264.0
431810;201802;616;415;201;393276.97;191620.98;584897.94
431820;201802;315;176;139;167904.0;131604.3;299508.3
431830;201802;2335;1412;923;1343347.4;879281.6;2222629.0
431840;201802;513;341;172;321690.4;162848.0;484538.4
431842;201802;34;28;6;26712.0;5724.0;32436.0
431843;201802;12;7;5;6678.0;4770.0;11448.0
431844;201802;15;13;2;12402.0;1908.0;14310.0
431845;201802;30;27;3;25758.0;2862.0;28620.0
431846;201802;29;25;4;23850.0;3816.0;27666.0
431848;201802;14;12;2;11448.0;1908.0;13356.0
431849;201802;8;6;2;5724.0;1908.0;7632.0
431850;201802;803;667;136;634805.5;129505.5;764311.0
431860;201802;104;75;29;71550.0;26712.0;98262.0
431861;201802;4;2;2;1908.0;1908.0;3816.0
431862;201802;51;33;18;31482.0;17172.0;48654.0
431870;201802;3468;2044;1424;1941518.0;1356898.4;3298416.5
431880;201802;940;689;251;652508.0;238500.0;891008.0
431890;201802;1300;805;495;762933.75;470623.0;1233556.8
431900;201802;185;129;56;123066.0;52632.18;175698.19
431910;201802;57;42;15;40068.0;14310.0;54378.0
431912;201802;35;19;16;18126.0;15264.0;33390.0
431915;201802;129;103;26;98262.0;24804.0;123066.0
431920;201802;144;107;37;101791.8;35298.0;137089.8
431930;201802;87;71;16;67734.0;15264.0;82998.0
431935;201802;4;3;1;2862.0;954.0;3816.0
431936;201802;12;11;1;10494.0;954.0;11448.0
431937;201802;18;13;5;12402.0;4770.0;17172.0
431940;201802;445;298;147;281525.4;140228.45;421753.88
431950;201802;465;298;167;283052.88;159185.52;442238.4
431960;201802;714;422;292;398402.03;278406.9;676808.94
431970;201802;73;64;9;61056.0;8586.0;69642.0
431971;201802;2;2;0;1908.0;0.0;1908.0
431973;201802;19;16;3;15264.0;2862.0;18126.0
431975;201802;6;5;1;4770.0;954.0;5724.0
431980;201802;198;124;74;116769.6;70596.0;187365.6
431990;201802;1228;654;574;622443.0;547550.0;1169993.0
432000;201802;1680;905;775;856276.44;735786.06;1592062.5
432010;201802;276;184;92;174422.95;87768.0;262190.97
432020;201802;174;137;37;130698.0;35288.46;165986.45
432023;201802;20;16;4;15264.0;3816.0;19080.0
432026;201802;65;58;7;55332.0;6678.0;62010.0
432030;201802;62;28;34;26712.0;32436.0;59148.0
432032;201802;22;19;3;18126.0;2862.0;20988.0
432035;201802;47;37;10;35298.0;9540.0;44838.0
432040;201802;98;67;31;63918.0;29574.0;93492.0
432045;201802;8;7;1;6678.0;954.0;7632.0
432050;201802;69;42;27;40068.0;25758.0;65826.0
432055;201802;100;73;27;69622.92;25758.0;95380.92
432057;201802;1;0;1;0.0;954.0;954.0
432060;201802;38;35;3;32674.5;2862.0;35536.5
432065;201802;30;28;2;26712.0;1908.0;28620.0
432067;201802;90;79;11;75346.92;10494.0;85840.92
432070;201802;400;303;97;287460.2;92509.92;379970.1
432080;201802;814;558;256;530633.9;244157.3;774791.2
432085;201802;16;12;4;11448.0;3816.0;15264.0
432090;201802;259;162;97;154548.0;92538.0;247086.0
432100;201802;174;116;58;110377.8;55332.0;165709.8
432110;201802;605;413;192;387467.84;182214.0;569681.8
432120;201802;959;576;383;548836.2;365343.84;914180.06
432130;201802;501;361;140;343058.4;132462.9;475521.3
432132;201802;26;22;4;20988.0;3816.0;24804.0
432135;201802;78;65;13;62010.0;12402.0;74412.0
432140;201802;265;209;56;199090.27;53424.0;252514.27
432143;201802;188;119;69;113526.0;65826.0;179352.0
432145;201802;268;184;84;173724.2;79849.8;253574.0
432146;201802;15;14;1;13356.0;954.0;14310.0
432147;201802;136;61;75;58194.0;71526.15;129720.15
432149;201802;17;12;5;11448.0;4770.0;16218.0
432150;201802;823;521;302;495841.5;285070.84;780912.3
432160;201802;1401;725;676;689352.4;643998.44;1333350.9
432162;201802;4;3;1;2862.0;954.0;3816.0
432163;201802;18;14;4;13356.0;3816.0;17172.0
432166;201802;122;91;31;87292.0;29574.0;116866.0
432170;201802;221;121;100;114481.0;95400.0;209881.0
432180;201802;524;319;205;300710.5;195284.0;495994.5
432183;201802;9;7;2;6678.0;1908.0;8586.0
432185;201802;82;71;11;67638.6;10494.0;78132.6
432190;201802;466;260;206;246877.45;196391.52;443268.97
432195;201802;85;74;11;69880.5;10494.0;80374.5
432200;201802;412;265;147;252810.0;140190.84;393000.84
432210;201802;118;76;42;70452.9;40068.0;110520.9
432215;201802;62;58;4;55332.0;3816.0;59148.0
432218;201802;19;18;1;17172.0;954.0;18126.0
432220;201802;675;343;332;326211.62;316220.75;642432.4
432225;201802;14;8;6;7155.0;5724.0;12879.0
432230;201802;144;87;57;82759.5;54378.0;137137.5
432232;201802;15;13;2;12402.0;1908.0;14310.0
432234;201802;4;3;1;2862.0;954.0;3816.0
432235;201802;1;1;0;954.0;0.0;954.0
432237;201802;29;17;12;16218.0;11448.0;27666.0
432240;201802;4193;2329;1864;2212747.2;1770723.4;3983470.8
432250;201802;1025;649;376;616523.94;358541.8;975065.75
432252;201802;38;31;7;28829.88;6678.0;35507.88
432253;201802;61;49;12;46746.0;11448.0;58194.0
432254;201802;21;9;12;8586.0;11448.0;20034.0
432255;201802;14;13;1;12402.0;954.0;13356.0
432260;201802;846;661;185;629535.25;175536.5;805071.75
432270;201802;221;164;57;156456.0;54378.0;210834.0
432280;201802;123;89;34;84429.8;32436.0;116865.8
432285;201802;2;1;1;954.0;954.0;1908.0
432290;201802;69;62;7;57526.2;6678.0;64204.2
432300;201802;4626;2638;1988;2500840.8;1892695.1;4393536.0
432310;201802;117;94;23;89676.0;21942.0;111618.0
432320;201802;20;15;5;14310.0;4770.0;19080.0
432330;201802;15;10;5;9540.0;4770.0;14310.0
432335;201802;7;6;1;5724.0;954.0;6678.0
432340;201802;41;37;4;35298.0;3816.0;39114.0
432345;201802;89;62;27;59148.0;25758.0;84906.0
432350;201802;22;21;1;20034.0;954.0;20988.0
432360;201802;6;4;2;3816.0;1908.0;5724.0
432370;201802;25;25;0;23850.0;0.0;23850.0
432375;201802;40;34;6;32436.0;5724.0;38160.0
432377;201802;7;7;0;6678.0;0.0;6678.0
432380;201802;169;74;95;69928.2;90582.3;160510.5
500020;201802;247;134;113;127836.0;107200.98;235036.98
500025;201802;119;58;61;54378.0;58194.0;112572.0
500060;201802;1389;849;540;809373.6;514554.62;1323928.2
500070;201802;757;360;397;343089.0;378728.47;721817.44
500080;201802;136;105;31;100170.0;29574.0;129744.0
500085;201802;141;114;27;108470.0;24923.25;133393.25
500090;201802;332;160;172;152640.0;164088.0;316728.0
500100;201802;694;368;326;348877.8;310432.0;659309.8
500110;201802;2242;1001;1241;954636.44;1183109.6;2137746.0
500124;201802;305;175;130;166950.0;123733.8;290683.8
500150;201802;327;130;197;124011.0;187578.0;311589.0
500190;201802;518;355;163;338002.2;155016.0;493018.2
500200;201802;200;171;29;162791.0;27666.0;190457.0
500210;201802;1463;522;941;496714.94;896551.0;1393266.0
500215;201802;241;139;102;131648.52;97308.0;228956.52
500220;201802;788;514;274;490111.84;260638.45;750750.3
500230;201802;256;176;80;167188.5;75843.0;243031.5
500240;201802;708;492;216;468604.8;205777.8;674382.6
500260;201802;568;212;356;202248.0;339624.0;541872.0
500270;201802;28324;12048;16276;1,15E+14;1,55E+14;2,70E+14
500280;201802;192;73;119;69642.0;113526.0;183168.0
500290;201802;1195;701;494;667515.0;471267.0;1138782.0
500295;201802;407;249;158;237546.0;150722.45;388268.47
500310;201802;63;20;43;19080.0;41022.0;60102.0
500315;201802;692;416;276;396854.47;263008.25;659862.75
500320;201802;3643;1815;1828;1729083.4;1742265.0;3471348.5
500325;201802;937;519;418;494649.0;397797.44;892446.44
500330;201802;1494;683;811;649360.25;773356.6;1422716.9
500345;201802;326;239;87;227043.2;82998.0;310041.2
500348;201802;242;142;100;135468.0;95381.46;230849.45
500350;201802;140;68;72;64872.0;68688.0;133560.0
500370;201802;5416;2425;2991;2305922.0;2850876.0;5156798.0
500375;201802;349;252;97;240398.45;92538.0;332936.47
500380;201802;583;330;253;314662.6;241352.45;556015.06
500390;201802;72;36;36;34344.0;34344.0;68688.0
500400;201802;221;150;71;143080.92;67725.0;210805.92
500410;201802;571;222;349;211742.16;332798.22;544540.4
500430;201802;544;378;166;360612.0;158364.0;518976.0
500440;201802;203;105;98;99397.43;93492.0;192889.44
500450;201802;410;175;235;166244.8;223835.12;390079.9
500460;201802;315;158;157;150722.45;149778.0;300500.47
500470;201802;437;343;94;326007.66;88713.0;414720.66
500480;201802;114;69;45;65826.0;42930.0;108756.0
500490;201802;108;44;64;41971.23;61056.0;103027.23
500500;201802;1442;500;942;475170.12;898074.44;1373244.5
500510;201802;47;36;11;34344.0;10485.0;44829.0
500515;201802;110;77;33;73458.0;31196.0;104654.0
500520;201802;350;197;153;186889.0;145672.0;332561.0
500525;201802;87;49;38;46746.0;35965.8;82711.8
500540;201802;892;369;523;351673.75;497931.84;849605.6
500560;201802;891;507;384;481939.03;365654.4;847593.44
500568;201802;999;577;422;546642.2;402297.22;948939.44
500570;201802;1217;685;532;650774.25;505206.6;1155980.9
500580;201802;332;170;162;161884.27;154535.0;316419.25
500600;201802;314;158;156;150021.27;148806.0;298827.28
500620;201802;910;639;271;603828.7;258343.2;862171.9
500625;201802;81;69;12;65119.19;11448.0;76567.19
500627;201802;24;11;13;10494.0;12402.0;22896.0
500630;201802;1573;831;742;791811.25;707387.0;1499198.2
500635;201802;514;294;220;280056.25;209736.9;489793.12
500640;201802;427;225;202;212076.0;192689.45;404765.47
500660;201802;5477;2105;3372;2004450.6;3211900.2;5216351.0
500690;201802;577;202;375;192360.78;356070.72;548431.5
500710;201802;356;174;182;165710.0;173543.9;339253.9
500720;201802;969;568;401;540198.25;382344.9;922543.1
500730;201802;197;115;82;109710.0;77937.03;187647.03
500740;201802;852;369;483;350734.94;460027.75;810762.7
500750;201802;136;44;92;41976.0;87739.92;129715.92
500755;201802;123;88;35;83666.0;33390.0;117056.0
500769;201802;745;419;326;399404.03;310991.0;710395.06
500770;201802;442;231;211;220364.45;201284.45;421648.9
500780;201802;173;116;57;110664.0;54378.0;165042.0
500790;201802;1030;511;519;486917.22;494799.47;981716.7
500793;201802;257;136;121;129744.0;115425.0;245169.0
500795;201802;179;128;51;122102.46;48645.0;170747.45
500797;201802;39;31;8;29574.0;7632.0;37206.0
500800;201802;408;175;233;166941.0;221995.8;388936.8
500830;201802;2183;1221;962;1162421.9;916708.7;2079130.6
500840;201802;144;107;37;102078.0;35289.0;137367.0
510010;201802;165;91;74;86804.46;70596.0;157400.45
510020;201802;486;224;262;213402.6;249135.5;462538.1
510025;201802;1665;937;728;893037.1;691690.06;1584727.2
510030;201802;645;331;314;315727.9;298792.22;614520.1
510035;201802;126;57;69;54350.46;65807.46;120157.92
510040;201802;382;167;215;159318.0;204663.27;363981.25
510050;201802;424;230;194;218679.2;184271.45;402950.66
510060;201802;116;58;58;55322.46;55322.46;110644.92
510080;201802;220;87;133;82965.69;126759.06;209724.75
510100;201802;77;34;43;32436.0;41002.92;73438.92
510120;201802;37;22;15;20988.0;14310.0;35298.0
510125;201802;398;247;151;234955.89;144030.92;378986.8
510130;201802;588;342;246;325871.8;234260.1;560131.94
510140;201802;392;129;263;123057.0;250897.23;373954.22
510160;201802;89;41;48;39114.0;45788.0;84902.0
510170;201802;865;526;339;501529.06;322763.3;824292.4
510180;201802;2885;1404;1481;1336407.4;1410923.2;2747330.5
510185;201802;12;6;6;5724.0;5724.0;11448.0
510190;201802;211;72;139;68688.0;132601.23;201289.23
510250;201802;2617;1535;1082;1463340.1;1031105.2;2494445.2
510260;201802;202;145;57;138147.84;54341.46;192489.3
510263;201802;455;249;206;236564.45;195768.6;432333.06
510267;201802;651;365;286;347654.75;272573.44;620228.2
510268;201802;56;29;27;27666.0;25758.0;53424.0
510269;201802;68;29;39;27657.0;37206.0;64863.0
510270;201802;413;211;202;201115.98;192291.48;393407.47
510279;201802;229;169;60;161189.45;56934.92;218124.38
510285;201802;166;73;93;69623.46;88722.0;158345.45
510300;201802;547;294;253;280025.06;241287.84;521312.9
510305;201802;217;100;117;95377.46;111524.22;206901.69
510310;201802;112;57;55;54378.0;52460.46;106838.46
510320;201802;855;530;325;505042.62;309614.38;814657.0
510325;201802;421;167;254;159308.45;242020.27;401328.72
510330;201802;423;239;184;227993.0;175516.92;403509.9
510335;201802;597;321;276;306187.38;262648.97;568836.4
510336;201802;49;36;13;34344.0;12402.0;46746.0
510337;201802;119;48;71;45782.46;67724.46;113506.92
510340;201802;17439;8393;9046;7984386.0;8619169.0;1,66E+14
510343;201802;72;50;22;47690.46;20988.0;68678.46
510345;201802;158;104;54;99206.46;51210.92;150417.38
510350;201802;667;372;295;353946.06;281365.38;635311.44
510360;201802;202;119;83;113517.0;79099.92;192616.92
510370;201802;139;72;67;68659.38;63786.6;132445.98
510380;201802;92;63;29;60102.0;27657.0;87759.0
510385;201802;58;27;31;25758.0;29565.0;55323.0
510390;201802;121;51;70;48654.0;66741.84;115395.84
510395;201802;38;27;11;25758.0;10494.0;36252.0
510410;201802;707;466;241;444540.0;229890.69;674430.7
510420;201802;590;289;301;274751.25;285696.38;560447.6
510450;201802;50;30;20;28620.0;19080.0;47700.0
510452;201802;41;23;18;21942.0;17172.0;39114.0
510454;201802;65;27;38;25758.0;36242.46;62000.46
510455;201802;127;81;46;77254.92;43884.0;121138.92
510460;201802;181;95;86;90163.72;82006.38;172170.1
510480;201802;735;415;320;394783.88;304932.38;699716.25
510490;201802;361;185;176;176100.8;167399.08;343499.88
510500;201802;254;190;64;181250.45;61056.0;242306.45
510510;201802;783;450;333;428414.06;317672.47;746086.5
510515;201802;1141;607;534;578709.4;509398.38;1088107.8
510517;201802;242;103;139;97697.71;132582.69;230280.4
510520;201802;232;150;82;143007.3;77908.3;220915.6
510523;201802;92;63;29;60102.0;27656.46;87758.46
510525;201802;720;407;313;387514.3;298491.3;686005.6
510530;201802;17;12;5;11448.0;4770.0;16218.0
510550;201802;271;121;150;115425.0;143091.0;258516.0
510558;201802;278;137;141;130665.15;134485.92;265151.06
510560;201802;387;239;148;228006.0;141174.0;369180.0
510562;201802;637;445;192;423199.16;182681.45;605880.6
510590;201802;818;427;391;407320.38;372995.7;780316.06
510600;201802;256;139;117;132582.92;111580.92;244163.84
510610;201802;170;82;88;78208.92;83656.46;161865.38
510615;201802;192;79;113;75346.92;107802.0;183148.92
510617;201802;17;10;7;9540.0;6678.0;16218.0
510618;201802;115;55;60;52470.0;56763.0;109233.0
510619;201802;106;73;33;69633.0;31473.0;101106.0
510620;201802;188;105;83;100160.46;79182.0;179342.45
510621;201802;196;124;72;118277.46;68660.46;186937.92
510622;201802;452;292;160;278475.84;152316.38;430792.22
510623;201802;358;241;117;229867.38;111589.38;341456.75
510624;201802;87;40;47;38151.0;44838.0;82989.0
510625;201802;533;325;208;309840.3;197834.98;507675.28
510626;201802;108;67;41;63918.0;39114.0;103032.0
510627;201802;57;42;15;40068.0;14310.0;54378.0
510628;201802;162;97;65;92491.92;61952.76;154444.69
510629;201802;253;162;91;154548.0;85850.46;240398.45
510630;201802;462;234;228;223151.22;217175.48;440326.72
510631;201802;11;3;8;2862.0;7346.0;10208.0
510637;201802;344;193;151;183776.19;143907.84;327684.03
510642;201802;980;541;439;515763.2;418663.44;934426.6
510645;201802;0;0;0;0.0;0.0;0.0
510650;201802;1506;991;515;945278.94;491198.22;1436477.1
510665;201802;86;43;43;40966.0;41022.0;81988.0
510670;201802;65;36;29;34344.0;27666.0;62010.0
510675;201802;1168;701;467;668723.0;445495.22;1114218.2
510677;201802;366;174;192;164990.84;182742.69;347733.53
510680;201802;108;63;45;60084.0;42921.0;103005.0
510682;201802;202;96;106;91262.0;101124.0;192386.0
510685;201802;51;37;14;35298.0;13356.0;48654.0
510700;201802;622;361;261;344275.9;248860.77;593136.7
510704;201802;1057;571;486;542454.25;462068.53;1004522.75
510706;201802;127;61;66;58189.23;62926.92;121116.15
510710;201802;389;263;126;250704.06;120089.68;370793.75
510715;201802;64;47;17;44828.46;16218.0;61046.46
510718;201802;209;113;96;107708.76;91565.46;199274.22
510719;201802;36;19;17;18126.0;16218.0;34344.0
510720;201802;194;129;65;123057.0;61723.8;184780.8
510724;201802;88;37;51;35288.46;48621.38;83909.84
510726;201802;52;27;25;25748.46;23832.0;49580.46
510729;201802;78;37;41;35298.0;39075.84;74373.84
510730;201802;472;258;214;246114.0;204008.45;450122.47
510735;201802;112;44;68;41976.0;64872.0;106848.0
510740;201802;29;15;14;14310.0;13356.0;27666.0
510757;201802;19;15;4;14310.0;3816.0;18126.0
510760;201802;7049;3751;3298;3567854.2;3140005.8;6707860.0
510770;201802;729;348;381;331803.3;363269.75;695073.06
510774;201802;14;6;8;5724.0;7632.0;13356.0
510775;201802;111;84;27;80126.46;25748.46;105874.92
510776;201802;29;7;22;6678.0;20988.0;27666.0
510777;201802;188;84;104;80107.38;99187.38;179294.77
510779;201802;55;25;30;23841.0;28582.92;52423.92
510780;201802;297;164;133;156393.45;126798.0;283191.47
510785;201802;442;241;201;229857.3;191687.22;421544.53
510787;201802;186;94;92;89667.0;87750.23;177417.23
510788;201802;0;0;0;0.0;0.0;0.0
510790;201802;2390;1246;1144;1186574.4;1089229.0;2275803.2
510792;201802;1085;605;480;576673.5;457495.34;1034168.8
510794;201802;115;57;58;54378.0;55303.92;109681.92
510795;201802;2406;1397;1009;1325412.5;959636.6;2285049.0
510800;201802;178;107;71;102068.46;67725.0;169793.45
510805;201802;165;116;49;110664.0;46746.0;157410.0
510810;201802;93;38;55;36169.38;52346.52;88515.9
510820;201802;259;121;138;115197.46;130652.03;245849.48
510830;201802;66;40;26;38160.0;24795.0;62955.0
510835;201802;7;5;2;4770.0;1908.0;6678.0
510840;201802;9292;4605;4687;4378419.5;4464173.0;8842592.0
510850;201802;207;86;121;82034.46;115110.18;197144.64
510860;201802;386;169;217;161039.52;206327.8;367367.3
510880;201802;65;50;15;47681.46;14310.0;61991.46
510885;201802;72;44;28;41957.46;26683.38;68640.84
510890;201802;73;42;31;40068.0;29574.0;69642.0
510895;201802;188;107;81;102078.0;76965.46;179043.45
520005;201802;35;23;12;21942.0;11448.0;33390.0
520010;201802;280;126;154;120204.0;146821.0;267025.0
520013;201802;636;379;257;361538.0;244891.8;606429.8
520015;201802;51;37;14;35298.0;13356.0;48654.0
520017;201802;103;60;43;56954.0;41022.0;97976.0
520020;201802;28;14;14;13356.0;13356.0;26712.0
520025;201802;2012;1092;920;1040585.25;876812.4;1917397.6
520030;201802;800;408;392;388269.0;372393.9;760662.9
520050;201802;78;52;26;49608.0;24804.0;74412.0
520055;201802;45;30;15;28620.0;14310.0;42930.0
520060;201802;177;115;62;109710.0;59148.0;168858.0
520080;201802;590;407;183;388278.0;174582.0;562860.0
520082;201802;20;14;6;13356.0;5724.0;19080.0
520085;201802;98;72;26;68688.0;24804.0;93492.0
520090;201802;90;63;27;60102.0;25758.0;85860.0
520110;201802;8985;3885;5100;3701230.2;4861717.0;8562947.0
520120;201802;14;8;6;7431.66;5724.0;13155.66
520130;201802;754;531;223;506565.0;212733.0;719298.0
520140;201802;11766;6620;5146;6308045.0;4906350.0;1,12E+14
520145;201802;43;32;11;30528.0;10494.0;41022.0
520150;201802;191;150;41;143100.0;39114.0;182214.0
520160;201802;32;22;10;20988.0;9540.0;30528.0
520170;201802;232;143;89;136390.0;84869.0;221259.0
520180;201802;116;61;55;58194.0;52470.0;110664.0
520215;201802;209;129;80;122779.8;76033.8;198813.6
520235;201802;70;53;17;50562.0;16218.0;66780.0
520250;201802;135;81;54;77274.0;51229.8;128503.8
520260;201802;112;70;42;66780.0;39114.0;105894.0
520280;201802;47;34;13;31769.0;12402.0;44171.0
520310;201802;38;26;12;24804.0;11448.0;36252.0
520320;201802;163;105;58;100160.46;55332.0;155492.45
520330;201802;782;409;373;390140.47;355815.0;745955.44
520340;201802;352;201;151;191754.0;144035.45;335789.47
520350;201802;523;239;284;228006.0;270889.0;498895.0
520355;201802;89;50;39;47700.0;37206.0;84906.0
520357;201802;25;18;7;17172.0;6678.0;23850.0
520360;201802;0;0;0;0.0;0.0;0.0
520380;201802;138;72;66;68688.0;62964.0;131652.0
520390;201802;293;120;173;114003.0;164779.5;278782.5
520393;201802;12;9;3;8586.0;2862.0;11448.0
520396;201802;99;59;40;56286.0;38160.0;94446.0
520400;201802;226;132;94;124307.2;89676.0;213983.2
520410;201802;203;103;100;98253.0;95391.0;193644.0
520420;201802;22;15;7;14310.0;6678.0;20988.0
520425;201802;298;127;171;120205.0;162658.2;282863.2
520430;201802;453;234;219;222949.8;208870.0;431819.8
520440;201802;605;405;200;386322.3;190800.0;577122.3
520450;201802;1902;861;1041;820279.44;992468.0;1812747.5
520455;201802;57;40;17;38160.0;16218.0;54378.0
520460;201802;29;14;15;13356.0;14310.0;27666.0
520465;201802;24;20;4;19080.0;3816.0;22896.0
520470;201802;414;257;157;244872.62;149778.0;394650.62
520480;201802;82;47;35;44838.0;33345.0;78183.0
520485;201802;126;42;84;40068.0;79850.0;119918.0
520490;201802;403;299;104;285061.97;99051.92;384113.9
520495;201802;177;106;71;101124.0;67734.0;168858.0
520500;201802;176;133;43;126882.0;41022.0;167904.0
520505;201802;176;92;84;87763.23;80136.0;167899.23
520510;201802;1780;872;908;828588.75;864225.44;1692814.1
520520;201802;38;29;9;27666.0;8586.0;36252.0
520530;201802;231;171;60;160742.31;56440.54;217182.86
520540;201802;530;354;176;336409.03;167904.0;504313.03
520545;201802;162;88;74;83952.0;70596.0;154548.0
520547;201802;54;30;24;28620.0;22896.0;51516.0
520549;201802;1089;521;568;496710.0;541468.0;1038178.0
520551;201802;290;148;142;141192.0;135468.0;276660.0
520552;201802;46;27;19;25758.0;18126.0;43884.0
520570;201802;16;9;7;8586.0;6678.0;15264.0
520580;201802;283;171;112;163115.45;106848.0;269963.47
520590;201802;162;96;66;91584.0;62677.8;154261.8
520620;201802;1146;535;611;509532.47;582312.25;1091844.8
520630;201802;43;25;18;23850.0;17172.0;41022.0
520640;201802;415;235;180;224190.0;171720.0;395910.0
520650;201802;53;38;15;36252.0;14310.0;50562.0
520660;201802;35;19;16;18126.0;15264.0;33390.0
520670;201802;33;28;5;26712.0;4770.0;31482.0
520680;201802;58;38;20;36252.0;19080.0;55332.0
520690;201802;33;10;23;9540.0;21913.92;31453.92
520710;201802;37;33;4;31482.0;3816.0;35298.0
520725;201802;192;123;69;117342.0;65826.0;183168.0
520735;201802;59;42;17;40068.0;16218.0;56286.0
520740;201802;404;201;203;191039.4;193653.0;384692.4
520750;201802;37;27;10;25758.0;9540.0;35298.0
520753;201802;55;37;18;35298.0;17172.0;52470.0
520760;201802;107;72;35;68688.0;33390.0;102078.0
520780;201802;287;219;68;208926.0;64872.0;273798.0
520790;201802;166;81;85;76987.8;81090.0;158077.8
520800;201802;3466;1842;1624;1753869.5;1548618.9;3302488.5
520810;201802;162;113;49;107802.0;46746.0;154548.0
520815;201802;5;5;0;4770.0;0.0;4770.0
520830;201802;139;91;48;86814.0;45505.8;132319.8
520840;201802;346;227;119;216081.0;113526.0;329607.0
520850;201802;109;70;39;66771.0;37053.36;103824.36
520860;201802;1686;1069;617;1018405.56;587474.2;1605879.8
520870;201802;30708;15129;15579;1,44E+14;1,48E+14;2,93E+13
520880;201802;1065;589;476;561906.0;454084.9;1015990.94
520890;201802;794;456;338;433393.4;322347.47;755740.9
520910;201802;1028;539;489;510629.75;466506.0;977135.75
520915;201802;99;75;24;71550.0;22886.46;94436.46
520920;201802;405;196;209;186411.6;199386.0;385797.6
520929;201802;19;17;2;16218.0;1908.0;18126.0
520940;201802;76;48;28;45792.0;26712.0;72504.0
520945;201802;20;13;7;12402.0;6678.0;19080.0
520960;201802;47;31;16;29574.0;15264.0;44838.0
520970;201802;331;205;126;194941.0;119917.8;314858.8
520980;201802;89;65;24;62010.0;22896.0;84906.0
520990;201802;472;315;157;300510.0;149778.0;450288.0
520993;201802;128;61;67;58194.0;63909.0;122103.0
520995;201802;244;135;109;127837.0;103414.0;231251.0
521000;201802;1539;894;645;850873.4;615235.0;1466108.4
521010;201802;667;306;361;291597.38;344328.3;635925.7
521015;201802;17;10;7;9540.0;6678.0;16218.0
521020;201802;1469;1021;448;973404.9;427021.22;1400426.1
521030;201802;47;33;14;31482.0;13356.0;44838.0
521040;201802;939;577;362;550220.2;345062.0;895282.2
521056;201802;41;28;13;26712.0;12402.0;39114.0
521060;201802;132;82;50;78228.0;47700.0;125928.0
521080;201802;467;349;118;332651.0;112572.0;445223.0
521090;201802;532;321;211;304993.8;201017.34;506011.12
521100;201802;289;212;77;202239.0;73458.0;275697.0
521120;201802;1047;717;330;682205.6;314525.0;996730.6
521130;201802;359;255;104;243260.45;98330.6;341591.06
521140;201802;188;108;80;103032.0;76320.0;179352.0
521150;201802;2812;1219;1593;1161916.9;1518449.5;2680366.2
521160;201802;33;17;16;16218.0;15264.0;31482.0
521170;201802;195;114;81;108746.46;77274.0;186020.45
521180;201802;1120;707;413;672847.25;393287.2;1066134.5
521190;201802;2555;1083;1472;1033162.94;1403410.8;2436573.8
521200;201802;46;34;12;32436.0;11448.0;43884.0
521205;201802;15;11;4;10494.0;3816.0;14310.0
521210;201802;148;84;64;80136.0;61056.0;141192.0
521220;201802;811;548;263;520159.75;250846.0;771005.75
521225;201802;28;17;11;16218.0;10494.0;26712.0
521230;201802;113;74;39;70309.8;37206.0;107515.8
521250;201802;6761;3729;3032;3551026.0;2890221.2;6441247.5
521260;201802;18;13;5;12402.0;4770.0;17172.0
521270;201802;144;111;33;105894.0;31482.0;137376.0
521280;201802;437;256;181;243047.4;172674.0;415721.4
521290;201802;31;13;18;12402.0;17172.0;29574.0
521295;201802;100;68;32;64643.04;30528.0;95171.04
521300;201802;231;119;112;113508.0;106488.38;219996.38
521305;201802;36;24;12;22896.0;11448.0;34344.0
521308;201802;1084;786;298;749345.7;283997.0;1033342.7
521310;201802;1345;800;545;761915.4;518738.9;1280654.4
521340;201802;20;16;4;15264.0;3816.0;19080.0
521350;201802;133;98;35;93492.0;33390.0;126882.0
521370;201802;188;118;70;111618.0;66493.8;178111.8
521375;201802;191;107;84;102078.0;79849.8;181927.8
521377;201802;51;34;17;32436.0;16218.0;48654.0
521380;201802;1073;698;375;661744.25;357750.0;1019494.25
521385;201802;15;8;7;7632.0;6678.0;14310.0
521390;201802;104;85;19;80772.04;18126.0;98898.04
521400;201802;325;206;119;196237.8;113478.3;309716.1
521405;201802;148;75;73;71550.0;69642.0;141192.0
521410;201802;65;43;22;41022.0;20988.0;62010.0
521440;201802;211;146;65;138473.1;62010.0;200483.1
521450;201802;721;398;323;379692.0;308142.0;687834.0
521460;201802;1188;730;458;696133.8;436912.9;1133046.8
521470;201802;15;10;5;9540.0;4770.0;14310.0
521480;201802;48;32;16;30519.0;15199.0;45718.0
521483;201802;303;162;141;154262.0;134514.0;288776.0
521486;201802;287;182;105;173503.98;99503.0;273006.97
521487;201802;23;11;12;10494.0;11448.0;21942.0
521490;201802;28;16;12;15264.0;11448.0;26712.0
521500;201802;113;73;40;69642.0;38160.0;107802.0
521520;201802;42;31;11;29574.0;10494.0;40068.0
521523;201802;587;362;225;343121.78;214650.0;557771.75
521525;201802;45;30;15;28620.0;14023.8;42643.8
521530;201802;249;132;117;125928.0;111618.0;237546.0
521540;201802;31;16;15;15264.0;14310.0;29574.0
521550;201802;92;43;49;40707.92;46690.92;87398.84
521560;201802;796;544;252;518690.0;240265.0;758955.0
521565;201802;48;33;15;31482.0;14310.0;45792.0
521570;201802;491;330;161;314810.47;153499.3;468309.75
521580;201802;61;38;23;36252.0;21942.0;58194.0
521590;201802;36;19;17;18126.0;16218.0;34344.0
521600;201802;30;18;12;17172.0;11448.0;28620.0
521630;201802;236;118;118;112562.46;111581.96;224144.42
521640;201802;302;153;149;145962.0;142146.0;288108.0
521645;201802;30;16;14;15264.0;13356.0;28620.0
521680;201802;220;139;81;132606.0;77274.0;209880.0
521690;201802;3;2;1;1908.0;954.0;2862.0
521710;201802;1193;558;635;531473.8;605781.0;1137254.8
521720;201802;527;349;178;332936.47;169774.45;502710.9
521730;201802;629;304;325;290016.0;308943.56;598959.56
521740;201802;923;372;551;354859.9;524454.3;879314.25
521760;201802;1589;864;725;822678.6;691336.0;1514014.6
521770;201802;802;510;292;486540.0;278100.53;764640.56
521800;201802;2082;1290;792;1225623.0;755144.1;1980767.1
521805;201802;33;18;15;17172.0;14310.0;31482.0
521810;201802;92;58;34;54187.8;32436.0;86623.8
521830;201802;956;674;282;642042.44;269019.0;911061.44
521839;201802;94;63;31;60102.0;29574.0;89676.0
521850;201802;1106;588;518;559532.94;493847.7;1053380.6
521860;201802;345;211;134;201294.0;127550.0;328844.0
521870;201802;73;42;31;40068.0;29574.0;69642.0
521878;201802;42;20;22;19080.0;20988.0;40068.0
521880;201802;4482;2006;2476;1911433.4;2359616.8;4271050.0
521890;201802;571;395;176;376830.0;167617.8;544447.8
521900;201802;294;237;57;225461.95;54378.0;279839.97
521910;201802;154;108;46;103032.0;43884.0;146916.0
521920;201802;54;26;28;24804.0;26712.0;51516.0
521925;201802;36;21;15;20034.0;14310.0;34344.0
521930;201802;1119;637;482;607502.0;459175.34;1066677.4
521935;201802;33;25;8;23850.0;7632.0;31482.0
521940;201802;192;97;95;92538.0;90625.23;183163.23
521945;201802;14;12;2;11448.0;1908.0;13356.0
521950;201802;9;5;4;4770.0;3816.0;8586.0
521960;201802;73;54;19;51516.0;18126.0;69642.0
521970;201802;423;270;153;257293.8;145962.0;403255.8
521971;201802;96;47;49;44838.0;46746.0;91584.0
521973;201802;29;13;16;12402.0;15264.0;27666.0
521975;201802;1119;577;542;549314.2;516152.66;1065466.9
521980;201802;244;166;78;158364.0;74412.0;232776.0
521990;201802;72;53;19;50562.0;18126.0;68688.0
522000;201802;288;178;110;169812.0;104940.0;274752.0
522005;201802;21;13;8;12402.0;7632.0;20034.0
522010;201802;1124;631;493;601965.0;469749.6;1071714.6
522015;201802;54;33;21;31473.0;20034.0;51507.0
522020;201802;863;463;400;440748.2;380818.12;821566.3
522026;201802;30;22;8;20988.0;7632.0;28620.0
522028;201802;16;12;4;11448.0;3816.0;15264.0
522040;201802;751;297;454;283224.0;433061.47;716285.44
522045;201802;2073;1302;771;1240786.0;735000.8;1975786.9
522050;201802;169;81;88;77274.0;83952.0;161226.0
522060;201802;560;353;207;336475.8;197382.6;533858.4
522068;201802;136;90;46;85573.8;43884.0;129457.8
522070;201802;10;10;0;9540.0;0.0;9540.0
522100;201802;47;25;22;23582.88;20988.0;44570.88
522108;201802;40;30;10;28620.0;9540.0;38160.0
522119;201802;56;28;28;26712.0;26712.0;53424.0
522130;201802;75;28;47;26712.0;44820.0;71532.0
522140;201802;3696;1876;1820;1785217.2;1734115.9;3519333.2
522145;201802;51;30;21;28620.0;20034.0;48654.0
522150;201802;64;50;14;47700.0;13356.0;61056.0
522155;201802;57;41;16;39105.0;15264.0;54369.0
522157;201802;5;4;1;3816.0;954.0;4770.0
522160;201802;1729;1010;719;962045.0;685630.8;1647675.9
522170;201802;396;266;130;253764.0;124020.0;377784.0
522180;201802;36;20;16;19080.0;15264.0;34344.0
522185;201802;1298;545;753;516909.25;717841.0;1234750.2
522190;201802;48;27;21;25758.0;19938.6;45696.6
522200;201802;301;182;119;173628.0;113526.0;287154.0
522205;201802;166;110;56;104940.0;53424.0;158364.0
522220;201802;165;117;48;111618.0;45792.0;157410.0
522230;201802;31;24;7;22896.0;6678.0;29574.0
530010;201802;55608;28523;27085;2,71E+14;2,58E+14;5,29E+14
110001;201803;518;410;108;390156.34;102386.96;492543.3
110002;201803;2798;1682;1116;1602748.2;1063757.5;2666505.8
110003;201803;94;74;20;70596.0;19080.0;89676.0
110004;201803;2000;1280;720;1218219.0;686584.25;1904803.2
110005;201803;441;354;87;336560.9;82988.46;419549.38
110006;201803;447;343;104;326935.8;99196.92;426132.72
110007;201803;82;65;17;62010.0;16218.0;78228.0
110008;201803;240;136;104;128508.9;99216.0;227724.9
110009;201803;790;536;254;509151.2;242117.0;751268.2
110010;201803;1796;1114;682;1061523.0;650486.5;1712009.5
110011;201803;1884;1447;437;1378927.2;416868.34;1795795.5
110012;201803;4110;2396;1714;2278317.0;1633884.5;3912201.5
110013;201803;752;570;182;543770.44;173628.0;717398.44
110014;201803;369;316;53;301443.88;50562.0;352005.88
110015;201803;1428;1152;276;1096580.9;262712.53;1359293.4
110018;201803;1118;666;452;635050.0;431195.22;1066245.2
110020;201803;15330;9018;6312;8561065.0;6010748.0;1,46E+14
110025;201803;651;477;174;453060.12;165987.0;619047.1
110026;201803;42;29;13;27666.0;12402.0;40068.0
110028;201803;1653;1197;456;1137522.1;431431.44;1568953.6
110029;201803;140;123;17;117342.0;16218.0;133560.0
110030;201803;2470;1655;815;1575816.4;776609.44;2352425.8
110032;201803;398;308;90;293523.0;85856.0;379379.0
110033;201803;670;507;163;480675.0;155498.0;636173.0
110034;201803;358;265;93;250498.0;88055.0;338553.0
110037;201803;106;87;19;82998.0;18126.0;101124.0
110040;201803;340;228;112;217512.0;106848.0;324360.0
110045;201803;948;633;315;602336.0;298806.38;901142.4
110050;201803;94;76;18;72504.0;17172.0;89676.0
110060;201803;86;45;41;42930.0;39114.0;82044.0
110070;201803;124;74;50;70596.0;47414.0;118010.0
110080;201803;397;240;157;226737.19;149734.05;376471.22
110090;201803;33;27;6;25758.0;5724.0;31482.0
110092;201803;111;63;48;60102.0;45722.0;105824.0
110094;201803;200;139;61;132606.0;58194.0;190800.0
110100;201803;28;23;5;21942.0;4770.0;26712.0
110110;201803;71;44;27;41976.0;25758.0;67734.0
110120;201803;73;60;13;57240.0;12402.0;69642.0
110130;201803;303;244;59;231301.12;56286.0;287587.12
110140;201803;240;154;86;146725.2;82034.46;228759.66
110143;201803;48;40;8;38160.0;7632.0;45792.0
110145;201803;27;19;8;18126.0;7632.0;25758.0
110146;201803;23;12;11;11448.0;10494.0;21942.0
110147;201803;39;30;9;28620.0;8586.0;37206.0
110148;201803;39;27;12;25706.57;11448.0;37154.57
110149;201803;295;214;81;203869.8;77274.0;281143.8
110150;201803;84;57;27;54378.0;25758.0;80136.0
110155;201803;8;7;1;6678.0;954.0;7632.0
110160;201803;70;59;11;56286.0;10494.0;66780.0
110170;201803;209;170;39;162180.0;37206.0;199386.0
110175;201803;36;27;9;25758.0;8586.0;34344.0
110180;201803;92;80;12;76320.0;11448.0;87768.0
120001;201803;136;93;43;88680.0;40993.0;129673.0
120005;201803;192;119;73;113483.12;69642.0;183125.12
120010;201803;1021;657;364;619655.25;345023.16;964678.4
120013;201803;139;96;43;90897.94;40656.16;131554.1
120017;201803;93;59;34;56177.48;32393.12;88570.6
120020;201803;3514;2799;715;2641623.8;679457.7;3321081.2
120025;201803;598;337;261;318960.22;247912.6;566872.8
120030;201803;1014;848;166;800855.7;157606.12;958461.8
120032;201803;49;41;8;39092.12;7632.0;46724.12
120033;201803;214;188;26;179004.75;24804.0;203808.75
120034;201803;155;112;43;104918.12;40978.24;145896.36
120035;201803;28;19;9;18126.0;8586.0;26712.0
120038;201803;388;246;142;233859.88;135424.23;369284.12
120039;201803;23;21;2;20034.0;1908.0;21942.0
120040;201803;14031;9706;4325;9126307.0;4087345.8;1,32E+14
120042;201803;43;37;6;35298.0;5724.0;41022.0
120043;201803;13;3;10;2862.0;9540.0;12402.0
120045;201803;537;348;189;329911.38;180040.6;509951.97
120050;201803;1258;960;298;911056.75;283939.5;1194996.2
120060;201803;1423;1154;269;1084582.8;252862.69;1337445.4
120070;201803;504;361;143;338055.44;135080.55;473135.97
120080;201803;163;105;58;98962.3;54765.3;153727.6
130002;201803;148;103;45;98262.0;42930.0;141192.0
130006;201803;75;43;32;41022.0;30528.0;71550.0
130008;201803;144;77;67;72737.72;63195.96;135933.69
130010;201803;137;73;64;69642.0;61056.0;130698.0
130014;201803;234;171;63;163134.0;60102.0;223236.0
130020;201803;89;48;41;45792.0;39114.0;84906.0
130030;201803;895;545;350;519930.0;333890.47;853820.44
130040;201803;328;164;164;156456.0;155502.28;311958.28
130050;201803;555;307;248;292591.8;236592.0;529183.8
130060;201803;888;605;283;572021.2;267161.25;839182.44
130063;201803;548;291;257;277614.0;245156.12;522770.12
130068;201803;186;121;65;115434.0;61723.8;177157.8
130070;201803;1332;924;408;867977.6;384291.0;1252268.6
130080;201803;663;431;232;410792.4;221319.0;632111.4
130083;201803;70;38;32;35701.8;30528.0;66229.8
130090;201803;377;194;183;183396.95;174582.0;357978.97
130100;201803;1102;515;587;491310.0;559711.8;1051021.8
130110;201803;704;315;389;300360.0;371106.0;671466.0
130115;201803;175;70;105;66780.0;100170.0;166950.0
130120;201803;1616;1009;607;962586.0;579078.0;1541664.0
130130;201803;613;420;193;400680.0;184122.0;584802.0
130140;201803;1526;1148;378;1094529.0;359658.2;1454187.2
130150;201803;424;361;63;344394.0;60102.0;404496.0
130160;201803;467;262;205;249948.0;195570.0;445518.0
130165;201803;24;17;7;16218.0;6678.0;22896.0
130170;201803;937;666;271;635293.4;258534.0;893827.4
130180;201803;152;92;60;87291.0;57240.0;144531.0
130185;201803;2261;1183;1078;1126653.9;1027820.94;2154474.8
130190;201803;3607;2256;1351;2147996.8;1287266.0;3435262.8
130195;201803;291;233;58;222282.0;55332.0;277614.0
130200;201803;176;81;95;77264.46;90630.0;167894.45
130210;201803;78;39;39;37206.0;37206.0;74412.0
130220;201803;187;128;59;122112.0;56286.0;178398.0
130230;201803;333;209;124;199386.0;118296.0;317682.0
130240;201803;1454;918;536;874432.4;510766.84;1385199.2
130250;201803;4703;3031;1672;2885940.8;1594954.6;4480895.5
130255;201803;423;208;215;198432.0;204823.8;403255.8
130260;201803;53216;25462;27754;2,43E+14;2,65E+14;5,07E+14
130270;201803;1506;964;542;919369.8;517068.0;1436437.8
130280;201803;114;69;45;65826.0;42930.0;108756.0
130290;201803;2083;1508;575;1438632.0;548263.8;1986895.8
130300;201803;425;305;120;290683.8;114480.0;405163.8
130310;201803;880;464;416;442656.0;396864.0;839520.0
130320;201803;442;235;207;223236.0;197478.0;420714.0
130330;201803;707;426;281;406404.0;267787.8;674191.8
130340;201803;3266;1965;1301;1870031.2;1239723.2;3109754.5
130350;201803;466;298;168;284270.12;160272.0;444542.12
130353;201803;786;323;463;307856.0;441702.0;749558.0
130356;201803;767;350;417;333900.0;397531.8;731431.8
130360;201803;68;41;27;39114.0;25758.0;64872.0
130370;201803;674;499;175;476046.0;166950.0;642996.0
130380;201803;629;431;198;411174.0;188892.0;600066.0
130390;201803;485;391;94;373014.0;89676.0;462690.0
130395;201803;180;41;139;39114.0;132606.0;171720.0
130400;201803;70;47;23;44838.0;21942.0;66780.0
130406;201803;2074;1304;770;1240402.2;733369.75;1973772.0
130410;201803;500;214;286;204156.0;272824.9;476980.9
130420;201803;3192;2564;628;2442269.5;599112.0;3041381.5
130423;201803;161;75;86;71550.0;82044.0;153594.0
130426;201803;143;84;59;80136.0;56286.0;136422.0
130430;201803;405;268;137;255672.0;130698.0;386370.0
130440;201803;198;70;128;66780.0;122112.0;188892.0
140002;201803;36;14;22;13356.0;20988.0;34344.0
140005;201803;207;127;80;120919.5;76320.0;197239.5
140010;201803;10240;6921;3319;6567282.0;3163652.8;9730935.0
140015;201803;153;69;84;65826.0;80136.0;145962.0
140017;201803;111;77;34;73458.0;32436.0;105894.0
140020;201803;473;318;155;302418.0;147870.0;450288.0
140023;201803;26;16;10;15045.0;9540.0;24585.0
140028;201803;18;13;5;12402.0;4770.0;17172.0
140030;201803;357;255;102;243270.0;96706.98;339976.97
140040;201803;55;38;17;36252.0;16122.6;52374.6
140045;201803;248;116;132;109996.2;125928.0;235924.2
140047;201803;559;381;178;361462.38;169049.0;530511.4
140050;201803;148;97;51;91725.0;48654.0;140379.0
140060;201803;34;23;11;21207.42;10494.0;31701.42
140070;201803;31;28;3;26712.0;2862.0;29574.0
150010;201803;4733;2929;1804;2791547.5;1719183.2;4510731.0
150013;201803;149;103;46;98262.0;43884.0;142146.0
150020;201803;1071;569;502;542826.0;478908.0;1021734.0
150030;201803;730;298;432;284292.0;412128.0;696420.0
150034;201803;194;121;73;115434.0;69642.0;185076.0
150040;201803;1382;822;560;784188.0;534240.0;1318428.0
150050;201803;710;423;287;402540.8;273598.0;676138.8
150060;201803;4736;3066;1670;2920932.2;1592932.5;4513865.0
150070;201803;315;145;170;138330.0;162180.0;300510.0
150080;201803;14491;7284;7207;6937039.0;6867874.0;1,38E+14
150085;201803;379;239;140;227996.45;133560.0;361556.47
150090;201803;762;647;115;617238.0;109710.0;726948.0
150095;201803;348;212;136;201478.12;128923.56;330401.7
150100;201803;55;39;16;37206.0;15264.0;52470.0
150110;201803;172;84;88;80136.0;83952.0;164088.0
150120;201803;432;320;112;305280.0;106848.0;412128.0
150125;201803;54;23;31;21942.0;29574.0;51516.0
150130;201803;1891;1007;884;960678.0;843331.25;1804009.2
150140;201803;54462;25390;29072;2,42E+14;2,77E+13;5,19E+14
150145;201803;176;102;74;97308.0;70596.0;167904.0
150150;201803;2816;1260;1556;1201822.5;1480479.6;2682302.0
150157;201803;439;304;135;290016.0;128785.23;418801.22
150160;201803;124;100;24;95400.0;22896.0;118296.0
150170;201803;3670;2716;954;2587200.2;909829.8;3497030.0
150172;201803;322;222;100;211788.0;95400.0;307188.0
150175;201803;90;55;35;52470.0;33390.0;85860.0
150178;201803;764;512;252;487494.0;240408.0;727902.0
150180;201803;3057;1474;1583;1405385.6;1509581.1;2914966.8
150190;201803;336;215;121;205110.0;115434.0;320544.0
150195;201803;120;58;62;55332.0;59148.0;114480.0
150200;201803;205;96;109;91584.0;103986.0;195570.0
150210;201803;3172;2568;604;2448813.8;575973.5;3024787.2
150215;201803;509;333;176;317682.0;167904.0;485586.0
150220;201803;3908;2641;1267;2517954.8;1206600.4;3724555.0
150230;201803;1149;923;226;879962.06;215600.0;1095562.0
150240;201803;5793;3405;2388;3244928.8;2277857.0;5522785.5
150250;201803;34;16;18;15264.0;17172.0;32436.0
150260;201803;76;47;29;44838.0;27666.0;72504.0
150270;201803;2355;1536;819;1463447.8;780467.8;2243915.5
150275;201803;578;353;225;336762.0;214650.0;551412.0
150276;201803;107;45;62;42930.0;59148.0;102078.0
150277;201803;762;328;434;312893.47;414036.0;726929.44
150280;201803;340;209;131;199386.0;124974.0;324360.0
150285;201803;74;37;37;35298.0;35298.0;70596.0
150290;201803;968;592;376;564472.25;358418.0;922890.25
150293;201803;673;311;362;296494.47;345348.0;641842.44
150295;201803;467;209;258;199386.0;245979.44;445365.44
150300;201803;80;41;39;39114.0;37206.0;76320.0
150304;201803;140;95;45;90630.0;42930.0;133560.0
150307;201803;398;327;71;311958.0;67734.0;379692.0
150309;201803;554;401;153;382554.0;145962.0;528516.0
150310;201803;252;171;81;163134.0;77274.0;240408.0
150320;201803;1799;1241;558;1183632.6;532332.0;1715964.6
150330;201803;2065;1186;879;1130776.2;838566.0;1969342.2
150340;201803;201;136;65;129505.5;62010.0;191515.5
150345;201803;602;327;275;311776.75;262350.0;574126.75
150350;201803;413;323;90;305747.47;85860.0;391607.47
150360;201803;4509;2883;1626;2746714.2;1551194.5;4297908.5
150370;201803;760;539;221;513410.0;210538.8;723948.8
150375;201803;197;104;93;99216.0;88722.0;187938.0
150380;201803;1307;868;439;828072.0;418520.0;1246592.0
150390;201803;741;422;319;402584.0;304326.0;706910.0
150400;201803;98;81;17;77274.0;16218.0;93492.0
150405;201803;1250;825;425;786293.5;404877.6;1191171.1
150410;201803;138;89;49;84886.92;46746.0;131632.92
150420;201803;7462;4073;3389;3883983.5;3231415.8;7115399.0
150430;201803;493;332;161;316728.0;153594.0;470322.0
150440;201803;589;350;239;333137.0;228006.0;561143.0
150442;201803;2151;1155;996;1099342.0;949607.0;2048949.1
150445;201803;522;327;195;311958.0;185076.0;497034.0
150450;201803;269;126;143;120204.0;136422.0;256626.0
150460;201803;766;580;186;551493.06;177424.92;728918.0
150470;201803;1343;809;534;771500.0;509436.0;1280936.0
150475;201803;38;28;10;26712.0;9540.0;36252.0
150480;201803;1246;867;379;827118.0;361279.8;1188397.8
150490;201803;613;336;277;320544.0;264258.0;584802.0
150495;201803;330;232;98;221328.0;93492.0;314820.0
150497;201803;298;205;93;195570.0;88712.46;284282.47
150500;201803;426;288;138;274752.0;131652.0;406404.0
150503;201803;880;425;455;405164.0;434052.0;839216.0
150506;201803;1033;677;356;645858.0;339614.47;985472.44
150510;201803;1237;695;542;662744.0;517068.0;1179812.0
150520;201803;278;185;93;176490.0;88722.0;265212.0
150530;201803;1576;847;729;804890.3;694225.8;1499116.1
150540;201803;237;164;73;156456.0;69642.0;226098.0
150543;201803;703;400;303;381008.53;288775.8;669784.3
150548;201803;501;345;156;329130.0;148824.0;477954.0
150549;201803;61;41;20;39114.0;19080.0;58194.0
150550;201803;2889;1517;1372;1446265.0;1308602.0;2754867.0
150553;201803;3076;1818;1258;1732846.6;1200122.5;2932969.0
150555;201803;144;75;69;71550.0;65826.0;137376.0
150560;201803;52;39;13;37206.0;12402.0;49608.0
150563;201803;74;40;34;38160.0;32436.0;70596.0
150565;201803;165;97;68;92538.0;64872.0;157410.0
150570;201803;400;265;135;252790.92;128790.0;381580.9
150580;201803;1517;643;874;612754.2;833796.0;1446550.2
150590;201803;771;471;300;449334.0;286200.0;735534.0
150600;201803;461;276;185;263304.0;176490.0;439794.0
150610;201803;144;124;20;117447.0;19080.0;136527.0
150611;201803;128;89;39;84906.0;37206.0;122112.0
150613;201803;3204;1969;1235;1878426.0;1178181.0;3056607.0
150616;201803;486;300;186;285962.0;177444.0;463406.0
150618;201803;1138;626;512;596975.56;488448.0;1085423.6
150619;201803;393;300;93;286200.0;88722.0;374922.0
150620;201803;1281;742;539;707868.0;513919.8;1221787.8
150630;201803;306;205;101;195570.0;96354.0;291924.0
150635;201803;486;200;286;190800.0;272844.0;463644.0
150640;201803;62;30;32;28620.0;30528.0;59148.0
150650;201803;2329;1361;968;1298117.4;923181.0;2221298.2
150655;201803;246;183;63;174582.0;60102.0;234684.0
150658;201803;105;60;45;57240.0;42930.0;100170.0
150660;201803;483;339;144;323406.0;137376.0;460782.0
150670;201803;1004;364;640;346960.8;610541.44;957502.25
150680;201803;9903;5390;4513;5134889.0;4303352.5;9438241.0
150690;201803;52;33;19;31482.0;18126.0;49608.0
150700;201803;539;349;190;332755.2;181260.0;514015.2
150710;201803;276;164;112;156456.0;106848.0;263304.0
150715;201803;868;523;345;497959.9;329101.38;827061.3
150720;201803;438;338;100;322452.0;95113.8;417565.8
150730;201803;924;491;433;468405.0;412795.8;881200.8
150740;201803;229;161;68;153594.0;64872.0;218466.0
150745;201803;775;419;356;399726.0;339624.0;739350.0
150746;201803;55;32;23;30528.0;21942.0;52470.0
150747;201803;267;206;61;196524.0;58194.0;254718.0
150750;201803;130;75;55;71550.0;52470.0;124020.0
150760;201803;1703;1104;599;1053216.0;571446.0;1624662.0
150770;201803;373;193;180;184122.0;171544.95;355666.94
150775;201803;95;43;52;41022.0;49608.0;90630.0
150780;201803;187;99;88;94446.0;83952.0;178398.0
150790;201803;882;477;405;455058.0;386370.0;841428.0
150795;201803;1448;841;607;802314.0;579078.0;1381392.0
150796;201803;401;231;170;220374.0;161893.8;382267.8
150797;201803;284;159;125;151686.0;119250.0;270936.0
150800;201803;1413;855;558;814711.25;532332.0;1347043.2
150803;201803;598;494;104;471276.0;99216.0;570492.0
150805;201803;186;118;68;112572.0;64858.46;177430.45
150808;201803;995;545;450;519930.0;429300.0;949230.0
150810;201803;3398;2350;1048;2238457.0;999220.0;3237677.0
150812;201803;424;222;202;211788.0;192708.0;404496.0
150815;201803;965;632;333;601549.5;317682.0;919231.5
150820;201803;1566;956;610;911070.0;581920.94;1492990.9
150830;201803;827;579;248;551412.0;236592.0;788004.0
150835;201803;188;112;76;106848.0;72504.0;179352.0
150840;201803;1330;852;478;812808.0;456012.0;1268820.0
160005;201803;53;31;22;29574.0;20988.0;50562.0
160010;201803;190;118;72;112572.0;68684.0;181256.0
160015;201803;116;66;50;62964.0;47700.0;110664.0
160020;201803;127;73;54;69642.0;51516.0;121158.0
160021;201803;41;21;20;20034.0;19080.0;39114.0
160023;201803;110;64;46;61056.0;43884.0;104940.0
160025;201803;32;14;18;13356.0;17172.0;30528.0
160027;201803;1448;826;622;785237.9;592634.0;1377871.9
160030;201803;15499;7958;7541;7584316.0;7189375.5;1,48E+14
160040;201803;317;181;136;172674.0;129744.0;302418.0
160050;201803;667;340;327;324360.0;311671.8;636031.8
160053;201803;322;181;141;172388.0;134514.0;306902.0
160055;201803;25;18;7;17172.0;6678.0;23850.0
160060;201803;6374;3339;3035;3174708.8;2894432.2;6069141.0
160070;201803;161;99;62;94446.0;59148.0;153594.0
160080;201803;78;41;37;39114.0;35298.0;74412.0
170025;201803;24;16;8;15264.0;7632.0;22896.0
170030;201803;227;185;42;176293.0;40068.0;216361.0
170035;201803;225;110;115;104940.0;109710.0;214650.0
170040;201803;192;148;44;140905.8;41976.0;182881.8
170070;201803;320;189;131;180306.0;124974.0;305280.0
170100;201803;374;268;106;255672.0;101124.0;356796.0
170105;201803;62;51;11;48654.0;10494.0;59148.0
170110;201803;103;63;40;60102.0;38160.0;98262.0
170130;201803;70;32;38;30528.0;35966.0;66494.0
170190;201803;105;66;39;62964.0;37206.0;100170.0
170200;201803;392;260;132;247363.2;125823.76;373186.97
170210;201803;6009;3121;2888;2969052.8;2751890.8;5720943.5
170215;201803;94;44;50;41976.0;47700.0;89676.0
170220;201803;1419;1044;375;993781.8;357464.0;1351245.8
170230;201803;154;100;54;95400.0;51516.0;146916.0
170240;201803;549;363;186;345410.88;177444.0;522854.88
170255;201803;1111;889;222;847896.1;211501.8;1059397.9
170270;201803;37;28;9;26712.0;8395.2;35107.2
170290;201803;78;57;21;54378.0;20034.0;74412.0
170300;201803;80;52;28;48844.8;26712.0;75556.8
170305;201803;45;34;11;32436.0;10494.0;42930.0
170307;201803;65;48;17;45792.0;16218.0;62010.0
170310;201803;102;55;47;52470.0;44838.0;97308.0
170320;201803;17;14;3;13356.0;2862.0;16218.0
170330;201803;21;19;2;18126.0;1908.0;20034.0
170360;201803;24;14;10;13356.0;9540.0;22896.0
170370;201803;122;64;58;61056.0;55332.0;116388.0
170380;201803;81;57;24;54378.0;22896.0;77274.0
170382;201803;47;42;5;40068.0;4770.0;44838.0
170384;201803;129;94;35;89676.0;33390.0;123066.0
170386;201803;61;27;34;25758.0;32436.0;58194.0
170388;201803;48;18;30;17172.0;28620.0;45792.0
170389;201803;25;18;7;17172.0;6678.0;23850.0
170390;201803;53;30;23;28620.0;21942.0;50562.0
170410;201803;34;23;11;21942.0;10494.0;32436.0
170460;201803;16;12;4;11448.0;3816.0;15264.0
170510;201803;28;21;7;20034.0;6678.0;26712.0
170550;201803;1483;838;645;799452.0;614567.0;1414019.0
170555;201803;111;76;35;72504.0;33390.0;105894.0
170560;201803;97;70;27;66780.0;25758.0;92538.0
170600;201803;39;19;20;18126.0;19080.0;37206.0
170610;201803;192;102;90;97150.59;85842.0;182992.6
170625;201803;39;20;19;19080.0;18126.0;37206.0
170650;201803;85;64;21;61056.0;20034.0;81090.0
170700;201803;554;420;134;399440.3;127836.0;527276.3
170710;201803;157;97;60;92538.0;57231.0;149769.0
170720;201803;87;70;17;66780.0;16218.0;82998.0
170730;201803;60;35;25;33390.0;23850.0;57240.0
170740;201803;78;58;20;55332.0;19080.0;74412.0
170755;201803;70;37;33;34678.0;31482.0;66160.0
170765;201803;143;69;74;65206.0;70596.0;135802.0
170770;201803;223;129;94;121968.9;89676.0;211644.9
170820;201803;594;389;205;371106.0;195141.0;566247.0
170825;201803;30;19;11;18126.0;10494.0;28620.0
170830;201803;76;56;20;53233.2;19080.0;72313.2
170900;201803;201;152;49;145008.0;46746.0;191754.0
170930;201803;816;428;388;407988.0;369580.0;777568.0
170950;201803;3046;1327;1719;1264700.0;1636664.5;2901364.5
170980;201803;17;9;8;8586.0;7632.0;16218.0
171050;201803;132;102;30;97308.0;28620.0;125928.0
171070;201803;38;31;7;29574.0;6678.0;36252.0
171090;201803;39;29;10;27666.0;9540.0;37206.0
171110;201803;22;15;7;14310.0;6678.0;20988.0
171150;201803;39;18;21;17172.0;20034.0;37206.0
171180;201803;20;10;10;9540.0;9540.0;19080.0
171190;201803;138;81;57;77274.0;54378.0;131652.0
171195;201803;64;50;14;47700.0;13356.0;61056.0
171200;201803;47;20;27;19080.0;25758.0;44838.0
171215;201803;2;2;0;1908.0;0.0;1908.0
171240;201803;54;44;10;41976.0;9540.0;51516.0
171245;201803;53;48;5;45792.0;4770.0;50562.0
171250;201803;72;38;34;36252.0;32426.46;68678.46
171270;201803;17;13;4;12402.0;3816.0;16218.0
171280;201803;39;36;3;34201.0;2862.0;37063.0
171320;201803;1000;566;434;539964.0;413082.0;953046.0
171330;201803;423;203;220;193662.0;209880.0;403542.0
171360;201803;85;63;22;60102.0;20988.0;81090.0
171370;201803;24;13;11;12402.0;10494.0;22896.0
171380;201803;135;110;25;104940.0;23620.09;128560.09
171395;201803;54;33;21;31482.0;20034.0;51516.0
171420;201803;310;205;105;195570.0;99883.8;295453.8
171430;201803;63;50;13;47700.0;12402.0;60102.0
171488;201803;204;108;96;103032.0;91584.0;194616.0
171500;201803;59;32;27;30528.0;25758.0;56286.0
171510;201803;68;45;23;42930.0;21942.0;64872.0
171515;201803;43;37;6;35298.0;5724.0;41022.0
171525;201803;31;26;5;24804.0;4770.0;29574.0
171550;201803;13;7;6;6678.0;5724.0;12402.0
171570;201803;63;31;32;29574.0;30528.0;60102.0
171575;201803;341;211;130;201294.0;124010.46;325304.47
171610;201803;1693;849;844;808047.5;803609.1;1611656.6
171620;201803;133;92;41;87214.68;39114.0;126328.68
171630;201803;51;27;24;25758.0;22896.0;48654.0
171650;201803;274;180;94;171720.0;89676.0;261396.0
171660;201803;264;140;124;133560.0;118292.0;251852.0
171665;201803;46;30;16;28620.0;15264.0;43884.0
171670;201803;432;253;179;238443.27;170193.6;408636.88
171700;201803;63;55;8;52470.0;7632.0;60102.0
171720;201803;25;8;17;7632.0;16218.0;23850.0
171750;201803;104;54;50;51516.0;47700.0;99216.0
171780;201803;71;58;13;55332.0;12402.0;67734.0
171790;201803;80;66;14;62964.0;13356.0;76320.0
171800;201803;36;28;8;26712.0;7632.0;34344.0
171820;201803;2057;1162;895;1107839.8;849222.8;1957062.5
171830;201803;37;29;8;27666.0;7632.0;35298.0
171840;201803;62;35;27;33390.0;25758.0;59148.0
171845;201803;31;20;11;19080.0;10494.0;29574.0
171850;201803;39;27;12;25758.0;11448.0;37206.0
171855;201803;77;60;17;57240.0;16218.0;73458.0
171865;201803;8;7;1;6678.0;954.0;7632.0
171870;201803;32;23;9;21942.0;8586.0;30528.0
171875;201803;78;53;25;50562.0;23850.0;74412.0
171880;201803;27;19;8;18126.0;7632.0;25758.0
171884;201803;47;24;23;22896.0;21942.0;44838.0
171886;201803;118;41;77;39114.0;73171.8;112285.8
171888;201803;24;18;6;17172.0;5724.0;22896.0
171889;201803;19;15;4;14310.0;3816.0;18126.0
171890;201803;56;46;10;43884.0;9540.0;53424.0
171900;201803;42;29;13;27666.0;12402.0;40068.0
172000;201803;40;34;6;32436.0;5724.0;38160.0
172010;201803;40;33;7;30671.1;6678.0;37349.1
172015;201803;26;16;10;15264.0;9253.8;24517.8
172020;201803;129;81;48;77274.0;45792.0;123066.0
172025;201803;32;21;11;20034.0;10494.0;30528.0
172030;201803;36;20;16;19080.0;15264.0;34344.0
172049;201803;75;44;31;41976.0;29574.0;71550.0
172065;201803;148;96;52;91584.0;49608.0;141192.0
172080;201803;92;65;27;60827.84;25758.0;86585.84
172085;201803;25;12;13;11448.0;12402.0;23850.0
172090;201803;401;305;96;290970.0;90821.0;381791.0
172093;201803;25;18;7;17172.0;6678.0;23850.0
172097;201803;17;8;9;7632.0;8300.0;15932.0
172100;201803;4684;2624;2060;2498097.8;1962771.0;4460869.0
172110;201803;83;55;28;52470.0;26712.0;79182.0
172120;201803;1717;1471;246;1397217.6;233576.4;1630794.0
172125;201803;3;3;0;2862.0;0.0;2862.0
172130;201803;17;13;4;12402.0;3816.0;16218.0
172208;201803;194;124;70;118296.0;66780.0;185076.0
172210;201803;431;208;223;198432.0;212456.0;410888.0
210005;201803;2916;1821;1095;1734181.2;1041770.0;2775951.2
210010;201803;192;98;94;93492.0;89676.0;183168.0
210015;201803;29;19;10;18126.0;9540.0;27666.0
210020;201803;346;178;168;169812.0;160272.0;330084.0
210030;201803;344;214;130;204156.0;124011.0;328167.0
210040;201803;155;120;35;114480.0;33390.0;147870.0
210043;201803;252;169;83;161226.0;79182.0;240408.0
210047;201803;605;313;292;298220.4;278558.47;576778.9
210050;201803;296;216;80;206064.0;76320.0;282384.0
210055;201803;45;34;11;32436.0;10494.0;42930.0
210060;201803;567;442;125;421282.6;119250.0;540532.56
210070;201803;411;301;110;287154.0;104940.0;392094.0
210080;201803;104;96;8;91584.0;7632.0;99216.0
210083;201803;305;128;177;122112.0;168858.0;290970.0
210087;201803;44;32;12;30528.0;11448.0;41976.0
210090;201803;492;340;152;324360.0;145008.0;469368.0
210095;201803;494;353;141;336752.47;134514.0;471266.47
210100;201803;685;519;166;494792.1;157410.02;652202.1
210110;201803;147;79;68;75366.0;64872.0;140238.0
210120;201803;5462;4098;1364;3902286.0;1300002.6;5202288.5
210125;201803;217;123;94;117342.0;89676.0;207018.0
210130;201803;549;283;266;269028.0;253744.92;522772.9
210135;201803;35;21;14;20034.0;13356.0;33390.0
210140;201803;4327;3391;936;3231820.8;892706.0;4124526.8
210150;201803;357;225;132;214650.0;125928.0;340578.0
210160;201803;3348;2811;537;2678834.8;512012.0;3190846.8
210170;201803;1127;878;249;837612.0;237546.0;1075158.0
210173;201803;122;101;21;96354.0;20034.0;116388.0
210177;201803;466;226;240;215604.0;228960.0;444564.0
210180;201803;32;18;14;17172.0;13356.0;30528.0
210190;201803;412;262;150;249948.0;143100.0;393048.0
210193;201803;1;1;0;954.0;0.0;954.0
210197;201803;82;54;28;51516.0;26712.0;78228.0
210200;201803;635;501;134;477954.0;127836.0;605790.0
210203;201803;261;175;86;166950.0;82044.0;248994.0
210207;201803;382;295;87;281430.0;82998.0;364428.0
210210;201803;772;702;70;669708.0;66780.0;736488.0
210215;201803;77;65;12;62010.0;11448.0;73458.0
210220;201803;394;323;71;308142.0;67447.8;375589.8
210230;201803;300;224;76;213696.0;72504.0;286200.0
210232;201803;1475;933;542;889796.0;517068.0;1406864.0
210235;201803;153;118;35;112382.0;33390.0;145772.0
210237;201803;46;25;21;23850.0;20034.0;43884.0
210240;201803;94;76;18;72504.0;17172.0;89676.0
210250;201803;183;145;38;138330.0;36252.0;174582.0
210255;201803;343;252;91;240408.0;86814.0;327222.0
210260;201803;422;263;159;250902.0;151686.0;402588.0
210270;201803;695;441;254;420714.0;242316.0;663030.0
210275;201803;42;33;9;31482.0;8586.0;40068.0
210280;201803;1030;656;374;623009.3;355460.5;978469.8
210290;201803;501;323;178;308142.0;169812.0;477954.0
210300;201803;6107;3555;2552;3386833.2;2433416.2;5820249.5
210310;201803;104;71;33;67734.0;31482.0;99216.0
210312;201803;127;80;47;76320.0;44838.0;121158.0
210315;201803;116;84;32;80136.0;30528.0;110664.0
210317;201803;126;89;37;84906.0;35298.0;120204.0
210320;201803;2390;1966;424;1873853.9;404496.0;2278349.8
210325;201803;131;88;43;82998.0;40736.0;123734.0
210330;201803;5540;2826;2714;2691172.0;2589146.5;5280318.5
210340;201803;1399;1000;399;953200.0;380575.06;1333775.1
210350;201803;610;497;113;473899.5;107802.0;581701.5
210355;201803;132;106;26;101124.0;24804.0;125928.0
210360;201803;2651;1653;998;1573815.6;951806.0;2525621.5
210370;201803;1251;541;710;516114.0;676672.2;1192786.2
210375;201803;185;99;86;93903.0;82044.0;175947.0
210380;201803;726;542;184;517068.0;175536.0;692604.0
210390;201803;204;167;37;159318.0;35298.0;194616.0
210400;201803;406;338;68;322452.0;64853.0;387305.0
210405;201803;1007;666;341;635364.0;325314.0;960678.0
210407;201803;56;44;12;41976.0;11448.0;53424.0
210408;201803;64;57;7;54378.0;6678.0;61056.0
210409;201803;313;261;52;248994.0;49608.0;298602.0
210410;201803;437;338;99;322452.0;94437.0;416889.0
210420;201803;195;159;36;151686.0;34344.0;186030.0
210430;201803;35;27;8;25758.0;7632.0;33390.0
210440;201803;376;226;150;215604.0;143100.0;358704.0
210450;201803;149;111;38;105894.0;36252.0;142146.0
210455;201803;221;121;100;115434.0;95400.0;210834.0
210460;201803;348;219;129;208926.0;123066.0;331992.0
210462;201803;61;51;10;48654.0;9540.0;58194.0
210465;201803;173;125;48;119250.0;45792.0;165042.0
210467;201803;521;372;149;354888.0;142146.0;497034.0
210470;201803;45;33;12;31482.0;11448.0;42930.0
210480;201803;1303;917;386;874818.0;368244.0;1243062.0
210490;201803;225;134;91;127836.0;86814.0;214650.0
210500;201803;571;297;274;283338.0;261396.0;544734.0
210510;201803;555;431;124;411174.0;118296.0;529470.0
210515;201803;445;242;203;230868.0;193662.0;424530.0
210520;201803;398;347;51;330751.8;48654.0;379405.8
210530;201803;9384;5030;4354;4786471.0;4147884.0;8934355.0
210535;201803;131;94;37;89676.0;35298.0;124974.0
210540;201803;1539;922;617;878443.8;587187.0;1465630.8
210542;201803;1165;585;580;557708.4;552748.0;1110456.4
210545;201803;13;12;1;11448.0;954.0;12402.0
210547;201803;136;116;20;110664.0;19080.0;129744.0
210550;201803;739;517;222;491670.0;211788.0;703458.0
210560;201803;174;145;29;138330.0;27666.0;165996.0
210565;201803;30;21;9;20034.0;8586.0;28620.0
210570;201803;1369;1072;297;1022688.0;283338.0;1306026.0
210580;201803;106;92;14;87768.0;13356.0;101124.0
210590;201803;770;602;168;573544.8;160272.0;733816.8
210592;201803;31;27;4;25758.0;3816.0;29574.0
210594;201803;103;84;19;80136.0;18126.0;98262.0
210596;201803;82;69;13;65826.0;12402.0;78228.0
210598;201803;124;91;33;86814.0;31482.0;118296.0
210600;201803;335;281;54;268074.0;51516.0;319590.0
210610;201803;247;229;18;217512.0;17172.0;234684.0
210620;201803;47;28;19;26712.0;18126.0;44838.0
210630;201803;60;57;3;54378.0;2862.0;57240.0
210632;201803;1115;738;377;704052.0;359163.0;1063215.0
210635;201803;16;13;3;12402.0;2862.0;15264.0
210637;201803;106;74;32;70596.0;30528.0;101124.0
210640;201803;586;511;75;487494.0;71550.0;559044.0
210650;201803;407;326;81;310078.62;76320.0;386398.62
210660;201803;403;286;117;272177.0;111494.0;383671.0
210663;201803;17;10;7;9540.0;6678.0;16218.0
210667;201803;116;36;80;34344.0;76320.0;110664.0
210670;201803;270;237;33;225383.0;31482.0;256865.0
210675;201803;570;294;276;280476.0;263304.0;543780.0
210680;201803;213;134;79;127836.0;75366.0;203202.0
210690;201803;645;507;138;483678.0;131652.0;615330.0
210700;201803;193;140;53;133560.0;50562.0;184122.0
210710;201803;299;165;134;157219.2;127836.0;285055.2
210720;201803;125;104;21;99216.0;20034.0;119250.0
210725;201803;65;57;8;54378.0;7632.0;62010.0
210730;201803;24;18;6;17172.0;5724.0;22896.0
210735;201803;417;278;139;265212.0;132320.0;397532.0
210740;201803;542;458;84;436932.0;80136.0;517068.0
210745;201803;152;109;43;103986.0;41022.0;145008.0
210750;201803;2424;1097;1327;1044583.0;1265938.9;2310522.0
210760;201803;276;201;75;191754.0;71535.69;263289.7
210770;201803;399;306;93;291924.0;88435.8;380359.8
210780;201803;421;303;118;289062.0;112572.0;401634.0
210790;201803;184;142;42;135468.0;40068.0;175536.0
210800;201803;137;102;35;97308.0;33390.0;130698.0
210805;201803;41;37;4;35298.0;3816.0;39114.0
210810;201803;485;368;117;350404.2;111618.0;462022.2
210820;201803;2315;1826;489;1733888.5;466506.0;2200394.5
210825;201803;170;87;83;82998.0;79182.0;162180.0
210830;201803;804;486;318;462690.0;302418.0;765108.0
210840;201803;215;142;73;135468.0;69642.0;205110.0
210845;201803;252;157;95;149778.0;90630.0;240408.0
210850;201803;856;544;312;518976.0;297648.0;816624.0
210860;201803;4152;2123;2029;2023148.2;1935360.8;3958509.0
210870;201803;466;348;118;331992.0;112572.0;444564.0
210880;201803;57;39;18;37206.0;17172.0;54378.0
210890;201803;339;278;61;265212.0;58194.0;323406.0
210900;201803;568;371;197;353930.0;187938.0;541868.0
210905;201803;71;35;36;33390.0;34344.0;67734.0
210910;201803;2006;1480;526;1410344.0;501804.0;1912148.0
210920;201803;229;66;163;62964.0;155502.0;218466.0
210923;201803;81;57;24;54378.0;22896.0;77274.0
210927;201803;437;181;256;172674.0;244224.0;416898.0
210930;201803;60;47;13;44838.0;12402.0;57240.0
210940;201803;92;69;23;65826.0;21942.0;87768.0
210945;201803;192;87;105;82998.0;100170.0;183168.0
210950;201803;505;364;141;347256.0;134509.23;481765.22
210955;201803;75;49;26;46746.0;24804.0;71550.0
210960;201803;2453;1032;1421;982906.4;1355348.0;2338254.5
210970;201803;114;98;16;93492.0;15264.0;108756.0
210975;201803;89;80;9;76320.0;8586.0;84906.0
210980;201803;1235;527;708;502643.53;675146.0;1177789.5
210990;201803;4379;2714;1665;2588055.2;1588410.0;4176465.2
211000;201803;1378;1084;294;1033850.0;280189.8;1314039.8
211003;201803;922;629;293;600066.0;279513.0;879579.0
211010;201803;479;418;61;398772.0;58194.0;456966.0
211020;201803;1612;581;1031;554274.0;983354.56;1537628.6
211023;201803;26;22;4;20701.8;3816.0;24517.8
211027;201803;64;40;24;38160.0;22896.0;61056.0
211030;201803;382;255;127;243270.0;121158.0;364428.0
211040;201803;317;238;79;226766.0;75366.0;302132.0
211050;201803;1184;749;435;714546.0;414699.22;1129245.2
211060;201803;686;581;105;551797.7;100170.0;651967.7
211065;201803;23;19;4;18126.0;3816.0;21942.0
211070;201803;916;743;173;707210.75;165042.0;872252.75
211080;201803;88;84;4;80136.0;3816.0;83952.0
211085;201803;59;31;28;29288.0;26712.0;56000.0
211090;201803;94;76;18;72504.0;17172.0;89676.0
211100;201803;508;403;105;384462.0;100170.0;484632.0
211102;201803;262;174;88;165996.0;83952.0;249948.0
211105;201803;221;151;70;144054.0;66780.0;210834.0
211107;201803;134;76;58;72504.0;55332.0;127836.0
211110;201803;825;531;294;506002.0;280467.0;786469.0
211120;201803;5808;2445;3363;2327152.5;3207210.2;5534363.0
211125;201803;35;28;7;26712.0;6678.0;33390.0
211130;201803;45951;18977;26974;1,81E+14;2,57E+14;4,38E+14
211140;201803;427;360;67;342482.0;63918.0;406400.0
211150;201803;1254;791;463;754280.1;441412.0;1195692.1
211153;201803;166;97;69;92538.0;65826.0;158364.0
211157;201803;60;44;16;41976.0;15264.0;57240.0
211160;201803;707;585;122;557123.5;116388.0;673511.5
211163;201803;0;0;0;0.0;0.0;0.0
211167;201803;7;5;2;4770.0;1908.0;6678.0
211170;201803;446;309;137;294786.0;130698.0;425484.0
211172;201803;124;86;38;82044.0;36252.0;118296.0
211174;201803;281;161;120;153594.0;114480.0;268074.0
211176;201803;519;372;147;354888.0;140238.0;495126.0
211178;201803;96;62;34;59148.0;32436.0;91584.0
211180;201803;208;163;45;155502.0;42767.82;198269.81
211190;201803;62;57;5;54378.0;4770.0;59148.0
211195;201803;25;16;9;15264.0;8586.0;23850.0
211200;201803;156;134;22;127492.56;20988.0;148480.56
211210;201803;532;328;204;312244.2;194616.0;506860.2
211220;201803;3984;2229;1755;2118623.5;1666983.6;3785607.0
211223;201803;97;90;7;85678.74;6678.0;92356.74
211227;201803;72;49;23;46746.0;21942.0;68688.0
211230;201803;779;631;148;601830.9;141172.92;743003.8
211240;201803;416;311;105;296694.0;100170.0;396864.0
211245;201803;210;92;118;87768.0;112572.0;200340.0
211250;201803;1637;1395;242;1329838.1;230868.0;1560706.1
211260;201803;812;636;176;606744.0;167904.0;774648.0
211270;201803;2091;1638;453;1562652.0;431208.2;1993860.2
211280;201803;1821;1080;741;1029366.8;706914.0;1736280.8
211285;201803;207;118;89;112572.0;84906.0;197478.0
211290;201803;683;455;228;433879.2;217512.0;651391.2
211300;201803;809;621;188;592156.06;179352.0;771508.06
211400;201803;1606;902;704;860508.0;671616.0;1532124.0
220005;201803;18;17;1;16218.0;954.0;17172.0
220010;201803;88;67;21;63918.0;19747.8;83665.8
220020;201803;608;476;132;453119.03;125928.0;579047.06
220025;201803;106;102;4;97308.0;3816.0;101124.0
220027;201803;34;27;7;25758.0;6678.0;32436.0
220030;201803;99;81;18;77274.0;17172.0;94446.0
220040;201803;1122;840;282;800284.94;268933.0;1069217.9
220045;201803;39;28;11;26712.0;10494.0;37206.0
220050;201803;647;528;119;502550.97;113506.92;616057.9
220060;201803;176;150;26;143100.0;24804.0;167904.0
220070;201803;94;84;10;80136.0;9540.0;89676.0
220080;201803;10;8;2;7632.0;1908.0;9540.0
220090;201803;35;28;7;26426.0;6678.0;33104.0
220095;201803;2;1;1;954.0;954.0;1908.0
220100;201803;28;24;4;22896.0;3816.0;26712.0
220105;201803;29;27;2;25758.0;1908.0;27666.0
220110;201803;207;191;16;181927.8;15264.0;197191.8
220115;201803;47;44;3;41976.0;2862.0;44838.0
220117;201803;18;17;1;16218.0;954.0;17172.0
220120;201803;1528;1056;472;1006795.3;450268.9;1457064.2
220130;201803;26;25;1;23850.0;954.0;24804.0
220140;201803;98;78;20;73458.0;19080.0;92538.0
220150;201803;451;319;132;304326.0;125928.0;430254.0
220155;201803;4;4;0;3816.0;0.0;3816.0
220157;201803;17;14;3;13356.0;2862.0;16218.0
220160;201803;72;62;10;59148.0;9540.0;68688.0
220170;201803;34;32;2;30528.0;1908.0;32436.0
220173;201803;7;7;0;6678.0;0.0;6678.0
220177;201803;5;5;0;4770.0;0.0;4770.0
220180;201803;66;65;1;62005.23;668.0;62673.23
220190;201803;1055;943;112;899622.0;106848.0;1006470.0
220191;201803;41;36;5;34344.0;4770.0;39114.0
220192;201803;62;59;3;56286.0;2862.0;59148.0
220194;201803;32;28;4;26712.0;3816.0;30528.0
220196;201803;103;85;18;81090.0;17172.0;98262.0
220198;201803;6;4;2;3816.0;1908.0;5724.0
220200;201803;435;355;80;339497.0;76320.0;415817.0
220202;201803;37;33;4;31482.0;3816.0;35298.0
220205;201803;41;35;6;33390.0;5724.0;39114.0
220207;201803;19;18;1;17172.0;954.0;18126.0
220208;201803;84;44;40;41976.0;38160.0;80136.0
220209;201803;31;28;3;26712.0;2862.0;29574.0
220210;201803;15;13;2;12402.0;1908.0;14310.0
220211;201803;28;28;0;26712.0;0.0;26712.0
220213;201803;41;37;4;35298.0;3530.0;38828.0
220217;201803;36;28;8;26712.0;7632.0;34344.0
220220;201803;2024;1286;738;1223238.6;702649.94;1925888.6
220225;201803;15;8;7;7632.0;6678.0;14310.0
220230;201803;933;740;193;705511.6;183482.81;888994.44
220240;201803;146;134;12;127836.0;11448.0;139284.0
220245;201803;33;30;3;27917.04;2862.0;30779.04
220250;201803;105;94;11;89676.0;10494.0;100170.0
220253;201803;43;35;8;33390.0;7632.0;41022.0
220255;201803;28;25;3;23850.0;2862.0;26712.0
220260;201803;686;499;187;476046.0;178398.0;654444.0
220265;201803;17;14;3;13356.0;2862.0;16218.0
220270;201803;669;592;77;564042.94;72981.0;637023.94
220271;201803;45;37;8;35298.0;7632.0;42930.0
220272;201803;27;26;1;24804.0;954.0;25758.0
220273;201803;14;12;2;11448.0;1908.0;13356.0
220275;201803;58;47;11;44838.0;10494.0;55332.0
220277;201803;11;9;2;8586.0;1908.0;10494.0
220280;201803;14;12;2;11448.0;1908.0;13356.0
220285;201803;43;40;3;38160.0;2862.0;41022.0
220290;201803;1377;1177;200;1120330.0;190753.0;1311083.0
220300;201803;54;53;1;50562.0;954.0;51516.0
220310;201803;316;265;51;252806.0;48645.0;301451.0
220320;201803;429;395;34;375400.0;32436.0;407836.0
220323;201803;0;0;0;0.0;0.0;0.0
220325;201803;15;10;5;9540.0;4770.0;14310.0
220327;201803;11;10;1;9540.0;954.0;10494.0
220330;201803;200;136;64;129744.0;61056.0;190800.0
220335;201803;139;121;18;115434.0;17172.0;132606.0
220340;201803;21;12;9;11448.0;8586.0;20034.0
220342;201803;56;47;9;44838.0;8586.0;53424.0
220345;201803;83;75;8;71550.0;7632.0;79182.0
220350;201803;430;377;53;357035.4;50562.0;407597.4
220360;201803;43;31;12;29574.0;11448.0;41022.0
220370;201803;1107;885;222;843336.0;211501.8;1054837.8
220375;201803;28;26;2;24804.0;1908.0;26712.0
220380;201803;38;31;7;29574.0;6678.0;36252.0
220385;201803;28;24;4;22896.0;3816.0;26712.0
220390;201803;2232;1268;964;1204978.5;918273.5;2123252.0
220400;201803;28;26;2;24804.0;1908.0;26712.0
220410;201803;14;13;1;12402.0;954.0;13356.0
220415;201803;13;12;1;11448.0;954.0;12402.0
220420;201803;124;103;21;98262.0;19747.8;118009.8
220430;201803;131;118;13;110903.8;12402.0;123305.8
220435;201803;21;15;6;14306.0;5724.0;20030.0
220440;201803;292;247;45;235638.0;42930.0;278568.0
220450;201803;329;168;161;159106.98;153594.0;312700.97
220455;201803;53;51;2;48654.0;1908.0;50562.0
220460;201803;15;15;0;13642.2;0.0;13642.2
220465;201803;108;68;40;64872.0;38160.0;103032.0
220470;201803;240;212;28;202248.0;26712.0;228960.0
220480;201803;72;61;11;58194.0;10494.0;68688.0
220490;201803;86;75;11;71550.0;10494.0;82044.0
220500;201803;96;83;13;79182.0;12402.0;91584.0
220510;201803;380;302;78;287345.0;74221.2;361566.2
220515;201803;21;17;4;16218.0;3816.0;20034.0
220520;201803;369;331;38;314459.0;36233.0;350692.0
220525;201803;26;18;8;17172.0;7632.0;24804.0
220527;201803;36;28;8;26712.0;6822.0;33534.0
220530;201803;33;12;21;11448.0;20034.0;31482.0
220535;201803;11;10;1;9540.0;954.0;10494.0
220540;201803;64;50;14;47700.0;13356.0;61056.0
220545;201803;60;39;21;37206.0;20034.0;57240.0
220550;201803;647;492;155;468604.8;147870.0;616474.8
220551;201803;27;20;7;19080.0;6678.0;25758.0
220552;201803;8;8;0;7632.0;0.0;7632.0
220553;201803;45;41;4;39114.0;3816.0;42930.0
220554;201803;13;8;5;7345.8;4770.0;12115.8
220555;201803;24;20;4;19080.0;3816.0;22896.0
220556;201803;55;51;4;48654.0;3816.0;52470.0
220557;201803;56;50;6;47700.0;5724.0;53424.0
220558;201803;7;2;5;1908.0;4770.0;6678.0
220559;201803;6;5;1;4770.0;954.0;5724.0
220560;201803;57;37;20;35107.2;19080.0;54187.2
220570;201803;798;474;324;450706.12;309096.0;759802.1
220580;201803;565;515;50;491310.0;47013.92;538323.94
220585;201803;6;5;1;4770.0;954.0;5724.0
220590;201803;14;14;0;13356.0;0.0;13356.0
220595;201803;58;43;15;41022.0;14310.0;55332.0
220600;201803;21;12;9;11448.0;8586.0;20034.0
220605;201803;20;19;1;18126.0;954.0;19080.0
220610;201803;62;53;9;50562.0;8586.0;59148.0
220620;201803;558;435;123;414751.5;117342.0;532093.5
220630;201803;6;4;2;3816.0;1908.0;5724.0
220635;201803;37;33;4;31482.0;3816.0;35298.0
220640;201803;98;77;21;73458.0;20034.0;93492.0
220650;201803;114;108;6;103032.0;5724.0;108756.0
220660;201803;28;22;6;20988.0;5724.0;26712.0
220665;201803;4;4;0;3816.0;0.0;3816.0
220667;201803;12;11;1;10494.0;954.0;11448.0
220669;201803;25;22;3;20988.0;2862.0;23850.0
220670;201803;69;54;15;51325.2;14310.0;65635.2
220672;201803;61;40;21;38160.0;20034.0;58194.0
220675;201803;35;27;8;25758.0;7632.0;33390.0
220680;201803;35;29;6;27666.0;5724.0;33390.0
220690;201803;46;44;2;41976.0;1908.0;43884.0
220695;201803;61;29;32;27666.0;30528.0;58194.0
220700;201803;1537;1176;361;1120062.8;344394.0;1464456.8
220710;201803;3;1;2;954.0;1908.0;2862.0
220720;201803;110;89;21;84667.5;19890.9;104558.4
220730;201803;19;18;1;17172.0;954.0;18126.0
220735;201803;3;1;2;954.0;1908.0;2862.0
220740;201803;45;41;4;39114.0;3816.0;42930.0
220750;201803;101;82;19;78228.0;18126.0;96354.0
220755;201803;14;14;0;13356.0;0.0;13356.0
220760;201803;52;49;3;46746.0;2862.0;49608.0
220770;201803;5791;2894;2897;2755666.8;2757601.5;5513268.0
220775;201803;26;12;14;11448.0;13356.0;24804.0
220777;201803;15;14;1;13356.0;954.0;14310.0
220779;201803;18;14;4;13356.0;3816.0;17172.0
220780;201803;876;747;129;711970.2;122780.0;834750.2
220785;201803;12;6;6;5724.0;5724.0;11448.0
220790;201803;1009;802;207;762706.0;197478.0;960184.0
220793;201803;13;13;0;12402.0;0.0;12402.0
220795;201803;22;21;1;20034.0;954.0;20988.0
220800;201803;3908;2979;929;2840323.2;885003.9;3725327.2
220810;201803;58;52;6;49608.0;5724.0;55332.0
220820;201803;239;217;22;207018.0;20988.0;228006.0
220830;201803;1162;984;178;938731.25;169793.0;1108524.2
220840;201803;2433;1613;820;1525641.8;780182.0;2305823.8
220850;201803;52;42;10;40068.0;9540.0;49608.0
220855;201803;14;9;5;8586.0;4770.0;13356.0
220860;201803;8;7;1;6678.0;954.0;7632.0
220865;201803;24;22;2;20988.0;1908.0;22896.0
220870;201803;57;55;2;52470.0;1908.0;54378.0
220880;201803;318;243;75;231154.2;71264.0;302418.2
220885;201803;44;40;4;38160.0;3816.0;41976.0
220887;201803;18;17;1;16218.0;954.0;17172.0
220890;201803;102;90;12;85860.0;11448.0;97308.0
220900;201803;47;26;21;24804.0;20034.0;44838.0
220910;201803;53;45;8;42930.0;7632.0;50562.0
220915;201803;10;9;1;8586.0;954.0;9540.0
220920;201803;36;32;4;30528.0;3816.0;34344.0
220930;201803;42;41;1;39114.0;954.0;40068.0
220935;201803;15;15;0;14310.0;0.0;14310.0
220937;201803;44;41;3;39114.0;2862.0;41976.0
220940;201803;52;48;4;45792.0;3816.0;49608.0
220945;201803;0;0;0;0.0;0.0;0.0
220950;201803;47;43;4;41022.0;3816.0;44838.0
220955;201803;35;30;5;28620.0;4770.0;33390.0
220960;201803;2;2;0;1908.0;0.0;1908.0
220965;201803;28;24;4;22896.0;3816.0;26712.0
220970;201803;46;39;7;37206.0;6678.0;43884.0
220975;201803;9;8;1;7632.0;954.0;8586.0
220980;201803;34;32;2;30528.0;1908.0;32436.0
220985;201803;64;57;7;54378.0;6678.0;61056.0
220987;201803;31;30;1;28620.0;954.0;29574.0
220990;201803;13;12;1;11448.0;954.0;12402.0
220995;201803;38;33;5;31482.0;4770.0;36252.0
220997;201803;39;32;7;30528.0;6678.0;37206.0
221000;201803;1127;1015;112;964877.6;106561.8;1071439.4
221005;201803;63;57;6;54378.0;5724.0;60102.0
221010;201803;16;13;3;12402.0;2862.0;15264.0
221020;201803;45;43;2;41022.0;1908.0;42930.0
221030;201803;27;22;5;20988.0;4770.0;25758.0
221035;201803;19;19;0;18126.0;0.0;18126.0
221037;201803;12;6;6;5724.0;5724.0;11448.0
221038;201803;23;21;2;20034.0;1908.0;21942.0
221039;201803;23;23;0;21942.0;0.0;21942.0
221040;201803;253;218;35;207972.0;33390.0;241362.0
221050;201803;232;195;37;186030.0;35298.0;221328.0
221060;201803;1713;1505;208;1434254.8;198432.0;1632686.8
221062;201803;28;27;1;25758.0;954.0;26712.0
221063;201803;13;9;4;8586.0;3816.0;12402.0
221065;201803;50;43;7;41022.0;6678.0;47700.0
221070;201803;137;118;19;112572.0;18126.0;130698.0
221080;201803;377;335;42;319590.0;39781.8;359371.8
221090;201803;36;35;1;33390.0;954.0;34344.0
221093;201803;56;37;19;35298.0;18126.0;53424.0
221095;201803;11;10;1;9540.0;954.0;10494.0
221097;201803;22;19;3;18126.0;2862.0;20988.0
221100;201803;24518;14071;10447;1,34E+14;9961147.0;2,34E+14
221110;201803;1026;752;274;717122.0;261396.0;978518.0
221120;201803;529;394;135;375590.0;128790.0;504380.0
221130;201803;932;759;173;722846.8;165042.0;887888.8
221135;201803;34;31;3;29574.0;2862.0;32436.0
221140;201803;40;32;8;30528.0;7632.0;38160.0
221150;201803;15;12;3;11448.0;2862.0;14310.0
221160;201803;11;11;0;10494.0;0.0;10494.0
221170;201803;13;13;0;12402.0;0.0;12402.0
230010;201803;161;150;11;143100.0;10494.0;153594.0
230015;201803;116;95;21;90630.0;20034.0;110664.0
230020;201803;1535;1310;225;1247451.0;213748.88;1461199.9
230030;201803;1620;1165;455;1105841.0;434070.0;1539911.0
230040;201803;198;174;24;165042.0;22896.0;187938.0
230050;201803;211;154;57;146916.0;54378.0;201294.0
230060;201803;150;124;26;117532.8;24804.0;142336.8
230070;201803;281;250;31;238500.0;29574.0;268074.0
230075;201803;794;692;102;658165.0;97021.8;755186.8
230080;201803;179;154;25;146916.0;23850.0;170766.0
230090;201803;94;64;30;60292.8;28620.0;88912.8
230100;201803;1928;1141;787;1086227.0;750798.0;1837025.0
230110;201803;2633;1683;950;1603183.4;905727.8;2508911.2
230120;201803;933;739;194;702354.6;185057.0;887411.6
230125;201803;137;112;25;106848.0;23850.0;130698.0
230130;201803;459;411;48;392094.0;45792.0;437886.0
230140;201803;203;174;29;165996.0;27666.0;193662.0
230150;201803;161;119;42;113526.0;40068.0;153594.0
230160;201803;909;786;123;749129.0;117342.0;866471.0
230170;201803;581;536;45;507530.7;42930.0;550460.7
230180;201803;80;75;5;71550.0;4770.0;76320.0
230185;201803;408;351;57;333488.84;54378.0;387866.84
230190;201803;2191;1767;424;1681738.5;404179.0;2085917.5
230195;201803;486;424;62;404496.0;59148.0;463644.0
230200;201803;367;320;47;304316.47;44838.0;349154.47
230205;201803;354;222;132;210018.33;125928.0;335946.34
230210;201803;1258;1004;254;956298.1;241552.8;1197851.0
230220;201803;1395;966;429;920800.8;409266.0;1330066.8
230230;201803;896;788;108;750845.7;103032.0;853877.7
230240;201803;1615;1391;224;1325209.8;213696.0;1538905.8
230250;201803;1761;1452;309;1381197.1;294786.0;1675983.1
230260;201803;2928;1758;1170;1671939.1;1115207.8;2787146.8
230270;201803;1340;1077;263;1024858.4;249709.5;1274567.9
230280;201803;2690;2000;690;1901325.2;657592.2;2558917.5
230290;201803;398;362;36;339211.06;34344.0;373555.06
230300;201803;513;379;134;360306.72;127836.0;488142.72
230310;201803;414;311;103;296546.12;98262.0;394808.12
230320;201803;906;774;132;734412.6;125928.0;860340.6
230330;201803;298;239;59;227242.8;56096.0;283338.8
230340;201803;449;360;89;342487.0;84906.0;427393.0
230350;201803;3030;1892;1138;1804948.9;1082791.1;2887740.0
230360;201803;260;216;44;205154.0;41976.0;247130.0
230365;201803;135;108;27;102317.0;25758.0;128075.0
230370;201803;9729;4741;4988;4515064.0;4754399.5;9269463.0
230380;201803;462;397;65;378452.0;61056.6;439508.6
230390;201803;497;277;220;262454.94;209880.0;472334.94
230393;201803;268;221;47;209980.8;44838.0;254818.8
230395;201803;335;273;62;260194.0;59148.0;319342.0
230400;201803;596;472;124;448380.0;117799.92;566179.94
230410;201803;2618;1628;990;1547484.8;944174.0;2491658.8
230420;201803;5925;3870;2055;3673776.5;1955888.4;5629665.0
230423;201803;311;269;42;256626.0;40068.0;296694.0
230425;201803;346;288;58;274752.0;55332.0;330084.0
230426;201803;106;97;9;91812.96;8299.8;100112.76
230427;201803;79;76;3;72504.0;2862.0;75366.0
230428;201803;1340;688;652;656123.06;622008.0;1278131.0
230430;201803;439;354;85;337522.0;81090.0;418612.0
230435;201803;794;556;238;528882.25;225812.61;754694.8
230440;201803;83513;36808;46705;3,50E+12;4,45E+14;7,95E+14
230445;201803;270;185;85;176299.2;81090.0;257389.2
230450;201803;539;438;101;417852.0;96354.0;514206.0
230460;201803;58;48;10;45792.0;9540.0;55332.0
230465;201803;297;242;55;230868.0;52470.0;283338.0
230470;201803;1850;1441;409;1374714.0;389079.1;1763793.1
230480;201803;152;146;6;138997.8;5724.0;144721.8
230490;201803;280;226;54;215604.0;51516.0;267120.0
230495;201803;436;327;109;311104.0;103986.0;415090.0
230500;201803;934;700;234;666846.0;223236.0;890082.0
230510;201803;46;36;10;34344.0;9540.0;43884.0
230520;201803;387;306;81;291924.0;77274.0;369198.0
230523;201803;1996;1263;733;1203419.8;698834.0;1902253.8
230526;201803;294;244;50;232776.0;46909.0;279685.0
230530;201803;673;504;169;477612.44;160272.2;637884.6
230533;201803;181;173;8;165042.0;7632.0;172674.0
230535;201803;342;257;85;245178.0;81090.0;326268.0
230540;201803;1822;1595;227;1518987.0;215985.8;1734972.9
230550;201803;3595;2310;1285;2195510.0;1224260.8;3419770.8
230560;201803;575;440;135;417661.8;127836.0;545497.8
230565;201803;193;140;53;133560.0;50562.0;184122.0
230570;201803;301;268;33;255672.0;31482.0;287154.0
230580;201803;1101;813;288;774142.4;273575.44;1047717.8
230590;201803;952;740;212;701717.1;201771.0;903488.1
230600;201803;248;225;23;213906.06;21942.0;235848.06
230610;201803;337;270;67;257390.0;63918.0;321308.0
230620;201803;164;135;29;127836.0;27666.0;155502.0
230625;201803;716;515;201;489927.5;190600.69;680528.2
230630;201803;1248;988;260;942552.0;247658.4;1190210.4
230640;201803;3477;3005;472;2859535.5;449529.56;3309065.0
230650;201803;395;344;51;327316.38;48654.0;375970.38
230655;201803;638;553;85;526608.8;81010.07;607618.9
230660;201803;334;280;54;267120.0;51229.8;318349.8
230670;201803;425;378;47;360612.0;44838.0;405450.0
230680;201803;198;182;16;173628.0;15264.0;188892.0
230690;201803;859;750;109;715500.0;103986.0;819486.0
230700;201803;697;590;107;562840.94;101791.8;664632.75
230710;201803;732;692;40;659978.0;38160.0;698138.0
230720;201803;147;124;23;117904.86;21942.0;139846.86
230725;201803;231;181;50;172674.0;47691.0;220365.0
230730;201803;11638;6314;5324;6007062.5;5071018.0;1,11E+14
230740;201803;652;522;130;497702.0;123329.46;621031.44
230750;201803;797;682;115;649436.3;109710.0;759146.3
230760;201803;1304;1131;173;1074927.2;165042.0;1239969.2
230763;201803;319;263;56;248946.95;53424.0;302370.94
230765;201803;6833;3209;3624;3055645.8;3455290.0;6510935.5
230770;201803;4966;2551;2415;2424280.5;2301230.2;4725510.5
230780;201803;680;595;85;564490.1;80789.69;645279.8
230790;201803;192;158;34;150732.0;31635.4;182367.4
230800;201803;1111;812;299;774624.1;285246.0;1059870.1
230810;201803;1283;1144;139;1090374.2;132415.2;1222789.5
230820;201803;333;241;92;228961.0;87768.0;316729.0
230830;201803;936;811;125;770180.44;119250.0;889430.44
230835;201803;276;238;38;226098.0;35537.0;261635.0
230837;201803;163;138;25;131652.0;23850.0;155502.0
230840;201803;900;720;180;685640.5;170480.0;856120.5
230850;201803;1479;1290;189;1230183.0;180020.0;1410203.0
230860;201803;300;223;77;212742.0;73458.0;286200.0
230870;201803;1787;1515;272;1444356.0;258152.8;1702508.8
230880;201803;36;25;11;23850.0;10494.0;34344.0
230890;201803;567;520;47;495957.8;44824.0;540781.8
230900;201803;272;207;65;197478.0;61813.0;259291.0
230910;201803;204;165;39;156646.8;37206.0;193852.8
230920;201803;392;309;83;294786.0;79182.0;373968.0
230930;201803;919;647;272;614376.6;259488.0;873864.6
230940;201803;825;663;162;632502.0;154358.0;786860.0
230945;201803;472;395;77;376640.0;73458.0;450098.0
230950;201803;381;325;56;310050.0;53424.0;363474.0
230960;201803;2498;1699;799;1614118.9;761960.0;2376078.8
230970;201803;1736;978;758;932101.9;722254.3;1654356.2
230980;201803;210;180;30;171720.0;28620.0;200340.0
230990;201803;139;112;27;106848.0;25001.47;131849.47
231000;201803;207;188;19;177444.0;18126.0;195570.0
231010;201803;136;106;30;100551.6;28620.0;129171.6
231020;201803;1284;889;395;846485.0;376830.0;1223315.0
231025;201803;939;704;235;668327.75;222644.8;890972.56
231030;201803;1138;953;185;909158.0;176204.0;1085362.0
231040;201803;140;95;45;89885.88;42199.0;132084.88
231050;201803;981;875;106;832985.9;101124.0;934109.9
231060;201803;140;124;16;118296.0;15264.0;133560.0
231070;201803;1419;1002;417;953717.1;397818.0;1351535.1
231080;201803;264;244;20;231965.1;19080.0;251045.1
231085;201803;547;339;208;322453.0;198432.0;520885.0
231090;201803;243;202;41;192708.0;39114.0;231822.0
231095;201803;164;131;33;124974.0;31482.0;156456.0
231100;201803;122;101;21;96354.0;18793.8;115147.8
231110;201803;347;302;45;287399.0;42930.0;330329.0
231120;201803;297;255;42;242311.86;40039.0;282350.88
231123;201803;135;128;7;122112.0;6678.0;128790.0
231126;201803;282;241;41;229914.0;39114.0;269028.0
231130;201803;4561;3543;1018;3370794.5;970099.25;4340894.0
231135;201803;202;172;30;164088.0;27354.4;191442.4
231140;201803;3030;2233;797;2127173.0;759345.8;2886518.8
231150;201803;355;338;17;322452.0;16218.0;338670.0
231160;201803;1202;945;257;898477.7;244949.05;1143426.8
231170;201803;531;351;180;334854.0;171720.0;506574.0
231180;201803;1600;1356;244;1292860.8;232776.0;1525636.8
231190;201803;196;175;21;166950.0;20034.0;186984.0
231195;201803;215;186;29;176720.0;27666.0;204386.0
231200;201803;827;682;145;650628.0;137070.0;787698.0
231210;201803;603;504;99;479862.8;94446.0;574308.8
231220;201803;1035;752;283;715768.1;269982.0;985750.1
231230;201803;1381;1105;276;1052968.0;262540.8;1315508.9
231240;201803;1360;983;377;937495.8;358418.2;1295914.0
231250;201803;110;102;8;97308.0;7632.0;104940.0
231260;201803;289;186;103;177444.0;97976.0;275420.0
231270;201803;986;825;161;781820.7;153307.8;935128.5
231280;201803;56;44;12;41976.0;11448.0;53424.0
231290;201803;7134;3970;3164;3779998.2;3016111.2;6796109.5
231300;201803;625;576;49;549504.0;46746.0;596250.0
231310;201803;701;652;49;620791.0;46746.0;667537.0
231320;201803;564;436;128;415468.0;122112.0;537580.0
231325;201803;86;77;9;73458.0;8586.0;82044.0
231330;201803;2018;1555;463;1477464.6;438746.6;1916211.2
231335;201803;243;215;28;205110.0;26712.0;231822.0
231340;201803;1602;1179;423;1123050.1;403255.8;1526305.9
231350;201803;1151;939;212;895806.0;201676.0;1097482.0
231355;201803;389;337;52;321498.0;49608.0;371106.0
231360;201803;473;374;99;354086.2;94446.0;448532.2
231370;201803;91;74;17;70596.0;16218.0;86814.0
231375;201803;285;207;78;197478.0;74412.0;271890.0
231380;201803;444;360;84;341844.7;79945.2;421789.88
231390;201803;194;158;36;150732.0;34344.0;185076.0
231395;201803;727;442;285;420370.56;271890.0;692260.56
231400;201803;1048;867;181;824546.8;172331.38;996878.25
231410;201803;1296;1049;247;996121.4;234685.0;1230806.4
240010;201803;387;180;207;170568.27;197469.0;368037.25
240020;201803;2187;1709;478;1628799.9;456008.0;2084807.9
240030;201803;134;113;21;107802.0;20034.0;127836.0
240040;201803;33;33;0;31482.0;0.0;31482.0
240050;201803;510;437;73;416044.44;69642.0;485686.44
240060;201803;66;62;4;59148.0;3816.0;62964.0
240070;201803;178;138;40;131652.0;38160.0;169812.0
240080;201803;439;295;144;281426.0;137376.0;418802.0
240090;201803;102;91;11;86508.72;10494.0;97002.72
240100;201803;1434;1350;84;1284927.5;79945.2;1364872.8
240110;201803;972;615;357;585738.25;340578.0;926316.25
240120;201803;139;117;22;111618.0;20988.0;132606.0
240130;201803;289;271;18;257817.55;17172.0;274989.53
240140;201803;79;62;17;59148.0;16218.0;75366.0
240145;201803;677;597;80;569013.3;76110.12;645123.44
240150;201803;20;15;5;14310.0;4741.38;19051.38
240160;201803;44;38;6;36252.0;5724.0;41976.0
240165;201803;35;29;6;27428.0;5724.0;33152.0
240170;201803;92;71;21;67734.0;20034.0;87768.0
240180;201803;77;63;14;60102.0;13356.0;73458.0
240185;201803;40;37;3;35288.46;2862.0;38150.46
240190;201803;14;12;2;11448.0;1908.0;13356.0
240200;201803;3000;1688;1312;1604371.6;1250409.0;2854780.8
240210;201803;162;128;34;122112.0;32436.0;154548.0
240220;201803;1102;791;311;754471.0;296684.47;1051155.5
240230;201803;818;758;60;720298.06;56592.0;776890.06
240240;201803;118;85;33;81090.0;31482.0;112572.0
240250;201803;92;80;12;76320.0;11448.0;87768.0
240260;201803;1790;1330;460;1268133.1;437857.38;1705990.5
240270;201803;190;168;22;159890.4;20988.0;180878.4
240280;201803;43;33;10;31482.0;9540.0;41022.0
240290;201803;48;47;1;44838.0;954.0;45792.0
240300;201803;179;99;80;94446.0;76320.0;170766.0
240310;201803;1985;1085;900;1023786.0;855363.56;1879149.5
240320;201803;207;197;10;187938.0;9540.0;197478.0
240325;201803;4300;2630;1670;2502008.5;1591011.2;4093019.8
240330;201803;65;62;3;59148.0;2862.0;62010.0
240340;201803;101;73;28;69642.0;26712.0;96354.0
240350;201803;90;80;10;76320.0;9540.0;85860.0
240360;201803;382;271;111;258534.0;105894.0;364428.0
240370;201803;36;34;2;32436.0;1908.0;34344.0
240375;201803;71;41;30;39114.0;28620.0;67734.0
240380;201803;233;189;44;180306.0;41881.0;222187.0
240390;201803;15;13;2;12402.0;1908.0;14310.0
240400;201803;78;74;4;70596.0;3816.0;74412.0
240410;201803;10;6;4;5724.0;3816.0;9540.0
240420;201803;879;684;195;651154.6;184980.6;836135.2
240430;201803;263;248;15;234569.69;14310.0;248879.69
240440;201803;69;36;33;34344.0;31482.0;65826.0
240450;201803;206;139;67;132033.8;63918.0;195951.8
240460;201803;60;47;13;44838.0;12402.0;57240.0
240470;201803;235;204;31;194058.86;29574.0;223632.86
240480;201803;14;14;0;13260.6;0.0;13260.6
240485;201803;75;65;10;62010.0;9540.0;71550.0
240490;201803;45;45;0;42720.12;0.0;42720.12
240500;201803;84;66;18;62964.0;17172.0;80136.0
240510;201803;52;37;15;35298.0;14310.0;49608.0
240520;201803;124;118;6;112572.0;5724.0;118296.0
240530;201803;49;44;5;41976.0;4770.0;46746.0
240540;201803;78;67;11;63918.0;10494.0;74412.0
240550;201803;15;13;2;12402.0;1908.0;14310.0
240560;201803;371;275;96;261723.23;91584.0;353307.22
240570;201803;462;286;176;271985.4;167904.0;439889.4
240580;201803;1254;1014;240;961871.9;227802.2;1189674.1
240590;201803;30;28;2;26712.0;1908.0;28620.0
240600;201803;109;108;1;103032.0;954.0;103986.0
240610;201803;509;426;83;406047.7;78419.0;484466.7
240615;201803;20;19;1;18126.0;954.0;19080.0
240620;201803;95;91;4;86814.0;3816.0;90630.0
240630;201803;33;31;2;29574.0;1908.0;31482.0
240640;201803;26;22;4;20988.0;3816.0;24804.0
240650;201803;235;198;37;188033.9;35298.0;223331.9
240660;201803;99;86;13;82044.0;12402.0;94446.0
240670;201803;288;170;118;160081.3;112572.0;272653.3
240680;201803;48;37;11;35298.0;10494.0;45792.0
240690;201803;49;46;3;43884.0;2862.0;46746.0
240700;201803;196;163;33;155502.0;31482.0;186984.0
240710;201803;1921;1224;697;1167262.9;664928.44;1832191.2
240720;201803;1050;770;280;733426.7;267120.0;1000546.7
240725;201803;66;63;3;60102.0;2862.0;62964.0
240730;201803;133;114;19;108756.0;18126.0;126882.0
240740;201803;241;204;37;193251.78;34344.02;227595.8
240750;201803;34;22;12;20988.0;11448.0;32436.0
240760;201803;32;28;4;26712.0;3816.0;30528.0
240770;201803;148;113;35;107802.0;33390.0;141192.0
240780;201803;700;579;121;550925.44;115434.0;666359.44
240790;201803;38;37;1;35298.0;954.0;36252.0
240800;201803;8544;5791;2753;5486810.5;2620105.2;8106915.5
240810;201803;19948;10967;8981;1,04E+14;8558047.0;1,90E+14
240820;201803;213;132;81;125637.03;77274.0;202911.03
240830;201803;1598;1308;290;1241307.1;275706.0;1517013.1
240840;201803;79;69;10;65826.0;9540.0;75366.0
240850;201803;85;74;11;70596.0;10494.0;81090.0
240860;201803;114;111;3;105894.0;2862.0;108756.0
240870;201803;60;53;7;50562.0;6678.0;57240.0
240880;201803;29;26;3;24794.46;2862.0;27656.46
240890;201803;1149;676;473;640994.75;451238.0;1092232.8
240895;201803;42;32;10;30528.0;9540.0;40068.0
240910;201803;153;138;15;131652.0;14310.0;145962.0
240920;201803;14;11;3;10494.0;2862.0;13356.0
240930;201803;381;344;37;327222.0;35298.0;362520.0
240933;201803;30;22;8;20988.0;7632.0;28620.0
240940;201803;2428;2146;282;2033791.2;266146.9;2299938.2
240950;201803;51;48;3;45792.0;2862.0;48654.0
240960;201803;31;25;6;23850.0;5724.0;29574.0
240970;201803;131;94;37;89676.0;34544.0;124220.0
240980;201803;189;151;38;144054.0;36252.0;180306.0
240990;201803;118;79;39;75366.0;37206.0;112572.0
241000;201803;70;65;5;62010.0;4770.0;66780.0
241010;201803;57;46;11;43884.0;10494.0;54378.0
241020;201803;116;109;7;103986.0;6678.0;110664.0
241025;201803;9;3;6;2862.0;5724.0;8586.0
241030;201803;120;98;22;93492.0;20988.0;114480.0
241040;201803;34;29;5;27666.0;4770.0;32436.0
241050;201803;92;80;12;76320.0;11448.0;87768.0
241060;201803;27;24;3;22896.0;2862.0;25758.0
241070;201803;14;14;0;13356.0;0.0;13356.0
241080;201803;65;57;8;54091.8;7632.0;61723.8
241090;201803;50;40;10;38160.0;9525.69;47685.69
241100;201803;73;64;9;61056.0;8586.0;69642.0
241105;201803;6;2;4;1908.0;3816.0;5724.0
241110;201803;47;45;2;42930.0;1908.0;44838.0
241120;201803;1420;1101;319;1047368.8;304326.0;1351694.8
241140;201803;224;183;41;173629.0;39114.0;212743.0
241142;201803;41;40;1;38160.0;954.0;39114.0
241150;201803;1210;1064;146;1012338.0;139284.0;1151622.0
241160;201803;22;21;1;20034.0;954.0;20988.0
241170;201803;42;39;3;37206.0;2862.0;40068.0
241180;201803;51;42;9;39893.42;8586.0;48479.42
241190;201803;38;37;1;35298.0;954.0;36252.0
241200;201803;3846;2103;1743;2000727.4;1660901.6;3661629.0
241210;201803;72;60;12;57240.0;10590.0;67830.0
241220;201803;1362;909;453;866663.06;432128.9;1298792.0
241230;201803;246;208;38;198241.2;36252.0;234493.2
241240;201803;52;40;12;38160.0;11448.0;49608.0
241250;201803;1078;1001;77;954668.0;73172.0;1027840.0
241255;201803;46;37;9;35298.0;8586.0;43884.0
241260;201803;627;496;131;473179.22;124974.0;598153.25
241270;201803;44;31;13;29574.0;12402.0;41976.0
241280;201803;98;86;12;82044.0;11448.0;93492.0
241290;201803;108;81;27;77274.0;25758.0;103032.0
241300;201803;77;54;23;51516.0;21942.0;73458.0
241310;201803;51;38;13;36109.0;12402.0;48511.0
241320;201803;26;14;12;13356.0;11448.0;24804.0
241330;201803;59;53;6;50562.0;5724.0;56286.0
241335;201803;62;55;7;51897.6;6678.0;58575.6
241340;201803;187;142;45;135468.0;42930.0;178398.0
241350;201803;57;52;5;49608.0;4770.0;54378.0
241355;201803;41;38;3;36252.0;2862.0;39114.0
241360;201803;46;46;0;43884.0;0.0;43884.0
241370;201803;44;36;8;34219.98;7632.0;41851.98
241380;201803;39;37;2;35298.0;1908.0;37206.0
241390;201803;76;61;15;58003.2;14310.0;72313.2
241400;201803;194;160;34;151972.2;32436.0;184408.2
241410;201803;176;159;17;151686.0;16122.6;167808.6
241415;201803;94;75;19;71550.0;18126.0;89676.0
241420;201803;97;74;23;70596.0;21771.0;92367.0
241430;201803;28;27;1;25758.0;954.0;26712.0
241440;201803;457;386;71;368230.0;67734.0;435964.0
241445;201803;37;35;2;33390.0;1908.0;35298.0
241450;201803;276;225;51;214523.0;48654.0;263177.0
241460;201803;135;123;12;117104.0;11448.0;128552.0
241470;201803;43;36;7;34344.0;6678.0;41022.0
241475;201803;65;61;4;58194.0;3816.0;62010.0
241480;201803;99;70;29;65540.69;27666.0;93206.69
241490;201803;9;8;1;7632.0;954.0;8586.0
241500;201803;47;34;13;32436.0;12402.0;44838.0
250010;201803;101;87;14;82854.9;13356.0;96210.9
250020;201803;26;23;3;21942.0;2862.0;24804.0
250030;201803;805;596;209;567239.2;198337.6;765576.8
250040;201803;331;277;54;264258.0;51229.8;315487.8
250050;201803;230;190;40;180969.8;38160.0;219129.8
250053;201803;54;42;12;40068.0;11448.0;51516.0
250057;201803;0;0;0;0.0;0.0;0.0
250060;201803;447;341;106;325314.0;100837.8;426151.8
250070;201803;701;583;118;554164.0;112572.0;666736.0
250073;201803;7;7;0;6678.0;0.0;6678.0
250077;201803;200;149;51;141754.86;48654.0;190408.86
250080;201803;421;331;90;314153.2;85860.0;400013.2
250090;201803;198;133;65;125928.4;61990.92;187919.31
250100;201803;466;381;85;363474.0;80709.0;444183.0
250110;201803;485;366;119;347380.03;113526.0;460906.03
250115;201803;28;9;19;8586.0;18126.0;26712.0
250120;201803;113;86;27;82044.0;25758.0;107802.0
250130;201803;580;460;120;438840.0;114290.0;553130.0
250135;201803;14;8;6;7632.0;5724.0;13356.0
250140;201803;78;69;9;65826.0;8586.0;74412.0
250150;201803;566;419;147;397558.0;139923.19;537481.2
250153;201803;10;9;1;8586.0;954.0;9540.0
250157;201803;28;23;5;21942.0;4770.0;26712.0
250160;201803;210;166;44;158364.0;41976.0;200340.0
250170;201803;66;46;20;43884.0;19080.0;62964.0
250180;201803;4017;2696;1321;2558327.0;1255136.0;3813463.0
250190;201803;903;600;303;570730.5;288346.5;859077.0
250200;201803;50;42;8;40068.0;7632.0;47700.0
250205;201803;21;19;2;18126.0;1908.0;20034.0
250210;201803;90;78;12;74412.0;11448.0;85860.0
250215;201803;63;54;9;51516.0;8586.0;60102.0
250220;201803;27;21;6;20034.0;5724.0;25758.0
250230;201803;76;69;7;65822.0;6678.0;72500.0
250240;201803;246;202;44;191897.1;41976.0;233873.1
250250;201803;389;331;58;315774.0;55332.0;371106.0
250260;201803;35;30;5;28620.0;4770.0;33390.0
250270;201803;55;44;11;41976.0;10494.0;52470.0
250280;201803;382;320;62;305280.0;59148.0;364428.0
250290;201803;95;90;5;85573.8;4770.0;90343.8
250300;201803;557;380;177;361872.72;168845.0;530717.7
250310;201803;46;41;5;39114.0;4770.0;43884.0
250320;201803;1943;1330;613;1262407.1;583228.8;1845636.0
250330;201803;82;73;9;69642.0;8586.0;78228.0
250340;201803;25;21;4;20034.0;3816.0;23850.0
250350;201803;140;90;50;85573.8;47127.6;132701.4
250355;201803;32;25;7;23850.0;6678.0;30528.0
250360;201803;200;163;37;155502.0;35060.0;190562.0
250370;201803;2380;1615;765;1535752.0;728253.8;2264005.8
250375;201803;16;12;4;11448.0;3816.0;15264.0
250380;201803;52;37;15;35298.0;14310.0;49608.0
250390;201803;42;35;7;33390.0;6678.0;40068.0
250400;201803;15578;7887;7691;7499539.0;7330823.0;1,48E+14
250403;201803;421;342;79;326258.47;75366.0;401624.47
250407;201803;54;46;8;43884.0;7632.0;51516.0
250410;201803;29;24;5;22896.0;4770.0;27666.0
250415;201803;42;28;14;26712.0;13336.92;40048.92
250420;201803;45;37;8;35298.0;7632.0;42930.0
250430;201803;1637;1386;251;1320051.0;239454.0;1559505.0
250435;201803;15;12;3;11448.0;2862.0;14310.0
250440;201803;687;593;94;563029.4;89676.0;652705.4
250450;201803;86;73;13;69642.0;12402.0;82044.0
250460;201803;418;285;133;271890.0;126872.46;398762.47
250470;201803;88;65;23;62010.0;21942.0;83952.0
250480;201803;323;254;69;242316.0;65826.0;308142.0
250485;201803;2;1;1;954.0;954.0;1908.0
250490;201803;205;167;38;159318.0;36252.0;195570.0
250500;201803;75;55;20;52470.0;19080.0;71550.0
250510;201803;732;572;160;544352.6;151631.44;695984.0
250520;201803;173;120;53;114460.92;50557.23;165018.16
250523;201803;111;92;19;87768.0;18126.0;105894.0
250527;201803;104;80;24;76315.23;22896.0;99211.23
250530;201803;6;5;1;4770.0;954.0;5724.0
250535;201803;25;21;4;20034.0;3816.0;23850.0
250540;201803;124;94;30;88960.5;28620.0;117580.5
250550;201803;68;65;3;62010.0;2862.0;64872.0
250560;201803;35;29;6;27666.0;5724.0;33390.0
250570;201803;151;120;31;114480.0;29574.0;144054.0
250580;201803;132;103;29;97975.8;27666.0;125641.8
250590;201803;20;16;4;15264.0;3816.0;19080.0
250600;201803;1323;894;429;850016.25;409170.6;1259186.9
250610;201803;153;132;21;125928.0;20034.0;145962.0
250620;201803;21;17;4;16218.0;3816.0;20034.0
250625;201803;62;46;16;43884.0;15264.0;59148.0
250630;201803;3004;1922;1082;1825545.6;1031160.75;2856706.5
250640;201803;203;168;35;160272.0;33390.0;193662.0
250650;201803;31;21;10;20034.0;9540.0;29574.0
250660;201803;43;33;10;31482.0;9540.0;41022.0
250670;201803;61;41;20;39114.0;19080.0;58194.0
250680;201803;383;314;69;299556.0;65826.0;365382.0
250690;201803;1825;1257;568;1196140.2;541490.8;1737631.0
250700;201803;953;839;114;796869.94;108546.12;905416.0
250710;201803;441;342;99;326268.0;94159.8;420427.8
250720;201803;103;81;22;77274.0;20988.0;98262.0
250730;201803;366;309;57;293832.6;54378.0;348210.6
250740;201803;48;44;4;41976.0;3816.0;45792.0
250750;201803;20299;12137;8162;1,15E+14;7777778.0;1,93E+14
250760;201803;68;51;17;48654.0;16218.0;64872.0
250770;201803;351;235;116;222282.14;109495.55;331777.7
250780;201803;57;44;13;41976.0;12402.0;54378.0
250790;201803;481;314;167;296694.9;158602.5;455297.4
250800;201803;151;140;11;132844.5;10494.0;143338.5
250810;201803;78;59;19;56286.0;18126.0;74412.0
250820;201803;158;127;31;121158.0;29574.0;150732.0
250830;201803;424;286;138;271842.5;131652.0;403494.5
250840;201803;53;51;2;48654.0;1908.0;50562.0
250850;201803;53;41;12;38427.12;11448.0;49875.12
250855;201803;13;11;2;10494.0;1908.0;12402.0
250860;201803;204;146;58;139284.0;55045.8;194329.8
250870;201803;33;30;3;28620.0;2862.0;31482.0
250880;201803;80;61;19;58136.76;18126.0;76262.76
250890;201803;2392;1766;626;1683428.4;596340.75;2279769.2
250900;201803;116;99;17;94446.0;16218.0;110664.0
250905;201803;125;96;29;91584.0;27666.0;119250.0
250910;201803;1171;834;337;794473.3;321211.8;1115685.1
250915;201803;109;74;35;70596.0;33390.0;103986.0
250920;201803;135;104;31;99216.0;29574.0;128790.0
250930;201803;159;98;61;93492.0;58194.0;151686.0
250933;201803;0;0;0;0.0;0.0;0.0
250937;201803;6;5;1;4770.0;954.0;5724.0
250939;201803;31;23;8;21942.0;7632.0;29574.0
250940;201803;108;82;26;78228.0;24804.0;103032.0
250950;201803;71;47;24;44838.0;22896.0;67734.0
250960;201803;90;50;40;47700.0;38160.0;85860.0
250970;201803;1205;859;346;817865.0;329130.0;1146995.0
250980;201803;90;63;27;60102.0;25758.0;85860.0
250990;201803;166;130;36;123562.08;34301.07;157863.16
251000;201803;74;67;7;63727.2;6678.0;70405.2
251010;201803;100;77;23;73454.0;21163.53;94617.53
251020;201803;80;69;11;65015.1;10494.0;75509.1
251030;201803;42;32;10;30528.0;9540.0;40068.0
251040;201803;53;38;15;36252.0;14310.0;50562.0
251050;201803;24;22;2;20988.0;1908.0;22896.0
251060;201803;51;41;10;38160.0;9540.0;47700.0
251065;201803;3;3;0;2862.0;0.0;2862.0
251070;201803;25;20;5;19071.0;4770.0;23841.0
251080;201803;4704;2285;2419;2167339.0;2301173.0;4468512.0
251090;201803;195;167;28;159318.0;26712.0;186030.0
251100;201803;18;17;1;16218.0;954.0;17172.0
251110;201803;46;37;9;35298.0;8586.0;43884.0
251120;201803;1774;1068;706;1013962.2;673524.0;1687486.2
251130;201803;355;288;67;274752.0;63918.0;338670.0
251140;201803;506;329;177;312722.8;168689.34;481412.12
251150;201803;292;252;40;239636.0;38160.0;277796.0
251160;201803;95;80;15;76316.0;14310.0;90626.0
251170;201803;98;78;20;74383.38;19075.23;93458.61
251180;201803;288;181;107;172665.23;102069.23;274734.47
251190;201803;193;131;62;124645.83;59148.0;183793.83
251200;201803;252;206;46;196524.0;43884.0;240408.0
251203;201803;33;31;2;29574.0;1908.0;31482.0
251207;201803;94;77;17;73458.0;16218.0;89676.0
251210;201803;1259;903;356;859908.5;338956.2;1198864.8
251220;201803;47;36;11;34344.0;10494.0;44838.0
251230;201803;470;394;76;375876.0;72504.0;448380.0
251240;201803;100;72;28;67734.0;26712.0;94446.0
251250;201803;1318;947;371;900548.9;353791.0;1254339.9
251260;201803;13;8;5;7632.0;4770.0;12402.0
251270;201803;345;254;91;242316.0;86671.0;328987.0
251272;201803;67;61;6;58194.0;5724.0;63918.0
251274;201803;29;24;5;22896.0;4770.0;27666.0
251275;201803;22;15;7;14310.0;6678.0;20988.0
251276;201803;18;14;4;13356.0;3816.0;17172.0
251278;201803;9;7;2;6678.0;1908.0;8586.0
251280;201803;97;93;4;88722.0;3816.0;92538.0
251290;201803;694;525;169;500850.0;161226.0;662076.0
251300;201803;16;14;2;13356.0;1908.0;15264.0
251310;201803;361;258;103;246128.0;98262.0;344390.0
251315;201803;18;17;1;16218.0;954.0;17172.0
251320;201803;60;49;11;46746.0;10494.0;57240.0
251330;201803;79;70;9;66780.0;8586.0;75366.0
251335;201803;11;7;4;6678.0;3816.0;10494.0
251340;201803;693;411;282;392094.0;268003.25;660097.25
251350;201803;35;33;2;31482.0;1908.0;33390.0
251360;201803;65;57;8;54171.94;7632.0;61803.94
251365;201803;14;14;0;13356.0;0.0;13356.0
251370;201803;5272;3583;1689;3413339.0;1609606.1;5022945.0
251380;201803;49;39;10;37206.0;9540.0;46746.0
251385;201803;2;2;0;1908.0;0.0;1908.0
251390;201803;667;532;135;506384.2;127550.0;633934.2
251392;201803;28;18;10;17172.0;9540.0;26712.0
251394;201803;9;9;0;8586.0;0.0;8586.0
251396;201803;18;13;5;12402.0;4770.0;17172.0
251398;201803;17;15;2;14310.0;1908.0;16218.0
251400;201803;40;33;7;31482.0;6678.0;38160.0
251410;201803;34;29;5;27666.0;4770.0;32436.0
251420;201803;107;80;27;76320.0;25758.0;102078.0
251430;201803;38;36;2;34344.0;1908.0;36252.0
251440;201803;34;22;12;20988.0;11448.0;32436.0
251445;201803;53;48;5;45792.0;4770.0;50562.0
251450;201803;418;369;49;350370.8;46746.0;397116.8
251455;201803;2;1;1;954.0;954.0;1908.0
251460;201803;17;13;4;12402.0;3816.0;16218.0
251465;201803;5;2;3;1908.0;2862.0;4770.0
251470;201803;46;36;10;34344.0;9540.0;43884.0
251480;201803;24;22;2;20988.0;1908.0;22896.0
251490;201803;131;92;39;87291.0;36253.0;123544.0
251500;201803;117;94;23;89676.0;21179.0;110855.0
251510;201803;35;27;8;25758.0;7632.0;33390.0
251520;201803;26;26;0;24804.0;0.0;24804.0
251530;201803;4520;3175;1345;3022650.2;1282834.2;4305484.5
251540;201803;73;65;8;62010.0;7632.0;69642.0
251550;201803;410;317;93;301464.2;87912.0;389376.2
251560;201803;22;17;5;16218.0;4770.0;20988.0
251570;201803;19;19;0;18126.0;0.0;18126.0
251580;201803;119;97;22;92538.0;20988.0;113526.0
251590;201803;124;92;32;87949.0;30528.0;118477.0
251593;201803;19;10;9;9540.0;8586.0;18126.0
251597;201803;57;47;10;44838.0;9540.0;54378.0
251600;201803;1099;781;318;743296.25;301763.9;1045060.2
251610;201803;212;160;52;151972.2;48941.0;200913.2
251615;201803;3;3;0;2862.0;0.0;2862.0
251620;201803;4231;2829;1402;2689025.8;1334743.2;4023769.0
251630;201803;453;333;120;317682.0;114471.0;432153.0
251640;201803;148;107;41;102078.0;39114.0;141192.0
251650;201803;263;191;72;180381.1;68688.0;249069.1
251660;201803;223;203;20;192708.1;18889.2;211597.3
251670;201803;360;282;78;267332.0;74412.0;341744.0
251675;201803;3;3;0;2862.0;0.0;2862.0
251680;201803;87;79;8;75366.0;7632.0;82998.0
251690;201803;341;286;55;271890.0;52119.89;324009.88
251700;201803;280;234;46;222649.3;43869.69;266518.97
251710;201803;19;12;7;11448.0;6678.0;18126.0
251720;201803;33;22;11;20988.0;10208.0;31196.0
251740;201803;10;8;2;7632.0;1908.0;9540.0
260005;201803;3115;1773;1342;1680353.4;1279101.1;2959454.5
260010;201803;1435;1024;411;973176.3;390091.3;1363267.6
260020;201803;430;377;53;359658.0;50562.0;410220.0
260030;201803;577;420;157;399912.97;149778.0;549691.0
260040;201803;857;521;336;495946.44;320391.38;816337.8
260050;201803;1135;815;320;777272.0;304708.0;1081980.0
260060;201803;417;377;40;358894.8;38160.0;397054.8
260070;201803;1452;910;542;864018.0;514098.38;1378116.4
260080;201803;729;578;151;550601.1;144054.0;694655.1
260090;201803;575;355;220;338442.12;209880.0;548322.1
260100;201803;226;158;68;149731.2;64872.0;214603.2
260105;201803;235;133;102;126882.0;97308.0;224190.0
260110;201803;2737;2036;701;1942335.0;667944.0;2610279.0
260120;201803;2901;1463;1438;1385984.0;1369564.1;2755548.0
260130;201803;149;104;45;99216.0;42930.0;142146.0
260140;201803;2112;1387;725;1314707.5;690105.44;2004813.0
260150;201803;228;151;77;144054.0;73458.0;217512.0
260160;201803;294;252;42;240408.0;40068.0;280476.0
260170;201803;3354;2051;1303;1950889.8;1241964.9;3192854.8
260180;201803;135;113;22;107802.0;20988.0;128790.0
260190;201803;2247;1602;645;1525157.9;615330.0;2140488.0
260200;201803;891;733;158;698507.06;150446.0;848953.06
260210;201803;1414;1003;411;956711.25;390845.12;1347556.4
260220;201803;713;654;59;623916.0;56286.0;680202.0
260230;201803;1194;907;287;863087.0;273798.0;1136885.0
260240;201803;219;165;54;156236.58;51516.0;207752.58
260250;201803;74;59;15;56286.0;14310.0;70596.0
260260;201803;986;709;277;676386.0;264258.0;940644.0
260270;201803;428;347;81;329655.2;76987.8;406643.0
260280;201803;1291;877;414;836181.0;394670.0;1230851.0
260290;201803;6384;3389;2995;3214302.2;2850520.0;6064822.5
260300;201803;854;751;103;714385.6;97976.0;812361.6
260310;201803;498;397;101;377359.47;96354.0;473713.47
260320;201803;885;667;218;636031.2;207972.0;844003.2
260330;201803;34;27;7;25758.0;6678.0;32436.0
260340;201803;67;48;19;45792.0;18126.0;63918.0
260345;201803;5652;3187;2465;3033935.5;2350609.5;5384545.0
260350;201803;467;340;127;322616.1;120205.0;442821.1
260360;201803;284;145;139;138330.0;132606.0;270936.0
260370;201803;644;419;225;397116.4;214510.0;611626.4
260380;201803;600;432;168;412128.0;159127.56;571255.56
260390;201803;291;249;42;236467.98;39114.0;275581.97
260392;201803;94;82;12;78228.0;11448.0;89676.0
260400;201803;4052;2335;1717;2217351.0;1637656.2;3855007.2
260410;201803;14254;7682;6572;7312493.5;6266957.0;1,36E+14
260415;201803;123;111;12;105894.0;11448.0;117342.0
260420;201803;1769;1053;716;999523.2;681267.6;1680790.9
260430;201803;189;173;16;163830.66;15264.0;179094.66
260440;201803;229;165;64;156686.0;61056.0;217742.0
260450;201803;474;343;131;325937.0;124974.0;450911.0
260460;201803;848;451;397;427584.8;378733.22;806318.0
260470;201803;376;232;144;220564.8;136995.0;357559.8
260480;201803;206;129;77;123066.0;73458.0;196524.0
260490;201803;208;167;41;159318.0;39114.0;198432.0
260500;201803;1128;758;370;720844.2;351883.8;1072728.0
260510;201803;737;586;151;559044.0;143100.0;702144.0
260515;201803;260;232;28;221328.0;26235.0;247563.0
260520;201803;3308;1957;1351;1859678.5;1286651.9;3146330.2
260530;201803;781;633;148;601062.6;141192.0;742254.6
260540;201803;572;433;139;413082.0;131652.72;544734.75
260545;201803;13;10;3;9540.0;2862.0;12402.0
260550;201803;340;212;128;202248.0;122112.0;324360.0
260560;201803;523;393;130;374331.0;123733.8;498064.8
260570;201803;1010;832;178;790723.8;169525.8;960249.6
260580;201803;267;239;28;228006.0;26712.0;254718.0
260590;201803;653;373;280;354430.1;267120.0;621550.06
260600;201803;8165;4154;4011;3940261.5;3822530.2;7762791.5
260610;201803;497;331;166;315774.0;158077.8;473851.8
260620;201803;3636;1895;1741;1796140.8;1656742.2;3452883.0
260630;201803;72;69;3;65826.0;2862.0;68688.0
260640;201803;3620;1976;1644;1881785.6;1568005.0;3449790.5
260650;201803;340;236;104;225144.0;99173.07;324317.06
260660;201803;494;338;156;322070.4;148203.9;470274.3
260670;201803;100;75;25;71550.0;23850.0;95400.0
260680;201803;3675;2047;1628;1935000.8;1552749.8;3487750.5
260690;201803;118;92;26;87768.0;24804.0;112572.0
260700;201803;322;198;124;188128.8;117462.0;305590.8
260710;201803;39;36;3;34344.0;2862.0;37206.0
260720;201803;2211;1329;882;1261660.5;840350.0;2102010.5
260730;201803;595;448;147;427392.0;138043.8;565435.8
260740;201803;62;58;4;55332.0;3816.0;59148.0
260750;201803;642;448;194;427067.62;185076.0;612143.6
260760;201803;621;340;281;324360.0;267757.0;592117.0
260765;201803;987;518;469;491229.8;447187.5;938417.3
260770;201803;218;164;54;156456.0;51516.0;207972.0
260775;201803;814;482;332;458445.8;316719.0;775164.8
260780;201803;271;175;96;166950.0;91584.0;258534.0
260790;201803;12395;6798;5597;6457266.5;5331969.0;1,18E+14
260795;201803;159;111;48;104730.12;45792.0;150522.12
260800;201803;279;228;51;217035.0;48654.0;265689.0
260805;201803;175;112;63;106119.14;60102.0;166221.14
260810;201803;741;645;96;614080.25;91584.0;705664.25
260820;201803;311;207;104;196148.8;99216.0;295364.78
260825;201803;204;140;64;133182.98;61056.0;194238.98
260830;201803;260;168;92;160272.0;87768.0;248040.0
260840;201803;228;166;62;157697.0;58862.0;216559.0
260845;201803;207;143;64;136135.8;61056.0;197191.8
260850;201803;504;366;138;347500.1;131652.0;479152.1
260860;201803;254;189;65;180108.34;62010.0;242118.34
260870;201803;373;267;106;254718.0;101124.0;355842.0
260875;201803;689;481;208;457760.7;198432.0;656192.7
260880;201803;1573;961;612;914835.06;583657.2;1498492.2
260890;201803;2421;1686;735;1601050.0;700237.0;2301287.0
260900;201803;1031;705;326;671267.8;311004.0;982271.8
260910;201803;281;220;61;209880.0;58194.0;268074.0
260915;201803;304;203;101;193662.0;96234.0;289896.0
260920;201803;173;98;75;93492.0;71550.0;165042.0
260930;201803;386;331;55;315774.0;52384.45;368158.44
260940;201803;2764;1513;1251;1439131.9;1192957.9;2632089.8
260950;201803;1995;1154;841;1094563.9;802285.4;1896849.2
260960;201803;14246;7393;6853;7017649.0;6530287.5;1,35E+14
260970;201803;435;373;62;355053.0;59148.0;414201.0
260980;201803;197;173;24;164756.0;22896.0;187652.0
260990;201803;2561;2111;450;2013388.4;428632.2;2442020.5
261000;201803;4323;2555;1768;2424047.0;1684774.4;4108821.2
261010;201803;188;137;51;130698.0;47836.23;178534.23
261020;201803;606;450;156;429157.0;148013.1;577170.1
261030;201803;221;161;60;153594.0;57034.89;210628.89
261040;201803;363;326;37;311004.0;34868.8;345872.8
261050;201803;465;410;55;391140.0;52470.0;443610.0
261060;201803;1322;863;459;821156.75;437886.0;1259042.8
261070;201803;9026;4606;4420;4369649.0;4207945.0;8577594.0
261080;201803;382;293;89;278750.0;84906.0;363656.0
261090;201803;2231;1713;518;1625622.0;493400.0;2119022.0
261100;201803;1091;773;318;735105.6;301502.16;1036607.75
261110;201803;8024;4920;3104;4688057.0;2958929.8;7646987.0
261120;201803;278;228;50;217512.0;47695.23;265207.22
261130;201803;570;329;241;313532.9;229437.0;542969.9
261140;201803;187;119;68;113526.0;64872.0;178398.0
261150;201803;663;390;273;372060.0;259774.2;631834.2
261153;201803;74;71;3;66780.31;2862.0;69642.31
261160;201803;76913;38869;38044;3,70E+14;3,63E+13;7,32E+14
261170;201803;446;333;113;316766.38;107802.0;424568.38
261180;201803;1771;1086;685;1030921.6;653490.0;1684411.6
261190;201803;617;427;190;406961.9;181251.0;588212.94
261200;201803;211;186;25;176726.3;23850.0;200576.3
261210;201803;35;31;4;29574.0;3816.0;33390.0
261220;201803;2527;1783;744;1695165.1;708917.8;2404083.0
261230;201803;326;241;85;229914.0;81075.69;310989.7
261240;201803;441;380;61;360087.3;58194.0;418281.3
261245;201803;223;187;36;178398.0;34344.0;212742.0
261247;201803;153;115;38;109710.0;36252.0;145962.0
261250;201803;2849;1442;1407;1375095.8;1341167.9;2716263.8
261255;201803;253;230;23;219420.0;21942.0;241362.0
261260;201803;862;740;122;705960.0;116388.0;822348.0
261270;201803;172;135;37;128790.0;35298.0;164088.0
261280;201803;157;128;29;122112.0;27666.0;149778.0
261290;201803;124;87;37;82759.5;35298.0;118057.5
261300;201803;1231;871;360;830934.0;343440.0;1174374.0
261310;201803;752;502;250;478908.0;237879.9;716787.9
261320;201803;544;367;177;350098.9;168858.0;518956.9
261330;201803;826;657;169;623779.5;160380.45;784159.94
261340;201803;313;176;137;167904.0;130698.0;298602.0
261350;201803;789;565;224;538056.2;213696.0;751752.2
261360;201803;1225;796;429;758982.4;409266.0;1168248.4
261370;201803;4970;3049;1921;2894631.5;1829477.5;4724109.0
261380;201803;573;424;149;402597.62;141860.0;544457.6
261390;201803;3420;2287;1133;2177018.8;1077021.2;3254040.2
261400;201803;276;250;26;237927.6;24804.0;262731.6
261410;201803;1060;701;359;668754.0;342481.22;1011235.25
261420;201803;883;552;331;525627.44;315755.47;841382.94
261430;201803;328;299;29;284400.0;27379.8;311779.8
261440;201803;113;102;11;97308.0;10494.0;107802.0
261450;201803;2496;2079;417;1980706.2;396807.03;2377513.2
261460;201803;726;579;147;551412.0;140238.0;691650.0
261470;201803;250;191;59;181404.0;56286.0;237690.0
261480;201803;353;288;65;273513.0;62006.0;335519.0
261485;201803;343;208;135;197764.2;128790.0;326554.2
261500;201803;629;426;203;406404.0;193662.0;600066.0
261510;201803;43;29;14;27666.0;13356.0;41022.0
261520;201803;126;113;13;107802.0;12402.0;120204.0
261530;201803;4159;2635;1524;2505594.0;1452642.8;3958236.8
261540;201803;1080;666;414;634900.4;394956.0;1029856.4
261550;201803;287;141;146;133132.0;139264.92;272396.9
261560;201803;788;526;262;498562.2;248794.6;747356.8
261570;201803;368;288;80;274752.0;76320.0;351072.0
261580;201803;378;299;79;284195.8;75366.0;359561.8
261590;201803;195;158;37;150732.0;35298.0;186030.0
261600;201803;291;234;57;222473.0;53901.0;276374.0
261610;201803;106;92;14;86936.69;13356.0;100292.69
261618;201803;65;51;14;48654.0;13356.0;62010.0
261620;201803;201;121;80;115434.0;76320.0;191754.0
261630;201803;581;448;133;425031.6;126882.0;551913.6
261640;201803;6276;3334;2942;3173275.0;2803054.0;5976329.0
261650;201803;477;299;178;284568.66;169812.0;454380.66
270010;201803;525;461;64;439508.0;60293.0;499801.0
270020;201803;301;238;63;227048.0;60102.0;287150.0
270030;201803;9144;5842;3302;5559829.0;3147665.0;8707494.0
270040;201803;1925;1172;753;1117792.2;717121.8;1834914.0
270050;201803;176;129;47;123066.0;44838.0;167904.0
270060;201803;116;64;52;61056.0;49608.0;110664.0
270070;201803;902;655;247;623055.8;235333.27;858389.06
270080;201803;39;33;6;31482.0;5724.0;37206.0
270090;201803;19;15;4;14310.0;3816.0;18126.0
270100;201803;1250;824;426;782935.3;404257.7;1187193.0
270110;201803;151;111;40;105894.0;38160.0;144054.0
270120;201803;222;181;41;171822.55;39114.0;210936.55
270130;201803;254;175;79;166663.8;75079.8;241743.6
270135;201803;98;60;38;57240.0;36252.0;93492.0
270140;201803;1269;765;504;729617.25;479730.75;1209348.0
270150;201803;268;213;55;203202.0;52470.0;255672.0
270160;201803;521;389;132;371106.0;125260.2;496366.2
270170;201803;715;455;260;432925.2;247229.1;680154.3
270180;201803;72;55;17;52152.04;16008.12;68160.16
270190;201803;101;88;13;83952.0;12402.0;96354.0
270200;201803;107;96;11;91393.2;10494.0;101887.2
270210;201803;484;251;233;239454.0;221995.8;461449.8
270220;201803;187;147;40;140238.0;38160.0;178398.0
270230;201803;2087;1238;849;1176972.0;807085.44;1984057.4
270235;201803;736;551;185;525364.5;176124.95;701489.44
270240;201803;3096;2394;702;2272459.8;666916.0;2939375.8
270250;201803;170;118;52;112572.0;49608.0;162180.0
270255;201803;219;189;30;180306.0;28238.4;208544.4
270260;201803;329;261;68;248994.0;64872.0;313866.0
270270;201803;115;49;66;46737.0;62964.0;109701.0
270280;201803;209;130;79;124020.0;75366.0;199386.0
270290;201803;1166;873;293;831606.44;278645.47;1110251.9
270300;201803;270;169;101;161226.0;96067.8;257293.8
270310;201803;917;734;183;697668.44;173858.05;871526.5
270320;201803;883;753;130;717294.8;123733.8;841028.6
270330;201803;271;226;45;214650.0;42930.0;257580.0
270340;201803;60;47;13;44838.0;12402.0;57240.0
270350;201803;94;48;46;45450.45;43884.0;89334.45
270360;201803;74;41;33;39114.0;31482.0;70596.0
270370;201803;52;39;13;37206.0;12402.0;49608.0
270375;201803;67;38;29;36252.0;27666.0;63918.0
270380;201803;1080;607;473;578124.0;451242.0;1029366.0
270390;201803;194;105;89;100170.0;84906.0;185076.0
270400;201803;702;509;193;484371.28;184113.0;668484.25
270410;201803;697;498;199;474774.03;189836.45;664610.5
270420;201803;394;255;139;241572.0;132521.38;374093.38
270430;201803;32076;22849;9227;2,17E+14;8793851.0;3,05E+14
270440;201803;485;379;106;360755.1;100837.8;461592.9
270450;201803;770;402;368;383269.5;350118.66;733388.2
270460;201803;200;153;47;145962.0;44838.0;190800.0
270470;201803;1351;891;460;849660.7;438840.0;1288500.8
270480;201803;527;424;103;401414.97;97546.5;498961.47
270490;201803;25;21;4;20034.0;3816.0;23850.0
270500;201803;513;421;92;401634.0;87768.0;489402.0
270510;201803;733;449;284;428346.0;270936.0;699282.0
270520;201803;380;232;148;221119.0;141192.0;362311.0
270530;201803;66;58;8;55332.0;7632.0;62964.0
270540;201803;124;96;28;91584.0;26712.0;118296.0
270550;201803;1716;1293;423;1232245.2;403255.0;1635500.2
270560;201803;314;144;170;137376.0;162180.0;299556.0
270570;201803;452;300;152;285229.56;145008.0;430237.56
270580;201803;79;57;22;54378.0;20988.0;75366.0
270590;201803;79;66;13;62964.0;12402.0;75366.0
270600;201803;175;145;30;138330.0;28620.0;166950.0
270610;201803;177;142;35;135459.0;33390.0;168849.0
270620;201803;30;29;1;27666.0;954.0;28620.0
270630;201803;3830;2907;923;2762037.5;878386.94;3640424.5
270640;201803;897;655;242;623166.6;230553.8;853720.4
270642;201803;209;176;33;167904.0;31482.0;199386.0
270644;201803;280;193;87;183931.73;82993.23;266924.97
270650;201803;241;139;102;132606.0;97308.0;229914.0
270660;201803;256;206;50;196524.0;47700.0;244224.0
270670;201803;3158;2396;762;2274044.5;724021.9;2998066.5
270680;201803;467;271;196;258525.0;186979.23;445504.22
270690;201803;1122;704;418;669883.75;398762.47;1068646.2
270700;201803;36;27;9;25758.0;8586.0;34344.0
270710;201803;870;654;216;622297.3;206064.0;828361.3
270720;201803;246;187;59;178398.0;55999.8;234397.8
270730;201803;1876;1089;787;1036665.4;748692.2;1785357.6
270740;201803;46;29;17;27666.0;16218.0;43884.0
270750;201803;631;460;171;438650.0;162467.0;601117.0
270760;201803;310;224;86;213696.0;82044.0;295740.0
270770;201803;2697;1705;992;1619296.2;945414.0;2564710.2
270780;201803;92;57;35;54373.23;33372.46;87745.69
270790;201803;272;181;91;172674.0;86814.0;259488.0
270800;201803;1963;1563;400;1489309.2;380855.88;1870165.1
270810;201803;312;244;68;232761.69;64863.23;297624.9
270820;201803;156;100;56;95400.0;53329.0;148729.0
270830;201803;932;675;257;643183.0;244892.0;888075.0
270840;201803;1412;1027;385;978613.7;365622.0;1344235.8
270850;201803;1687;1029;658;976744.56;627713.44;1604458.0
270860;201803;2422;1570;852;1495441.4;809910.56;2305352.0
270870;201803;121;65;56;62010.0;53424.0;115434.0
270880;201803;912;668;244;635436.1;231882.58;867318.75
270890;201803;360;264;96;251407.62;91579.23;342986.84
270895;201803;72;61;11;58194.0;10494.0;68688.0
270900;201803;104;80;24;76320.0;22896.0;99216.0
270910;201803;325;259;66;245941.2;62964.0;308905.2
270915;201803;1802;1072;730;1017799.6;695701.1;1713500.8
270920;201803;475;398;77;379692.0;73458.0;453150.0
270930;201803;6200;4478;1722;4266494.5;1640007.2;5906501.5
270940;201803;2369;1788;581;1703782.9;553302.0;2257085.0
280010;201803;44;39;5;37206.0;4770.0;41976.0
280020;201803;702;605;97;575231.0;91584.0;666815.0
280030;201803;19237;12305;6932;1,17E+14;6585206.0;1,82E+13
280040;201803;339;214;125;204156.0;117819.0;321975.0
280050;201803;375;290;85;276373.8;81090.0;357463.8
280060;201803;328;217;111;204771.44;105894.0;310665.44
280067;201803;983;690;293;655501.94;278568.25;934070.2
280070;201803;131;109;22;103986.0;20988.0;124974.0
280100;201803;614;482;132;456988.28;125738.0;582726.25
280110;201803;75;71;4;67734.0;3816.0;71550.0
280120;201803;627;503;124;479862.0;118296.0;598158.0
280130;201803;1351;841;510;800883.8;486396.9;1287280.8
280140;201803;466;377;89;358799.4;83909.33;442708.72
280150;201803;319;236;83;224464.1;79182.0;303646.1
280160;201803;97;82;15;78228.0;14310.0;92538.0
280170;201803;582;385;197;365824.56;187938.0;553762.56
280190;201803;27;25;2;23850.0;1908.0;25758.0
280200;201803;23;15;8;14310.0;7632.0;21942.0
280210;201803;2745;1936;809;1829288.1;766209.0;2595497.0
280220;201803;40;31;9;29574.0;8586.0;38160.0
280230;201803;313;257;56;244343.62;53424.0;297767.62
280240;201803;112;106;6;100980.9;5724.0;106704.9
280250;201803;19;12;7;11448.0;6678.0;18126.0
280260;201803;80;69;11;65826.0;10494.0;76320.0
280270;201803;159;122;37;116388.0;35298.0;151686.0
280280;201803;196;125;71;119250.0;67734.0;186984.0
280290;201803;3059;2213;846;2098297.2;805773.25;2904070.5
280300;201803;1093;825;268;785385.25;254908.8;1040294.06
280310;201803;107;102;5;96977.29;4770.0;101747.29
280320;201803;655;445;210;423694.2;200340.0;624034.2
280330;201803;358;255;103;243270.0;98137.98;341407.97
280340;201803;415;332;83;315256.56;78419.0;393675.56
280350;201803;3403;2618;785;2487605.2;746150.2;3233755.5
280360;201803;463;292;171;278568.0;162180.0;440748.0
280370;201803;98;87;11;82998.0;10494.0;93492.0
280380;201803;56;42;14;40068.0;13356.0;53424.0
280390;201803;186;155;31;147870.0;29574.0;177444.0
280400;201803;343;232;111;220469.8;105894.0;326363.8
280410;201803;289;234;55;222074.0;52470.0;274544.0
280420;201803;174;146;28;139265.0;26712.0;165977.0
280430;201803;105;77;28;73458.0;26603.63;100061.63
280440;201803;681;525;156;496940.9;148623.66;645564.56
280445;201803;114;106;8;101124.0;7632.0;108756.0
280450;201803;1072;914;158;869380.2;150732.0;1020112.2
280460;201803;735;534;201;502575.44;191754.0;694329.44
280470;201803;192;175;17;166950.0;15265.0;182215.0
280480;201803;2241;1588;653;1499999.2;618920.9;2118920.0
280490;201803;354;325;29;308599.0;27666.0;336265.0
280500;201803;45;40;5;38160.0;4770.0;42930.0
280510;201803;147;113;34;107501.2;32150.0;139651.2
280520;201803;53;39;14;37206.0;13356.0;50562.0
280530;201803;77;54;23;51516.0;21942.0;73458.0
280540;201803;502;402;100;383508.0;95113.8;478621.8
280550;201803;707;652;55;619392.6;52470.0;671862.6
280560;201803;478;415;63;393159.94;60102.0;453261.94
280570;201803;1773;1350;423;1284171.5;402686.84;1686858.2
280580;201803;595;450;145;427757.6;138235.0;565992.6
280590;201803;164;100;64;95120.48;61056.0;156176.48
280600;201803;356;298;58;283547.88;55332.0;338879.88
280610;201803;143;108;35;102826.0;33390.0;136216.0
280620;201803;545;445;100;423576.5;94446.9;518023.4
280630;201803;163;135;28;128790.0;26712.0;155502.0
280640;201803;209;168;41;159443.0;39114.0;198557.0
280650;201803;79;53;26;50562.0;24804.0;75366.0
280660;201803;130;93;37;88722.0;35059.5;123781.5
280670;201803;1627;1017;610;964023.75;578195.94;1542219.8
280680;201803;180;153;27;144178.14;25758.0;169936.14
280690;201803;52;43;9;41022.0;8586.0;49608.0
280700;201803;17;17;0;16218.0;0.0;16218.0
280710;201803;1409;1067;342;1010842.8;325600.2;1336443.0
280720;201803;109;74;35;68036.4;33390.0;101426.4
280730;201803;27;23;4;21942.0;3816.0;25758.0
280740;201803;2395;1763;632;1676089.1;601536.44;2277625.5
280750;201803;291;251;40;239454.0;38160.0;277614.0
280760;201803;881;601;280;572029.2;267120.0;839149.2
290010;201803;199;133;66;126882.0;62964.0;189846.0
290020;201803;177;164;13;156456.0;12402.0;168858.0
290030;201803;593;385;208;366622.2;198432.0;565054.2
290035;201803;139;113;26;104597.7;24804.0;129401.7
290040;201803;267;167;100;159318.0;95400.0;254718.0
290050;201803;75;56;19;53424.0;18126.0;71550.0
290060;201803;253;112;141;106561.8;134514.0;241075.8
290070;201803;5585;2759;2826;2624647.8;2691480.5;5316128.0
290080;201803;501;227;274;216252.72;261377.0;477629.72
290090;201803;380;164;216;156456.0;206064.0;362520.0
290100;201803;1586;1043;543;990827.1;517449.8;1508276.9
290110;201803;753;449;304;426720.2;289773.5;716493.7
290115;201803;212;195;17;185076.0;16218.0;201294.0
290120;201803;779;503;276;479194.2;263304.0;742498.2
290130;201803;418;249;169;237250.27;161226.0;398476.25
290135;201803;296;225;71;213972.66;67734.0;281706.66
290140;201803;301;246;55;234684.0;52279.2;286963.2
290150;201803;130;97;33;92538.0;31482.0;124020.0
290160;201803;245;189;56;179066.58;53424.0;232490.58
290170;201803;88;62;26;59148.0;24804.0;83952.0
290180;201803;154;121;33;115434.0;31482.0;146916.0
290190;201803;447;363;84;346016.0;79849.8;425865.8
290195;201803;303;176;127;167904.0;121158.0;289062.0
290200;201803;282;238;44;227052.0;41976.0;269028.0
290205;201803;138;85;53;81090.0;50562.0;131652.0
290210;201803;1125;817;308;778274.2;293832.0;1072106.2
290220;201803;217;119;98;113049.0;93492.0;206541.0
290225;201803;280;107;173;102078.0;165042.0;267120.0
290230;201803;63;41;22;39114.0;20988.0;60102.0
290240;201803;309;123;186;117055.8;177444.0;294499.8
290250;201803;274;246;28;233988.0;26712.0;260700.0
290260;201803;275;226;49;214841.0;46746.0;261587.0
290265;201803;180;150;30;142283.0;28620.0;170903.0
290270;201803;1388;1147;241;1092378.2;229051.0;1321429.2
290280;201803;467;345;122;329130.0;116388.0;445518.0
290290;201803;1217;705;512;667477.9;488448.0;1155925.9
290300;201803;446;377;69;359367.22;65826.0;425193.22
290310;201803;322;143;179;136422.0;170766.0;307188.0
290320;201803;3943;2454;1489;2338413.8;1417645.0;3756058.8
290323;201803;183;159;24;151400.0;22896.0;174296.0
290327;201803;151;119;32;113254.11;30528.0;143782.11
290330;201803;72;37;35;35298.0;33390.0;68688.0
290340;201803;907;360;547;342467.0;521552.0;864019.0
290350;201803;586;348;238;331229.0;227052.0;558281.0
290360;201803;367;274;93;259489.69;88722.0;348211.7
290370;201803;912;359;553;342486.0;527548.0;870034.0
290380;201803;307;189;118;180306.0;112572.0;292878.0
290390;201803;2489;1551;938;1476681.6;892648.44;2369330.0
290395;201803;243;134;109;127025.6;103986.0;231011.6
290400;201803;280;206;74;196238.0;70596.0;266834.0
290405;201803;255;220;35;209880.0;33390.0;243270.0
290410;201803;566;481;85;455869.62;81090.0;536959.6
290420;201803;234;182;52;173628.0;49608.0;223236.0
290430;201803;494;310;184;295740.0;175536.0;471276.0
290440;201803;73;64;9;61056.0;7949.96;69005.96
290450;201803;232;178;54;169812.0;51516.0;221328.0
290460;201803;1870;1109;761;1056117.8;725517.5;1781635.4
290470;201803;1444;608;836;578903.25;797229.4;1376132.6
290475;201803;585;547;38;521123.0;36252.0;557375.0
290480;201803;289;161;128;153594.0;122112.0;275706.0
290485;201803;225;210;15;200340.0;14310.0;214650.0
290490;201803;1166;844;322;804412.8;306234.2;1110647.0
290500;201803;672;338;334;321498.0;318636.0;640134.0
290510;201803;219;165;54;156457.0;51516.0;207973.0
290515;201803;136;78;58;74412.0;55332.0;129744.0
290520;201803;1393;899;494;856024.6;468034.4;1324059.0
290530;201803;312;283;29;269982.0;27666.0;297648.0
290540;201803;95;58;37;55332.0;35298.0;90630.0
290550;201803;150;128;22;122112.0;20658.98;142770.98
290560;201803;3372;1361;2011;1297096.8;1918299.6;3215396.2
290570;201803;5886;3012;2874;2868836.8;2738981.0;5607818.0
290580;201803;1245;729;516;694225.8;491548.5;1185774.2
290590;201803;537;442;95;420877.0;90630.0;511507.0
290600;201803;1717;1189;528;1129605.0;503683.38;1633288.4
290610;201803;218;196;22;186527.0;20988.0;207515.0
290620;201803;323;285;38;271890.0;35965.8;307855.8
290630;201803;2097;890;1207;844774.5;1145855.2;1990629.8
290640;201803;150;122;28;116388.0;26712.0;143100.0
290650;201803;1701;803;898;765099.0;856692.0;1621791.0
290660;201803;280;228;52;217512.0;49608.0;267120.0
290670;201803;989;513;476;488830.0;453758.38;942588.4
290680;201803;1178;947;231;902484.0;219420.0;1121904.0
290682;201803;291;213;78;202215.3;74393.46;276608.75
290685;201803;230;147;83;139284.0;79182.0;218466.0
290687;201803;930;615;315;583323.6;299556.0;882879.6
290689;201803;129;75;54;71536.0;51501.69;123037.69
290690;201803;648;266;382;253735.92;363548.8;617284.75
290700;201803;239;113;126;107802.0;120204.0;228006.0
290710;201803;702;464;238;442636.9;227052.0;669688.94
290720;201803;1021;830;191;791820.0;181737.0;973557.0
290730;201803;1115;639;476;607746.5;453150.0;1060896.5
290740;201803;15;12;3;11448.0;2862.0;14310.0
290750;201803;1350;614;736;583718.06;700032.1;1283750.1
290755;201803;70;62;8;59148.0;7632.0;66780.0
290760;201803;298;259;39;247086.0;37206.0;284292.0
290770;201803;186;175;11;166940.45;10494.0;177434.45
290780;201803;974;780;194;742176.7;183263.4;925440.06
290790;201803;371;259;112;247086.0;106848.0;353934.0
290800;201803;2623;1048;1575;997622.06;1501443.4;2499065.5
290810;201803;436;302;134;287822.0;127836.0;415658.0
290820;201803;374;232;142;220360.0;135468.0;355828.0
290830;201803;399;272;127;259488.0;121158.0;380646.0
290840;201803;1679;1027;652;977612.8;619928.5;1597541.2
290850;201803;754;417;337;397627.2;320544.0;718171.2
290860;201803;643;284;359;270936.0;342200.0;613136.0
290870;201803;663;478;185;454791.8;176490.0;631281.8
290880;201803;125;67;58;63918.0;55332.0;119250.0
290890;201803;328;233;95;222282.0;90630.0;312912.0
290900;201803;169;127;42;121158.0;40068.0;161226.0
290910;201803;361;273;88;260442.0;83952.0;344394.0
290920;201803;230;195;35;186030.0;33390.0;219420.0
290930;201803;810;613;197;584802.0;187919.0;772721.0
290940;201803;250;204;46;193852.8;43884.0;237736.8
290950;201803;172;99;73;94446.0;69642.0;164088.0
290960;201803;439;293;146;278282.25;138997.8;417280.03
290970;201803;251;220;31;209689.2;29431.0;239120.2
290980;201803;1491;1056;435;1003255.75;413941.2;1417197.0
290990;201803;369;312;57;297619.9;54322.38;351942.3
291000;201803;864;243;621;231822.0;591861.6;823683.6
291005;201803;2086;882;1204;839081.75;1147839.0;1986920.8
291010;201803;157;142;15;135468.0;14310.0;149778.0
291020;201803;102;80;22;76320.0;20988.0;97308.0
291030;201803;91;67;24;63918.0;22896.0;86814.0
291040;201803;578;286;292;272844.0;278568.0;551412.0
291050;201803;1335;746;589;710039.25;561619.8;1271659.0
291060;201803;1484;819;665;780658.2;634410.0;1415068.2
291070;201803;1879;1390;489;1319729.4;464482.3;1784211.8
291072;201803;7290;2671;4619;2544785.5;4404342.5;6949128.0
291075;201803;205;166;39;158364.0;37206.0;195570.0
291077;201803;48;32;16;30528.0;15264.0;45792.0
291080;201803;19508;8516;10992;8100239.5;1,05E+14;1,86E+14
291085;201803;294;234;60;223236.0;57235.23;280471.22
291090;201803;304;116;188;110378.0;179342.45;289720.47
291100;201803;677;196;481;186984.0;458874.0;645858.0
291110;201803;400;300;100;286180.9;95400.0;381580.9
291120;201803;2507;1181;1326;1126531.0;1263025.9;2389557.0
291125;201803;60;30;30;28620.0;28620.0;57240.0
291130;201803;213;187;26;178398.0;24804.0;203202.0
291140;201803;121;89;32;84906.0;30242.0;115148.0
291150;201803;378;150;228;143100.0;217512.0;360612.0
291160;201803;361;300;61;285246.5;58194.0;343440.5
291165;201803;23;19;4;18126.0;3816.0;21942.0
291170;201803;2881;1442;1439;1371900.1;1369753.6;2741653.8
291180;201803;1320;511;809;487297.38;771652.7;1258950.0
291185;201803;74;72;2;68688.0;1908.0;70596.0
291190;201803;1248;535;713;507618.16;679658.8;1187277.0
291200;201803;164;120;44;114480.0;41976.0;156456.0
291210;201803;2198;852;1346;809528.4;1282272.1;2091800.5
291220;201803;266;199;67;188892.64;63918.0;252810.64
291230;201803;1027;348;679;331134.0;647766.0;978900.0
291240;201803;438;415;23;394670.0;21942.0;416612.0
291250;201803;432;353;79;336762.0;75366.0;412128.0
291260;201803;43;32;11;30528.0;10494.0;41022.0
291270;201803;1202;488;714;465552.0;680631.8;1146183.8
291280;201803;373;170;203;161974.89;193366.27;355341.16
291290;201803;1760;888;872;845435.2;830840.0;1676275.2
291300;201803;223;176;47;167236.2;44838.0;212074.2
291310;201803;231;205;26;195283.8;24804.0;220087.8
291320;201803;1384;989;395;940644.0;375781.28;1316425.2
291330;201803;129;110;19;103127.4;18126.0;121253.4
291340;201803;144;83;61;79182.0;58194.0;137376.0
291345;201803;129;85;44;81090.0;41976.0;123066.0
291350;201803;1572;505;1067;481579.2;1017727.3;1499306.5
291360;201803;8595;4219;4376;4013160.8;4171857.5;8185018.5
291370;201803;1082;596;486;568298.0;463644.0;1031942.0
291380;201803;254;199;55;189846.0;52184.0;242030.0
291390;201803;3890;1687;2203;1604946.0;2099850.0;3704796.0
291400;201803;2075;1486;589;1412493.4;560223.5;1972716.9
291410;201803;152;133;19;125928.0;18126.0;144054.0
291420;201803;110;79;31;75366.0;29574.0;104940.0
291430;201803;169;95;74;89923.0;69642.53;159565.53
291440;201803;498;397;101;376014.3;96354.0;472368.3
291450;201803;902;566;336;538724.8;319590.0;858314.8
291460;201803;1719;1398;321;1331927.1;306234.0;1638161.1
291465;201803;2201;1020;1181;972234.06;1126392.1;2098626.2
291470;201803;2772;1399;1373;1330860.5;1309112.0;2639972.5
291480;201803;11843;5210;6633;4959290.5;6318801.5;1,13E+14
291490;201803;547;226;321;215604.0;306234.0;521838.0
291500;201803;371;201;170;191754.0;162180.0;353934.0
291510;201803;1234;464;770;441495.0;734293.8;1175788.8
291520;201803;960;438;522;417852.0;497978.47;915830.44
291530;201803;1010;269;741;256626.0;706608.75;963234.75
291535;201803;115;95;20;90630.0;19080.0;109710.0
291540;201803;360;107;253;102078.0;240408.6;342486.6
291550;201803;1182;555;627;527373.1;597758.25;1125131.4
291560;201803;5537;2825;2712;2682179.0;2575023.0;5257202.0
291570;201803;206;107;99;102078.0;94446.0;196524.0
291580;201803;1216;740;476;705193.44;454090.22;1159283.8
291590;201803;81;31;50;29430.9;47700.0;77130.9
291600;201803;1370;624;746;594342.0;711380.0;1305722.0
291610;201803;1403;641;762;610230.9;726892.0;1337122.9
291620;201803;580;268;312;255672.0;297266.4;552938.4
291630;201803;495;162;333;154548.0;317682.0;472230.0
291640;201803;3902;1961;1941;1863233.8;1850347.0;3713580.8
291650;201803;419;278;141;264077.75;133714.73;397792.47
291660;201803;446;177;269;168165.95;255528.9;423694.88
291670;201803;223;142;81;134896.0;77274.0;212170.0
291680;201803;699;400;299;381600.0;285141.47;666741.44
291685;201803;581;311;270;296456.0;257389.2;553845.2
291690;201803;561;290;271;276660.0;257571.0;534231.0
291700;201803;916;724;192;689966.2;182214.0;872180.2
291710;201803;1702;787;915;750102.25;872033.06;1622135.4
291720;201803;397;263;134;250897.23;127836.0;378733.22
291730;201803;936;546;390;518928.5;372050.47;890978.94
291733;201803;259;181;78;172387.8;74412.0;246799.8
291735;201803;65;49;16;46746.0;15264.0;62010.0
291740;201803;343;258;85;246132.0;81090.0;327222.0
291750;201803;1937;1294;643;1227192.8;612600.0;1839792.8
291760;201803;3057;1650;1407;1567460.5;1339893.0;2907353.5
291770;201803;807;543;264;515923.25;251856.0;767779.25
291780;201803;46;27;19;25758.0;18126.0;43884.0
291790;201803;165;76;89;72504.0;84906.0;157410.0
291800;201803;9939;3953;5986;3760086.5;5706448.0;9466534.0
291810;201803;1142;819;323;780749.0;308142.0;1088891.0
291820;201803;262;190;72;181260.0;68688.0;249948.0
291830;201803;1072;405;667;385149.0;635355.0;1020504.0
291835;201803;608;559;49;532809.0;46746.0;579555.0
291840;201803;4658;2399;2259;2283854.2;2154238.0;4438092.0
291845;201803;302;103;199;98262.0;189817.38;288079.38
291850;201803;324;282;42;268789.5;40068.0;308857.5
291855;201803;267;106;161;101124.0;153594.0;254718.0
291860;201803;175;110;65;103986.0;62010.0;165996.0
291870;201803;82;33;49;31482.0;46746.0;78228.0
291875;201803;186;168;18;160272.0;17172.0;177444.0
291880;201803;488;382;106;363618.0;101124.0;464742.0
291890;201803;245;81;164;77264.46;154739.0;232003.45
291900;201803;57;32;25;30528.0;23850.0;54378.0
291905;201803;133;93;40;88436.0;38160.0;126596.0
291910;201803;175;142;33;135468.0;31482.0;166950.0
291915;201803;389;346;43;328416.0;41022.0;369438.0
291920;201803;4940;2563;2377;2442413.5;2265806.8;4708220.5
291930;201803;182;105;77;100170.0;73458.0;173628.0
291940;201803;319;176;143;167207.58;135468.0;302675.6
291950;201803;1135;925;210;881687.0;200340.0;1082027.0
291955;201803;1013;602;411;574308.0;391665.0;965973.0
291960;201803;180;124;56;118296.0;53137.8;171433.8
291970;201803;779;590;189;562860.0;180306.0;743166.0
291980;201803;1496;1322;174;1257775.8;165042.4;1422818.1
291990;201803;123;114;9;108756.0;8586.0;117342.0
291992;201803;164;85;79;80326.8;75366.0;155692.8
291995;201803;149;105;44;100170.0;41976.0;142146.0
292000;201803;383;290;93;274193.06;88722.0;362915.06
292010;201803;281;200;81;190133.0;76320.0;266453.0
292020;201803;268;197;71;187938.0;67734.0;255672.0
292030;201803;138;107;31;102078.0;29574.0;131652.0
292040;201803;624;314;310;299556.0;295740.0;595296.0
292045;201803;92;83;9;79182.0;8586.0;87768.0
292050;201803;883;609;274;579976.9;261110.0;841086.9
292060;201803;936;768;168;730478.75;160272.0;890750.75
292070;201803;50;21;29;20034.0;27666.0;47700.0
292080;201803;115;79;36;75366.0;34344.0;109710.0
292090;201803;496;174;322;165805.2;307188.0;472993.2
292100;201803;1402;600;802;570826.7;765079.94;1335906.6
292105;201803;203;171;32;163134.0;30528.0;193662.0
292110;201803;2109;780;1329;743795.6;1265840.9;2009636.5
292120;201803;643;517;126;492085.78;120204.0;612289.8
292130;201803;446;264;182;251856.0;173628.0;425484.0
292140;201803;197;154;43;146916.0;40890.26;187806.27
292145;201803;159;86;73;82044.0;69599.07;151643.06
292150;201803;1417;1134;283;1081836.0;268954.16;1350790.1
292160;201803;181;148;33;140905.8;31482.0;172387.8
292170;201803;1217;1066;151;1015271.3;143996.77;1159268.1
292180;201803;200;141;59;134514.0;56286.0;190800.0
292190;201803;157;96;61;91584.0;58194.0;149778.0
292200;201803;1274;461;813;438651.72;774953.56;1213605.2
292205;201803;115;103;12;97975.8;11448.0;109423.8
292210;201803;369;256;113;242841.0;107086.5;349927.5
292220;201803;22;16;6;15264.0;5724.0;20988.0
292225;201803;38;35;3;33390.0;2862.0;36252.0
292230;201803;912;736;176;699446.0;167904.0;867350.0
292240;201803;619;443;176;421525.0;167904.0;589429.0
292250;201803;1688;1072;616;1022688.0;587664.0;1610352.0
292260;201803;437;244;193;232776.0;183358.8;416134.8
292265;201803;269;189;80;180019.8;76320.0;256339.8
292270;201803;774;340;434;324360.0;413082.8;737442.8
292273;201803;199;110;89;104162.49;84906.0;189068.48
292275;201803;164;80;84;76320.0;79849.8;156169.8
292280;201803;138;97;41;92538.0;39114.0;131652.0
292285;201803;59;50;9;47032.2;8586.0;55618.2
292290;201803;551;369;182;349536.47;173342.0;522878.47
292300;201803;1623;619;1004;589953.8;956982.56;1546936.4
292303;201803;97;66;31;62964.0;29574.0;92538.0
292305;201803;111;79;32;75366.0;30528.0;105894.0
292310;201803;799;502;297;478546.0;282040.16;760586.1
292320;201803;662;498;164;474805.8;156265.0;631070.8
292330;201803;187;98;89;93492.0;84906.0;178398.0
292335;201803;273;210;63;200340.0;60102.0;260442.0
292340;201803;571;399;172;379906.84;164088.0;543994.9
292350;201803;267;142;125;134657.1;118963.8;253620.9
292360;201803;703;531;172;504857.0;164088.0;668945.0
292370;201803;774;590;184;562860.0;175536.0;738396.0
292380;201803;646;501;145;476046.62;138330.0;614376.6
292390;201803;502;187;315;178398.0;298745.5;477143.5
292400;201803;3356;2050;1306;1937382.4;1242043.8;3179426.2
292405;201803;264;175;89;166473.0;84619.8;251092.8
292410;201803;153;90;63;85860.0;60102.0;145962.0
292420;201803;306;261;45;248707.8;42930.0;291637.8
292430;201803;517;405;112;386370.0;106371.0;492741.0
292440;201803;577;492;85;467574.6;80803.8;548378.4
292450;201803;247;191;56;182214.0;53424.0;235638.0
292460;201803;585;435;150;414417.8;142909.03;557326.8
292465;201803;200;164;36;156456.0;33606.09;190062.1
292467;201803;103;60;43;57240.0;41022.0;98262.0
292470;201803;251;171;80;163134.0;76320.0;239454.0
292480;201803;325;215;110;204156.5;104654.0;308810.5
292490;201803;218;143;75;136422.0;71550.0;207972.0
292500;201803;1166;504;662;480605.0;631090.25;1111695.2
292510;201803;3327;1495;1832;1425276.1;1745000.8;3170276.8
292520;201803;1064;503;561;477997.7;535185.0;1013182.7
292525;201803;385;274;111;261391.23;105894.0;367285.22
292530;201803;4223;1727;2496;1644287.0;2379718.0;4024005.0
292540;201803;477;257;220;245178.0;209880.0;455058.0
292550;201803;1059;571;488;543992.75;465047.72;1009040.44
292560;201803;318;299;19;285246.0;18126.0;303372.0
292570;201803;299;227;72;216229.0;68688.0;284917.0
292575;201803;467;300;167;285914.0;159318.0;445232.0
292580;201803;911;576;335;548073.0;319304.0;867377.0
292590;201803;508;435;73;414687.6;69642.0;484329.6
292593;201803;143;112;31;106848.0;29574.0;136422.0
292595;201803;179;136;43;129744.0;41022.0;170766.0
292600;201803;1234;920;314;877363.0;298888.2;1176251.2
292610;201803;127;97;30;92538.0;28362.42;120900.42
292620;201803;520;430;90;409925.0;85860.0;495785.0
292630;201803;1370;788;582;750164.0;553559.75;1303723.8
292640;201803;763;533;230;508148.1;219420.0;727568.1
292650;201803;172;147;25;139802.0;23850.0;163652.0
292660;201803;1994;1439;555;1366982.9;525272.8;1892255.6
292665;201803;138;101;37;96354.0;35298.0;131652.0
292670;201803;398;321;77;306230.0;73458.0;379688.0
292680;201803;249;194;55;185076.0;51993.0;237069.0
292690;201803;180;137;43;130698.0;41022.0;171720.0
292700;201803;916;604;312;575262.8;297648.0;872910.8
292710;201803;97;85;12;81090.0;11448.0;92538.0
292720;201803;827;467;360;444716.62;343440.0;788156.6
292730;201803;201;95;106;89676.5;101124.0;190800.5
292740;201803;66191;32763;33428;3,12E+14;3,19E+13;6,30E+14
292750;201803;372;266;106;252810.94;100313.57;353124.5
292760;201803;316;256;60;243213.5;57240.0;300453.5
292770;201803;788;335;453;319304.0;432162.0;751466.0
292780;201803;421;158;263;150504.48;250902.0;401406.47
292790;201803;731;357;374;340578.0;356557.5;697135.5
292800;201803;1138;699;439;665892.0;418806.0;1084698.0
292805;201803;426;123;303;116817.3;289062.0;405879.3
292810;201803;1465;850;615;809755.8;586414.44;1396170.2
292820;201803;743;596;147;566676.9;139942.8;706619.7
292830;201803;103;82;21;78228.0;20034.0;98262.0
292840;201803;656;539;117;513729.0;111603.69;625332.7
292850;201803;130;88;42;83948.0;40068.0;124016.0
292860;201803;2136;1247;889;1185567.0;848106.0;2033673.0
292870;201803;3380;2265;1115;2159547.8;1063700.5;3223248.2
292880;201803;1447;949;498;901579.9;473908.97;1375488.9
292890;201803;481;410;71;391112.0;67734.0;458846.0
292895;201803;137;91;46;85455.5;43884.0;129339.5
292900;201803;391;289;102;275706.0;97308.0;373014.0
292905;201803;447;230;217;219420.0;207018.0;426438.0
292910;201803;400;304;96;289683.0;91584.0;381267.0
292920;201803;541;236;305;225144.0;290970.0;516114.0
292925;201803;508;472;36;449610.66;34325.0;483935.66
292930;201803;562;348;214;331992.0;204156.0;536148.0
292935;201803;292;125;167;119250.0;159318.0;278568.0
292937;201803;233;160;73;152640.0;69642.0;222282.0
292940;201803;191;145;46;138330.0;43884.0;182214.0
292950;201803;1092;564;528;535910.5;502759.0;1038669.5
292960;201803;555;371;184;353934.0;175536.0;529470.0
292970;201803;275;192;83;182501.0;79182.0;261683.0
292975;201803;156;89;67;84906.0;63728.0;148634.0
292980;201803;255;173;82;163258.44;78228.0;241486.44
292990;201803;1311;969;342;917089.9;325991.94;1243081.8
293000;201803;103;75;28;71550.0;26712.0;98262.0
293010;201803;2656;1631;1025;1550212.9;973813.0;2524026.0
293015;201803;649;515;134;491092.5;127197.0;618289.5
293020;201803;329;270;59;257580.0;56286.0;313866.0
293030;201803;618;538;80;511726.44;76320.0;588046.44
293040;201803;338;264;74;251856.0;70596.0;322452.0
293050;201803;2707;1578;1129;1495904.9;1072936.4;2568841.2
293060;201803;251;201;50;190567.0;46746.8;237313.8
293070;201803;3378;1710;1668;1623487.6;1590051.9;3213539.5
293075;201803;90;58;32;55332.0;30528.0;85860.0
293076;201803;72;46;26;43884.0;24804.0;68688.0
293077;201803;430;263;167;246387.47;159318.0;405705.47
293080;201803;446;396;50;377784.0;47700.0;425484.0
293090;201803;130;112;18;106848.0;16854.04;123702.04
293100;201803;517;363;154;346302.0;146916.0;493218.0
293105;201803;342;233;109;221996.0;103986.0;325982.0
293110;201803;169;120;49;114480.0;46746.0;161226.0
293120;201803;316;212;104;202248.0;99025.2;301273.2
293130;201803;246;165;81;157410.0;77274.0;234684.0
293135;201803;7906;3127;4779;2976526.2;4550929.0;7527455.5
293140;201803;182;118;64;112572.0;60293.0;172865.0
293150;201803;328;278;50;263781.2;47700.0;311481.2
293160;201803;427;244;183;232776.0;174582.0;407358.0
293170;201803;189;132;57;125642.0;53520.0;179162.0
293180;201803;465;316;149;301178.0;142146.0;443324.0
293190;201803;1277;887;390;841548.75;372060.0;1213608.8
293200;201803;524;463;61;440622.0;58194.0;498816.0
293210;201803;342;250;92;238348.0;87052.5;325400.5
293220;201803;2686;1077;1609;1025524.44;1532896.5;2558421.0
293230;201803;1767;638;1129;607221.8;1077066.0;1684287.8
293240;201803;222;201;21;191754.0;20034.0;211788.0
293245;201803;110;93;17;88722.0;16218.0;104940.0
293250;201803;735;273;462;260194.0;440748.0;700942.0
293260;201803;312;262;50;248994.17;47700.0;296694.16
293270;201803;1182;562;620;534240.7;591480.0;1125720.6
293280;201803;239;132;107;125928.0;102078.0;228006.0
293290;201803;3074;2008;1066;1914434.8;1016665.0;2931099.8
293300;201803;699;496;203;470851.5;191181.6;662033.1
293305;201803;152;130;22;124020.0;20988.0;145008.0
293310;201803;136;102;34;97308.0;32436.0;129744.0
293315;201803;156;120;36;114480.0;34344.0;148824.0
293317;201803;96;67;29;63918.0;27666.0;91584.0
293320;201803;962;554;408;527562.5;389232.0;916794.5
293325;201803;184;64;120;61056.0;114441.84;175497.84
293330;201803;12867;6009;6858;5721669.5;6534699.5;1,23E+14
293340;201803;250;181;69;172674.0;64872.0;237546.0
293345;201803;244;194;50;185076.0;47700.0;232776.0
293350;201803;630;337;293;321498.0;278043.3;599541.3
293360;201803;1573;1123;450;1070102.0;428060.7;1498162.8
310010;201803;152;77;75;73458.0;71264.0;144722.0
310020;201803;1055;577;478;548073.2;454104.12;1002177.3
310030;201803;324;263;61;249776.88;57907.8;307684.7
310040;201803;50;31;19;29574.0;18126.0;47700.0
310050;201803;186;123;63;116388.4;59816.0;176204.4
310060;201803;232;162;70;154071.0;66780.0;220851.0
310070;201803;16;8;8;7632.0;7632.0;15264.0
310080;201803;50;27;23;25758.0;21942.0;47700.0
310090;201803;956;503;453;474616.7;431017.6;905634.25
310100;201803;298;223;75;212742.0;71550.0;284292.0
310110;201803;733;390;343;371025.1;326268.0;697293.1
310120;201803;389;216;173;205396.2;164667.94;370064.12
310130;201803;33;20;13;19080.0;12402.0;31482.0
310140;201803;28;16;12;15264.0;11448.0;26712.0
310150;201803;1287;882;405;835658.6;385511.8;1221170.4
310160;201803;2104;1064;1040;1006949.5;989775.4;1996724.9
310163;201803;92;51;41;48654.0;39114.0;87768.0
310170;201803;2562;1052;1510;1003484.0;1437964.6;2441448.5
310180;201803;129;49;80;46746.0;75938.4;122684.4
310190;201803;487;327;160;311958.0;152067.6;464025.6
310200;201803;503;318;185;303372.0;176204.0;479576.0
310205;201803;59;45;14;42930.0;13356.0;56286.0
310210;201803;278;227;51;216558.0;48654.0;265212.0
310220;201803;54;32;22;30528.0;20988.0;51516.0
310230;201803;261;183;78;174391.2;74412.0;248803.2
310240;201803;106;93;13;88483.5;12402.0;100885.5
310250;201803;99;80;19;76320.0;18126.0;94446.0
310260;201803;799;428;371;405356.25;353199.4;758555.7
310270;201803;269;178;91;169259.0;86814.0;256073.0
310280;201803;366;273;93;259488.8;88722.0;348210.8
310285;201803;219;156;63;148515.86;60102.0;208617.86
310290;201803;257;149;108;142146.0;103032.0;245178.0
310300;201803;157;130;27;124020.0;25758.0;149778.0
310310;201803;7;5;2;4770.0;1908.0;6678.0
310320;201803;23;14;9;13356.0;8586.0;21942.0
310330;201803;31;23;8;21942.0;7632.0;29574.0
310340;201803;1691;1094;597;1035949.8;568012.5;1603962.2
310350;201803;2826;1532;1294;1456706.0;1233894.8;2690600.8
310360;201803;41;33;8;31482.0;7632.0;39114.0
310370;201803;124;102;22;97308.0;20702.0;118010.0
310375;201803;104;37;67;35298.0;63899.0;99197.0
310380;201803;53;31;22;28668.0;20988.0;49656.0
310390;201803;105;72;33;68688.0;31482.0;100170.0
310400;201803;2320;1495;825;1422320.0;786763.8;2209083.8
310410;201803;126;69;57;65826.0;54378.0;120204.0
310420;201803;669;359;310;340674.8;294777.06;635451.9
310430;201803;330;216;114;205777.8;108756.0;314533.8
310440;201803;67;41;26;39114.0;24804.0;63918.0
310445;201803;86;68;18;64872.0;17172.0;82044.0
310450;201803;857;539;318;513538.2;303372.0;816910.2
310460;201803;264;191;73;182214.0;69642.0;251856.0
310470;201803;499;317;182;302418.0;173628.0;476046.0
310480;201803;77;55;22;52470.0;20988.0;73458.0
310490;201803;498;234;264;222282.2;251856.0;474138.2
310500;201803;124;54;70;51516.0;66780.0;118296.0
310510;201803;606;394;212;374636.6;202229.45;576866.06
310520;201803;127;84;43;80136.0;41022.0;121158.0
310530;201803;87;41;46;39114.0;43597.8;82711.8
310540;201803;455;281;174;265690.6;165996.0;431686.6
310550;201803;85;56;29;53424.0;27666.0;81090.0
310560;201803;2916;2010;906;1906772.6;862745.1;2769517.8
310570;201803;126;85;41;81090.0;39114.0;120204.0
310590;201803;347;228;119;216129.8;113511.69;329641.5
310600;201803;158;91;67;85049.7;63918.0;148967.7
310610;201803;59;21;38;20034.0;36252.0;56286.0
310620;201803;45676;21863;23813;2,08E+14;2,27E+13;4,35E+14
310630;201803;593;378;215;357893.6;203616.28;561509.9
310640;201803;134;113;21;107611.2;20034.0;127645.2
310650;201803;161;141;20;133274.0;19080.0;152354.0
310660;201803;90;57;33;54378.0;31482.0;85860.0
310665;201803;55;40;15;38160.0;14310.0;52470.0
310670;201803;6346;2924;3422;2781607.2;3259544.5;6041151.5
310680;201803;55;36;19;34344.0;18126.0;52470.0
310690;201803;602;437;165;412692.16;157410.0;570102.2
310700;201803;63;40;23;38160.0;21798.9;59958.9
310710;201803;1239;824;415;784842.25;395337.8;1180180.0
310720;201803;86;28;58;26712.0;55332.0;82044.0
310730;201803;1373;955;418;909544.5;398772.0;1308316.5
310740;201803;1003;564;439;534908.4;418558.47;953466.9
310750;201803;245;143;102;135468.19;97308.0;232776.19
310760;201803;69;53;16;50562.0;15264.0;65826.0
310770;201803;94;46;48;43884.0;45792.0;89676.0
310780;201803;402;328;74;312330.6;70596.0;382926.6
310790;201803;102;82;20;78228.0;19080.0;97308.0
310800;201803;454;221;233;210357.0;221995.8;432352.8
310810;201803;167;116;51;109605.2;47700.0;157305.2
310820;201803;354;281;73;268074.0;69355.8;337429.8
310825;201803;192;158;34;150732.0;32436.0;183168.0
310830;201803;463;222;241;211127.94;229914.0;441041.94
310840;201803;383;217;166;207018.0;158364.0;365382.0
310850;201803;109;88;21;83952.0;20034.0;103986.0
310855;201803;376;297;79;283338.0;75366.0;358704.0
310860;201803;1398;1045;353;992210.1;335026.9;1327237.0
310870;201803;54;42;12;40068.0;11448.0;51516.0
310880;201803;83;65;18;61723.8;17172.0;78895.8
310890;201803;313;185;128;176490.0;122112.0;298602.0
310900;201803;630;289;341;272887.22;325008.8;597896.0
310910;201803;247;168;79;158937.2;75366.0;234303.2
310920;201803;487;292;195;274753.2;186030.0;460783.2
310925;201803;38;31;7;29574.0;6392.0;35966.0
310930;201803;1092;659;433;628283.3;412987.06;1041270.4
310940;201803;679;348;331;331391.8;315774.0;647165.8
310945;201803;118;73;45;69642.0;42930.0;112572.0
310950;201803;252;198;54;188892.0;51516.0;240408.0
310960;201803;85;31;54;29574.0;51512.0;81086.0
310970;201803;168;105;63;100170.0;59179.76;159349.77
310980;201803;46;24;22;22896.0;20988.0;43884.0
310990;201803;149;84;65;79850.0;62010.0;141860.0
311000;201803;846;423;423;400013.7;403533.0;803546.7
311010;201803;40;33;7;31482.0;6678.0;38160.0
311020;201803;41;26;15;24804.0;14310.0;39114.0
311030;201803;389;231;158;218180.0;150732.0;368912.0
311040;201803;38;33;5;31482.0;4770.0;36252.0
311050;201803;461;194;267;184504.0;254145.6;438649.6
311060;201803;757;432;325;410697.4;309764.0;720461.4
311070;201803;333;152;181;145008.0;172674.0;317682.0
311080;201803;105;58;47;55332.0;44838.0;100170.0
311090;201803;396;185;211;175250.0;201294.0;376544.0
311100;201803;613;365;248;347923.8;236305.8;584229.6
311110;201803;679;469;210;447139.8;200331.0;647470.8
311115;201803;67;48;19;45792.0;18126.0;63918.0
311120;201803;1036;540;496;513870.0;472563.9;986433.9
311130;201803;409;237;172;225907.2;164088.0;389995.2
311140;201803;162;81;81;77274.0;76463.1;153737.1
311150;201803;352;232;120;221328.0;114241.5;335569.5
311160;201803;747;538;209;510867.4;198909.0;709776.4
311170;201803;79;58;21;55332.0;19747.8;75079.8
311180;201803;346;229;117;218179.8;111332.0;329511.8
311190;201803;35;18;17;17172.0;16218.0;33390.0
311200;201803;337;235;102;222568.6;97308.0;319876.6
311205;201803;29;19;10;18126.0;9158.4;27284.4
311210;201803;49;41;8;38828.0;7632.0;46460.0
311220;201803;18;16;2;15264.0;1908.0;17172.0
311230;201803;1636;1060;576;1006873.94;549504.0;1556378.0
311240;201803;170;107;63;101874.33;60102.0;161976.33
311250;201803;82;31;51;29574.0;48654.0;78228.0
311260;201803;556;352;204;335808.0;194616.0;530424.0
311265;201803;116;81;35;77274.0;33390.0;110664.0
311270;201803;284;204;80;194616.0;76320.0;270936.0
311280;201803;211;95;116;90630.0;110091.6;200721.6
311290;201803;110;88;22;83952.0;20416.0;104368.0
311300;201803;547;344;203;327222.97;193376.0;520598.97
311310;201803;23;18;5;17172.0;4770.0;21942.0
311320;201803;673;504;169;479862.0;161226.0;641088.0
311330;201803;1031;757;274;721653.3;260442.4;982095.7
311340;201803;2621;1863;758;1769872.6;722722.9;2492595.5
311350;201803;274;210;64;200340.0;61056.0;261396.0
311360;201803;179;106;73;101124.0;69642.0;170766.0
311370;201803;1202;487;715;462604.5;681537.6;1144142.1
311380;201803;7;6;1;5724.0;954.0;6678.0
311390;201803;283;150;133;143100.0;126405.2;269505.2
311400;201803;147;97;50;92538.0;47700.0;140238.0
311410;201803;97;54;43;51516.0;41022.0;92538.0
311420;201803;300;165;135;156456.8;128790.0;285246.8
311430;201803;847;549;298;522698.0;284292.0;806990.0
311440;201803;492;343;149;327222.0;141859.8;469081.8
311450;201803;319;199;120;189846.0;114480.0;304326.0
311455;201803;303;204;99;194320.8;94159.8;288480.6
311460;201803;131;52;79;49608.0;74560.27;124168.27
311470;201803;22;12;10;11448.0;9540.0;20988.0
311480;201803;25;10;15;9540.0;14310.0;23850.0
311490;201803;16;10;6;9540.0;5724.0;15264.0
311500;201803;19;10;9;9540.0;8586.0;18126.0
311510;201803;618;436;182;414001.7;173055.8;587057.5
311520;201803;46;33;13;30814.2;12402.0;43216.2
311530;201803;1802;1345;457;1273687.8;435978.0;1709665.8
311535;201803;68;51;17;48654.0;16218.0;64872.0
311540;201803;33;29;4;27666.0;3816.0;31482.0
311545;201803;186;140;46;133560.0;43884.0;177444.0
311547;201803;31;22;9;20988.0;8586.0;29574.0
311550;201803;638;299;339;285246.0;323387.47;608633.44
311560;201803;43;28;15;26712.0;14310.0;41022.0
311570;201803;304;204;100;194043.6;95400.0;289443.6
311580;201803;310;181;129;172387.8;123066.0;295453.8
311590;201803;33;29;4;27666.0;3816.0;31482.0
311600;201803;91;72;19;68688.0;18126.0;86814.0
311610;201803;258;224;34;212742.5;32436.0;245178.5
311615;201803;100;81;19;76634.82;17935.2;94570.02
311620;201803;19;11;8;10494.0;7632.0;18126.0
311630;201803;85;71;14;67734.0;13356.0;81090.0
311640;201803;121;65;56;62010.0;53424.0;115434.0
311650;201803;130;96;34;90868.5;32436.0;123304.5
311660;201803;405;193;212;184122.0;202248.0;386370.0
311670;201803;167;107;60;101833.0;57240.0;159073.0
311680;201803;223;161;62;152692.95;58384.8;211077.75
311690;201803;18;11;7;10494.0;6678.0;17172.0
311700;201803;200;139;61;132319.8;58194.0;190513.8
311710;201803;214;137;77;130698.0;73458.0;204156.0
311720;201803;39;28;11;26712.0;10494.0;37206.0
311730;201803;549;362;187;344776.0;178398.0;523174.0
311740;201803;39;28;11;26712.0;10494.0;37206.0
311750;201803;702;479;223;455058.8;212742.0;667800.8
311760;201803;65;36;29;34344.0;27666.0;62010.0
311770;201803;404;192;212;181260.62;202248.0;383508.62
311780;201803;169;95;74;90344.0;70279.0;160623.0
311783;201803;80;71;9;67734.0;8586.0;76320.0
311787;201803;35;15;20;14310.0;19080.0;33390.0
311790;201803;260;124;136;118296.0;129744.0;248040.0
311800;201803;642;434;208;410650.3;197764.2;608414.5
311810;201803;43;35;8;33390.0;7632.0;41022.0
311820;201803;109;91;18;86814.0;17172.0;103986.0
311830;201803;1882;1200;682;1139192.5;647003.6;1786196.1
311840;201803;1013;563;450;532810.9;427831.53;960642.44
311850;201803;8;5;3;4770.0;2862.0;7632.0
311860;201803;9477;4321;5156;4105915.2;4910336.0;9016251.0
311870;201803;149;83;66;79182.0;62964.0;142146.0
311880;201803;945;703;242;669126.8;230868.0;899994.8
311890;201803;218;111;107;105894.0;102078.0;207972.0
311900;201803;88;36;52;34344.0;49608.0;83952.0
311910;201803;1386;858;528;815336.9;501613.4;1316950.2
311920;201803;228;150;78;142862.0;74412.0;217274.0
311930;201803;908;524;384;499227.84;366098.0;865325.9
311940;201803;2451;1269;1182;1208289.8;1124384.4;2332674.0
311950;201803;34;24;10;22896.0;9540.0;32436.0
311960;201803;65;46;19;43884.0;18126.0;62010.0
311970;201803;26;17;9;13928.4;8586.0;22514.4
311980;201803;41;31;10;29574.0;9540.0;39114.0
311990;201803;58;41;17;39114.0;16218.0;55332.0
311995;201803;63;44;19;41976.0;18126.0;60102.0
312000;201803;34;24;10;22609.8;9540.0;32149.8
312010;201803;82;59;23;56286.0;21942.0;78228.0
312015;201803;97;72;25;68402.0;23850.0;92252.0
312020;201803;138;85;53;81090.0;50275.8;131365.8
312030;201803;42;34;8;31483.0;7632.0;39115.0
312040;201803;79;50;29;47700.0;27666.0;75366.0
312050;201803;223;116;107;110664.0;102078.0;212742.0
312060;201803;68;41;27;39114.0;25090.2;64204.2
312070;201803;73;45;28;42930.0;26712.0;69642.0
312080;201803;532;239;293;228006.0;279522.0;507528.0
312083;201803;49;36;13;34344.0;12402.0;46746.0
312087;201803;108;86;22;82044.0;20988.0;103032.0
312090;201803;2869;1637;1232;1547414.2;1171946.2;2719360.5
312100;201803;160;113;47;107802.0;44056.0;151858.0
312110;201803;117;74;43;70596.0;41022.0;111618.0
312120;201803;140;105;35;98930.0;33390.0;132320.0
312125;201803;95;54;41;51325.2;39114.0;90439.2
312130;201803;121;81;40;77274.0;38160.0;115434.0
312140;201803;135;106;29;101124.0;27666.0;128790.0
312150;201803;47;36;11;34344.0;10494.0;44838.0
312160;201803;1523;1014;509;964399.0;484174.47;1448573.5
312170;201803;11;9;2;8586.0;1908.0;10494.0
312180;201803;98;60;38;56525.0;35966.0;92491.0
312190;201803;31;27;4;25758.0;3816.0;29574.0
312200;201803;736;636;100;604788.7;95400.0;700188.7
312210;201803;98;62;36;59148.0;34344.0;93492.0
312220;201803;122;89;33;84668.0;31482.0;116150.0
312230;201803;3490;1704;1786;1622498.0;1702226.6;3324724.5
312235;201803;147;97;50;92538.0;47700.0;140238.0
312240;201803;109;71;38;67734.0;36252.0;103986.0
312245;201803;164;110;54;104936.0;51516.0;156452.0
312247;201803;58;41;17;38351.0;16218.0;54569.0
312250;201803;182;84;98;79659.0;93492.0;173151.0
312260;201803;104;68;36;64014.2;34344.0;98358.2
312270;201803;135;84;51;80136.0;48654.0;128790.0
312280;201803;25;15;10;14310.0;9540.0;23850.0
312290;201803;162;111;51;105607.8;47701.0;153308.8
312300;201803;202;135;67;128790.0;63918.0;192708.0
312310;201803;59;54;5;51516.0;4770.0;56286.0
312320;201803;419;261;158;247086.0;149444.5;396530.5
312330;201803;85;74;11;69833.0;10207.8;80040.8
312340;201803;36;17;19;16218.0;18126.0;34344.0
312350;201803;16;10;6;9540.0;5724.0;15264.0
312352;201803;96;65;31;62010.0;29574.0;91584.0
312360;201803;563;255;308;242316.0;293832.0;536148.0
312370;201803;298;178;120;169525.8;114480.0;284005.8
312380;201803;136;87;49;82998.0;46746.0;129744.0
312385;201803;176;142;34;135468.0;32436.0;167904.0
312390;201803;301;188;113;179352.0;107135.0;286487.0
312400;201803;383;290;93;276660.0;88246.0;364906.0
312410;201803;869;279;590;265689.0;562284.0;827973.0
312420;201803;610;486;124;462976.2;118296.0;581272.2
312430;201803;861;633;228;601594.06;216558.2;818152.25
312440;201803;45;34;11;32436.0;10494.0;42930.0
312450;201803;211;128;83;122112.0;79182.0;201294.0
312460;201803;58;29;29;27666.0;27666.0;55332.0
312470;201803;55;36;19;34344.0;18126.0;52470.0
312480;201803;209;128;81;122112.0;77274.0;199386.0
312490;201803;261;179;82;170766.0;78228.0;248994.0
312500;201803;32;18;14;17172.0;13356.0;30528.0
312510;201803;429;160;269;152640.0;256010.39;408650.38
312520;201803;41;14;27;13356.0;25758.0;39114.0
312530;201803;48;36;12;34344.0;11448.0;45792.0
312540;201803;100;87;13;82998.0;12402.0;95400.0
312550;201803;40;31;9;29574.0;8586.0;38160.0
312560;201803;199;145;54;138044.0;51229.8;189273.8
312570;201803;441;267;174;254050.2;165304.45;419354.66
312580;201803;85;45;40;42930.0;38160.0;81090.0
312590;201803;275;216;59;206064.0;56286.0;262350.0
312595;201803;144;129;15;123066.0;14310.0;137376.0
312600;201803;75;46;29;43455.0;27666.0;71121.0
312610;201803;1620;852;768;804988.0;730955.6;1535943.6
312620;201803;187;133;54;126882.0;51511.23;178393.23
312630;201803;64;55;9;52470.0;8586.0;61056.0
312640;201803;47;13;34;12402.0;32436.0;44838.0
312650;201803;147;120;27;114194.0;25472.0;139666.0
312660;201803;69;52;17;49322.0;16218.0;65540.0
312670;201803;865;568;297;540031.75;283124.3;823156.06
312675;201803;42;31;11;29574.0;10494.0;40068.0
312680;201803;84;58;26;54950.4;24804.0;79754.4
312690;201803;237;126;111;120194.46;105607.8;225802.27
312695;201803;31;24;7;22896.0;6678.0;29574.0
312700;201803;212;123;89;117342.0;84906.0;202248.0
312705;201803;76;62;14;59148.0;13356.0;72504.0
312707;201803;95;70;25;66360.44;23850.0;90210.44
312710;201803;1867;993;874;944975.4;833585.0;1778560.4
312720;201803;66;33;33;31482.0;31482.0;62964.0
312730;201803;289;169;120;160272.0;114193.8;274465.8
312733;201803;52;44;8;41690.0;7632.0;49322.0
312735;201803;22;16;6;15264.0;5724.0;20988.0
312737;201803;67;36;31;34344.0;29574.0;63918.0
312738;201803;53;38;15;36252.0;14310.0;50562.0
312740;201803;72;49;23;46746.0;21942.0;68688.0
312750;201803;72;52;20;49608.0;19080.0;68688.0
312760;201803;268;196;72;186984.0;68688.0;255672.0
312770;201803;7627;3528;4099;3342957.8;3901782.8;7244740.5
312780;201803;435;334;101;318349.8;96354.0;414703.8
312790;201803;20;15;5;14310.0;4770.0;19080.0
312800;201803;1590;1117;473;1058197.2;450059.62;1508256.9
312810;201803;368;237;131;225811.8;124974.0;350785.8
312820;201803;195;147;48;140238.0;45792.0;186030.0
312825;201803;26;18;8;17172.0;7632.0;24804.0
312830;201803;286;167;119;158079.0;112887.0;270966.0
312840;201803;149;109;40;103986.0;38160.0;142146.0
312850;201803;26;23;3;21942.0;2862.0;24804.0
312860;201803;170;105;65;99884.0;62010.0;161894.0
312870;201803;985;516;469;489335.2;447426.0;936761.2
312880;201803;150;104;46;99072.9;43788.6;142861.5
312890;201803;164;114;50;108756.0;47700.0;156456.0
312900;201803;209;155;54;147202.2;51516.0;198718.2
312910;201803;184;93;91;87553.72;86814.0;174367.72
312920;201803;155;85;70;81090.0;66780.0;147870.0
312930;201803;342;248;94;236592.0;89676.0;326268.0
312940;201803;105;71;34;67734.0;32436.0;100170.0
312950;201803;696;456;240;433688.6;228960.0;662648.6
312960;201803;174;132;42;125928.0;40068.0;165996.0
312965;201803;52;48;4;45792.0;3816.0;49608.0
312970;201803;285;232;53;220374.2;50562.0;270936.2
312980;201803;2314;1231;1083;1170169.4;1032319.4;2202488.8
312990;201803;51;29;22;27666.0;20988.0;48654.0
313000;201803;40;25;15;23850.0;14310.0;38160.0
313005;201803;166;127;39;120919.5;36920.0;157839.5
313010;201803;940;386;554;367003.8;528220.8;895224.6
313020;201803;188;99;89;93969.0;84906.0;178875.0
313030;201803;209;134;75;125929.0;71550.0;197479.0
313040;201803;61;23;38;21942.0;36252.0;58194.0
313050;201803;294;205;89;194616.2;84906.0;279522.2
313055;201803;46;34;12;32436.0;11448.0;43884.0
313060;201803;128;85;43;81090.0;40735.8;121825.8
313065;201803;59;38;21;36252.0;20034.0;56286.0
313070;201803;150;81;69;77274.0;65826.0;143100.0
313080;201803;41;17;24;16218.0;22896.0;39114.0
313090;201803;710;489;221;465218.3;210834.0;676052.3
313100;201803;164;65;99;62010.0;94438.0;156448.0
313110;201803;124;73;51;69642.0;48654.0;118296.0
313115;201803;158;86;72;81843.66;68688.0;150531.66
313120;201803;752;412;340;392762.0;323120.0;715882.0
313130;201803;5246;2824;2422;2668038.5;2302070.2;4970108.5
313140;201803;160;83;77;79182.0;73458.0;152640.0
313150;201803;315;251;64;239454.0;60769.8;300223.8
313160;201803;196;142;54;135468.0;51516.0;186984.0
313170;201803;1348;948;400;891314.44;381209.4;1272523.8
313180;201803;329;195;134;185381.28;127836.0;313217.28
313190;201803;727;433;294;410029.4;279713.0;689742.4
313200;201803;23;22;1;20988.0;954.0;21942.0
313210;201803;1038;874;164;830793.2;156451.23;987244.4
313220;201803;234;159;75;150732.0;70834.5;221566.5
313230;201803;268;199;69;188893.0;65826.0;254719.0
313240;201803;1920;1025;895;975266.75;850623.8;1825890.5
313250;201803;1249;924;325;875777.6;308143.8;1183921.4
313260;201803;92;54;38;51516.0;36252.0;87768.0
313270;201803;963;565;398;534955.3;379692.0;914647.3
313280;201803;61;52;9;49131.0;8586.0;57717.0
313290;201803;226;182;44;173342.0;41022.8;214364.8
313300;201803;369;186;183;175536.8;174582.0;350118.8
313310;201803;224;118;106;112572.0;101124.0;213696.0
313320;201803;367;284;83;268981.1;79182.0;348163.1
313330;201803;1364;820;544;780849.2;517784.5;1298633.8
313340;201803;336;231;105;220374.0;100170.0;320544.0
313350;201803;527;354;173;335808.1;165042.0;500850.1
313360;201803;116;68;48;64872.0;45506.0;110378.0
313370;201803;188;71;117;67734.0;111618.0;179352.0
313375;201803;275;164;111;156456.0;105894.0;262350.0
313380;201803;1297;660;637;627751.06;607408.0;1235159.1
313390;201803;48;40;8;37206.8;7632.0;44838.8
313400;201803;422;274;148;261396.0;140906.0;402302.0
313410;201803;20;11;9;10494.0;8586.0;19080.0
313420;201803;4690;2425;2265;2302739.8;2153838.0;4456578.0
313430;201803;136;62;74;59148.0;70596.0;129744.0
313440;201803;1463;983;480;935541.1;456776.0;1392317.1
313450;201803;61;24;37;22896.0;35011.8;57907.8
313460;201803;372;175;197;165510.0;187938.0;353448.0
313470;201803;535;244;291;232776.0;276946.2;509722.2
313480;201803;160;109;51;103033.0;48654.0;151687.0
313490;201803;514;252;262;240403.23;249901.0;490304.22
313500;201803;20;12;8;11448.0;7632.0;19080.0
313505;201803;966;750;216;714610.0;205778.0;920388.0
313507;201803;92;54;38;51516.0;36252.0;87768.0
313510;201803;2775;1775;1000;1687919.8;953046.0;2640965.8
313520;201803;3591;2801;790;2659610.8;753656.0;3413266.8
313530;201803;42;29;13;27666.0;12402.0;40068.0
313535;201803;106;84;22;79469.0;20988.0;100457.0
313540;201803;71;54;17;51516.0;16218.0;67734.0
313545;201803;110;90;20;85860.0;19080.0;104940.0
313550;201803;230;187;43;178398.0;40736.0;219134.0
313560;201803;330;172;158;164088.0;150732.0;314820.0
313570;201803;59;31;28;29574.0;26712.0;56286.0
313580;201803;1297;706;591;671139.0;562097.4;1233236.4
313590;201803;83;50;33;47700.0;31482.0;79182.0
313600;201803;687;409;278;389900.0;264354.0;654254.0
313610;201803;57;45;12;42310.8;11448.0;53758.8
313620;201803;1348;713;635;669643.1;601907.0;1271550.1
313630;201803;1636;1253;383;1192768.2;365096.0;1557864.2
313640;201803;128;74;54;70596.0;51516.0;122112.0
313650;201803;236;110;126;104940.0;120204.0;225144.0
313652;201803;17;16;1;15264.0;954.0;16218.0
313655;201803;55;31;24;29574.0;22896.0;52470.0
313657;201803;48;44;4;41976.0;3816.0;45792.0
313660;201803;132;93;39;88722.0;37206.0;125928.0
313665;201803;641;314;327;299556.0;311719.5;611275.5
313670;201803;10295;7122;3173;6769628.5;3026183.8;9795812.0
313680;201803;41;30;11;28620.0;10494.0;39114.0
313690;201803;155;118;37;112572.0;35298.0;147870.0
313695;201803;67;50;17;47700.0;16218.0;63918.0
313700;201803;294;237;57;225812.0;54378.0;280190.0
313710;201803;150;101;49;96354.0;46746.0;143100.0
313720;201803;1061;503;558;477381.8;530987.9;1008369.7
313730;201803;59;41;18;39114.0;17172.0;56286.0
313740;201803;165;132;33;125928.0;31482.0;157410.0
313750;201803;441;324;117;308809.8;111618.0;420427.8
313753;201803;238;169;69;160558.2;65826.0;226384.2
313760;201803;1239;451;788;430254.0;749015.5;1179269.5
313770;201803;357;255;102;243270.0;97308.0;340578.0
313780;201803;761;391;370;373014.0;352693.8;725707.8
313790;201803;27;26;1;24804.0;954.0;25758.0
313800;201803;145;89;56;84906.0;53424.0;138330.0
313810;201803;66;38;28;36252.0;26712.0;62964.0
313820;201803;1287;634;653;603882.2;621985.2;1225867.4
313830;201803;66;49;17;46746.0;16218.0;62964.0
313835;201803;55;48;7;45792.0;6678.0;52470.0
313840;201803;1682;1032;650;978901.5;618860.0;1597761.5
313850;201803;178;61;117;58194.0;111038.06;169232.06
313860;201803;487;380;107;359039.3;101124.1;460163.4
313862;201803;172;114;58;108756.0;55332.0;164088.0
313865;201803;85;67;18;63918.0;17172.0;81090.0
313867;201803;49;37;12;35298.0;11448.0;46746.0
313868;201803;27;18;9;16409.0;8586.0;24995.0
313870;201803;125;65;60;62010.0;56954.0;118964.0
313880;201803;348;223;125;212655.0;118677.8;331332.8
313890;201803;317;168;149;159509.8;141573.6;301083.4
313900;201803;915;494;421;469655.5;401587.0;871242.5
313910;201803;137;98;39;93492.0;36252.2;129744.2
313920;201803;610;433;177;412891.2;168858.0;581749.2
313925;201803;33;29;4;27666.0;3816.0;31482.0
313930;201803;800;614;186;585756.0;177421.0;763177.0
313940;201803;1780;1122;658;1066858.4;627064.4;1693922.8
313950;201803;940;603;337;573450.6;321211.8;894662.4
313960;201803;1379;793;586;752258.3;557804.0;1310062.2
313970;201803;121;82;39;78228.0;37206.0;115434.0
313980;201803;210;136;74;129506.0;70596.0;200102.0
313990;201803;365;217;148;206731.8;141112.81;347844.62
314000;201803;916;620;296;587999.9;282379.22;870379.1
314010;201803;76;49;27;46746.0;25519.5;72265.5
314015;201803;54;17;37;16218.0;35298.0;51516.0
314020;201803;49;34;15;32436.0;14214.6;46650.6
314030;201803;86;40;46;37997.82;43884.0;81881.82
314040;201803;43;30;13;28620.0;12402.0;41022.0
314050;201803;317;186;131;177158.0;123495.3;300653.3
314053;201803;103;68;35;63918.4;33390.0;97308.4
314055;201803;302;178;124;169812.0;118296.0;288108.0
314060;201803;142;120;22;113526.0;20988.0;134514.0
314070;201803;982;483;499;456977.12;475411.0;932388.1
314080;201803;219;143;76;135181.8;71454.88;206636.69
314085;201803;125;81;44;77274.0;41976.0;119250.0
314090;201803;352;253;99;241362.0;94441.23;335803.22
314100;201803;477;391;86;369199.0;81472.0;450671.0
314110;201803;688;371;317;352321.75;301702.6;654024.3
314120;201803;95;53;42;50562.0;40068.0;90630.0
314130;201803;25;12;13;11448.0;12402.0;23850.0
314140;201803;1089;655;434;621225.94;412128.66;1033354.56
314150;201803;162;103;59;98262.0;56286.0;154548.0
314160;201803;356;263;93;248040.8;88532.0;336572.8
314170;201803;70;52;18;49608.0;17172.0;66780.0
314180;201803;729;639;90;609320.0;84906.5;694226.5
314190;201803;104;60;44;57240.0;41976.0;99216.0
314200;201803;583;403;180;383191.6;170766.0;553957.6
314210;201803;280;209;71;198432.0;67448.0;265880.0
314220;201803;308;232;76;219421.0;72218.0;291639.0
314225;201803;64;44;20;41976.0;19080.0;61056.0
314230;201803;107;49;58;46746.0;55332.0;102078.0
314240;201803;139;106;33;101124.0;31482.0;132606.0
314250;201803;59;35;24;33390.0;22896.0;56286.0
314260;201803;187;95;92;90630.0;87768.0;178398.0
314270;201803;336;260;76;247277.0;72504.0;319781.0
314280;201803;684;381;303;363465.0;289062.0;652527.0
314290;201803;555;451;104;429014.5;98929.8;527944.3
314300;201803;414;295;119;278494.0;113479.0;391973.0
314310;201803;1451;976;475;929197.3;453129.97;1382327.2
314315;201803;36;29;7;27666.0;6678.0;34344.0
314320;201803;607;386;221;367671.8;209908.62;577580.44
314330;201803;10665;5377;5288;5118472.0;5040287.0;1,02E+14
314340;201803;568;265;303;252237.8;288490.0;540727.8
314345;201803;30;24;6;22896.0;5724.0;28620.0
314350;201803;190;117;73;111618.0;69642.0;181260.0
314360;201803;78;47;31;44838.0;29574.0;74412.0
314370;201803;56;46;10;43884.0;9540.0;53424.0
314380;201803;91;65;26;62010.0;24804.0;86814.0
314390;201803;3195;2014;1181;1917063.5;1123717.4;3040781.0
314400;201803;681;487;194;461728.2;185076.0;646804.2
314410;201803;429;276;153;263304.0;145962.0;409266.0
314420;201803;18;8;10;7632.0;9540.0;17172.0
314430;201803;2507;896;1611;851036.3;1534210.8;2385247.0
314435;201803;268;153;115;145675.8;108756.0;254431.8
314437;201803;27;21;6;20034.0;5724.0;25758.0
314440;201803;98;70;28;66780.0;26712.0;93492.0
314450;201803;153;117;36;111618.0;34344.0;145962.0
314460;201803;661;301;360;287154.0;343440.0;630594.0
314465;201803;82;55;27;52470.0;25758.0;78228.0
314467;201803;67;57;10;54369.0;9540.0;63909.0
314470;201803;387;199;188;186394.52;178398.5;364793.03
314480;201803;1052;506;546;482724.0;520693.2;1003417.2
314490;201803;88;67;21;63918.0;20034.0;83952.0
314500;201803;316;209;107;199386.0;102078.0;301464.0
314505;201803;126;81;45;77274.0;42930.0;120204.0
314510;201803;226;183;43;174563.0;41022.0;215585.0
314520;201803;1238;637;601;600452.7;571398.9;1171851.6
314530;201803;712;563;149;536616.0;142146.0;678762.0
314535;201803;210;133;77;125832.6;73207.01;199039.61
314537;201803;62;37;25;35298.0;23850.0;59148.0
314540;201803;14;9;5;8586.0;4770.0;13356.0
314545;201803;49;32;17;30528.0;16218.0;46746.0
314550;201803;80;43;37;41022.0;35298.0;76320.0
314560;201803;805;433;372;410888.0;354888.0;765776.0
314570;201803;22;17;5;16218.0;4770.0;20988.0
314580;201803;18;9;9;8586.0;8586.0;17172.0
314585;201803;20;14;6;13356.0;5724.0;19080.0
314587;201803;84;72;12;68688.0;11448.0;80136.0
314590;201803;559;412;147;393048.0;140238.0;533286.0
314600;201803;993;646;347;611887.7;329702.6;941590.3
314610;201803;946;519;427;492550.9;406213.2;898764.1
314620;201803;150;111;39;104367.6;37206.0;141573.6
314625;201803;96;71;25;67162.0;23850.0;91012.0
314630;201803;1235;635;600;604311.3;572113.8;1176425.1
314640;201803;90;58;32;55332.0;30241.8;85573.8
314650;201803;202;117;85;111045.6;80613.0;191658.6
314655;201803;66;51;15;48654.0;14310.0;62964.0
314660;201803;19;14;5;13356.0;4770.0;18126.0
314670;201803;187;147;40;139952.0;38160.0;178112.0
314675;201803;214;122;92;116388.0;87768.0;204156.0
314690;201803;533;298;235;284005.8;224190.0;508195.8
314700;201803;2423;1325;1098;1258089.5;1046304.9;2304394.5
314710;201803;1624;952;672;903250.9;640468.1;1543719.0
314720;201803;407;242;165;229465.62;157410.0;386875.62
314730;201803;511;274;237;259966.0;226089.0;486055.0
314740;201803;690;344;346;326506.5;330084.0;656590.5
314750;201803;22;19;3;18126.0;2862.0;20988.0
314760;201803;317;151;166;144054.0;158354.45;302408.47
314770;201803;120;82;38;78228.0;36252.0;114480.0
314780;201803;21;6;15;5724.0;14310.0;20034.0
314790;201803;2348;1467;881;1392781.8;839796.7;2232578.5
314795;201803;52;45;7;42692.0;6678.0;49370.0
314800;201803;2937;1722;1215;1637502.6;1156812.2;2794314.8
314810;201803;1508;838;670;797115.5;637559.0;1434674.5
314820;201803;92;51;41;48654.0;39114.0;87768.0
314830;201803;210;166;44;157648.5;41690.0;199338.5
314840;201803;81;47;34;44838.0;32436.0;77274.0
314850;201803;357;175;182;166950.0;173628.0;340578.0
314860;201803;707;529;178;502662.88;168285.7;670948.56
314870;201803;1462;747;715;711684.0;682110.0;1393794.0
314875;201803;58;50;8;47700.0;7632.0;55332.0
314880;201803;47;34;13;32436.0;12402.0;44838.0
314890;201803;53;31;22;29574.0;20988.0;50562.0
314900;201803;32;27;5;25758.0;4770.0;30528.0
314910;201803;256;173;83;164755.8;79182.0;243937.8
314915;201803;154;133;21;126644.0;20034.0;146678.0
314920;201803;123;76;47;72504.0;44551.8;117055.8
314930;201803;1037;528;509;502187.0;485299.8;987486.8
314940;201803;54;42;12;40068.0;11448.0;51516.0
314950;201803;37;26;11;24804.0;10494.0;35298.0
314960;201803;60;44;16;41976.0;15264.0;57240.0
314970;201803;137;69;68;65373.0;64872.0;130245.0
314980;201803;303;197;106;185696.1;100170.0;285866.1
314990;201803;467;259;208;247086.0;197526.5;444612.5
314995;201803;201;65;136;62010.0;129734.46;191744.45
315000;201803;88;71;17;67734.0;16218.0;83952.0
315010;201803;46;30;16;28620.0;15264.0;43884.0
315015;201803;171;139;32;131880.95;30528.0;162408.95
315020;201803;71;61;10;58194.0;9540.0;67734.0
315030;201803;117;88;29;82998.0;27666.0;110664.0
315040;201803;66;49;17;46746.0;16218.0;62964.0
315050;201803;201;120;81;114480.0;77274.0;191754.0
315053;201803;39;34;5;32436.0;4770.0;37206.0
315057;201803;97;80;17;75938.4;16218.0;92156.4
315060;201803;70;63;7;58195.16;6678.0;64873.16
315070;201803;103;57;46;54378.0;43884.0;98262.0
315080;201803;371;304;67;290016.0;63918.0;353934.0
315090;201803;106;63;43;60102.0;41022.0;101124.0
315100;201803;77;39;38;37206.0;36252.0;73458.0
315110;201803;292;162;130;153690.0;124020.0;277710.0
315120;201803;1655;840;815;797402.2;776556.0;1573958.2
315130;201803;341;247;94;235638.0;89676.0;325314.0
315140;201803;536;315;221;298888.2;210834.0;509722.2
315150;201803;983;463;520;440749.0;495794.0;936543.0
315160;201803;211;107;104;102078.0;99216.0;201294.0
315170;201803;343;223;120;211789.0;114193.8;325982.8
315180;201803;3206;1359;1847;1292942.2;1758844.2;3051786.5
315190;201803;313;177;136;168477.0;129744.0;298221.0
315200;201803;1181;673;508;640230.2;483773.4;1124003.6
315210;201803;1561;893;668;847821.9;634852.2;1482674.1
315213;201803;46;28;18;26712.0;17172.0;43884.0
315217;201803;204;162;42;154548.0;40068.0;194616.0
315220;201803;1522;1164;358;1109550.4;341436.6;1450987.0
315230;201803;167;123;44;117056.0;41976.0;159032.0
315240;201803;425;273;152;260442.0;143806.5;404248.5
315250;201803;2549;1262;1287;1203370.9;1226548.9;2429919.8
315260;201803;150;92;58;86432.4;55332.0;141764.4
315270;201803;130;88;42;83379.6;39342.96;122722.56
315280;201803;701;457;244;435597.0;232766.45;668363.44
315290;201803;203;119;84;113526.0;79182.49;192708.48
315300;201803;71;47;24;44838.0;22896.0;67734.0
315310;201803;64;58;6;55332.0;5724.0;61056.0
315320;201803;159;89;70;84906.0;66780.0;151686.0
315330;201803;55;47;8;44838.0;7632.0;52470.0
315340;201803;420;293;127;278339.6;121158.0;399497.6
315350;201803;150;87;63;82998.0;60102.0;143100.0
315360;201803;95;51;44;48654.0;41976.0;90630.0
315370;201803;55;33;22;31482.0;20844.9;52326.9
315380;201803;12;7;5;6678.0;4770.0;11448.0
315390;201803;57;13;44;12402.0;41976.0;54378.0
315400;201803;817;610;207;576216.5;196810.2;773026.7
315410;201803;351;214;137;203870.0;130412.0;334282.0
315415;201803;61;47;14;44838.0;13356.0;58194.0
315420;201803;206;156;50;147727.1;47700.0;195427.1
315430;201803;678;395;283;375876.2;269505.8;645382.0
315440;201803;83;57;26;54378.0;24804.0;79182.0
315445;201803;255;205;50;195255.19;47700.0;242955.19
315450;201803;178;134;44;127836.0;41976.0;169812.0
315460;201803;3377;1710;1667;1628279.4;1587877.1;3216156.5
315470;201803;44;22;22;20988.0;20988.0;41976.0
315480;201803;63;24;39;22896.0;37206.0;60102.0
315490;201803;619;382;237;362376.9;226098.0;588474.9
315500;201803;22;14;8;13356.0;7632.0;20988.0
315510;201803;150;99;51;94446.0;48654.0;143100.0
315520;201803;71;62;9;59148.0;8586.0;67734.0
315530;201803;52;28;24;26712.0;22896.0;49608.0
315540;201803;238;156;82;148824.0;78228.0;227052.0
315550;201803;175;139;36;132606.0;34344.0;166950.0
315560;201803;742;592;150;563428.8;143100.0;706528.8
315570;201803;321;168;153;157077.7;145962.0;303039.7
315580;201803;661;431;230;410507.0;219420.0;629927.0
315590;201803;209;107;102;102078.0;97308.0;199386.0
315600;201803;291;213;78;203202.0;74222.0;277424.0
315610;201803;97;47;50;44838.0;47700.0;92538.0
315620;201803;34;27;7;25758.0;6678.0;32436.0
315630;201803;141;93;48;88722.0;45792.0;134514.0
315640;201803;61;36;25;34344.0;23850.0;58194.0
315645;201803;62;45;17;42930.0;15741.0;58671.0
315650;201803;167;121;46;115148.0;43884.0;159032.0
315660;201803;477;204;273;194616.0;260442.0;455058.0
315670;201803;2361;1193;1168;1135337.4;1113099.6;2248437.0
315680;201803;859;578;281;547978.4;267348.97;815327.4
315690;201803;690;471;219;448259.66;208926.0;657185.7
315700;201803;1906;1008;898;957760.4;856692.0;1814452.4
315710;201803;327;87;240;82998.0;228960.0;311958.0
315720;201803;433;278;155;265212.0;147870.0;413082.0
315725;201803;202;161;41;153594.0;39114.0;192708.0
315727;201803;43;22;21;20988.0;20034.0;41022.0
315730;201803;42;40;2;38160.0;1908.0;40068.0
315733;201803;88;58;30;55332.0;28620.0;83952.0
315737;201803;51;38;13;36252.0;12402.0;48654.0
315740;201803;45;40;5;38160.0;4770.0;42930.0
315750;201803;159;125;34;119250.0;32436.0;151686.0
315760;201803;47;32;15;30528.0;14310.0;44838.0
315765;201803;117;77;40;73458.0;38160.0;111618.0
315770;201803;228;137;91;130698.0;86528.0;217226.0
315780;201803;3285;1706;1579;1621085.5;1503982.6;3125068.0
315790;201803;211;162;49;154548.0;46173.6;200721.6
315800;201803;281;203;78;193662.0;74412.0;268074.0
315810;201803;96;56;40;53424.0;37874.0;91298.0
315820;201803;793;572;221;543399.3;210834.0;754233.3
315830;201803;143;82;61;78228.0;58194.0;136422.0
315840;201803;92;64;28;61056.0;26712.0;87768.0
315850;201803;260;192;68;183168.0;64872.0;248040.0
315860;201803;12;4;8;3816.0;7632.0;11448.0
315870;201803;35;27;8;25758.0;7632.0;33390.0
315880;201803;104;67;37;63918.0;35298.0;99216.0
315890;201803;79;61;18;58194.0;17172.0;75366.0
315895;201803;445;295;150;280381.0;142528.0;422909.0
315900;201803;70;34;36;32436.0;34344.0;66780.0
315910;201803;36;23;13;21703.5;12402.0;34105.5
315920;201803;184;120;64;114480.0;60102.9;174582.9
315930;201803;40;14;26;13356.0;24804.0;38160.0
315935;201803;149;117;32;111618.0;30519.0;142137.0
315940;201803;91;68;23;64872.0;21942.0;86814.0
315950;201803;63;45;18;42930.0;17172.0;60102.0
315960;201803;557;259;298;245817.58;283719.8;529537.4
315970;201803;38;29;9;27666.0;8586.0;36252.0
315980;201803;695;326;369;308481.0;352016.47;660497.44
315990;201803;255;150;105;142862.0;99875.0;242737.0
316000;201803;51;33;18;31482.0;16886.0;48368.0
316010;201803;75;63;12;60102.0;11448.0;71550.0
316020;201803;109;89;20;84906.0;19080.0;103986.0
316030;201803;402;211;191;201294.0;181690.0;382984.0
316040;201803;504;221;283;209880.2;269696.0;479576.2
316045;201803;58;52;6;49608.0;5724.0;55332.0
316050;201803;16;14;2;13356.0;1908.0;15264.0
316060;201803;95;61;34;58194.0;32436.0;90630.0
316070;201803;1045;676;369;638425.5;351263.0;989688.5
316080;201803;102;62;40;59148.0;38160.0;97308.0
316090;201803;43;25;18;23182.2;17172.0;40354.2
316095;201803;70;58;12;55056.0;11448.0;66504.0
316100;201803;307;179;128;169955.3;122112.0;292067.3
316105;201803;35;24;11;22896.0;10494.0;33390.0
316110;201803;1917;1543;374;1461140.4;356128.2;1817268.5
316120;201803;82;61;21;58194.0;19747.8;77941.8
316130;201803;139;107;32;101411.0;30528.0;131939.0
316140;201803;27;20;7;19080.0;6678.0;25758.0
316150;201803;204;142;62;134752.5;59148.0;193900.5
316160;201803;85;51;34;48654.0;32436.0;81090.0
316165;201803;64;47;17;44648.0;15502.5;60150.5
316170;201803;204;137;67;129744.0;63918.0;193662.0
316180;201803;199;89;110;84572.1;104940.0;189512.1
316190;201803;140;100;40;94446.0;38160.0;132606.0
316200;201803;702;392;310;373968.0;295167.6;669135.6
316210;201803;759;507;252;483332.34;240408.0;723740.3
316220;201803;117;79;38;75366.0;36252.0;111618.0
316225;201803;23;14;9;13356.0;8586.0;21942.0
316230;201803;32;19;13;18126.0;12402.0;30528.0
316240;201803;617;501;116;477000.2;110664.0;587664.2
316245;201803;104;87;17;82998.0;16218.0;99216.0
316250;201803;1518;1057;461;1000728.5;438432.03;1439160.5
316255;201803;110;90;20;85478.4;19080.0;104558.4
316257;201803;183;96;87;91584.0;82711.8;174295.8
316260;201803;242;162;80;153251.06;76225.0;229476.06
316265;201803;26;17;9;16218.0;8586.0;24804.0
316270;201803;680;472;208;447521.6;198432.0;645953.6
316280;201803;546;341;205;323756.8;194902.6;518659.4
316290;201803;699;473;226;448380.97;215604.0;663985.0
316292;201803;502;201;301;191754.0;286916.0;478670.0
316294;201803;101;59;42;56286.0;40068.0;96354.0
316295;201803;284;126;158;118279.0;150732.0;269011.0
316300;201803;103;72;31;68688.0;29574.0;98262.0
316310;201803;35;18;17;17172.0;16218.0;33390.0
316320;201803;41;25;16;23850.0;15264.0;39114.0
316330;201803;131;85;46;80136.5;43597.8;123734.3
316340;201803;140;93;47;88722.0;44838.0;133560.0
316350;201803;193;139;54;132440.0;51516.0;183956.0
316360;201803;22;17;5;16218.0;4770.0;20988.0
316370;201803;1072;571;501;540938.5;477658.25;1018596.75
316380;201803;120;90;30;85860.0;28620.0;114480.0
316390;201803;122;87;35;82998.0;33390.0;116388.0
316400;201803;137;103;34;98262.0;32436.0;130698.0
316410;201803;302;221;81;209450.7;77274.0;286724.7
316420;201803;203;144;59;136660.5;56286.0;192946.5
316430;201803;160;82;78;78228.0;74412.0;152640.0
316440;201803;98;47;51;44838.0;48654.0;93492.0
316443;201803;38;35;3;33390.0;2862.0;36252.0
316447;201803;64;50;14;47700.0;13356.0;61056.0
316450;201803;219;165;54;157410.0;51516.0;208926.0
316460;201803;68;28;40;26712.0;38160.0;64872.0
316470;201803;1607;1158;449;1097026.5;426225.16;1523251.6
316480;201803;13;10;3;9540.0;2862.0;12402.0
316490;201803;18;7;11;6678.0;10494.0;17172.0
316500;201803;152;101;51;96067.8;48654.0;144721.8
316510;201803;167;124;43;117294.3;41022.0;158316.3
316520;201803;191;117;74;111045.6;70596.0;181641.6
316530;201803;158;114;44;108756.0;41689.8;150445.8
316540;201803;143;79;64;75366.0;61056.0;136422.0
316550;201803;139;99;40;94446.0;38160.0;132606.0
316553;201803;241;116;125;110155.33;119250.0;229405.33
316555;201803;33;25;8;23850.0;7632.0;31482.0
316556;201803;10;7;3;6678.0;2862.0;9540.0
316557;201803;18;14;4;13356.0;3816.0;17172.0
316560;201803;60;46;14;43884.0;13356.0;57240.0
316570;201803;244;222;22;211550.0;20988.0;232538.0
316580;201803;21;15;6;14310.0;5724.0;20034.0
316590;201803;113;97;16;92538.0;15264.0;107802.0
316600;201803;181;147;34;139952.0;32436.0;172388.0
316610;201803;66;47;19;44551.8;18126.0;62677.8
316620;201803;134;103;31;98262.0;29574.0;127836.0
316630;201803;38;28;10;26712.0;9540.0;36252.0
316640;201803;16;10;6;9540.0;5724.0;15264.0
316650;201803;66;50;16;47700.0;15264.0;62964.0
316660;201803;7;4;3;3816.0;2862.0;6678.0
316670;201803;438;156;282;148805.0;268455.8;417260.8
316680;201803;162;111;51;105894.0;48464.0;154358.0
316690;201803;193;122;71;116388.0;67734.0;184122.0
316695;201803;62;55;7;52470.0;6678.0;59148.0
316700;201803;14;7;7;6678.0;6678.0;13356.0
316710;201803;711;517;194;492980.0;185076.0;678056.0
316720;201803;4879;2485;2394;2356197.0;2278160.0;4634357.0
316730;201803;15;14;1;13356.0;954.0;14310.0
316740;201803;133;84;49;80136.0;46746.0;126882.0
316750;201803;19;13;6;12402.0;5724.0;18126.0
316760;201803;323;260;63;248040.0;60102.0;308142.0
316770;201803;141;81;60;77274.0;57240.0;134514.0
316780;201803;72;42;30;39762.72;28620.0;68382.72
316790;201803;57;44;13;41976.0;12402.0;54378.0
316800;201803;1804;1107;697;1054074.8;663222.2;1717297.0
316805;201803;19;10;9;9540.0;8586.0;18126.0
316810;201803;66;43;23;41022.0;21656.0;62678.0
316820;201803;38;19;19;18126.0;18126.0;36252.0
316830;201803;90;39;51;37206.0;47414.0;84620.0
316840;201803;505;306;199;291161.0;187938.0;479099.0
316850;201803;347;225;122;213266.7;116388.0;329654.7
316860;201803;5988;2651;3337;2514324.5;3179721.0;5694045.5
316870;201803;1453;942;511;890363.7;482726.0;1373089.8
316880;201803;116;65;51;61723.8;48654.0;110377.8
316890;201803;255;170;85;162133.0;81090.0;243223.0
316900;201803;414;283;131;267435.28;124974.0;392409.28
316905;201803;16;9;7;8586.0;6678.0;15264.0
316910;201803;50;26;24;24804.0;22896.0;47700.0
316920;201803;135;104;31;98501.0;29574.0;128075.0
316930;201803;1926;979;947;928196.3;901239.94;1829436.2
316935;201803;860;519;341;492885.72;324360.0;817245.75
316940;201803;1102;635;467;604836.4;444936.25;1049772.6
316950;201803;185;96;89;91584.0;84906.0;176490.0
316960;201803;1104;613;491;583466.8;468118.47;1051585.2
316970;201803;637;497;140;474138.0;133560.0;607698.0
316980;201803;111;67;44;63918.0;41966.46;105884.46
316990;201803;2174;1428;746;1354920.1;710005.94;2064926.1
317000;201803;328;255;73;242984.0;69642.0;312626.0
317005;201803;246;174;72;165996.0;68688.0;234684.0
317010;201803;6255;3439;2816;3260721.2;2684556.2;5945277.5
317020;201803;16164;7144;9020;6783367.0;8587948.0;1,54E+14
317030;201803;85;33;52;31482.0;49391.26;80873.26
317040;201803;3129;1945;1184;1852878.9;1126484.6;2979363.5
317043;201803;71;51;20;48654.0;19080.0;67734.0
317047;201803;37;18;19;17172.0;18122.0;35294.0
317050;201803;179;132;47;125928.0;44838.0;170766.0
317052;201803;127;97;30;92538.0;28620.0;121158.0
317057;201803;204;152;52;145008.0;49036.0;194044.0
317060;201803;55;36;19;34344.0;17839.8;52183.8
317065;201803;60;48;12;45792.0;11448.0;57240.0
317070;201803;1966;932;1034;884359.7;985291.6;1869651.2
317075;201803;107;55;52;52470.0;49608.0;102078.0
317080;201803;824;430;394;409122.9;375686.0;784808.9
317090;201803;630;504;126;478479.5;120204.0;598683.5
317100;201803;410;304;106;288108.2;101124.0;389232.2
317103;201803;109;95;14;90630.0;13356.0;103986.0
317107;201803;36;32;4;30528.0;3816.0;34344.0
317110;201803;100;42;58;40068.0;55332.0;95400.0
317115;201803;40;34;6;32436.0;5724.0;38160.0
317120;201803;1817;914;903;864052.6;861005.0;1725057.6
317130;201803;1909;1225;684;1165701.4;651869.0;1817570.4
317140;201803;9;7;2;6678.0;1908.0;8586.0
317150;201803;269;162;107;154548.0;101314.8;255862.8
317160;201803;317;229;88;218149.0;83666.0;301815.0
317170;201803;204;141;63;134514.0;60102.0;194616.0
317180;201803;430;309;121;294070.5;115434.0;409504.5
317190;201803;253;172;81;164088.0;76987.8;241075.8
317200;201803;805;565;240;526618.0;228722.0;755340.0
317210;201803;154;88;66;82998.2;62964.0;145962.2
317220;201803;20;13;7;12402.0;6678.0;19080.0
320010;201803;619;461;158;436456.5;150732.0;587188.5
320013;201803;133;99;34;94446.0;32436.0;126882.0
320016;201803;279;178;101;169812.0;96354.0;266166.0
320020;201803;714;427;287;404808.75;271890.3;676699.06
320030;201803;151;113;38;107802.0;35918.1;143720.1
320035;201803;137;100;37;95400.0;35298.0;130698.0
320040;201803;500;260;240;247468.0;228960.0;476428.0
320050;201803;114;87;27;82998.0;25758.0;108756.0
320060;201803;1541;726;815;692557.0;776833.6;1469390.6
320070;201803;103;72;31;68688.0;29574.0;98262.0
320080;201803;759;434;325;411205.0;310050.0;721255.0
320090;201803;1201;836;365;794190.9;347351.6;1141542.5
320100;201803;314;178;136;169812.0;129744.0;299556.0
320110;201803;139;89;50;83046.2;47700.0;130746.2
320115;201803;112;92;20;87768.0;19080.0;106848.0
320120;201803;3280;1832;1448;1736059.8;1379714.6;3115774.5
320130;201803;7338;3509;3829;3326197.8;3645044.8;6971242.5
320140;201803;412;267;145;253383.2;138086.0;391469.2
320150;201803;1889;1107;782;1048479.94;746018.44;1794498.4
320160;201803;690;312;378;295635.84;359259.28;654895.1
320170;201803;112;87;25;82235.0;23850.0;106085.0
320180;201803;52;30;22;28620.0;20988.0;49608.0
320190;201803;233;157;76;149005.27;72218.0;221223.27
320200;201803;54;41;13;39114.0;12402.0;51516.0
320210;201803;840;475;365;451338.6;347238.0;798576.6
320220;201803;306;112;194;106848.0;184790.0;291638.0
320225;201803;75;61;14;58194.0;13356.0;71550.0
320230;201803;550;353;197;335178.4;187128.0;522306.4
320240;201803;3129;1577;1552;1501978.8;1477941.8;2979920.5
320245;201803;451;315;136;299365.4;129744.0;429109.4
320250;201803;229;120;109;113526.6;103986.0;217512.6
320255;201803;143;114;29;107449.02;27523.0;134972.02
320260;201803;178;125;53;119250.0;50514.3;169764.3
320265;201803;158;127;31;120348.0;29574.0;149922.0
320270;201803;151;124;27;118296.0;25758.0;144054.0
320280;201803;954;572;382;540728.2;363312.03;904040.25
320290;201803;65;55;10;52470.0;9540.0;62010.0
320300;201803;537;383;154;363923.3;145867.1;509790.4
320305;201803;665;362;303;345348.0;288872.0;634220.0
320310;201803;210;119;91;111571.5;86058.0;197629.5
320313;201803;305;153;152;145962.0;144722.0;290684.0
320316;201803;108;89;19;84906.0;18126.0;103032.0
320320;201803;3307;1509;1798;1433902.0;1712303.0;3146205.0
320330;201803;258;190;68;180597.3;62964.8;243562.1
320332;201803;882;531;351;504717.6;333805.3;838522.9
320334;201803;235;143;92;136136.0;87768.0;223904.0
320335;201803;145;104;41;98023.9;39114.0;137137.9
320340;201803;588;406;182;386180.0;172961.0;559141.0
320350;201803;962;410;552;388660.88;526082.5;914743.4
320360;201803;165;92;73;87482.0;69642.0;157124.0
320370;201803;241;185;56;174798.0;52391.0;227189.0
320380;201803;284;191;93;180435.75;88722.0;269157.75
320390;201803;1112;682;430;649064.0;409600.12;1058664.1
320400;201803;318;229;89;217513.0;84906.0;302419.0
320405;201803;891;381;510;362897.6;486227.9;849125.5
320410;201803;968;494;474;469587.4;451825.34;921412.75
320420;201803;479;246;233;234207.4;222282.0;456489.4
320425;201803;193;105;88;100170.0;83952.0;184122.0
320430;201803;389;221;168;209212.7;160272.0;369484.7
320435;201803;167;112;55;106027.56;52470.0;158497.56
320440;201803;200;121;79;115147.8;75366.0;190513.8
320450;201803;129;76;53;72504.0;50562.0;123066.0
320455;201803;244;198;46;187939.0;43884.0;231823.0
320460;201803;239;152;87;145008.0;82998.0;228006.0
320465;201803;114;77;37;73095.48;35298.0;108393.48
320470;201803;633;404;229;385112.25;218462.0;603574.25
320480;201803;177;118;59;111761.1;56286.0;168047.1
320490;201803;3002;1501;1501;1428594.2;1430009.9;2858604.2
320495;201803;91;57;34;54359.0;32436.0;86795.0
320500;201803;9417;4761;4656;4514678.0;4429423.5;8944102.0
320501;201803;545;276;269;263304.0;256626.0;519930.0
320503;201803;280;202;78;191754.2;74412.0;266166.2
320506;201803;254;194;60;185076.0;57240.0;242316.0
320510;201803;934;443;491;419713.3;466888.1;886601.4
320515;201803;79;66;13;62010.9;12402.0;74412.9
320517;201803;204;144;60;137376.0;57240.0;194616.0
320520;201803;6798;3046;3752;2891857.5;3571073.2;6462930.5
320530;201803;5256;2638;2618;2507919.0;2494322.2;5002241.0
330010;201803;3067;1583;1484;1502522.5;1412938.4;2915461.0
330015;201803;157;63;94;58958.08;89676.0;148634.08
330020;201803;3576;1561;2015;1485952.9;1921738.0;3407690.8
330022;201803;219;122;97;115673.0;91584.8;207257.8
330023;201803;524;183;341;173103.8;325314.0;498417.8
330025;201803;546;120;426;114480.0;405831.8;520311.8
330030;201803;1916;1221;695;1156493.1;659761.7;1816254.9
330040;201803;2331;1192;1139;1135308.1;1085272.0;2220580.0
330045;201803;8287;2614;5673;2485628.8;5405853.0;7891482.0
330050;201803;803;508;295;484632.0;281430.0;766062.0
330060;201803;882;552;330;522793.9;314171.28;836965.2
330070;201803;3433;1312;2121;1245691.5;2022119.5;3267811.0
330080;201803;1499;701;798;663491.3;760052.4;1423543.8
330090;201803;350;212;138;202248.0;131652.0;333900.0
330093;201803;289;129;160;123066.0;152604.0;275670.0
330095;201803;101;53;48;49894.2;45792.0;95686.2
330100;201803;9474;4889;4585;4654539.0;4370513.0;9025052.0
330110;201803;475;210;265;199624.5;252810.0;452434.5
330115;201803;526;309;217;294786.0;207018.0;501804.0
330120;201803;377;196;181;185839.2;171910.8;357750.0
330130;201803;1525;424;1101;403770.97;1050336.0;1454107.0
330140;201803;600;315;285;300492.0;270937.0;571429.0
330150;201803;447;266;181;251856.0;171720.0;423576.0
330160;201803;208;129;79;123066.0;75366.0;198432.0
330170;201803;26666;9416;17250;8961351.0;1,64E+14;2,54E+14
330180;201803;237;151;86;141507.02;81328.5;222835.52
330185;201803;799;331;468;314238.8;445204.8;759443.6
330187;201803;292;92;200;87768.0;190800.0;278568.0
330190;201803;5542;2220;3322;2109138.0;3165892.8;5275030.5
330200;201803;4474;1529;2945;1454680.6;2804563.8;4259244.5
330205;201803;392;243;149;231392.7;141860.0;373252.7
330210;201803;1006;615;391;581467.6;371344.9;952812.5
330220;201803;2524;1512;1012;1439062.5;964494.2;2403556.8
330225;201803;554;309;245;294147.0;233062.2;527209.2
330227;201803;2466;782;1684;742870.44;1606180.2;2349050.8
330230;201803;201;121;80;114767.0;76320.0;191087.0
330240;201803;3626;1892;1734;1800391.2;1650933.5;3451324.8
330245;201803;153;65;88;62010.0;83188.8;145198.8
330250;201803;6475;3376;3099;3209881.5;2947493.2;6157375.0
330260;201803;566;166;400;158364.0;381600.0;539964.0
330270;201803;3337;1244;2093;1185919.0;1996151.2;3182070.2
330280;201803;438;281;157;266282.1;149769.0;416051.1
330285;201803;7003;2317;4686;2206396.5;4468260.5;6674657.0
330290;201803;565;218;347;207972.0;331038.0;539010.0
330300;201803;759;510;249;482724.7;237528.0;720252.7
330310;201803;411;238;173;225144.7;165042.0;390186.7
330320;201803;8051;3046;5005;2898159.8;4769262.0;7667421.5
330330;201803;9259;3630;5629;3456412.2;5365375.0;8821787.0
330340;201803;2640;1577;1063;1502255.0;1014082.94;2516338.0
330350;201803;17880;7074;10806;6723233.0;1,03E+14;1,70E+13
330360;201803;2558;1269;1289;1209653.2;1229697.0;2439350.2
330370;201803;979;542;437;516114.8;414895.6;931010.4
330380;201803;852;371;481;353208.97;458254.8;811463.75
330385;201803;599;315;284;299557.0;270936.0;570493.0
330390;201803;5162;2872;2290;2726250.5;2182098.5;4908349.0
330395;201803;251;156;95;147107.1;88865.2;235972.3
330400;201803;674;348;326;328558.6;309105.1;637663.7
330410;201803;501;356;145;337956.0;137840.33;475796.34
330411;201803;232;132;100;125747.0;95352.3;221099.3
330412;201803;253;106;147;100838.0;140238.0;241076.0
330414;201803;6157;2502;3655;2383800.0;3484896.2;5868696.5
330415;201803;573;270;303;256626.0;288108.8;544734.8
330420;201803;2283;1208;1075;1149447.6;1022871.0;2172318.5
330430;201803;1795;827;968;786860.0;921469.8;1708329.8
330440;201803;264;121;143;115434.0;136422.0;251856.0
330450;201803;121;51;70;48654.0;66780.0;115434.0
330452;201803;1715;803;912;764348.2;869725.75;1634074.0
330455;201803;110584;39559;71025;3,77E+14;6,77E+13;1,05E+16
330460;201803;263;107;156;102078.0;148824.0;250902.0
330470;201803;1237;679;558;641473.0;532322.44;1173795.5
330475;201803;1403;378;1025;358648.38;977277.6;1335926.0
330480;201803;744;398;346;379024.2;329130.8;708155.0
330490;201803;13586;4764;8822;4538074.5;8408901.0;1,29E+14
330500;201803;1343;618;725;589428.9;691269.0;1280697.9
330510;201803;11182;3746;7436;3566006.5;7087253.5;1,07E+13
330513;201803;104;51;53;48654.0;50562.0;99216.0
330515;201803;857;358;499;337507.8;475665.0;813172.8
330520;201803;2481;933;1548;889863.0;1476648.9;2366512.0
330530;201803;226;118;108;112572.0;102842.0;215414.0
330540;201803;352;175;177;166950.0;168381.0;335331.0
330550;201803;3060;1089;1971;1036416.2;1878044.8;2914461.0
330555;201803;760;281;479;268055.0;456012.8;724067.8
330560;201803;550;205;345;195570.0;329112.0;524682.0
330570;201803;253;175;78;166950.0;74412.0;241362.0
330575;201803;806;330;476;314582.0;452049.5;766631.5
330580;201803;3356;1881;1475;1788507.0;1405385.8;3193892.8
330590;201803;307;153;154;145962.0;146916.0;292878.0
330600;201803;1096;704;392;669479.25;372280.38;1041759.6
330610;201803;1523;842;681;796115.5;645525.9;1441641.4
330615;201803;190;142;48;135468.0;45792.0;181260.0
330620;201803;971;443;528;420239.4;502281.8;922521.2
330630;201803;3832;2433;1399;2305828.2;1327214.4;3633042.8
350010;201803;589;383;206;364098.75;196524.0;560622.75
350020;201803;41;21;20;20034.0;19080.0;39114.0
350030;201803;526;341;185;324170.0;175300.66;499470.66
350040;201803;127;49;78;46402.56;74412.0;120814.56
350050;201803;290;159;131;151686.0;124717.46;276403.47
350055;201803;85;47;38;44838.0;36252.0;81090.0
350060;201803;74;28;46;26712.0;43884.0;70596.0
350070;201803;801;470;331;444099.6;314107.56;758207.1
350075;201803;66;44;22;41976.0;20988.0;62964.0
350080;201803;51;32;19;29891.96;18126.0;48017.96
350090;201803;97;54;43;51516.0;41017.23;92533.23
350100;201803;293;184;109;174820.5;103986.0;278806.5
350110;201803;59;36;23;34344.0;21942.0;56286.0
350115;201803;154;94;60;89008.2;57240.0;146248.2
350120;201803;113;76;37;72504.0;35298.0;107802.0
350130;201803;357;175;182;166378.0;173628.0;340006.0
350140;201803;35;21;14;19271.0;13356.0;32627.0
350150;201803;71;57;14;54378.0;13356.0;67734.0
350160;201803;2490;965;1525;917541.2;1453508.6;2371049.8
350170;201803;398;241;157;228006.2;149492.0;377498.2
350180;201803;184;96;88;91584.0;83952.0;175536.0
350190;201803;973;501;472;475666.62;449987.5;925654.1
350200;201803;70;26;44;24804.0;41711.08;66515.08
350210;201803;1355;766;589;723063.3;561388.7;1284452.0
350220;201803;667;574;93;543458.75;88722.0;632180.75
350230;201803;80;56;24;53424.0;22896.0;76320.0
350240;201803;63;48;15;45792.0;14310.0;60102.0
350250;201803;1216;610;606;576217.6;577590.06;1153807.6
350260;201803;93;66;27;62964.0;25758.0;88722.0
350270;201803;829;541;288;515037.0;273302.9;788339.94
350275;201803;298;116;182;110283.0;173628.0;283911.0
350280;201803;4709;2404;2305;2281542.2;2196815.5;4478357.5
350290;201803;402;190;212;180969.23;201675.8;382645.03
350300;201803;46;25;21;23850.0;20034.0;43884.0
350310;201803;97;69;28;65730.0;26712.0;92442.0
350315;201803;38;23;15;21942.0;14310.0;36252.0
350320;201803;3255;1614;1641;1534940.5;1564733.8;3099674.2
350330;201803;1676;889;787;844005.94;749494.06;1593500.0
350335;201803;21;13;8;12402.0;7632.0;20034.0
350340;201803;132;63;69;60102.0;64872.9;124974.9
350350;201803;96;47;49;44838.0;46746.0;91584.0
350360;201803;130;88;42;83948.0;40068.0;124016.0
350370;201803;96;56;40;52787.96;38150.46;90938.42
350380;201803;740;313;427;297934.2;406594.8;704529.0
350390;201803;1421;577;844;549662.4;804031.4;1353693.8
350395;201803;25;20;5;19080.0;4770.0;23850.0
350400;201803;1698;908;790;856626.0;750108.2;1606734.1
350410;201803;2242;1004;1238;954726.94;1180129.0;2134856.0
350420;201803;231;142;89;134865.0;84906.0;219771.0
350430;201803;73;43;30;40450.0;28620.0;69070.0
350440;201803;152;112;40;105846.5;38160.0;144006.5
350450;201803;1614;1000;614;946780.94;585661.0;1532442.0
350460;201803;336;122;214;116388.0;203869.8;320257.8
350470;201803;14;10;4;9540.0;3816.0;13356.0
350480;201803;157;87;70;82998.0;66780.0;149778.0
350490;201803;242;120;122;113526.8;116388.0;229914.8
350500;201803;37;18;19;17172.0;18126.0;35298.0
350510;201803;164;110;54;104940.0;51516.0;156456.0
350520;201803;452;214;238;200975.95;226415.95;427391.9
350530;201803;451;214;237;204156.0;226098.0;430254.0
350535;201803;66;51;15;48396.42;14310.0;62706.42
350540;201803;374;190;184;180446.05;175250.0;355696.03
350550;201803;2736;1607;1129;1525785.2;1075962.1;2601747.2
350560;201803;636;444;192;423571.22;182810.25;606381.5
350570;201803;4174;1738;2436;1652582.0;2321437.2;3974019.2
350580;201803;364;174;190;165043.0;181246.45;346289.47
350590;201803;893;488;405;465552.0;385416.0;850968.0
350600;201803;6211;3127;3084;2968670.8;2938677.0;5907348.0
350610;201803;1534;784;750;741843.25;715491.0;1457334.2
350620;201803;37;25;12;23850.0;11448.0;35298.0
350630;201803;238;133;105;125928.96;99217.0;225145.95
350635;201803;869;347;522;330752.0;497341.22;828093.2
350640;201803;119;87;32;82998.0;30528.0;113526.0
350650;201803;1893;1245;648;1183276.2;616842.94;1800119.2
350660;201803;757;344;413;327536.8;393044.0;720580.8
350670;201803;310;161;149;153356.0;142146.0;295502.0
350680;201803;179;98;81;93492.0;77274.0;170766.0
350690;201803;196;98;98;93492.0;93492.0;186984.0
350700;201803;702;348;354;328657.94;337716.0;666373.94
350710;201803;331;136;195;129744.0;186030.0;315774.0
350715;201803;50;43;7;41022.0;6678.0;47700.0
350720;201803;18;13;5;12402.0;4770.0;17172.0
350730;201803;44;28;16;26712.0;15264.0;41976.0
350740;201803;209;117;92;111322.26;87768.0;199090.27
350745;201803;21;11;10;10470.0;9540.0;20010.0
350750;201803;2144;1376;768;1304416.8;732035.94;2036452.8
350760;201803;3742;1614;2128;1538135.4;2027272.4;3565407.8
350770;201803;59;40;19;38160.0;18126.0;56286.0
350775;201803;50;37;13;35298.0;12393.0;47691.0
350780;201803;423;210;213;200340.0;203202.0;403542.0
350790;201803;364;158;206;150732.0;196524.0;347256.0
350800;201803;434;244;190;232776.0;181260.0;414036.0
350810;201803;520;420;100;399727.0;95400.0;495127.0
350820;201803;85;52;33;49608.0;31482.0;81090.0
350830;201803;81;46;35;43884.0;33390.0;77274.0
350840;201803;725;325;400;310050.0;380360.0;690410.0
350850;201803;1759;1014;745;961348.3;710698.44;1672046.8
350860;201803;579;336;243;316505.5;231822.0;548327.5
350870;201803;441;299;142;285246.0;135181.8;420427.8
350880;201803;286;156;130;145964.1;123352.2;269316.3
350890;201803;43;26;17;24804.0;16218.0;41022.0
350900;201803;1466;477;989;453071.94;942742.8;1395814.8
350910;201803;28;18;10;17172.0;9540.0;26712.0
350920;201803;595;332;263;316410.03;250902.0;567312.06
350925;201803;1167;631;536;598932.3;509913.6;1108846.0
350930;201803;95;57;38;54378.0;36252.0;90630.0
350940;201803;718;403;315;382935.6;298669.6;681605.2
350945;201803;106;79;27;74830.0;25758.0;100588.0
350950;201803;15257;7355;7902;6988253.5;7528332.5;1,45E+14
350960;201803;1285;602;683;569626.94;651578.0;1221205.0
350970;201803;1123;605;518;574597.94;493876.47;1068474.4
350980;201803;95;64;31;61056.0;29574.0;90630.0
350990;201803;357;129;228;122112.72;217225.8;339338.53
350995;201803;34;17;17;16218.0;16218.0;32436.0
351000;201803;641;457;184;433754.06;175536.0;609290.06
351010;201803;52;30;22;28620.0;20988.0;49608.0
351015;201803;57;41;16;39114.0;15264.0;54378.0
351020;201803;1671;965;706;918900.25;671330.0;1590230.2
351030;201803;333;229;104;215890.2;99216.0;315106.2
351040;201803;848;458;390;435978.0;371106.66;807084.7
351050;201803;3271;1559;1712;1479001.0;1632200.5;3111201.5
351060;201803;5014;2050;2964;1945177.9;2824622.0;4769799.5
351070;201803;416;265;151;250302.92;144054.0;394356.9
351080;201803;813;584;229;557136.0;217512.0;774648.0
351090;201803;63;27;36;25758.0;34344.0;60102.0
351100;201803;460;264;196;249634.48;186979.23;436613.72
351110;201803;2117;1022;1095;969913.44;1042003.2;2011916.6
351120;201803;73;38;35;36167.09;33390.0;69557.09
351130;201803;175;60;115;57240.0;109710.0;166950.0
351140;201803;340;237;103;224571.64;98262.0;322833.62
351150;201803;401;207;194;196285.8;185076.0;381361.8
351160;201803;245;161;84;153594.0;80136.0;233730.0
351170;201803;187;100;87;95400.0;82235.0;177635.0
351190;201803;91;62;29;59148.0;27666.0;86814.0
351200;201803;379;247;132;235034.05;125928.0;360962.03
351210;201803;129;62;67;58893.38;63918.0;122811.38
351220;201803;527;317;210;298845.12;200340.0;499185.12
351230;201803;277;203;74;193025.95;70576.92;263602.88
351240;201803;227;98;129;93301.2;123066.0;216367.2
351250;201803;72;50;22;47476.0;20798.0;68274.0
351260;201803;153;112;41;106848.0;38828.0;145676.0
351270;201803;48;20;28;19080.0;26712.0;45792.0
351280;201803;1106;501;605;474141.4;576084.4;1050225.8
351290;201803;225;100;125;95400.0;118964.0;214364.0
351300;201803;3740;1747;1993;1659774.1;1900429.0;3560203.2
351310;201803;769;395;374;376830.0;356796.0;733626.0
351320;201803;109;67;42;63918.0;40068.0;103986.0
351330;201803;41;28;13;26712.0;12402.0;39114.0
351340;201803;1239;769;470;727074.9;447396.22;1174471.1
351350;201803;2464;1346;1118;1282510.8;1066281.0;2348791.8
351360;201803;778;388;390;369198.0;371742.03;740940.06
351370;201803;366;189;177;180301.23;168221.95;348523.2
351380;201803;8918;4066;4852;3863788.8;4619857.0;8483646.0
351385;201803;30;20;10;19080.0;9540.0;28620.0
351390;201803;288;212;76;201294.02;72504.0;273798.03
351400;201803;64;39;25;37206.0;23803.92;61009.92
351410;201803;427;267;160;253447.05;152640.0;406087.03
351420;201803;62;50;12;47700.0;11448.0;59148.0
351430;201803;73;38;35;36252.0;33390.0;69642.0
351440;201803;792;550;242;522505.75;230864.0;753369.75
351450;201803;253;127;126;121158.0;120204.0;241362.0
351460;201803;123;56;67;52709.0;63918.0;116627.0
351470;201803;138;74;64;70596.0;61056.0;131652.0
351480;201803;517;290;227;275420.97;216438.75;491859.72
351490;201803;293;105;188;100170.0;179352.0;279522.0
351492;201803;32;23;9;21942.0;8586.0;30528.0
351495;201803;27;18;9;17172.0;8586.0;25758.0
351500;201803;3541;1539;2002;1462701.8;1904996.4;3367698.0
351510;201803;1773;742;1031;707581.8;981370.25;1688952.0
351512;201803;22;18;4;17172.0;3816.0;20988.0
351515;201803;192;112;80;106848.0;76320.0;183168.0
351518;201803;751;459;292;436928.0;278568.0;715496.0
351519;201803;74;47;27;44838.0;25758.0;70596.0
351520;201803;144;89;55;84269.96;52470.0;136739.95
351530;201803;20;13;7;12402.0;6678.0;19080.0
351535;201803;133;74;59;70596.0;56286.0;126882.0
351540;201803;461;332;129;314345.0;123066.0;437411.0
351550;201803;1327;803;524;762024.94;497978.88;1260003.9
351560;201803;74;39;35;37206.0;33390.0;70596.0
351565;201803;13;8;5;7632.0;4770.0;12402.0
351570;201803;2563;1324;1239;1260772.4;1181339.6;2442112.0
351580;201803;39;35;4;33390.0;3816.0;37206.0
351590;201803;66;44;22;41976.0;20988.0;62964.0
351600;201803;192;146;46;139284.0;43884.0;183168.0
351610;201803;62;31;31;29574.0;29574.0;59148.0
351620;201803;5924;3391;2533;3224985.2;2414263.0;5639248.5
351630;201803;2531;1307;1224;1241563.4;1165211.2;2406774.8
351640;201803;1658;808;850;768947.4;808181.8;1577129.1
351650;201803;30;25;5;23850.0;4770.0;28620.0
351660;201803;157;100;57;94446.0;54378.0;148824.0
351670;201803;748;469;279;445090.0;266166.0;711256.0
351680;201803;74;60;14;57240.0;13356.0;70596.0
351685;201803;42;27;15;25758.0;14310.0;40068.0
351690;201803;310;220;90;208015.62;85860.0;293875.62
351700;201803;163;114;49;108756.0;46746.0;155502.0
351710;201803;75;54;21;51516.0;20034.0;71550.0
351720;201803;134;63;71;60102.0;67734.0;127836.0
351730;201803;101;73;28;68600.96;26707.23;95308.19
351740;201803;718;487;231;462098.0;220369.23;682467.25
351750;201803;366;154;212;146280.0;202248.0;348528.0
351760;201803;794;617;177;588857.0;168858.0;757715.0
351770;201803;288;247;41;235638.0;39114.0;274752.0
351780;201803;172;98;74;93483.0;70596.0;164079.0
351790;201803;243;127;116;121158.0;110664.0;231822.0
351800;201803;54;35;19;33390.0;18126.0;51516.0
351810;201803;126;84;42;80136.0;40068.0;120204.0
351820;201803;883;638;245;604170.4;233439.23;837609.6
351830;201803;507;184;323;174772.8;308142.0;482914.8
351840;201803;1869;947;922;894494.0;878087.7;1772581.8
351850;201803;231;169;62;160606.8;59148.0;219754.8
351860;201803;756;501;255;472232.84;242979.23;715212.06
351870;201803;5636;2659;2977;2526274.0;2833767.8;5360041.5
351880;201803;18984;8315;10669;7909905.0;1,02E+14;1,81E+14
351885;201803;90;62;28;58433.0;26712.0;85145.0
351890;201803;72;61;11;58194.0;10494.0;68688.0
351900;201803;224;133;91;126215.0;86814.0;213029.0
351905;201803;77;34;43;32436.0;41022.0;73458.0
351907;201803;3114;1362;1752;1296479.0;1669329.8;2965808.8
351910;201803;177;74;103;70596.0;98262.0;168858.0
351920;201803;133;76;57;72504.0;54355.69;126859.69
351925;201803;86;58;28;55332.0;26712.0;82044.0
351930;201803;383;259;124;246990.6;118296.0;365286.6
351940;201803;234;105;129;100170.0;123066.0;223236.0
351950;201803;145;84;61;80136.0;58194.0;138330.0
351960;201803;864;401;463;382372.72;439546.38;821919.06
351970;201803;1899;1014;885;965209.8;843709.0;1808918.9
351980;201803;146;73;73;67734.0;69642.0;137376.0
351990;201803;276;187;89;177444.0;84104.64;261548.64
352000;201803;357;216;141;206064.0;134514.0;340578.0
352010;201803;352;209;143;199386.0;136422.0;335808.0
352020;201803;199;68;131;64872.0;124974.0;189846.0
352030;201803;1011;522;489;497272.5;464915.97;962188.44
352040;201803;571;249;322;237546.0;307188.0;544734.0
352042;201803;280;95;185;90630.0;176204.0;266834.0
352044;201803;392;234;158;222282.2;150732.0;373014.2
352050;201803;3157;1284;1873;1217100.0;1785306.2;3002406.2
352060;201803;106;66;40;62964.0;38160.0;101124.0
352070;201803;104;74;30;69326.0;28620.0;97946.0
352080;201803;65;40;25;37206.0;23850.0;61056.0
352090;201803;173;117;56;111618.0;53424.0;165042.0
352100;201803;254;124;130;118292.0;122868.0;241160.0
352110;201803;112;33;79;31482.0;75366.0;106848.0
352115;201803;72;28;44;26712.0;41976.0;68688.0
352120;201803;96;64;32;61056.0;30528.0;91584.0
352130;201803;219;184;35;175345.2;33390.0;208735.2
352140;201803;180;73;107;69165.0;102078.0;171243.0
352150;201803;122;67;55;62964.04;52470.0;115434.04
352160;201803;130;86;44;82044.0;41976.0;124020.0
352170;201803;371;252;119;239454.05;113526.0;352980.03
352180;201803;611;412;199;392094.5;189842.0;581936.5
352190;201803;263;103;160;98252.46;152601.84;250854.3
352200;201803;32;16;16;15264.0;15264.0;30528.0
352210;201803;3766;1568;2198;1487076.5;2090975.2;3578051.8
352215;201803;54;30;24;28620.0;22438.08;51058.08
352220;201803;6887;2716;4171;2586136.5;3976642.5;6562779.0
352230;201803;3177;2025;1152;1918902.5;1092269.4;3011171.8
352240;201803;2217;1303;914;1240582.5;869659.06;2110241.5
352250;201803;2591;1348;1243;1282719.5;1181688.9;2464408.5
352260;201803;1084;593;491;563905.25;468128.0;1032033.25
352265;201803;61;27;34;25758.0;32436.0;58194.0
352270;201803;408;234;174;222282.92;165940.0;388222.9
352280;201803;396;248;148;235321.0;141187.23;376508.22
352290;201803;174;111;63;105894.0;60102.0;165996.0
352300;201803;102;76;26;72504.0;24804.0;97308.0
352310;201803;5765;2818;2947;2675122.2;2805296.0;5480418.5
352320;201803;969;506;463;479229.84;439651.1;918880.94
352330;201803;528;239;289;227672.1;275420.0;503092.1
352340;201803;1400;684;716;649884.0;681014.5;1330898.5
352350;201803;333;210;123;200340.0;117056.0;317396.0
352360;201803;231;96;135;90677.7;125907.32;216585.02
352370;201803;102;69;33;65826.0;31482.0;97308.0
352380;201803;120;75;45;71550.0;42930.0;114480.0
352390;201803;2430;1113;1317;1058301.4;1255256.0;2313557.2
352400;201803;474;204;270;193662.0;257293.8;450955.8
352410;201803;760;544;216;514471.88;205778.0;720249.9
352420;201803;101;65;36;62010.0;34344.0;96354.0
352430;201803;1763;783;980;741929.8;932287.5;1674217.4
352440;201803;3123;1610;1513;1526863.5;1441454.6;2968318.2
352450;201803;190;161;29;153594.0;27666.0;181260.0
352460;201803;568;292;276;278010.7;262589.2;540599.9
352470;201803;596;201;395;191754.0;376821.0;568575.0
352480;201803;1376;770;606;733307.94;577551.8;1310859.8
352490;201803;84;32;52;30528.0;49608.0;80136.0
352500;201803;1202;534;668;508483.0;636119.2;1144602.2
352510;201803;736;401;335;381600.97;319480.0;701080.94
352520;201803;537;239;298;228006.0;284148.9;512154.9
352530;201803;1725;904;821;862416.0;782852.6;1645268.6
352540;201803;74;49;25;46746.0;23850.0;70596.0
352550;201803;180;103;77;98262.0;72790.2;171052.2
352560;201803;49;39;10;37206.0;9540.0;46746.0
352570;201803;666;345;321;328527.0;306234.0;634761.0
352580;201803;57;38;19;35298.65;18126.0;53424.65
352585;201803;17;5;12;4770.0;11448.0;16218.0
352590;201803;4330;2186;2144;2079039.8;2044475.4;4123515.2
352600;201803;358;249;109;236592.95;103986.0;340578.97
352610;201803;933;437;496;415877.22;473184.0;889061.25
352620;201803;959;385;574;366336.2;546643.0;912979.2
352630;201803;175;66;109;62964.0;103976.46;166940.45
352640;201803;556;395;161;373778.38;153594.0;527372.4
352650;201803;89;58;31;55332.0;29574.0;84906.0
352660;201803;81;48;33;45792.0;31482.0;77274.0
352670;201803;1657;901;756;856060.75;720134.6;1576195.4
352680;201803;887;569;318;539594.56;301910.03;841504.6
352690;201803;4342;1999;2343;1898935.9;2231356.8;4130292.5
352700;201803;107;62;45;58861.8;42930.0;101791.8
352710;201803;1373;735;638;699282.0;605690.6;1304972.6
352720;201803;1311;638;673;606108.2;641751.25;1247859.4
352725;201803;26;24;2;22896.0;1908.0;24804.0
352730;201803;365;181;184;171495.81;175536.0;347031.8
352740;201803;416;261;155;247039.69;147870.0;394909.7
352750;201803;22;14;8;13069.8;7632.0;20701.8
352760;201803;199;142;57;135468.0;54378.0;189846.0
352770;201803;81;63;18;60102.0;17172.0;77274.0
352780;201803;79;44;35;41976.0;33390.0;75366.0
352790;201803;29;24;5;22896.0;4770.0;27666.0
352800;201803;248;168;80;160272.0;76033.8;236305.8
352810;201803;166;109;57;101475.42;54378.0;155853.42
352820;201803;65;52;13;48896.32;12402.0;61298.32
352830;201803;88;61;27;58194.0;25758.0;83952.0
352840;201803;596;308;288;292545.2;274752.0;567297.2
352850;201803;1368;488;880;464884.2;839520.0;1304404.2
352860;201803;132;86;46;81408.0;43884.0;125292.0
352870;201803;45;29;16;27666.0;15264.0;42930.0
352880;201803;190;128;62;122092.92;59148.0;181240.92
352885;201803;28;20;8;19080.0;7632.0;26712.0
352890;201803;56;39;17;37206.0;15932.0;53138.0
352900;201803;4899;2367;2532;2240104.0;2407946.8;4648050.5
352910;201803;38;31;7;29574.0;6678.0;36252.0
352920;201803;713;439;274;417852.0;261396.0;679248.0
352930;201803;1272;616;656;586231.8;622845.2;1209077.0
352940;201803;6309;2745;3564;2607174.2;3396894.8;6004069.0
352950;201803;93;37;56;35298.0;53424.0;88722.0
352960;201803;69;45;24;42930.0;22896.0;65826.0
352965;201803;20;8;12;7632.0;11448.0;19080.0
352970;201803;465;347;118;327830.97;111619.0;439449.97
352980;201803;175;94;81;89676.0;77274.0;166950.0
352990;201803;950;423;527;402539.28;501670.1;904209.4
353000;201803;67;31;36;29574.0;34344.0;63918.0
353010;201803;552;343;209;327222.0;199366.92;526588.94
353020;201803;289;212;77;202248.0;73458.0;275706.0
353030;201803;1186;538;648;512289.28;617505.7;1129795.0
353040;201803;89;54;35;51516.0;33390.0;84906.0
353050;201803;1315;833;482;787037.0;459732.6;1246769.6
353060;201803;7996;3613;4383;3431566.0;4175139.8;7606706.0
353070;201803;1635;1028;607;974158.44;577787.4;1551945.9
353080;201803;1325;705;620;670233.56;590522.0;1260755.5
353090;201803;56;34;22;32436.0;20988.0;53424.0
353100;201803;62;51;11;48654.0;10494.0;59148.0
353110;201803;1999;610;1389;580208.9;1323137.2;1903346.1
353120;201803;78;41;37;39114.0;35298.0;74412.0
353130;201803;878;442;436;420695.47;415822.7;836518.1
353140;201803;565;222;343;211727.0;327222.0;538949.0
353150;201803;364;204;160;193662.0;152630.45;346292.47
353160;201803;102;84;18;80136.0;17172.0;97308.0
353170;201803;196;65;131;62010.0;124946.46;186956.45
353180;201803;954;435;519;412696.7;494602.0;907298.7
353190;201803;481;347;134;329982.9;127550.0;457532.9
353200;201803;191;97;94;92538.0;89676.0;182214.0
353205;201803;27;19;8;18126.0;7632.0;25758.0
353210;201803;87;52;35;49608.0;33390.0;82998.0
353215;201803;54;32;22;30528.0;20988.0;51516.0
353220;201803;86;48;38;45792.0;35055.27;80847.27
353230;201803;161;63;98;60102.0;93492.0;153594.0
353240;201803;292;161;131;153594.0;124974.0;278568.0
353250;201803;202;105;97;100170.0;92538.0;192708.0
353260;201803;458;330;128;313685.5;122102.46;435787.97
353270;201803;68;49;19;46746.0;17458.2;64204.2
353280;201803;95;48;47;45315.0;44838.0;90153.0
353282;201803;120;88;32;83952.0;30528.0;114480.0
353284;201803;22;18;4;17172.0;3816.0;20988.0
353286;201803;1;1;0;954.0;0.0;954.0
353290;201803;80;47;33;44838.0;31473.0;76311.0
353300;201803;400;222;178;210246.45;169812.0;380058.47
353310;201803;55;48;7;45792.0;6678.0;52470.0
353320;201803;63;40;23;38160.0;21942.0;60102.0
353325;201803;57;35;22;33381.0;20684.0;54065.0
353330;201803;67;51;16;48511.0;15264.0;63775.0
353340;201803;617;197;420;187938.0;400094.25;588032.25
353350;201803;925;429;496;408275.62;471640.8;879916.44
353360;201803;111;88;23;83634.04;21656.0;105290.04
353370;201803;121;71;50;66780.1;47700.0;114480.1
353380;201803;27;19;8;18122.0;7632.0;25754.0
353390;201803;1062;504;558;480816.0;532332.0;1013148.0
353400;201803;52;31;21;29574.0;20034.0;49608.0
353410;201803;121;76;45;72504.0;42883.0;115387.0
353420;201803;57;23;34;21942.0;32436.0;54378.0
353430;201803;553;365;188;344489.3;179065.8;523555.1
353440;201803;10216;4476;5740;4257452.0;5468894.0;9726346.0
353450;201803;56;30;26;28620.0;24804.0;53424.0
353460;201803;613;334;279;315467.1;265441.5;580908.6
353470;201803;2149;1169;980;1111273.9;932505.25;2043779.1
353475;201803;239;161;78;150904.95;74412.0;225316.95
353480;201803;190;151;39;144054.0;37206.0;181260.0
353490;201803;237;142;95;135468.0;90630.0;226098.0
353500;201803;185;108;77;101792.96;73458.0;175250.95
353510;201803;102;73;29;69623.46;27656.46;97279.92
353520;201803;209;140;69;133560.0;65826.0;199386.0
353530;201803;474;259;215;247086.0;205110.0;452196.0
353540;201803;358;238;120;226729.27;114480.0;341209.28
353550;201803;737;500;237;473186.88;226098.0;699284.9
353560;201803;640;271;369;256968.69;351426.06;608394.75
353570;201803;59;31;28;29574.0;26712.0;56286.0
353580;201803;357;276;81;262827.0;77274.0;340101.0
353590;201803;85;59;26;55968.04;24804.0;80772.04
353600;201803;274;156;118;148507.0;111936.0;260443.0
353610;201803;113;59;54;56286.0;51516.0;107802.0
353620;201803;570;310;260;293753.5;247753.8;541507.3
353625;201803;50;28;22;26712.0;20988.0;47700.0
353630;201803;239;172;67;159757.16;63918.0;223675.16
353640;201803;128;87;41;82521.0;39114.0;121635.0
353650;201803;855;331;524;313675.2;499896.0;813571.2
353657;201803;23;17;6;16218.0;5724.0;21942.0
353660;201803;255;144;111;137376.0;105607.8;242983.8
353670;201803;755;446;309;424530.2;294786.0;719316.2
353680;201803;100;71;29;67734.0;27666.0;95400.0
353690;201803;47;37;10;34737.0;9540.0;44277.0
353700;201803;283;199;84;189846.0;80136.0;269982.0
353710;201803;417;196;221;186030.8;210548.0;396578.8
353715;201803;46;34;12;32149.8;11448.0;43597.8
353720;201803;361;170;191;162162.0;182214.0;344376.0
353730;201803;1128;694;434;659166.9;413835.66;1073002.6
353740;201803;651;358;293;341245.8;279522.0;620767.8
353750;201803;93;58;35;54800.14;33390.0;88190.14
353760;201803;2746;1043;1703;992963.1;1621059.2;2614022.5
353770;201803;98;81;17;76797.0;16218.0;93015.0
353780;201803;1123;562;561;534431.94;533286.0;1067718.0
353790;201803;514;296;218;280315.1;205087.34;485402.44
353800;201803;3273;1670;1603;1585150.8;1526882.8;3112033.5
353810;201803;237;132;105;125074.71;100143.0;225217.7
353820;201803;186;92;94;87768.0;89051.41;176819.4
353830;201803;48;41;7;39114.0;6678.0;45792.0
353850;201803;165;86;79;82044.0;75366.0;157410.0
353860;201803;467;210;257;199624.5;244891.8;444516.3
353870;201803;5008;2520;2488;2387662.0;2362346.8;4750008.5
353880;201803;679;486;193;462308.4;183168.12;645476.5
353890;201803;587;332;255;316156.0;242984.0;559140.0
353900;201803;134;68;66;64872.0;62964.0;127836.0
353910;201803;176;88;88;83952.0;83952.0;167904.0
353920;201803;452;244;208;231584.4;197989.16;429573.56
353930;201803;999;595;404;565937.8;384181.8;950119.56
353940;201803;188;102;86;96544.8;81186.0;177730.8
353950;201803;516;321;195;305947.8;186021.0;491968.8
353960;201803;71;58;13;55332.0;12402.0;67734.0
353970;201803;75;46;29;43884.0;27666.0;71550.0
353980;201803;1529;752;777;714748.94;740319.75;1455068.8
353990;201803;75;42;33;40068.0;31482.0;71550.0
354000;201803;375;181;194;172007.0;184881.2;356888.2
354010;201803;94;51;43;48654.0;40545.0;89199.0
354020;201803;544;343;201;326268.0;191754.0;518022.0
354025;201803;55;43;12;41022.0;11448.0;52470.0
354030;201803;64;35;29;33390.0;27666.0;61056.0
354040;201803;96;68;28;64490.4;26712.0;91202.4
354050;201803;189;105;84;99884.0;80136.0;180020.0
354060;201803;774;371;403;353934.0;381935.4;735869.4
354070;201803;876;511;365;485964.03;348210.0;834174.0
354075;201803;212;115;97;109615.0;91584.8;201199.8
354080;201803;293;126;167;119917.8;159318.0;279235.8
354085;201803;18;11;7;10494.0;6678.0;17172.0
354090;201803;311;172;139;164007.0;132606.0;296613.0
354100;201803;5495;2286;3209;2169768.2;3055567.0;5225335.5
354105;201803;79;41;38;39114.0;36252.0;75366.0
354110;201803;47;21;26;20034.0;24804.0;44838.0
354120;201803;147;101;46;96214.97;43884.0;140098.97
354130;201803;698;468;230;446234.0;219130.0;665364.0
354140;201803;3172;1479;1693;1406999.4;1613577.9;3020577.2
354150;201803;645;402;243;382248.97;230391.0;612639.94
354160;201803;709;451;258;429061.5;245846.0;674907.5
354165;201803;19;12;7;11448.0;6678.0;18126.0
354170;201803;176;119;57;112858.2;54378.0;167236.2
354180;201803;63;39;24;36880.0;22896.0;59776.0
354190;201803;215;100;115;93778.2;109710.0;203488.2
354200;201803;131;72;59;68211.0;56286.0;124497.0
354210;201803;69;34;35;32436.0;33390.0;65826.0
354220;201803;643;398;245;378388.16;232204.16;610592.3
354230;201803;160;66;94;62964.0;88722.6;151686.6
354240;201803;320;207;113;196524.48;107165.96;303690.44
354250;201803;92;56;36;53424.0;34344.0;87768.0
354260;201803;1929;904;1025;850729.3;976510.0;1827239.4
354270;201803;95;71;24;67734.0;22896.0;90630.0
354280;201803;36;19;17;18126.0;16218.0;34344.0
354290;201803;143;98;45;92681.1;42930.0;135611.1
354300;201803;422;288;134;274435.0;127678.0;402113.0
354310;201803;105;76;29;71550.2;27666.0;99216.2
354320;201803;181;97;84;92538.0;80136.0;172674.0
354323;201803;16;14;2;13356.0;1908.0;15264.0
354325;201803;108;62;46;58342.0;43884.0;102226.0
354330;201803;2586;866;1720;821529.25;1638714.0;2460243.2
354340;201803;10557;5146;5411;4896209.5;5155748.5;1,01E+14
354350;201803;129;87;42;82998.0;39924.9;122922.9
354360;201803;87;48;39;45792.0;37206.0;82998.0
354370;201803;265;144;121;137376.0;115434.0;252810.0
354380;201803;210;127;83;120372.0;79182.0;199554.0
354390;201803;2752;999;1753;952095.94;1670991.8;2623087.8
354400;201803;329;173;156;164375.0;148251.8;312626.8
354410;201803;611;297;314;281712.44;298602.2;580314.6
354420;201803;270;170;100;162180.0;95400.0;257580.0
354425;201803;320;186;134;177444.0;127836.0;305280.0
354430;201803;187;116;71;109089.9;66970.8;176060.7
354440;201803;40;28;12;26712.0;11448.0;38160.0
354450;201803;53;38;15;36252.0;14310.0;50562.0
354460;201803;103;60;43;57240.0;41022.0;98262.0
354470;201803;39;26;13;24804.0;12402.0;37206.0
354480;201803;119;62;57;59139.0;54368.46;113507.46
354490;201803;149;93;56;88562.97;53424.0;141986.97
354500;201803;395;197;198;187938.0;188892.0;376830.0
354510;201803;101;70;31;66780.0;29574.0;96354.0
354515;201803;39;13;26;12402.0;24804.0;37206.0
354520;201803;1625;712;913;676537.2;870563.56;1547100.8
354530;201803;652;340;312;323225.8;296504.0;619729.8
354540;201803;279;159;120;151686.0;114475.23;266161.22
354550;201803;42;24;18;22896.0;17172.0;40068.0
354560;201803;165;96;69;91298.0;65816.46;157114.45
354570;201803;138;89;49;84906.0;46746.0;131652.0
354580;201803;1967;932;1035;886265.0;987090.25;1873355.2
354600;201803;275;148;127;138938.12;121143.69;260081.81
354610;201803;73;65;8;61056.58;7632.0;68688.58
354620;201803;64;21;43;20034.0;41022.0;61056.0
354625;201803;17;11;6;10494.0;5720.0;16214.0
354630;201803;320;211;109;200788.55;103986.0;304774.56
354640;201803;798;512;286;484522.38;272844.0;757366.4
354650;201803;72;41;31;38818.8;29545.92;68364.72
354660;201803;816;605;211;573148.44;201294.0;774442.44
354670;201803;279;100;179;94447.0;169813.0;264260.0
354680;201803;1250;477;773;455058.0;736965.0;1192023.0
354690;201803;92;63;29;59149.0;27666.0;86815.0
354700;201803;77;56;21;53424.0;20034.0;73458.0
354710;201803;56;38;18;35615.96;17172.0;52787.96
354720;201803;20;19;1;18126.0;954.0;19080.0
354730;201803;1902;803;1099;762905.2;1048255.2;1811160.4
354740;201803;56;41;15;39114.0;14310.0;53424.0
354750;201803;441;262;179;249939.0;170766.0;420705.0
354760;201803;516;316;200;299082.0;190227.8;489309.8
354765;201803;12;5;7;4770.0;6678.0;11448.0
354770;201803;340;232;108;220504.03;102268.8;322772.84
354780;201803;8115;3308;4807;3142877.8;4581041.0;7723918.5
354790;201803;113;67;46;63918.0;43884.0;107802.0
354800;201803;423;234;189;223236.0;180000.92;403236.9
354805;201803;103;53;50;49926.0;47700.0;97626.0
354810;201803;137;80;57;76320.0;54378.0;130698.0
354820;201803;185;81;104;77065.0;99216.0;176281.0
354830;201803;40;21;19;20034.0;18126.0;38160.0
354840;201803;55;37;18;35298.0;17172.0;52470.0
354850;201803;4564;2026;2538;1925021.0;2416736.5;4341757.5
354860;201803;329;159;170;151686.0;159785.52;311471.53
354870;201803;11850;5357;6493;5080577.5;6183673.5;1,13E+14
354880;201803;3002;1125;1877;1071612.5;1789062.9;2860675.2
354890;201803;2833;1563;1270;1485586.8;1210597.4;2696184.0
354900;201803;59;39;20;37206.0;19080.0;56286.0
354910;201803;1228;643;585;610614.25;558090.0;1168704.2
354920;201803;50;42;8;40068.0;7632.0;47700.0
354925;201803;12;7;5;6678.0;4770.0;11448.0
354930;201803;31;28;3;26442.0;2862.0;29304.0
354940;201803;796;587;209;558045.2;199386.0;757431.2
354950;201803;220;144;76;136766.0;72504.0;209270.0
354960;201803;170;64;106;61056.0;100838.0;161894.0
354970;201803;844;551;293;520795.1;278883.03;799678.1
354980;201803;8414;3136;5278;2983637.2;5032227.0;8015864.5
354990;201803;9173;4326;4847;4112966.5;4617903.0;8730870.0
354995;201803;513;181;332;172674.0;316413.2;489087.2
355000;201803;495;164;331;156451.23;314581.5;471032.72
355010;201803;620;391;229;373014.0;216254.48;589268.5
355020;201803;720;451;269;429295.6;256618.0;685913.56
355030;201803;203881;79129;124752;7,53E+14;1,19E+14;1,94E+16
355040;201803;717;337;380;319972.3;362329.2;682301.5
355050;201803;151;100;51;94129.77;48654.0;142783.77
355060;201803;1489;753;736;713493.9;700952.3;1414446.1
355070;201803;1459;718;741;681148.4;705921.0;1387069.4
355080;201803;199;115;84;109710.0;79248.8;188958.8
355090;201803;291;193;98;182024.0;93492.0;275516.0
355100;201803;4777;2374;2403;2243739.0;2290584.2;4534323.5
355110;201803;271;172;99;163131.0;94446.0;257577.0
355120;201803;80;56;24;53424.0;22896.0;76320.0
355130;201803;55;29;26;27666.0;24804.0;52470.0
355140;201803;182;120;62;113764.5;59148.0;172912.5
355150;201803;677;407;270;387034.0;257103.0;644137.0
355160;201803;450;218;232;205587.95;221276.0;426863.97
355170;201803;2054;1069;985;1018446.9;939670.94;1958117.8
355180;201803;621;267;354;253764.0;336881.25;590645.25
355190;201803;222;151;71;144054.0;67734.0;211788.0
355200;201803;116;68;48;64872.0;45792.0;110664.0
355210;201803;722;416;306;396864.0;291905.47;688769.44
355220;201803;6647;3558;3089;3382892.8;2938647.2;6321540.0
355230;201803;106;63;43;60102.0;41017.23;101119.23
355240;201803;4249;1870;2379;1770010.9;2264855.8;4034866.5
355250;201803;5378;2629;2749;2501452.5;2619143.0;5120595.5
355255;201803;53;32;21;30528.0;20034.0;50562.0
355260;201803;186;112;74;105875.12;70568.46;176443.58
355270;201803;164;97;67;92538.0;63203.0;155741.0
355280;201803;6346;2672;3674;2544180.5;3500294.5;6044475.0
355290;201803;78;58;20;55332.0;19080.0;74412.0
355300;201803;182;119;63;112286.6;60102.0;172388.6
355310;201803;106;60;46;57240.0;43884.0;101124.0
355320;201803;93;47;46;44838.0;42936.6;87774.6
355330;201803;270;150;120;143100.0;114480.0;257580.0
355340;201803;1513;551;962;523047.62;917006.0;1440053.6
355350;201803;142;74;68;70596.0;64872.0;135468.0
355360;201803;183;115;68;109500.12;64872.0;174372.12
355365;201803;26;21;5;20034.0;4770.0;24804.0
355370;201803;1036;586;450;553167.75;428032.56;981200.3
355380;201803;770;516;254;490818.53;242030.0;732848.5
355385;201803;61;43;18;41022.0;17172.0;58194.0
355390;201803;107;62;45;59148.0;42930.0;102078.0
355395;201803;188;114;74;107655.23;70596.0;178251.23
355400;201803;1548;960;588;911841.5;559291.3;1471132.9
355410;201803;4889;2290;2599;2167239.0;2471685.2;4638924.0
355420;201803;48;36;12;34344.0;11448.0;45792.0
355430;201803;343;208;135;197096.4;128790.0;325886.4
355440;201803;79;47;32;44838.0;30528.0;75366.0
355450;201803;440;209;231;196486.28;219324.8;415811.1
355460;201803;70;54;16;50562.42;15264.0;65826.42
355465;201803;51;32;19;30528.0;18126.0;48654.0
355470;201803;182;73;109;68688.1;103986.0;172674.1
355475;201803;13;8;5;7632.0;4770.0;12402.0
355480;201803;458;201;257;189856.34;243737.45;433593.8
355490;201803;116;82;34;78228.0;32436.0;110664.0
355495;201803;56;27;29;25758.0;27666.0;53424.0
355500;201803;1667;942;725;892802.7;691615.44;1584418.1
355510;201803;271;196;75;183525.67;71550.0;255075.67
355520;201803;36;28;8;26426.0;7632.0;34058.0
355530;201803;23;16;7;15264.0;6678.0;21942.0
355535;201803;76;38;38;36252.0;36252.0;72504.0
355540;201803;2357;940;1417;895301.5;1349678.0;2244979.5
355550;201803;64;39;25;37206.0;23850.0;61056.0
355560;201803;237;119;118;113526.0;111935.96;225461.95
355570;201803;31;20;11;19080.0;10494.0;29574.0
355580;201803;271;189;82;180306.0;77937.23;258243.23
355590;201803;23;14;9;13356.0;8586.0;21942.0
355600;201803;273;140;133;133560.0;126591.23;260151.23
355610;201803;206;135;71;128790.0;67734.0;196524.0
355620;201803;1249;581;668;553463.8;636190.0;1189653.8
355630;201803;408;297;111;283338.0;105894.0;389232.0
355635;201803;125;60;65;57240.0;61997.0;119237.0
355640;201803;570;332;238;315774.16;227052.0;542826.2
355645;201803;825;356;469;338145.3;445546.8;783692.1
355650;201803;2137;894;1243;849606.8;1185517.5;2035124.2
355660;201803;262;140;122;133560.0;116388.0;249948.0
355670;201803;484;191;293;182214.0;279235.8;461449.8
355680;201803;208;118;90;111619.0;85574.0;197193.0
355690;201803;87;40;47;38160.0;44434.0;82594.0
355695;201803;15;12;3;11448.0;2862.0;14310.0
355700;201803;1140;586;554;553974.6;527944.0;1081918.6
355710;201803;2190;1200;990;1141449.5;943669.0;2085118.5
355715;201803;20;18;2;17172.0;1908.0;19080.0
355720;201803;208;126;82;118614.08;78228.0;196842.08
355730;201803;93;53;40;49437.95;38160.0;87597.95
410010;201803;137;115;22;109710.0;20988.0;130698.0
410020;201803;106;94;12;89676.0;11448.0;101124.0
410030;201803;164;104;60;98548.4;57240.0;155788.4
410040;201803;970;532;438;507289.5;417662.0;924951.5
410045;201803;26;21;5;20034.0;4770.0;24804.0
410050;201803;471;260;211;248040.0;200626.2;448666.2
410060;201803;277;213;64;203202.0;61056.0;264258.0
410070;201803;307;254;53;242316.0;50562.0;292878.0
410080;201803;165;106;59;101124.0;56286.0;157410.0
410090;201803;75;66;9;62755.0;8586.0;71341.0
410100;201803;297;213;84;202887.19;79325.1;282212.28
410105;201803;46;27;19;25758.0;18126.0;43884.0
410110;201803;313;193;120;184122.0;114480.0;298602.0
410115;201803;26;18;8;17172.0;7632.0;24804.0
410120;201803;442;227;215;216256.8;205110.0;421366.8
410130;201803;43;26;17;24804.0;16218.0;41022.0
410140;201803;3088;1522;1566;1448017.6;1490616.0;2938633.8
410150;201803;2693;1079;1614;1028213.44;1539446.0;2567659.5
410160;201803;505;317;188;302131.8;179352.0;481483.8
410165;201803;68;46;22;43884.0;20988.0;64872.0
410170;201803;166;124;42;116871.0;40068.0;156939.0
410180;201803;2146;1250;896;1188511.2;852884.1;2041395.4
410185;201803;33;29;4;27666.0;3816.0;31482.0
410190;201803;443;277;166;264258.0;158364.0;422622.0
410200;201803;966;721;245;686984.94;233624.89;920609.8
410210;201803;554;287;267;273798.0;254146.0;527944.0
410220;201803;40;22;18;20988.0;17172.0;38160.0
410230;201803;128;69;59;65826.0;56286.0;122112.0
410240;201803;747;490;257;466887.8;245178.0;712065.8
410250;201803;377;276;101;262699.84;96349.23;359049.06
410260;201803;289;172;117;164088.0;111618.0;275706.0
410270;201803;29;18;11;17172.0;10494.0;27666.0
410275;201803;66;49;17;46746.0;16218.0;62964.0
410280;201803;324;185;139;176230.52;132606.0;308836.53
410290;201803;232;147;85;140238.0;81090.0;221328.0
410300;201803;80;64;16;61056.0;15264.0;76320.0
410302;201803;24;16;8;15264.0;7632.0;22896.0
410304;201803;46;32;14;30528.0;13356.0;43884.0
410305;201803;207;112;95;106040.2;90630.0;196670.2
410310;201803;264;169;95;161226.0;90610.92;251836.92
410315;201803;52;37;15;35274.0;14310.0;49584.0
410320;201803;139;96;43;91584.0;41022.0;132606.0
410322;201803;34;24;10;22896.0;9540.0;32436.0
410330;201803;164;116;48;110664.0;45602.0;156266.0
410335;201803;100;62;38;59148.0;36252.0;95400.0
410337;201803;38;33;5;31482.0;4770.0;36252.0
410340;201803;31;29;2;27666.0;1908.0;29574.0
410345;201803;215;136;79;129744.0;75366.0;205110.0
410347;201803;53;40;13;38160.0;12402.0;50562.0
410350;201803;227;138;89;131652.0;84906.0;216558.0
410360;201803;453;271;182;255990.4;173056.0;429046.4
410370;201803;2399;1023;1376;972208.3;1309708.0;2281916.2
410380;201803;219;144;75;137376.0;71550.0;208926.0
410390;201803;370;276;94;263300.0;89676.0;352976.0
410395;201803;34;22;12;20988.0;11067.0;32055.0
410400;201803;843;434;409;412707.2;389647.0;802354.2
410405;201803;90;68;22;64872.0;20988.0;85860.0
410410;201803;40;31;9;29574.0;8586.0;38160.0
410420;201803;1657;819;838;779231.9;798499.0;1577730.9
410425;201803;180;85;95;80900.0;90630.0;171530.0
410430;201803;2196;1291;905;1228466.0;862492.3;2090958.4
410440;201803;393;290;103;275707.0;98262.0;373969.0
410442;201803;357;239;118;227053.0;112572.0;339625.0
410445;201803;423;292;131;278568.0;124974.0;403542.0
410450;201803;412;206;206;196524.0;196524.0;393048.0
410460;201803;410;223;187;212446.8;178398.0;390844.8
410465;201803;190;124;66;117055.8;62964.0;180019.8
410470;201803;220;140;80;133560.0;76320.0;209880.0
410480;201803;5786;2863;2923;2711826.5;2783381.2;5495207.5
410490;201803;1384;914;470;870459.0;446473.0;1316932.0
410500;201803;268;152;116;145008.0;110664.0;255672.0
410510;201803;180;132;48;125928.0;45783.0;171711.0
410520;201803;258;191;67;182214.0;63918.0;246132.0
410530;201803;238;89;149;84906.0;142142.0;227048.0
410540;201803;318;228;90;216931.6;85855.23;302786.84
410550;201803;1613;699;914;666559.8;870756.4;1537316.1
410560;201803;147;115;32;109710.0;30528.0;140238.0
410570;201803;431;303;128;286974.2;122112.0;409086.2
410580;201803;3175;1424;1751;1356880.8;1669024.0;3025904.8
410590;201803;404;285;119;271890.0;113526.0;385416.0
410600;201803;184;159;25;151686.0;23850.0;175536.0
410610;201803;55;44;11;41976.0;10494.0;52470.0
410620;201803;241;174;67;165996.0;63918.0;229914.0
410630;201803;443;261;182;248994.0;172469.0;421463.0
410640;201803;975;599;376;567991.0;357097.28;925088.25
410645;201803;97;74;23;70215.0;21942.0;92157.0
410650;201803;367;252;115;239454.0;109710.0;349164.0
410655;201803;78;60;18;57240.0;17172.0;74412.0
410657;201803;44;19;25;18126.0;23850.0;41976.0
410660;201803;598;421;177;400391.0;168858.0;569249.0
410670;201803;77;63;14;60102.0;13356.0;73458.0
410680;201803;187;155;32;147203.0;30528.0;177731.0
410685;201803;16;10;6;9540.0;5724.0;15264.0
410690;201803;28299;12289;16010;1,17E+14;1,53E+13;2,70E+14
410700;201803;320;232;88;220756.0;83952.0;304708.0
410710;201803;127;102;25;97308.0;23850.0;121158.0
410712;201803;24;15;9;14310.0;8586.0;22896.0
410715;201803;84;62;22;59148.0;20988.0;80136.0
410720;201803;597;361;236;344394.0;224909.05;569303.06
410725;201803;180;129;51;123066.0;48654.0;171720.0
410730;201803;87;54;33;51516.0;31482.0;82998.0
410740;201803;111;80;31;76320.0;29574.0;105894.0
410750;201803;222;165;57;157406.0;54373.23;211779.23
410752;201803;24;15;9;14310.0;8586.0;22896.0
410753;201803;54;24;30;22223.43;28620.0;50843.43
410754;201803;36;22;14;20702.0;13356.0;34058.0
410755;201803;81;55;26;52183.8;24804.0;76987.8
410760;201803;717;407;310;388278.0;295740.0;684018.0
410765;201803;1654;793;861;750177.7;820240.44;1570418.1
410770;201803;105;88;17;83952.0;16218.0;100170.0
410773;201803;45;34;11;32436.0;10494.0;42930.0
410775;201803;178;134;44;127168.2;41976.0;169144.2
410780;201803;79;43;36;41022.0;34344.0;75366.0
410785;201803;53;42;11;40068.0;10494.0;50562.0
410790;201803;71;33;38;31482.0;36252.0;67734.0
410800;201803;296;188;108;178399.0;103032.0;281431.0
410810;201803;26;22;4;20988.0;3530.0;24518.0
410820;201803;179;132;47;125785.0;44838.0;170623.0
410830;201803;8482;3868;4614;3681120.8;4399471.0;8080592.0
410832;201803;104;72;32;68401.8;30528.0;98929.8
410840;201803;1420;793;627;754254.06;597473.5;1351727.5
410845;201803;63;39;24;37206.0;22896.0;60102.0
410850;201803;189;131;58;124688.0;55332.0;180020.0
410855;201803;47;40;7;38160.0;6678.0;44838.0
410860;201803;670;392;278;373182.75;265212.0;638394.75
410865;201803;104;80;24;76320.0;22896.0;99216.0
410870;201803;155;134;21;127836.0;19743.0;147579.0
410880;201803;1111;555;556;528959.6;530379.0;1059338.6
410890;201803;76;53;23;50562.0;21942.0;72504.0
410895;201803;73;55;18;52470.0;17172.0;69642.0
410900;201803;19;11;8;10494.0;7632.0;18126.0
410910;201803;17;15;2;14310.0;1908.0;16218.0
410920;201803;34;23;11;21942.0;10494.0;32436.0
410930;201803;504;326;178;310792.97;169812.0;480604.97
410940;201803;4330;2580;1750;2452312.0;1667476.4;4119788.5
410950;201803;122;87;35;82998.0;33390.0;116388.0
410960;201803;761;338;423;322166.0;403352.0;725518.0
410965;201803;63;48;15;45505.8;14310.0;59815.8
410970;201803;627;446;181;425016.2;172674.0;597690.2
410975;201803;106;63;43;59591.0;41022.0;100613.0
410980;201803;1565;710;855;674793.8;814707.25;1489501.0
410990;201803;268;181;87;172505.23;82711.8;255217.05
411000;201803;62;40;22;38160.0;20988.0;59148.0
411005;201803;25;20;5;19080.0;4770.0;23850.0
411007;201803;235;137;98;130698.0;93492.0;224190.0
411010;201803;575;401;174;382554.0;165996.0;548550.0
411020;201803;290;200;90;190800.0;85860.0;276660.0
411030;201803;19;10;9;9540.0;8586.0;18126.0
411040;201803;49;35;14;33390.0;13356.0;46746.0
411050;201803;216;171;45;162477.72;42803.12;205280.84
411060;201803;519;349;170;332937.0;162180.0;495117.0
411065;201803;61;53;8;50562.0;7632.0;58194.0
411070;201803;1196;796;400;753877.3;380646.0;1134523.2
411080;201803;243;171;72;163218.0;68688.0;231906.0
411090;201803;118;89;29;84906.0;27666.0;112572.0
411095;201803;263;106;157;100647.0;149768.0;250415.0
411100;201803;113;94;19;89676.0;18126.0;107802.0
411110;201803;121;83;38;79182.0;36252.0;115434.0
411120;201803;183;137;46;130698.0;43884.0;174582.0
411125;201803;182;81;101;76625.28;96354.0;172979.28
411130;201803;125;107;18;101440.0;16885.8;118325.8
411140;201803;180;125;55;119228.12;51945.3;171173.42
411150;201803;1217;816;401;777786.7;382554.0;1160340.6
411155;201803;120;84;36;80136.0;34344.0;114480.0
411160;201803;21;10;11;9540.0;10494.0;20034.0
411170;201803;58;52;6;49321.8;5724.0;55045.8
411180;201803;938;616;322;586138.0;307183.22;893321.25
411190;201803;343;198;145;188224.2;138330.0;326554.2
411200;201803;671;445;226;423259.88;214697.9;637957.8
411210;201803;683;365;318;346660.22;303372.0;650032.2
411220;201803;147;111;36;105894.0;34344.0;140238.0
411230;201803;40;36;4;34344.0;3816.0;38160.0
411240;201803;118;80;38;76320.0;36252.0;112572.0
411250;201803;418;305;113;290970.0;107802.0;398772.0
411260;201803;21;15;6;14310.0;5724.0;20034.0
411270;201803;298;161;137;153594.0;130698.0;284292.0
411275;201803;202;178;24;169096.6;22896.0;191992.6
411280;201803;230;163;67;154231.12;63918.0;218149.12
411290;201803;58;43;15;41022.0;14310.0;55332.0
411295;201803;143;114;29;108756.0;27666.0;136422.0
411300;201803;70;36;34;34344.0;32436.0;66780.0
411310;201803;90;69;21;65826.0;20034.0;85860.0
411320;201803;757;548;209;521266.4;197783.28;719049.7
411325;201803;44;27;17;25758.0;16218.0;41976.0
411330;201803;919;584;335;555610.6;318859.6;874470.2
411340;201803;25;17;8;16218.0;7318.0;23536.0
411342;201803;76;55;21;52470.0;20034.0;72504.0
411345;201803;126;63;63;60102.0;60102.0;120204.0
411350;201803;480;382;98;363140.44;92529.2;455669.62
411360;201803;54;35;19;33390.0;18126.0;51516.0
411370;201803;14096;5785;8311;5501301.5;7914930.5;1,34E+14
411373;201803;190;140;50;133499.0;47700.0;181199.0
411375;201803;72;60;12;57240.0;11448.0;68688.0
411380;201803;96;71;25;67734.0;23850.0;91584.0
411390;201803;137;91;46;86814.0;43884.0;130698.0
411400;201803;349;262;87;249939.0;82998.0;332937.0
411410;201803;448;230;218;218752.2;207686.0;426438.2
411420;201803;1025;468;557;444182.4;530877.06;975059.5
411430;201803;406;263;143;250234.2;136413.0;386647.2
411435;201803;35;23;12;21942.0;11448.0;33390.0
411440;201803;472;376;96;357050.75;91584.0;448634.75
411450;201803;429;356;73;339624.0;69642.0;409266.0
411460;201803;750;300;450;285255.2;428017.97;713273.2
411470;201803;87;63;24;60102.0;22896.0;82998.0
411480;201803;628;356;272;338098.6;258915.6;597014.2
411490;201803;290;179;111;170766.0;105894.0;276660.0
411500;201803;112;95;17;90426.33;15837.0;106263.33
411510;201803;219;176;43;167156.06;41022.0;208178.06
411520;201803;5912;2308;3604;2196883.5;3429510.8;5626394.5
411530;201803;111;75;36;71550.0;34344.0;105894.0
411535;201803;45;18;27;17172.0;25758.0;42930.0
411540;201803;347;242;105;229845.9;100170.0;330015.9
411545;201803;55;39;16;37206.0;15264.0;52470.0
411550;201803;75;58;17;55332.0;16218.0;71550.0
411560;201803;384;181;203;172010.38;193662.0;365672.38
411570;201803;785;298;487;283997.0;464408.0;748405.0
411573;201803;33;20;13;19080.0;12402.0;31482.0
411575;201803;264;163;101;155502.0;96354.0;251856.0
411580;201803;1243;489;754;465199.03;717468.4;1182667.4
411585;201803;80;40;40;38160.0;38160.0;76320.0
411590;201803;24;17;7;16218.0;6678.0;22896.0
411600;201803;26;10;16;9540.0;15264.0;24804.0
411605;201803;247;109;138;103735.0;131652.0;235387.0
411610;201803;239;161;78;153594.0;74412.0;228006.0
411620;201803;356;199;157;189655.2;149139.0;338794.2
411630;201803;58;38;20;36252.0;19080.0;55332.0
411640;201803;36;30;6;28620.0;5724.0;34344.0
411650;201803;12;9;3;8586.0;2862.0;11448.0
411660;201803;31;25;6;23850.0;5724.0;29574.0
411670;201803;247;188;59;179352.0;56286.0;235638.0
411680;201803;155;133;22;126882.0;20988.0;147870.0
411690;201803;606;321;285;305635.44;271547.84;577183.25
411695;201803;63;47;16;44838.0;15264.0;60102.0
411700;201803;164;142;22;135468.0;20988.0;156456.0
411705;201803;100;65;35;62010.0;33390.0;95400.0
411710;201803;299;201;98;190687.81;93492.0;284179.8
411720;201803;140;89;51;84906.0;48654.0;133560.0
411721;201803;58;48;10;45792.0;9540.0;55332.0
411722;201803;99;43;56;41022.0;53424.0;94446.0
411725;201803;147;113;34;107486.0;32436.0;139922.0
411727;201803;72;56;16;53424.0;14977.8;68401.8
411729;201803;32;25;7;23850.0;6678.0;30528.0
411730;201803;546;353;193;335171.97;183835.8;519007.75
411740;201803;30;19;11;18126.0;10494.0;28620.0
411745;201803;68;45;23;42139.0;21942.0;64081.0
411750;201803;871;412;459;391951.9;436908.16;828860.06
411760;201803;1178;891;287;848765.2;273789.0;1122554.2
411770;201803;439;291;148;277594.9;141192.0;418786.9
411780;201803;369;237;132;226098.0;125928.0;352026.0
411790;201803;530;299;231;283364.47;220261.14;503625.62
411800;201803;173;137;36;130698.0;34344.0;165042.0
411810;201803;166;128;38;122112.0;36252.0;158364.0
411820;201803;2094;1022;1072;972679.5;1021964.3;1994643.9
411830;201803;12;12;0;11448.0;0.0;11448.0
411840;201803;1965;1226;739;1167409.8;704513.0;1871922.8
411845;201803;49;18;31;17172.0;29574.0;46746.0
411850;201803;1242;713;529;678666.06;502713.03;1181379.1
411860;201803;44;28;16;26426.0;15264.0;41690.0
411870;201803;72;52;20;49608.0;18793.8;68401.8
411880;201803;426;274;152;261282.0;144263.88;405545.88
411885;201803;104;69;35;65826.0;33390.0;99216.0
411890;201803;320;205;115;194330.45;109700.46;304030.9
411900;201803;69;50;19;47700.0;18126.0;65826.0
411910;201803;170;140;30;133550.45;27780.48;161330.94
411915;201803;2114;910;1204;866987.56;1147552.0;2014539.6
411920;201803;126;104;22;99216.0;20988.0;120204.0
411925;201803;14;9;5;8586.0;4770.0;13356.0
411930;201803;797;588;209;559046.0;199386.0;758432.0
411940;201803;590;422;168;402111.0;160247.56;562358.56
411950;201803;905;481;424;458206.2;403828.2;862034.4
411960;201803;978;693;285;658219.5;271890.0;930109.5
411965;201803;23;15;8;14310.0;7632.0;21942.0
411970;201803;72;65;7;62010.0;6678.0;68688.0
411980;201803;199;130;69;124020.0;65826.0;189846.0
411990;201803;4939;2870;2069;2721038.5;1971841.2;4692880.0
411995;201803;460;172;288;164088.0;274752.0;438840.0
412000;201803;294;175;119;165758.56;113516.46;279275.03
412010;201803;46;29;17;27666.0;16218.0;43884.0
412015;201803;44;31;13;29574.0;12402.0;41976.0
412020;201803;27;25;2;23563.8;1908.0;25471.8
412030;201803;61;52;9;49608.0;8586.0;58194.0
412033;201803;55;36;19;34320.0;18126.0;52446.0
412035;201803;66;43;23;41022.0;21942.0;62964.0
412040;201803;36;25;11;23564.0;10494.0;34058.0
412050;201803;201;150;51;143100.0;48654.0;191754.0
412060;201803;747;586;161;556182.75;152603.8;708786.56
412065;201803;51;35;16;33390.0;15264.0;48654.0
412070;201803;154;103;51;97594.2;48654.0;146248.2
412080;201803;279;145;134;138330.0;127836.0;266166.0
412085;201803;33;16;17;15264.0;16218.0;31482.0
412090;201803;743;466;277;442895.2;264258.0;707153.2
412100;201803;249;209;40;198433.0;38160.0;236593.0
412110;201803;71;57;14;54378.0;13069.8;67447.8
412120;201803;312;204;108;194043.6;103032.0;297075.6
412125;201803;78;46;32;43597.8;30528.0;74125.8
412130;201803;47;35;12;33390.0;11448.0;44838.0
412135;201803;28;15;13;14310.0;12402.0;26712.0
412140;201803;308;219;89;208286.81;84906.0;293192.8
412150;201803;260;176;84;166950.05;80136.0;247086.05
412160;201803;83;48;35;45792.0;33390.0;79182.0
412170;201803;639;452;187;430921.8;178398.0;609319.8
412175;201803;39;29;10;27666.0;9540.0;37206.0
412180;201803;198;158;40;150132.61;37539.9;187672.52
412190;201803;329;264;65;251183.44;62010.0;313193.44
412200;201803;190;122;68;116388.0;64872.0;181260.0
412210;201803;72;56;16;53424.0;15264.0;68688.0
412215;201803;241;167;74;159032.0;70309.8;229341.8
412217;201803;71;55;16;52470.0;15264.0;67734.0
412220;201803;828;621;207;592434.0;197478.0;789912.0
412230;201803;337;205;132;193948.2;125891.46;319839.66
412240;201803;1322;647;675;613068.0;641869.44;1254937.5
412250;201803;381;247;134;235638.0;127836.0;363474.0
412260;201803;126;93;33;88722.0;31482.0;120204.0
412265;201803;167;133;34;126277.84;32436.0;158713.84
412270;201803;84;52;32;49608.0;30528.0;80136.0
412280;201803;90;71;19;67734.0;18126.0;85860.0
412290;201803;92;63;29;60102.0;27666.0;87768.0
412300;201803;216;139;77;132606.0;73314.9;205920.9
412310;201803;43;36;7;34344.0;6678.0;41022.0
412320;201803;94;80;14;76320.0;13356.0;89676.0
412330;201803;168;150;18;143100.0;17172.0;160272.0
412340;201803;144;100;44;95400.0;41690.0;137090.0
412350;201803;599;301;298;285866.3;284292.0;570158.3
412360;201803;27;24;3;22896.0;2862.0;25758.0
412370;201803;159;136;23;128790.0;21942.0;150732.0
412380;201803;255;193;62;183835.8;58738.5;242574.3
412382;201803;47;25;22;23850.0;20988.0;44838.0
412385;201803;139;100;39;95400.0;37206.0;132606.0
412390;201803;277;208;69;198432.0;65826.0;264258.0
412395;201803;66;52;14;49608.0;13356.0;62964.0
412400;201803;69;50;19;47700.0;18126.0;65826.0
412402;201803;245;114;131;108751.23;124687.8;233439.03
412405;201803;822;328;494;310214.22;470599.66;780813.9
412410;201803;935;587;348;558472.0;331992.0;890464.0
412420;201803;15;12;3;11448.0;2862.0;14310.0
412430;201803;21;14;7;13356.0;6678.0;20034.0
412440;201803;596;322;274;304875.94;259531.95;564407.9
412450;201803;84;70;14;66780.0;13356.0;80136.0
412460;201803;81;64;17;61056.0;16218.0;77274.0
412470;201803;260;206;54;195760.8;51516.0;247276.8
412480;201803;173;132;41;124974.9;39114.0;164088.9
412490;201803;166;140;26;133560.0;24804.0;158364.0
412500;201803;476;388;88;368291.8;83952.0;452243.8
412510;201803;186;152;34;144261.0;32436.0;176697.0
412520;201803;136;74;62;70596.0;59148.0;129744.0
412530;201803;108;58;50;55332.0;47413.8;102745.8
412535;201803;108;80;28;76302.0;26712.0;103014.0
412540;201803;63;31;32;29574.0;30528.0;60102.0
412545;201803;100;73;27;69642.0;25758.0;95400.0
412550;201803;3511;1578;1933;1501414.8;1841984.9;3343399.8
412555;201803;14;9;5;8586.0;4770.0;13356.0
412560;201803;590;443;147;420032.2;140238.0;560270.2
412570;201803;735;413;322;392151.25;306902.0;699053.25
412575;201803;81;56;25;53424.0;23850.0;77274.0
412580;201803;162;110;52;104940.0;49608.0;154548.0
412590;201803;34;32;2;30528.0;1908.0;32436.0
412600;201803;174;132;42;125928.0;40068.0;165996.0
412610;201803;31;19;12;18126.0;11448.0;29574.0
412620;201803;147;129;18;123066.0;17172.0;140238.0
412625;201803;2190;1178;1012;1121010.2;963570.56;2084580.8
412627;201803;68;55;13;52470.0;12402.0;64872.0
412630;201803;427;287;140;272265.2;133274.0;405539.2
412635;201803;64;19;45;18126.0;42930.0;61056.0
412640;201803;118;79;39;75366.0;37206.0;112572.0
412650;201803;343;214;129;203869.8;123061.23;326931.03
412660;201803;488;297;191;282623.0;182214.0;464837.0
412665;201803;51;45;6;42930.0;5724.0;48654.0
412667;201803;286;194;92;184191.81;87452.92;271644.72
412670;201803;61;52;9;49608.0;8586.0;58194.0
412680;201803;290;228;62;217512.0;59148.0;276660.0
412690;201803;115;74;41;70596.0;38828.0;109424.0
412700;201803;168;114;54;108756.0;51230.0;159986.0
412710;201803;1408;874;534;827788.6;507008.0;1334796.6
412720;201803;230;159;71;151686.0;67734.0;219420.0
412730;201803;205;162;43;154548.0;40068.0;194616.0
412740;201803;416;223;193;212598.9;184122.0;396720.9
412750;201803;463;267;196;253764.0;186984.0;440748.0
412760;201803;256;130;126;124020.0;120204.0;244224.0
412770;201803;2101;1192;909;1132785.0;865642.2;1998427.1
412780;201803;152;121;31;115434.0;29574.0;145008.0
412785;201803;269;135;134;128313.0;127836.0;256149.0
412788;201803;34;20;14;19080.0;13356.0;32436.0
412790;201803;142;116;26;109996.2;24804.0;134800.2
412795;201803;156;117;39;111618.0;37206.0;148824.0
412796;201803;301;209;92;198221.19;87634.44;285855.62
412800;201803;561;369;192;351466.38;183168.0;534634.4
412810;201803;2997;1664;1333;1581905.2;1270437.0;2852342.2
412820;201803;924;605;319;566618.75;303133.88;869752.6
412830;201803;16;13;3;12402.0;2862.0;15264.0
412840;201803;216;154;62;145962.2;59148.0;205110.2
412850;201803;782;535;247;508195.8;235638.0;743833.8
412853;201803;169;90;79;85860.0;75366.0;161226.0
412855;201803;212;117;95;110506.82;90630.0;201136.81
412860;201803;92;68;24;64872.0;22896.0;87768.0
412862;201803;59;44;15;41689.8;14310.0;55999.8
412863;201803;6;5;1;4770.0;954.0;5724.0
412865;201803;42;31;11;29574.0;10494.0;40068.0
412870;201803;108;72;36;68688.0;34344.0;103032.0
412880;201803;103;77;26;73458.0;24804.0;98262.0
420005;201803;35;32;3;30528.0;2290.0;32818.0
420010;201803;367;240;127;227772.34;121158.0;348930.34
420020;201803;76;64;12;61056.0;11448.0;72504.0
420030;201803;28;25;3;23850.0;2862.0;26712.0
420040;201803;105;80;25;76320.0;23850.0;100170.0
420050;201803;56;34;22;32436.0;20988.0;53424.0
420055;201803;20;19;1;18126.0;954.0;19080.0
420060;201803;32;23;9;21942.0;8586.0;30528.0
420070;201803;100;86;14;82044.0;13346.46;95390.46
420075;201803;13;11;2;10494.0;1908.0;12402.0
420080;201803;48;42;6;39161.7;5724.0;44885.7
420090;201803;35;33;2;30704.49;1908.0;32612.49
420100;201803;159;133;26;125928.2;24804.0;150732.2
420110;201803;18;18;0;17172.0;0.0;17172.0
420120;201803;45;34;11;32436.0;10494.0;42930.0
420125;201803;82;65;17;62010.0;16218.0;78228.0
420127;201803;35;31;4;29574.0;3816.0;33390.0
420130;201803;386;247;139;235342.45;132357.95;367700.4
420140;201803;1268;743;525;707497.4;500784.0;1208281.4
420150;201803;47;40;7;38160.0;6678.0;44838.0
420160;201803;39;37;2;35298.0;1908.0;37206.0
420165;201803;19;14;5;13356.0;4770.0;18126.0
420170;201803;63;41;22;39114.0;20988.0;60102.0
420180;201803;22;21;1;20034.0;954.0;20988.0
420190;201803;31;28;3;26712.0;2862.0;29574.0
420195;201803;126;60;66;57240.0;62824.0;120064.0
420200;201803;1270;567;703;536911.6;669338.06;1206249.6
420205;201803;69;36;33;34344.0;31482.0;65826.0
420207;201803;108;62;46;59148.0;43874.46;103022.46
420208;201803;23;18;5;17172.0;3911.4;21083.4
420209;201803;20;16;4;15264.0;3816.0;19080.0
420210;201803;464;220;244;209593.8;232681.14;442274.94
420213;201803;46;37;9;35298.0;8586.0;43884.0
420215;201803;26;22;4;20988.0;3816.0;24804.0
420220;201803;70;45;25;42930.0;23850.0;66780.0
420230;201803;748;429;319;408503.0;304030.47;712533.44
420240;201803;2280;1541;739;1462290.9;704567.2;2166858.0
420243;201803;36;29;7;27666.0;6678.0;34344.0
420245;201803;103;58;45;55332.0;42930.0;98262.0
420250;201803;54;31;23;29574.0;21942.0;51516.0
420253;201803;40;32;8;30528.0;7632.0;38160.0
420257;201803;11;9;2;8586.0;1908.0;10494.0
420260;201803;99;87;12;82998.0;11448.0;94446.0
420270;201803;37;30;7;28616.0;6678.0;35294.0
420280;201803;279;205;74;193846.06;69338.1;263184.16
420285;201803;20;12;8;11448.0;7632.0;19080.0
420287;201803;50;31;19;29574.0;18126.0;47700.0
420290;201803;974;685;289;652504.2;275638.3;928142.5
420300;201803;1381;1088;293;1033374.4;277328.34;1310702.8
420310;201803;59;45;14;42930.0;13356.0;56286.0
420315;201803;35;31;4;29574.0;3816.0;33390.0
420320;201803;848;430;418;409242.16;398768.0;808010.1
420325;201803;0;0;0;0.0;0.0;0.0
420330;201803;119;81;38;77274.0;36137.52;113411.52
420340;201803;156;107;49;101116.0;46726.92;147842.92
420350;201803;246;180;66;170099.0;62964.0;233063.0
420360;201803;752;574;178;545670.2;168191.78;713861.94
420370;201803;109;70;39;66590.0;36920.0;103510.0
420380;201803;1149;822;327;780364.5;310921.03;1091285.5
420390;201803;253;163;90;154243.52;85144.5;239388.02
420395;201803;185;133;52;126882.0;49598.46;176480.45
420400;201803;246;182;64;173056.0;61056.0;234112.0
420410;201803;57;44;13;41976.0;12402.0;54378.0
420415;201803;35;32;3;30528.0;2862.0;33390.0
420417;201803;47;35;12;33390.0;11428.92;44818.92
420419;201803;11;11;0;10494.0;0.0;10494.0
420420;201803;2789;1708;1081;1617444.2;1028700.44;2646144.8
420425;201803;71;60;11;57231.0;10180.26;67411.26
420430;201803;1274;885;389;841298.75;369360.2;1210658.9
420435;201803;16;14;2;13356.0;1908.0;15264.0
420440;201803;107;74;33;69968.68;31330.6;101299.28
420445;201803;22;20;2;19080.0;1908.0;20988.0
420450;201803;80;38;42;36243.0;40068.0;76311.0
420455;201803;249;189;60;180277.92;57148.38;237426.3
420460;201803;2341;1560;781;1483555.5;744849.9;2228405.5
420470;201803;120;85;35;81090.0;33390.0;114480.0
420475;201803;6;6;0;5724.0;0.0;5724.0
420480;201803;848;631;217;596518.1;206064.2;802582.3
420490;201803;113;88;25;83952.0;23850.0;107802.0
420500;201803;677;286;391;271159.2;373014.0;644173.2
420510;201803;20;17;3;16218.0;2862.0;19080.0
420515;201803;25;20;5;19080.0;4770.0;23850.0
420517;201803;12;12;0;11448.0;0.0;11448.0
420519;201803;0;0;0;0.0;0.0;0.0
420520;201803;66;49;17;46746.0;16218.0;62964.0
420530;201803;162;110;52;103965.02;49608.0;153573.02
420535;201803;20;18;2;17172.0;1908.0;19080.0
420540;201803;4815;2842;1973;2698881.2;1877607.0;4576488.5
420543;201803;23;23;0;21942.0;0.0;21942.0
420545;201803;194;138;56;130698.0;53404.92;184102.92
420550;201803;843;676;167;642959.3;159160.73;802120.06
420555;201803;41;29;12;27666.0;11448.0;39114.0
420560;201803;62;49;13;46364.4;12402.0;58766.4
420570;201803;142;79;63;75366.0;60092.46;135458.45
420580;201803;300;133;167;126882.0;159032.0;285914.0
420590;201803;509;359;150;342199.8;143100.0;485299.8
420600;201803;93;48;45;45792.0;42930.0;88722.0
420610;201803;37;35;2;33104.0;1908.0;35012.0
420620;201803;73;59;14;56286.0;13356.0;69642.0
420630;201803;152;111;41;105885.23;39110.0;144995.23
420640;201803;94;83;11;78991.2;10494.0;89485.2
420650;201803;241;129;112;122398.2;106229.23;228627.44
420660;201803;55;41;14;38350.8;13356.0;51706.8
420665;201803;38;29;9;27380.0;8586.0;35966.0
420670;201803;321;242;79;230142.95;75347.46;305490.4
420675;201803;15;14;1;13356.0;954.0;14310.0
420680;201803;36;26;10;24804.0;9540.0;34344.0
420690;201803;176;146;30;139284.0;28620.0;167904.0
420700;201803;626;429;197;409182.3;187705.44;596887.75
420710;201803;147;86;61;82044.0;57907.8;139951.8
420720;201803;107;87;20;82998.0;19080.0;102078.0
420730;201803;535;342;193;325210.5;182827.12;508037.62
420740;201803;45;44;1;41976.0;954.0;42930.0
420750;201803;494;330;164;314533.8;156456.0;470989.8
420757;201803;18;15;3;13499.1;2862.0;16361.1
420760;201803;38;29;9;27666.0;8586.0;36252.0
420765;201803;72;59;13;56286.0;12402.0;68688.0
420768;201803;67;59;8;56286.0;7632.0;63918.0
420770;201803;85;71;14;67734.0;13356.0;81090.0
420775;201803;49;46;3;42930.0;2862.0;45792.0
420780;201803;238;186;52;177434.45;49608.0;227042.45
420785;201803;14;10;4;9540.0;3816.0;13356.0
420790;201803;180;149;31;141805.8;28592.46;170398.27
420800;201803;78;59;19;55522.8;18126.0;73648.8
420810;201803;250;214;36;204147.0;33533.1;237680.1
420820;201803;2309;1379;930;1309212.6;885692.2;2194904.8
420830;201803;563;315;248;297561.84;235628.45;533190.3
420840;201803;144;109;35;103986.0;32686.0;136672.0
420845;201803;450;199;251;189175.06;238214.0;427389.06
420850;201803;230;183;47;174582.0;44838.0;219420.0
420860;201803;62;53;9;50562.0;8586.0;59148.0
420870;201803;120;87;33;82998.0;31482.0;114480.0
420880;201803;172;120;52;113802.66;49608.0;163410.66
420890;201803;862;426;436;404268.84;415649.0;819917.8
420895;201803;10;10;0;9540.0;0.0;9540.0
420900;201803;421;329;92;311807.03;87739.92;399546.97
420910;201803;5827;3266;2561;3105041.2;2438211.8;5543253.0
420915;201803;80;73;7;69642.0;6678.0;76320.0
420917;201803;18;13;5;12402.0;4770.0;17172.0
420920;201803;24;16;8;15264.0;7632.0;22896.0
420930;201803;2630;1600;1030;1517831.0;976731.44;2494562.5
420940;201803;599;438;161;416507.6;151942.08;568449.7
420945;201803;8;6;2;5724.0;1908.0;7632.0
420950;201803;55;50;5;47700.0;4770.0;52470.0
420960;201803;113;88;25;83914.92;23841.0;107755.92
420970;201803;303;242;61;229192.84;58166.46;287359.3
420980;201803;26;25;1;23850.0;954.0;24804.0
420985;201803;65;56;9;53424.0;8586.0;62010.0
420990;201803;67;52;15;49608.0;14310.0;63918.0
421000;201803;34;22;12;20988.0;11448.0;32436.0
421003;201803;68;44;24;41976.0;22887.0;64863.0
421005;201803;8;5;3;4770.0;2862.0;7632.0
421010;201803;771;543;228;516773.0;215452.0;732225.0
421020;201803;29;24;5;22896.0;4770.0;27666.0
421030;201803;130;110;20;104607.0;19080.0;123687.0
421040;201803;69;59;10;56286.0;9540.0;65826.0
421050;201803;306;221;85;208735.2;81090.0;289825.2
421055;201803;24;20;4;19080.0;3816.0;22896.0
421060;201803;82;56;26;53424.0;24804.0;78228.0
421070;201803;51;46;5;43884.0;4770.0;48654.0
421080;201803;36;32;4;30528.0;3816.0;34344.0
421085;201803;25;20;5;19080.0;4770.0;23850.0
421090;201803;42;32;10;30528.0;9540.0;40068.0
421100;201803;127;94;33;89676.0;31482.0;121158.0
421105;201803;218;177;41;168428.8;39090.69;207519.48
421110;201803;109;89;20;84285.9;19080.0;103365.9
421120;201803;151;118;33;112076.46;31462.92;143539.38
421125;201803;14;10;4;9540.0;3816.0;13356.0
421130;201803;806;519;287;493996.06;272758.53;766754.56
421140;201803;31;22;9;20272.5;8586.0;28858.5
421145;201803;39;31;8;29574.0;7632.0;37206.0
421150;201803;108;78;30;74412.0;28620.0;103032.0
421160;201803;61;40;21;38150.46;20034.0;58184.46
421165;201803;20;18;2;17172.0;1908.0;19080.0
421170;201803;192;166;26;157336.84;24795.0;182131.84
421175;201803;150;98;52;93492.0;49569.92;143061.92
421180;201803;56;35;21;33028.0;20034.0;53062.0
421185;201803;17;14;3;13356.0;2862.0;16218.0
421187;201803;0;0;0;0.0;0.0;0.0
421189;201803;38;30;8;28620.0;7622.46;36242.46
421190;201803;1500;924;576;880534.0;548807.56;1429341.6
421200;201803;88;66;22;62010.7;20988.0;82998.7
421205;201803;24;16;8;15264.0;7622.46;22886.46
421210;201803;179;121;58;115434.0;55332.0;170766.0
421220;201803;275;219;56;208059.9;53424.0;261483.9
421223;201803;55;46;9;43884.0;8586.0;52470.0
421225;201803;61;43;18;41022.0;17172.0;58194.0
421227;201803;95;72;23;68688.0;21942.0;90630.0
421230;201803;49;36;13;34344.0;12402.0;46746.0
421240;201803;18;18;0;17172.0;0.0;17172.0
421250;201803;357;221;136;209500.0;128952.18;338452.2
421260;201803;28;23;5;21942.0;4770.0;26712.0
421265;201803;0;0;0;0.0;0.0;0.0
421270;201803;52;46;6;43884.0;5724.0;49608.0
421280;201803;335;188;147;179066.0;138520.8;317586.8
421290;201803;319;213;106;202964.0;99713.76;302677.75
421300;201803;25;20;5;19080.0;4770.0;23850.0
421310;201803;54;41;13;38446.2;12402.0;50848.2
421315;201803;28;20;8;19080.0;7632.0;26712.0
421320;201803;131;94;37;89676.0;35298.0;124974.0
421330;201803;110;86;24;79639.92;22887.0;102526.92
421335;201803;40;26;14;24804.0;13356.0;38160.0
421340;201803;292;198;94;187128.05;89676.0;276804.06
421350;201803;178;104;74;98773.0;70596.0;169369.0
421360;201803;691;508;183;478989.72;174373.45;653363.2
421370;201803;190;145;45;138330.0;42596.1;180926.1
421380;201803;131;105;26;100165.23;24804.0;124969.23
421390;201803;19;15;4;14310.0;3816.0;18126.0
421400;201803;112;94;18;89676.0;17172.0;106848.0
421410;201803;23;18;5;17172.0;4770.0;21942.0
421415;201803;23;22;1;20988.0;954.0;21942.0
421420;201803;148;122;26;115815.6;24517.8;140333.4
421430;201803;14;11;3;10494.0;2862.0;13356.0
421440;201803;57;44;13;41976.0;12402.0;54378.0
421450;201803;98;85;13;81090.0;12402.0;93492.0
421460;201803;58;49;9;45941.77;8586.0;54527.77
421470;201803;69;45;24;42930.0;22896.0;65826.0
421480;201803;635;470;165;447903.0;157401.0;605304.0
421490;201803;22;21;1;19358.0;954.0;20312.0
421500;201803;515;331;184;314686.7;175248.9;489935.6
421505;201803;24;18;6;17172.0;5724.0;22896.0
421507;201803;33;27;6;25758.0;5724.0;31482.0
421510;201803;72;46;26;43884.0;24422.4;68306.4
421520;201803;66;57;9;53615.0;8586.0;62201.0
421530;201803;53;48;5;45792.0;4770.0;50562.0
421535;201803;28;27;1;25491.0;954.0;26445.0
421540;201803;60;52;8;49608.0;7632.0;57240.0
421545;201803;97;76;21;72018.0;20034.0;92052.0
421550;201803;286;208;78;197765.0;74412.0;272177.0
421555;201803;27;22;5;20988.0;4675.0;25663.0
421560;201803;8;7;1;6678.0;954.0;7632.0
421565;201803;123;90;33;85860.0;31482.0;117342.0
421567;201803;30;25;5;23850.0;4770.0;28620.0
421568;201803;34;32;2;30528.0;1908.0;32436.0
421569;201803;8;8;0;7632.0;0.0;7632.0
421570;201803;138;94;44;89676.0;41976.0;131652.0
421575;201803;27;22;5;20725.65;4770.0;25495.65
421580;201803;713;430;283;408884.34;269028.34;677912.7
421590;201803;20;19;1;18126.0;954.0;19080.0
421600;201803;109;75;34;71550.0;31197.0;102747.0
421605;201803;102;72;30;68355.0;28620.0;96975.0
421610;201803;187;148;39;139999.5;37206.0;177205.5
421620;201803;1106;661;445;628094.94;424510.9;1052605.9
421625;201803;21;18;3;17172.0;2862.0;20034.0
421630;201803;278;179;99;169955.8;93588.0;263543.8
421635;201803;16;8;8;7632.0;7632.0;15264.0
421640;201803;101;87;14;82998.0;13356.0;96354.0
421650;201803;276;161;115;153574.92;109690.92;263265.84
421660;201803;2095;1256;839;1195021.2;800092.25;1995113.5
421670;201803;181;129;52;123066.0;49608.0;172674.0
421680;201803;167;152;15;145008.0;14301.0;159309.0
421690;201803;353;243;110;230841.0;103976.58;334817.6
421700;201803;58;36;22;34344.0;20130.0;54474.0
421710;201803;24;24;0;22896.0;0.0;22896.0
421715;201803;11;10;1;9540.0;954.0;10494.0
421720;201803;588;426;162;403787.4;152821.27;556608.7
421725;201803;14;7;7;6678.0;6678.0;13356.0
421730;201803;44;30;14;27912.12;13356.0;41268.12
421740;201803;85;41;44;39114.0;41976.0;81090.0
421750;201803;218;161;57;151148.7;54378.0;205526.7
421755;201803;24;23;1;21942.0;954.0;22896.0
421760;201803;100;71;29;67724.46;27666.0;95390.46
421770;201803;566;381;185;361276.38;176433.3;537709.7
421775;201803;26;17;9;16218.0;8586.0;24804.0
421780;201803;195;153;42;145962.0;40068.0;186030.0
421790;201803;155;130;25;123127.5;23850.0;146977.5
421795;201803;17;14;3;13356.0;2862.0;16218.0
421800;201803;464;301;163;286357.3;155498.0;441855.3
421810;201803;67;54;13;51516.0;12402.0;63918.0
421820;201803;302;207;95;196810.2;90630.0;287440.2
421825;201803;126;105;21;100170.0;20034.0;120204.0
421830;201803;125;96;29;91584.0;27666.0;119250.0
421835;201803;3;3;0;2862.0;0.0;2862.0
421840;201803;61;51;10;48358.8;9540.0;57898.8
421850;201803;76;66;10;62964.0;9536.0;72500.0
421860;201803;40;32;8;30528.0;7632.0;38160.0
421870;201803;977;739;238;696104.6;226219.42;922324.06
421875;201803;52;46;6;43884.0;5724.0;49608.0
421880;201803;161;117;44;111618.0;41690.0;153308.0
421885;201803;28;23;5;21942.0;4770.0;26712.0
421890;201803;111;78;33;74412.0;31482.0;105894.0
421895;201803;39;36;3;34344.0;2862.0;37206.0
421900;201803;151;124;27;117935.3;25713.0;143648.3
421910;201803;64;42;22;40068.0;20988.0;61056.0
421915;201803;32;26;6;24804.0;5724.0;30528.0
421917;201803;38;28;10;26712.0;9540.0;36252.0
421920;201803;34;30;4;28620.0;3816.0;32436.0
421930;201803;743;575;168;546237.25;160245.0;706482.25
421935;201803;57;50;7;47700.0;6678.0;54378.0
421940;201803;39;37;2;35298.0;1908.0;37206.0
421950;201803;822;542;280;511149.1;264623.44;775772.56
421960;201803;39;35;4;33104.0;3816.0;36920.0
421970;201803;374;235;139;223691.12;132575.12;356266.25
421985;201803;30;20;10;19080.0;9540.0;28620.0
422000;201803;0;0;0;0.0;0.0;0.0
430003;201803;204;48;156;45076.5;148824.0;193900.5
430005;201803;36;28;8;26712.0;7632.0;34344.0
430010;201803;278;196;82;186507.0;78228.0;264735.0
430020;201803;151;98;53;93206.0;49608.0;142814.0
430030;201803;128;100;28;95113.8;26712.0;121825.8
430040;201803;2976;1731;1245;1643328.2;1186100.2;2829428.5
430045;201803;68;58;10;55046.0;9540.0;64586.0
430047;201803;6;5;1;4770.0;954.0;5724.0
430050;201803;81;68;13;64872.0;12402.0;77274.0
430055;201803;17;14;3;13356.0;2862.0;16218.0
430057;201803;4;2;2;1908.0;1908.0;3816.0
430060;201803;3679;2195;1484;2086786.8;1412238.6;3499025.2
430063;201803;57;52;5;49608.0;4770.0;54378.0
430064;201803;148;124;24;118296.0;22896.0;141192.0
430066;201803;10;7;3;6678.0;2862.0;9540.0
430070;201803;43;33;10;31482.0;9540.0;41022.0
430080;201803;68;47;21;44138.33;20034.0;64172.33
430085;201803;37;11;26;10494.0;24804.0;35298.0
430087;201803;33;25;8;23707.0;7632.0;31339.0
430090;201803;72;65;7;61723.8;6678.0;68401.8
430100;201803;118;78;40;73458.0;38160.0;111618.0
430105;201803;142;70;72;66780.0;68382.72;135162.72
430107;201803;20;15;5;14310.0;4770.0;19080.0
430110;201803;412;239;173;227195.1;164975.22;392170.3
430120;201803;137;125;12;118296.9;11448.0;129744.9
430130;201803;799;503;296;479241.9;282097.8;761339.7
430140;201803;124;114;10;108756.0;9540.0;118296.0
430150;201803;113;74;39;69833.0;36252.0;106085.0
430155;201803;33;30;3;28620.0;2862.0;31482.0
430160;201803;3815;2250;1565;2126068.0;1488936.6;3615004.5
430163;201803;329;146;183;138235.34;174524.77;312760.1
430165;201803;24;16;8;15264.0;7632.0;22896.0
430170;201803;82;74;8;70596.0;7632.0;78228.0
430175;201803;83;65;18;62010.0;16504.2;78514.2
430180;201803;100;80;20;76320.0;18459.9;94779.9
430185;201803;31;23;8;21942.0;7632.0;29574.0
430187;201803;102;43;59;41022.0;55980.8;97002.8
430190;201803;224;126;98;120156.3;92815.46;212971.77
430192;201803;15;14;1;13356.0;954.0;14310.0
430195;201803;13;8;5;7632.0;4770.0;12402.0
430200;201803;165;147;18;139570.2;17172.0;156742.2
430205;201803;20;19;1;18126.0;954.0;19080.0
430210;201803;630;489;141;462785.4;132653.9;595439.3
430215;201803;15;11;4;10494.0;3816.0;14310.0
430220;201803;65;45;20;42930.0;19080.0;62010.0
430222;201803;14;7;7;6678.0;6678.0;13356.0
430223;201803;15;8;7;7632.0;6678.0;14310.0
430225;201803;4;3;1;2862.0;954.0;3816.0
430230;201803;301;186;115;176490.0;109710.0;286200.0
430235;201803;53;39;14;37206.0;13346.46;50552.46
430237;201803;30;22;8;20988.0;7632.0;28620.0
430240;201803;131;84;47;79945.2;44838.0;124783.2
430245;201803;71;60;11;57240.0;10494.0;67734.0
430250;201803;191;109;82;103976.46;78218.46;182194.92
430258;201803;13;11;2;10494.0;1908.0;12402.0
430260;201803;35;30;5;28620.0;4760.46;33380.46
430265;201803;34;29;5;27646.92;4770.0;32416.92
430270;201803;558;413;145;390612.53;137473.02;528085.56
430280;201803;1035;629;406;596431.25;384824.6;981255.9
430290;201803;374;217;157;205110.8;149778.0;354888.8
430300;201803;2112;1171;941;1111345.1;894654.8;2005999.9
430310;201803;1964;1038;926;983204.4;880352.9;1863557.2
430320;201803;49;41;8;39099.69;7632.0;46731.69
430330;201803;99;89;10;84429.0;9520.92;93949.92
430340;201803;65;58;7;55332.0;6678.0;62010.0
430350;201803;1665;1154;511;1089440.4;484786.53;1574226.9
430355;201803;26;23;3;21942.0;2862.0;24804.0
430360;201803;79;39;40;37206.0;37873.8;75079.8
430367;201803;27;19;8;18126.0;7632.0;25758.0
430370;201803;53;46;7;43884.0;6678.0;50562.0
430380;201803;132;100;32;94827.6;30528.0;125355.6
430390;201803;618;384;234;366049.8;222931.45;588981.25
430400;201803;135;105;30;98452.8;28600.92;127053.72
430410;201803;60;47;13;44838.0;12402.0;57240.0
430420;201803;491;322;169;304708.8;158680.16;463388.97
430430;201803;55;52;3;48972.63;2862.0;51834.63
430435;201803;159;120;39;113526.0;36490.5;150016.5
430440;201803;495;329;166;313866.0;158173.2;472039.2
430450;201803;1200;990;210;937878.1;200330.45;1138208.6
430460;201803;5099;2787;2312;2643700.8;2201057.2;4844758.0
430461;201803;17;15;2;14310.0;1908.0;16218.0
430462;201803;10;7;3;6678.0;2862.0;9540.0
430463;201803;1029;545;484;517497.38;461374.56;978871.94
430465;201803;27;15;12;14310.0;11448.0;25758.0
430466;201803;660;479;181;455058.2;172483.2;627541.4
430467;201803;101;59;42;55045.8;40058.46;95104.26
430468;201803;110;69;41;65826.0;38862.91;104688.91
430469;201803;23;17;6;16218.0;5724.0;21942.0
430470;201803;1170;644;526;607610.4;499848.3;1107458.8
430471;201803;48;36;12;34324.92;11448.0;45772.92
430480;201803;92;56;36;52565.4;34334.46;86899.86
430485;201803;6;6;0;5438.0;0.0;5438.0
430490;201803;89;71;18;66923.7;17172.0;84095.7
430495;201803;38;29;9;27666.0;8586.0;36252.0
430500;201803;192;131;61;124974.0;57818.46;182792.45
430510;201803;3081;2050;1031;1950147.8;982687.3;2932835.0
430511;201803;18;18;0;17172.0;0.0;17172.0
430512;201803;136;94;42;89676.0;40068.0;129744.0
430513;201803;54;46;8;43407.0;7632.0;51039.0
430515;201803;32;30;2;28620.0;1908.0;30528.0
430517;201803;169;150;19;142146.0;18106.92;160252.92
430520;201803;365;250;115;237833.0;109681.38;347514.38
430530;201803;89;53;36;50562.0;34344.0;84906.0
430535;201803;476;318;158;303172.44;150708.16;453880.6
430537;201803;10;10;0;9540.0;0.0;9540.0
430540;201803;71;48;23;45792.0;21942.0;67734.0
430543;201803;374;116;258;110664.0;246132.0;356796.0
430544;201803;43;39;4;37206.0;3816.0;41022.0
430545;201803;347;164;183;156437.0;174085.92;330522.9
430550;201803;43;34;9;32436.0;8586.0;41022.0
430558;201803;6;4;2;3816.0;1908.0;5724.0
430560;201803;46;20;26;19080.0;24804.0;43884.0
430570;201803;108;47;61;44838.0;58136.76;102974.76
430580;201803;125;97;28;92538.0;26664.3;119202.3
430583;201803;14;14;0;13356.0;0.0;13356.0
430585;201803;9;4;5;3816.0;4770.0;8586.0
430587;201803;14;8;6;7632.0;5724.0;13356.0
430590;201803;154;126;28;118963.8;26712.0;145675.8
430593;201803;4;4;0;3816.0;0.0;3816.0
430595;201803;17;12;5;11448.0;4770.0;16218.0
430597;201803;51;27;24;25758.0;22896.0;48654.0
430600;201803;215;151;64;144044.45;60769.8;204814.27
430605;201803;160;100;60;95400.0;57230.46;152630.45
430607;201803;26;21;5;20034.0;4770.0;24804.0
430610;201803;1643;770;873;731443.3;827843.75;1559287.1
430613;201803;2;2;0;1908.0;0.0;1908.0
430620;201803;113;81;32;77130.9;30518.46;107649.36
430630;201803;45;41;4;39114.0;3816.0;42930.0
430632;201803;31;26;5;24804.0;4770.0;29574.0
430635;201803;40;36;4;34344.0;3816.0;38160.0
430637;201803;56;31;25;29574.0;23850.0;53424.0
430640;201803;207;114;93;107897.4;88722.0;196619.4
430642;201803;27;25;2;23850.0;1908.0;25758.0
430645;201803;33;29;4;27666.0;3816.0;31482.0
430650;201803;255;205;50;195284.0;47652.3;242936.3
430655;201803;3;3;0;2862.0;0.0;2862.0
430660;201803;970;474;496;450621.9;471657.8;922279.7
430670;201803;71;51;20;48654.0;19080.0;67734.0
430673;201803;75;42;33;40068.0;31482.0;71550.0
430675;201803;13;10;3;9540.0;2862.0;12402.0
430676;201803;486;299;187;284521.03;178327.06;462848.12
430680;201803;249;174;75;163802.0;71550.0;235352.0
430690;201803;525;307;218;291972.25;206316.14;498288.38
430692;201803;7;5;2;4770.0;1908.0;6678.0
430693;201803;144;96;48;91584.0;45782.46;137366.45
430695;201803;71;64;7;60121.08;6678.0;66799.08
430697;201803;59;35;24;33390.0;22896.0;56286.0
430700;201803;1590;1113;477;1048894.4;455058.0;1503952.4
430705;201803;20;19;1;18126.0;954.0;19080.0
430710;201803;258;167;91;159318.0;86814.0;246132.0
430720;201803;109;92;17;87577.2;16218.0;103795.2
430730;201803;121;102;19;96354.0;18126.0;114480.0
430740;201803;65;42;23;40068.0;21942.0;62010.0
430745;201803;36;29;7;27380.0;6678.0;34058.0
430750;201803;339;229;110;217522.64;103986.0;321508.62
430755;201803;82;46;36;43884.0;34344.0;78228.0
430760;201803;368;223;145;210071.72;138301.92;348373.62
430770;201803;1474;757;717;720060.8;679561.25;1399622.1
430780;201803;312;201;111;190772.72;105827.76;296600.47
430781;201803;29;23;6;21942.0;5724.0;27666.0
430783;201803;50;40;10;37842.13;9540.0;47382.13
430786;201803;6;3;3;2862.0;2862.0;5724.0
430790;201803;489;316;173;300192.12;164746.45;464938.6
430800;201803;152;126;26;120184.92;24804.0;144988.92
430805;201803;42;38;4;36252.0;3816.0;40068.0
430807;201803;35;21;14;20034.0;13356.0;33390.0
430810;201803;74;48;26;45792.0;24804.0;70596.0
430820;201803;136;84;52;80136.0;48940.2;129076.2
430825;201803;13;11;2;10494.0;1908.0;12402.0
430830;201803;233;219;14;208620.92;13356.0;221976.92
430840;201803;125;84;41;80136.0;38446.2;118582.2
430843;201803;5;3;2;2862.0;1908.0;4770.0
430845;201803;69;39;30;37206.0;28620.0;65826.0
430850;201803;570;392;178;372794.6;169680.69;542475.25
430860;201803;156;99;57;93778.2;53700.66;147478.86
430865;201803;63;32;31;29860.2;29259.18;59119.38
430870;201803;78;64;14;61056.0;13356.0;74412.0
430880;201803;159;118;41;112552.92;39114.0;151666.92
430885;201803;7;6;1;5724.0;954.0;6678.0
430890;201803;334;204;130;192956.05;124020.0;316976.03
430900;201803;541;372;169;350690.4;160739.45;511429.88
430905;201803;89;36;53;34344.0;50562.0;84906.0
430910;201803;264;147;117;140238.0;110942.0;251180.0
430912;201803;3;3;0;2862.0;0.0;2862.0
430915;201803;35;27;8;25758.0;7345.8;33103.8
430920;201803;4211;2353;1858;2238072.8;1770130.5;4008203.2
430925;201803;5;4;1;3567.96;954.0;4521.96
430930;201803;2090;1240;850;1175263.5;810653.44;1985916.9
430940;201803;245;151;94;143376.66;89656.92;233033.58
430950;201803;160;130;30;124020.0;28620.0;152640.0
430955;201803;22;14;8;13356.0;7632.0;20988.0
430957;201803;18;17;1;16218.0;954.0;17172.0
430960;201803;237;158;79;148299.3;75366.0;223665.3
430965;201803;103;64;39;61056.0;37206.0;98262.0
430970;201803;78;65;13;62010.0;11448.0;73458.0
430975;201803;34;32;2;30528.0;1908.0;32436.0
430980;201803;44;27;17;25758.0;16218.0;41976.0
430990;201803;113;87;26;82998.0;24804.0;107802.0
430995;201803;113;108;5;101791.8;4770.0;106561.8
431000;201803;294;135;159;126643.2;151686.0;278329.2
431010;201803;339;206;133;195541.38;126882.0;322423.38
431020;201803;1919;1113;806;1053516.2;764812.25;1818328.5
431030;201803;43;34;9;32436.0;8586.0;41022.0
431033;201803;392;194;198;184265.2;188892.0;373157.2
431036;201803;16;9;7;8586.0;6678.0;15264.0
431040;201803;130;78;52;73458.0;49498.29;122956.29
431041;201803;36;24;12;22896.0;11448.0;34344.0
431043;201803;46;27;19;25758.0;18126.0;43884.0
431046;201803;11;6;5;5724.0;4770.0;10494.0
431050;201803;206;132;74;124401.6;69594.3;193995.9
431053;201803;75;44;31;41212.8;29574.0;70786.8
431055;201803;63;42;21;40068.0;20014.92;60082.92
431057;201803;17;17;0;16218.0;0.0;16218.0
431060;201803;1679;1055;624;998954.7;593444.44;1592399.1
431065;201803;18;11;7;10494.0;6678.0;17172.0
431070;201803;72;67;5;63918.0;4770.0;68688.0
431075;201803;8;8;0;7632.0;0.0;7632.0
431080;201803;132;86;46;81757.8;43884.0;125641.8
431085;201803;30;27;3;25758.0;2862.0;28620.0
431087;201803;14;12;2;11448.0;1908.0;13356.0
431090;201803;55;43;12;41022.0;11448.0;52470.0
431100;201803;1228;729;499;684461.3;476046.0;1160507.4
431110;201803;243;152;91;145008.0;86804.46;231812.45
431112;201803;29;17;12;16218.0;11448.0;27666.0
431113;201803;30;20;10;19080.0;9540.0;28620.0
431115;201803;153;105;48;99533.87;45782.46;145316.33
431120;201803;618;363;255;344356.62;243193.84;587550.5
431123;201803;3;2;1;1908.0;954.0;2862.0
431125;201803;91;81;10;77274.0;9540.0;86814.0
431127;201803;7;3;4;2862.0;3816.0;6678.0
431130;201803;624;403;221;383221.8;210528.72;593750.5
431140;201803;731;495;236;468557.4;225067.69;693625.06
431142;201803;34;26;8;23592.0;7632.0;31224.0
431150;201803;205;152;53;145008.0;50552.46;195560.45
431160;201803;56;50;6;47700.0;5724.0;53424.0
431162;201803;19;14;5;13356.0;4770.0;18126.0
431164;201803;4;4;0;3816.0;0.0;3816.0
431170;201803;102;83;19;79182.0;18126.0;97308.0
431171;201803;52;29;23;27666.0;21932.46;49598.46
431173;201803;1;1;0;954.0;0.0;954.0
431175;201803;202;100;102;94160.0;97298.46;191458.45
431177;201803;75;57;18;54378.0;16485.92;70863.92
431179;201803;11;10;1;9540.0;954.0;10494.0
431180;201803;434;262;172;249948.0;164069.45;414017.47
431190;201803;86;65;21;62010.0;20034.0;82044.0
431198;201803;73;48;25;45792.0;23850.0;69642.0
431200;201803;20;17;3;16218.0;2862.0;19080.0
431205;201803;23;23;0;21942.0;0.0;21942.0
431210;201803;88;55;33;52137.0;31482.0;83619.0
431213;201803;28;23;5;21942.0;4770.0;26712.0
431215;201803;27;24;3;22896.0;2862.0;25758.0
431217;201803;5;4;1;3816.0;954.0;4770.0
431220;201803;67;57;10;54378.0;9540.0;63918.0
431225;201803;149;99;50;94437.0;47690.46;142127.45
431230;201803;99;87;12;82998.0;11448.0;94446.0
431235;201803;7;7;0;6678.0;0.0;6678.0
431237;201803;23;15;8;14310.0;7632.0;21942.0
431238;201803;14;10;4;9254.0;3816.0;13070.0
431240;201803;990;635;355;604130.6;338154.84;942285.5
431242;201803;36;36;0;34344.0;0.0;34344.0
431244;201803;11;8;3;7632.0;2862.0;10494.0
431245;201803;60;46;14;43884.0;13356.0;57240.0
431247;201803;14;11;3;10494.0;2862.0;13356.0
431250;201803;269;139;130;132539.22;123333.92;255873.14
431260;201803;62;45;17;42930.0;16218.0;59148.0
431261;201803;21;14;7;13356.0;6678.0;20034.0
431262;201803;15;15;0;14310.0;0.0;14310.0
431265;201803;162;86;76;82044.0;72504.0;154548.0
431267;201803;13;12;1;11448.0;954.0;12402.0
431270;201803;316;265;51;252810.0;48654.0;301464.0
431275;201803;41;39;2;37206.0;1908.0;39114.0
431280;201803;21;17;4;15383.25;3816.0;19199.25
431290;201803;21;18;3;17172.0;2862.0;20034.0
431295;201803;5;5;0;4770.0;0.0;4770.0
431300;201803;20;17;3;16218.0;2862.0;19080.0
431301;201803;7;7;0;6678.0;0.0;6678.0
431303;201803;51;34;17;32311.98;15931.8;48243.78
431306;201803;226;118;108;112115.98;103032.0;215147.98
431308;201803;7;5;2;4770.0;1908.0;6678.0
431310;201803;62;53;9;50562.0;8586.0;59148.0
431320;201803;119;69;50;65826.0;47404.26;113230.26
431330;201803;178;116;62;110664.0;59148.0;169812.0
431333;201803;33;27;6;25758.0;5724.0;31482.0
431335;201803;10;5;5;4770.0;4770.0;9540.0
431337;201803;325;152;173;144178.2;164002.34;308180.53
431339;201803;20;17;3;16218.0;2862.0;19080.0
431340;201803;3042;1754;1288;1669420.0;1225543.4;2894963.5
431342;201803;42;25;17;23850.0;16218.0;40068.0
431344;201803;19;18;1;17172.0;954.0;18126.0
431346;201803;4;4;0;3816.0;0.0;3816.0
431349;201803;36;33;3;31482.0;2862.0;34344.0
431350;201803;904;529;375;500117.66;356090.03;856207.7
431360;201803;44;38;6;36252.0;5724.0;41976.0
431365;201803;312;149;163;142126.92;154538.45;296665.38
431370;201803;1335;790;545;750025.94;519742.97;1269768.9
431380;201803;97;84;13;80136.0;12402.0;92538.0
431390;201803;496;275;221;261319.88;210290.22;471610.1
431395;201803;283;121;162;115434.0;154529.0;269963.0
431400;201803;39;30;9;28620.0;8586.0;37206.0
431402;201803;97;66;31;62964.0;29574.0;92538.0
431403;201803;19;11;8;10494.0;7632.0;18126.0
431405;201803;651;350;301;332260.03;286841.0;619101.0
431406;201803;32;28;4;26712.0;3816.0;30528.0
431407;201803;51;41;10;39114.0;9540.0;48654.0
431410;201803;3242;1930;1312;1827882.2;1248738.2;3076620.5
431413;201803;15;13;2;12402.0;1908.0;14310.0
431415;201803;71;52;19;49608.0;18126.0;67734.0
431417;201803;22;11;11;10494.0;10494.0;20988.0
431420;201803;303;214;89;203519.95;84906.0;288425.97
431430;201803;43;17;26;16218.0;24804.0;41022.0
431440;201803;8979;6399;2580;6034533.5;2452654.2;8487188.0
431442;201803;27;14;13;13356.0;12402.0;25758.0
431445;201803;26;20;6;19080.0;5724.0;24804.0
431446;201803;7;6;1;5724.0;954.0;6678.0
431447;201803;85;60;25;57240.0;23850.0;81090.0
431449;201803;52;45;7;42930.0;6678.0;49608.0
431450;201803;410;283;127;268932.6;120442.5;389375.1
431454;201803;0;0;0;0.0;0.0;0.0
431455;201803;49;39;10;37206.0;9540.0;46746.0
431460;201803;527;363;164;343535.4;156169.8;499705.2
431470;201803;116;91;25;86122.54;23600.0;109722.54
431475;201803;11;10;1;9540.0;954.0;10494.0
431477;201803;35;25;10;23850.0;9540.0;33390.0
431478;201803;8;7;1;6678.0;954.0;7632.0
431480;201803;500;318;182;301785.38;173580.3;475365.66
431490;201803;28163;16001;12162;1,52E+14;1,16E+14;2,68E+14
431500;201803;78;52;26;49608.0;24804.0;74412.0
431505;201803;37;21;16;20034.0;15264.0;35298.0
431507;201803;11;9;2;8586.0;1908.0;10494.0
431510;201803;278;183;95;173866.8;89656.92;263523.72
431513;201803;22;17;5;16218.0;4770.0;20988.0
431514;201803;8;7;1;6678.0;954.0;7632.0
431515;201803;78;65;13;62010.0;12402.0;74412.0
431517;201803;4;2;2;1908.0;1908.0;3816.0
431520;201803;37;33;4;31482.0;3816.0;35298.0
431530;201803;1599;715;884;681060.8;842893.0;1523953.9
431531;201803;23;21;2;20034.0;1908.0;21942.0
431532;201803;25;17;8;16218.0;7632.0;23850.0
431535;201803;25;16;9;15264.0;8586.0;23850.0
431540;201803;138;123;15;116321.22;14310.0;130631.22
431545;201803;17;15;2;14310.0;1908.0;16218.0
431550;201803;351;205;146;195570.0;139188.6;334758.6
431555;201803;12;11;1;10494.0;954.0;11448.0
431560;201803;4473;3166;1307;2989134.8;1244608.4;4233743.0
431570;201803;784;415;369;392762.2;349155.47;741917.7
431575;201803;36;25;11;23850.0;10494.0;34344.0
431580;201803;96;68;28;63918.0;26712.0;90630.0
431590;201803;138;115;23;108756.0;21942.0;130698.0
431595;201803;12;11;1;10494.0;954.0;11448.0
431600;201803;217;125;92;119250.0;87768.0;207018.0
431610;201803;128;93;35;88054.2;33390.0;121444.2
431620;201803;42;34;8;32436.0;7632.0;40068.0
431630;201803;139;118;21;112572.0;20034.0;132606.0
431640;201803;1341;833;508;789486.06;483270.78;1272756.9
431642;201803;39;36;3;33867.0;2862.0;36729.0
431643;201803;45;20;25;19080.0;23850.0;42930.0
431645;201803;299;172;127;164088.0;120204.0;284292.0
431647;201803;11;11;0;10494.0;0.0;10494.0
431650;201803;36;27;9;25758.0;8586.0;34344.0
431660;201803;283;185;98;174582.0;93492.0;268074.0
431670;201803;218;104;114;96592.5;108727.38;205319.88
431673;201803;3;3;0;2862.0;0.0;2862.0
431675;201803;29;24;5;22609.8;4770.0;27379.8
431680;201803;1096;783;313;743166.0;297553.12;1040719.1
431690;201803;4767;2914;1853;2758504.0;1763843.8;4522348.0
431695;201803;26;20;6;19080.0;5724.0;24804.0
431697;201803;0;0;0;0.0;0.0;0.0
431700;201803;168;128;40;122112.0;38160.0;160272.0
431710;201803;4003;1726;2277;1643924.0;2171749.5;3815673.5
431720;201803;1387;823;564;777202.25;536802.25;1314004.5
431725;201803;1;1;0;954.0;0.0;954.0
431730;201803;1194;811;383;766999.1;365382.0;1132381.1
431740;201803;1370;683;687;646678.5;654847.56;1301526.1
431750;201803;1878;1217;661;1149788.2;628657.94;1778446.2
431755;201803;6;5;1;4770.0;954.0;5724.0
431760;201803;1076;685;391;653108.4;372785.6;1025894.0
431770;201803;395;288;107;274742.47;102058.92;376801.38
431775;201803;27;21;6;20034.0;5724.0;25758.0
431780;201803;561;346;215;328967.8;205100.45;534068.25
431790;201803;150;112;38;105894.0;36204.3;142098.3
431795;201803;14;12;2;11448.0;1908.0;13356.0
431800;201803;3383;1774;1609;1681013.4;1528087.0;3209100.2
431805;201803;16;15;1;14310.0;954.0;15264.0
431810;201803;618;414;204;392322.97;194482.98;586805.94
431820;201803;316;177;139;168858.0;131604.3;300462.3
431830;201803;2330;1408;922;1339694.6;878327.6;2218022.2
431840;201803;510;340;170;320736.4;160940.0;481676.4
431842;201803;34;28;6;26712.0;5724.0;32436.0
431843;201803;12;8;4;7632.0;3816.0;11448.0
431844;201803;15;13;2;12402.0;1908.0;14310.0
431845;201803;29;26;3;24804.0;2862.0;27666.0
431846;201803;28;24;4;22896.0;3816.0;26712.0
431848;201803;14;12;2;11448.0;1908.0;13356.0
431849;201803;8;6;2;5724.0;1908.0;7632.0
431850;201803;806;668;138;635759.5;131413.5;767173.0
431860;201803;101;72;29;68688.0;26712.0;95400.0
431861;201803;4;2;2;1908.0;1908.0;3816.0
431862;201803;52;34;18;32436.0;17172.0;49608.0
431870;201803;3468;2047;1421;1944438.0;1353379.0;3297817.0
431880;201803;941;691;250;654416.0;237546.0;891962.0
431890;201803;1303;806;497;763887.75;472531.0;1236418.8
431900;201803;187;130;57;124020.0;53586.18;177606.19
431910;201803;57;42;15;40068.0;14310.0;54378.0
431912;201803;35;19;16;18126.0;15264.0;33390.0
431915;201803;130;103;27;98262.0;25758.0;124020.0
431920;201803;145;107;38;101791.8;36252.0;138043.8
431930;201803;86;70;16;66780.0;15264.0;82044.0
431935;201803;4;3;1;2862.0;954.0;3816.0
431936;201803;12;11;1;10494.0;954.0;11448.0
431937;201803;17;12;5;11448.0;4770.0;16218.0
431940;201803;451;301;150;284387.4;143090.45;427477.88
431950;201803;473;302;171;286868.88;162982.98;449851.88
431960;201803;713;421;292;397448.03;278406.9;675854.94
431970;201803;72;63;9;60102.0;8586.0;68688.0
431971;201803;2;2;0;1908.0;0.0;1908.0
431973;201803;19;16;3;15264.0;2862.0;18126.0
431975;201803;7;6;1;5724.0;954.0;6678.0
431980;201803;199;125;74;117723.6;70596.0;188319.6
431990;201803;1227;652;575;620535.0;548504.0;1169039.0
432000;201803;1670;901;769;852174.44;730062.06;1582236.5
432010;201803;279;186;93;176330.95;88722.0;265052.97
432020;201803;170;135;35;128790.0;33380.46;162170.45
432023;201803;20;16;4;15264.0;3816.0;19080.0
432026;201803;65;57;8;54378.0;7632.0;62010.0
432030;201803;62;28;34;26712.0;32436.0;59148.0
432032;201803;22;19;3;18126.0;2862.0;20988.0
432035;201803;48;38;10;36252.0;9540.0;45792.0
432040;201803;102;69;33;65826.0;31482.0;97308.0
432045;201803;8;7;1;6678.0;954.0;7632.0
432050;201803;69;42;27;40068.0;25758.0;65826.0
432055;201803;99;73;26;69622.92;24804.0;94426.92
432057;201803;1;0;1;0.0;954.0;954.0
432060;201803;38;35;3;32674.5;2862.0;35536.5
432065;201803;30;28;2;26712.0;1908.0;28620.0
432067;201803;90;79;11;75346.92;10494.0;85840.92
432070;201803;403;303;100;287165.38;95371.92;382537.3
432080;201803;810;555;255;527771.9;243222.38;770994.25
432085;201803;16;12;4;11448.0;3816.0;15264.0
432090;201803;258;160;98;152640.0;93492.0;246132.0
432100;201803;179;119;60;113239.8;57240.0;170479.8
432110;201803;609;416;193;390329.84;183168.0;573497.8
432120;201803;956;577;379;549790.2;361527.84;911318.06
432130;201803;504;364;140;345920.4;132462.9;478383.3
432132;201803;26;22;4;20988.0;3816.0;24804.0
432135;201803;79;66;13;62964.0;12402.0;75366.0
432140;201803;264;209;55;199090.27;52470.0;251560.27
432143;201803;190;121;69;115434.0;65826.0;181260.0
432145;201803;272;189;83;178494.2;78895.8;257390.0
432146;201803;14;13;1;12402.0;954.0;13356.0
432147;201803;135;61;74;58194.0;70572.15;128766.15
432149;201803;17;12;5;11448.0;4770.0;16218.0
432150;201803;830;521;309;495831.97;292702.62;788534.6
432160;201803;1405;728;677;692214.4;644952.44;1337166.9
432162;201803;4;3;1;2862.0;954.0;3816.0
432163;201803;18;14;4;13356.0;3816.0;17172.0
432166;201803;123;92;31;88246.0;29574.0;117820.0
432170;201803;220;119;101;112573.0;96354.0;208927.0
432180;201803;520;317;203;299470.4;193376.0;492846.4
432183;201803;9;7;2;6678.0;1908.0;8586.0
432185;201803;83;72;11;68592.6;10494.0;79086.6
432190;201803;465;259;206;245932.45;196391.52;442323.97
432195;201803;85;74;11;69880.5;10494.0;80374.5
432200;201803;410;266;144;253764.0;137328.84;391092.84
432210;201803;119;76;43;70739.1;41022.0;111761.1
432215;201803;62;58;4;55332.0;3816.0;59148.0
432218;201803;19;18;1;17172.0;954.0;18126.0
432220;201803;682;345;337;328119.62;320990.75;649110.4
432225;201803;14;8;6;7155.0;5724.0;12879.0
432230;201803;143;86;57;81805.5;54378.0;136183.5
432232;201803;15;13;2;12402.0;1908.0;14310.0
432234;201803;4;3;1;2862.0;954.0;3816.0
432235;201803;1;1;0;954.0;0.0;954.0
432237;201803;29;17;12;16218.0;11448.0;27666.0
432240;201803;4194;2329;1865;2213033.5;1771827.4;3984861.0
432250;201803;1027;651;376;618431.94;358541.8;976973.75
432252;201803;39;32;7;29783.88;6678.0;36461.88
432253;201803;61;49;12;46746.0;11448.0;58194.0
432254;201803;22;10;12;9540.0;11448.0;20988.0
432255;201803;14;13;1;12402.0;954.0;13356.0
432260;201803;857;670;187;638121.25;177444.5;815565.75
432270;201803;223;164;59;156456.0;56286.0;212742.0
432280;201803;125;91;34;86337.8;32436.0;118773.8
432285;201803;2;1;1;954.0;954.0;1908.0
432290;201803;70;63;7;58480.2;6678.0;65158.2
432300;201803;4627;2637;1990;2500068.2;1894556.1;4394624.5
432310;201803;118;95;23;90630.0;21942.0;112572.0
432320;201803;20;15;5;14310.0;4770.0;19080.0
432330;201803;15;10;5;9540.0;4770.0;14310.0
432335;201803;7;6;1;5724.0;954.0;6678.0
432340;201803;40;37;3;35298.0;2862.0;38160.0
432345;201803;90;64;26;61056.0;24804.0;85860.0
432350;201803;24;23;1;21942.0;954.0;22896.0
432360;201803;6;4;2;3816.0;1908.0;5724.0
432370;201803;25;25;0;23850.0;0.0;23850.0
432375;201803;41;34;7;32436.0;6678.0;39114.0
432377;201803;7;7;0;6678.0;0.0;6678.0
432380;201803;169;75;94;70882.2;89628.3;160510.5
500020;201803;249;136;113;129744.0;107200.98;236944.98
500025;201803;119;58;61;54378.0;58194.0;112572.0
500060;201803;1390;848;542;808419.6;516462.62;1324882.2
500070;201803;765;364;401;346905.0;382544.47;729449.44
500080;201803;134;104;30;99216.0;28620.0;127836.0
500085;201803;140;114;26;108470.0;23969.25;132439.25
500090;201803;332;160;172;152640.0;164088.0;316728.0
500100;201803;695;371;324;351739.8;308524.0;660263.8
500110;201803;2249;1006;1243;959406.44;1185017.6;2144424.0
500124;201803;313;179;134;170766.0;127549.8;298315.8
500150;201803;327;130;197;124011.0;187578.0;311589.0
500190;201803;520;357;163;339910.2;155016.0;494926.2
500200;201803;201;172;29;163745.0;27666.0;191411.0
500210;201803;1459;522;937;496857.0;892735.0;1389592.0
500215;201803;242;139;103;131648.52;98262.0;229910.52
500220;201803;796;519;277;494881.84;263214.47;758096.3
500230;201803;254;174;80;165280.5;75843.0;241123.5
500240;201803;711;492;219;468604.8;208639.8;677244.6
500260;201803;569;213;356;203202.0;339624.0;542826.0
500270;201803;28310;12045;16265;1,15E+14;1,55E+14;2,70E+14
500280;201803;193;73;120;69642.0;114480.0;184122.0
500290;201803;1203;708;495;674193.0;472221.0;1146414.0
500295;201803;412;252;160;240408.0;152630.45;393038.47
500310;201803;64;21;43;20034.0;41022.0;61056.0
500315;201803;693;413;280;393992.47;266824.25;660816.75
500320;201803;3636;1817;1819;1730991.4;1733679.0;3464670.5
500325;201803;938;521;417;496557.0;396843.44;893400.44
500330;201803;1496;687;809;653176.25;771162.6;1424338.9
500345;201803;324;239;85;227043.2;81090.0;308133.2
500348;201803;243;142;101;135468.0;96335.46;231803.45
500350;201803;141;68;73;64872.0;69642.0;134514.0
500370;201803;5418;2429;2989;2309738.0;2848982.2;5158720.5
500375;201803;350;254;96;242306.45;91584.0;333890.47
500380;201803;585;334;251;318478.6;239444.45;557923.06
500390;201803;72;36;36;34344.0;34344.0;68688.0
500400;201803;221;150;71;143080.92;67725.0;210805.92
500410;201803;570;222;348;211742.16;331844.22;543586.4
500430;201803;542;377;165;359658.0;157410.0;517068.0
500440;201803;203;106;97;100351.43;92538.0;192889.44
500450;201803;412;177;235;168152.8;223835.12;391987.9
500460;201803;309;156;153;148814.45;145962.0;294776.47
500470;201803;441;346;95;328869.66;89667.0;418536.66
500480;201803;115;69;46;65826.0;43884.0;109710.0
500490;201803;108;44;64;41971.23;61056.0;103027.23
500500;201803;1429;499;930;474023.6;886603.6;1360627.2
500510;201803;47;37;10;35298.0;9531.0;44829.0
500515;201803;110;77;33;73458.0;31196.0;104654.0
500520;201803;348;195;153;184981.0;145672.0;330653.0
500525;201803;88;50;38;47700.0;35965.8;83665.8
500540;201803;889;372;517;354535.75;492207.84;846743.6
500560;201803;887;504;383;479077.03;364690.88;843767.94
500568;201803;999;575;424;546642.0;404205.22;950847.25
500570;201803;1209;680;529;646004.25;502335.6;1148339.9
500580;201803;336;171;165;162838.27;157397.0;320235.25
500600;201803;312;156;156;148113.27;148806.0;296919.28
500620;201803;914;641;273;605736.7;260251.2;865987.9
500625;201803;81;69;12;65119.19;11448.0;76567.19
500627;201803;24;11;13;10494.0;12402.0;22896.0
500630;201803;1575;833;742;794005.44;707387.0;1501392.5
500635;201803;516;293;223;279102.25;212598.9;491701.12
500640;201803;427;225;202;212076.0;192689.45;404765.47
500660;201803;5489;2108;3381;2007312.5;3220649.2;5227962.0
500690;201803;574;202;372;192360.78;353208.72;545569.5
500710;201803;356;174;182;165710.0;173619.0;339329.0
500720;201803;972;569;403;541142.7;384252.9;925395.6
500730;201803;199;117;82;111618.0;78223.23;189841.23
500740;201803;851;371;480;352642.94;457473.75;810116.7
500750;201803;138;45;93;42930.0;88693.92;131623.92
500755;201803;121;87;34;82712.0;32436.0;115148.0
500769;201803;750;425;325;405128.03;310037.0;715165.06
500770;201803;440;230;210;219410.45;200330.45;419740.9
500780;201803;173;115;58;109710.0;55332.0;165042.0
500790;201803;1029;513;516;488825.22;491937.47;980762.7
500793;201803;254;137;117;130698.0;111609.0;242307.0
500795;201803;179;128;51;122102.46;48645.0;170747.45
500797;201803;38;30;8;28620.0;7632.0;36252.0
500800;201803;409;177;232;168849.0;221041.8;389890.8
500830;201803;2188;1221;967;1162421.9;921478.7;2083900.6
500840;201803;145;108;37;103032.0;35289.0;138321.0
510010;201803;165;92;73;87758.46;69642.0;157400.45
510020;201803;486;223;263;212448.6;250089.5;462538.1
510025;201803;1666;939;727;894945.1;690736.06;1585681.2
510030;201803;652;335;317;319543.9;301654.22;621198.1
510035;201803;126;58;68;55304.46;64853.46;120157.92
510040;201803;383;171;212;163134.0;201801.27;364935.25
510050;201803;426;233;193;221541.2;183317.45;404858.66
510060;201803;116;57;59;54368.46;56276.46;110644.92
510080;201803;221;88;133;83919.69;126768.6;210688.3
510100;201803;77;34;43;32436.0;41002.92;73438.92
510120;201803;37;22;15;20988.0;14310.0;35298.0
510125;201803;395;243;152;231139.89;144984.92;376124.8
510130;201803;580;335;245;319193.8;233315.64;552509.44
510140;201803;392;130;262;124011.0;249943.23;373954.22
510160;201803;89;40;49;38160.0;46742.0;84902.0
510170;201803;868;526;342;501529.06;325625.84;827154.9
510180;201803;2870;1395;1475;1327817.4;1405199.2;2733016.5
510185;201803;12;6;6;5724.0;5724.0;11448.0
510190;201803;210;71;139;67734.0;132601.23;200335.23
510250;201803;2617;1544;1073;1471926.1;1022519.2;2494445.2
510260;201803;202;146;56;139101.84;53387.46;192489.3
510263;201803;455;248;207;235610.45;196722.6;432333.06
510267;201803;654;364;290;346700.75;276389.44;623090.2
510268;201803;56;29;27;27666.0;25758.0;53424.0
510269;201803;67;29;38;27657.0;36252.0;63909.0
510270;201803;407;206;201;196345.98;191623.69;387969.66
510279;201803;231;171;60;163097.45;56934.92;220032.38
510285;201803;168;73;95;69623.46;90630.0;160253.45
510300;201803;547;294;253;280025.06;241287.84;521312.9
510305;201803;218;102;116;97285.46;110570.22;207855.69
510310;201803;112;57;55;54378.0;52460.46;106838.46
510320;201803;855;534;321;508858.62;305798.38;814657.0
510325;201803;418;169;249;161216.45;237250.27;398466.72
510330;201803;422;240;182;228947.0;173608.92;402555.9
510335;201803;593;321;272;306187.38;258841.98;565029.4
510336;201803;49;36;13;34344.0;12402.0;46746.0
510337;201803;120;49;71;46736.46;67724.46;114460.92
510340;201803;17427;8376;9051;7968186.5;8624568.0;1,66E+14
510343;201803;72;50;22;47690.46;20988.0;68678.46
510345;201803;158;106;52;101114.46;49302.92;150417.38
510350;201803;665;370;295;352038.06;281365.38;633403.44
510360;201803;204;121;83;115425.0;79099.92;194524.92
510370;201803;138;72;66;68659.38;62832.6;131491.98
510380;201803;92;63;29;60102.0;27657.0;87759.0
510385;201803;57;27;30;25758.0;28611.0;54369.0
510390;201803;123;53;70;50562.0;66741.84;117303.84
510395;201803;39;28;11;26712.0;10494.0;37206.0
510410;201803;708;470;238;448376.0;227028.69;675404.7
510420;201803;591;290;301;275714.8;285715.44;561430.25
510450;201803;50;30;20;28620.0;19080.0;47700.0
510452;201803;41;23;18;21942.0;17172.0;39114.0
510454;201803;65;27;38;25758.0;36242.46;62000.46
510455;201803;126;81;45;77254.92;42930.0;120184.92
510460;201803;180;95;85;90163.72;81052.38;171216.1
510480;201803;746;424;322;403369.88;306840.38;710210.25
510490;201803;360;183;177;174202.8;168353.08;342555.88
510500;201803;256;191;65;182204.45;62010.0;244214.45
510510;201803;788;451;337;429368.06;321488.47;750856.5
510515;201803;1144;609;535;580617.4;510352.38;1090969.8
510517;201803;243;103;140;97975.8;133536.69;231512.48
510520;201803;234;152;82;144915.3;77908.3;222823.6
510523;201803;92;63;29;60102.0;27656.46;87758.46
510525;201803;728;409;319;389422.3;304215.3;693637.6
510530;201803;16;11;5;10494.0;4770.0;15264.0
510550;201803;273;120;153;114471.0;145953.0;260424.0
510558;201803;278;137;141;130665.15;134485.92;265151.06
510560;201803;385;239;146;228006.0;139266.0;367272.0
510562;201803;642;450;192;427969.16;182681.45;610650.6
510590;201803;817;426;391;406356.84;372995.7;779352.5
510600;201803;258;141;117;134490.92;111580.92;246071.84
510610;201803;169;82;87;78208.92;82702.46;160911.38
510615;201803;192;79;113;75346.92;107802.0;183148.92
510617;201803;17;10;7;9540.0;6678.0;16218.0
510618;201803;114;54;60;51516.0;56763.0;108279.0
510619;201803;106;73;33;69633.0;31473.0;101106.0
510620;201803;188;105;83;100160.46;79182.0;179342.45
510621;201803;198;126;72;120185.46;68660.46;188845.92
510622;201803;449;289;160;275613.84;152316.38;427930.22
510623;201803;359;241;118;229876.92;112543.38;342420.3
510624;201803;87;41;46;39105.0;43884.0;82989.0
510625;201803;534;326;208;310794.3;197835.52;508629.8
510626;201803;108;68;40;64872.0;38160.0;103032.0
510627;201803;58;43;15;41022.0;14310.0;55332.0
510628;201803;164;97;67;92491.92;63860.76;156352.69
510629;201803;254;162;92;154548.0;86804.46;241352.45
510630;201803;460;234;226;223151.22;215267.48;438418.72
510631;201803;11;3;8;2862.0;7346.0;10208.0
510637;201803;341;193;148;183776.19;141045.84;324822.03
510642;201803;977;545;432;519579.2;411994.97;931574.2
510645;201803;0;0;0;0.0;0.0;0.0
510650;201803;1505;990;515;944306.4;491198.75;1435505.1
510665;201803;85;43;42;40966.0;40068.0;81034.0
510670;201803;65;36;29;34344.0;27666.0;62010.0
510675;201803;1170;703;467;670631.0;445495.22;1116126.2
510677;201803;364;174;190;164990.84;180834.69;345825.53
510680;201803;108;63;45;60084.0;42921.0;103005.0
510682;201803;201;95;106;90308.0;101124.0;191432.0
510685;201803;52;37;15;35298.0;14310.0;49608.0
510700;201803;627;365;262;348091.9;249814.77;597906.7
510704;201803;1052;570;482;541445.7;458260.97;999706.7
510706;201803;126;61;65;58189.23;61972.92;120162.15
510710;201803;390;264;126;251658.06;120089.68;371747.75
510715;201803;64;47;17;44828.46;16218.0;61046.46
510718;201803;210;114;96;108662.76;91565.46;200228.22
510719;201803;36;19;17;18126.0;16218.0;34344.0
510720;201803;195;130;65;124011.0;61723.8;185734.8
510724;201803;88;37;51;35288.46;48621.38;83909.84
510726;201803;52;27;25;25748.46;23832.0;49580.46
510729;201803;76;36;40;34344.0;38121.84;72465.84
510730;201803;470;259;211;247068.0;201146.45;448214.47
510735;201803;111;44;67;41976.0;63918.0;105894.0
510740;201803;29;15;14;14310.0;13356.0;27666.0
510757;201803;19;15;4;14310.0;3816.0;18126.0
510760;201803;7046;3751;3295;3568820.2;3137144.2;6705964.5
510770;201803;724;346;378;329895.3;360417.3;690312.6
510774;201803;14;6;8;5724.0;7632.0;13356.0
510775;201803;111;84;27;80126.46;25748.46;105874.92
510776;201803;30;7;23;6678.0;21942.0;28620.0
510777;201803;187;83;104;79153.38;99187.38;178340.77
510779;201803;53;24;29;22887.0;27628.92;50515.92
510780;201803;295;163;132;155439.45;125844.0;281283.47
510785;201803;445;241;204;229857.3;194549.22;424406.53
510787;201803;189;97;92;92529.0;87750.23;180279.23
510788;201803;0;0;0;0.0;0.0;0.0
510790;201803;2383;1244;1139;1184757.4;1084468.5;2269226.0
510792;201803;1090;611;479;581475.25;456541.34;1038016.56
510794;201803;115;58;57;55332.0;54349.92;109681.92
510795;201803;2397;1392;1005;1320356.5;955820.6;2276177.0
510800;201803;181;109;72;103976.46;68679.0;172655.45
510805;201803;170;118;52;112572.0;49608.0;162180.0
510810;201803;94;39;55;37123.38;52346.52;89469.9
510820;201803;260;122;138;115961.46;130652.03;246613.48
510830;201803;66;40;26;38160.0;24795.0;62955.0
510835;201803;7;5;2;4770.0;1908.0;6678.0
510840;201803;9300;4597;4703;4370750.0;4479164.5;8849914.0
510850;201803;207;86;121;82034.46;115110.18;197144.64
510860;201803;385;168;217;160085.52;206327.8;366413.3
510880;201803;63;48;15;45773.46;14310.0;60083.46
510885;201803;72;44;28;41957.46;26683.38;68640.84
510890;201803;73;42;31;40068.0;29574.0;69642.0
510895;201803;189;108;81;103032.0;76965.46;179997.45
520005;201803;34;23;11;21942.0;10494.0;32436.0
520010;201803;279;126;153;120204.0;145867.0;266071.0
520013;201803;632;375;257;357722.0;244891.8;602613.8
520015;201803;51;37;14;35298.0;13356.0;48654.0
520017;201803;103;60;43;56954.0;41022.0;97976.0
520020;201803;27;13;14;12402.0;13356.0;25758.0
520025;201803;2004;1086;918;1034861.25;874904.4;1909765.6
520030;201803;797;408;389;388269.0;369531.9;757800.9
520050;201803;78;52;26;49608.0;24804.0;74412.0
520055;201803;44;30;14;28620.0;13356.0;41976.0
520060;201803;177;115;62;109710.0;59148.0;168858.0
520080;201803;591;412;179;393048.0;170766.0;563814.0
520082;201803;20;14;6;13356.0;5724.0;19080.0
520085;201803;99;72;27;68688.0;25758.0;94446.0
520090;201803;90;63;27;60102.0;25758.0;85860.0
520110;201803;8982;3893;5089;3708862.2;4851223.0;8560085.0
520120;201803;14;8;6;7431.66;5724.0;13155.66
520130;201803;754;531;223;506278.8;212733.0;719011.8
520140;201803;11739;6611;5128;6299736.0;4889464.0;1,12E+12
520145;201803;43;32;11;30528.0;10494.0;41022.0
520150;201803;191;149;42;142146.0;40068.0;182214.0
520160;201803;30;22;8;20988.0;7632.0;28620.0
520170;201803;231;143;88;136390.0;83915.0;220305.0
520180;201803;114;61;53;58194.0;50562.0;108756.0
520215;201803;213;131;82;124687.8;77941.8;202629.6
520235;201803;70;53;17;50562.0;16218.0;66780.0
520250;201803;137;82;55;78228.0;52183.8;130411.8
520260;201803;111;69;42;65826.0;39114.0;104940.0
520280;201803;46;33;13;30815.0;12402.0;43217.0
520310;201803;38;26;12;24804.0;11448.0;36252.0
520320;201803;164;106;58;101114.46;55332.0;156446.45
520330;201803;781;410;371;391094.47;353907.0;745001.44
520340;201803;353;202;151;192708.0;144035.45;336743.47
520350;201803;524;239;285;228006.0;271843.0;499849.0
520355;201803;89;51;38;48654.0;36252.0;84906.0
520357;201803;25;18;7;17172.0;6678.0;23850.0
520360;201803;0;0;0;0.0;0.0;0.0
520380;201803;136;71;65;67734.0;62010.0;129744.0
520390;201803;286;118;168;112095.0;160009.5;272104.5
520393;201803;13;10;3;9540.0;2862.0;12402.0
520396;201803;97;57;40;54378.0;38160.0;92538.0
520400;201803;225;132;93;124307.2;88722.0;213029.2
520410;201803;202;103;99;98253.0;94437.0;192690.0
520420;201803;22;15;7;14310.0;6678.0;20988.0
520425;201803;297;127;170;120205.0;161704.2;281909.2
520430;201803;454;235;219;223903.8;208870.0;432773.8
520440;201803;613;414;199;394956.0;189846.0;584802.0
520450;201803;1913;866;1047;825049.44;998192.0;1823241.5
520455;201803;57;40;17;38160.0;16218.0;54378.0
520460;201803;31;16;15;15264.0;14310.0;29574.0
520465;201803;23;19;4;18126.0;3816.0;21942.0
520470;201803;412;255;157;242964.62;149778.0;392742.62
520480;201803;82;47;35;44838.0;33345.0;78183.0
520485;201803;126;42;84;40068.0;79850.0;119918.0
520490;201803;401;297;104;283153.97;99051.92;382205.9
520495;201803;175;106;69;101124.0;65826.0;166950.0
520500;201803;175;132;43;125928.0;41022.0;166950.0
520505;201803;177;92;85;87763.23;81090.0;168853.23
520510;201803;1777;874;903;830496.75;859464.44;1689961.1
520520;201803;37;28;9;26712.0;8586.0;35298.0
520530;201803;230;171;59;160742.31;55486.54;216228.86
520540;201803;529;355;174;337363.03;165996.0;503359.03
520545;201803;163;89;74;84906.0;70596.0;155502.0
520547;201803;54;30;24;28620.0;22896.0;51516.0
520549;201803;1114;541;573;515790.0;546311.0;1062101.0
520551;201803;292;150;142;143100.0;135468.0;278568.0
520552;201803;45;27;18;25758.0;17172.0;42930.0
520570;201803;16;9;7;8586.0;6678.0;15264.0
520580;201803;285;171;114;163115.45;108756.0;271871.47
520590;201803;162;96;66;91584.0;62677.8;154261.8
520620;201803;1153;539;614;513348.47;585174.25;1098522.8
520630;201803;44;26;18;24804.0;17172.0;41976.0
520640;201803;413;235;178;224190.0;169812.0;394002.0
520650;201803;53;38;15;36252.0;14310.0;50562.0
520660;201803;35;19;16;18126.0;15264.0;33390.0
520670;201803;33;28;5;26712.0;4770.0;31482.0
520680;201803;58;38;20;36252.0;19080.0;55332.0
520690;201803;33;10;23;9540.0;21913.92;31453.92
520710;201803;38;34;4;32436.0;3816.0;36252.0
520725;201803;194;124;70;118296.0;66780.0;185076.0
520735;201803;59;41;18;39114.0;17172.0;56286.0
520740;201803;405;203;202;192947.4;192699.0;385646.4
520750;201803;37;27;10;25758.0;9540.0;35298.0
520753;201803;55;37;18;35298.0;17172.0;52470.0
520760;201803;109;74;35;70596.0;33390.0;103986.0
520780;201803;288;219;69;208926.0;65826.0;274752.0
520790;201803;164;81;83;76987.8;79182.0;156169.8
520800;201803;3450;1833;1617;1745999.0;1541940.9;3287940.0
520810;201803;164;115;49;109710.0;46746.0;156456.0
520815;201803;5;5;0;4770.0;0.0;4770.0
520830;201803;139;91;48;86814.0;45505.8;132319.8
520840;201803;349;228;121;217035.0;115434.0;332469.0
520850;201803;110;71;39;67725.0;37053.36;104778.36
520860;201803;1687;1067;620;1016497.56;590336.2;1606833.8
520870;201803;30737;15138;15599;1,44E+14;1,49E+14;2,93E+14
520880;201803;1064;587;477;559998.0;455038.9;1015036.94
520890;201803;795;458;337;435301.4;321393.47;756694.9
520910;201803;1034;547;487;518261.75;464598.0;982859.75
520915;201803;100;76;24;72504.0;22886.46;95390.46
520920;201803;406;197;209;187365.6;199376.45;386742.06
520929;201803;19;17;2;16218.0;1908.0;18126.0
520940;201803;73;46;27;43884.0;25758.0;69642.0
520945;201803;21;13;8;12402.0;7632.0;20034.0
520960;201803;46;30;16;28620.0;15264.0;43884.0
520970;201803;329;206;123;195895.0;117055.8;312950.8
520980;201803;89;65;24;62010.0;22896.0;84906.0
520990;201803;474;317;157;302418.0;149778.0;452196.0
520993;201803;128;61;67;58194.0;63909.0;122103.0
520995;201803;242;135;107;127837.0;101506.0;229343.0
521000;201803;1543;898;645;854689.4;615235.0;1469924.4
521010;201803;670;307;363;292551.38;346236.3;638787.7
521015;201803;17;10;7;9540.0;6678.0;16218.0
521020;201803;1464;1018;446;970542.9;425113.22;1395656.1
521030;201803;47;33;14;31482.0;13356.0;44838.0
521040;201803;942;576;366;549266.2;348878.0;898144.2
521056;201803;40;28;12;26712.0;11448.0;38160.0
521060;201803;130;80;50;76320.0;47700.0;124020.0
521080;201803;469;350;119;333605.0;113526.0;447131.0
521090;201803;534;322;212;305947.8;202248.0;508195.8
521100;201803;289;213;76;203193.0;72504.0;275697.0
521120;201803;1046;717;329;682435.4;313571.0;996006.4
521130;201803;361;257;104;245168.45;98330.6;343499.06
521140;201803;189;109;80;103986.0;76320.0;180306.0
521150;201803;2802;1214;1588;1157146.9;1513393.5;2670540.2
521160;201803;33;17;16;16218.0;15264.0;31482.0
521170;201803;195;114;81;108746.46;77274.0;186020.45
521180;201803;1129;714;415;679525.25;395195.2;1074720.5
521190;201803;2551;1080;1471;1030300.94;1402456.8;2432757.8
521200;201803;46;34;12;32436.0;11448.0;43884.0
521205;201803;16;12;4;11448.0;3816.0;15264.0
521210;201803;148;84;64;80136.0;61056.0;141192.0
521220;201803;819;556;263;527791.75;250846.0;778637.75
521225;201803;28;17;11;16218.0;10494.0;26712.0
521230;201803;112;74;38;70309.8;36252.0;106561.8
521250;201803;6793;3754;3039;3574876.0;2896613.2;6471489.5
521260;201803;21;14;7;13356.0;6678.0;20034.0
521270;201803;143;111;32;105894.0;30528.0;136422.0
521280;201803;437;258;179;245464.2;170766.0;416230.2
521290;201803;31;13;18;12402.0;17172.0;29574.0
521295;201803;100;68;32;64643.04;30528.0;95171.04
521300;201803;231;119;112;113508.0;106488.38;219996.38
521305;201803;36;24;12;22896.0;11448.0;34344.0
521308;201803;1080;786;294;748454.75;280181.0;1028635.75
521310;201803;1350;800;550;761915.4;523508.9;1285424.4
521340;201803;20;16;4;15264.0;3816.0;19080.0
521350;201803;131;96;35;91584.0;33390.0;124974.0
521370;201803;188;119;69;112572.0;65539.8;178111.8
521375;201803;189;106;83;101124.0;78895.8;180019.8
521377;201803;51;34;17;32436.0;16218.0;48654.0
521380;201803;1080;698;382;661744.25;364428.0;1026172.25
521385;201803;15;8;7;7632.0;6678.0;14310.0
521390;201803;106;87;19;82680.04;18126.0;100806.04
521400;201803;323;205;118;195283.8;112524.3;307808.1
521405;201803;150;78;72;74412.0;68688.0;143100.0
521410;201803;65;43;22;41022.0;20988.0;62010.0
521440;201803;210;146;64;138473.1;61056.0;199529.1
521450;201803;721;397;324;378738.0;309096.0;687834.0
521460;201803;1187;728;459;694225.8;437866.9;1132092.8
521470;201803;14;9;5;8586.0;4770.0;13356.0
521480;201803;47;32;15;30519.0;14245.0;44764.0
521483;201803;307;165;142;157124.0;135468.0;292592.0
521486;201803;284;181;103;172549.98;97595.0;270144.97
521487;201803;23;11;12;10494.0;11448.0;21942.0
521490;201803;28;16;12;15264.0;11448.0;26712.0
521500;201803;117;76;41;72504.0;39114.0;111618.0
521520;201803;42;31;11;29574.0;10494.0;40068.0
521523;201803;595;365;230;345983.78;219420.0;565403.75
521525;201803;45;30;15;28620.0;14023.8;42643.8
521530;201803;251;134;117;127836.0;111618.0;239454.0
521540;201803;31;16;15;15264.0;14310.0;29574.0
521550;201803;91;43;48;40707.92;45736.92;86444.84
521560;201803;801;546;255;520598.0;243127.0;763725.0
521565;201803;50;33;17;31482.0;16218.0;47700.0
521570;201803;495;332;163;316718.47;155407.3;472125.75
521580;201803;61;38;23;36252.0;21942.0;58194.0
521590;201803;36;19;17;18126.0;16218.0;34344.0
521600;201803;30;18;12;17172.0;11448.0;28620.0
521630;201803;238;117;121;111608.46;114443.96;226052.42
521640;201803;301;154;147;146916.0;140238.0;287154.0
521645;201803;31;17;14;16218.0;13356.0;29574.0
521680;201803;221;140;81;133560.0;77274.0;210834.0
521690;201803;3;2;1;1908.0;954.0;2862.0
521710;201803;1196;561;635;534350.8;605781.0;1140131.8
521720;201803;536;359;177;342476.47;168820.45;511296.9
521730;201803;624;302;322;288108.0;306081.56;594189.56
521740;201803;925;375;550;357721.9;523509.3;881231.25
521760;201803;1594;866;728;824586.6;694198.0;1518784.6
521770;201803;803;511;292;487494.0;278100.53;765594.56
521800;201803;2081;1295;786;1231888.5;749420.1;1981308.6
521805;201803;32;18;14;17172.0;13356.0;30528.0
521810;201803;92;58;34;54187.8;32436.0;86623.8
521830;201803;950;670;280;636986.25;267111.0;904097.25
521839;201803;94;62;32;59148.0;30528.0;89676.0
521850;201803;1115;591;524;562394.94;499562.7;1061957.6
521860;201803;346;212;134;202248.0;127550.0;329798.0
521870;201803;73;42;31;40068.0;29574.0;69642.0
521878;201803;42;20;22;19080.0;20988.0;40068.0
521880;201803;4503;2026;2477;1930513.4;2361222.0;4291735.5
521890;201803;571;395;176;376830.0;167617.8;544447.8
521900;201803;293;237;56;225461.95;53424.0;278885.97
521910;201803;154;108;46;103032.0;43884.0;146916.0
521920;201803;55;27;28;25758.0;26712.0;52470.0
521925;201803;36;21;15;20034.0;14310.0;34344.0
521930;201803;1114;634;480;604640.0;457276.88;1061916.9
521935;201803;34;26;8;24804.0;7632.0;32436.0
521940;201803;191;96;95;91584.0;90625.23;182209.23
521945;201803;14;12;2;11448.0;1908.0;13356.0
521950;201803;9;5;4;4770.0;3816.0;8586.0
521960;201803;73;54;19;51516.0;18126.0;69642.0
521970;201803;425;272;153;259201.8;145962.0;405163.8
521971;201803;97;48;49;45792.0;46746.0;92538.0
521973;201803;29;13;16;12402.0;15264.0;27666.0
521975;201803;1128;585;543;557137.0;517106.66;1074243.6
521980;201803;239;164;75;156456.0;71550.0;228006.0
521990;201803;72;54;18;51516.0;17172.0;68688.0
522000;201803;288;178;110;169812.0;104940.0;274752.0
522005;201803;21;13;8;12402.0;7632.0;20034.0
522010;201803;1130;633;497;603873.0;473565.6;1077438.6
522015;201803;54;33;21;31473.0;20034.0;51507.0
522020;201803;860;463;397;440748.2;377956.12;818704.3
522026;201803;30;22;8;20988.0;7632.0;28620.0
522028;201803;16;12;4;11448.0;3816.0;15264.0
522040;201803;748;298;450;284178.0;429245.47;713423.44
522045;201803;2090;1318;772;1256050.0;735954.8;1992004.9
522050;201803;166;81;85;77274.0;81090.0;158364.0
522060;201803;561;354;207;337429.8;197382.6;534812.4
522068;201803;138;90;48;85573.8;45792.0;131365.8
522070;201803;10;10;0;9540.0;0.0;9540.0
522100;201803;47;26;21;24536.88;20034.0;44570.88
522108;201803;40;30;10;28620.0;9540.0;38160.0
522119;201803;55;28;27;26712.0;25758.0;52470.0
522130;201803;76;29;47;27666.0;44820.0;72486.0
522140;201803;3703;1880;1823;1789033.2;1736977.9;3526011.2
522145;201803;51;30;21;28620.0;20034.0;48654.0
522150;201803;65;51;14;48654.0;13356.0;62010.0
522155;201803;58;41;17;39105.0;16218.0;55323.0
522157;201803;4;3;1;2862.0;954.0;3816.0
522160;201803;1720;1004;716;956671.2;682768.8;1639440.0
522170;201803;394;264;130;251856.0;124020.0;375876.0
522180;201803;36;20;16;19080.0;15264.0;34344.0
522185;201803;1305;543;762;515001.25;726427.0;1241428.2
522190;201803;48;27;21;25758.0;19938.6;45696.6
522200;201803;302;182;120;173628.0;114480.0;288108.0
522205;201803;164;110;54;104940.0;51516.0;156456.0
522220;201803;164;117;47;111618.0;44838.0;156456.0
522230;201803;30;24;6;22896.0;5724.0;28620.0
530010;201803;55583;28538;27045;2,71E+14;2,57E+14;5,28E+14
110001;201804;519;410;109;390156.34;103340.96;493497.3
110002;201804;2795;1690;1105;1610380.2;1053263.5;2663643.8
110003;201804;96;76;20;72504.0;19080.0;91584.0
110004;201804;2016;1295;721;1232529.0;687538.25;1920067.2
110005;201804;446;358;88;340376.9;83952.0;424328.9
110006;201804;451;347;104;330751.8;99196.92;429948.72
110007;201804;82;65;17;62010.0;16218.0;78228.0
110008;201804;236;135;101;127554.9;96354.0;223908.9
110009;201804;796;541;255;514101.2;243071.0;757172.2
110010;201804;1801;1116;685;1063431.0;653348.5;1716779.5
110011;201804;1885;1451;434;1382743.2;414006.34;1796749.5
110012;201804;4113;2398;1715;2281255.2;1634838.5;3916093.8
110013;201804;750;571;179;544724.44;170766.0;715490.44
110014;201804;370;317;53;302397.88;50562.0;352959.88
110015;201804;1434;1155;279;1099442.8;265574.53;1365017.2
110018;201804;1117;664;453;633142.0;432149.22;1065291.2
110020;201804;15383;9044;6339;8583686.0;6035318.0;1,46E+14
110025;201804;652;478;174;454014.12;165987.0;620001.1
110026;201804;41;28;13;26712.0;12402.0;39114.0
110028;201804;1650;1197;453;1137150.9;428568.94;1565719.9
110029;201804;142;126;16;120204.0;15264.0;135468.0
110030;201804;2477;1662;815;1582655.4;776609.44;2359264.8
110032;201804;394;307;87;292569.0;82994.0;375563.0
110033;201804;674;510;164;483537.0;156452.0;639989.0
110034;201804;361;267;94;252406.0;89009.0;341415.0
110037;201804;104;85;19;81090.0;18126.0;99216.0
110040;201804;340;229;111;218466.0;105894.0;324360.0
110045;201804;947;633;314;602336.0;297852.38;900188.4
110050;201804;95;78;17;74412.0;16218.0;90630.0
110060;201804;87;46;41;43884.0;39114.0;82998.0
110070;201804;125;75;50;71550.0;47414.0;118964.0
110080;201804;403;244;159;230553.19;151642.05;382195.22
110090;201804;33;27;6;25758.0;5724.0;31482.0
110092;201804;112;64;48;61056.0;45722.0;106778.0
110094;201804;199;139;60;132606.0;57240.0;189846.0
110100;201804;28;23;5;21942.0;4770.0;26712.0
110110;201804;69;42;27;40068.0;25758.0;65826.0
110120;201804;73;60;13;57240.0;12402.0;69642.0
110130;201804;301;243;58;230347.12;55332.0;285679.12
110140;201804;240;154;86;146725.2;82034.46;228759.66
110143;201804;49;41;8;39114.0;7632.0;46746.0
110145;201804;28;20;8;19080.0;7632.0;26712.0
110146;201804;23;12;11;11448.0;10494.0;21942.0
110147;201804;39;30;9;28620.0;8586.0;37206.0
110148;201804;39;27;12;25706.57;11448.0;37154.57
110149;201804;293;211;82;201007.8;78228.0;279235.8
110150;201804;85;58;27;55332.0;25758.0;81090.0
110155;201804;8;7;1;6678.0;954.0;7632.0
110160;201804;70;59;11;56286.0;10494.0;66780.0
110170;201804;208;169;39;161226.0;37206.0;198432.0
110175;201804;39;28;11;26712.0;10494.0;37206.0
110180;201804;92;80;12;76320.0;11448.0;87768.0
120001;201804;136;93;43;88680.0;40993.0;129673.0
120005;201804;191;119;72;113483.12;68688.0;182171.12
120010;201804;1037;667;370;629172.44;350747.16;979919.6
120013;201804;140;98;42;92784.06;39724.04;132508.1
120017;201804;93;57;36;54269.48;34301.12;88570.6
120020;201804;3536;2819;717;2660856.5;681365.7;3342222.0
120025;201804;596;337;259;318960.22;246004.6;564964.8
120030;201804;1020;856;164;808487.7;155698.12;964185.8
120032;201804;49;41;8;39092.12;7632.0;46724.12
120033;201804;215;188;27;179004.75;25758.0;204762.75
120034;201804;156;113;43;105872.12;40978.24;146850.36
120035;201804;29;20;9;19080.0;8586.0;27666.0
120038;201804;389;247;142;234792.0;135424.23;370216.25
120039;201804;23;21;2;20034.0;1908.0;21942.0
120040;201804;14047;9734;4313;9154237.0;4076125.2;1,32E+14
120042;201804;43;37;6;35298.0;5724.0;41022.0
120043;201804;12;3;9;2862.0;8586.0;11448.0
120045;201804;538;348;190;329911.38;180994.6;510905.97
120050;201804;1264;962;302;912196.25;288017.47;1200213.8
120060;201804;1423;1155;268;1085601.5;251930.56;1337532.0
120070;201804;505;363;142;340000.44;134126.55;474126.97
120080;201804;165;106;59;99916.3;55719.3;155635.6
130002;201804;148;103;45;98262.0;42930.0;141192.0
130006;201804;75;43;32;41022.0;30528.0;71550.0
130008;201804;144;77;67;72737.72;63195.96;135933.69
130010;201804;137;73;64;69642.0;61056.0;130698.0
130014;201804;237;173;64;165042.0;61056.0;226098.0
130020;201804;88;48;40;45792.0;38160.0;83952.0
130030;201804;899;549;350;523746.0;333890.47;857636.44
130040;201804;328;164;164;156456.0;155502.28;311958.28
130050;201804;554;306;248;291637.8;236592.0;528229.8
130060;201804;885;601;284;568205.2;268137.12;836342.3
130063;201804;565;307;258;292878.0;246110.12;538988.1
130068;201804;188;122;66;116388.0;62677.8;179065.8
130070;201804;1328;922;406;866110.75;382403.0;1248513.8
130080;201804;668;435;233;414608.4;222273.0;636881.4
130083;201804;71;38;33;35701.8;31482.0;67183.8
130090;201804;376;193;183;182442.95;174582.0;357024.97
130100;201804;1104;515;589;491310.0;561619.8;1052929.8
130110;201804;703;316;387;301314.0;369198.0;670512.0
130115;201804;175;71;104;67734.0;99216.0;166950.0
130120;201804;1625;1011;614;964494.0;585756.0;1550250.0
130130;201804;617;423;194;403542.0;185076.0;588618.0
130140;201804;1523;1144;379;1090713.0;360612.2;1451325.2
130150;201804;423;360;63;343418.12;60102.0;403520.12
130160;201804;468;263;205;250902.0;195570.0;446472.0
130165;201804;23;16;7;15264.0;6678.0;21942.0
130170;201804;937;667;270;636247.4;257580.0;893827.4
130180;201804;152;92;60;87291.0;57240.0;144531.0
130185;201804;2284;1204;1080;1146687.9;1029728.94;2176416.8
130190;201804;3618;2257;1361;2148950.8;1297092.0;3446042.8
130195;201804;291;233;58;222282.0;55332.0;277614.0
130200;201804;177;81;96;77264.46;91584.0;168848.45
130210;201804;78;39;39;37206.0;37206.0;74412.0
130220;201804;183;127;56;121158.0;53424.0;174582.0
130230;201804;334;211;123;201294.0;117342.0;318636.0
130240;201804;1448;916;532;872524.4;506950.84;1379475.2
130250;201804;4721;3047;1674;2901373.2;1596862.6;4498236.0
130255;201804;421;206;215;196524.0;204823.8;401347.8
130260;201804;53536;25674;27862;2,45E+14;2,66E+13;5,10E+14
130270;201804;1511;969;542;923758.06;517068.0;1440826.1
130280;201804;113;68;45;64872.0;42930.0;107802.0
130290;201804;2080;1509;571;1439586.0;544447.8;1984033.8
130300;201804;426;307;119;292591.8;113526.0;406117.8
130310;201804;883;462;421;440748.0;401634.0;842382.0
130320;201804;448;235;213;223236.0;203202.0;426438.0
130330;201804;704;426;278;406404.0;264925.8;671329.8
130340;201804;3276;1970;1306;1874801.2;1244493.2;3119294.5
130350;201804;464;297;167;283316.12;159318.0;442634.12
130353;201804;792;327;465;311672.0;443610.0;755282.0
130356;201804;777;352;425;335808.0;405163.8;740971.8
130360;201804;68;41;27;39114.0;25758.0;64872.0
130370;201804;677;504;173;480816.0;165042.0;645858.0
130380;201804;627;430;197;410220.0;187938.0;598158.0
130390;201804;484;389;95;371106.0;90630.0;461736.0
130395;201804;183;42;141;40068.0;134514.0;174582.0
130400;201804;72;47;25;44838.0;23850.0;68688.0
130406;201804;2066;1298;768;1234678.2;731461.75;1966140.0
130410;201804;501;214;287;204156.0;273778.9;477934.9
130420;201804;3192;2564;628;2442269.5;599112.0;3041381.5
130423;201804;162;76;86;72504.0;82044.0;154548.0
130426;201804;141;83;58;79182.0;55332.0;134514.0
130430;201804;406;268;138;255672.0;131652.0;387324.0
130440;201804;198;69;129;65826.0;123066.0;188892.0
140002;201804;36;14;22;13356.0;20988.0;34344.0
140005;201804;211;128;83;121873.5;79182.0;201055.5
140010;201804;10274;6937;3337;6580257.0;3180824.8;9761082.0
140015;201804;155;68;87;64872.0;82998.0;147870.0
140017;201804;115;78;37;74412.0;35298.0;109710.0
140020;201804;475;317;158;301464.0;150732.0;452196.0
140023;201804;31;18;13;16953.0;12402.0;29355.0
140028;201804;17;12;5;11448.0;4770.0;16218.0
140030;201804;358;256;102;244224.0;96706.98;340930.97
140040;201804;54;38;16;36252.0;15168.6;51420.6
140045;201804;246;115;131;109042.2;124974.0;234016.2
140047;201804;564;386;178;366232.38;169049.0;535281.4
140050;201804;148;97;51;91725.0;48654.0;140379.0
140060;201804;35;24;11;22161.42;10494.0;32655.42
140070;201804;31;28;3;26712.0;2862.0;29574.0
150010;201804;4737;2938;1799;2800944.5;1713746.2;4514690.5
150013;201804;150;106;44;101124.0;41976.0;143100.0
150020;201804;1067;569;498;542826.0;475092.0;1017918.0
150030;201804;726;297;429;283338.0;409266.0;692604.0
150034;201804;196;123;73;117342.0;69642.0;186984.0
150040;201804;1394;831;563;792774.0;537102.0;1329876.0
150050;201804;702;420;282;399678.8;268828.0;668506.8
150060;201804;4724;3068;1656;2922923.2;1579576.5;4502500.0
150070;201804;315;146;169;139284.0;161226.0;300510.0
150080;201804;14489;7290;7199;6942935.0;6860242.0;1,38E+14
150085;201804;387;243;144;231812.45;137376.0;369188.47
150090;201804;764;650;114;620100.0;108756.0;728856.0
150095;201804;347;212;135;201478.12;127969.56;329447.7
150100;201804;56;40;16;38160.0;15264.0;53424.0
150110;201804;173;83;90;79182.0;85860.0;165042.0
150120;201804;433;320;113;305280.0;107802.0;413082.0
150125;201804;54;23;31;21942.0;29574.0;51516.0
150130;201804;1898;1015;883;968310.0;842377.25;1810687.2
150140;201804;54487;25404;29083;2,42E+14;2,77E+14;5,19E+14
150145;201804;180;106;74;101124.0;70596.0;171720.0
150150;201804;2813;1259;1554;1200868.5;1478823.6;2679692.0
150157;201804;439;303;136;289062.0;129739.23;418801.22
150160;201804;125;101;24;96354.0;22896.0;119250.0
150170;201804;3671;2719;952;2591970.2;907921.8;3499892.0
150172;201804;322;221;101;210834.0;96354.0;307188.0
150175;201804;88;54;34;51516.0;32436.0;83952.0
150178;201804;770;518;252;493218.0;240408.0;733626.0
150180;201804;3065;1481;1584;1412063.6;1510535.1;2922598.8
150190;201804;332;213;119;203202.0;113526.0;316728.0
150195;201804;123;61;62;58194.0;59148.0;117342.0
150200;201804;205;96;109;91584.0;103986.0;195570.0
150210;201804;3183;2577;606;2457399.8;577881.5;3035281.2
150215;201804;513;334;179;318636.0;170480.0;489116.0
150220;201804;3898;2636;1262;2513184.8;1201830.4;3715015.0
150230;201804;1146;923;223;879962.06;212742.0;1092704.0
150240;201804;5806;3420;2386;3259503.8;2275949.0;5535452.5
150250;201804;34;16;18;15264.0;17172.0;32436.0
150260;201804;74;45;29;42930.0;27666.0;70596.0
150270;201804;2351;1543;808;1470730.4;769973.8;2240704.0
150275;201804;577;352;225;335808.0;214650.0;550458.0
150276;201804;109;46;63;43884.0;60102.0;103986.0
150277;201804;763;326;437;310985.47;416898.0;727883.44
150280;201804;339;209;130;199386.0;124020.0;323406.0
150285;201804;74;37;37;35298.0;35298.0;70596.0
150290;201804;975;597;378;569242.25;360326.0;929568.25
150293;201804;673;311;362;296494.47;345348.0;641842.44
150295;201804;479;216;263;206064.0;250749.44;456813.44
150300;201804;79;41;38;39114.0;36252.0;75366.0
150304;201804;143;97;46;92538.0;43884.0;136422.0
150307;201804;393;323;70;308142.0;66780.0;374922.0
150309;201804;559;407;152;388278.0;145008.0;533286.0
150310;201804;256;173;83;165042.0;79182.0;244224.0
150320;201804;1802;1246;556;1188402.6;530424.0;1718826.6
150330;201804;2064;1188;876;1132684.2;835704.0;1968388.2
150340;201804;201;136;65;129505.5;62010.0;191515.5
150345;201804;606;329;277;313684.75;264258.0;577942.75
150350;201804;416;325;91;307655.47;86814.0;394469.47
150360;201804;4539;2892;1647;2755300.2;1571228.5;4326528.5
150370;201804;755;535;220;509594.0;209584.8;719178.8
150375;201804;198;104;94;99216.0;89676.0;188892.0
150380;201804;1333;889;444;848106.0;423290.0;1271396.0
150390;201804;742;423;319;403538.0;304326.0;707864.0
150400;201804;99;82;17;78228.0;16218.0;94446.0
150405;201804;1246;824;422;784824.5;402015.6;1186840.1
150410;201804;136;89;47;84886.92;44838.0;129724.92
150420;201804;7441;4064;3377;3875397.2;3219986.2;7095383.5
150430;201804;498;334;164;318636.0;156456.0;475092.0
150440;201804;587;349;238;332183.0;227052.0;559235.0
150442;201804;2159;1160;999;1103387.0;952469.0;2055856.0
150445;201804;526;332;194;316728.0;184122.0;500850.0
150450;201804;264;124;140;118296.0;133560.0;251856.0
150460;201804;765;580;185;551493.06;176470.92;727964.0
150470;201804;1340;809;531;770259.8;506574.0;1276833.8
150475;201804;41;31;10;29574.0;9540.0;39114.0
150480;201804;1244;867;377;827118.0;359371.8;1186489.8
150490;201804;612;335;277;319590.0;264258.0;583848.0
150495;201804;329;232;97;221328.0;92538.0;313866.0
150497;201804;299;205;94;195570.0;89666.46;285236.47
150500;201804;427;287;140;273798.0;133560.0;407358.0
150503;201804;882;426;456;406118.0;434945.0;841063.0
150506;201804;1030;674;356;642996.0;339614.47;982610.44
150510;201804;1239;695;544;662744.0;518976.0;1181720.0
150520;201804;275;184;91;175536.0;86814.0;262350.0
150530;201804;1575;851;724;808706.3;689455.8;1498162.1
150540;201804;240;167;73;159318.0;69642.0;228960.0
150543;201804;720;409;311;389594.53;296407.8;686002.3
150548;201804;505;349;156;332946.0;148824.0;481770.0
150549;201804;63;43;20;41022.0;19080.0;60102.0
150550;201804;2887;1516;1371;1445311.0;1307648.0;2752959.0
150553;201804;3079;1815;1264;1730937.8;1205846.5;2936784.2
150555;201804;144;76;68;72504.0;64872.0;137376.0
150560;201804;51;39;12;37206.0;11448.0;48654.0
150563;201804;74;40;34;38160.0;32436.0;70596.0
150565;201804;169;100;69;95400.0;65826.0;161226.0
150570;201804;400;265;135;252790.92;128790.0;381580.9
150580;201804;1521;647;874;616570.2;833796.0;1450366.2
150590;201804;775;475;300;453150.0;286200.0;739350.0
150600;201804;462;278;184;265212.0;175536.0;440748.0
150610;201804;145;124;21;117447.0;20034.0;137481.0
150611;201804;128;89;39;84906.0;37206.0;122112.0
150613;201804;3215;1976;1239;1885104.0;1181997.0;3067101.0
150616;201804;487;297;190;283100.0;181260.0;464360.0
150618;201804;1168;636;532;606515.56;507528.0;1114043.6
150619;201804;394;301;93;287154.0;88722.0;375876.0
150620;201804;1284;744;540;709776.0;514873.8;1224649.8
150630;201804;307;206;101;196524.0;96354.0;292878.0
150635;201804;484;197;287;187938.0;273798.0;461736.0
150640;201804;61;29;32;27666.0;30528.0;58194.0
150650;201804;2331;1373;958;1309804.4;913641.0;2223445.2
150655;201804;246;183;63;174582.0;60102.0;234684.0
150658;201804;106;62;44;59148.0;41976.0;101124.0
150660;201804;488;344;144;328176.0;137376.0;465552.0
150670;201804;1006;365;641;347914.8;611495.44;959410.25
150680;201804;9912;5409;4503;5153015.0;4293526.5;9446541.0
150690;201804;51;32;19;30528.0;18126.0;48654.0
150700;201804;534;344;190;327985.2;181260.0;509245.2
150710;201804;280;167;113;159318.0;107802.0;267120.0
150715;201804;870;527;343;501775.9;327193.38;828969.3
150720;201804;438;338;100;322452.0;95113.8;417565.8
150730;201804;932;496;436;473175.0;415657.8;888832.8
150740;201804;228;161;67;153594.0;63918.0;217512.0
150745;201804;781;423;358;403542.0;341532.0;745074.0
150746;201804;57;34;23;32436.0;21942.0;54378.0
150747;201804;264;206;58;196524.0;55332.0;251856.0
150750;201804;131;76;55;72504.0;52470.0;124974.0
150760;201804;1718;1116;602;1064664.0;574308.0;1638972.0
150770;201804;371;192;179;183168.0;170590.95;353758.94
150775;201804;95;44;51;41976.0;48654.0;90630.0
150780;201804;186;99;87;94446.0;82998.0;177444.0
150790;201804;882;476;406;454104.0;387324.0;841428.0
150795;201804;1454;847;607;808038.0;579078.0;1387116.0
150796;201804;399;230;169;219420.0;161019.84;380439.84
150797;201804;288;163;125;155502.0;119250.0;274752.0
150800;201804;1414;854;560;813757.25;534240.0;1347997.2
150803;201804;596;493;103;470322.0;98262.0;568584.0
150805;201804;188;120;68;114480.0;64858.46;179338.45
150808;201804;993;547;446;521838.0;425484.0;947322.0
150810;201804;3407;2356;1051;2244181.0;1001796.0;3245977.0
150812;201804;423;221;202;210834.0;192708.0;403542.0
150815;201804;966;635;331;604411.5;315774.0;920185.5
150820;201804;1573;961;612;915840.0;583828.94;1499668.9
150830;201804;831;585;246;557136.0;234684.0;791820.0
150835;201804;186;111;75;105894.0;71550.0;177444.0
150840;201804;1344;860;484;820440.0;461736.0;1282176.0
160005;201804;52;30;22;28620.0;20988.0;49608.0
160010;201804;193;120;73;114480.0;69638.0;184118.0
160015;201804;115;65;50;62010.0;47700.0;109710.0
160020;201804;127;72;55;68688.0;52470.0;121158.0
160021;201804;41;21;20;20034.0;19080.0;39114.0
160023;201804;110;64;46;61056.0;43884.0;104940.0
160025;201804;32;14;18;13356.0;17172.0;30528.0
160027;201804;1461;828;633;787145.9;603128.0;1390273.9
160030;201804;15492;7969;7523;7594619.5;7172203.5;1,48E+14
160040;201804;315;181;134;172674.0;127836.0;300510.0
160050;201804;671;340;331;324360.0;315487.8;639847.8
160053;201804;323;182;141;173342.0;134514.0;307856.0
160055;201804;26;19;7;18126.0;6678.0;24804.0
160060;201804;6405;3362;3043;3197604.8;2902064.2;6099669.0
160070;201804;162;99;63;94446.0;60102.0;154548.0
160080;201804;79;42;37;40068.0;35298.0;75366.0
170025;201804;23;15;8;14310.0;7632.0;21942.0
170030;201804;227;185;42;176293.0;40068.0;216361.0
170035;201804;226;110;116;104940.0;110664.0;215604.0
170040;201804;191;148;43;140905.8;41022.0;181927.8
170070;201804;322;193;129;184122.0;123066.0;307188.0
170100;201804;370;268;102;255672.0;97308.0;352980.0
170105;201804;62;51;11;48654.0;10494.0;59148.0
170110;201804;103;63;40;60102.0;38160.0;98262.0
170130;201804;69;32;37;30528.0;35012.0;65540.0
170190;201804;105;67;38;63918.0;36252.0;100170.0
170200;201804;392;262;130;249271.2;123915.76;373186.97
170210;201804;6025;3148;2877;2995096.5;2741396.8;5736493.5
170215;201804;96;45;51;42930.0;48654.0;91584.0
170220;201804;1418;1041;377;991873.8;359372.0;1351245.8
170230;201804;154;100;54;95400.0;51516.0;146916.0
170240;201804;540;355;185;338670.0;176490.0;515160.0
170255;201804;1107;887;220;845988.1;209593.8;1055581.9
170270;201804;37;28;9;26712.0;8395.2;35107.2
170290;201804;80;59;21;56286.0;20034.0;76320.0
170300;201804;82;54;28;50752.8;26712.0;77464.8
170305;201804;45;34;11;32436.0;10494.0;42930.0
170307;201804;65;48;17;45792.0;16218.0;62010.0
170310;201804;103;56;47;53424.0;44838.0;98262.0
170320;201804;17;14;3;13356.0;2862.0;16218.0
170330;201804;21;19;2;18126.0;1908.0;20034.0
170360;201804;24;14;10;13356.0;9540.0;22896.0
170370;201804;123;64;59;61056.0;56286.0;117342.0
170380;201804;79;57;22;54378.0;20988.0;75366.0
170382;201804;46;41;5;39114.0;4770.0;43884.0
170384;201804;130;95;35;90630.0;33390.0;124020.0
170386;201804;61;27;34;25758.0;32436.0;58194.0
170388;201804;48;18;30;17172.0;28620.0;45792.0
170389;201804;23;18;5;17172.0;4770.0;21942.0
170390;201804;54;30;24;28620.0;22896.0;51516.0
170410;201804;35;24;11;22896.0;10494.0;33390.0
170460;201804;16;12;4;11448.0;3816.0;15264.0
170510;201804;29;22;7;20988.0;6678.0;27666.0
170550;201804;1489;844;645;805176.0;614567.0;1419743.0
170555;201804;114;79;35;75366.0;33390.0;108756.0
170560;201804;98;71;27;67734.0;25758.0;93492.0
170600;201804;40;19;21;18126.0;20034.0;38160.0
170610;201804;191;102;89;97150.59;84888.0;182038.6
170625;201804;38;20;18;19080.0;17172.0;36252.0
170650;201804;85;64;21;61056.0;20034.0;81090.0
170700;201804;557;423;134;402302.3;127836.0;530138.3
170710;201804;157;97;60;92538.0;57231.0;149769.0
170720;201804;86;70;16;66780.0;15264.0;82044.0
170730;201804;60;36;24;34344.0;22896.0;57240.0
170740;201804;77;57;20;54378.0;19080.0;73458.0
170755;201804;70;37;33;34678.0;31482.0;66160.0
170765;201804;142;69;73;65206.0;69642.0;134848.0
170770;201804;223;130;93;122922.9;88722.0;211644.9
170820;201804;596;389;207;371106.0;197049.0;568155.0
170825;201804;31;20;11;19080.0;10494.0;29574.0
170830;201804;77;57;20;54187.2;19080.0;73267.2
170900;201804;201;152;49;145008.0;46746.0;191754.0
170930;201804;824;430;394;409896.0;375304.0;785200.0
170950;201804;3046;1325;1721;1263078.2;1638572.5;2901650.8
170980;201804;18;10;8;9540.0;7632.0;17172.0
171050;201804;132;102;30;97308.0;28620.0;125928.0
171070;201804;38;31;7;29574.0;6678.0;36252.0
171090;201804;39;29;10;27666.0;9540.0;37206.0
171110;201804;21;14;7;13356.0;6678.0;20034.0
171150;201804;38;18;20;17172.0;19080.0;36252.0
171180;201804;21;10;11;9540.0;10494.0;20034.0
171190;201804;138;81;57;77274.0;54378.0;131652.0
171195;201804;65;50;15;47700.0;14310.0;62010.0
171200;201804;47;20;27;19080.0;25758.0;44838.0
171215;201804;3;3;0;2862.0;0.0;2862.0
171240;201804;54;44;10;41976.0;9540.0;51516.0
171245;201804;53;48;5;45792.0;4770.0;50562.0
171250;201804;72;38;34;36252.0;32426.46;68678.46
171270;201804;17;13;4;12402.0;3816.0;16218.0
171280;201804;38;35;3;33247.0;2862.0;36109.0
171320;201804;994;562;432;536148.0;411174.0;947322.0
171330;201804;424;204;220;194616.0;209880.0;404496.0
171360;201804;88;64;24;61056.0;22896.0;83952.0
171370;201804;24;13;11;12402.0;10494.0;22896.0
171380;201804;135;110;25;104940.0;23850.0;128790.0
171395;201804;54;33;21;31482.0;20034.0;51516.0
171420;201804;306;202;104;192708.0;98929.8;291637.8
171430;201804;65;52;13;49608.0;12402.0;62010.0
171488;201804;204;108;96;103032.0;91584.0;194616.0
171500;201804;59;32;27;30528.0;25758.0;56286.0
171510;201804;68;45;23;42930.0;21942.0;64872.0
171515;201804;43;37;6;35298.0;5724.0;41022.0
171525;201804;31;26;5;24804.0;4770.0;29574.0
171550;201804;13;7;6;6678.0;5724.0;12402.0
171570;201804;62;30;32;28620.0;30528.0;59148.0
171575;201804;342;211;131;201294.0;124964.46;326258.47
171610;201804;1704;854;850;812817.5;809342.1;1622159.6
171620;201804;131;92;39;87214.68;37206.0;124420.68
171630;201804;50;27;23;25758.0;21942.0;47700.0
171650;201804;274;181;93;172674.0;88722.0;261396.0
171660;201804;265;140;125;133560.0;119246.0;252806.0
171665;201804;48;32;16;30528.0;15264.0;45792.0
171670;201804;429;251;178;236535.27;169239.6;405774.88
171700;201804;63;55;8;52470.0;7632.0;60102.0
171720;201804;25;8;17;7632.0;16218.0;23850.0
171750;201804;102;54;48;51516.0;45792.0;97308.0
171780;201804;74;60;14;57240.0;13356.0;70596.0
171790;201804;78;65;13;62010.0;12402.0;74412.0
171800;201804;35;27;8;25758.0;7632.0;33390.0
171820;201804;2069;1165;904;1109669.6;857808.8;1967478.5
171830;201804;37;29;8;27666.0;7632.0;35298.0
171840;201804;63;36;27;34344.0;25758.0;60102.0
171845;201804;31;20;11;19080.0;10494.0;29574.0
171850;201804;40;29;11;27666.0;10494.0;38160.0
171855;201804;78;61;17;58194.0;16218.0;74412.0
171865;201804;8;7;1;6678.0;954.0;7632.0
171870;201804;30;21;9;20034.0;8586.0;28620.0
171875;201804;78;53;25;50562.0;23850.0;74412.0
171880;201804;29;21;8;20034.0;7632.0;27666.0
171884;201804;47;24;23;22896.0;21942.0;44838.0
171886;201804;118;41;77;39114.0;73171.8;112285.8
171888;201804;24;18;6;17172.0;5724.0;22896.0
171889;201804;19;15;4;14310.0;3816.0;18126.0
171890;201804;56;46;10;43884.0;9540.0;53424.0
171900;201804;42;29;13;27666.0;12402.0;40068.0
172000;201804;39;33;6;31482.0;5724.0;37206.0
172010;201804;42;35;7;32579.1;6678.0;39257.1
172015;201804;27;17;10;16218.0;9253.8;25471.8
172020;201804;130;82;48;78228.0;45792.0;124020.0
172025;201804;32;21;11;20034.0;10494.0;30528.0
172030;201804;36;20;16;19080.0;15264.0;34344.0
172049;201804;75;44;31;41976.0;29574.0;71550.0
172065;201804;147;96;51;91534.0;48654.0;140188.0
172080;201804;94;66;28;61781.84;26712.0;88493.84
172085;201804;25;12;13;11448.0;12402.0;23850.0
172090;201804;403;308;95;293832.0;89867.0;383699.0
172093;201804;24;18;6;17172.0;5724.0;22896.0
172097;201804;17;8;9;7632.0;8300.0;15932.0
172100;201804;4714;2647;2067;2520039.8;1969449.0;4489489.0
172110;201804;81;54;27;51516.0;25758.0;77274.0
172120;201804;1717;1469;248;1395309.6;236208.5;1631518.1
172125;201804;4;4;0;3816.0;0.0;3816.0
172130;201804;17;13;4;12402.0;3816.0;16218.0
172208;201804;194;124;70;118296.0;66780.0;185076.0
172210;201804;428;207;221;197478.0;210548.0;408026.0
210005;201804;2933;1829;1104;1741813.2;1050356.0;2792169.2
210010;201804;190;98;92;93492.0;87768.0;181260.0
210015;201804;29;19;10;18126.0;9540.0;27666.0
210020;201804;348;179;169;170766.0;161226.0;331992.0
210030;201804;346;217;129;207018.0;123057.0;330075.0
210040;201804;154;119;35;113526.0;33390.0;146916.0
210043;201804;255;171;84;163134.0;80136.0;243270.0
210047;201804;605;315;290;300128.4;276650.47;576778.9
210050;201804;297;217;80;207018.0;76320.0;283338.0
210055;201804;42;32;10;30528.0;9540.0;40068.0
210060;201804;567;444;123;423368.22;117342.0;540710.25
210070;201804;411;301;110;287154.0;104940.0;392094.0
210080;201804;103;95;8;90630.0;7632.0;98262.0
210083;201804;307;131;176;124974.0;167904.0;292878.0
210087;201804;43;31;12;29574.0;11448.0;41022.0
210090;201804;493;341;152;325314.0;145008.0;470322.0
210095;201804;491;355;136;338660.47;129744.0;468404.47
210100;201804;688;523;165;498608.1;156456.02;655064.1
210110;201804;149;81;68;77274.0;64872.0;142146.0
210120;201804;5461;4100;1361;3904480.2;1297140.6;5201621.0
210125;201804;218;124;94;118296.0;89676.0;207972.0
210130;201804;551;287;264;272844.0;251836.92;524680.94
210135;201804;35;21;14;20034.0;13356.0;33390.0
210140;201804;4365;3425;940;3263970.5;896522.0;4160492.5
210150;201804;358;227;131;216558.0;124974.0;341532.0
210160;201804;3371;2833;538;2699822.8;512966.0;3212788.8
210170;201804;1133;883;250;842382.0;238500.0;1080882.0
210173;201804;121;100;21;95400.0;20034.0;115434.0
210177;201804;464;226;238;215604.0;227052.0;442656.0
210180;201804;32;18;14;17172.0;13356.0;30528.0
210190;201804;415;264;151;251856.0;144054.0;395910.0
210193;201804;1;1;0;954.0;0.0;954.0
210197;201804;83;54;29;51516.0;27647.88;79163.88
210200;201804;636;502;134;478908.0;127836.0;606744.0
210203;201804;262;175;87;166950.0;82998.0;249948.0
210207;201804;383;297;86;283338.0;82044.0;365382.0
210210;201804;775;704;71;671616.0;67734.0;739350.0
210215;201804;78;66;12;62964.0;11448.0;74412.0
210220;201804;394;323;71;308142.0;67447.8;375589.8
210230;201804;305;230;75;219420.0;71550.0;290970.0
210232;201804;1474;933;541;889796.0;516114.0;1405910.0
210235;201804;156;122;34;116198.0;32436.0;148634.0
210237;201804;46;25;21;23850.0;20034.0;43884.0
210240;201804;94;77;17;73458.0;16218.0;89676.0
210250;201804;186;149;37;142146.0;35298.0;177444.0
210255;201804;346;255;91;243270.0;86814.0;330084.0
210260;201804;416;263;153;250902.0;145962.0;396864.0
210270;201804;695;441;254;420714.0;242316.0;663030.0
210275;201804;45;35;10;33390.0;9540.0;42930.0
210280;201804;1038;661;377;627779.3;358322.5;986101.8
210290;201804;506;328;178;312912.0;169812.0;482724.0
210300;201804;6095;3547;2548;3378629.2;2429600.2;5808229.5
210310;201804;104;71;33;67734.0;31482.0;99216.0
210312;201804;128;81;47;77274.0;44838.0;122112.0
210315;201804;116;85;31;81090.0;29574.0;110664.0
210317;201804;125;88;37;83952.0;35298.0;119250.0
210320;201804;2393;1970;423;1877669.9;403542.0;2281211.8
210325;201804;131;88;43;82998.0;40736.0;123734.0
210330;201804;5522;2830;2692;2694997.8;2568158.5;5263156.0
210340;201804;1394;999;395;952246.0;376759.06;1329005.1
210350;201804;615;502;113;478669.5;107802.0;586471.5
210355;201804;134;107;27;102078.0;25758.0;127836.0
210360;201804;2642;1655;987;1575723.6;941312.0;2517035.5
210370;201804;1248;544;704;518976.0;670948.2;1189924.2
210375;201804;183;96;87;91041.0;82998.0;174039.0
210380;201804;728;542;186;517068.0;177444.0;694512.0
210390;201804;203;166;37;158364.0;35298.0;193662.0
210400;201804;417;350;67;333900.0;63899.0;397799.0
210405;201804;1015;677;338;645858.0;322452.0;968310.0
210407;201804;56;44;12;41976.0;11448.0;53424.0
210408;201804;66;59;7;56286.0;6678.0;62964.0
210409;201804;317;264;53;251856.0;50562.0;302418.0
210410;201804;440;341;99;325314.0;94437.0;419751.0
210420;201804;194;159;35;151686.0;33390.0;185076.0
210430;201804;38;28;10;26712.0;9540.0;36252.0
210440;201804;376;227;149;216558.0;142146.0;358704.0
210450;201804;145;107;38;102078.0;36252.0;138330.0
210455;201804;225;124;101;118296.0;96354.0;214650.0
210460;201804;347;219;128;208926.0;122112.0;331038.0
210462;201804;62;52;10;49608.0;9540.0;59148.0
210465;201804;173;125;48;119250.0;45792.0;165042.0
210467;201804;525;378;147;360612.0;140238.0;500850.0
210470;201804;46;34;12;32436.0;11448.0;43884.0
210480;201804;1311;923;388;880542.0;370152.0;1250694.0
210490;201804;220;130;90;124020.0;85860.0;209880.0
210500;201804;572;300;272;286200.0;259488.0;545688.0
210510;201804;555;431;124;411174.0;118296.0;529470.0
210515;201804;447;244;203;232776.0;193662.0;426438.0
210520;201804;403;352;51;335521.8;48654.0;384175.8
210530;201804;9420;5041;4379;4797240.5;4171734.0;8968975.0
210535;201804;131;94;37;89676.0;35298.0;124974.0
210540;201804;1546;932;614;887983.8;584325.0;1472308.8
210542;201804;1173;589;584;561524.4;556564.0;1118088.4
210545;201804;13;12;1;11448.0;954.0;12402.0
210547;201804;136;116;20;110664.0;19080.0;129744.0
210550;201804;744;520;224;494532.0;213696.0;708228.0
210560;201804;173;145;28;138330.0;26712.0;165042.0
210565;201804;30;21;9;20034.0;8586.0;28620.0
210570;201804;1366;1071;295;1021734.0;281430.0;1303164.0
210580;201804;106;92;14;87768.0;13356.0;101124.0
210590;201804;775;607;168;578314.8;160272.0;738586.8
210592;201804;32;28;4;26712.0;3816.0;30528.0
210594;201804;105;86;19;82044.0;18126.0;100170.0
210596;201804;84;70;14;66780.0;13356.0;80136.0
210598;201804;125;91;34;86814.0;32436.0;119250.0
210600;201804;335;282;53;269028.0;50562.0;319590.0
210610;201804;251;232;19;220374.0;18126.0;238500.0
210620;201804;47;27;20;25758.0;19080.0;44838.0
210630;201804;59;57;2;54378.0;1908.0;56286.0
210632;201804;1109;734;375;700236.0;357273.0;1057509.0
210635;201804;16;13;3;12402.0;2862.0;15264.0
210637;201804;106;74;32;70596.0;30528.0;101124.0
210640;201804;585;512;73;488448.0;69642.0;558090.0
210650;201804;406;327;79;311032.62;74412.0;385444.62
210660;201804;400;286;114;272177.0;108632.0;380809.0
210663;201804;18;11;7;10494.0;6678.0;17172.0
210667;201804;114;35;79;33390.0;75366.0;108756.0
210670;201804;272;239;33;227291.0;31482.0;258773.0
210675;201804;571;294;277;280476.0;264258.0;544734.0
210680;201804;210;131;79;124974.0;75366.0;200340.0
210690;201804;649;511;138;487494.0;131652.0;619146.0
210700;201804;192;141;51;134514.0;48654.0;183168.0
210710;201804;298;165;133;157219.2;126882.0;284101.2
210720;201804;126;105;21;100170.0;20034.0;120204.0
210725;201804;67;58;9;55332.0;8586.0;63918.0
210730;201804;25;19;6;18126.0;5724.0;23850.0
210735;201804;416;278;138;265212.0;131366.0;396578.0
210740;201804;547;461;86;439794.0;82044.0;521838.0
210745;201804;151;109;42;103986.0;40068.0;144054.0
210750;201804;2420;1095;1325;1042675.0;1264030.9;2306706.0
210760;201804;273;199;74;189846.0;70581.69;260427.69
210770;201804;404;312;92;297648.0;87481.8;385129.8
210780;201804;423;303;120;289062.0;114480.0;403542.0
210790;201804;184;143;41;136422.0;39114.0;175536.0
210800;201804;142;104;38;99216.0;36252.0;135468.0
210805;201804;42;38;4;36252.0;3816.0;40068.0
210810;201804;485;369;116;351358.2;110664.0;462022.2
210820;201804;2318;1836;482;1743428.5;459828.0;2203256.5
210825;201804;172;88;84;83952.0;80136.0;164088.0
210830;201804;805;488;317;464598.0;301464.0;766062.0
210840;201804;214;142;72;135468.0;68688.0;204156.0
210845;201804;254;160;94;152640.0;89676.0;242316.0
210850;201804;856;543;313;518022.0;298602.0;816624.0
210860;201804;4152;2130;2022;2029540.2;1928682.8;3958223.0
210870;201804;469;353;116;336762.0;110664.0;447426.0
210880;201804;58;39;19;37206.0;18126.0;55332.0
210890;201804;342;282;60;269028.0;57240.0;326268.0
210900;201804;574;375;199;357746.0;189846.0;547592.0
210905;201804;70;35;35;33390.0;33390.0;66780.0
210910;201804;2013;1489;524;1419168.0;499896.0;1919064.0
210920;201804;231;68;163;64872.0;155502.0;220374.0
210923;201804;81;57;24;54378.0;22896.0;77274.0
210927;201804;438;181;257;172674.0;245178.0;417852.0
210930;201804;63;49;14;46746.0;13356.0;60102.0
210940;201804;93;70;23;66780.0;21942.0;88722.0
210945;201804;193;87;106;82998.0;101124.0;184122.0
210950;201804;507;364;143;347256.0;136417.23;483673.22
210955;201804;75;49;26;46746.0;24804.0;71550.0
210960;201804;2463;1042;1421;992446.4;1355348.0;2347794.5
210970;201804;114;98;16;93492.0;15264.0;108756.0
210975;201804;91;81;10;77274.0;9540.0;86814.0
210980;201804;1235;530;705;505505.53;672284.0;1177789.5
210990;201804;4367;2712;1655;2586147.2;1578870.0;4165017.2
211000;201804;1381;1089;292;1038620.0;278281.8;1316901.8
211003;201804;925;631;294;601974.0;280467.0;882441.0
211010;201804;482;422;60;402588.0;57240.0;459828.0
211020;201804;1625;586;1039;559044.0;990986.56;1550030.6
211023;201804;27;23;4;21655.8;3816.0;25471.8
211027;201804;63;41;22;39114.0;20988.0;60102.0
211030;201804;387;259;128;247086.0;122112.0;369198.0
211040;201804;320;243;77;231536.0;73458.0;304994.0
211050;201804;1180;750;430;715500.0;409929.22;1125429.2
211060;201804;685;579;106;550171.8;101124.0;651295.8
211065;201804;23;19;4;18126.0;3816.0;21942.0
211070;201804;923;749;174;712934.75;165996.0;878930.75
211080;201804;88;84;4;80136.0;3816.0;83952.0
211085;201804;60;32;28;30242.0;26712.0;56954.0
211090;201804;92;74;18;70596.0;17172.0;87768.0
211100;201804;505;402;103;382267.8;98262.0;480529.8
211102;201804;261;173;88;165042.0;83952.0;248994.0
211105;201804;222;152;70;145008.0;66780.0;211788.0
211107;201804;135;77;58;73458.0;55332.0;128790.0
211110;201804;828;531;297;506002.0;283329.0;789331.0
211120;201804;5814;2463;3351;2344324.5;3195762.2;5540087.0
211125;201804;36;29;7;27666.0;6678.0;34344.0
211130;201804;45969;19166;26803;1,83E+14;2,56E+14;4,38E+13
211140;201804;428;361;67;343436.0;63918.0;407354.0
211150;201804;1261;796;465;759050.1;443320.0;1202370.1
211153;201804;167;97;70;92538.0;66780.0;159318.0
211157;201804;63;46;17;43884.0;16218.0;60102.0
211160;201804;710;588;122;559985.5;116388.0;676373.5
211163;201804;0;0;0;0.0;0.0;0.0
211167;201804;7;5;2;4770.0;1908.0;6678.0
211170;201804;446;308;138;293832.0;131652.0;425484.0
211172;201804;122;85;37;81090.0;35298.0;116388.0
211174;201804;281;164;117;156456.0;111618.0;268074.0
211176;201804;521;373;148;355842.0;141192.0;497034.0
211178;201804;95;61;34;58194.0;32436.0;90630.0
211180;201804;207;162;45;154548.0;42767.82;197315.81
211190;201804;62;57;5;54378.0;4770.0;59148.0
211195;201804;25;16;9;15264.0;8586.0;23850.0
211200;201804;157;136;21;129400.56;20034.0;149434.56
211210;201804;531;331;200;315106.2;190800.0;505906.2
211220;201804;3995;2246;1749;2134841.5;1662209.0;3797050.5
211223;201804;96;89;7;84724.74;6678.0;91402.74
211227;201804;70;48;22;45792.0;20988.0;66780.0
211230;201804;782;632;150;602784.9;143080.92;745865.8
211240;201804;418;314;104;299556.0;99216.0;398772.0
211245;201804;212;93;119;88722.0;113526.0;202248.0
211250;201804;1640;1398;242;1332700.1;230868.0;1563568.1
211260;201804;820;641;179;611514.0;170766.0;782280.0
211270;201804;2091;1640;451;1564560.0;429300.2;1993860.2
211280;201804;1826;1086;740;1035090.8;705960.0;1741050.8
211285;201804;207;120;87;114480.0;82998.0;197478.0
211290;201804;688;459;229;437695.2;218466.0;656161.2
211300;201804;812;622;190;593110.06;181260.0;774370.06
211400;201804;1604;905;699;863370.0;666846.0;1530216.0
220005;201804;18;17;1;16218.0;954.0;17172.0
220010;201804;88;67;21;63918.0;19747.8;83665.8
220020;201804;617;484;133;460751.03;126882.0;587633.06
220025;201804;107;103;4;98262.0;3816.0;102078.0
220027;201804;34;27;7;25758.0;6678.0;32436.0
220030;201804;99;81;18;77274.0;17172.0;94446.0
220040;201804;1133;850;283;809736.94;269982.0;1079719.0
220045;201804;38;28;10;26712.0;9540.0;36252.0
220050;201804;653;534;119;508274.97;113506.92;621781.9
220060;201804;170;145;25;138330.0;23850.0;162180.0
220070;201804;97;88;9;83952.0;8586.0;92538.0
220080;201804;10;9;1;8586.0;954.0;9540.0
220090;201804;36;29;7;27380.0;6678.0;34058.0
220095;201804;2;1;1;954.0;954.0;1908.0
220100;201804;28;24;4;22896.0;3816.0;26712.0
220105;201804;27;25;2;23278.0;1908.0;25186.0
220110;201804;208;192;16;182881.8;15264.0;198145.8
220115;201804;47;44;3;41976.0;2862.0;44838.0
220117;201804;18;17;1;16218.0;954.0;17172.0
220120;201804;1530;1062;468;1012519.3;446452.9;1458972.2
220130;201804;26;25;1;23850.0;954.0;24804.0
220140;201804;98;78;20;73458.0;19080.0;92538.0
220150;201804;455;323;132;308142.0;125928.0;434070.0
220155;201804;4;4;0;3816.0;0.0;3816.0
220157;201804;18;15;3;14310.0;2862.0;17172.0
220160;201804;71;61;10;58194.0;9540.0;67734.0
220170;201804;35;33;2;31482.0;1908.0;33390.0
220173;201804;7;7;0;6678.0;0.0;6678.0
220177;201804;7;6;1;5724.0;954.0;6678.0
220180;201804;65;64;1;61051.23;668.0;61719.23
220190;201804;1053;942;111;898668.0;105894.0;1004562.0
220191;201804;42;37;5;35298.0;4770.0;40068.0
220192;201804;62;59;3;56286.0;2862.0;59148.0
220194;201804;34;30;4;28620.0;3816.0;32436.0
220196;201804;103;85;18;81090.0;17172.0;98262.0
220198;201804;7;5;2;4770.0;1908.0;6678.0
220200;201804;434;355;79;339116.0;75366.0;414482.0
220202;201804;37;33;4;31482.0;3816.0;35298.0
220205;201804;41;35;6;33390.0;5724.0;39114.0
220207;201804;19;18;1;17172.0;954.0;18126.0
220208;201804;84;44;40;41976.0;38160.0;80136.0
220209;201804;31;28;3;26712.0;2862.0;29574.0
220210;201804;15;13;2;12402.0;1908.0;14310.0
220211;201804;27;27;0;25758.0;0.0;25758.0
220213;201804;42;38;4;36252.0;3530.0;39782.0
220217;201804;36;28;8;26712.0;7632.0;34344.0
220220;201804;2042;1298;744;1234686.6;708373.94;1943060.6
220225;201804;17;9;8;8586.0;7632.0;16218.0
220230;201804;942;744;198;709327.6;188252.81;897580.44
220240;201804;147;134;13;127836.0;12402.0;140238.0
220245;201804;33;30;3;27917.04;2862.0;30779.04
220250;201804;108;97;11;92538.0;10494.0;103032.0
220253;201804;45;37;8;35298.0;7632.0;42930.0
220255;201804;28;25;3;23850.0;2862.0;26712.0
220260;201804;688;498;190;475092.0;181260.0;656352.0
220265;201804;15;12;3;11448.0;2862.0;14310.0
220270;201804;677;598;79;569766.94;74889.0;644655.94
220271;201804;46;38;8;36252.0;7632.0;43884.0
220272;201804;28;27;1;25758.0;954.0;26712.0
220273;201804;14;12;2;11448.0;1908.0;13356.0
220275;201804;58;47;11;44838.0;10494.0;55332.0
220277;201804;11;9;2;8586.0;1908.0;10494.0
220280;201804;15;12;3;11448.0;2862.0;14310.0
220285;201804;42;39;3;37206.0;2862.0;40068.0
220290;201804;1383;1181;202;1124146.0;192661.0;1316807.0
220300;201804;53;52;1;49608.0;954.0;50562.0
220310;201804;317;267;50;254714.0;47691.0;302405.0
220320;201804;439;404;35;383986.0;33390.0;417376.0
220323;201804;0;0;0;0.0;0.0;0.0
220325;201804;15;10;5;9540.0;4770.0;14310.0
220327;201804;11;10;1;9540.0;954.0;10494.0
220330;201804;205;140;65;133560.0;62010.0;195570.0
220335;201804;139;121;18;115434.0;17172.0;132606.0
220340;201804;25;15;10;14310.0;9540.0;23850.0
220342;201804;55;47;8;44838.0;7632.0;52470.0
220345;201804;83;75;8;71550.0;7632.0;79182.0
220350;201804;432;377;55;357035.4;52470.0;409505.4
220360;201804;43;31;12;29574.0;11448.0;41022.0
220370;201804;1122;898;224;855928.8;213409.8;1069338.6
220375;201804;27;25;2;23850.0;1908.0;25758.0
220380;201804;38;31;7;29574.0;6678.0;36252.0
220385;201804;28;24;4;22896.0;3816.0;26712.0
220390;201804;2237;1270;967;1206886.5;921135.5;2128022.0
220400;201804;28;26;2;24804.0;1908.0;26712.0
220410;201804;15;14;1;13356.0;954.0;14310.0
220415;201804;13;12;1;11448.0;954.0;12402.0
220420;201804;123;102;21;97308.0;19747.8;117055.8
220430;201804;130;118;12;110903.8;11448.0;122351.8
220435;201804;21;15;6;14306.0;5724.0;20030.0
220440;201804;291;248;43;236592.0;41022.0;277614.0
220450;201804;333;169;164;160060.98;156456.0;316516.97
220455;201804;53;51;2;48654.0;1908.0;50562.0
220460;201804;17;17;0;15550.2;0.0;15550.2
220465;201804;108;69;39;65826.0;37206.0;103032.0
220470;201804;240;211;29;201294.0;27666.0;228960.0
220480;201804;71;60;11;57240.0;10494.0;67734.0
220490;201804;85;74;11;70596.0;10494.0;81090.0
220500;201804;97;84;13;80136.0;12402.0;92538.0
220510;201804;385;305;80;290207.0;76129.2;366336.2
220515;201804;21;17;4;16218.0;3816.0;20034.0
220520;201804;374;336;38;319229.0;36233.0;355462.0
220525;201804;26;18;8;17172.0;7632.0;24804.0
220527;201804;38;29;9;27666.0;7776.0;35442.0
220530;201804;34;13;21;12402.0;20034.0;32436.0
220535;201804;9;9;0;8586.0;0.0;8586.0
220540;201804;65;52;13;49608.0;12402.0;62010.0
220545;201804;60;39;21;37206.0;20034.0;57240.0
220550;201804;645;492;153;468604.8;145962.0;614566.8
220551;201804;27;20;7;19080.0;6678.0;25758.0
220552;201804;8;8;0;7632.0;0.0;7632.0
220553;201804;47;43;4;41022.0;3816.0;44838.0
220554;201804;13;8;5;7345.8;4770.0;12115.8
220555;201804;24;20;4;19080.0;3816.0;22896.0
220556;201804;55;51;4;48654.0;3816.0;52470.0
220557;201804;57;51;6;48654.0;5724.0;54378.0
220558;201804;7;2;5;1908.0;4770.0;6678.0
220559;201804;7;6;1;5724.0;954.0;6678.0
220560;201804;58;37;21;35107.2;20034.0;55141.2
220570;201804;801;478;323;454607.12;308142.0;762749.1
220580;201804;560;513;47;489402.0;44151.92;533553.94
220585;201804;6;5;1;4770.0;954.0;5724.0
220590;201804;14;14;0;13356.0;0.0;13356.0
220595;201804;58;43;15;41022.0;14310.0;55332.0
220600;201804;22;12;10;11448.0;9540.0;20988.0
220605;201804;20;19;1;18126.0;954.0;19080.0
220610;201804;62;53;9;50562.0;8586.0;59148.0
220620;201804;560;438;122;417613.5;116388.0;534001.5
220630;201804;6;4;2;3816.0;1908.0;5724.0
220635;201804;37;33;4;31482.0;3816.0;35298.0
220640;201804;98;77;21;73458.0;20034.0;93492.0
220650;201804;114;108;6;103032.0;5724.0;108756.0
220660;201804;30;24;6;22896.0;5724.0;28620.0
220665;201804;4;4;0;3816.0;0.0;3816.0
220667;201804;14;11;3;10494.0;2862.0;13356.0
220669;201804;26;23;3;21942.0;2862.0;24804.0
220670;201804;72;56;16;53233.2;15264.0;68497.2
220672;201804;63;42;21;40068.0;20034.0;60102.0
220675;201804;36;28;8;26712.0;7632.0;34344.0
220680;201804;34;28;6;26712.0;5724.0;32436.0
220690;201804;46;44;2;41976.0;1908.0;43884.0
220695;201804;59;28;31;26712.0;29574.0;56286.0
220700;201804;1545;1185;360;1128648.8;343440.0;1472088.8
220710;201804;3;1;2;954.0;1908.0;2862.0
220720;201804;111;90;21;85621.5;19890.9;105512.4
220730;201804;20;19;1;18126.0;954.0;19080.0
220735;201804;3;1;2;954.0;1908.0;2862.0
220740;201804;46;42;4;40068.0;3816.0;43884.0
220750;201804;98;80;18;76320.0;17172.0;93492.0
220755;201804;14;14;0;13356.0;0.0;13356.0
220760;201804;53;50;3;47700.0;2862.0;50562.0
220770;201804;5821;2922;2899;2782378.8;2759509.5;5541888.0
220775;201804;24;10;14;9540.0;13356.0;22896.0
220777;201804;16;15;1;14310.0;954.0;15264.0
220779;201804;18;14;4;13356.0;3816.0;17172.0
220780;201804;876;748;128;712924.2;121826.0;834750.2
220785;201804;13;7;6;6678.0;5724.0;12402.0
220790;201804;1011;803;208;763660.0;198432.0;962092.0
220793;201804;13;13;0;12402.0;0.0;12402.0
220795;201804;22;21;1;20034.0;954.0;20988.0
220800;201804;3931;3004;927;2864173.2;883095.9;3747269.2
220810;201804;62;55;7;52470.0;6678.0;59148.0
220820;201804;240;218;22;207972.0;20988.0;228960.0
220830;201804;1163;984;179;938731.25;170747.0;1109478.2
220840;201804;2440;1618;822;1530777.9;782090.0;2312867.8
220850;201804;53;43;10;41022.0;9540.0;50562.0
220855;201804;14;9;5;8586.0;4770.0;13356.0
220860;201804;8;7;1;6678.0;954.0;7632.0
220865;201804;23;21;2;20034.0;1908.0;21942.0
220870;201804;59;57;2;54378.0;1908.0;56286.0
220880;201804;317;242;75;230200.2;71264.0;301464.2
220885;201804;47;44;3;41976.0;2862.0;44838.0
220887;201804;19;17;2;16218.0;1908.0;18126.0
220890;201804;101;89;12;84906.0;11448.0;96354.0
220900;201804;47;26;21;24804.0;20034.0;44838.0
220910;201804;53;45;8;42930.0;7632.0;50562.0
220915;201804;10;9;1;8586.0;954.0;9540.0
220920;201804;39;36;3;34344.0;2862.0;37206.0
220930;201804;42;41;1;39114.0;954.0;40068.0
220935;201804;15;15;0;14310.0;0.0;14310.0
220937;201804;44;41;3;39114.0;2862.0;41976.0
220940;201804;52;48;4;45792.0;3816.0;49608.0
220945;201804;0;0;0;0.0;0.0;0.0
220950;201804;47;43;4;41022.0;3816.0;44838.0
220955;201804;35;31;4;29574.0;3816.0;33390.0
220960;201804;1;1;0;954.0;0.0;954.0
220965;201804;28;25;3;23850.0;2862.0;26712.0
220970;201804;46;39;7;37206.0;6678.0;43884.0
220975;201804;9;8;1;7632.0;954.0;8586.0
220980;201804;33;31;2;29574.0;1908.0;31482.0
220985;201804;65;58;7;55332.0;6678.0;62010.0
220987;201804;31;30;1;28620.0;954.0;29574.0
220990;201804;13;12;1;11448.0;954.0;12402.0
220995;201804;37;32;5;30528.0;4770.0;35298.0
220997;201804;42;34;8;32436.0;7632.0;40068.0
221000;201804;1128;1014;114;963923.6;108469.8;1072393.4
221005;201804;62;56;6;53424.0;5724.0;59148.0
221010;201804;17;14;3;13356.0;2862.0;16218.0
221020;201804;44;42;2;40068.0;1908.0;41976.0
221030;201804;29;23;6;21942.0;5724.0;27666.0
221035;201804;19;19;0;18126.0;0.0;18126.0
221037;201804;12;6;6;5724.0;5724.0;11448.0
221038;201804;25;23;2;21942.0;1908.0;23850.0
221039;201804;23;23;0;21942.0;0.0;21942.0
221040;201804;257;222;35;211788.0;33390.0;245178.0
221050;201804;234;197;37;187938.0;35298.0;223236.0
221060;201804;1723;1513;210;1441886.8;200340.0;1642226.8
221062;201804;28;27;1;25758.0;954.0;26712.0
221063;201804;14;10;4;9540.0;3816.0;13356.0
221065;201804;50;43;7;41022.0;6678.0;47700.0
221070;201804;139;120;19;114480.0;18126.0;132606.0
221080;201804;376;334;42;318636.0;39781.8;358417.8
221090;201804;36;35;1;33390.0;954.0;34344.0
221093;201804;55;37;18;35298.0;17172.0;52470.0
221095;201804;11;10;1;9540.0;954.0;10494.0
221097;201804;20;17;3;16218.0;2862.0;19080.0
221100;201804;24688;14192;10496;1,35E+14;1,00E+14;2,35E+14
221110;201804;1031;754;277;719030.0;264258.0;983288.0
221120;201804;533;395;138;376544.0;131652.0;508196.0
221130;201804;939;766;173;729524.8;165042.0;894566.8
221135;201804;34;31;3;29574.0;2862.0;32436.0
221140;201804;40;32;8;30528.0;7632.0;38160.0
221150;201804;16;13;3;12402.0;2862.0;15264.0
221160;201804;13;13;0;12402.0;0.0;12402.0
221170;201804;13;13;0;12402.0;0.0;12402.0
230010;201804;164;151;13;144054.0;12402.0;156456.0
230015;201804;114;94;20;89676.0;19080.0;108756.0
230020;201804;1559;1327;232;1263029.9;220426.56;1483456.4
230030;201804;1634;1172;462;1112519.0;440748.0;1553267.0
230040;201804;203;179;24;169573.5;22896.0;192469.5
230050;201804;210;153;57;145962.0;54378.0;200340.0
230060;201804;153;126;27;119440.8;25758.0;145198.8
230070;201804;278;248;30;236592.0;28620.0;265212.0
230075;201804;805;700;105;665797.0;99883.8;765680.8
230080;201804;181;156;25;148824.0;23850.0;172674.0
230090;201804;97;66;31;62200.8;29574.0;91774.8
230100;201804;1939;1149;790;1093859.0;753660.0;1847519.0
230110;201804;2643;1691;952;1610815.4;907635.8;2518451.2
230120;201804;941;749;192;712162.25;183149.0;895311.25
230125;201804;137;112;25;106848.0;23850.0;130698.0
230130;201804;459;412;47;393048.0;44838.0;437886.0
230140;201804;204;175;29;166950.0;27666.0;194616.0
230150;201804;157;121;36;115434.0;34344.0;149778.0
230160;201804;913;789;124;752229.0;118296.0;870525.0
230170;201804;584;539;45;509693.7;42930.0;552623.7
230180;201804;79;74;5;70596.0;4770.0;75366.0
230185;201804;409;352;57;334442.84;54378.0;388820.84
230190;201804;2198;1776;422;1690324.5;402271.0;2092595.5
230195;201804;487;425;62;405450.0;59148.0;464598.0
230200;201804;370;321;49;305270.47;46746.0;352016.47
230205;201804;357;226;131;213834.33;124974.0;338808.34
230210;201804;1259;1003;256;955535.3;243460.8;1198996.1
230220;201804;1409;976;433;930340.8;413082.0;1343422.8
230230;201804;892;785;107;747983.7;102078.0;850061.7
230240;201804;1625;1399;226;1332961.8;215604.0;1548565.8
230250;201804;1776;1465;311;1393172.0;296694.0;1689866.0
230260;201804;2945;1774;1171;1687203.1;1116161.8;2803364.8
230270;201804;1339;1075;264;1023332.0;250663.5;1273995.5
230280;201804;2717;2022;695;1922313.2;662362.2;2584675.5
230290;201804;398;363;35;340165.06;33390.0;373555.06
230300;201804;515;382;133;363168.72;126882.0;490050.72
230310;201804;415;312;103;297500.12;98262.0;395762.12
230320;201804;913;778;135;738228.6;128790.0;867018.6
230330;201804;298;239;59;227242.8;56096.0;283338.8
230340;201804;452;363;89;345349.0;84906.0;430255.0
230350;201804;3052;1913;1139;1824982.9;1083745.1;2908728.0
230360;201804;262;215;47;204200.0;44838.0;249038.0
230365;201804;134;108;26;102317.0;24804.0;127121.0
230370;201804;9778;4771;5007;4543684.0;4772239.5;9315923.0
230380;201804;462;398;64;379406.0;60102.6;439508.6
230390;201804;507;280;227;265316.94;216558.0;481874.94
230393;201804;267;220;47;209026.8;44838.0;253864.8
230395;201804;334;271;63;258286.0;60102.0;318388.0
230400;201804;597;476;121;452196.0;114937.92;567133.94
230410;201804;2625;1631;994;1550346.8;947990.0;2498336.8
230420;201804;5956;3892;2064;3694783.8;1964474.4;5659258.0
230423;201804;313;270;43;257580.0;41022.0;298602.0
230425;201804;353;293;60;278921.0;57240.0;336161.0
230426;201804;108;97;11;91812.96;10207.8;102020.76
230427;201804;78;75;3;71550.0;2862.0;74412.0
230428;201804;1355;697;658;664709.06;627732.0;1292441.0
230430;201804;445;359;86;342292.0;82044.0;424336.0
230435;201804;797;561;236;533652.25;223904.61;757556.8
230440;201804;83762;36995;46767;3,52E+14;4,46E+13;7,98E+14
230445;201804;268;187;81;178207.2;77274.0;255481.2
230450;201804;537;436;101;415944.0;96354.0;512298.0
230460;201804;58;49;9;46746.0;8586.0;55332.0
230465;201804;300;244;56;232776.0;53424.0;286200.0
230470;201804;1860;1451;409;1384254.0;389079.1;1773333.1
230480;201804;150;144;6;137089.8;5724.0;142813.8
230490;201804;278;224;54;213696.0;51516.0;265212.0
230495;201804;436;328;108;312058.0;103032.0;415090.0
230500;201804;952;716;236;682110.0;225144.0;907254.0
230510;201804;45;36;9;34344.0;8586.0;42930.0
230520;201804;385;306;79;291924.0;75366.0;367290.0
230523;201804;2028;1279;749;1217872.9;714098.0;1931970.9
230526;201804;294;244;50;232776.0;46909.0;279685.0
230530;201804;675;505;170;478757.6;161226.2;639983.8
230533;201804;182;173;9;165042.0;8586.0;173628.0
230535;201804;345;259;86;247086.0;82044.0;329130.0
230540;201804;1831;1600;231;1523757.0;219801.8;1743558.9
230550;201804;3603;2317;1286;2202188.0;1225494.1;3427682.2
230560;201804;575;440;135;417661.8;127836.0;545497.8
230565;201804;194;141;53;134514.0;50562.0;185076.0
230570;201804;301;267;34;254718.0;32436.0;287154.0
230580;201804;1099;809;290;769572.75;275706.0;1045278.75
230590;201804;951;737;214;699522.1;203679.0;903201.1
230600;201804;259;235;24;223446.06;22896.0;246342.06
230610;201804;338;270;68;257390.0;64872.0;322262.0
230620;201804;162;134;28;126882.0;26712.0;153594.0
230625;201804;722;522;200;496443.3;189646.69;686090.0
230630;201804;1251;991;260;945414.0;247658.4;1193072.4
230640;201804;3520;3039;481;2891971.8;458115.56;3350087.2
230650;201804;393;343;50;326362.38;47700.0;374062.38
230655;201804;638;554;84;527562.8;80070.38;607633.2
230660;201804;343;288;55;274752.0;52183.8;326935.8
230670;201804;427;380;47;362520.0;44838.0;407358.0
230680;201804;198;182;16;173628.0;15264.0;188892.0
230690;201804;862;752;110;717408.0;104940.0;822348.0
230700;201804;698;591;107;563814.0;101791.8;665605.8
230710;201804;733;693;40;660932.0;38160.0;699092.0
230720;201804;146;123;23;116950.86;21942.0;138892.86
230725;201804;237;187;50;178398.0;47691.0;226089.0
230730;201804;11672;6335;5337;6027096.5;5083134.0;1,11E+14
230740;201804;655;524;131;499610.0;124283.46;623893.44
230750;201804;806;690;116;657068.3;110664.0;767732.3
230760;201804;1309;1133;176;1076835.2;167904.0;1244739.2
230763;201804;319;264;55;249900.95;52470.0;302370.94
230765;201804;6858;3229;3629;3075679.5;3461013.0;6536692.5
230770;201804;4980;2559;2421;2431912.5;2308193.5;4740106.0
230780;201804;687;602;85;571168.1;80789.69;651957.8
230790;201804;199;164;35;156456.0;32589.4;189045.4
230800;201804;1112;814;298;776246.1;284292.0;1060538.1
230810;201804;1294;1153;141;1098960.2;134323.2;1233283.5
230820;201804;333;239;94;227053.0;89676.0;316729.0
230830;201804;937;810;127;769226.44;121158.0;890384.44
230835;201804;277;239;38;227052.0;35537.0;262589.0
230837;201804;160;135;25;128790.0;23850.0;152640.0
230840;201804;898;721;177;686594.5;168572.0;855166.5
230850;201804;1474;1285;189;1225413.0;180020.0;1405433.0
230860;201804;301;224;77;213696.0;73458.0;287154.0
230870;201804;1797;1527;270;1455804.0;257008.0;1712812.0
230880;201804;39;28;11;26712.0;10494.0;37206.0
230890;201804;572;525;47;500727.8;44824.0;545551.8
230900;201804;278;211;67;201294.0;63721.0;265015.0
230910;201804;202;164;38;155692.8;36252.0;191944.8
230920;201804;400;314;86;299556.0;82044.0;381600.0
230930;201804;920;646;274;613422.6;261396.0;874818.6
230940;201804;827;667;160;636318.0;152450.0;788768.0
230945;201804;480;401;79;382078.0;75366.0;457444.0
230950;201804;382;326;56;311004.0;53424.0;364428.0
230960;201804;2531;1713;818;1627474.9;780086.0;2407560.8
230970;201804;1747;986;761;939733.9;725116.3;1664850.2
230980;201804;208;179;29;170766.0;27666.0;198432.0
230990;201804;139;112;27;106848.0;25001.47;131849.47
231000;201804;208;188;20;177444.0;19080.0;196524.0
231010;201804;136;107;29;101505.6;27666.0;129171.6
231020;201804;1290;893;397;850301.0;378738.0;1229039.0
231025;201804;950;714;236;678038.2;223598.8;901637.0
231030;201804;1134;949;185;905342.0;176204.0;1081546.0
231040;201804;144;99;45;93701.88;42199.0;135900.88
231050;201804;981;874;107;832031.9;102078.0;934109.9
231060;201804;141;124;17;118296.0;16218.0;134514.0
231070;201804;1428;1008;420;959534.1;400680.0;1360214.1
231080;201804;262;243;19;231011.1;18126.0;249137.1
231085;201804;557;346;211;329131.0;201294.0;530425.0
231090;201804;241;201;40;191754.0;38160.0;229914.0
231095;201804;166;132;34;125928.0;32436.0;158364.0
231100;201804;123;102;21;97308.0;18793.8;116101.8
231110;201804;348;303;45;287539.9;42930.0;330469.9
231120;201804;297;254;43;241357.86;41022.0;282379.88
231123;201804;138;131;7;124974.0;6678.0;131652.0
231126;201804;292;243;49;231822.0;46746.0;278568.0
231130;201804;4564;3552;1012;3379520.5;964375.25;4343896.0
231135;201804;204;173;31;165042.0;28308.4;193350.4
231140;201804;3044;2247;797;2140529.0;759345.8;2899874.8
231150;201804;355;338;17;322452.0;16218.0;338670.0
231160;201804;1202;945;257;898477.7;244949.05;1143426.8
231170;201804;536;355;181;338670.0;172674.0;511344.0
231180;201804;1613;1369;244;1305262.8;232776.0;1538038.8
231190;201804;196;174;22;165996.0;20988.0;186984.0
231195;201804;216;186;30;176720.0;28620.0;205340.0
231200;201804;827;680;147;648720.0;138978.0;787698.0
231210;201804;605;506;99;481770.8;94446.0;576216.8
231220;201804;1038;751;287;714814.1;273798.0;988612.1
231230;201804;1384;1105;279;1052968.0;265402.8;1318370.9
231240;201804;1369;988;381;942265.8;362234.2;1304500.0
231250;201804;110;102;8;97308.0;7632.0;104940.0
231260;201804;287;184;103;175536.0;97976.0;273512.0
231270;201804;997;835;162;791360.7;154261.8;945622.5
231280;201804;56;43;13;41022.0;12402.0;53424.0
231290;201804;7172;3994;3178;3803180.2;3029467.2;6832647.5
231300;201804;623;575;48;548550.0;45792.0;594342.0
231310;201804;704;654;50;622699.0;47700.0;670399.0
231320;201804;565;436;129;415468.0;123066.0;538534.0
231325;201804;88;79;9;75366.0;8586.0;83952.0
231330;201804;2026;1565;461;1487195.6;437124.6;1924320.2
231335;201804;245;217;28;207018.0;26712.0;233730.0
231340;201804;1615;1188;427;1132208.1;407071.8;1539279.9
231350;201804;1157;946;211;902484.0;200722.0;1103206.0
231355;201804;395;343;52;327222.0;49608.0;376830.0
231360;201804;477;377;100;356948.2;95396.0;452344.2
231370;201804;91;74;17;70596.0;16218.0;86814.0
231375;201804;287;208;79;198432.0;75366.0;273798.0
231380;201804;449;362;87;343752.7;82807.2;426559.88
231390;201804;195;160;35;152640.0;33390.0;186030.0
231395;201804;732;447;285;425140.56;271890.0;697030.56
231400;201804;1056;875;181;832178.5;172331.38;1004509.94
231410;201804;1317;1071;246;1017109.4;233731.0;1250840.4
240010;201804;389;181;208;171522.27;198423.0;369945.25
240020;201804;2189;1714;475;1633569.9;453146.0;2086715.9
240030;201804;132;111;21;105894.0;20034.0;125928.0
240040;201804;32;32;0;30528.0;0.0;30528.0
240050;201804;509;435;74;414136.44;70596.0;484732.44
240060;201804;65;61;4;58194.0;3816.0;62010.0
240070;201804;182;143;39;136422.0;37206.0;173628.0
240080;201804;438;294;144;280472.0;137376.0;417848.0
240090;201804;104;92;12;87462.72;11448.0;98910.72
240100;201804;1440;1356;84;1290651.5;79945.2;1370596.8
240110;201804;977;621;356;591462.25;339624.0;931086.25
240120;201804;139;117;22;111618.0;20988.0;132606.0
240130;201804;286;268;18;254955.55;17172.0;272127.53
240140;201804;79;63;16;60102.0;15264.0;75366.0
240145;201804;683;603;80;574737.3;76110.12;650847.44
240150;201804;20;15;5;14310.0;4741.38;19051.38
240160;201804;44;38;6;36252.0;5724.0;41976.0
240165;201804;34;28;6;26474.0;5724.0;32198.0
240170;201804;93;71;22;67734.0;20988.0;88722.0
240180;201804;77;63;14;60102.0;13356.0;73458.0
240185;201804;42;39;3;37196.46;2862.0;40058.46
240190;201804;13;11;2;10494.0;1908.0;12402.0
240200;201804;3007;1689;1318;1605325.6;1256133.0;2861458.8
240210;201804;163;129;34;123066.0;32436.0;155502.0
240220;201804;1105;793;312;756379.0;297638.47;1054017.5
240230;201804;824;762;62;724114.06;58500.0;782614.06
240240;201804;119;86;33;82044.0;31482.0;113526.0
240250;201804;93;80;13;76320.0;12402.0;88722.0
240260;201804;1801;1336;465;1273857.1;442341.2;1716198.2
240270;201804;192;170;22;161798.4;20988.0;182786.4
240280;201804;43;33;10;31482.0;9540.0;41022.0
240290;201804;48;47;1;44838.0;954.0;45792.0
240300;201804;179;100;79;95400.0;75366.0;170766.0
240310;201804;2000;1095;905;1033593.0;860152.56;1893745.5
240320;201804;207;197;10;187938.0;9540.0;197478.0
240325;201804;4321;2646;1675;2517272.5;1595781.2;4113053.8
240330;201804;65;62;3;59148.0;2862.0;62010.0
240340;201804;102;74;28;70596.0;26712.0;97308.0
240350;201804;90;80;10;76320.0;9540.0;85860.0
240360;201804;394;279;115;266166.0;109710.0;375876.0
240370;201804;38;36;2;34344.0;1908.0;36252.0
240375;201804;69;40;29;38160.0;27666.0;65826.0
240380;201804;234;189;45;180306.0;42835.0;223141.0
240390;201804;16;13;3;12402.0;2862.0;15264.0
240400;201804;78;74;4;70596.0;3816.0;74412.0
240410;201804;10;6;4;5724.0;3816.0;9540.0
240420;201804;879;684;195;651154.6;184980.6;836135.2
240430;201804;262;247;15;233493.84;14310.0;247803.84
240440;201804;70;37;33;35298.0;31482.0;66780.0
240450;201804;207;140;67;132987.8;63918.0;196905.8
240460;201804;60;47;13;44838.0;12402.0;57240.0
240470;201804;235;204;31;194058.86;29574.0;223632.86
240480;201804;14;14;0;13260.6;0.0;13260.6
240485;201804;74;64;10;61056.0;9540.0;70596.0
240490;201804;45;45;0;42720.12;0.0;42720.12
240500;201804;85;67;18;63918.0;17172.0;81090.0
240510;201804;53;38;15;36252.0;14310.0;50562.0
240520;201804;122;116;6;110664.0;5724.0;116388.0
240530;201804;52;47;5;44838.0;4770.0;49608.0
240540;201804;78;67;11;63918.0;10494.0;74412.0
240550;201804;15;13;2;12402.0;1908.0;14310.0
240560;201804;372;275;97;261723.23;92538.0;354261.22
240570;201804;463;289;174;274847.4;165996.0;440843.4
240580;201804;1260;1020;240;967595.9;227802.2;1195398.1
240590;201804;30;28;2;26712.0;1908.0;28620.0
240600;201804;109;108;1;103032.0;954.0;103986.0
240610;201804;508;426;82;406047.7;77465.0;483512.7
240615;201804;20;19;1;18126.0;954.0;19080.0
240620;201804;95;91;4;86814.0;3816.0;90630.0
240630;201804;34;32;2;30528.0;1908.0;32436.0
240640;201804;26;22;4;20988.0;3816.0;24804.0
240650;201804;232;196;36;186125.9;34344.0;220469.9
240660;201804;98;85;13;81090.0;12402.0;93492.0
240670;201804;290;172;118;161989.3;112572.0;274561.3
240680;201804;48;37;11;35298.0;10494.0;45792.0
240690;201804;48;45;3;42930.0;2862.0;45792.0
240700;201804;194;160;34;152640.0;32436.0;185076.0
240710;201804;1928;1228;700;1171078.9;667790.44;1838869.2
240720;201804;1057;776;281;739150.7;268074.0;1007224.7
240725;201804;65;62;3;59148.0;2862.0;62010.0
240730;201804;133;115;18;109710.0;17172.0;126882.0
240740;201804;240;203;37;192297.78;34344.02;226641.8
240750;201804;36;24;12;22896.0;11448.0;34344.0
240760;201804;32;28;4;26712.0;3816.0;30528.0
240770;201804;147;112;35;106848.0;33390.0;140238.0
240780;201804;699;578;121;549971.44;115434.0;665405.44
240790;201804;38;37;1;35298.0;954.0;36252.0
240800;201804;8610;5837;2773;5528500.5;2638613.2;8167113.5
240810;201804;20008;11009;8999;1,05E+14;8574932.0;1,90E+14
240820;201804;210;130;80;123729.03;76320.0;200049.03
240830;201804;1610;1316;294;1248939.1;279522.0;1528461.1
240840;201804;79;69;10;65826.0;9540.0;75366.0
240850;201804;86;75;11;71550.0;10494.0;82044.0
240860;201804;114;111;3;105894.0;2862.0;108756.0
240870;201804;59;52;7;49608.0;6678.0;56286.0
240880;201804;29;26;3;24794.46;2862.0;27656.46
240890;201804;1156;684;472;648626.75;450284.0;1098910.8
240895;201804;43;33;10;31482.0;9540.0;41022.0
240910;201804;153;138;15;131652.0;14310.0;145962.0
240920;201804;15;12;3;11448.0;2862.0;14310.0
240930;201804;382;345;37;328176.0;35298.0;363474.0
240933;201804;30;23;7;21942.0;6678.0;28620.0
240940;201804;2430;2150;280;2037607.2;264238.9;2301846.2
240950;201804;51;48;3;45792.0;2862.0;48654.0
240960;201804;31;25;6;23850.0;5724.0;29574.0
240970;201804;129;91;38;86814.0;35498.0;122312.0
240980;201804;189;149;40;142146.0;38160.0;180306.0
240990;201804;117;78;39;74412.0;37206.0;111618.0
241000;201804;70;65;5;62010.0;4770.0;66780.0
241010;201804;59;47;12;44838.0;11448.0;56286.0
241020;201804;117;110;7;104940.0;6678.0;111618.0
241025;201804;9;3;6;2862.0;5724.0;8586.0
241030;201804;119;97;22;92538.0;20988.0;113526.0
241040;201804;35;29;6;27666.0;5724.0;33390.0
241050;201804;90;78;12;74412.0;11448.0;85860.0
241060;201804;27;24;3;22896.0;2862.0;25758.0
241070;201804;14;14;0;13356.0;0.0;13356.0
241080;201804;64;57;7;54091.8;6678.0;60769.8
241090;201804;51;41;10;39114.0;9525.69;48639.69
241100;201804;73;63;10;60102.0;9540.0;69642.0
241105;201804;6;2;4;1908.0;3816.0;5724.0
241110;201804;47;45;2;42930.0;1908.0;44838.0
241120;201804;1424;1103;321;1049276.8;306234.0;1355510.8
241140;201804;223;183;40;173629.0;38160.0;211789.0
241142;201804;42;40;2;38160.0;1908.0;40068.0
241150;201804;1216;1068;148;1016154.0;141192.0;1157346.0
241160;201804;22;21;1;20034.0;954.0;20988.0
241170;201804;42;39;3;37206.0;2862.0;40068.0
241180;201804;50;41;9;38939.42;8586.0;47525.42
241190;201804;39;38;1;36252.0;954.0;37206.0
241200;201804;3870;2110;1760;2007405.4;1677119.6;3684525.0
241210;201804;70;59;11;56286.0;9636.0;65922.0
241220;201804;1376;925;451;881926.8;430220.9;1312147.8
241230;201804;244;205;39;195379.2;37206.0;232585.2
241240;201804;52;40;12;38160.0;11448.0;49608.0
241250;201804;1086;1006;80;959438.0;76034.0;1035472.0
241255;201804;47;38;9;36252.0;8586.0;44838.0
241260;201804;629;498;131;475087.22;124974.0;600061.25
241270;201804;43;31;12;29574.0;11448.0;41022.0
241280;201804;98;85;13;81090.0;12402.0;93492.0
241290;201804;109;81;28;77274.0;26712.0;103986.0
241300;201804;78;55;23;52470.0;21942.0;74412.0
241310;201804;51;38;13;36109.0;12402.0;48511.0
241320;201804;27;14;13;13356.0;12402.0;25758.0
241330;201804;60;54;6;51516.0;5724.0;57240.0
241335;201804;61;54;7;50848.2;6678.0;57526.2
241340;201804;188;141;47;134514.0;44838.0;179352.0
241350;201804;59;54;5;51516.0;4770.0;56286.0
241355;201804;41;38;3;36252.0;2862.0;39114.0
241360;201804;46;46;0;43884.0;0.0;43884.0
241370;201804;43;36;7;34219.98;6678.0;40897.98
241380;201804;38;35;3;33390.0;2862.0;36252.0
241390;201804;75;60;15;57049.2;14310.0;71359.2
241400;201804;195;161;34;152926.2;32436.0;185362.2
241410;201804;177;160;17;152640.0;16122.6;168762.6
241415;201804;95;76;19;72504.0;18126.0;90630.0
241420;201804;99;75;24;71550.0;22725.0;94275.0
241430;201804;28;27;1;25758.0;954.0;26712.0
241440;201804;458;384;74;366322.0;70596.0;436918.0
241445;201804;38;36;2;34344.0;1908.0;36252.0
241450;201804;277;226;51;215596.0;48654.0;264250.0
241460;201804;134;122;12;116150.0;11448.0;127598.0
241470;201804;43;36;7;34344.0;6678.0;41022.0
241475;201804;63;61;2;58194.0;1908.0;60102.0
241480;201804;101;72;29;67448.69;27666.0;95114.69
241490;201804;8;7;1;6678.0;954.0;7632.0
241500;201804;46;33;13;31482.0;12402.0;43884.0
250010;201804;101;87;14;82854.9;13356.0;96210.9
250020;201804;27;24;3;22896.0;2862.0;25758.0
250030;201804;801;595;206;566285.2;195475.6;761760.8
250040;201804;330;278;52;265212.0;49321.8;314533.8
250050;201804;230;190;40;180969.8;38160.0;219129.8
250053;201804;54;42;12;40068.0;11448.0;51516.0
250057;201804;0;0;0;0.0;0.0;0.0
250060;201804;447;340;107;324360.0;101791.8;426151.8
250070;201804;705;585;120;556072.0;114480.0;670552.0
250073;201804;7;7;0;6678.0;0.0;6678.0
250077;201804;202;150;52;142708.86;49608.0;192316.86
250080;201804;421;331;90;314153.2;85860.0;400013.2
250090;201804;198;134;64;126882.4;61036.92;187919.31
250100;201804;470;383;87;365382.0;82617.0;447999.0
250110;201804;492;372;120;353104.03;114480.0;467584.03
250115;201804;26;9;17;8586.0;16218.0;24804.0
250120;201804;112;84;28;80136.0;26712.0;106848.0
250130;201804;579;460;119;438840.0;113336.0;552176.0
250135;201804;14;8;6;7632.0;5724.0;13356.0
250140;201804;78;70;8;66780.0;7632.0;74412.0
250150;201804;569;419;150;397558.0;142785.19;540343.2
250153;201804;10;9;1;8586.0;954.0;9540.0
250157;201804;28;23;5;21942.0;4770.0;26712.0
250160;201804;210;166;44;158364.0;41976.0;200340.0
250170;201804;66;46;20;43884.0;19080.0;62964.0
250180;201804;4014;2696;1318;2558327.0;1252274.0;3810601.0
250190;201804;902;599;303;569776.5;288346.5;858123.0
250200;201804;52;43;9;41022.0;8586.0;49608.0
250205;201804;24;21;3;20034.0;2862.0;22896.0
250210;201804;90;78;12;74412.0;11448.0;85860.0
250215;201804;63;54;9;51516.0;8586.0;60102.0
250220;201804;27;21;6;20034.0;5724.0;25758.0
250230;201804;77;70;7;66776.0;6678.0;73454.0
250240;201804;244;202;42;191897.1;40068.0;231965.1
250250;201804;395;337;58;321498.0;55332.0;376830.0
250260;201804;35;30;5;28620.0;4770.0;33390.0
250270;201804;56;45;11;42930.0;10494.0;53424.0
250280;201804;383;321;62;306234.0;59148.0;365382.0
250290;201804;94;89;5;84619.8;4770.0;89389.8
250300;201804;556;381;175;362826.72;166937.0;529763.7
250310;201804;47;42;5;40068.0;4770.0;44838.0
250320;201804;1960;1339;621;1271096.1;590860.8;1861957.0
250330;201804;83;74;9;70596.0;8586.0;79182.0
250340;201804;25;21;4;20034.0;3816.0;23850.0
250350;201804;140;90;50;85573.8;47127.6;132701.4
250355;201804;32;25;7;23850.0;6678.0;30528.0
250360;201804;201;164;37;156456.0;35060.0;191516.0
250370;201804;2392;1621;771;1541476.0;733977.8;2275453.8
250375;201804;16;12;4;11448.0;3816.0;15264.0
250380;201804;52;37;15;35298.0;14310.0;49608.0
250390;201804;41;34;7;32436.0;6678.0;39114.0
250400;201804;15652;7936;7716;7546485.5;7354615.5;1,49E+14
250403;201804;423;345;78;329120.47;74412.0;403532.47
250407;201804;55;47;8;44838.0;7632.0;52470.0
250410;201804;30;25;5;23850.0;4770.0;28620.0
250415;201804;42;28;14;26712.0;13336.92;40048.92
250420;201804;46;38;8;36252.0;7632.0;43884.0
250430;201804;1644;1393;251;1326729.0;239454.0;1566183.0
250435;201804;16;13;3;12402.0;2862.0;15264.0
250440;201804;686;590;96;560167.4;91584.0;651751.4
250450;201804;88;73;15;69642.0;13544.53;83186.53
250460;201804;417;286;131;272844.0;124964.46;397808.47
250470;201804;89;66;23;62964.0;21942.0;84906.0
250480;201804;326;256;70;244224.0;66604.0;310828.0
250485;201804;2;1;1;954.0;954.0;1908.0
250490;201804;208;171;37;163134.0;35298.0;198432.0
250500;201804;77;57;20;54378.0;19080.0;73458.0
250510;201804;729;572;157;544352.6;148769.44;693122.0
250520;201804;174;121;53;115414.92;50557.23;165972.16
250523;201804;111;92;19;87768.0;18126.0;105894.0
250527;201804;103;81;22;77269.23;20988.0;98257.23
250530;201804;7;5;2;4770.0;1908.0;6678.0
250535;201804;25;21;4;20034.0;3816.0;23850.0
250540;201804;126;96;30;90868.5;28620.0;119488.5
250550;201804;68;65;3;62010.0;2862.0;64872.0
250560;201804;35;29;6;27666.0;5724.0;33390.0
250570;201804;151;120;31;114480.0;29574.0;144054.0
250580;201804;132;103;29;97975.8;27666.0;125641.8
250590;201804;20;16;4;15264.0;3816.0;19080.0
250600;201804;1321;893;428;849062.25;408216.6;1257278.9
250610;201804;152;131;21;124974.0;20034.0;145008.0
250620;201804;22;18;4;17172.0;3816.0;20988.0
250625;201804;63;47;16;44838.0;15264.0;60102.0
250630;201804;3005;1925;1080;1828407.6;1029252.75;2857660.5
250640;201804;201;167;34;159318.0;32436.0;191754.0
250650;201804;31;21;10;20034.0;9540.0;29574.0
250660;201804;45;34;11;32436.0;10494.0;42930.0
250670;201804;62;41;21;39114.0;20034.0;59148.0
250680;201804;385;316;69;301464.0;65826.0;367290.0
250690;201804;1831;1262;569;1200223.4;542444.8;1742668.1
250700;201804;950;837;113;794961.94;107592.12;902554.0
250710;201804;443;343;100;327222.0;95220.04;422442.03
250720;201804;104;82;22;78228.0;20988.0;99216.0
250730;201804;373;317;56;301464.6;53424.0;354888.6
250740;201804;50;46;4;43884.0;3816.0;47700.0
250750;201804;20420;12238;8182;1,16E+14;7794773.5;1,94E+14
250760;201804;69;52;17;49608.0;16218.0;65826.0
250770;201804;352;236;116;223236.14;109495.55;332731.7
250780;201804;56;43;13;41022.0;12402.0;53424.0
250790;201804;480;313;167;295740.9;158602.5;454343.4
250800;201804;152;141;11;133798.5;10494.0;144292.5
250810;201804;79;60;19;57240.0;18126.0;75366.0
250820;201804;161;130;31;124020.0;29574.0;153594.0
250830;201804;421;286;135;271842.5;128790.0;400632.5
250840;201804;53;51;2;48654.0;1908.0;50562.0
250850;201804;54;42;12;39381.12;11448.0;50829.12
250855;201804;13;11;2;10494.0;1908.0;12402.0
250860;201804;203;144;59;137376.0;55999.8;193375.8
250870;201804;32;29;3;27666.0;2862.0;30528.0
250880;201804;80;61;19;58136.76;18126.0;76262.76
250890;201804;2408;1774;634;1690583.4;603972.75;2294556.2
250900;201804;117;99;18;94446.0;17172.0;111618.0
250905;201804;125;97;28;92538.0;26712.0;119250.0
250910;201804;1180;837;343;797335.3;326935.8;1124271.1
250915;201804;110;76;34;72504.0;32436.0;104940.0
250920;201804;136;105;31;100170.0;29574.0;129744.0
250930;201804;160;99;61;94446.0;58194.0;152640.0
250933;201804;1;1;0;954.0;0.0;954.0
250937;201804;6;5;1;4770.0;954.0;5724.0
250939;201804;31;22;9;20988.0;8586.0;29574.0
250940;201804;106;80;26;76320.0;24804.0;101124.0
250950;201804;71;47;24;44838.0;22896.0;67734.0
250960;201804;88;49;39;46746.0;37206.0;83952.0
250970;201804;1207;858;349;816911.0;331992.0;1148903.0
250980;201804;90;63;27;60102.0;25758.0;85860.0
250990;201804;166;130;36;123547.77;34301.07;157848.84
251000;201804;74;67;7;63727.2;6678.0;70405.2
251010;201804;100;77;23;73454.0;21163.53;94617.53
251020;201804;80;70;10;65969.1;9540.0;75509.1
251030;201804;43;33;10;31482.0;9540.0;41022.0
251040;201804;53;38;15;36252.0;14310.0;50562.0
251050;201804;23;21;2;20034.0;1908.0;21942.0
251060;201804;52;41;11;38160.0;10494.0;48654.0
251065;201804;3;3;0;2862.0;0.0;2862.0
251070;201804;25;20;5;19071.0;4770.0;23841.0
251080;201804;4722;2292;2430;2173969.2;2311667.0;4485636.5
251090;201804;197;169;28;161226.0;26712.0;187938.0
251100;201804;19;18;1;17172.0;954.0;18126.0
251110;201804;46;37;9;35298.0;8586.0;43884.0
251120;201804;1800;1090;710;1034950.2;677340.0;1712290.2
251130;201804;355;289;66;275706.0;62964.0;338670.0
251140;201804;510;331;179;314630.8;170597.34;485228.12
251150;201804;295;255;40;242498.0;38160.0;280658.0
251160;201804;94;79;15;75362.0;14310.0;89672.0
251170;201804;98;78;20;74383.38;19075.23;93458.61
251180;201804;289;181;108;172665.23;103023.23;275688.47
251190;201804;194;133;61;126553.83;58194.0;184747.83
251200;201804;251;205;46;195570.0;43884.0;239454.0
251203;201804;33;31;2;29574.0;1908.0;31482.0
251207;201804;95;78;17;74412.0;16218.0;90630.0
251210;201804;1269;912;357;868494.5;339910.2;1208404.8
251220;201804;47;37;10;35298.0;9540.0;44838.0
251230;201804;473;397;76;378738.0;72504.0;451242.0
251240;201804;100;72;28;67734.0;26712.0;94446.0
251250;201804;1325;952;373;905318.9;355699.0;1261017.9
251260;201804;13;8;5;7632.0;4770.0;12402.0
251270;201804;344;255;89;243270.0;84763.0;328033.0
251272;201804;64;59;5;56286.0;4770.0;61056.0
251274;201804;30;25;5;23850.0;4770.0;28620.0
251275;201804;22;15;7;14310.0;6678.0;20988.0
251276;201804;18;14;4;13356.0;3816.0;17172.0
251278;201804;9;7;2;6678.0;1908.0;8586.0
251280;201804;99;94;5;89676.0;4770.0;94446.0
251290;201804;698;528;170;503712.0;162180.0;665892.0
251300;201804;16;14;2;13356.0;1908.0;15264.0
251310;201804;363;261;102;248990.0;97308.0;346298.0
251315;201804;18;17;1;16218.0;954.0;17172.0
251320;201804;60;49;11;46746.0;10494.0;57240.0
251330;201804;79;70;9;66780.0;8586.0;75366.0
251335;201804;12;7;5;6678.0;4770.0;11448.0
251340;201804;694;409;285;390186.0;270865.25;661051.25
251350;201804;37;35;2;33390.0;1908.0;35298.0
251360;201804;66;58;8;55125.94;7632.0;62757.94
251365;201804;14;14;0;13356.0;0.0;13356.0
251370;201804;5297;3594;1703;3423797.0;1623089.5;5046886.5
251380;201804;50;40;10;38160.0;9540.0;47700.0
251385;201804;3;3;0;2862.0;0.0;2862.0
251390;201804;667;532;135;506384.2;127550.0;633934.2
251392;201804;28;18;10;17172.0;9540.0;26712.0
251394;201804;10;10;0;9540.0;0.0;9540.0
251396;201804;18;13;5;12402.0;4770.0;17172.0
251398;201804;18;15;3;14310.0;2862.0;17172.0
251400;201804;41;34;7;32436.0;6678.0;39114.0
251410;201804;34;29;5;27666.0;4770.0;32436.0
251420;201804;107;80;27;76320.0;25758.0;102078.0
251430;201804;39;37;2;35298.0;1908.0;37206.0
251440;201804;33;22;11;20988.0;10494.0;31482.0
251445;201804;52;47;5;44838.0;4770.0;49608.0
251450;201804;420;372;48;353232.8;45792.0;399024.8
251455;201804;2;1;1;954.0;954.0;1908.0
251460;201804;17;13;4;12402.0;3816.0;16218.0
251465;201804;5;2;3;1908.0;2862.0;4770.0
251470;201804;47;37;10;35298.0;9540.0;44838.0
251480;201804;25;23;2;21942.0;1908.0;23850.0
251490;201804;129;90;39;85383.0;36253.0;121636.0
251500;201804;116;93;23;88722.0;21179.0;109901.0
251510;201804;35;27;8;25758.0;7632.0;33390.0
251520;201804;26;26;0;24804.0;0.0;24804.0
251530;201804;4532;3186;1346;3033144.2;1283788.2;4316932.5
251540;201804;72;64;8;61056.0;7632.0;68688.0
251550;201804;413;319;94;303372.2;88866.0;392238.2
251560;201804;23;17;6;16218.0;5724.0;21942.0
251570;201804;19;19;0;18126.0;0.0;18126.0
251580;201804;121;98;23;93492.0;21942.0;115434.0
251590;201804;125;93;32;88903.0;30528.0;119431.0
251593;201804;20;11;9;10494.0;8586.0;19080.0
251597;201804;55;45;10;42930.0;9540.0;52470.0
251600;201804;1101;779;322;741578.3;305579.9;1047158.25
251610;201804;210;158;52;150064.2;48941.0;199005.2
251615;201804;3;3;0;2862.0;0.0;2862.0
251620;201804;4241;2836;1405;2695703.8;1337605.2;4033309.0
251630;201804;453;334;119;318636.0;113517.0;432153.0
251640;201804;151;108;43;103032.0;41022.0;144054.0
251650;201804;265;193;72;182289.1;68688.0;250977.1
251660;201804;225;204;21;193662.1;19843.2;213505.3
251670;201804;357;279;78;264470.0;74412.0;338882.0
251675;201804;3;3;0;2862.0;0.0;2862.0
251680;201804;91;83;8;79182.0;7632.0;86814.0
251690;201804;341;286;55;271890.0;52119.89;324009.88
251700;201804;280;234;46;222649.3;43869.69;266518.97
251710;201804;19;12;7;11448.0;6678.0;18126.0
251720;201804;33;22;11;20988.0;10208.0;31196.0
251740;201804;10;8;2;7632.0;1908.0;9540.0
260005;201804;3139;1788;1351;1694663.4;1287687.1;2982350.5
260010;201804;1455;1034;421;981477.3;399631.3;1381108.6
260020;201804;429;376;53;358704.0;50562.0;409266.0
260030;201804;582;422;160;401820.97;152640.0;554461.0
260040;201804;863;529;334;503578.44;318626.47;822204.9
260050;201804;1139;815;324;777272.0;308524.0;1085796.0
260060;201804;414;376;38;357940.8;36252.0;394192.8
260070;201804;1462;921;541;874512.0;513144.38;1387656.4
260080;201804;729;579;150;551555.1;143100.0;694655.1
260090;201804;580;358;222;341304.12;211788.0;553092.1
260100;201804;230;161;69;152593.2;65826.0;218419.2
260105;201804;234;132;102;125928.0;97308.0;223236.0
260110;201804;2750;2042;708;1948059.0;674622.0;2622681.0
260120;201804;2916;1460;1456;1383122.2;1386736.1;2769858.2
260130;201804;150;104;46;99216.0;43884.0;143100.0
260140;201804;2121;1393;728;1320431.5;692967.44;2013399.0
260150;201804;227;150;77;143100.0;73458.0;216558.0
260160;201804;298;256;42;244224.0;40068.0;284292.0
260170;201804;3360;2050;1310;1948891.2;1248356.9;3197248.0
260180;201804;135;113;22;107802.0;20988.0;128790.0
260190;201804;2265;1605;660;1528019.9;629640.0;2157660.0
260200;201804;893;733;160;698507.06;152354.0;850861.06
260210;201804;1411;1002;409;955757.25;388937.12;1344694.4
260220;201804;716;655;61;624870.0;58194.0;683064.0
260230;201804;1199;910;289;865949.0;275706.0;1141655.0
260240;201804;220;166;54;157190.58;51516.0;208706.58
260250;201804;74;59;15;56286.0;14310.0;70596.0
260260;201804;993;713;280;680202.0;267120.0;947322.0
260270;201804;427;347;80;329655.2;76033.8;405689.0
260280;201804;1337;882;455;840951.0;433784.0;1274735.0
260290;201804;6373;3390;2983;3215256.2;2839072.0;6054328.5
260300;201804;862;759;103;722017.6;97976.0;819993.6
260310;201804;496;398;98;378313.47;93492.0;471805.47
260320;201804;882;667;215;636031.2;205110.0;841141.2
260330;201804;34;27;7;25758.0;6678.0;32436.0
260340;201804;68;49;19;46746.0;18126.0;64872.0
260345;201804;5678;3197;2481;3043475.5;2365797.8;5409273.0
260350;201804;472;341;131;323570.1;124021.0;447591.1
260360;201804;288;147;141;140238.0;134514.0;274752.0
260370;201804;649;422;227;399978.4;216418.0;616396.4
260380;201804;598;432;166;412128.0;157219.56;569347.56
260390;201804;292;249;43;236467.98;40068.0;276535.97
260392;201804;95;83;12;79182.0;11448.0;90630.0
260400;201804;4058;2337;1721;2219259.0;1641453.6;3860712.8
260410;201804;14347;7701;6646;7330619.5;6337839.0;1,37E+14
260415;201804;123;111;12;105894.0;11448.0;117342.0
260420;201804;1775;1058;717;1004293.2;682221.6;1686514.9
260430;201804;190;174;16;164784.66;15264.0;180048.66
260440;201804;232;169;63;160502.0;60102.0;220604.0
260450;201804;472;341;131;324029.0;124974.0;449003.0
260460;201804;849;452;397;428538.8;378733.22;807272.0
260470;201804;376;232;144;220564.8;136995.0;357559.8
260480;201804;203;126;77;120204.0;73458.0;193662.0
260490;201804;208;167;41;159318.0;39114.0;198432.0
260500;201804;1135;762;373;724660.2;354745.8;1079406.0
260510;201804;738;586;152;557803.8;144054.0;701857.8
260515;201804;261;233;28;222282.0;26235.0;248517.0
260520;201804;3324;1972;1352;1873988.5;1288558.6;3162547.2
260530;201804;787;638;149;605832.6;142146.0;747978.6
260540;201804;570;433;137;413082.0;129744.72;542826.75
260545;201804;13;10;3;9540.0;2862.0;12402.0
260550;201804;342;213;129;203202.0;123066.0;326268.0
260560;201804;519;389;130;370515.0;123733.8;494248.8
260570;201804;1010;831;179;789769.8;170479.8;960249.6
260580;201804;268;239;29;228006.0;27666.0;255672.0
260590;201804;659;376;283;357292.1;269982.0;627274.06
260600;201804;8200;4170;4030;3955526.5;3841514.8;7797041.0
260610;201804;498;333;165;317682.0;157123.8;474805.8
260620;201804;3640;1897;1743;1798048.8;1658650.2;3456699.0
260630;201804;72;69;3;65826.0;2862.0;68688.0
260640;201804;3654;1993;1661;1898003.6;1584518.8;3482522.2
260650;201804;343;238;105;227052.0;100127.07;327179.06
260660;201804;504;343;161;326840.4;152973.9;479814.3
260670;201804;100;75;25;71550.0;23850.0;95400.0
260680;201804;3668;2046;1622;1935000.4;1547025.8;3482026.0
260690;201804;120;94;26;89676.0;24804.0;114480.0
260700;201804;321;196;125;186220.8;118416.0;304636.8
260710;201804;39;36;3;34344.0;2862.0;37206.0
260720;201804;2218;1335;883;1267383.8;841304.0;2108687.8
260730;201804;600;451;149;430254.0;139951.8;570205.8
260740;201804;62;58;4;55332.0;3816.0;59148.0
260750;201804;639;444;195;423251.62;186030.0;609281.6
260760;201804;622;338;284;322452.0;270619.0;593071.0
260765;201804;982;516;466;489321.8;444325.5;933647.3
260770;201804;217;163;54;155502.0;51516.0;207018.0
260775;201804;819;488;331;464169.8;315765.0;779934.8
260780;201804;274;175;99;166950.0;94446.0;261396.0
260790;201804;12367;6790;5577;6449586.5;5312889.0;1,18E+14
260795;201804;164;113;51;106638.12;48654.0;155292.12
260800;201804;277;227;50;216081.0;47700.0;263781.0
260805;201804;177;114;63;108027.14;60102.0;168129.14
260810;201804;743;646;97;615034.25;92538.0;707572.25
260820;201804;318;215;103;203780.8;98262.0;302042.78
260825;201804;205;141;64;134136.98;61056.0;195192.98
260830;201804;260;168;92;160272.0;87768.0;248040.0
260840;201804;230;167;63;158651.0;59816.0;218467.0
260845;201804;209;145;64;138043.8;61056.0;199099.8
260850;201804;501;363;138;344638.1;131652.0;476290.1
260860;201804;255;190;65;181062.34;62010.0;243072.34
260870;201804;375;270;105;257580.0;100170.0;357750.0
260875;201804;694;485;209;461576.7;199386.0;660962.7
260880;201804;1583;964;619;917697.06;590335.2;1508032.2
260890;201804;2431;1692;739;1606774.0;704053.0;2310827.0
260900;201804;1043;718;325;683669.8;310050.0;993719.8
260910;201804;278;218;60;207972.0;57240.0;265212.0
260915;201804;300;202;98;192708.0;93372.0;286080.0
260920;201804;173;97;76;92538.0;72504.0;165042.0
260930;201804;387;331;56;315774.0;53338.45;369112.44
260940;201804;2777;1526;1251;1451609.9;1192957.9;2644567.8
260950;201804;2009;1166;843;1106011.9;804222.0;1910233.9
260960;201804;14266;7407;6859;7030986.0;6536011.5;1,36E+14
260970;201804;439;375;64;356961.0;61056.0;418017.0
260980;201804;197;173;24;164756.0;22896.0;187652.0
260990;201804;2565;2116;449;2016918.6;427678.2;2444596.8
261000;201804;4331;2561;1770;2429771.0;1686682.4;4116453.2
261010;201804;188;137;51;130698.0;47836.23;178534.23
261020;201804;606;452;154;431065.0;146916.0;577981.0
261030;201804;220;161;59;153594.0;56080.89;209674.89
261040;201804;361;325;36;310050.0;34057.8;344107.8
261050;201804;470;413;57;394002.0;54378.0;448380.0
261060;201804;1319;864;455;823064.75;434070.0;1257134.8
261070;201804;9033;4599;4434;4362915.5;4222225.0;8585141.0
261080;201804;390;293;97;278750.0;92538.0;371288.0
261090;201804;2239;1716;523;1628484.0;498170.0;2126654.0
261100;201804;1092;774;318;736059.6;301502.16;1037561.75
261110;201804;8045;4924;3121;4691873.0;2975147.8;7667021.0
261120;201804;274;225;49;214650.0;46741.23;261391.23
261130;201804;569;330;239;314486.9;227662.0;542148.9
261140;201804;189;122;67;116388.0;63918.0;180306.0
261150;201804;667;390;277;372060.0;263590.2;635650.2
261153;201804;73;70;3;65826.31;2862.0;68688.31
261160;201804;76950;38864;38086;3,70E+13;3,63E+14;7,33E+13
261170;201804;452;338;114;321547.38;108756.0;430303.38
261180;201804;1776;1088;688;1032829.6;656352.0;1689181.6
261190;201804;614;424;190;404099.9;181251.0;585350.94
261200;201804;213;188;25;178587.3;23850.0;202437.3
261210;201804;35;31;4;29574.0;3816.0;33390.0
261220;201804;2548;1801;747;1712337.1;711856.8;2424194.0
261230;201804;328;241;87;229914.0;82983.69;312897.7
261240;201804;441;380;61;360087.3;58194.0;418281.3
261245;201804;223;188;35;179352.0;33390.0;212742.0
261247;201804;152;114;38;108756.0;36252.0;145008.0
261250;201804;2859;1448;1411;1380581.8;1344983.9;2725565.8
261255;201804;254;231;23;220374.0;21942.0;242316.0
261260;201804;865;744;121;709776.0;115434.0;825210.0
261270;201804;173;135;38;128790.0;36252.0;165042.0
261280;201804;157;128;29;122112.0;27666.0;149778.0
261290;201804;126;88;38;83713.5;36252.0;119965.5
261300;201804;1232;872;360;831888.0;343440.0;1175328.0
261310;201804;760;508;252;484632.0;239787.9;724419.9
261320;201804;542;368;174;351052.9;165996.0;517048.9
261330;201804;838;664;174;630457.5;165150.45;795607.94
261340;201804;311;176;135;167904.0;128790.0;296694.0
261350;201804;796;570;226;542826.2;215604.0;758430.2
261360;201804;1225;795;430;758028.4;410220.0;1168248.4
261370;201804;4996;3061;1935;2905078.0;1843068.5;4748146.5
261380;201804;574;422;152;400689.62;144722.0;545411.6
261390;201804;3430;2290;1140;2179880.8;1083699.2;3263580.2
261400;201804;276;249;27;236973.6;25758.0;262731.6
261410;201804;1068;707;361;674478.0;344389.22;1018867.25
261420;201804;885;555;330;528489.44;314801.47;843290.94
261430;201804;328;299;29;284400.0;27379.8;311779.8
261440;201804;112;101;11;96354.0;10494.0;106848.0
261450;201804;2492;2078;414;1979751.5;393945.03;2373696.5
261460;201804;721;575;146;547596.0;139284.0;686880.0
261470;201804;251;192;59;182358.0;56286.0;238644.0
261480;201804;358;292;66;277329.0;62960.0;340289.0
261485;201804;346;210;136;199672.2;129744.0;329416.2
261500;201804;628;426;202;406404.0;192708.0;599112.0
261510;201804;45;30;15;28620.0;14310.0;42930.0
261520;201804;114;101;13;96354.0;12402.0;108756.0
261530;201804;4171;2655;1516;2524674.0;1445010.8;3969684.8
261540;201804;1083;671;412;639670.4;393048.0;1032718.4
261550;201804;285;142;143;134086.0;136402.92;270488.9
261560;201804;792;529;263;501424.2;249748.6;751172.8
261570;201804;370;290;80;276660.0;76320.0;352980.0
261580;201804;374;295;79;280379.8;75366.0;355745.8
261590;201804;192;155;37;147870.0;35298.0;183168.0
261600;201804;293;236;57;224381.0;53901.0;278282.0
261610;201804;107;92;15;86936.69;14310.0;101246.69
261618;201804;66;51;15;48654.0;14310.0;62964.0
261620;201804;200;121;79;115434.0;75366.0;190800.0
261630;201804;584;451;133;427893.6;126882.0;554775.6
261640;201804;6314;3353;2961;3191401.0;2821180.0;6012581.0
261650;201804;479;302;177;287430.66;168858.0;456288.66
270010;201804;526;462;64;440462.0;60293.0;500755.0
270020;201804;305;241;64;229910.0;61056.0;290966.0
270030;201804;9175;5864;3311;5580824.5;3156251.0;8737076.0
270040;201804;1956;1198;758;1142596.2;721891.8;1864488.0
270050;201804;175;129;46;123066.0;43884.0;166950.0
270060;201804;115;64;51;61056.0;48654.0;109710.0
270070;201804;904;657;247;624963.8;235333.27;860297.06
270080;201804;38;32;6;30528.0;5724.0;36252.0
270090;201804;20;16;4;15264.0;3816.0;19080.0
270100;201804;1254;828;426;786751.3;404098.7;1190850.0
270110;201804;150;110;40;104940.0;38160.0;143100.0
270120;201804;225;184;41;174684.55;39114.0;213798.55
270130;201804;248;170;78;161321.4;74412.0;235733.4
270135;201804;98;60;38;57240.0;36252.0;93492.0
270140;201804;1282;774;508;738203.25;483669.2;1221872.5
270150;201804;267;212;55;202248.0;52470.0;254718.0
270160;201804;520;388;132;370152.0;125260.2;495412.2
270170;201804;726;464;262;441511.2;248850.9;690362.1
270180;201804;73;56;17;53106.04;16008.12;69114.16
270190;201804;102;89;13;84906.0;12402.0;97308.0
270200;201804;106;95;11;90439.2;10494.0;100933.2
270210;201804;485;252;233;240408.0;221995.8;462403.8
270220;201804;185;146;39;139284.0;37206.0;176490.0
270230;201804;2103;1250;853;1188324.5;810901.44;1999226.0
270235;201804;734;551;183;525364.5;174216.95;699581.44
270240;201804;3100;2397;703;2276649.8;667870.0;2944519.8
270250;201804;170;118;52;112572.0;49608.0;162180.0
270255;201804;221;191;30;182214.0;28238.4;210452.4
270260;201804;327;260;67;248040.0;63918.0;311958.0
270270;201804;112;47;65;44829.0;62010.0;106839.0
270280;201804;205;127;78;121158.0;74412.0;195570.0
270290;201804;1167;875;292;833514.44;277691.47;1111205.9
270300;201804;278;174;104;165996.0;98929.8;264925.8
270310;201804;916;735;181;698894.25;171950.05;870844.3
270320;201804;882;753;129;717294.8;122779.8;840074.6
270330;201804;275;230;45;218466.0;42930.0;261396.0
270340;201804;59;47;12;44838.0;11448.0;56286.0
270350;201804;94;48;46;45553.5;43884.0;89437.5
270360;201804;75;41;34;39114.0;32436.0;71550.0
270370;201804;52;40;12;38160.0;11448.0;49608.0
270375;201804;69;40;29;38160.0;27666.0;65826.0
270380;201804;1086;611;475;581940.0;453150.0;1035090.0
270390;201804;197;109;88;103986.0;83952.0;187938.0
270400;201804;706;514;192;489141.28;183159.0;672300.25
270410;201804;696;499;197;475728.03;187928.45;663656.5
270420;201804;399;258;141;244434.0;134429.38;378863.38
270430;201804;32318;23066;9252;2,19E+14;8818921.0;3,08E+14
270440;201804;490;383;107;364571.1;101791.8;466362.9
270450;201804;770;401;369;382315.5;351072.66;733388.2
270460;201804;199;153;46;145962.0;43884.0;189846.0
270470;201804;1368;907;461;864924.7;439794.0;1304718.8
270480;201804;534;428;106;405230.97;100408.5;505639.47
270490;201804;25;21;4;20034.0;3816.0;23850.0
270500;201804;514;422;92;402588.0;87768.0;490356.0
270510;201804;736;451;285;430254.0;271890.0;702144.0
270520;201804;375;230;145;219211.0;138330.0;357541.0
270530;201804;66;58;8;55332.0;7632.0;62964.0
270540;201804;123;95;28;90630.0;26712.0;117342.0
270550;201804;1730;1300;430;1239877.1;409738.22;1649615.4
270560;201804;313;145;168;138330.0;160272.0;298602.0
270570;201804;452;299;153;283035.38;145962.0;428997.38
270580;201804;79;57;22;54378.0;20988.0;75366.0
270590;201804;78;64;14;61056.0;13356.0;74412.0
270600;201804;177;146;31;139284.0;29574.0;168858.0
270610;201804;181;145;36;138321.0;34344.0;172665.0
270620;201804;30;29;1;27666.0;954.0;28620.0
270630;201804;3834;2907;927;2762659.0;882202.94;3644862.0
270640;201804;900;659;241;626982.6;229599.8;856582.4
270642;201804;211;178;33;169812.0;31482.0;201294.0
270644;201804;277;191;86;182023.73;82039.23;264062.97
270650;201804;246;144;102;137376.0;97308.0;234684.0
270660;201804;255;205;50;195570.0;47700.0;243270.0
270670;201804;3178;2415;763;2292538.2;724979.7;3017518.0
270680;201804;467;271;196;258525.0;186979.23;445504.22
270690;201804;1122;705;417;670837.75;397808.47;1068646.2
270700;201804;37;27;10;25758.0;9540.0;35298.0
270710;201804;876;660;216;628021.3;206064.0;834085.3
270720;201804;246;187;59;178398.0;55999.8;234397.8
270730;201804;1897;1095;802;1042389.4;763002.2;1805391.6
270740;201804;45;28;17;26712.0;16218.0;42930.0
270750;201804;635;465;170;443420.0;161513.0;604933.0
270760;201804;312;225;87;214650.0;82998.0;297648.0
270770;201804;2730;1736;994;1648870.2;947322.0;2596192.2
270780;201804;92;57;35;54373.23;33372.46;87745.69
270790;201804;272;182;90;173628.0;85860.0;259488.0
270800;201804;1966;1570;396;1495987.2;377039.88;1873027.1
270810;201804;311;244;67;232761.69;63909.23;296670.9
270820;201804;159;102;57;97308.0;54283.0;151591.0
270830;201804;926;669;257;637459.0;244892.0;882351.0
270840;201804;1414;1032;382;983737.3;362760.0;1346497.4
270850;201804;1674;1020;654;966918.4;623897.44;1590815.9
270860;201804;2439;1590;849;1514521.4;807048.56;2321570.0
270870;201804;120;65;55;62010.0;52470.0;114480.0
270880;201804;919;673;246;640206.1;233790.58;873996.75
270890;201804;357;261;96;248545.62;91579.23;340124.84
270895;201804;71;61;10;58194.0;9540.0;67734.0
270900;201804;104;80;24;76320.0;22896.0;99216.0
270910;201804;324;258;66;244987.2;62964.0;307951.2
270915;201804;1827;1091;736;1035925.6;701238.1;1737163.8
270920;201804;475;398;77;379692.0;73458.0;453150.0
270930;201804;6197;4480;1717;4268402.5;1635237.2;5903639.5
270940;201804;2375;1798;577;1713322.9;549486.0;2262809.0
280010;201804;44;39;5;37206.0;4770.0;41976.0
280020;201804;704;607;97;577139.0;91584.0;668723.0
280030;201804;19399;12403;6996;1,17E+14;6645166.5;1,84E+13
280040;201804;337;211;126;201294.0;118773.0;320067.0
280050;201804;375;290;85;276373.8;81090.0;357463.8
280060;201804;327;218;109;205725.44;103986.0;309711.44
280067;201804;980;690;290;655501.94;275706.25;931208.2
280070;201804;130;109;21;103986.0;20034.0;124020.0
280100;201804;617;485;132;459945.66;125738.0;585683.7
280110;201804;75;71;4;67734.0;3816.0;71550.0
280120;201804;635;510;125;486540.0;119250.0;605790.0
280130;201804;1360;847;513;806607.8;489258.9;1295866.8
280140;201804;473;385;88;366431.4;82998.0;449429.4
280150;201804;318;236;82;224464.1;78228.0;302692.1
280160;201804;99;84;15;80136.0;14310.0;94446.0
280170;201804;594;394;200;374679.56;190800.0;565479.56
280190;201804;28;26;2;24804.0;1908.0;26712.0
280200;201804;24;16;8;15264.0;7632.0;22896.0
280210;201804;2763;1947;816;1839782.1;772887.0;2612669.0
280220;201804;40;31;9;29574.0;8586.0;38160.0
280230;201804;317;261;56;248159.62;53424.0;301583.62
280240;201804;114;108;6;102888.9;5724.0;108612.9
280250;201804;19;12;7;11448.0;6678.0;18126.0
280260;201804;81;70;11;66780.0;10494.0;77274.0
280270;201804;159;122;37;116388.0;35298.0;151686.0
280280;201804;195;125;70;119250.0;66780.0;186030.0
280290;201804;3071;2213;858;2099239.8;816935.25;2916175.0
280300;201804;1099;830;269;790155.25;255862.8;1046018.06
280310;201804;107;102;5;96977.29;4770.0;101747.29
280320;201804;651;444;207;423567.0;197478.0;621045.0
280330;201804;358;254;104;242316.0;99091.98;341407.97
280340;201804;419;336;83;319072.56;78419.0;397491.56
280350;201804;3434;2645;789;2513363.2;749966.2;3263329.5
280360;201804;467;295;172;281430.0;163134.0;444564.0
280370;201804;98;87;11;82998.0;10494.0;93492.0
280380;201804;56;42;14;40068.0;13356.0;53424.0
280390;201804;186;155;31;147870.0;29574.0;177444.0
280400;201804;341;231;110;219515.8;104940.0;324455.8
280410;201804;290;235;55;223237.0;52470.0;275707.0
280420;201804;172;144;28;137357.0;26712.0;164069.0
280430;201804;108;79;29;75366.0;27557.63;102923.63
280440;201804;681;527;154;499802.4;146715.66;646518.06
280445;201804;115;107;8;102078.0;7632.0;109710.0
280450;201804;1089;928;161;882736.2;153594.0;1036330.2
280460;201804;746;545;201;513069.44;191754.0;704823.44
280470;201804;190;173;17;165042.0;15265.0;180307.0
280480;201804;2249;1588;661;1500270.2;626552.9;2126823.0
280490;201804;353;325;28;308658.0;26712.0;335370.0
280500;201804;46;41;5;39114.0;4770.0;43884.0
280510;201804;146;112;34;106547.2;32150.0;138697.2
280520;201804;52;38;14;36252.0;13356.0;49608.0
280530;201804;77;54;23;51516.0;21942.0;73458.0
280540;201804;504;403;101;384462.0;96067.8;480529.8
280550;201804;711;656;55;623208.6;52470.0;675678.6
280560;201804;478;415;63;393191.1;60102.0;453293.1
280570;201804;1774;1350;424;1284171.5;403640.84;1687812.2
280580;201804;591;451;140;428873.6;133465.0;562338.6
280590;201804;164;100;64;95120.48;61056.0;156176.48
280600;201804;357;299;58;285246.0;55332.0;340578.0
280610;201804;141;107;34;101872.0;32436.0;134308.0
280620;201804;545;446;99;424530.5;93492.9;518023.4
280630;201804;163;134;29;127836.0;27666.0;155502.0
280640;201804;212;171;41;162305.0;39114.0;201419.0
280650;201804;79;53;26;50562.0;24804.0;75366.0
280660;201804;131;94;37;89676.0;35059.5;124735.5
280670;201804;1637;1025;612;970702.56;580103.94;1550806.5
280680;201804;179;152;27;143224.14;25758.0;168982.14
280690;201804;54;45;9;42930.0;8586.0;51516.0
280700;201804;19;19;0;18126.0;0.0;18126.0
280710;201804;1414;1071;343;1014658.8;326554.2;1341213.0
280720;201804;110;74;36;68036.4;34344.0;102380.4
280730;201804;27;23;4;21942.0;3816.0;25758.0
280740;201804;2408;1773;635;1685716.5;604501.2;2290217.8
280750;201804;292;254;38;242316.0;36252.0;278568.0
280760;201804;886;608;278;578887.2;265212.0;844099.2
290010;201804;201;134;67;127836.0;63918.0;191754.0
290020;201804;177;164;13;156456.0;12402.0;168858.0
290030;201804;596;388;208;369484.2;198432.0;567916.2
290035;201804;139;113;26;104597.7;24804.0;129401.7
290040;201804;268;167;101;159318.0;96354.0;255672.0
290050;201804;78;58;20;55332.0;19080.0;74412.0
290060;201804;254;113;141;107515.8;134514.0;242029.8
290070;201804;5620;2776;2844;2640865.8;2708670.5;5349536.0
290080;201804;504;228;276;217206.72;263285.0;480491.72
290090;201804;384;166;218;158364.0;207972.0;366336.0
290100;201804;1589;1047;542;994643.1;516495.8;1511138.9
290110;201804;760;452;308;429582.2;293303.3;722885.5
290115;201804;210;193;17;183168.0;16218.0;199386.0
290120;201804;776;503;273;479194.2;260442.0;739636.2
290130;201804;416;247;169;235342.27;161226.0;396568.25
290135;201804;297;225;72;213972.66;68688.0;282660.66
290140;201804;304;251;53;239454.0;50371.2;289825.2
290150;201804;130;97;33;92538.0;31482.0;124020.0
290160;201804;244;188;56;178112.58;53424.0;231536.58
290170;201804;90;64;26;61056.0;24804.0;85860.0
290180;201804;154;121;33;115434.0;31482.0;146916.0
290190;201804;448;364;84;346970.0;79849.8;426819.8
290195;201804;311;182;129;173628.0;123066.0;296694.0
290200;201804;282;238;44;227052.0;41976.0;269028.0
290205;201804;141;89;52;84906.0;49608.0;134514.0
290210;201804;1128;819;309;780182.2;294786.0;1074968.2
290220;201804;221;122;99;115911.0;94446.0;210357.0
290225;201804;285;111;174;105894.0;165996.0;271890.0
290230;201804;63;41;22;39114.0;20988.0;60102.0
290240;201804;309;123;186;117055.8;177444.0;294499.8
290250;201804;274;246;28;233988.0;26712.0;260700.0
290260;201804;280;228;52;216463.0;49608.0;266071.0
290265;201804;181;151;30;143237.0;28620.0;171857.0
290270;201804;1393;1150;243;1095240.2;230959.0;1326199.2
290280;201804;468;345;123;329130.0;117342.0;446472.0
290290;201804;1229;710;519;672247.9;495126.0;1167373.9
290300;201804;447;378;69;360321.22;65826.0;426147.22
290310;201804;316;140;176;133560.0;167904.0;301464.0
290320;201804;3968;2464;1504;2347953.8;1431955.0;3779908.8
290323;201804;185;161;24;153308.0;22896.0;176204.0
290327;201804;151;119;32;113254.11;30528.0;143782.11
290330;201804;74;40;34;38160.0;32436.0;70596.0
290340;201804;911;361;550;343421.0;524414.0;867835.0
290350;201804;587;349;238;332946.0;227052.0;559998.0
290360;201804;365;273;92;258535.69;87768.0;346303.7
290370;201804;909;360;549;343440.0;523732.0;867172.0
290380;201804;308;189;119;180306.0;113526.0;293832.0
290390;201804;2495;1556;939;1481451.6;893602.44;2375054.0
290395;201804;243;135;108;128265.29;103032.0;231297.3
290400;201804;281;208;73;198146.0;69642.0;267788.0
290405;201804;252;220;32;209880.0;30528.0;240408.0
290410;201804;571;485;86;459685.62;82044.0;541729.6
290420;201804;234;182;52;173628.0;49608.0;223236.0
290430;201804;496;311;185;296694.0;176490.0;473184.0
290440;201804;72;64;8;61056.0;7632.0;68688.0
290450;201804;232;178;54;169812.0;51516.0;221328.0
290460;201804;1872;1113;759;1059933.8;723323.3;1783257.1
290470;201804;1440;606;834;576995.25;795321.4;1372316.6
290475;201804;587;549;38;522593.0;36252.0;558845.0
290480;201804;288;160;128;152640.0;122112.0;274752.0
290485;201804;230;214;16;204156.0;15264.0;219420.0
290490;201804;1177;853;324;812998.8;308142.2;1121141.0
290500;201804;672;338;334;321498.0;318636.0;640134.0
290510;201804;221;168;53;159319.0;50562.0;209881.0
290515;201804;136;79;57;75366.0;54378.0;129744.0
290520;201804;1399;905;494;861748.6;468034.4;1329783.0
290530;201804;315;286;29;272844.0;27666.0;300510.0
290540;201804;96;58;38;55332.0;36252.0;91584.0
290550;201804;151;129;22;123066.0;20921.22;143987.22
290560;201804;3369;1363;2006;1299004.8;1913529.6;3212534.2
290570;201804;5945;3020;2925;2876468.8;2787635.0;5664104.0
290580;201804;1262;742;520;706627.8;495364.5;1201992.2
290590;201804;532;439;93;418015.0;88722.0;506737.0
290600;201804;1712;1186;526;1126743.0;501775.38;1628518.4
290610;201804;218;196;22;186527.0;20988.0;207515.0
290620;201804;325;288;37;274752.0;35298.0;310050.0
290630;201804;2091;893;1198;847820.8;1138491.2;1986312.1
290640;201804;151;123;28;117342.0;26712.0;144054.0
290650;201804;1697;799;898;761283.0;856692.0;1617975.0
290660;201804;279;228;51;217512.0;48654.0;266166.0
290670;201804;992;516;476;491692.0;453758.38;945450.4
290680;201804;1183;951;232;906013.8;220374.0;1126387.8
290682;201804;292;213;79;202215.3;75347.46;277562.75
290685;201804;231;148;83;140238.0;79182.0;219420.0
290687;201804;933;615;318;583323.6;302418.0;885741.6
290689;201804;130;75;55;71536.0;52455.69;123991.69
290690;201804;647;264;383;251827.92;364502.8;616330.75
290700;201804;239;113;126;107802.0;120204.0;228006.0
290710;201804;707;473;234;451222.9;223236.0;674458.94
290720;201804;1024;831;193;792774.0;183645.0;976419.0
290730;201804;1124;645;479;613470.5;456012.0;1069482.5
290740;201804;15;12;3;11448.0;2862.0;14310.0
290750;201804;1361;619;742;588613.25;705756.1;1294369.4
290755;201804;70;62;8;59148.0;7632.0;66780.0
290760;201804;300;260;40;248040.0;38160.0;286200.0
290770;201804;186;175;11;166940.45;10494.0;177434.45
290780;201804;977;783;194;745038.7;183263.4;928302.06
290790;201804;373;261;112;248994.0;106848.0;355842.0
290800;201804;2631;1053;1578;1001629.06;1504305.4;2505934.5
290810;201804;434;303;131;288776.0;124784.0;413560.0
290820;201804;380;233;147;221314.0;140238.0;361552.0
290830;201804;403;276;127;263304.0;121158.0;384462.0
290840;201804;1688;1032;656;982382.8;623744.5;1606127.2
290850;201804;763;420;343;400489.2;326268.0;726757.2
290860;201804;643;285;358;271890.0;341246.0;613136.0
290870;201804;665;477;188;453837.8;179352.0;633189.8
290880;201804;125;67;58;63918.0;55332.0;119250.0
290890;201804;330;235;95;224190.0;90630.0;314820.0
290900;201804;170;128;42;122112.0;40068.0;162180.0
290910;201804;364;276;88;263304.0;83952.0;347256.0
290920;201804;231;197;34;187938.0;32436.0;220374.0
290930;201804;815;617;198;588618.0;188873.0;777491.0
290940;201804;250;205;45;194806.8;42930.0;237736.8
290950;201804;172;99;73;94446.0;69642.0;164088.0
290960;201804;445;298;147;283052.25;139951.8;423004.03
290970;201804;251;219;32;208735.2;30385.0;239120.2
290980;201804;1497;1062;435;1008979.75;413941.2;1422921.0
290990;201804;368;311;57;296665.9;54322.38;350988.3
291000;201804;864;244;620;232776.0;590907.6;823683.6
291005;201804;2111;899;1212;855299.75;1155471.0;2010770.8
291010;201804;155;140;15;133560.0;14310.0;147870.0
291020;201804;101;80;21;76320.0;20034.0;96354.0
291030;201804;90;66;24;62964.0;22896.0;85860.0
291040;201804;573;285;288;271890.0;274752.0;546642.0
291050;201804;1346;752;594;715763.25;566389.8;1282153.0
291060;201804;1488;820;668;781612.2;637272.0;1418884.2
291070;201804;1891;1398;493;1327361.4;469061.5;1796422.9
291072;201804;7341;2694;4647;2566727.5;4431054.5;6997782.0
291075;201804;205;167;38;159318.0;36252.0;195570.0
291077;201804;50;34;16;32436.0;15264.0;47700.0
291080;201804;19691;8623;11068;8203749.0;1,05E+14;1,88E+14
291085;201804;292;233;59;222282.0;56281.23;278563.22
291090;201804;308;118;190;112286.0;181250.45;293536.47
291100;201804;675;196;479;186984.0;456966.0;643950.0
291110;201804;399;299;100;285226.9;95400.0;380626.9
291120;201804;2516;1194;1322;1138933.0;1259219.5;2398152.5
291125;201804;59;30;29;28620.0;27666.0;56286.0
291130;201804;214;188;26;179352.0;24804.0;204156.0
291140;201804;125;92;33;87768.0;31196.0;118964.0
291150;201804;375;150;225;143100.0;214650.0;357750.0
291160;201804;364;303;61;288108.5;58194.0;346302.5
291165;201804;24;20;4;19080.0;3816.0;22896.0
291170;201804;2918;1459;1459;1388118.1;1388833.6;2776951.8
291180;201804;1324;513;811;489205.38;773560.7;1262766.0
291185;201804;74;72;2;68688.0;1908.0;70596.0
291190;201804;1254;538;716;510480.16;682520.8;1193001.0
291200;201804;167;123;44;117342.0;41976.0;159318.0
291210;201804;2211;864;1347;821117.3;1283226.1;2104343.5
291220;201804;269;202;67;191754.64;63918.0;255672.64
291230;201804;1031;350;681;333042.0;649674.0;982716.0
291240;201804;439;416;23;395624.0;21942.0;417566.0
291250;201804;431;354;77;337716.0;73458.0;411174.0
291260;201804;45;34;11;32436.0;10494.0;42930.0
291270;201804;1205;494;711;471276.0;678007.8;1149283.8
291280;201804;374;169;205;161020.89;195274.27;356295.16
291290;201804;1764;892;872;849251.2;830840.0;1680091.2
291300;201804;222;174;48;165328.2;45792.0;211120.2
291310;201804;229;204;25;194329.8;23850.0;218179.8
291320;201804;1397;999;398;950184.0;378643.28;1328827.2
291330;201804;128;110;18;103127.4;17172.0;120299.4
291340;201804;146;83;63;79182.0;60102.0;139284.0
291345;201804;133;86;47;82044.0;44838.0;126882.0
291350;201804;1585;516;1069;492073.2;1019635.3;1511708.5
291360;201804;8626;4254;4372;4046541.8;4168080.5;8214622.5
291370;201804;1096;606;490;577838.0;467460.0;1045298.0
291380;201804;253;198;55;188892.0;52184.0;241076.0
291390;201804;3893;1693;2200;1610670.0;2096988.0;3707658.0
291400;201804;2085;1494;591;1420125.4;562131.5;1982256.9
291410;201804;154;133;21;125928.0;20034.0;145962.0
291420;201804;112;80;32;76320.0;30528.0;106848.0
291430;201804;168;95;73;89923.0;68688.53;158611.53
291440;201804;493;392;101;371244.3;96354.0;467598.3
291450;201804;903;572;331;544448.8;314820.0;859268.8
291460;201804;1725;1402;323;1335743.1;308142.0;1643885.1
291465;201804;2214;1024;1190;976114.2;1134978.1;2111092.2
291470;201804;2785;1407;1378;1338492.5;1313882.0;2652374.5
291480;201804;11842;5218;6624;4966729.0;6310082.5;1,13E+14
291490;201804;551;228;323;217512.0;308142.0;525654.0
291500;201804;372;203;169;193662.0;161226.0;354888.0
291510;201804;1240;470;770;447219.0;734293.8;1181512.8
291520;201804;957;437;520;416898.0;496070.47;912968.44
291530;201804;1012;270;742;257580.0;707562.75;965142.75
291535;201804;116;97;19;92538.0;18126.0;110664.0
291540;201804;361;106;255;101124.0;242316.6;343440.6
291550;201804;1188;559;629;531380.1;599762.0;1131142.1
291560;201804;5532;2818;2714;2675473.0;2576951.2;5252424.0
291570;201804;204;104;100;99216.0;95400.0;194616.0
291580;201804;1215;738;477;703285.44;455044.22;1158329.8
291590;201804;81;31;50;29430.9;47700.0;77130.9
291600;201804;1364;625;739;595296.0;704702.0;1299998.0
291610;201804;1423;655;768;623586.9;732616.0;1356202.9
291620;201804;585;270;315;257580.0;300128.4;557708.4
291630;201804;493;163;330;155502.0;314820.0;470322.0
291640;201804;3906;1966;1940;1867288.2;1849393.0;3716681.2
291650;201804;423;282;141;267894.0;133714.73;401608.72
291660;201804;444;177;267;168165.95;253620.9;421786.88
291670;201804;223;142;81;134896.0;77274.0;212170.0
291680;201804;699;397;302;378738.0;288003.47;666741.44
291685;201804;585;315;270;300272.0;257389.2;557661.2
291690;201804;566;290;276;276660.0;262341.0;539001.0
291700;201804;915;723;192;689012.2;182214.0;871226.2
291710;201804;1713;797;916;759642.25;872987.06;1632629.4
291720;201804;399;264;135;251851.23;128790.0;380641.22
291730;201804;945;558;387;530521.0;369188.47;899709.44
291733;201804;259;180;79;171433.8;75366.0;246799.8
291735;201804;64;49;15;46746.0;14310.0;61056.0
291740;201804;339;256;83;244224.0;79182.0;323406.0
291750;201804;1936;1291;645;1224330.8;614508.0;1838838.8
291760;201804;3059;1660;1399;1577773.0;1332261.0;2910034.0
291770;201804;811;543;268;515923.25;255672.0;771595.25
291780;201804;47;29;18;27666.0;17172.0;44838.0
291790;201804;166;77;89;73458.0;84906.0;158364.0
291800;201804;10024;4014;6010;3817325.5;5727897.5;9545223.0
291810;201804;1142;818;324;779795.0;309096.0;1088891.0
291820;201804;263;190;73;181260.0;69642.0;250902.0
291830;201804;1077;410;667;389465.0;635355.0;1024820.0
291835;201804;603;555;48;528993.0;45792.0;574785.0
291840;201804;4662;2405;2257;2289578.2;2152330.0;4441908.0
291845;201804;300;102;198;97308.0;188863.38;286171.38
291850;201804;322;279;43;265927.5;41022.0;306949.5
291855;201804;269;107;162;102078.0;154548.0;256626.0
291860;201804;175;110;65;103986.0;62010.0;165996.0
291870;201804;83;34;49;32436.0;46746.0;79182.0
291875;201804;186;168;18;160272.0;17172.0;177444.0
291880;201804;489;385;104;366480.0;99216.0;465696.0
291890;201804;243;81;162;77264.46;152863.17;230127.62
291900;201804;56;32;24;30528.0;22896.0;53424.0
291905;201804;134;94;40;89390.0;38160.0;127550.0
291910;201804;176;143;33;136422.0;31482.0;167904.0
291915;201804;388;345;43;327462.0;41022.0;368484.0
291920;201804;4965;2579;2386;2457677.5;2274392.8;4732070.0
291930;201804;183;106;77;101124.0;73458.0;174582.0
291940;201804;322;178;144;169115.58;136422.0;305537.6
291950;201804;1139;926;213;882641.0;203202.0;1085843.0
291955;201804;1018;605;413;577170.0;393700.0;970870.0
291960;201804;180;124;56;118296.0;53137.8;171433.8
291970;201804;778;589;189;561906.0;180306.0;742212.0
291980;201804;1500;1327;173;1262545.8;164088.4;1426634.1
291990;201804;123;114;9;108756.0;8586.0;117342.0
291992;201804;164;84;80;79372.8;76320.0;155692.8
291995;201804;149;105;44;100170.0;41976.0;142146.0
292000;201804;384;291;93;275420.94;88722.0;364142.94
292010;201804;285;202;83;191754.8;78228.0;269982.8
292020;201804;274;199;75;189846.0;71550.0;261396.0
292030;201804;138;107;31;102078.0;29574.0;131652.0
292040;201804;627;316;311;301464.0;296694.0;598158.0
292045;201804;93;84;9;80136.0;8586.0;88722.0
292050;201804;885;612;273;582838.9;260156.0;842994.9
292060;201804;934;770;164;732654.25;156456.0;889110.25
292070;201804;50;21;29;20034.0;27666.0;47700.0
292080;201804;115;79;36;75366.0;34344.0;109710.0
292090;201804;505;177;328;168667.2;312912.0;481579.2
292100;201804;1410;605;805;575596.7;766702.5;1342299.2
292105;201804;201;169;32;161226.0;30528.0;191754.0
292110;201804;2116;784;1332;747611.6;1268702.9;2016314.5
292120;201804;648;518;130;493039.78;124020.0;617059.8
292130;201804;448;265;183;252810.0;174582.0;427392.0
292140;201804;197;154;43;146916.0;40890.26;187806.27
292145;201804;163;89;74;84906.0;70553.07;155459.06
292150;201804;1420;1136;284;1083744.0;269908.16;1353652.1
292160;201804;180;147;33;139951.8;31482.0;171433.8
292170;201804;1221;1070;151;1019087.3;143996.77;1163084.1
292180;201804;200;141;59;134514.0;56286.0;190800.0
292190;201804;160;97;63;92538.0;60102.0;152640.0
292200;201804;1280;459;821;436914.72;782585.56;1219500.2
292205;201804;116;104;12;98929.8;11448.0;110377.8
292210;201804;373;258;115;244749.0;108994.5;353743.5
292220;201804;22;16;6;15264.0;5724.0;20988.0
292225;201804;38;35;3;33390.0;2862.0;36252.0
292230;201804;916;744;172;707078.0;164088.0;871166.0
292240;201804;620;446;174;424387.0;165996.0;590383.0
292250;201804;1709;1089;620;1038906.0;591480.0;1630386.0
292260;201804;444;248;196;236592.0;186220.8;422812.8
292265;201804;268;189;79;180019.8;75366.0;255385.8
292270;201804;773;339;434;323406.0;413082.8;736488.8
292273;201804;199;110;89;104162.49;84906.0;189068.48
292275;201804;164;80;84;76320.0;79849.8;156169.8
292280;201804;137;97;40;92538.0;38160.0;130698.0
292285;201804;62;52;10;48940.2;9540.0;58480.2
292290;201804;553;369;184;349536.47;175250.0;524786.5
292300;201804;1633;621;1012;591861.8;964614.56;1556476.4
292303;201804;96;66;30;62964.0;28620.0;91584.0
292305;201804;110;78;32;74412.0;30528.0;104940.0
292310;201804;814;515;299;490948.0;283948.16;774896.1
292320;201804;662;497;165;473851.8;157410.0;631261.8
292330;201804;185;99;86;94446.0;82044.0;176490.0
292335;201804;273;210;63;200340.0;60102.0;260442.0
292340;201804;575;399;176;379906.84;167904.0;547810.9
292350;201804;271;144;127;136565.1;120871.8;257436.9
292360;201804;706;534;172;507719.0;164088.0;671807.0
292370;201804;775;591;184;563814.0;175536.0;739350.0
292380;201804;654;504;150;478908.62;143100.0;622008.6
292390;201804;500;188;312;179352.0;295883.5;475235.5
292400;201804;3373;2065;1308;1951461.5;1243665.8;3195127.2
292405;201804;265;176;89;167427.0;84619.8;252046.8
292410;201804;151;88;63;83952.0;60102.0;144054.0
292420;201804;306;261;45;248707.8;42930.0;291637.8
292430;201804;519;407;112;388278.0;106371.0;494649.0
292440;201804;580;494;86;469482.6;81757.8;551240.4
292450;201804;247;191;56;182214.0;53424.0;235638.0
292460;201804;585;434;151;413463.8;143958.6;557422.4
292465;201804;199;164;35;156456.0;32652.09;189108.1
292467;201804;103;61;42;58194.0;40068.0;98262.0
292470;201804;258;176;82;167904.0;78228.0;246132.0
292480;201804;327;217;110;206064.5;104654.0;310718.5
292490;201804;219;144;75;137376.0;71550.0;208926.0
292500;201804;1161;502;659;478697.0;628228.25;1106925.2
292510;201804;3332;1501;1831;1430714.1;1743812.5;3174526.8
292520;201804;1061;503;558;477997.7;532323.0;1010320.7
292525;201804;387;275;112;262345.22;106848.0;369193.22
292530;201804;4244;1734;2510;1650965.0;2393330.0;4044295.0
292540;201804;478;257;221;245178.0;210834.0;456012.0
292550;201804;1057;571;486;544011.8;463139.72;1007151.56
292560;201804;318;299;19;285246.0;18126.0;303372.0
292570;201804;299;228;71;217183.0;67734.0;284917.0
292575;201804;467;301;166;286868.0;158364.0;445232.0
292580;201804;917;579;338;550935.0;322166.0;873101.0
292590;201804;511;438;73;417549.6;69642.0;487191.6
292593;201804;143;112;31;106848.0;29574.0;136422.0
292595;201804;180;137;43;130698.0;41022.0;171720.0
292600;201804;1233;918;315;875455.0;299842.2;1175297.2
292610;201804;127;97;30;92538.0;28362.42;120900.42
292620;201804;525;434;91;413741.0;86814.0;500555.0
292630;201804;1377;791;586;753026.0;557413.1;1310439.1
292640;201804;772;538;234;512918.1;223236.0;736154.1
292650;201804;172;147;25;139952.0;23850.0;163802.0
292660;201804;1989;1433;556;1361258.9;526226.8;1887485.6
292665;201804;137;101;36;96354.0;34344.0;130698.0
292670;201804;399;321;78;306230.0;74412.0;380642.0
292680;201804;252;195;57;186030.0;53901.0;239931.0
292690;201804;179;138;41;131652.0;39114.0;170766.0
292700;201804;920;609;311;580032.8;296694.0;876726.8
292710;201804;96;84;12;80136.0;11448.0;91584.0
292720;201804;834;471;363;448532.62;346112.0;794644.6
292730;201804;201;95;106;89676.5;101124.0;190800.5
292740;201804;66614;32983;33631;3,14E+13;3,21E+13;6,34E+13
292750;201804;371;264;107;251856.0;101267.57;353123.56
292760;201804;321;260;61;247029.5;58194.0;305223.5
292770;201804;789;333;456;317396.0;435024.0;752420.0
292780;201804;418;155;263;147642.48;250902.0;398544.47
292790;201804;739;362;377;345348.0;359419.5;704767.5
292800;201804;1147;704;443;670662.0;422622.0;1093284.0
292805;201804;428;124;304;117771.3;290016.0;407787.3
292810;201804;1473;855;618;814525.8;589276.44;1403802.2
292820;201804;741;596;145;566676.9;138034.8;704711.7
292830;201804;105;83;22;79182.0;20988.0;100170.0
292840;201804;658;542;116;516591.0;110649.69;627240.7
292850;201804;130;87;43;82994.0;41022.0;124016.0
292860;201804;2156;1254;902;1192245.0;860508.0;2052753.0
292870;201804;3395;2276;1119;2170041.8;1067516.5;3237558.2
292880;201804;1460;956;504;908257.9;479576.0;1387833.9
292890;201804;483;414;69;394928.0;65826.0;460754.0
292895;201804;134;89;45;83547.5;42930.0;126477.5
292900;201804;389;287;102;273798.0;97308.0;371106.0
292905;201804;448;231;217;220374.0;207018.0;427392.0
292910;201804;409;310;99;295407.0;94446.0;389853.0
292920;201804;548;241;307;229914.0;292878.0;522792.0
292925;201804;506;469;37;446748.66;35279.0;482027.66
292930;201804;574;355;219;338670.0;208926.0;547596.0
292935;201804;293;126;167;120204.0;159318.0;279522.0
292937;201804;233;160;73;152640.0;69642.0;222282.0
292940;201804;194;147;47;140238.0;44838.0;185076.0
292950;201804;1103;569;534;540680.5;508483.0;1049163.5
292960;201804;555;371;184;353934.0;175536.0;529470.0
292970;201804;272;190;82;180593.0;78228.0;258821.0
292975;201804;156;89;67;84906.0;63728.0;148634.0
292980;201804;255;173;82;163258.44;78228.0;241486.44
292990;201804;1310;969;341;917089.9;325126.94;1242216.8
293000;201804;103;75;28;71550.0;26712.0;98262.0
293010;201804;2672;1635;1037;1554028.9;985261.0;2539290.0
293015;201804;657;523;134;498724.5;127197.0;625921.5
293020;201804;331;271;60;258534.0;57240.0;315774.0
293030;201804;619;539;80;512680.44;76320.0;589000.44
293040;201804;339;266;73;253764.0;69642.0;323406.0
293050;201804;2722;1586;1136;1504489.8;1079614.4;2584104.2
293060;201804;252;202;50;191521.0;46746.8;238267.8
293070;201804;3379;1718;1661;1631119.6;1583148.9;3214268.5
293075;201804;90;58;32;55332.0;30528.0;85860.0
293076;201804;72;46;26;43884.0;24804.0;68688.0
293077;201804;436;267;169;250203.47;161226.0;411429.47
293080;201804;449;398;51;379692.0;48654.0;428346.0
293090;201804;128;111;17;105894.0;16218.0;122112.0
293100;201804;517;365;152;348210.0;145008.0;493218.0
293105;201804;343;234;109;222950.0;103986.0;326936.0
293110;201804;171;121;50;115434.0;47700.0;163134.0
293120;201804;315;213;102;203202.0;97117.2;300319.2
293130;201804;246;166;80;158364.0;76320.0;234684.0
293135;201804;7939;3132;4807;2980322.0;4577643.0;7557965.0
293140;201804;183;117;66;111618.0;62201.0;173819.0
293150;201804;327;278;49;263781.2;46746.0;310527.2
293160;201804;429;247;182;235638.0;173628.0;409266.0
293170;201804;191;132;59;125744.0;55428.0;181172.0
293180;201804;464;317;147;302132.0;140238.0;442370.0
293190;201804;1276;886;390;840594.75;372060.0;1212654.8
293200;201804;529;468;61;445392.0;58194.0;503586.0
293210;201804;347;255;92;243118.0;87052.5;330170.5
293220;201804;2678;1085;1593;1033156.44;1517576.0;2550732.5
293230;201804;1771;638;1133;607221.8;1080882.0;1688103.8
293240;201804;219;200;19;190800.0;18126.0;208926.0
293245;201804;111;93;18;88722.0;17172.0;105894.0
293250;201804;735;273;462;260194.0;440748.0;700942.0
293260;201804;312;262;50;248994.17;47700.0;296694.16
293270;201804;1180;562;618;534240.7;589572.0;1123812.6
293280;201804;236;132;104;125928.0;99216.0;225144.0
293290;201804;3080;2010;1070;1916586.0;1020481.0;2937067.0
293300;201804;711;506;205;480391.5;193089.6;673481.1
293305;201804;151;129;22;123066.0;20988.0;144054.0
293310;201804;134;100;34;95400.0;32436.0;127836.0
293315;201804;158;122;36;116388.0;34344.0;150732.0
293317;201804;97;68;29;64872.0;27666.0;92538.0
293320;201804;967;558;409;531378.5;390186.0;921564.5
293325;201804;190;65;125;62010.0;119211.84;181221.84
293330;201804;12910;6049;6861;5759829.5;6537561.5;1,23E+14
293340;201804;253;183;70;174582.0;65826.0;240408.0
293345;201804;247;197;50;187938.0;47700.0;235638.0
293350;201804;634;341;293;325314.0;278043.3;603357.3
293360;201804;1577;1125;452;1072010.0;429968.7;1501978.8
310010;201804;150;77;73;73458.0;69356.0;142814.0
310020;201804;1051;576;475;547119.2;451242.12;998361.3
310030;201804;326;263;63;249776.88;59908.39;309685.28
310040;201804;49;30;19;28620.0;18126.0;46746.0
310050;201804;185;123;62;116388.4;58862.0;175250.4
310060;201804;234;163;71;155025.0;67734.0;222759.0
310070;201804;16;8;8;7632.0;7632.0;15264.0
310080;201804;50;27;23;25758.0;21942.0;47700.0
310090;201804;965;510;455;480137.53;432925.6;913063.1
310100;201804;298;224;74;213696.0;70596.0;284292.0
310110;201804;730;389;341;369784.9;324360.0;694144.9
310120;201804;390;216;174;205396.2;165621.94;371018.12
310130;201804;34;21;13;20034.0;12402.0;32436.0
310140;201804;28;16;12;15264.0;11448.0;26712.0
310150;201804;1296;888;408;841382.6;388373.8;1229756.4
310160;201804;2104;1062;1042;1005041.5;991397.4;1996438.9
310163;201804;95;53;42;50562.0;40068.0;90630.0
310170;201804;2587;1075;1512;1024758.2;1440826.6;2465584.8
310180;201804;132;51;81;48654.0;76892.4;125546.4
310190;201804;484;328;156;312912.0;148251.6;461163.6
310200;201804;502;319;183;304326.0;174296.0;478622.0
310205;201804;58;45;13;42930.0;12402.0;55332.0
310210;201804;276;225;51;214650.0;48654.0;263304.0
310220;201804;56;32;24;30528.0;22896.0;53424.0
310230;201804;261;183;78;174391.2;74412.0;248803.2
310240;201804;104;90;14;85621.5;13356.0;98977.5
310250;201804;99;80;19;76320.0;18126.0;94446.0
310260;201804;801;428;373;405356.25;355107.4;760463.7
310270;201804;271;181;90;172121.0;85860.0;257981.0
310280;201804;367;274;93;260442.8;88722.0;349164.8
310285;201804;219;156;63;148515.86;60102.0;208617.86
310290;201804;259;150;109;143100.0;103986.0;247086.0
310300;201804;155;129;26;123066.0;24804.0;147870.0
310310;201804;7;5;2;4770.0;1908.0;6678.0
310320;201804;23;14;9;13356.0;8586.0;21942.0
310330;201804;31;23;8;21942.0;7632.0;29574.0
310340;201804;1711;1105;606;1045203.6;576598.5;1621802.1
310350;201804;2838;1538;1300;1463383.8;1239618.8;2703002.5
310360;201804;40;33;7;31482.0;6678.0;38160.0
310370;201804;124;102;22;97308.0;20702.0;118010.0
310375;201804;105;38;67;36252.0;63899.0;100151.0
310380;201804;53;31;22;28668.0;20988.0;49656.0
310390;201804;104;71;33;67734.0;31482.0;99216.0
310400;201804;2345;1514;831;1440446.0;792487.8;2232933.8
310410;201804;125;68;57;64872.0;54378.0;119250.0
310420;201804;667;355;312;336858.8;296685.06;633543.9
310430;201804;328;217;111;206731.8;105894.0;312625.8
310440;201804;71;43;28;41022.0;26712.0;67734.0
310445;201804;84;66;18;62964.0;17172.0;80136.0
310450;201804;862;540;322;515160.0;306901.8;822061.8
310460;201804;264;191;73;182214.0;69642.0;251856.0
310470;201804;504;321;183;306234.0;174582.0;480816.0
310480;201804;79;57;22;54378.0;20988.0;75366.0
310490;201804;501;236;265;224190.2;252810.0;477000.2
310500;201804;125;54;71;51516.0;67734.0;119250.0
310510;201804;611;396;215;376544.6;205091.45;581636.06
310520;201804;129;86;43;82044.0;41022.0;123066.0
310530;201804;85;39;46;37206.0;43597.8;80803.8
310540;201804;457;281;176;265690.6;167617.8;433308.4
310550;201804;89;60;29;57240.0;27666.0;84906.0
310560;201804;2941;2026;915;1922036.6;871331.1;2793367.8
310570;201804;124;86;38;82044.0;36252.0;118296.0
310590;201804;348;230;118;218037.8;112557.69;330595.5
310600;201804;159;90;69;84095.7;65826.0;149921.7
310610;201804;59;21;38;20034.0;36252.0;56286.0
310620;201804;45933;22008;23925;2,09E+13;2,28E+14;4,37E+14
310630;201804;602;383;219;362663.6;207591.4;570255.0
310640;201804;139;115;24;109710.0;22896.0;132606.0
310650;201804;162;142;20;134228.0;19080.0;153308.0
310660;201804;91;57;34;54378.0;32436.0;86814.0
310665;201804;55;40;15;38160.0;14310.0;52470.0
310670;201804;6378;2923;3455;2780653.2;3291301.8;6071955.0
310680;201804;57;37;20;35298.0;19080.0;54378.0
310690;201804;606;442;164;417462.16;156456.0;573918.2
310700;201804;61;40;21;38160.0;19890.9;58050.9
310710;201804;1240;825;415;785796.25;395337.8;1181134.0
310720;201804;89;29;60;27666.0;57240.0;84906.0
310730;201804;1379;962;417;916253.5;397532.0;1313785.5
310740;201804;1000;561;439;532046.4;418272.25;950318.7
310750;201804;244;143;101;135468.19;96354.0;231822.19
310760;201804;71;54;17;51516.0;15932.0;67448.0
310770;201804;93;46;47;43884.0;44838.0;88722.0
310780;201804;405;329;76;313284.6;72504.0;385788.6
310790;201804;102;82;20;78228.0;19080.0;97308.0
310800;201804;452;220;232;209403.0;221041.8;430444.8
310810;201804;168;117;51;110559.2;47700.0;158259.2
310820;201804;354;281;73;268074.0;69355.8;337429.8
310825;201804;198;162;36;154548.0;34344.0;188892.0
310830;201804;463;222;241;211127.94;229770.9;440898.84
310840;201804;386;220;166;209880.0;158364.0;368244.0
310850;201804;109;88;21;83952.0;20034.0;103986.0
310855;201804;379;300;79;286200.0;75366.0;361566.0
310860;201804;1405;1051;354;997647.9;335980.9;1333628.8
310870;201804;55;43;12;41022.0;11448.0;52470.0
310880;201804;83;65;18;61723.8;17172.0;78895.8
310890;201804;311;184;127;175536.0;121158.0;296694.0
310900;201804;630;292;338;275930.28;322146.8;598077.06
310910;201804;247;167;80;157983.2;76320.0;234303.2
310920;201804;483;290;193;272845.2;184122.0;456967.2
310925;201804;39;32;7;30528.0;6392.0;36920.0
310930;201804;1096;663;433;632385.5;412987.06;1045372.6
310940;201804;685;347;338;330437.8;322452.0;652889.8
310945;201804;117;73;44;69642.0;41976.0;111618.0
310950;201804;252;198;54;188892.0;51516.0;240408.0
310960;201804;83;30;53;28620.0;50558.0;79178.0
310970;201804;168;104;64;99216.0;60133.76;159349.77
310980;201804;45;24;21;22896.0;20034.0;42930.0
310990;201804;152;86;66;81758.0;62964.0;144722.0
311000;201804;855;422;433;399059.7;413073.0;812132.7
311010;201804;40;33;7;31482.0;6678.0;38160.0
311020;201804;42;26;16;24804.0;15264.0;40068.0
311030;201804;388;231;157;218180.0;149778.0;367958.0
311040;201804;38;33;5;31482.0;4770.0;36252.0
311050;201804;461;193;268;183550.0;255099.6;438649.6
311060;201804;765;435;330;413559.4;314534.0;728093.4
311070;201804;331;152;179;145008.0;170766.0;315774.0
311080;201804;106;59;47;56286.0;44838.0;101124.0
311090;201804;394;183;211;173342.0;201294.0;374636.0
311100;201804;609;364;245;346969.8;233443.8;580413.6
311110;201804;680;469;211;447139.8;201285.0;648424.8
311115;201804;68;49;19;46746.0;18126.0;64872.0
311120;201804;1048;546;502;519594.0;478001.9;997595.9
311130;201804;409;241;168;229723.2;160272.0;389995.2
311140;201804;164;83;81;79182.0;76463.1;155645.1
311150;201804;356;234;122;223236.0;116149.5;339385.5
311160;201804;750;540;210;512775.4;199863.0;712638.4
311170;201804;79;58;21;55332.0;19747.8;75079.8
311180;201804;347;231;116;220087.8;110378.0;330465.8
311190;201804;35;18;17;17172.0;16218.0;33390.0
311200;201804;340;238;102;225430.6;97308.0;322738.6
311205;201804;29;19;10;18126.0;9158.4;27284.4
311210;201804;49;41;8;38828.0;7632.0;46460.0
311220;201804;18;16;2;15264.0;1908.0;17172.0
311230;201804;1632;1059;573;1006204.94;546642.0;1552847.0
311240;201804;174;110;64;104736.33;61056.0;165792.33
311250;201804;83;31;52;29574.0;49608.0;79182.0
311260;201804;558;354;204;337716.0;194616.0;532332.0
311265;201804;115;80;35;76320.0;33390.0;109710.0
311270;201804;284;206;78;196524.0;74412.0;270936.0
311280;201804;214;96;118;91584.0;111999.6;203583.6
311290;201804;109;88;21;83952.0;19748.0;103700.0
311300;201804;548;345;203;329130.0;193376.0;522506.0
311310;201804;25;19;6;18126.0;5724.0;23850.0
311320;201804;677;504;173;479862.0;165042.0;644904.0
311330;201804;1031;758;273;722893.5;259488.4;982381.9
311340;201804;2637;1870;767;1775557.1;731022.9;2506580.0
311350;201804;272;208;64;198432.0;61056.0;259488.0
311360;201804;180;106;74;101124.0;70596.0;171720.0
311370;201804;1204;489;715;464512.5;681537.6;1146050.1
311380;201804;7;6;1;5724.0;954.0;6678.0
311390;201804;281;150;131;143100.0;124497.2;267597.2
311400;201804;149;99;50;94446.0;47700.0;142146.0
311410;201804;101;56;45;53138.0;42930.0;96068.0
311420;201804;300;168;132;159318.8;125928.0;285246.8
311430;201804;853;552;301;525573.0;287154.0;812727.0
311440;201804;492;343;149;327222.0;141859.8;469081.8
311450;201804;325;203;122;193662.0;116388.0;310050.0
311455;201804;302;204;98;194320.8;93205.8;287526.6
311460;201804;135;54;81;51516.0;76468.27;127984.27
311470;201804;23;13;10;12402.0;9540.0;21942.0
311480;201804;29;11;18;10494.0;17172.0;27666.0
311490;201804;16;10;6;9540.0;5724.0;15264.0
311500;201804;20;11;9;10494.0;8586.0;19080.0
311510;201804;624;437;187;414955.7;177825.8;592781.5
311520;201804;45;33;12;30814.2;11448.0;42262.2
311530;201804;1801;1346;455;1274641.1;434070.0;1708711.1
311535;201804;68;51;17;48654.0;16218.0;64872.0
311540;201804;35;30;5;28620.0;4770.0;33390.0
311545;201804;188;141;47;134514.0;44838.0;179352.0
311547;201804;32;23;9;21942.0;8586.0;30528.0
311550;201804;639;298;341;284292.0;325295.47;609587.44
311560;201804;43;28;15;26712.0;14310.0;41022.0
311570;201804;301;201;100;191181.6;95400.0;286581.6
311580;201804;311;184;127;175249.8;121158.0;296407.8
311590;201804;33;29;4;27666.0;3816.0;31482.0
311600;201804;90;71;19;67734.0;18126.0;85860.0
311610;201804;257;224;33;212742.5;31482.0;244224.5
311615;201804;101;82;19;77588.82;17935.2;95524.02
311620;201804;19;11;8;10494.0;7632.0;18126.0
311630;201804;85;71;14;67734.0;13356.0;81090.0
311640;201804;122;65;57;62010.0;54378.0;116388.0
311650;201804;130;96;34;90868.5;32436.0;123304.5
311660;201804;408;196;212;186984.0;202248.0;389232.0
311670;201804;169;109;60;103741.0;57240.0;160981.0
311680;201804;223;160;63;151738.95;59338.8;211077.75
311690;201804;18;11;7;10494.0;6678.0;17172.0
311700;201804;200;140;60;133273.8;57240.0;190513.8
311710;201804;213;135;78;128790.0;74412.0;203202.0
311720;201804;39;28;11;26712.0;10494.0;37206.0
311730;201804;551;359;192;341914.0;183168.0;525082.0
311740;201804;40;29;11;27666.0;10494.0;38160.0
311750;201804;706;478;228;454104.8;217512.0;671616.8
311760;201804;65;36;29;34344.0;27666.0;62010.0
311770;201804;406;194;212;183168.62;202248.0;385416.62
311780;201804;170;95;75;90344.0;71233.0;161577.0
311783;201804;82;73;9;69642.0;8586.0;78228.0
311787;201804;35;15;20;14310.0;19080.0;33390.0
311790;201804;263;127;136;121158.0;129744.0;250902.0
311800;201804;639;431;208;408551.5;197764.2;606315.7
311810;201804;44;36;8;34344.0;7632.0;41976.0
311820;201804;106;89;17;84906.0;16218.0;101124.0
311830;201804;1899;1203;696;1141814.9;659787.4;1801602.2
311840;201804;1025;570;455;539488.9;432601.53;972090.44
311850;201804;8;5;3;4770.0;2862.0;7632.0
311860;201804;9495;4312;5183;4096705.5;4936889.0;9033594.0
311870;201804;151;84;67;80136.0;63918.0;144054.0
311880;201804;950;708;242;673896.8;230868.0;904764.8
311890;201804;219;111;108;105894.0;103032.0;208926.0
311900;201804;84;35;49;33390.0;46746.0;80136.0
311910;201804;1398;861;537;819200.06;510199.4;1329399.5
311920;201804;231;152;79;144770.0;75366.0;220136.0
311930;201804;914;527;387;502248.5;368960.0;871208.5
311940;201804;2480;1287;1193;1225461.8;1134878.4;2360340.0
311950;201804;37;26;11;24804.0;10494.0;35298.0
311960;201804;65;46;19;43884.0;18126.0;62010.0
311970;201804;26;17;9;13928.4;8586.0;22514.4
311980;201804;41;31;10;29574.0;9540.0;39114.0
311990;201804;59;41;18;39114.0;17172.0;56286.0
311995;201804;63;44;19;41976.0;18126.0;60102.0
312000;201804;35;25;10;23563.8;9540.0;33103.8
312010;201804;81;59;22;56286.0;20988.0;77274.0
312015;201804;100;75;25;71264.0;23850.0;95114.0
312020;201804;140;88;52;83952.0;49321.8;133273.8
312030;201804;43;34;9;31659.0;8586.0;40245.0
312040;201804;82;51;31;48654.0;29574.0;78228.0
312050;201804;224;116;108;110664.0;103032.0;213696.0
312060;201804;69;42;27;40068.0;25090.2;65158.2
312070;201804;74;46;28;43884.0;26712.0;70596.0
312080;201804;531;239;292;228006.0;278568.0;506574.0
312083;201804;49;36;13;34344.0;12402.0;46746.0
312087;201804;111;89;22;84906.0;20988.0;105894.0
312090;201804;2894;1647;1247;1557315.5;1186256.2;2743571.8
312100;201804;158;111;47;105894.0;44056.0;149950.0
312110;201804;119;74;45;70596.0;42930.0;113526.0
312120;201804;142;107;35;100838.0;33390.0;134228.0
312125;201804;98;55;43;52279.2;41022.0;93301.2
312130;201804;121;82;39;78228.0;37206.0;115434.0
312140;201804;136;106;30;101124.0;28620.0;129744.0
312150;201804;46;36;10;34344.0;9540.0;43884.0
312160;201804;1527;1013;514;961919.2;488944.47;1450863.6
312170;201804;12;10;2;9540.0;1908.0;11448.0
312180;201804;98;59;39;55571.0;36920.0;92491.0
312190;201804;32;28;4;26712.0;3816.0;30528.0
312200;201804;739;638;101;606696.7;96354.0;703050.7
312210;201804;97;63;34;60102.0;32436.0;92538.0
312220;201804;123;91;32;86576.0;30528.0;117104.0
312230;201804;3511;1718;1793;1634726.0;1708904.6;3343630.5
312235;201804;153;101;52;96354.0;49608.0;145962.0
312240;201804;109;72;37;68688.0;35298.0;103986.0
312245;201804;165;111;54;105890.0;51516.0;157406.0
312247;201804;62;44;18;41213.0;17172.0;58385.0
312250;201804;182;84;98;79659.0;93492.0;173151.0
312260;201804;102;68;34;64013.4;32436.0;96449.4
312270;201804;136;85;51;81090.0;48654.0;129744.0
312280;201804;25;15;10;14310.0;9540.0;23850.0
312290;201804;163;111;52;105607.8;48655.0;154262.8
312300;201804;203;134;69;127836.0;65826.0;193662.0
312310;201804;59;54;5;51516.0;4770.0;56286.0
312320;201804;419;260;159;246132.0;150684.5;396816.5
312330;201804;85;74;11;69833.0;10207.8;80040.8
312340;201804;36;16;20;15264.0;19080.0;34344.0
312350;201804;16;10;6;9540.0;5724.0;15264.0
312352;201804;96;64;32;61056.0;30528.0;91584.0
312360;201804;557;253;304;240408.0;290016.0;530424.0
312370;201804;298;179;119;170479.8;113526.0;284005.8
312380;201804;137;88;49;83952.0;46746.0;130698.0
312385;201804;175;142;33;135468.0;31482.0;166950.0
312390;201804;300;186;114;177444.0;108089.0;285533.0
312400;201804;380;289;91;275706.0;86338.0;362044.0
312410;201804;882;283;599;269505.0;570870.0;840375.0
312420;201804;615;490;125;466792.2;119250.0;586042.2
312430;201804;864;638;226;606364.06;214650.2;821014.25
312440;201804;47;35;12;33390.0;11448.0;44838.0
312450;201804;209;128;81;122112.0;77274.0;199386.0
312460;201804;58;29;29;27666.0;27666.0;55332.0
312470;201804;55;36;19;34344.0;18126.0;52470.0
312480;201804;207;128;79;122112.0;75366.0;197478.0
312490;201804;263;181;82;172674.0;78228.0;250902.0
312500;201804;32;18;14;17172.0;13356.0;30528.0
312510;201804;436;166;270;158364.0;256964.39;415328.38
312520;201804;41;14;27;13356.0;25758.0;39114.0
312530;201804;49;37;12;35298.0;11448.0;46746.0
312540;201804;104;91;13;86814.0;12402.0;99216.0
312550;201804;40;31;9;29574.0;8586.0;38160.0
312560;201804;205;151;54;143768.0;51229.8;194997.8
312570;201804;440;265;175;252142.2;166258.45;418400.66
312580;201804;82;43;39;41022.0;37206.0;78228.0
312590;201804;271;213;58;203202.0;55332.0;258534.0
312595;201804;141;126;15;120204.0;14310.0;134514.0
312600;201804;76;46;30;43455.0;28620.0;72075.0
312610;201804;1633;864;769;816436.0;731909.6;1548345.6
312620;201804;190;135;55;128790.0;52465.23;181255.23
312630;201804;63;54;9;51516.0;8586.0;60102.0
312640;201804;48;13;35;12402.0;33390.0;45792.0
312650;201804;149;122;27;116102.0;25472.0;141574.0
312660;201804;71;53;18;50276.0;17172.0;67448.0
312670;201804;863;568;295;540919.0;281216.3;822135.3
312675;201804;42;31;11;29574.0;10494.0;40068.0
312680;201804;85;57;28;53996.4;26712.0;80708.4
312690;201804;235;126;109;120194.46;103699.8;223894.27
312695;201804;31;24;7;22896.0;6678.0;29574.0
312700;201804;215;125;90;119250.0;85860.0;205110.0
312705;201804;76;62;14;59148.0;13356.0;72504.0
312707;201804;95;70;25;66360.44;23850.0;90210.44
312710;201804;1876;998;878;950029.75;837401.0;1787430.8
312720;201804;67;33;34;31482.0;32436.0;63918.0
312730;201804;289;169;120;160272.0;114193.8;274465.8
312733;201804;52;44;8;41690.0;7632.0;49322.0
312735;201804;21;15;6;14310.0;5724.0;20034.0
312737;201804;67;36;31;34344.0;29574.0;63918.0
312738;201804;54;39;15;37206.0;14310.0;51516.0
312740;201804;73;50;23;47700.0;21942.0;69642.0
312750;201804;71;52;19;49608.0;18126.0;67734.0
312760;201804;269;197;72;187938.0;68688.0;256626.0
312770;201804;7632;3534;4098;3346420.0;3900828.8;7247248.5
312780;201804;431;331;100;315487.8;95400.0;410887.8
312790;201804;20;15;5;14310.0;4770.0;19080.0
312800;201804;1611;1132;479;1072507.2;455783.62;1528290.9
312810;201804;370;238;132;226765.8;125928.0;352693.8
312820;201804;195;147;48;140238.0;45792.0;186030.0
312825;201804;28;19;9;18126.0;8586.0;26712.0
312830;201804;286;170;116;160941.0;110025.0;270966.0
312840;201804;149;109;40;103986.0;38160.0;142146.0
312850;201804;26;23;3;21942.0;2862.0;24804.0
312860;201804;170;104;66;98930.0;62964.0;161894.0
312870;201804;990;517;473;490324.25;451242.0;941566.25
312880;201804;150;103;47;98118.9;44742.6;142861.5
312890;201804;165;114;51;108756.0;48654.0;157410.0
312900;201804;210;157;53;149110.2;50562.0;199672.2
312910;201804;187;95;92;89461.72;87768.0;177229.72
312920;201804;160;90;70;85860.0;66780.0;152640.0
312930;201804;341;247;94;235638.0;89676.0;325314.0
312940;201804;105;71;34;67734.0;32436.0;100170.0
312950;201804;699;460;239;437667.6;228006.0;665673.6
312960;201804;173;132;41;125928.0;39114.0;165042.0
312965;201804;52;48;4;45792.0;3816.0;49608.0
312970;201804;284;229;55;217512.2;52470.0;269982.2
312980;201804;2327;1230;1097;1169215.4;1045675.4;2214890.8
312990;201804;51;29;22;27666.0;20988.0;48654.0
313000;201804;40;25;15;23850.0;14310.0;38160.0
313005;201804;166;127;39;120919.5;36920.0;157839.5
313010;201804;937;382;555;363187.8;529174.8;892362.6
313020;201804;187;99;88;93969.0;83952.0;177921.0
313030;201804;205;134;71;125929.0;67734.0;193663.0
313040;201804;61;23;38;21942.0;36252.0;58194.0
313050;201804;292;201;91;190800.2;86814.0;277614.2
313055;201804;46;34;12;32436.0;11448.0;43884.0
313060;201804;129;86;43;82044.0;40131.6;122175.6
313065;201804;59;38;21;36252.0;20034.0;56286.0
313070;201804;151;80;71;76320.0;67734.0;144054.0
313080;201804;41;17;24;16218.0;22896.0;39114.0
313090;201804;710;492;218;468080.3;207972.0;676052.3
313100;201804;163;64;99;61056.0;94438.0;155494.0
313110;201804;127;75;52;71550.0;49608.0;121158.0
313115;201804;158;86;72;81843.66;68688.0;150531.66
313120;201804;752;412;340;392762.0;323120.0;715882.0
313130;201804;5256;2832;2424;2675753.5;2303930.8;4979684.5
313140;201804;158;81;77;77274.0;73458.0;150732.0
313150;201804;315;251;64;239454.0;60769.8;300223.8
313160;201804;198;143;55;136136.0;52470.0;188606.0
313170;201804;1351;947;404;890418.1;385025.4;1275443.5
313180;201804;330;197;133;187289.28;126882.0;314171.28
313190;201804;737;438;299;414799.4;284483.0;699282.4
313200;201804;24;23;1;21942.0;954.0;22896.0
313210;201804;1041;878;163;834609.2;155497.23;990106.4
313220;201804;238;162;76;153594.0;71788.5;225382.5
313230;201804;268;198;70;187939.0;66780.0;254719.0
313240;201804;1926;1028;898;978128.75;853729.8;1831858.5
313250;201804;1255;932;323;883502.6;306235.8;1189738.4
313260;201804;94;55;39;52470.0;37206.0;89676.0
313270;201804;965;565;400;535338.4;381600.0;916938.4
313280;201804;61;52;9;49131.0;8586.0;57717.0
313290;201804;227;183;44;174296.0;41022.8;215318.8
313300;201804;377;194;183;181929.0;174582.0;356511.0
313310;201804;227;118;109;112572.0;103986.0;216558.0
313320;201804;370;285;85;269935.1;81090.0;351025.1
313330;201804;1360;822;538;782757.2;512060.5;1294817.8
313340;201804;338;234;104;223236.0;99216.0;322452.0
313350;201804;526;352;174;333900.1;165996.0;499896.1
313360;201804;118;69;49;65826.0;46460.0;112286.0
313370;201804;190;70;120;66780.0;114480.0;181260.0
313375;201804;279;168;111;160272.0;105894.0;266166.0
313380;201804;1318;676;642;643015.06;612178.0;1255193.1
313390;201804;49;42;7;39114.8;6678.0;45792.8
313400;201804;424;278;146;265212.0;138712.0;403924.0
313410;201804;19;11;8;10494.0;7632.0;18126.0
313420;201804;4706;2442;2264;2319148.8;2152884.0;4472033.0
313430;201804;141;66;75;62964.0;71550.0;134514.0
313440;201804;1476;998;478;949851.1;454868.0;1404719.1
313450;201804;61;25;36;23850.0;34057.8;57907.8
313460;201804;370;174;196;164556.0;186984.0;351540.0
313470;201804;539;246;293;234684.0;278854.2;513538.2
313480;201804;157;107;50;101125.0;47700.0;148825.0
313490;201804;517;253;264;241357.23;251809.0;493166.22
313500;201804;22;14;8;13356.0;7632.0;20988.0
313505;201804;973;757;216;721574.2;205778.0;927352.2
313507;201804;94;55;39;52470.0;37206.0;89676.0
313510;201804;2778;1773;1005;1686679.5;957816.0;2644495.5
313520;201804;3606;2814;792;2669671.8;755564.0;3425235.8
313530;201804;43;29;14;27666.0;13356.0;41022.0
313535;201804;104;83;21;78515.0;20034.0;98549.0
313540;201804;71;55;16;52470.0;15264.0;67734.0
313545;201804;115;95;20;90630.0;19080.0;109710.0
313550;201804;232;189;43;180306.0;40736.0;221042.0
313560;201804;333;172;161;164088.0;153594.0;317682.0
313570;201804;60;31;29;29574.0;27666.0;57240.0
313580;201804;1304;709;595;674001.0;565913.4;1239914.4
313590;201804;83;50;33;47700.0;31482.0;79182.0
313600;201804;690;408;282;388946.0;268170.0;657116.0
313610;201804;59;47;12;44218.8;11448.0;55666.8
313620;201804;1362;722;640;677592.56;606583.56;1284176.1
313630;201804;1642;1252;390;1190974.4;371774.0;1562748.4
313640;201804;129;75;54;71550.0;51516.0;123066.0
313650;201804;237;109;128;103986.0;122112.0;226098.0
313652;201804;18;17;1;16218.0;954.0;17172.0
313655;201804;55;31;24;29574.0;22896.0;52470.0
313657;201804;47;44;3;41976.0;2862.0;44838.0
313660;201804;133;93;40;88722.0;38160.0;126882.0
313665;201804;644;314;330;299270.0;314581.5;613851.5
313670;201804;10372;7160;3212;6807006.5;3063103.8;9870110.0
313680;201804;41;30;11;28620.0;10106.0;38726.0
313690;201804;156;118;38;112572.0;36252.0;148824.0
313695;201804;72;54;18;51516.0;17172.0;68688.0
313700;201804;297;239;58;227720.0;55332.0;283052.0
313710;201804;152;102;50;97308.0;47700.0;145008.0
313720;201804;1084;516;568;489783.8;540527.9;1030311.7
313730;201804;60;41;19;39114.0;18126.0;57240.0
313740;201804;163;130;33;124020.0;31482.0;155502.0
313750;201804;442;325;117;309763.8;111618.0;421381.8
313753;201804;238;169;69;160558.2;65826.0;226384.2
313760;201804;1251;452;799;431208.0;759509.5;1190717.5
313770;201804;356;256;100;243700.0;95400.0;339100.0
313780;201804;760;393;367;374922.0;349831.8;724753.8
313790;201804;27;26;1;24804.0;954.0;25758.0
313800;201804;148;90;58;85860.0;55332.0;141192.0
313810;201804;68;40;28;38160.0;26712.0;64872.0
313820;201804;1285;635;650;604836.2;618837.0;1223673.2
313830;201804;66;48;18;45792.0;17172.0;62964.0
313835;201804;55;48;7;45792.0;6678.0;52470.0
313840;201804;1699;1042;657;988727.5;625252.0;1613979.5
313850;201804;181;62;119;59148.0;112946.06;172094.06
313860;201804;493;383;110;361901.3;104940.0;466841.3
313862;201804;172;114;58;108756.0;55332.0;164088.0
313865;201804;87;68;19;64872.0;18126.0;82998.0
313867;201804;49;38;11;36252.0;10494.0;46746.0
313868;201804;25;17;8;15455.0;7632.0;23087.0
313870;201804;126;66;60;62964.0;56954.0;119918.0
313880;201804;353;224;129;213696.0;122493.8;336189.8
313890;201804;321;170;151;161417.8;143481.6;304899.4
313900;201804;912;497;415;472517.5;395863.0;868380.5
313910;201804;139;100;39;95400.0;36252.2;131652.2
313920;201804;615;437;178;416707.2;169812.0;586519.2
313925;201804;31;27;4;25758.0;3816.0;29574.0
313930;201804;810;625;185;595678.0;176467.0;772145.0
313940;201804;1792;1129;663;1072496.4;631834.4;1704330.9
313950;201804;942;602;340;572496.6;324073.8;896570.4
313960;201804;1386;794;592;753212.3;563528.0;1316740.2
313970;201804;119;82;37;78228.0;35298.0;113526.0
313980;201804;213;139;74;132368.0;70596.0;202964.0
313990;201804;371;221;150;210648.62;143020.81;353669.44
314000;201804;927;629;298;596585.9;284287.22;880873.1
314010;201804;77;50;27;47700.0;25519.5;73219.5
314015;201804;52;17;35;16218.0;33390.0;49608.0
314020;201804;50;34;16;32436.0;15191.05;47627.05
314030;201804;87;40;47;37997.82;44838.0;82835.82
314040;201804;43;30;13;28620.0;12402.0;41022.0
314050;201804;317;187;130;178112.0;123209.1;301321.1
314053;201804;101;66;35;62010.4;33390.0;95400.4
314055;201804;302;178;124;169812.0;118296.0;288108.0
314060;201804;144;123;21;116388.0;20034.0;136422.0
314070;201804;1006;501;505;474149.12;481150.0;955299.1
314080;201804;219;143;76;135181.8;71454.88;206636.69
314085;201804;129;83;46;79182.0;43884.0;123066.0
314090;201804;354;256;98;244224.0;93487.23;337711.22
314100;201804;475;389;86;367291.0;81472.0;448763.0
314110;201804;694;373;321;354229.75;305518.6;659748.3
314120;201804;96;54;42;51516.0;40068.0;91584.0
314130;201804;25;12;13;11448.0;12402.0;23850.0
314140;201804;1094;662;432;627903.94;409552.88;1037456.75
314150;201804;162;103;59;98262.0;56286.0;154548.0
314160;201804;354;262;92;247086.8;87578.0;334664.8
314170;201804;73;55;18;52470.0;17172.0;69642.0
314180;201804;728;640;88;610274.0;82998.5;693272.5
314190;201804;103;60;43;57240.0;41022.0;98262.0
314200;201804;583;404;179;384145.6;169812.0;553957.6
314210;201804;281;211;70;200340.0;66494.0;266834.0
314220;201804;310;234;76;221329.0;72218.0;293547.0
314225;201804;63;44;19;41976.0;18126.0;60102.0
314230;201804;106;48;58;45792.0;55332.0;101124.0
314240;201804;137;105;32;100170.0;30528.0;130698.0
314250;201804;59;35;24;33390.0;22896.0;56286.0
314260;201804;189;95;94;90630.0;89676.0;180306.0
314270;201804;330;260;70;247277.0;66780.0;314057.0
314280;201804;688;383;305;365373.0;290970.0;656343.0
314290;201804;559;455;104;432830.5;98929.8;531760.3
314300;201804;412;292;120;275632.0;114433.0;390065.0
314310;201804;1465;987;478;939691.3;455991.97;1395683.2
314315;201804;36;29;7;27666.0;6678.0;34344.0
314320;201804;608;389;219;370533.8;208000.81;578534.6
314330;201804;10673;5377;5296;5118768.0;5047919.0;1,02E+14
314340;201804;573;267;306;254145.8;291352.0;545497.8
314345;201804;31;25;6;23850.0;5724.0;29574.0
314350;201804;191;119;72;113526.0;68688.0;182214.0
314360;201804;77;47;30;44838.0;28620.0;73458.0
314370;201804;56;46;10;43884.0;9540.0;53424.0
314380;201804;91;65;26;62010.0;24804.0;86814.0
314390;201804;3228;2046;1182;1946351.2;1124671.4;3071022.8
314400;201804;682;488;194;462682.2;185076.0;647758.2
314410;201804;432;281;151;268074.0;144054.0;412128.0
314420;201804;19;9;10;8586.0;9540.0;18126.0
314430;201804;2516;901;1615;855806.3;1538026.8;2393833.0
314435;201804;270;155;115;147583.8;108756.0;256339.8
314437;201804;27;21;6;20034.0;5724.0;25758.0
314440;201804;98;70;28;66780.0;26712.0;93492.0
314450;201804;153;115;38;109710.0;36252.0;145962.0
314460;201804;661;304;357;290016.0;340578.0;630594.0
314465;201804;83;55;28;52470.0;26712.0;79182.0
314467;201804;67;56;11;53415.0;10494.0;63909.0
314470;201804;386;200;186;187348.52;176490.5;363839.03
314480;201804;1086;519;567;495126.0;540727.2;1035853.2
314490;201804;89;67;22;63918.0;20988.0;84906.0
314500;201804;316;209;107;199386.0;102078.0;301464.0
314505;201804;127;81;46;77274.0;43884.0;121158.0
314510;201804;226;183;43;174582.0;41022.0;215604.0
314520;201804;1251;645;606;608084.7;576168.9;1184253.6
314530;201804;724;570;154;543294.0;146916.0;690210.0
314535;201804;211;132;79;124878.6;75115.01;199993.61
314537;201804;62;37;25;35298.0;23850.0;59148.0
314540;201804;14;9;5;8586.0;4770.0;13356.0
314545;201804;50;32;18;30528.0;17172.0;47700.0
314550;201804;80;43;37;41022.0;35298.0;76320.0
314560;201804;810;435;375;412796.0;357750.0;770546.0
314570;201804;22;17;5;16218.0;4770.0;20988.0
314580;201804;18;9;9;8586.0;8586.0;17172.0
314585;201804;21;15;6;14310.0;5724.0;20034.0
314587;201804;85;73;12;69642.0;11448.0;81090.0
314590;201804;563;412;151;393048.0;144054.0;537102.0
314600;201804;998;646;352;611889.06;334472.6;946361.7
314610;201804;947;519;428;492264.7;408121.2;900385.9
314620;201804;152;112;40;105321.6;38160.0;143481.6
314625;201804;97;71;26;67162.0;24804.0;91966.0
314630;201804;1235;636;599;605265.3;571159.8;1176425.1
314640;201804;92;60;32;57240.0;30241.8;87481.8
314650;201804;201;116;85;110180.67;80613.0;190793.67
314655;201804;66;51;15;48654.0;14310.0;62964.0
314660;201804;20;15;5;14310.0;4770.0;19080.0
314670;201804;191;151;40;143768.0;38160.0;181928.0
314675;201804;220;127;93;121158.0;88722.0;209880.0
314690;201804;533;295;238;281143.8;227052.0;508195.8
314700;201804;2435;1331;1104;1264481.2;1052028.9;2316510.2
314710;201804;1623;950;673;901342.9;641422.1;1542765.0
314720;201804;408;244;164;231373.62;156456.0;387829.62
314730;201804;514;274;240;259966.0;228951.0;488917.0
314740;201804;687;339;348;321736.5;331992.0;653728.5
314750;201804;21;18;3;17172.0;2862.0;20034.0
314760;201804;323;154;169;146916.0;161216.45;308132.47
314770;201804;120;81;39;77274.0;37206.0;114480.0
314780;201804;21;6;15;5724.0;14310.0;20034.0
314790;201804;2360;1472;888;1397889.2;846474.7;2244364.0
314795;201804;53;45;8;42692.0;7632.0;50324.0
314800;201804;2943;1724;1219;1639410.6;1160628.2;2800038.8
314810;201804;1509;837;672;796161.5;639467.0;1435628.5
314820;201804;91;50;41;47700.0;39114.0;86814.0
314830;201804;209;165;44;156694.5;41690.0;198384.5
314840;201804;82;48;34;45792.0;32436.0;78228.0
314850;201804;356;174;182;165996.0;173628.0;339624.0
314860;201804;710;533;177;506478.88;167474.7;673953.56
314870;201804;1472;762;710;725994.0;677340.0;1403334.0
314875;201804;57;49;8;46746.0;7632.0;54378.0
314880;201804;47;34;13;32436.0;12402.0;44838.0
314890;201804;53;31;22;29574.0;20988.0;50562.0
314900;201804;33;27;6;25758.0;5724.0;31482.0
314910;201804;252;172;80;163801.8;76320.0;240121.8
314915;201804;157;137;20;130698.0;19080.0;149778.0
314920;201804;122;76;46;72504.0;43597.8;116101.8
314930;201804;1036;526;510;500279.0;486253.8;986532.8
314940;201804;52;40;12;38160.0;11448.0;49608.0
314950;201804;37;26;11;24804.0;10494.0;35298.0
314960;201804;58;43;15;41022.0;14310.0;55332.0
314970;201804;138;70;68;66494.0;64872.0;131366.0
314980;201804;307;197;110;185696.1;103986.0;289682.1
314990;201804;466;256;210;244224.0;199434.5;443658.5
314995;201804;201;65;136;62010.0;129734.46;191744.45
315000;201804;92;75;17;71550.0;16218.0;87768.0
315010;201804;46;30;16;28620.0;15264.0;43884.0
315015;201804;174;141;33;133788.95;31482.0;165270.95
315020;201804;72;63;9;60102.0;8586.0;68688.0
315030;201804;116;89;27;83952.0;25758.0;109710.0
315040;201804;68;50;18;47700.0;17172.0;64872.0
315050;201804;205;122;83;116388.0;79182.0;195570.0
315053;201804;39;34;5;32436.0;4770.0;37206.0
315057;201804;97;80;17;75938.4;16218.0;92156.4
315060;201804;71;63;8;58195.16;7632.0;65827.16
315070;201804;103;57;46;54378.0;43884.0;98262.0
315080;201804;375;307;68;292878.0;64872.0;357750.0
315090;201804;106;63;43;60102.0;41022.0;101124.0
315100;201804;79;39;40;37206.0;38160.0;75366.0
315110;201804;292;162;130;153690.0;124020.0;277710.0
315120;201804;1656;846;810;801886.0;771786.0;1573672.0
315130;201804;343;249;94;237546.0;89676.0;327222.0
315140;201804;532;313;219;296980.2;208926.0;505906.2
315150;201804;986;466;520;443611.0;495794.0;939405.0
315160;201804;215;110;105;104940.0;100170.0;205110.0
315170;201804;343;223;120;211789.0;114193.8;325982.8
315180;201804;3218;1360;1858;1293829.9;1768766.0;3062596.0
315190;201804;320;184;136;175155.0;129744.0;304899.0
315200;201804;1193;681;512;647862.2;487589.4;1135451.6
315210;201804;1555;888;667;843051.9;633898.2;1476950.1
315213;201804;46;27;19;25758.0;18126.0;43884.0
315217;201804;209;165;44;157410.0;41976.0;199386.0
315220;201804;1530;1170;360;1115274.4;343344.6;1458619.0
315230;201804;168;122;46;116102.0;43884.0;159986.0
315240;201804;427;272;155;259488.0;146668.5;406156.5
315250;201804;2556;1266;1290;1207186.9;1229410.9;2436597.8
315260;201804;151;92;59;86432.4;56286.0;142718.4
315270;201804;132;91;41;86241.6;38388.96;124630.56
315280;201804;698;458;240;436551.0;228950.45;665501.44
315290;201804;204;120;84;114480.0;79182.49;193662.48
315300;201804;73;49;24;46746.0;22896.0;69642.0
315310;201804;65;59;6;56286.0;5724.0;62010.0
315320;201804;162;91;71;86814.0;67734.0;154548.0
315330;201804;55;47;8;44838.0;7632.0;52470.0
315340;201804;423;297;126;282155.6;120204.0;402359.6
315350;201804;151;89;62;84906.0;59148.0;144054.0
315360;201804;97;51;46;48654.0;43884.0;92538.0
315370;201804;56;33;23;31482.0;21798.9;53280.9
315380;201804;12;7;5;6678.0;4770.0;11448.0
315390;201804;59;13;46;12402.0;43884.0;56286.0
315400;201804;819;613;206;579227.5;196524.0;775751.5
315410;201804;358;217;141;206732.0;134228.0;340960.0
315415;201804;61;47;14;44838.0;13356.0;58194.0
315420;201804;207;157;50;148681.1;47700.0;196381.1
315430;201804;679;396;283;376544.0;269505.8;646049.8
315440;201804;84;57;27;54378.0;25758.0;80136.0
315445;201804;256;206;50;196209.19;47700.0;243909.19
315450;201804;178;134;44;127836.0;41976.0;169812.0
315460;201804;3400;1703;1697;1621601.4;1616497.1;3238098.5
315470;201804;42;21;21;20034.0;20034.0;40068.0
315480;201804;63;24;39;22896.0;37206.0;60102.0
315490;201804;617;381;236;361422.9;225144.0;586566.9
315500;201804;22;14;8;13356.0;7632.0;20988.0
315510;201804;150;99;51;94446.0;48654.0;143100.0
315520;201804;71;62;9;59148.0;8586.0;67734.0
315530;201804;52;28;24;26712.0;22896.0;49608.0
315540;201804;237;156;81;148824.0;77274.0;226098.0
315550;201804;179;142;37;135468.0;35298.0;170766.0
315560;201804;738;588;150;559612.8;143100.0;702712.8
315570;201804;318;167;151;156323.7;144054.0;300377.7
315580;201804;663;435;228;414323.0;217512.0;631835.0
315590;201804;206;105;101;100170.0;96354.0;196524.0
315600;201804;293;214;79;204156.0;75176.0;279332.0
315610;201804;99;48;51;45792.0;48654.0;94446.0
315620;201804;34;27;7;25758.0;6678.0;32436.0
315630;201804;141;94;47;89676.0;44838.0;134514.0
315640;201804;61;36;25;34344.0;23850.0;58194.0
315645;201804;63;45;18;42930.0;16695.0;59625.0
315650;201804;168;122;46;116102.0;43311.6;159413.6
315660;201804;477;208;269;198432.0;256626.0;455058.0
315670;201804;2383;1193;1190;1135337.4;1134087.6;2269425.0
315680;201804;859;578;281;548931.6;267348.97;816280.56
315690;201804;689;473;216;450167.66;206064.0;656231.7
315700;201804;1914;1011;903;960622.4;861462.0;1822084.4
315710;201804;327;89;238;84906.0;227052.0;311958.0
315720;201804;437;277;160;264258.0;152640.0;416898.0
315725;201804;200;160;40;152640.0;38160.0;190800.0
315727;201804;43;22;21;20988.0;20034.0;41022.0
315730;201804;41;39;2;37206.0;1908.0;39114.0
315733;201804;88;58;30;55332.0;28620.0;83952.0
315737;201804;52;39;13;37206.0;12402.0;49608.0
315740;201804;45;39;6;37206.0;5724.0;42930.0
315750;201804;160;125;35;119250.0;33390.0;152640.0
315760;201804;48;33;15;31482.0;14310.0;45792.0
315765;201804;118;77;41;73458.0;39114.0;112572.0
315770;201804;229;137;92;130698.0;87482.0;218180.0
315780;201804;3315;1722;1593;1635548.1;1517338.6;3152886.8
315790;201804;211;162;49;154548.0;46173.6;200721.6
315800;201804;284;204;80;194616.0;76320.0;270936.0
315810;201804;97;58;39;55332.0;36920.0;92252.0
315820;201804;796;575;221;545975.3;210834.0;756809.3
315830;201804;143;82;61;78228.0;58194.0;136422.0
315840;201804;93;65;28;62010.0;26712.0;88722.0
315850;201804;259;192;67;183168.0;63918.0;247086.0
315860;201804;12;4;8;3816.0;7632.0;11448.0
315870;201804;35;27;8;25758.0;7632.0;33390.0
315880;201804;106;69;37;65826.0;35298.0;101124.0
315890;201804;78;60;18;57240.0;17172.0;74412.0
315895;201804;451;301;150;286105.0;142528.0;428633.0
315900;201804;71;34;37;32150.0;35298.0;67448.0
315910;201804;36;23;13;21703.5;12402.0;34105.5
315920;201804;183;119;64;113526.0;60102.9;173628.9
315930;201804;40;14;26;13356.0;24804.0;38160.0
315935;201804;149;117;32;111618.0;30519.0;142137.0
315940;201804;91;68;23;64872.0;21942.0;86814.0
315950;201804;65;46;19;43884.0;18126.0;62010.0
315960;201804;557;260;297;246771.58;282479.6;529251.2
315970;201804;37;28;9;26712.0;8586.0;35298.0
315980;201804;700;329;371;311343.0;353924.47;665267.44
315990;201804;255;151;104;143816.0;98921.0;242737.0
316000;201804;51;33;18;31482.0;16886.0;48368.0
316010;201804;76;64;12;61056.0;11448.0;72504.0
316020;201804;109;89;20;84906.0;19080.0;103986.0
316030;201804;405;215;190;204538.0;180736.0;385274.0
316040;201804;506;223;283;211788.2;269696.0;481484.2
316045;201804;59;53;6;50562.0;5724.0;56286.0
316050;201804;16;14;2;13356.0;1908.0;15264.0
316060;201804;95;62;33;59148.0;31482.0;90630.0
316070;201804;1058;685;373;647023.5;355079.0;1002102.5
316080;201804;102;63;39;60102.0;37206.0;97308.0
316090;201804;42;25;17;23182.2;16218.0;39400.2
316095;201804;72;60;12;56964.0;11448.0;68412.0
316100;201804;309;181;128;171863.3;122112.0;293975.3
316105;201804;34;23;11;21942.0;10494.0;32436.0
316110;201804;1928;1549;379;1467016.1;360898.2;1827914.2
316120;201804;80;60;20;57240.0;18793.8;76033.8
316130;201804;139;107;32;101411.0;30528.0;131939.0
316140;201804;27;20;7;19080.0;6678.0;25758.0
316150;201804;203;141;62;133798.5;59148.0;192946.5
316160;201804;84;50;34;47700.0;32436.0;80136.0
316165;201804;63;46;17;43694.0;15502.5;59196.5
316170;201804;206;139;67;131652.0;63918.0;195570.0
316180;201804;205;90;115;85526.1;109710.0;195236.1
316190;201804;143;103;40;97308.0;38160.0;135468.0
316200;201804;707;393;314;374922.0;298983.6;673905.6
316210;201804;769;516;253;491918.34;241362.0;733280.3
316220;201804;117;79;38;75366.0;36252.0;111618.0
316225;201804;24;14;10;13356.0;9540.0;22896.0
316230;201804;31;19;12;18126.0;11448.0;29574.0
316240;201804;621;505;116;481770.0;110664.0;592434.0
316245;201804;106;88;18;83952.0;17172.0;101124.0
316250;201804;1521;1061;460;1004544.5;437657.12;1442201.6
316255;201804;111;91;20;86432.4;19065.69;105498.09
316257;201804;185;97;88;92538.0;83665.8;176203.8
316260;201804;243;162;81;153251.06;77179.0;230430.06
316265;201804;26;17;9;16218.0;8586.0;24804.0
316270;201804;676;471;205;446567.6;195570.0;642137.6
316280;201804;544;338;206;320999.8;195856.6;516856.4
316290;201804;694;464;230;439794.97;219420.0;659215.0
316292;201804;507;205;302;195570.0;287870.0;483440.0
316294;201804;100;57;43;54378.0;41022.0;95400.0
316295;201804;289;129;160;121141.0;152640.0;273781.0
316300;201804;102;71;31;67734.0;29574.0;97308.0
316310;201804;34;17;17;16218.0;16218.0;32436.0
316320;201804;41;25;16;23850.0;15264.0;39114.0
316330;201804;132;86;46;81090.5;43597.8;124688.3
316340;201804;144;96;48;91584.0;45792.0;137376.0
316350;201804;193;139;54;132440.0;51516.0;183956.0
316360;201804;22;17;5;16218.0;4770.0;20988.0
316370;201804;1081;575;506;544754.5;482428.25;1027182.75
316380;201804;121;91;30;86814.0;28620.0;115434.0
316390;201804;123;88;35;83952.0;33390.0;117342.0
316400;201804;139;105;34;100170.0;32436.0;132606.0
316410;201804;305;224;81;212312.7;77274.0;289586.7
316420;201804;202;143;59;135706.5;56286.0;191992.5
316430;201804;158;80;78;76320.0;74412.0;150732.0
316440;201804;98;46;52;43884.0;49608.0;93492.0
316443;201804;39;35;4;33390.0;3816.0;37206.0
316447;201804;64;50;14;47700.0;13356.0;61056.0
316450;201804;223;168;55;160272.0;52470.0;212742.0
316460;201804;69;28;41;26712.0;39114.0;65826.0
316470;201804;1603;1155;448;1094164.5;425271.16;1519435.6
316480;201804;13;10;3;9540.0;2862.0;12402.0
316490;201804;18;7;11;6678.0;10494.0;17172.0
316500;201804;154;103;51;97975.8;48654.0;146629.8
316510;201804;163;123;40;116340.3;38160.0;154500.3
316520;201804;190;114;76;108183.6;72356.0;180539.6
316530;201804;158;113;45;107802.0;42643.8;150445.8
316540;201804;145;80;65;76320.0;62010.0;138330.0
316550;201804;139;99;40;94446.0;38160.0;132606.0
316553;201804;245;119;126;113017.33;120204.0;233221.33
316555;201804;33;25;8;23850.0;7632.0;31482.0
316556;201804;10;7;3;6678.0;2862.0;9540.0
316557;201804;18;14;4;13356.0;3816.0;17172.0
316560;201804;62;48;14;45792.0;13356.0;59148.0
316570;201804;243;220;23;209642.0;21942.0;231584.0
316580;201804;21;15;6;14310.0;5724.0;20034.0
316590;201804;113;97;16;92538.0;15264.0;107802.0
316600;201804;183;149;34;141860.0;32436.0;174296.0
316610;201804;64;45;19;42643.8;18126.0;60769.8
316620;201804;134;103;31;98262.0;29574.0;127836.0
316630;201804;44;32;12;30528.0;11448.0;41976.0
316640;201804;16;10;6;9540.0;5724.0;15264.0
316650;201804;69;51;18;48654.0;17172.0;65826.0
316660;201804;7;4;3;3816.0;2862.0;6678.0
316670;201804;441;157;284;149759.0;270363.8;420122.8
316680;201804;159;112;47;106848.0;44648.0;151496.0
316690;201804;193;122;71;116388.0;67734.0;184122.0
316695;201804;60;53;7;50562.0;6678.0;57240.0
316700;201804;15;8;7;7632.0;6678.0;14310.0
316710;201804;712;520;192;495842.0;183168.0;679010.0
316720;201804;4913;2503;2410;2373364.2;2294159.8;4667524.0
316730;201804;15;14;1;13356.0;954.0;14310.0
316740;201804;128;80;48;76320.0;45792.0;122112.0
316750;201804;19;13;6;12402.0;5724.0;18126.0
316760;201804;325;262;63;249948.0;60102.0;310050.0
316770;201804;143;81;62;77274.0;59148.0;136422.0
316780;201804;74;44;30;41670.72;28620.0;70290.72
316790;201804;56;43;13;41022.0;12402.0;53424.0
316800;201804;1809;1111;698;1057890.8;664176.2;1722067.0
316805;201804;18;10;8;9540.0;7632.0;17172.0
316810;201804;67;43;24;41022.0;22610.0;63632.0
316820;201804;38;19;19;18126.0;18126.0;36252.0
316830;201804;89;38;51;36252.0;47637.0;83889.0
316840;201804;504;303;201;288299.0;190800.0;479099.0
316850;201804;343;224;119;212312.7;113526.0;325838.7
316860;201804;6021;2674;3347;2536837.5;3189261.0;5726098.5
316870;201804;1464;948;516;896094.7;487496.0;1383590.8
316880;201804;117;65;52;61723.8;49608.0;111331.8
316890;201804;255;170;85;162133.0;81090.0;243223.0
316900;201804;418;286;132;270297.28;125928.0;396225.28
316905;201804;17;9;8;8586.0;7632.0;16218.0
316910;201804;51;26;25;24804.0;23850.0;48654.0
316920;201804;136;105;31;99455.0;29574.0;129029.0
316930;201804;1933;987;946;935828.3;900285.94;1836114.2
316935;201804;869;524;345;497655.72;328176.0;825831.75
316940;201804;1108;639;469;608652.4;446844.25;1055496.6
316950;201804;186;97;89;92538.0;84906.0;177444.0
316960;201804;1112;620;492;589318.0;469072.47;1058390.5
316970;201804;633;493;140;470322.0;133560.0;603882.0
316980;201804;110;67;43;63918.0;41012.46;104930.46
316990;201804;2188;1438;750;1364460.1;713535.94;2077996.1
317000;201804;328;254;74;242030.0;70596.0;312626.0
317005;201804;248;175;73;166950.0;69642.0;236592.0
317010;201804;6281;3458;2823;3277817.5;2691234.2;5969052.0
317020;201804;16255;7183;9072;6819864.5;8637461.0;1,55E+14
317030;201804;85;33;52;31482.0;49391.26;80873.26
317040;201804;3117;1945;1172;1852221.2;1115036.6;2967258.0
317043;201804;72;52;20;49608.0;19080.0;68688.0
317047;201804;38;18;20;17172.0;19076.0;36248.0
317050;201804;181;134;47;127836.0;44838.0;172674.0
317052;201804;127;96;31;91584.0;29574.0;121158.0
317057;201804;204;152;52;145008.0;49036.0;194044.0
317060;201804;57;37;20;35298.0;18793.8;54091.8
317065;201804;59;46;13;43884.0;12402.0;56286.0
317070;201804;1962;927;1035;879589.7;986245.6;1865835.2
317075;201804;110;57;53;54378.0;50562.0;104940.0
317080;201804;826;432;394;411030.9;375686.0;786716.9
317090;201804;634;509;125;483249.5;119250.0;602499.5
317100;201804;416;311;105;294786.0;100170.0;394956.0
317103;201804;108;94;14;89676.0;13356.0;103032.0
317107;201804;36;32;4;30528.0;3816.0;34344.0
317110;201804;102;43;59;41022.0;56286.0;97308.0
317115;201804;41;35;6;33390.0;5724.0;39114.0
317120;201804;1827;929;898;878362.6;856235.0;1734597.6
317130;201804;1915;1228;687;1168563.4;654731.0;1823294.4
317140;201804;11;9;2;8586.0;1908.0;10494.0
317150;201804;270;161;109;153594.0;103222.8;256816.8
317160;201804;313;226;87;215287.0;82712.0;297999.0
317170;201804;209;145;64;138330.0;61056.0;199386.0
317180;201804;436;314;122;298840.5;116388.0;415228.5
317190;201804;255;173;82;165042.0;77941.8;242983.8
317200;201804;812;570;242;531388.0;230630.0;762018.0
317210;201804;154;89;65;83952.2;62010.0;145962.2
317220;201804;21;13;8;12402.0;7632.0;20034.0
320010;201804;620;462;158;437410.5;150732.0;588142.5
320013;201804;132;98;34;93492.0;32436.0;125928.0
320016;201804;282;179;103;170766.0;98262.0;269028.0
320020;201804;717;429;288;406716.75;272844.3;679561.06
320030;201804;152;114;38;108756.0;35918.1;144674.1
320035;201804;137;102;35;97308.0;33390.0;130698.0
320040;201804;503;257;246;245178.0;234684.0;479862.0
320050;201804;118;88;30;83952.0;28620.0;112572.0
320060;201804;1555;735;820;701143.0;781603.6;1482746.6
320070;201804;104;72;32;68688.0;30528.0;99216.0
320080;201804;763;436;327;413113.0;311958.0;725071.0
320090;201804;1209;842;367;799914.9;349259.6;1149174.5
320100;201804;321;182;139;173628.0;132606.0;306234.0
320110;201804;136;87;49;81138.2;46460.0;127598.2
320115;201804;113;93;20;88722.0;19080.0;107802.0
320120;201804;3294;1840;1454;1743820.2;1385438.6;3129258.8
320130;201804;7408;3535;3873;3350366.5;3688020.2;7038386.5
320140;201804;414;269;145;255291.2;138086.0;393377.2
320150;201804;1912;1122;790;1062580.0;753364.25;1815944.2
320160;201804;688;312;376;295445.03;357303.6;652748.6
320170;201804;113;88;25;83189.0;23850.0;107039.0
320180;201804;52;30;22;28620.0;20988.0;49608.0
320190;201804;235;156;79;148051.27;75080.0;223131.27
320200;201804;56;43;13;41022.0;12402.0;53424.0
320210;201804;846;476;370;452492.6;352008.0;804500.6
320220;201804;304;111;193;105894.0;183836.0;289730.0
320225;201804;78;63;15;60102.0;14310.0;74412.0
320230;201804;556;357;199;339052.4;189036.0;528088.4
320240;201804;3126;1570;1556;1495300.8;1481757.8;2977058.5
320245;201804;454;314;140;298411.4;133560.0;431971.4
320250;201804;231;122;109;115434.6;103986.0;219420.6
320255;201804;144;113;31;106495.02;29431.0;135926.02
320260;201804;179;126;53;120204.0;50514.3;170718.3
320265;201804;159;127;32;120348.0;30528.0;150876.0
320270;201804;153;125;28;119250.0;26712.0;145962.0
320280;201804;969;582;387;550268.2;368082.03;918350.25
320290;201804;66;56;10;53424.0;9540.0;62964.0
320300;201804;543;385;158;365115.8;149683.1;514798.9
320305;201804;667;363;304;346302.0;289826.0;636128.0
320310;201804;212;119;93;111571.5;87966.0;199537.5
320313;201804;308;157;151;149778.0;143768.0;293546.0
320316;201804;107;89;18;84906.0;17172.0;102078.0
320320;201804;3318;1507;1811;1431994.0;1724713.8;3156707.8
320330;201804;260;191;69;181551.3;63918.8;245470.1
320332;201804;884;537;347;510441.6;329989.3;840430.9
320334;201804;236;143;93;136136.0;88722.0;224858.0
320335;201804;147;106;41;100170.4;39114.0;139284.4
320340;201804;589;407;182;387134.0;172961.0;560095.0
320350;201804;967;414;553;392476.88;526722.5;919199.4
320360;201804;166;91;75;86528.0;71550.0;158078.0
320370;201804;240;184;56;173844.0;52391.0;226235.0
320380;201804;281;189;92;178637.3;87768.0;266405.3
320390;201804;1126;687;439;652880.8;418186.12;1071066.9
320400;201804;318;229;89;217513.0;84906.0;302419.0
320405;201804;899;385;514;366713.6;490043.9;856757.5
320410;201804;975;499;476;474377.4;453733.34;928110.75
320420;201804;479;245;234;233635.0;223236.0;456871.0
320425;201804;193;105;88;100170.0;83952.0;184122.0
320430;201804;390;221;169;209212.7;161226.0;370438.7
320435;201804;169;114;55;107935.56;52470.0;160405.56
320440;201804;203;122;81;116101.8;77274.0;193375.8
320450;201804;130;77;53;73458.0;50562.0;124020.0
320455;201804;246;201;45;190801.0;42930.0;233731.0
320460;201804;241;155;86;147870.0;82044.0;229914.0
320465;201804;114;77;37;73095.48;35298.0;108393.48
320470;201804;635;403;232;384158.25;221324.0;605482.25
320480;201804;179;120;59;113669.1;56286.0;169955.1
320490;201804;3022;1517;1505;1444309.1;1433825.9;2878135.0
320495;201804;93;56;37;53405.0;35298.0;88703.0
320500;201804;9457;4771;4686;4523136.0;4458321.5;8981458.0
320501;201804;551;280;271;267120.0;258534.0;525654.0
320503;201804;284;203;81;192708.2;77274.0;269982.2
320506;201804;257;194;63;185076.0;60102.0;245178.0
320510;201804;945;445;500;420691.6;475474.1;896165.7
320515;201804;79;67;12;62964.9;11448.0;74412.9
320517;201804;202;142;60;135468.0;57240.0;192708.0
320520;201804;6862;3067;3795;2911843.8;3612095.2;6523939.0
320530;201804;5291;2668;2623;2537493.0;2499092.2;5036585.0
330010;201804;3143;1616;1527;1534148.2;1453960.4;2988108.5
330015;201804;156;64;92;59912.08;87768.0;147680.08
330020;201804;3604;1562;2042;1487859.9;1947496.0;3435355.8
330022;201804;229;130;99;123305.0;93492.8;216797.8
330023;201804;533;183;350;173103.8;333900.0;507003.8
330025;201804;550;120;430;114480.0;409647.8;524127.8
330030;201804;1930;1234;696;1168895.1;660715.7;1829610.9
330040;201804;2363;1215;1148;1157250.1;1093763.2;2251013.5
330045;201804;8326;2630;5696;2500892.8;5427794.5;7928687.5
330050;201804;807;509;298;485586.0;284292.0;769878.0
330060;201804;894;558;336;528518.1;319228.28;847746.4
330070;201804;3470;1316;2154;1249507.5;2053601.5;3303109.0
330080;201804;1507;708;799;670169.3;761006.4;1431175.8
330090;201804;354;212;142;202248.0;135468.0;337716.0
330093;201804;288;129;159;123066.0;151650.0;274716.0
330095;201804;100;52;48;48940.2;45792.0;94732.2
330100;201804;9461;4879;4582;4645142.0;4367724.0;9012866.0
330110;201804;480;210;270;198909.0;257580.0;456489.0
330115;201804;526;306;220;291924.0;209880.0;501804.0
330120;201804;379;197;182;186793.2;172864.8;359658.0
330130;201804;1541;428;1113;407586.97;1061784.0;1469371.0
330140;201804;602;317;285;302400.0;270937.0;573337.0
330150;201804;448;266;182;251856.0;172674.0;424530.0
330160;201804;208;129;79;123066.0;75366.0;198432.0
330170;201804;26799;9503;17296;9044302.0;1,65E+14;2,55E+13
330180;201804;236;151;85;141507.02;80374.5;221881.52
330185;201804;813;332;481;315192.6;457606.8;772799.4
330187;201804;293;88;205;83952.0;195570.0;279522.0
330190;201804;5552;2225;3327;2112967.2;3170948.8;5283916.0
330200;201804;4451;1528;2923;1452753.0;2783575.8;4236329.0
330205;201804;395;243;152;231392.7;144722.0;376114.7
330210;201804;1008;618;390;584329.6;370390.9;954720.5
330220;201804;2549;1528;1021;1454326.5;973080.2;2427406.8
330225;201804;556;306;250;291285.0;237832.2;529117.2
330227;201804;2444;775;1669;736192.44;1591870.2;2328062.8
330230;201804;199;120;79;113813.0;75366.0;189179.0
330240;201804;3648;1908;1740;1815616.9;1656747.1;3472364.0
330245;201804;153;65;88;62010.0;83188.8;145198.8
330250;201804;6489;3377;3112;3210835.5;2960038.2;6170874.0
330260;201804;567;166;401;158364.0;382554.0;540918.0
330270;201804;3370;1251;2119;1192597.0;2020955.2;3213552.2
330280;201804;450;288;162;272960.1;154539.0;427499.1
330285;201804;7063;2314;4749;2202962.5;4528343.5;6731305.5
330290;201804;566;218;348;207972.0;331992.0;539964.0
330300;201804;760;508;252;480816.7;240390.0;721206.7
330310;201804;416;238;178;225144.7;169812.0;394956.7
330320;201804;8151;3085;5066;2934888.8;4826597.0;7761486.0
330330;201804;9275;3641;5634;3466763.2;5370270.0;8837033.0
330340;201804;2642;1573;1069;1498439.0;1019806.94;2518246.0
330350;201804;17936;7105;10831;6751567.0;1,03E+14;1,71E+13
330360;201804;2546;1264;1282;1204883.2;1223019.0;2427902.2
330370;201804;998;553;445;526608.0;422527.6;949135.6
330380;201804;856;370;486;352254.97;463024.8;815279.75
330385;201804;604;317;287;301465.0;273798.0;575263.0
330390;201804;5158;2864;2294;2717390.5;2185914.5;4903305.0
330395;201804;260;165;95;155693.1;88865.2;244558.3
330400;201804;678;349;329;329512.6;311681.1;641193.7
330410;201804;500;355;145;337002.0;137840.33;474842.34
330411;201804;230;131;99;124793.0;94398.3;219191.3
330412;201804;252;104;148;98930.0;141192.0;240122.0
330414;201804;6123;2494;3629;2376168.0;3460092.2;5836260.5
330415;201804;575;269;306;255672.0;290970.8;546642.8
330420;201804;2276;1201;1075;1142769.6;1022976.0;2165745.5
330430;201804;1791;828;963;787241.8;916699.8;1703941.6
330440;201804;266;122;144;116388.0;137376.0;253764.0
330450;201804;121;51;70;48654.0;66780.0;115434.0
330452;201804;1738;824;914;784400.3;871633.75;1656034.0
330455;201804;110804;39699;71105;3,78E+14;6,78E+13;1,06E+16
330460;201804;265;108;157;103032.0;149778.0;252810.0
330470;201804;1240;677;563;639565.0;537092.44;1176657.5
330475;201804;1406;377;1029;357694.38;981093.6;1338788.0
330480;201804;749;397;352;378070.2;333614.6;711684.8
330490;201804;13667;4788;8879;4561375.0;8464364.0;1,30E+14
330500;201804;1345;617;728;588474.9;694131.0;1282605.9
330510;201804;11233;3787;7446;3605091.8;7096221.5;1,07E+14
330513;201804;103;50;53;47700.0;50562.0;98262.0
330515;201804;850;354;496;334645.0;472803.0;807448.0
330520;201804;2523;942;1581;898449.0;1508121.9;2406571.0
330530;201804;226;118;108;112048.0;102842.0;214890.0
330540;201804;352;175;177;166950.0;168381.0;335331.0
330550;201804;3061;1086;1975;1033612.2;1881860.8;2915473.0
330555;201804;761;284;477;270917.0;454104.8;725021.8
330560;201804;550;205;345;195570.0;329112.0;524682.0
330570;201804;253;176;77;167904.0;73458.0;241362.0
330575;201804;805;335;470;319352.0;446325.5;765677.5
330580;201804;3373;1893;1480;1800020.0;1410155.8;3210175.8
330590;201804;305;152;153;145008.0;145962.0;290970.0
330600;201804;1102;705;397;670433.25;377040.84;1047474.06
330610;201804;1521;839;682;793311.56;646479.9;1439791.5
330615;201804;192;146;46;139284.0;43884.0;183168.0
330620;201804;994;439;555;417376.6;528039.8;945416.4
330630;201804;3872;2469;1403;2340601.0;1331120.8;3671721.8
350010;201804;592;389;203;369246.66;193662.0;562908.7
350020;201804;41;21;20;20034.0;19080.0;39114.0
350030;201804;526;341;185;324170.0;175300.66;499470.66
350040;201804;127;50;77;47356.56;73458.0;120814.56
350050;201804;290;159;131;151686.0;124717.46;276403.47
350055;201804;85;47;38;44838.0;36252.0;81090.0
350060;201804;74;27;47;25758.0;44838.0;70596.0
350070;201804;809;472;337;446055.6;319831.56;765887.1
350075;201804;65;44;21;41976.0;20034.0;62010.0
350080;201804;52;33;19;30845.96;18126.0;48971.96
350090;201804;98;55;43;52470.0;41017.23;93487.23
350100;201804;293;184;109;174820.5;103986.0;278806.5
350110;201804;58;36;22;34344.0;20988.0;55332.0
350115;201804;156;94;62;89008.2;59148.0;148156.2
350120;201804;112;75;37;71550.0;35298.0;106848.0
350130;201804;359;175;184;166378.0;175536.0;341914.0
350140;201804;35;21;14;19271.0;13356.0;32627.0
350150;201804;71;56;15;53424.0;14310.0;67734.0
350160;201804;2521;981;1540;932805.2;1467805.9;2400611.0
350170;201804;406;246;160;232776.2;152354.0;385130.2
350180;201804;181;95;86;90630.0;82044.0;172674.0
350190;201804;976;501;475;475666.62;452849.7;928516.3
350200;201804;67;24;43;22896.0;40757.08;63653.08
350210;201804;1352;764;588;721155.3;560434.7;1281590.0
350220;201804;665;572;93;541550.75;88722.0;630272.75
350230;201804;83;58;25;55332.0;23850.0;79182.0
350240;201804;63;48;15;45792.0;14310.0;60102.0
350250;201804;1219;611;608;577171.6;579498.06;1156669.6
350260;201804;94;67;27;63918.0;25758.0;89676.0
350270;201804;828;541;287;515036.6;272348.9;787385.5
350275;201804;299;116;183;110283.0;174582.0;284865.0
350280;201804;4732;2421;2311;2297759.2;2201871.8;4499631.0
350290;201804;406;191;215;181923.23;204537.8;386461.03
350300;201804;49;26;23;24804.0;21942.0;46746.0
350310;201804;96;68;28;64872.0;26712.0;91584.0
350315;201804;38;23;15;21942.0;14310.0;36252.0
350320;201804;3263;1622;1641;1542572.5;1564733.8;3107306.2
350330;201804;1680;892;788;846867.94;750448.06;1597316.0
350335;201804;20;13;7;12402.0;6678.0;19080.0
350340;201804;131;63;68;60102.0;63918.9;124020.9
350350;201804;96;47;49;44838.0;46746.0;91584.0
350360;201804;131;88;43;83948.0;41022.0;124970.0
350370;201804;96;57;39;53741.96;37196.46;90938.42
350380;201804;749;317;432;301750.2;411364.8;713115.0
350390;201804;1423;576;847;548708.4;806893.4;1355601.8
350395;201804;25;20;5;19080.0;4770.0;23850.0
350400;201804;1691;903;788;852666.94;748200.2;1600867.1
350410;201804;2257;1015;1242;965220.94;1183945.0;2149166.0
350420;201804;233;142;91;134865.0;86814.0;221679.0
350430;201804;73;43;30;40450.0;28620.0;69070.0
350440;201804;151;111;40;104892.5;38160.0;143052.5
350450;201804;1626;1010;616;956420.94;587569.0;1543990.0
350460;201804;337;122;215;116388.0;204823.8;321211.8
350470;201804;14;10;4;9540.0;3816.0;13356.0
350480;201804;158;87;71;82998.0;67734.0;150732.0
350490;201804;241;119;122;112572.8;116388.0;228960.8
350500;201804;38;18;20;17172.0;19080.0;36252.0
350510;201804;164;110;54;104940.0;51516.0;156456.0
350520;201804;454;214;240;200975.95;228323.95;429299.9
350530;201804;453;217;236;207018.0;225144.0;432162.0
350535;201804;67;52;15;49350.42;14310.0;63660.42
350540;201804;374;192;182;182354.05;173342.0;355696.03
350550;201804;2740;1606;1134;1523590.4;1080732.1;2604322.5
350560;201804;642;448;194;427387.22;184718.25;612105.5
350570;201804;4168;1739;2429;1653536.0;2314759.2;3968295.2
350580;201804;373;179;194;169813.0;185062.45;354875.47
350590;201804;896;489;407;466506.0;387324.0;853830.0
350600;201804;6205;3129;3076;2970578.8;2929852.5;5900431.5
350610;201804;1541;788;753;745676.2;718353.0;1464029.2
350620;201804;36;24;12;22896.0;11448.0;34344.0
350630;201804;240;135;105;127836.96;99217.0;227053.95
350635;201804;883;350;533;333614.0;507835.22;841449.2
350640;201804;118;87;31;82998.0;29574.0;112572.0
350650;201804;1889;1242;647;1180414.2;615888.94;1796303.2
350660;201804;759;342;417;325624.06;396860.0;722484.06
350670;201804;309;160;149;152402.0;142146.0;294548.0
350680;201804;180;98;82;93492.0;78228.0;171720.0
350690;201804;198;99;99;94446.0;94446.0;188892.0
350700;201804;717;347;370;327703.94;352980.0;680683.94
350710;201804;334;137;197;130125.6;187938.0;318063.6
350715;201804;50;43;7;41022.0;6678.0;47700.0
350720;201804;17;12;5;11448.0;4770.0;16218.0
350730;201804;44;29;15;27666.0;14310.0;41976.0
350740;201804;211;118;93;112276.26;88722.0;200998.27
350745;201804;19;10;9;9516.0;8586.0;18102.0
350750;201804;2157;1384;773;1312048.8;736805.94;2048854.8
350760;201804;3744;1623;2121;1546005.9;2020594.4;3566600.2
350770;201804;62;42;20;40068.0;19080.0;59148.0
350775;201804;51;37;14;35298.0;13347.0;48645.0
350780;201804;425;211;214;201294.0;204156.0;405450.0
350790;201804;365;160;205;152640.0;195570.0;348210.0
350800;201804;436;246;190;234684.0;181260.0;415944.0
350810;201804;521;421;100;400681.0;95400.0;496081.0
350820;201804;85;52;33;49608.0;31482.0;81090.0
350830;201804;80;45;35;42930.0;33390.0;76320.0
350840;201804;741;331;410;315536.0;389900.0;705436.0
350850;201804;1770;1020;750;967072.3;715459.44;1682531.8
350860;201804;585;341;244;321481.72;232776.0;554257.75
350870;201804;441;299;142;285246.0;135181.8;420427.8
350880;201804;285;155;130;145010.1;123352.2;268362.3
350890;201804;44;27;17;25758.0;16218.0;41976.0
350900;201804;1467;476;991;451669.94;944650.8;1396320.8
350910;201804;27;17;10;16218.0;9540.0;25758.0
350920;201804;596;331;265;315456.03;252810.0;568266.06
350925;201804;1172;631;541;598932.3;514397.4;1113329.8
350930;201804;96;58;38;55332.0;36252.0;91584.0
350940;201804;725;408;317;387705.6;300577.6;688283.2
350945;201804;106;79;27;74830.0;25758.0;100588.0
350950;201804;15355;7389;7966;7021357.0;7589383.5;1,46E+14
350960;201804;1287;599;688;566764.94;656348.0;1223113.0
350970;201804;1126;606;520;575551.94;495784.47;1071336.4
350980;201804;96;65;31;62010.0;29574.0;91584.0
350990;201804;361;130;231;122370.72;220156.08;342526.8
350995;201804;33;17;16;16218.0;15264.0;31482.0
351000;201804;642;454;188;430892.06;179352.0;610244.06
351010;201804;51;30;21;28620.0;20034.0;48654.0
351015;201804;57;41;16;39114.0;15264.0;54378.0
351020;201804;1660;960;700;914176.8;665606.0;1579782.9
351030;201804;333;230;103;216844.2;98262.0;315106.2
351040;201804;854;461;393;438840.0;373968.66;812808.7
351050;201804;3275;1554;1721;1474231.0;1640500.5;3114731.5
351060;201804;5047;2068;2979;1962349.9;2838932.0;4801281.5
351070;201804;417;265;152;250302.92;145008.0;395310.9
351080;201804;808;583;225;556182.0;213696.0;769878.0
351090;201804;63;27;36;25758.0;34344.0;60102.0
351100;201804;459;267;192;252496.48;183163.23;435659.72
351110;201804;2119;1015;1104;962272.06;1050589.2;2012861.2
351120;201804;72;37;35;35298.0;33390.0;68688.0
351130;201804;175;61;114;58194.0;108756.0;166950.0
351140;201804;340;238;102;225525.64;97308.0;322833.62
351150;201804;402;206;196;195335.8;186984.0;382319.8
351160;201804;244;160;84;152640.0;80136.0;232776.0
351170;201804;187;99;88;94446.0;83189.0;177635.0
351190;201804;90;61;29;58194.0;27666.0;85860.0
351200;201804;378;245;133;233126.05;126882.0;360008.03
351210;201804;130;62;68;58893.38;64872.0;123765.38
351220;201804;525;315;210;296937.12;200340.0;497277.12
351230;201804;278;203;75;193025.95;71530.92;264556.88
351240;201804;229;98;131;93301.2;124974.0;218275.2
351250;201804;73;50;23;47476.0;21752.0;69228.0
351260;201804;155;114;41;108756.0;38828.0;147584.0
351270;201804;50;21;29;20034.0;27666.0;47700.0
351280;201804;1108;501;607;475094.47;578246.4;1053340.9
351290;201804;226;100;126;95400.0;119918.0;215318.0
351300;201804;3739;1741;1998;1654330.1;1905714.0;3560044.2
351310;201804;771;398;373;379692.0;355556.0;735248.0
351320;201804;108;66;42;62964.0;40068.0;103032.0
351330;201804;40;27;13;25758.0;12402.0;38160.0
351340;201804;1250;776;474;733768.94;451212.22;1184981.1
351350;201804;2488;1356;1132;1290906.1;1079637.0;2370543.0
351360;201804;777;387;390;368244.0;371742.03;739986.06
351370;201804;368;192;176;183163.23;167267.95;350431.2
351380;201804;8930;4077;4853;3873819.2;4619218.0;8493037.0
351385;201804;30;20;10;19080.0;9540.0;28620.0
351390;201804;288;212;76;201294.02;72504.0;273798.03
351400;201804;67;42;25;40068.0;23812.92;63880.92
351410;201804;440;272;168;258217.05;160272.0;418489.03
351420;201804;60;49;11;46746.0;10494.0;57240.0
351430;201804;73;39;34;37206.0;32436.0;69642.0
351440;201804;787;546;241;518689.75;229910.0;748599.75
351450;201804;255;128;127;122112.0;121158.0;243270.0
351460;201804;122;55;67;51755.0;63918.0;115673.0
351470;201804;138;74;64;70596.0;61056.0;131652.0
351480;201804;521;295;226;280190.97;215484.75;495675.72
351490;201804;293;104;189;99216.0;180306.0;279522.0
351492;201804;32;23;9;21942.0;8586.0;30528.0
351495;201804;27;18;9;17172.0;8586.0;25758.0
351500;201804;3547;1547;2000;1470476.8;1903088.4;3373565.2
351510;201804;1784;748;1036;713306.0;986140.25;1699446.2
351512;201804;21;18;3;17172.0;2862.0;20034.0
351515;201804;193;112;81;106848.0;77274.0;184122.0
351518;201804;762;469;293;446468.0;279522.0;725990.0
351519;201804;77;49;28;46746.0;26712.0;73458.0
351520;201804;146;89;57;84269.96;54378.0;138647.95
351530;201804;22;14;8;13356.0;7632.0;20988.0
351535;201804;135;75;60;71550.0;57240.0;128790.0
351540;201804;460;331;129;313391.0;123066.0;436457.0
351550;201804;1331;808;523;766794.94;497024.88;1263819.9
351560;201804;73;38;35;36252.0;33390.0;69642.0
351565;201804;11;7;4;6678.0;3816.0;10494.0
351570;201804;2564;1328;1236;1264588.4;1178477.6;2443066.0
351580;201804;39;35;4;33390.0;3816.0;37206.0
351590;201804;67;45;22;42930.0;20988.0;63918.0
351600;201804;195;148;47;141192.0;44838.0;186030.0
351610;201804;61;30;31;28620.0;29574.0;58194.0
351620;201804;5926;3386;2540;3221486.2;2420941.0;5642427.5
351630;201804;2547;1315;1232;1249195.4;1172843.2;2422038.8
351640;201804;1662;813;849;773717.4;807227.8;1580945.1
351650;201804;30;25;5;23850.0;4770.0;28620.0
351660;201804;157;101;56;95400.0;53424.0;148824.0
351670;201804;748;468;280;444136.0;267120.0;711256.0
351680;201804;73;60;13;57240.0;12402.0;69642.0
351685;201804;40;25;15;23850.0;14310.0;38160.0
351690;201804;309;218;91;206107.62;86814.0;292921.62
351700;201804;162;114;48;108756.0;45792.0;154548.0
351710;201804;74;53;21;50562.0;20034.0;70596.0
351720;201804;133;63;70;60102.0;66780.0;126882.0
351730;201804;101;73;28;68688.96;26707.23;95396.19
351740;201804;718;486;232;461164.75;221323.23;682488.0
351750;201804;368;155;213;147234.0;203202.0;350436.0
351760;201804;790;615;175;586949.0;166950.0;753899.0
351770;201804;287;246;41;234684.0;39114.0;273798.0
351780;201804;171;98;73;93483.0;69642.0;163125.0
351790;201804;240;125;115;119250.0;109710.0;228960.0
351800;201804;53;35;18;33390.0;17172.0;50562.0
351810;201804;126;84;42;80136.0;40068.0;120204.0
351820;201804;881;635;246;601021.6;234393.23;835414.8
351830;201804;508;184;324;174772.8;309096.0;483868.8
351840;201804;1877;950;927;897356.0;882857.7;1780213.8
351850;201804;231;169;62;160606.8;59148.0;219754.8
351860;201804;757;504;253;475094.84;241071.23;716166.06
351870;201804;5647;2667;2980;2533868.0;2836591.5;5370459.5
351880;201804;19024;8328;10696;7922179.5;1,02E+14;1,81E+14
351885;201804;89;60;29;56525.0;27666.0;84191.0
351890;201804;72;61;11;58194.0;10494.0;68688.0
351900;201804;224;134;90;127169.0;85860.0;213029.0
351905;201804;78;34;44;32436.0;41976.0;74412.0
351907;201804;3128;1372;1756;1306019.0;1673145.8;2979164.8
351910;201804;180;75;105;71550.0;100170.0;171720.0
351920;201804;133;75;58;71550.0;55309.69;126859.69
351925;201804;88;60;28;57240.0;26712.0;83952.0
351930;201804;378;258;120;246036.6;114480.0;360516.6
351940;201804;234;104;130;99216.0;124020.0;223236.0
351950;201804;142;83;59;79182.0;56286.0;135468.0
351960;201804;867;405;462;386188.72;438592.38;824781.06
351970;201804;1908;1018;890;969025.8;848193.0;1817218.9
351980;201804;146;73;73;67734.0;69642.0;137376.0
351990;201804;278;187;91;177444.0;86012.64;263456.62
352000;201804;364;220;144;209880.0;137376.0;347256.0
352010;201804;355;212;143;202248.0;136422.0;338670.0
352020;201804;203;68;135;64872.0;128790.0;193662.0
352030;201804;1018;526;492;501088.5;467777.97;968866.44
352040;201804;577;253;324;241362.0;309096.0;550458.0
352042;201804;281;95;186;90630.0;177158.0;267788.0
352044;201804;395;234;161;222081.86;153594.0;375675.88
352050;201804;3182;1291;1891;1224541.1;1802478.2;3027019.5
352060;201804;105;65;40;62010.0;38160.0;100170.0
352070;201804;103;74;29;69326.0;27666.0;96992.0
352080;201804;66;41;25;38160.0;23850.0;62010.0
352090;201804;174;115;59;109710.0;56286.0;165996.0
352100;201804;253;125;128;119246.0;120960.0;240206.0
352110;201804;112;33;79;31482.0;75366.0;106848.0
352115;201804;71;27;44;25758.0;41976.0;67734.0
352120;201804;98;65;33;62010.0;31482.0;93492.0
352130;201804;219;183;36;174582.0;34344.0;208926.0
352140;201804;184;75;109;71073.0;103986.0;175059.0
352150;201804;122;67;55;62964.04;52470.0;115434.04
352160;201804;131;87;44;82998.0;41976.0;124974.0
352170;201804;375;255;120;242316.05;114480.0;356796.03
352180;201804;611;410;201;389519.5;191750.0;581269.5
352190;201804;259;101;158;96344.46;150693.84;247038.3
352200;201804;32;16;16;15264.0;15264.0;30528.0
352210;201804;3799;1585;2214;1503813.9;2104999.0;3608812.8
352215;201804;54;30;24;28620.0;22438.08;51058.08
352220;201804;6909;2720;4189;2589373.5;3993519.5;6582893.0
352230;201804;3205;2044;1161;1937243.4;1100932.6;3038176.0
352240;201804;2234;1310;924;1247461.8;879199.06;2126660.8
352250;201804;2589;1338;1251;1273179.5;1189390.0;2462569.5
352260;201804;1077;586;491;557227.25;468128.0;1025355.25
352265;201804;62;27;35;25758.0;33390.0;59148.0
352270;201804;409;234;175;222282.92;166894.0;389176.9
352280;201804;400;250;150;237229.0;143095.23;380324.22
352290;201804;176;112;64;106848.0;61056.0;167904.0
352300;201804;102;76;26;72504.0;24804.0;97308.0
352310;201804;5769;2822;2947;2679211.8;2805410.8;5484622.5
352320;201804;970;506;464;479229.84;440605.1;919834.94
352330;201804;528;242;286;230534.1;272558.0;503092.1
352340;201804;1399;680;719;646068.0;683876.5;1329944.5
352350;201804;332;210;122;200340.0;116102.0;316442.0
352360;201804;230;96;134;90677.7;124953.32;215631.02
352370;201804;101;70;31;66780.0;29574.0;96354.0
352380;201804;121;75;46;71550.0;43884.0;115434.0
352390;201804;2453;1124;1329;1068795.4;1266704.0;2335499.2
352400;201804;475;203;272;192946.5;259201.8;452148.3
352410;201804;771;553;218;523057.88;207686.0;730743.9
352420;201804;103;66;37;62964.0;35298.0;98262.0
352430;201804;1764;786;978;744791.8;930379.5;1675171.4
352440;201804;3138;1608;1530;1524955.5;1457672.6;2982628.2
352450;201804;191;160;31;152640.0;29574.0;182214.0
352460;201804;573;295;278;280872.7;264497.2;545369.9
352470;201804;597;203;394;193662.0;375867.0;569529.0
352480;201804;1374;767;607;730445.94;578505.8;1308951.8
352490;201804;84;32;52;30528.0;49608.0;80136.0
352500;201804;1210;539;671;512680.6;638981.2;1151661.8
352510;201804;739;401;338;381600.97;322452.0;704052.94
352520;201804;541;241;300;229914.0;286056.9;515970.9
352530;201804;1738;921;817;878634.0;779036.6;1657670.6
352540;201804;74;49;25;46746.0;23850.0;70596.0
352550;201804;181;104;77;99216.0;72790.2;172006.2
352560;201804;50;40;10;38160.0;9540.0;47700.0
352570;201804;666;348;318;331389.0;303372.0;634761.0
352580;201804;57;38;19;35298.65;18126.0;53424.65
352585;201804;17;5;12;4770.0;11448.0;16218.0
352590;201804;4359;2204;2155;2096433.1;2054969.4;4151402.5
352600;201804;358;248;110;235638.95;104940.0;340578.97
352610;201804;939;439;500;416545.34;477000.0;893545.3
352620;201804;957;387;570;368244.2;543780.0;912024.2
352630;201804;170;66;104;62964.0;99206.46;162170.45
352640;201804;560;393;167;371870.38;159318.0;531188.4
352650;201804;87;57;30;54378.0;28620.0;82998.0
352660;201804;80;47;33;44838.0;31482.0;76320.0
352670;201804;1666;905;761;860839.9;724904.6;1585744.5
352680;201804;896;575;321;545318.56;304772.03;850090.6
352690;201804;4352;2000;2352;1899285.9;2239942.8;4139228.5
352700;201804;108;63;45;59815.8;42930.0;102745.8
352710;201804;1366;729;637;693558.0;603801.5;1297359.5
352720;201804;1327;640;687;608016.2;655107.25;1263123.4
352725;201804;26;24;2;22896.0;1908.0;24804.0
352730;201804;363;181;182;171495.81;173628.0;345123.8
352740;201804;422;266;156;251809.69;148824.0;400633.7
352750;201804;22;14;8;13069.8;7632.0;20701.8
352760;201804;201;144;57;137376.0;54378.0;191754.0
352770;201804;81;63;18;60102.0;17172.0;77274.0
352780;201804;79;44;35;41976.0;33390.0;75366.0
352790;201804;28;23;5;21942.0;4770.0;26712.0
352800;201804;249;170;79;162180.0;75079.8;237259.8
352810;201804;166;109;57;101475.42;54378.0;155853.42
352820;201804;66;52;14;48896.32;13356.0;62252.32
352830;201804;90;62;28;59148.0;26712.0;85860.0
352840;201804;601;310;291;294453.2;277614.0;572067.2
352850;201804;1374;493;881;469654.2;840474.0;1310128.2
352860;201804;134;88;46;83316.0;43884.0;127200.0
352870;201804;45;29;16;27666.0;15264.0;42930.0
352880;201804;191;129;62;123046.92;59148.0;182194.92
352885;201804;28;20;8;19080.0;7632.0;26712.0
352890;201804;57;39;18;37206.0;16886.0;54092.0
352900;201804;4879;2357;2522;2229323.8;2398461.8;4627785.5
352910;201804;38;31;7;29574.0;6678.0;36252.0
352920;201804;709;435;274;414036.0;261396.0;675432.0
352930;201804;1274;619;655;589093.8;621881.6;1210975.5
352940;201804;6335;2753;3582;2614768.0;3414066.8;6028834.5
352950;201804;93;38;55;36252.0;52470.0;88722.0
352960;201804;65;42;23;40068.0;21942.0;62010.0
352965;201804;19;8;11;7632.0;10494.0;18126.0
352970;201804;467;348;119;328784.97;112573.0;441357.97
352980;201804;173;92;81;87768.0;77274.0;165042.0
352990;201804;965;420;545;399677.28;518842.1;918519.4
353000;201804;67;31;36;29574.0;34344.0;63918.0
353010;201804;547;336;211;320544.0;201274.92;521818.9
353020;201804;289;212;77;202248.0;73458.0;275706.0
353030;201804;1199;545;654;518958.28;623229.7;1142188.0
353040;201804;87;54;33;51516.0;31482.0;82998.0
353050;201804;1327;845;482;798485.0;459732.6;1258217.6
353060;201804;8058;3647;4411;3463373.0;4201852.0;7665225.0
353070;201804;1640;1034;606;980463.44;576833.4;1557296.8
353080;201804;1331;705;626;670233.56;596246.0;1266479.5
353090;201804;56;34;22;32436.0;20988.0;53424.0
353100;201804;62;51;11;48654.0;10494.0;59148.0
353110;201804;2042;621;1421;590702.9;1353665.2;1944368.1
353120;201804;80;42;38;40068.0;36252.0;76320.0
353130;201804;876;439;437;417842.47;416785.7;834628.1
353140;201804;559;218;341;207911.0;325314.0;533225.0
353150;201804;362;205;157;194616.0;149768.45;344384.47
353160;201804;101;83;18;79182.0;17172.0;96354.0
353170;201804;195;65;130;62010.0;123992.46;186002.45
353180;201804;960;437;523;414890.7;498418.0;913308.7
353190;201804;486;348;138;330936.9;131366.0;462302.9
353200;201804;195;98;97;93492.0;92538.0;186030.0
353205;201804;25;18;7;17172.0;6678.0;23850.0
353210;201804;88;53;35;50562.0;33390.0;83952.0
353215;201804;54;32;22;30528.0;20988.0;51516.0
353220;201804;86;47;39;44838.0;36252.27;81090.27
353230;201804;162;64;98;61056.0;93492.0;154548.0
353240;201804;298;163;135;155502.0;128790.0;284292.0
353250;201804;205;108;97;103032.0;92538.0;195570.0
353260;201804;461;332;129;315593.5;123056.46;438649.97
353270;201804;69;50;19;47700.0;17458.2;65158.2
353280;201804;93;48;45;45315.0;42930.0;88245.0
353282;201804;122;89;33;84906.0;31482.0;116388.0
353284;201804;23;19;4;18126.0;3816.0;21942.0
353286;201804;1;1;0;954.0;0.0;954.0
353290;201804;80;47;33;44838.0;31473.0;76311.0
353300;201804;401;222;179;210246.45;170766.0;381012.47
353310;201804;54;48;6;45792.0;5724.0;51516.0
353320;201804;62;39;23;37206.0;21942.0;59148.0
353325;201804;58;34;24;32427.0;22592.0;55019.0
353330;201804;67;51;16;48511.0;15264.0;63775.0
353340;201804;625;203;422;193662.0;402002.25;595664.25
353350;201804;921;432;489;411137.62;465249.0;876386.6
353360;201804;110;88;22;83634.04;20702.0;104336.04
353370;201804;121;71;50;66780.1;47700.0;114480.1
353380;201804;26;18;8;17168.0;7632.0;24800.0
353390;201804;1066;506;560;482724.0;534240.0;1016964.0
353400;201804;52;31;21;29574.0;20034.0;49608.0
353410;201804;119;75;44;71550.0;41929.0;113479.0
353420;201804;57;23;34;21942.0;32436.0;54378.0
353430;201804;554;367;187;346397.3;178111.8;524509.1
353440;201804;10233;4476;5757;4258406.0;5485064.5;9743470.0
353450;201804;56;30;26;28620.0;24804.0;53424.0
353460;201804;615;337;278;318329.1;264487.5;582816.6
353470;201804;2145;1165;980;1107457.9;932514.25;2039972.1
353475;201804;240;161;79;150904.95;75366.0;226270.95
353480;201804;187;151;36;144054.0;34344.0;178398.0
353490;201804;236;141;95;134514.0;90630.0;225144.0
353500;201804;188;109;79;102746.96;75366.0;178112.95
353510;201804;103;73;30;69623.46;28610.46;98233.92
353520;201804;206;139;67;132606.0;63918.0;196524.0
353530;201804;473;259;214;247086.0;204156.0;451242.0
353540;201804;357;235;122;223867.27;116388.0;340255.28
353550;201804;740;504;236;477002.88;225144.0;702146.9
353560;201804;643;274;369;259830.69;351426.06;611256.75
353570;201804;60;31;29;29574.0;27666.0;57240.0
353580;201804;358;276;82;262827.0;78228.0;341055.0
353590;201804;87;60;27;56922.04;25758.0;82680.04
353600;201804;273;154;119;146599.0;112890.0;259489.0
353610;201804;114;60;54;57240.0;51516.0;108756.0
353620;201804;572;311;261;294707.5;248707.8;543415.3
353625;201804;50;28;22;26712.0;20988.0;47700.0
353630;201804;238;170;68;158485.4;64872.0;223357.4
353640;201804;127;86;41;81567.0;39114.0;120681.0
353650;201804;867;340;527;322261.2;502758.0;825019.2
353657;201804;23;17;6;16218.0;5724.0;21942.0
353660;201804;253;142;111;135468.0;105607.8;241075.8
353670;201804;765;453;312;431208.2;297648.0;728856.2
353680;201804;100;71;29;67210.0;27666.0;94876.0
353690;201804;47;37;10;34989.0;9540.0;44529.0
353700;201804;284;201;83;191754.0;79182.0;270936.0
353710;201804;426;197;229;186984.8;218180.0;405164.8
353715;201804;46;34;12;32149.8;11448.0;43597.8
353720;201804;362;168;194;160254.0;185076.0;345330.0
353730;201804;1123;691;432;656304.9;412128.0;1068432.9
353740;201804;647;358;289;341245.8;275706.0;616951.8
353750;201804;92;58;34;54800.14;32436.0;87236.14
353760;201804;2773;1047;1726;996779.1;1643001.2;2639780.5
353770;201804;97;81;16;76797.0;15264.0;92061.0
353780;201804;1139;567;572;539201.94;543494.0;1082696.0
353790;201804;509;293;216;277453.5;203239.34;480692.84
353800;201804;3285;1671;1614;1585389.8;1537381.5;3122771.2
353810;201804;236;132;104;125074.71;99189.0;224263.7
353820;201804;187;93;94;88722.0;89051.41;177773.4
353830;201804;47;40;7;38160.0;6678.0;44838.0
353850;201804;169;86;83;82044.0;79182.0;161226.0
353860;201804;470;214;256;203440.5;243937.8;447378.3
353870;201804;5025;2531;2494;2396787.0;2368090.5;4764877.5
353880;201804;683;488;195;464216.4;185076.12;649292.5
353890;201804;586;330;256;314248.0;243938.0;558186.0
353900;201804;133;66;67;62964.0;63918.0;126882.0
353910;201804;176;87;89;82998.0;84906.0;167904.0
353920;201804;454;246;208;233492.4;197989.16;431481.56
353930;201804;1004;593;411;564029.8;390859.8;954889.56
353940;201804;188;101;87;95590.8;82140.0;177730.8
353950;201804;516;321;195;305947.8;186021.0;491968.8
353960;201804;70;57;13;54378.0;12402.0;66780.0
353970;201804;76;46;30;43884.0;28620.0;72504.0
353980;201804;1531;754;777;716656.94;740323.75;1456980.8
353990;201804;74;42;32;40068.0;30528.0;70596.0
354000;201804;374;181;193;172007.0;183927.2;355934.2
354010;201804;93;52;41;49608.0;38637.0;88245.0
354020;201804;547;345;202;328176.0;192708.0;520884.0
354025;201804;56;44;12;41976.0;11448.0;53424.0
354030;201804;64;35;29;33390.0;27666.0;61056.0
354040;201804;96;68;28;64490.4;26712.0;91202.4
354050;201804;192;106;86;100838.0;82044.0;182882.0
354060;201804;776;373;403;355842.0;382062.4;737904.4
354070;201804;868;506;362;481194.03;345348.0;826542.0
354075;201804;213;113;100;107802.0;94446.8;202248.8
354080;201804;294;127;167;120871.8;159318.0;280189.8
354085;201804;18;11;7;10494.0;6678.0;17172.0
354090;201804;313;173;140;164961.0;133560.0;298521.0
354100;201804;5504;2296;3208;2179178.8;3054608.2;5233787.0
354105;201804;80;41;39;39114.0;37206.0;76320.0
354110;201804;48;22;26;20988.0;24804.0;45792.0
354120;201804;148;102;46;97168.97;43884.0;141052.97
354130;201804;705;473;232;451004.0;221038.0;672042.0
354140;201804;3174;1485;1689;1413390.4;1609761.9;3023152.2
354150;201804;650;406;244;384824.84;231345.0;616169.8
354160;201804;706;452;254;430015.5;242030.0;672045.5
354165;201804;22;13;9;12402.0;8586.0;20988.0
354170;201804;176;120;56;113812.2;53424.0;167236.2
354180;201804;63;39;24;36880.0;22896.0;59776.0
354190;201804;215;100;115;93778.2;109710.0;203488.2
354200;201804;131;72;59;68211.0;56286.0;124497.0
354210;201804;67;33;34;31482.0;32436.0;63918.0
354220;201804;642;395;247;376162.2;234306.39;610468.56
354230;201804;165;67;98;63918.0;92538.6;156456.6
354240;201804;318;205;113;194616.48;107165.96;301782.44
354250;201804;95;56;39;53424.0;37206.0;90630.0
354260;201804;1938;910;1028;856211.3;979372.0;1835583.4
354270;201804;95;71;24;67734.0;22896.0;90630.0
354280;201804;38;20;18;19080.0;17172.0;36252.0
354290;201804;145;99;46;93635.1;43884.0;137519.1
354300;201804;422;288;134;274435.0;127678.0;402113.0
354310;201804;105;76;29;71550.2;27666.0;99216.2
354320;201804;182;97;85;92538.0;81090.0;173628.0
354323;201804;16;14;2;13356.0;1908.0;15264.0
354325;201804;106;61;45;57388.0;42930.0;100318.0
354330;201804;2597;873;1724;828207.25;1642530.1;2470737.5
354340;201804;10568;5166;5402;4916242.5;5146876.5;1,01E+14
354350;201804;130;86;44;82044.0;41832.9;123876.9
354360;201804;88;48;40;45792.0;38160.0;83952.0
354370;201804;266;147;119;140238.0;113526.0;253764.0
354380;201804;214;129;85;122280.0;81090.0;203370.0
354390;201804;2767;1008;1759;960682.75;1677162.8;2637845.5
354400;201804;330;174;156;165266.25;148251.8;313518.06
354410;201804;615;299;316;283620.44;300510.2;584130.6
354420;201804;274;172;102;164088.0;97308.0;261396.0
354425;201804;320;185;135;176490.0;128790.0;305280.0
354430;201804;185;116;69;109089.9;65062.8;174152.7
354440;201804;39;27;12;25758.0;11448.0;37206.0
354450;201804;51;37;14;35298.0;13356.0;48654.0
354460;201804;104;60;44;57240.0;41976.0;99216.0
354470;201804;39;26;13;24804.0;12402.0;37206.0
354480;201804;117;60;57;57231.0;54368.46;111599.46
354490;201804;149;92;57;87608.97;54378.0;141986.97
354500;201804;392;195;197;186030.0;187938.0;373968.0
354510;201804;102;70;32;66780.0;30528.0;97308.0
354515;201804;38;13;25;12402.0;23850.0;36252.0
354520;201804;1645;728;917;691801.2;874379.56;1566180.8
354530;201804;659;345;314;327408.8;298412.0;625820.8
354540;201804;278;156;122;148824.0;116383.23;265207.22
354550;201804;43;25;18;23850.0;17172.0;41022.0
354560;201804;165;94;71;89390.0;67724.46;157114.45
354570;201804;138;89;49;84906.0;46746.0;131652.0
354580;201804;1969;934;1035;888459.0;986804.25;1875263.2
354600;201804;273;147;126;137984.12;120189.69;258173.81
354610;201804;72;65;7;61056.58;6678.0;67734.58
354620;201804;64;21;43;20034.0;41022.0;61056.0
354625;201804;17;11;6;10494.0;5720.0;16214.0
354630;201804;320;211;109;200919.34;103986.0;304905.34
354640;201804;805;520;285;492154.38;271890.0;764044.4
354650;201804;72;41;31;38818.8;29545.92;68364.72
354660;201804;812;602;210;570286.44;200340.0;770626.44
354670;201804;277;98;179;92539.0;169813.0;262352.0
354680;201804;1247;471;776;449334.0;739827.0;1189161.0
354690;201804;90;60;30;56287.0;28620.0;84907.0
354700;201804;78;56;22;53424.0;20988.0;74412.0
354710;201804;55;38;17;35615.96;16218.0;51833.96
354720;201804;20;19;1;18126.0;954.0;19080.0
354730;201804;1895;800;1095;760043.2;1044439.2;1804482.4
354740;201804;59;41;18;39114.0;17172.0;56286.0
354750;201804;439;260;179;248031.0;170766.0;418797.0
354760;201804;519;318;201;300811.0;191319.73;492130.75
354765;201804;12;5;7;4770.0;6678.0;11448.0
354770;201804;340;229;111;217642.03;105130.8;322772.84
354780;201804;8157;3322;4835;3156233.2;4607753.0;7763986.0
354790;201804;114;67;47;63918.0;44838.0;108756.0
354800;201804;426;236;190;225144.0;180954.92;406098.9
354805;201804;104;52;52;48972.0;49608.0;98580.0
354810;201804;137;80;57;76320.0;54378.0;130698.0
354820;201804;186;81;105;77065.0;100170.0;177235.0
354830;201804;40;22;18;20988.0;17172.0;38160.0
354840;201804;55;37;18;35298.0;17172.0;52470.0
354850;201804;4576;2038;2538;1936469.0;2416323.0;4352792.0
354860;201804;328;160;168;152640.0;157877.52;310517.53
354870;201804;11917;5401;6516;5124744.5;6205423.5;1,13E+14
354880;201804;3005;1124;1881;1070658.5;1792878.9;2863537.2
354890;201804;2861;1581;1280;1501614.9;1220137.4;2721752.2
354900;201804;60;39;21;37206.0;20034.0;57240.0
354910;201804;1232;650;582;617486.25;555228.0;1172714.2
354920;201804;50;42;8;40068.0;7632.0;47700.0
354925;201804;12;7;5;6678.0;4770.0;11448.0
354930;201804;31;28;3;26442.0;2862.0;29304.0
354940;201804;796;584;212;555183.2;202248.0;757431.2
354950;201804;218;143;75;135812.0;71550.0;207362.0
354960;201804;168;64;104;61056.0;98930.0;159986.0
354970;201804;848;556;292;525565.1;277929.03;803494.1
354980;201804;8451;3138;5313;2985658.2;5065617.0;8051275.5
354990;201804;9190;4330;4860;4117299.8;4630300.0;8747600.0
354995;201804;518;182;336;173628.0;320229.2;493857.2
355000;201804;496;165;331;157405.23;314581.5;471986.72
355010;201804;625;393;232;374922.0;219116.48;594038.5
355020;201804;716;452;264;430249.6;251848.0;682097.56
355030;201804;204952;79582;125370;7,57E+14;1,20E+16;1,95E+16
355040;201804;720;340;380;322309.6;362329.2;684638.8
355050;201804;153;101;52;95083.77;49608.0;144691.77
355060;201804;1520;758;762;718263.9;725756.3;1444020.1
355070;201804;1451;711;740;674470.4;704967.0;1379437.4
355080;201804;201;117;84;111618.0;79248.8;190866.8
355090;201804;294;196;98;184886.0;93492.0;278378.0
355100;201804;4785;2373;2412;2244180.5;2299170.2;4543351.0
355110;201804;269;171;98;162177.0;93492.0;255669.0
355120;201804;80;56;24;53424.0;22896.0;76320.0
355130;201804;53;29;24;27666.0;22896.0;50562.0
355140;201804;183;121;62;114718.5;59148.0;173866.5
355150;201804;680;410;270;389896.0;257103.0;646999.0
355160;201804;453;219;234;206541.95;223236.0;429777.97
355170;201804;2060;1075;985;1024170.9;939670.94;1963841.8
355180;201804;618;264;354;250902.0;336881.25;587783.25
355190;201804;224;152;72;145008.0;68688.0;213696.0
355200;201804;117;68;49;64872.0;46746.0;111618.0
355210;201804;722;418;304;398772.0;289997.47;688769.44
355220;201804;6727;3585;3142;3408631.8;2988242.8;6396874.5
355230;201804;106;63;43;60102.0;41017.23;101119.23
355240;201804;4274;1876;2398;1776846.1;2283268.0;4060114.0
355250;201804;5395;2622;2773;2495423.2;2642034.2;5137457.5
355255;201804;53;32;21;30528.0;20034.0;50562.0
355260;201804;187;113;74;106829.12;70568.46;177397.58
355270;201804;166;98;68;93492.0;64157.0;157649.0
355280;201804;6381;2685;3696;2556201.5;3520996.5;6077198.0
355290;201804;78;58;20;55332.0;19080.0;74412.0
355300;201804;184;119;65;112565.56;62010.0;174575.56
355310;201804;108;60;48;57240.0;45792.0;103032.0
355320;201804;91;47;44;44838.0;41028.6;85866.6
355330;201804;268;151;117;144054.0;111618.0;255672.0
355340;201804;1519;543;976;515415.62;930362.0;1445777.6
355350;201804;143;72;71;68688.0;67734.0;136422.0
355360;201804;184;116;68;110454.12;64872.0;175326.12
355365;201804;25;20;5;19080.0;4770.0;23850.0
355370;201804;1040;590;450;556983.75;428032.56;985016.3
355380;201804;771;516;255;491672.53;242984.0;734656.5
355385;201804;62;44;18;41976.0;17172.0;59148.0
355390;201804;107;62;45;59148.0;42930.0;102078.0
355395;201804;186;114;72;107655.23;68688.0;176343.23
355400;201804;1547;959;588;910887.5;559425.8;1470313.4
355410;201804;4903;2302;2601;2179211.5;2473583.5;4652795.0
355420;201804;50;37;13;35298.0;12402.0;47700.0
355430;201804;347;208;139;197096.4;132606.0;329702.4
355440;201804;79;48;31;45792.0;29574.0;75366.0
355450;201804;451;217;234;204299.94;222186.8;426486.75
355460;201804;69;53;16;49608.42;15264.0;64872.42
355465;201804;51;32;19;30528.0;18126.0;48654.0
355470;201804;181;73;108;68688.1;103032.0;171720.1
355475;201804;13;8;5;7632.0;4770.0;12402.0
355480;201804;458;199;259;187948.34;245645.45;433593.8
355490;201804;116;81;35;77274.0;33390.0;110664.0
355495;201804;57;28;29;26712.0;27666.0;54378.0
355500;201804;1658;931;727;883500.7;693523.44;1577024.1
355510;201804;272;199;73;186387.67;69642.0;256029.67
355520;201804;36;28;8;26426.0;7632.0;34058.0
355530;201804;25;17;8;16218.0;7632.0;23850.0
355535;201804;77;39;38;37206.0;36252.0;73458.0
355540;201804;2368;941;1427;896255.5;1359442.0;2255697.5
355550;201804;63;38;25;36252.0;23850.0;60102.0
355560;201804;240;120;120;114480.0;113843.96;228323.95
355570;201804;31;20;11;19080.0;10494.0;29574.0
355580;201804;272;185;87;176490.0;82707.23;259197.23
355590;201804;23;14;9;13356.0;8586.0;21942.0
355600;201804;272;139;133;132606.0;126591.23;259197.23
355610;201804;212;138;74;131652.0;70596.0;202248.0
355620;201804;1260;589;671;561095.8;639175.5;1200271.2
355630;201804;418;303;115;289062.0;108469.96;397531.97
355635;201804;126;61;65;58194.0;61997.0;120191.0
355640;201804;574;334;240;317682.16;228960.0;546642.2
355645;201804;828;356;472;338145.3;448408.8;786554.1
355650;201804;2147;895;1252;850560.8;1194103.2;2044664.0
355660;201804;259;138;121;131652.0;115434.0;247086.0
355670;201804;491;192;299;183168.0;284959.8;468127.8
355680;201804;206;116;90;109711.0;85574.0;195285.0
355690;201804;87;40;47;38160.0;44494.0;82654.0
355695;201804;15;12;3;11448.0;2862.0;14310.0
355700;201804;1145;589;556;556836.6;529852.0;1086688.6
355710;201804;2191;1201;990;1142117.5;943780.06;2085897.6
355715;201804;20;18;2;17172.0;1908.0;19080.0
355720;201804;209;126;83;118614.08;79182.0;197796.08
355730;201804;94;54;40;50641.95;38160.0;88801.95
410010;201804;134;113;21;107802.0;20034.0;127836.0
410020;201804;104;93;11;88722.0;10494.0;99216.0
410030;201804;165;104;61;98548.4;58194.0;156742.4
410040;201804;975;533;442;508243.5;421478.0;929721.5
410045;201804;26;21;5;20034.0;4770.0;24804.0
410050;201804;477;264;213;251856.0;202725.0;454581.0
410060;201804;279;214;65;204156.0;62010.0;266166.0
410070;201804;308;255;53;243270.0;50562.0;293832.0
410080;201804;165;106;59;101124.0;56286.0;157410.0
410090;201804;74;66;8;62755.0;7632.0;70387.0
410100;201804;298;214;84;203841.19;79325.1;283166.28
410105;201804;47;28;19;26712.0;18126.0;44838.0
410110;201804;318;194;124;185076.0;118296.0;303372.0
410115;201804;28;19;9;18126.0;8586.0;26712.0
410120;201804;446;230;216;219118.8;206064.0;425182.8
410130;201804;44;27;17;25758.0;16218.0;41976.0
410140;201804;3106;1527;1579;1452501.4;1503027.6;2955529.0
410150;201804;2700;1082;1618;1030789.25;1542975.8;2573765.0
410160;201804;503;318;185;303085.8;176490.0;479575.8
410165;201804;68;46;22;43884.0;20988.0;64872.0
410170;201804;169;126;43;118779.0;41022.0;159801.0
410180;201804;2145;1252;893;1190419.2;850464.94;2040884.1
410185;201804;34;30;4;28620.0;3816.0;32436.0
410190;201804;444;278;166;265212.0;158364.0;423576.0
410200;201804;964;721;243;686984.94;231822.0;918806.94
410210;201804;555;289;266;275706.0;253478.0;529184.0
410220;201804;39;21;18;20034.0;17172.0;37206.0
410230;201804;131;70;61;66780.0;58194.0;124974.0
410240;201804;741;485;256;462117.8;244224.0;706341.8
410250;201804;377;276;101;262699.84;96349.23;359049.06
410260;201804;294;174;120;165996.0;114480.0;280476.0
410270;201804;31;19;12;18126.0;11448.0;29574.0
410275;201804;65;48;17;45792.0;16218.0;62010.0
410280;201804;323;185;138;176230.52;131652.0;307882.53
410290;201804;234;147;87;140238.0;82998.0;223236.0
410300;201804;80;64;16;61056.0;15264.0;76320.0
410302;201804;24;16;8;15264.0;7632.0;22896.0
410304;201804;46;32;14;30528.0;13356.0;43884.0
410305;201804;206;111;95;105086.2;90630.0;195716.2
410310;201804;265;168;97;160272.0;92518.92;252790.92
410315;201804;52;37;15;35274.0;14310.0;49584.0
410320;201804;139;97;42;92538.0;40068.0;132606.0
410322;201804;34;24;10;22896.0;9540.0;32436.0
410330;201804;164;116;48;110664.0;45602.0;156266.0
410335;201804;100;62;38;59148.0;36252.0;95400.0
410337;201804;38;33;5;31482.0;4770.0;36252.0
410340;201804;31;29;2;27666.0;1908.0;29574.0
410345;201804;217;136;81;129744.0;77274.0;207018.0
410347;201804;54;41;13;39114.0;12402.0;51516.0
410350;201804;228;139;89;132606.0;84906.0;217512.0
410360;201804;457;277;180;261714.4;171148.0;432862.4
410370;201804;2414;1028;1386;977117.3;1319464.9;2296582.2
410380;201804;222;146;76;139284.0;72504.0;211788.0
410390;201804;372;277;95;264254.0;90630.0;354884.0
410395;201804;35;23;12;21942.0;11448.0;33390.0
410400;201804;844;428;416;406983.2;396325.0;803308.2
410405;201804;92;70;22;66780.0;20988.0;87768.0
410410;201804;40;31;9;29574.0;8586.0;38160.0
410420;201804;1655;817;838;777323.9;798499.0;1575822.9
410425;201804;179;84;95;79946.0;90630.0;170576.0
410430;201804;2195;1293;902;1230374.0;859630.3;2090004.4
410440;201804;391;290;101;275707.0;96354.0;372061.0
410442;201804;356;238;118;226099.0;112572.0;338671.0
410445;201804;419;291;128;277614.0;122112.0;399726.0
410450;201804;413;209;204;199386.0;194616.0;394002.0
410460;201804;413;224;189;213400.8;180306.0;393706.8
410465;201804;187;122;65;115147.8;62010.0;177157.8
410470;201804;219;140;79;133560.0;75366.0;208926.0
410480;201804;5831;2883;2948;2731574.2;2805991.5;5537566.0
410490;201804;1401;924;477;879999.0;453151.0;1333150.0
410500;201804;269;153;116;145962.0;110664.0;256626.0
410510;201804;183;135;48;128790.0;45783.0;174573.0
410520;201804;257;191;66;182214.0;62964.0;245178.0
410530;201804;236;87;149;82998.0;142142.0;225140.0
410540;201804;321;232;89;220747.6;84901.23;305648.84
410550;201804;1623;702;921;669383.8;877434.4;1546818.1
410560;201804;146;114;32;108756.0;30528.0;139284.0
410570;201804;429;302;127;286020.2;121158.0;407178.2
410580;201804;3173;1426;1747;1358521.8;1665208.0;3023729.8
410590;201804;407;288;119;274752.0;113526.0;388278.0
410600;201804;185;160;25;152640.0;23850.0;176490.0
410610;201804;55;44;11;41976.0;10494.0;52470.0
410620;201804;246;176;70;167904.0;66780.0;234684.0
410630;201804;445;260;185;248040.0;175331.0;423371.0
410640;201804;980;604;376;572761.0;357097.28;929858.25
410645;201804;100;75;25;71169.0;23850.0;95019.0
410650;201804;369;253;116;240408.0;110664.0;351072.0
410655;201804;80;61;19;58194.0;18126.0;76320.0
410657;201804;44;19;25;18126.0;23850.0;41976.0
410660;201804;598;420;178;399437.0;169812.0;569249.0
410670;201804;78;65;13;62010.0;12402.0;74412.0
410680;201804;191;157;34;149111.0;32436.0;181547.0
410685;201804;17;11;6;10494.0;5724.0;16218.0
410690;201804;28306;12289;16017;1,17E+14;1,53E+14;2,70E+14
410700;201804;322;235;87;223109.2;82998.0;306107.2
410710;201804;126;101;25;96354.0;23850.0;120204.0
410712;201804;24;15;9;14310.0;8586.0;22896.0
410715;201804;84;62;22;59148.0;20988.0;80136.0
410720;201804;597;362;235;345348.0;224181.0;569529.0
410725;201804;181;131;50;124974.0;47700.0;172674.0
410730;201804;87;54;33;51516.0;31482.0;82998.0
410740;201804;112;81;31;77274.0;29574.0;106848.0
410750;201804;220;163;57;155502.0;54373.23;209875.23
410752;201804;24;15;9;14310.0;8586.0;22896.0
410753;201804;54;24;30;22223.43;28620.0;50843.43
410754;201804;38;23;15;21561.0;14310.0;35871.0
410755;201804;79;54;25;51229.8;23850.0;75079.8
410760;201804;718;405;313;386345.56;298602.0;684947.56
410765;201804;1666;805;861;760585.7;820240.25;1580826.0
410770;201804;105;87;18;82998.0;17172.0;100170.0
410773;201804;47;35;12;33390.0;11448.0;44838.0
410775;201804;179;136;43;129076.2;41022.0;170098.2
410780;201804;78;42;36;40068.0;34344.0;74412.0
410785;201804;53;43;10;41022.0;9540.0;50562.0
410790;201804;70;33;37;31482.0;35298.0;66780.0
410800;201804;297;189;108;179353.0;103032.0;282385.0
410810;201804;26;22;4;20988.0;3530.0;24518.0
410820;201804;178;132;46;125785.0;43884.0;169669.0
410830;201804;8489;3870;4619;3682266.0;4404236.0;8086502.0
410832;201804;104;72;32;68688.0;30528.0;99216.0
410840;201804;1428;794;634;755208.06;603913.0;1359121.0
410845;201804;63;39;24;37206.0;22896.0;60102.0
410850;201804;188;130;58;123734.0;55332.0;179066.0
410855;201804;47;40;7;38160.0;6678.0;44838.0
410860;201804;671;392;279;373014.75;266166.0;639180.75
410865;201804;103;80;23;76320.0;21942.0;98262.0
410870;201804;159;137;22;130698.0;20697.0;151395.0
410880;201804;1119;559;560;532775.6;534195.0;1066970.6
410890;201804;77;54;23;51516.0;21942.0;73458.0
410895;201804;74;56;18;53424.0;17172.0;70596.0
410900;201804;21;13;8;12402.0;7632.0;20034.0
410910;201804;17;15;2;14310.0;1908.0;16218.0
410920;201804;34;23;11;21942.0;10494.0;32436.0
410930;201804;501;325;176;309838.97;167904.0;477742.97
410940;201804;4324;2580;1744;2450538.0;1660512.2;4111050.2
410950;201804;120;87;33;82998.0;31482.0;114480.0
410960;201804;761;339;422;323120.0;402398.0;725518.0
410965;201804;64;49;15;46459.8;14310.0;60769.8
410970;201804;629;448;181;426924.2;172674.0;599598.2
410975;201804;104;62;42;58637.0;40068.0;98705.0
410980;201804;1575;717;858;681471.8;817574.0;1499045.9
410990;201804;269;181;88;172674.0;83665.8;256339.8
411000;201804;63;41;22;39114.0;20988.0;60102.0
411005;201804;25;20;5;19080.0;4770.0;23850.0
411007;201804;235;139;96;132606.0;91584.0;224190.0
411010;201804;580;402;178;383508.0;169812.0;553320.0
411020;201804;295;205;90;195570.0;85860.0;281430.0
411030;201804;18;9;9;8586.0;8586.0;17172.0
411040;201804;49;35;14;33390.0;13356.0;46746.0
411050;201804;220;174;46;165339.72;43757.12;209096.84
411060;201804;514;344;170;328167.0;162180.0;490347.0
411065;201804;62;54;8;51516.0;7632.0;59148.0
411070;201804;1202;798;404;755785.3;384462.0;1140247.2
411080;201804;242;172;70;164172.0;66780.0;230952.0
411090;201804;117;88;29;83952.0;27666.0;111618.0
411095;201804;264;108;156;102555.0;148814.0;251369.0
411100;201804;113;94;19;89676.0;18126.0;107802.0
411110;201804;120;83;37;79182.0;35298.0;114480.0
411120;201804;183;136;47;129744.0;44838.0;174582.0
411125;201804;182;82;100;77579.28;95400.0;172979.28
411130;201804;125;107;18;101440.0;16885.8;118325.8
411140;201804;183;126;57;120182.12;53853.3;174035.42
411150;201804;1227;821;406;782556.7;387324.0;1169880.6
411155;201804;121;84;37;80136.0;35298.0;115434.0
411160;201804;21;10;11;9540.0;10494.0;20034.0
411170;201804;59;53;6;50275.8;5724.0;55999.8
411180;201804;946;623;323;593019.0;308137.22;901156.25
411190;201804;346;199;147;189178.2;140238.0;329416.2
411200;201804;666;440;226;418489.88;214697.7;633187.56
411210;201804;684;366;318;347614.22;303372.0;650986.2
411220;201804;147;111;36;105894.0;34344.0;140238.0
411230;201804;40;36;4;34344.0;3816.0;38160.0
411240;201804;119;81;38;77274.0;36252.0;113526.0
411250;201804;422;307;115;292878.0;109710.0;402588.0
411260;201804;22;15;7;14310.0;6678.0;20988.0
411270;201804;293;157;136;149778.0;129744.0;279522.0
411275;201804;202;178;24;169096.6;22896.0;191992.6
411280;201804;230;163;67;154231.12;63918.0;218149.12
411290;201804;58;43;15;41022.0;14310.0;55332.0
411295;201804;146;115;31;109710.0;29574.0;139284.0
411300;201804;70;36;34;34344.0;32436.0;66780.0
411310;201804;90;69;21;65826.0;20034.0;85860.0
411320;201804;762;551;211;524128.4;199691.28;723819.7
411325;201804;44;27;17;25758.0;16218.0;41976.0
411330;201804;917;588;329;559426.6;313708.0;873134.6
411340;201804;25;17;8;16218.0;7318.0;23536.0
411342;201804;74;56;18;53424.0;17172.0;70596.0
411345;201804;126;64;62;61056.0;59148.0;120204.0
411350;201804;481;385;96;366002.44;90621.2;456623.62
411360;201804;53;34;19;32436.0;18126.0;50562.0
411370;201804;14177;5811;8366;5522649.0;7964698.5;1,35E+14
411373;201804;187;137;50;130698.0;47700.0;178398.0
411375;201804;73;61;12;58194.0;11448.0;69642.0
411380;201804;96;71;25;67734.0;23850.0;91584.0
411390;201804;137;91;46;86814.0;43884.0;130698.0
411400;201804;350;263;87;250893.0;82998.0;333891.0
411410;201804;452;233;219;221614.2;208640.0;430254.2
411420;201804;1026;471;555;446758.2;528993.2;975751.4
411430;201804;411;264;147;251188.2;140229.0;391417.2
411435;201804;34;23;11;21942.0;10494.0;32436.0
411440;201804;469;376;93;357050.75;88722.0;445772.75
411450;201804;432;359;73;342486.0;69642.0;412128.0
411460;201804;755;302;453;287187.62;430689.16;717876.8
411470;201804;87;65;22;62010.0;20988.0;82998.0
411480;201804;636;360;276;340674.4;262731.6;603406.0
411490;201804;293;183;110;174582.0;104940.0;279522.0
411500;201804;112;94;18;89472.33;16791.0;106263.33
411510;201804;218;176;42;167156.06;40068.0;207224.06
411520;201804;5919;2311;3608;2199648.2;3434280.2;5633928.5
411530;201804;110;75;35;71550.0;33390.0;104940.0
411535;201804;47;20;27;19080.0;25758.0;44838.0
411540;201804;348;242;106;229845.9;101124.0;330969.9
411545;201804;55;39;16;37206.0;15264.0;52470.0
411550;201804;73;56;17;53424.0;16218.0;69642.0
411560;201804;381;178;203;169148.38;193662.0;362810.38
411570;201804;780;298;482;283997.0;459638.0;743635.0
411573;201804;33;20;13;19080.0;12402.0;31482.0
411575;201804;263;163;100;155502.0;95400.0;250902.0
411580;201804;1250;499;751;474739.03;714606.4;1189345.4
411585;201804;80;40;40;38160.0;38160.0;76320.0
411590;201804;25;18;7;17172.0;6678.0;23850.0
411600;201804;26;10;16;9540.0;15264.0;24804.0
411605;201804;248;109;139;103843.0;132606.0;236449.0
411610;201804;234;158;76;150732.0;72504.0;223236.0
411620;201804;357;200;157;190323.0;149139.0;339462.0
411630;201804;58;38;20;36252.0;19080.0;55332.0
411640;201804;35;29;6;27666.0;5724.0;33390.0
411650;201804;13;9;4;8586.0;3816.0;12402.0
411660;201804;31;25;6;23850.0;5724.0;29574.0
411670;201804;247;188;59;179352.0;56286.0;235638.0
411680;201804;155;133;22;126882.0;20988.0;147870.0
411690;201804;602;318;284;302794.44;270592.1;573386.5
411695;201804;63;47;16;44838.0;15264.0;60102.0
411700;201804;166;144;22;137376.0;20988.0;158364.0
411705;201804;101;66;35;62964.0;33390.0;96354.0
411710;201804;300;201;99;190687.81;94446.0;285133.8
411720;201804;142;91;51;86814.0;48654.0;135468.0
411721;201804;63;52;11;49608.0;10494.0;60102.0
411722;201804;99;42;57;40068.0;54378.0;94446.0
411725;201804;146;113;33;107486.0;31482.0;138968.0
411727;201804;74;58;16;55332.0;14977.8;70309.8
411729;201804;32;25;7;23850.0;6678.0;30528.0
411730;201804;545;353;192;335171.97;182881.8;518053.75
411740;201804;33;20;13;19080.0;12402.0;31482.0
411745;201804;69;46;23;43093.0;21942.0;65035.0
411750;201804;871;417;454;396721.9;432147.7;828869.56
411760;201804;1193;898;295;855443.2;281421.0;1136864.2
411770;201804;443;295;148;281410.9;141192.0;422602.9
411780;201804;370;240;130;228960.0;124020.0;352980.0
411790;201804;531;298;233;282410.47;222169.14;504579.62
411800;201804;172;135;37;128790.0;35298.0;164088.0
411810;201804;166;129;37;123066.0;35298.0;158364.0
411820;201804;2100;1027;1073;976209.44;1022918.3;1999127.8
411830;201804;12;12;0;11448.0;0.0;11448.0
411840;201804;1965;1226;739;1167409.8;704513.0;1871922.8
411845;201804;50;19;31;18126.0;29574.0;47700.0
411850;201804;1242;711;531;676739.94;504621.03;1181361.0
411860;201804;44;28;16;26426.0;15264.0;41690.0
411870;201804;74;53;21;50562.0;19747.8;70309.8
411880;201804;427;274;153;261282.0;145217.88;406499.88
411885;201804;104;69;35;65826.0;33390.0;99216.0
411890;201804;321;205;116;194330.45;110654.46;304984.9
411900;201804;68;50;18;47700.0;17172.0;64872.0
411910;201804;171;140;31;133550.45;28734.48;162284.94
411915;201804;2112;904;1208;861263.56;1151368.0;2012631.6
411920;201804;126;104;22;99216.0;20988.0;120204.0
411925;201804;13;9;4;8586.0;3816.0;12402.0
411930;201804;795;586;209;557138.0;199386.0;756524.0
411940;201804;589;421;168;401157.0;160247.56;561404.56
411950;201804;901;480;421;457252.2;400966.2;858218.4
411960;201804;977;692;285;656788.5;271890.0;928678.5
411965;201804;23;15;8;14310.0;7632.0;21942.0
411970;201804;72;65;7;62010.0;6678.0;68688.0
411980;201804;199;129;70;123066.0;66780.0;189846.0
411990;201804;4982;2887;2095;2736617.5;1996856.8;4733474.0
411995;201804;461;173;288;165042.0;274752.0;439794.0
412000;201804;295;175;120;165968.19;114470.46;280438.62
412010;201804;45;28;17;26712.0;16218.0;42930.0
412015;201804;44;31;13;29574.0;12402.0;41976.0
412020;201804;27;24;3;22609.8;2862.0;25471.8
412030;201804;60;51;9;48654.0;8586.0;57240.0
412033;201804;55;36;19;34320.0;18126.0;52446.0
412035;201804;67;42;25;40068.0;23850.0;63918.0
412040;201804;36;25;11;23564.0;10494.0;34058.0
412050;201804;202;152;50;145008.0;47700.0;192708.0
412060;201804;748;585;163;555228.75;154511.8;709740.56
412065;201804;51;35;16;33390.0;15264.0;48654.0
412070;201804;154;103;51;97594.2;48654.0;146248.2
412080;201804;282;146;136;139284.0;129744.0;269028.0
412085;201804;34;17;17;16218.0;16218.0;32436.0
412090;201804;744;468;276;444803.2;263304.0;708107.2
412100;201804;251;210;41;199387.0;39114.0;238501.0
412110;201804;71;57;14;54378.0;13181.08;67559.08
412120;201804;310;203;107;193089.6;102078.0;295167.6
412125;201804;78;46;32;43597.8;30528.0;74125.8
412130;201804;46;35;11;33390.0;10494.0;43884.0
412135;201804;28;15;13;14310.0;12402.0;26712.0
412140;201804;311;221;90;210194.81;85860.0;296054.8
412150;201804;260;176;84;166950.05;80136.0;247086.05
412160;201804;85;49;36;46746.0;34344.0;81090.0
412170;201804;648;456;192;434737.8;183168.0;617905.8
412175;201804;40;29;11;27666.0;10494.0;38160.0
412180;201804;197;157;40;149178.61;37539.9;186718.52
412190;201804;334;266;68;253091.44;64872.0;317963.44
412200;201804;193;122;71;116388.0;67734.0;184122.0
412210;201804;73;56;17;53424.0;16218.0;69642.0
412215;201804;242;166;76;158078.0;72217.8;230295.8
412217;201804;69;53;16;50562.0;15264.0;65826.0
412220;201804;828;619;209;590526.0;199386.0;789912.0
412230;201804;340;206;134;194902.2;127799.46;322701.66
412240;201804;1325;650;675;617199.2;641869.44;1259068.6
412250;201804;383;249;134;237546.0;127836.0;365382.0
412260;201804;127;94;33;89676.0;31482.0;121158.0
412265;201804;168;134;34;127231.84;32436.0;159667.84
412270;201804;84;53;31;50562.0;29574.0;80136.0
412280;201804;91;72;19;68688.0;18126.0;86814.0
412290;201804;96;65;31;62010.0;29574.0;91584.0
412300;201804;215;138;77;131652.0;73314.9;204966.9
412310;201804;43;36;7;34344.0;6678.0;41022.0
412320;201804;94;80;14;76320.0;13356.0;89676.0
412330;201804;169;151;18;144054.0;17172.0;161226.0
412340;201804;144;100;44;95400.0;41690.0;137090.0
412350;201804;605;308;297;292520.3;283338.0;575858.3
412360;201804;27;24;3;22896.0;2862.0;25758.0
412370;201804;160;137;23;129744.0;21942.0;151686.0
412380;201804;253;192;61;182881.8;58090.0;240971.8
412382;201804;50;26;24;24804.0;22896.0;47700.0
412385;201804;141;102;39;97308.0;37206.0;134514.0
412390;201804;277;209;68;199386.0;64872.0;264258.0
412395;201804;66;52;14;49608.0;13356.0;62964.0
412400;201804;69;50;19;47700.0;18126.0;65826.0
412402;201804;250;118;132;112567.23;125641.8;238209.03
412405;201804;820;328;492;310218.1;468682.66;778900.75
412410;201804;938;589;349;559807.6;332946.0;892753.6
412420;201804;15;12;3;11448.0;2862.0;14310.0
412430;201804;21;14;7;13356.0;6678.0;20034.0
412440;201804;595;323;272;305829.94;257623.95;563453.9
412450;201804;80;68;12;64872.0;11448.0;76320.0
412460;201804;81;64;17;61056.0;16218.0;77274.0
412470;201804;260;206;54;195760.8;51516.0;247276.8
412480;201804;173;132;41;124974.9;39114.0;164088.9
412490;201804;168;142;26;135468.0;24804.0;160272.0
412500;201804;475;387;88;367485.8;83952.0;451437.8
412510;201804;186;152;34;144261.0;32436.0;176697.0
412520;201804;136;74;62;70596.0;59148.0;129744.0
412530;201804;108;58;50;55332.0;47413.8;102745.8
412535;201804;106;78;28;74394.0;26712.0;101106.0
412540;201804;67;33;34;31482.0;32436.0;63918.0
412545;201804;99;72;27;68688.0;25758.0;94446.0
412550;201804;3528;1594;1934;1514914.8;1842652.9;3357567.8
412555;201804;14;9;5;8586.0;4770.0;13356.0
412560;201804;591;441;150;418124.2;143100.0;561224.2
412570;201804;734;411;323;390243.25;307856.0;698099.25
412575;201804;81;56;25;53424.0;23850.0;77274.0
412580;201804;158;107;51;102078.0;48654.0;150732.0
412590;201804;34;32;2;30528.0;1908.0;32436.0
412600;201804;175;133;42;126882.0;40068.0;166950.0
412610;201804;30;18;12;17172.0;11448.0;28620.0
412620;201804;148;130;18;124020.0;17172.0;141192.0
412625;201804;2202;1182;1020;1124826.2;971202.56;2096028.8
412627;201804;68;54;14;51516.0;13356.0;64872.0
412630;201804;428;288;140;273219.2;133274.0;406493.2
412635;201804;66;20;46;19080.0;43884.0;62964.0
412640;201804;120;80;40;76320.0;38160.0;114480.0
412650;201804;341;212;129;201961.8;123061.23;325023.03
412660;201804;484;295;189;280715.0;180306.0;461021.0
412665;201804;52;46;6;43884.0;5724.0;49608.0
412667;201804;283;193;90;183327.55;85593.8;268921.34
412670;201804;61;52;9;49608.0;8586.0;58194.0
412680;201804;292;230;62;219420.0;59148.0;278568.0
412690;201804;114;73;41;69642.0;38828.0;108470.0
412700;201804;163;111;52;105894.0;49322.0;155216.0
412710;201804;1409;873;536;826834.6;509282.66;1336117.2
412720;201804;228;158;70;150732.0;66780.0;217512.0
412730;201804;201;160;41;152640.0;38160.0;190800.0
412740;201804;419;226;193;215460.9;184122.0;399582.9
412750;201804;466;270;196;256626.0;186984.0;443610.0
412760;201804;260;134;126;127836.0;120204.0;248040.0
412770;201804;2115;1201;914;1141371.0;870126.0;2011497.0
412780;201804;154;123;31;117342.0;29574.0;146916.0
412785;201804;275;139;136;132129.0;129744.0;261873.0
412788;201804;35;21;14;20034.0;13356.0;33390.0
412790;201804;142;116;26;109996.2;24804.0;134800.2
412795;201804;154;115;39;109710.0;37206.0;146916.0
412796;201804;300;209;91;198221.19;86680.44;284901.62
412800;201804;561;369;192;351466.38;183168.0;534634.4
412810;201804;3013;1670;1343;1587629.2;1279977.0;2867606.2
412820;201804;925;606;319;567688.9;302466.1;870154.94
412830;201804;15;12;3;11448.0;2862.0;14310.0
412840;201804;220;157;63;148824.2;60102.0;208926.2
412850;201804;785;535;250;508282.97;238500.0;746782.94
412853;201804;170;90;80;85860.0;76320.0;162180.0
412855;201804;214;117;97;110506.82;92538.0;203044.81
412860;201804;92;68;24;64872.0;22896.0;87768.0
412862;201804;59;44;15;41689.8;14310.0;55999.8
412863;201804;6;5;1;4770.0;954.0;5724.0
412865;201804;42;31;11;29574.0;10494.0;40068.0
412870;201804;108;71;37;67734.0;35298.0;103032.0
412880;201804;103;77;26;73458.0;24804.0;98262.0
420005;201804;37;33;4;31482.0;3244.0;34726.0
420010;201804;366;238;128;225864.34;122112.0;347976.34
420020;201804;75;64;11;61056.0;10494.0;71550.0
420030;201804;29;26;3;24804.0;2862.0;27666.0
420040;201804;105;80;25;76320.0;23850.0;100170.0
420050;201804;56;34;22;32436.0;20988.0;53424.0
420055;201804;20;19;1;18126.0;954.0;19080.0
420060;201804;32;23;9;21942.0;8586.0;30528.0
420070;201804;103;88;15;83952.0;14300.46;98252.46
420075;201804;14;12;2;11448.0;1908.0;13356.0
420080;201804;48;42;6;38398.5;5724.0;44122.5
420090;201804;35;33;2;30704.49;1908.0;32612.49
420100;201804;160;133;27;125928.2;25758.0;151686.2
420110;201804;20;20;0;19080.0;0.0;19080.0
420120;201804;47;36;11;34344.0;10494.0;44838.0
420125;201804;85;68;17;64872.0;16218.0;81090.0
420127;201804;35;31;4;29574.0;3816.0;33390.0
420130;201804;389;248;141;236296.45;134265.95;370562.4
420140;201804;1284;744;540;708451.4;515094.0;1223545.4
420150;201804;46;40;6;38160.0;5724.0;43884.0
420160;201804;38;36;2;34344.0;1908.0;36252.0
420165;201804;19;14;5;13356.0;4770.0;18126.0
420170;201804;63;41;22;39114.0;20988.0;60102.0
420180;201804;22;21;1;20034.0;954.0;20988.0
420190;201804;31;28;3;26712.0;2862.0;29574.0
420195;201804;127;60;67;57240.0;63918.0;121158.0
420200;201804;1276;568;708;537865.6;674088.75;1211954.4
420205;201804;68;36;32;34344.0;30528.0;64872.0
420207;201804;106;61;45;58194.0;42920.46;101114.46
420208;201804;24;19;5;18126.0;3911.4;22037.4
420209;201804;20;16;4;15264.0;3816.0;19080.0
420210;201804;466;222;244;211501.8;232681.14;444182.94
420213;201804;45;36;9;34344.0;8586.0;42930.0
420215;201804;26;22;4;20988.0;3816.0;24804.0
420220;201804;68;43;25;41022.0;23850.0;64872.0
420230;201804;756;431;325;410411.0;310024.47;720435.44
420240;201804;2296;1548;748;1469224.1;713153.2;2182377.2
420243;201804;37;30;7;28620.0;6678.0;35298.0
420245;201804;109;64;45;61056.0;42930.0;103986.0
420250;201804;54;31;23;29574.0;21942.0;51516.0
420253;201804;40;32;8;30528.0;7632.0;38160.0
420257;201804;11;9;2;8586.0;1908.0;10494.0
420260;201804;98;86;12;82044.0;11448.0;93492.0
420270;201804;37;30;7;28616.0;6678.0;35294.0
420280;201804;281;205;76;193846.06;71246.1;265092.16
420285;201804;19;12;7;11448.0;6678.0;18126.0
420287;201804;50;31;19;29574.0;18126.0;47700.0
420290;201804;966;678;288;644776.75;274684.3;919461.0
420300;201804;1382;1091;291;1036236.4;275134.12;1311370.5
420310;201804;60;46;14;43884.0;13356.0;57240.0
420315;201804;34;30;4;28620.0;3816.0;32436.0
420320;201804;851;432;419;411150.16;399722.0;810872.1
420325;201804;0;0;0;0.0;0.0;0.0
420330;201804;120;82;38;78228.0;36137.52;114365.52
420340;201804;157;107;50;101116.0;47680.92;148796.92
420350;201804;246;181;65;171053.0;62010.0;233063.0
420360;201804;758;578;180;549486.2;170099.78;719585.94
420370;201804;109;71;38;67544.0;35966.0;103510.0
420380;201804;1141;819;322;777502.5;306151.03;1083653.5
420390;201804;255;163;92;154243.52;87052.5;241296.02
420395;201804;187;134;53;127072.8;49789.26;176862.06
420400;201804;248;184;64;174964.0;61056.0;236020.0
420410;201804;61;48;13;45792.0;12402.0;58194.0
420415;201804;35;32;3;30528.0;2862.0;33390.0
420417;201804;47;35;12;33390.0;11428.92;44818.92
420419;201804;12;12;0;11448.0;0.0;11448.0
420420;201804;2796;1716;1080;1624719.0;1027847.44;2652566.5
420425;201804;71;60;11;57231.0;10180.26;67411.26
420430;201804;1283;893;390;848501.44;370314.2;1218815.6
420435;201804;16;14;2;13356.0;1908.0;15264.0
420440;201804;111;76;35;71876.68;33238.6;105115.28
420445;201804;23;20;3;19080.0;2862.0;21942.0
420450;201804;79;38;41;36243.0;39114.0;75357.0
420455;201804;254;193;61;184093.92;58102.38;242196.3
420460;201804;2350;1571;779;1494050.1;742932.9;2236983.0
420470;201804;121;86;35;82044.0;33390.0;115434.0
420475;201804;6;6;0;5724.0;0.0;5724.0
420480;201804;859;639;220;604150.1;208831.2;812981.3
420490;201804;112;88;24;83952.0;22896.0;106848.0
420500;201804;673;290;383;274689.2;365382.0;640071.2
420510;201804;19;16;3;15264.0;2862.0;18126.0
420515;201804;26;20;6;19080.0;5724.0;24804.0
420517;201804;12;12;0;11448.0;0.0;11448.0
420519;201804;0;0;0;0.0;0.0;0.0
420520;201804;67;50;17;47700.0;16218.0;63918.0
420530;201804;163;111;52;104919.02;49608.0;154527.02
420535;201804;20;18;2;17172.0;1908.0;19080.0
420540;201804;4888;2886;2002;2740892.2;1905273.0;4646165.5
420543;201804;23;23;0;21942.0;0.0;21942.0
420545;201804;195;139;56;131175.0;53404.92;184579.92
420550;201804;851;684;167;650591.3;159160.73;809752.06
420555;201804;41;29;12;27666.0;11448.0;39114.0
420560;201804;64;51;13;48272.4;12402.0;60674.4
420570;201804;145;82;63;78228.0;60092.46;138320.45
420580;201804;296;131;165;124974.0;157124.0;282098.0
420590;201804;515;365;150;347923.8;142718.4;490642.2
420600;201804;94;49;45;46746.0;42930.0;89676.0
420610;201804;37;35;2;33104.0;1908.0;35012.0
420620;201804;74;60;14;57240.0;13356.0;70596.0
420630;201804;154;112;42;106839.23;40064.0;146903.23
420640;201804;93;83;10;78991.2;9540.0;88531.2
420650;201804;243;130;113;123352.2;107183.23;230535.44
420660;201804;53;41;12;38350.8;11448.0;49798.8
420665;201804;37;28;9;26426.0;8586.0;35012.0
420670;201804;321;242;79;230142.95;75347.46;305490.4
420675;201804;15;14;1;13356.0;954.0;14310.0
420680;201804;36;26;10;24804.0;9540.0;34344.0
420690;201804;176;147;29;140238.0;27666.0;167904.0
420700;201804;643;441;202;420621.84;192446.81;613068.7
420710;201804;148;86;62;82044.0;58861.8;140905.8
420720;201804;108;86;22;82044.0;20988.0;103032.0
420730;201804;540;347;193;329980.5;182827.12;512807.62
420740;201804;46;45;1;42930.0;954.0;43884.0
420750;201804;500;336;164;320257.8;156456.0;476713.8
420757;201804;19;16;3;14453.1;2862.0;17315.1
420760;201804;40;31;9;29574.0;8586.0;38160.0
420765;201804;71;58;13;55332.0;12402.0;67734.0
420768;201804;66;59;7;56286.0;6678.0;62964.0
420770;201804;84;70;14;66780.0;13356.0;80136.0
420775;201804;48;45;3;41976.0;2862.0;44838.0
420780;201804;238;186;52;177434.45;49608.0;227042.45
420785;201804;14;10;4;9540.0;3816.0;13356.0
420790;201804;178;149;29;141805.8;26684.46;168490.27
420800;201804;77;58;19;54568.8;18126.0;72694.8
420810;201804;251;216;35;206055.0;32579.1;238634.1
420820;201804;2321;1383;938;1313028.6;893126.8;2206155.5
420830;201804;576;323;253;305171.94;240398.45;545570.44
420840;201804;148;112;36;106848.0;33640.0;140488.0
420845;201804;450;198;252;188221.06;239168.0;427389.06
420850;201804;233;186;47;177444.0;44838.0;222282.0
420860;201804;62;53;9;50562.0;8586.0;59148.0
420870;201804;119;86;33;82044.0;31482.0;113526.0
420880;201804;172;121;51;114756.66;48654.0;163410.66
420890;201804;861;424;437;401407.84;416317.0;817724.8
420895;201804;10;10;0;9540.0;0.0;9540.0
420900;201804;423;331;92;313715.03;87739.92;401454.97
420910;201804;5830;3278;2552;3116433.2;2429625.8;5546059.0
420915;201804;79;72;7;68688.0;6678.0;75366.0
420917;201804;19;14;5;13356.0;4770.0;18126.0
420920;201804;24;17;7;16218.0;6678.0;22896.0
420930;201804;2641;1613;1028;1531336.8;974849.9;2506186.5
420940;201804;610;446;164;424139.6;154804.08;578943.7
420945;201804;8;6;2;5724.0;1908.0;7632.0
420950;201804;55;50;5;47700.0;4770.0;52470.0
420960;201804;113;88;25;83914.92;23841.0;107755.92
420970;201804;305;244;61;231100.84;58166.46;289267.3
420980;201804;24;23;1;21942.0;954.0;22896.0
420985;201804;65;57;8;54378.0;7632.0;62010.0
420990;201804;69;54;15;51516.0;14310.0;65826.0
421000;201804;34;22;12;20988.0;11448.0;32436.0
421003;201804;68;44;24;41976.0;22887.0;64863.0
421005;201804;8;5;3;4770.0;2862.0;7632.0
421010;201804;769;541;228;514865.0;215452.0;730317.0
421020;201804;30;25;5;23850.0;4770.0;28620.0
421030;201804;131;111;20;105561.0;19080.0;124641.0
421040;201804;71;60;11;57240.0;10494.0;67734.0
421050;201804;318;230;88;217321.2;83952.0;301273.2
421055;201804;24;20;4;19080.0;3816.0;22896.0
421060;201804;82;56;26;53424.0;24804.0;78228.0
421070;201804;53;48;5;45792.0;4770.0;50562.0
421080;201804;36;32;4;30528.0;3816.0;34344.0
421085;201804;25;20;5;19080.0;4770.0;23850.0
421090;201804;42;31;11;29574.0;10494.0;40068.0
421100;201804;129;95;34;90630.0;32436.0;123066.0
421105;201804;219;178;41;169382.8;39090.69;208473.48
421110;201804;109;89;20;84285.9;19080.0;103365.9
421120;201804;150;117;33;111122.46;31462.92;142585.38
421125;201804;14;10;4;9540.0;3816.0;13356.0
421130;201804;810;523;287;497812.06;272758.53;770570.56
421140;201804;31;22;9;20272.5;8586.0;28858.5
421145;201804;40;31;9;29574.0;8586.0;38160.0
421150;201804;108;78;30;74412.0;28620.0;103032.0
421160;201804;61;40;21;38150.46;20034.0;58184.46
421165;201804;18;17;1;16218.0;954.0;17172.0
421170;201804;194;168;26;159244.84;24795.0;184039.84
421175;201804;150;98;52;93492.0;49569.92;143061.92
421180;201804;56;35;21;33028.0;20034.0;53062.0
421185;201804;17;14;3;13356.0;2862.0;16218.0
421187;201804;0;0;0;0.0;0.0;0.0
421189;201804;38;30;8;28620.0;7622.46;36242.46
421190;201804;1519;938;581;893889.44;553577.56;1447467.0
421200;201804;88;66;22;62010.7;20988.0;82998.7
421205;201804;24;16;8;15264.0;7622.46;22886.46
421210;201804;182;123;59;117342.0;56286.0;173628.0
421220;201804;275;219;56;208059.9;53424.0;261483.9
421223;201804;55;46;9;43407.0;8586.0;51993.0
421225;201804;60;41;19;39114.0;18126.0;57240.0
421227;201804;94;71;23;67734.0;21942.0;89676.0
421230;201804;48;35;13;33390.0;12402.0;45792.0
421240;201804;18;18;0;17172.0;0.0;17172.0
421250;201804;357;222;135;210454.0;127998.18;338452.2
421260;201804;27;22;5;20988.0;4770.0;25758.0
421265;201804;0;0;0;0.0;0.0;0.0
421270;201804;53;47;6;44838.0;5724.0;50562.0
421280;201804;334;189;145;180020.0;136612.8;316632.8
421290;201804;325;213;112;202964.0;105437.76;308401.75
421300;201804;25;20;5;19080.0;4770.0;23850.0
421310;201804;54;41;13;39114.0;12402.0;51516.0
421315;201804;29;20;9;19080.0;8586.0;27666.0
421320;201804;132;93;39;88722.0;37206.0;125928.0
421330;201804;111;85;26;78726.07;24795.0;103521.07
421335;201804;40;26;14;24804.0;13356.0;38160.0
421340;201804;292;199;93;188082.05;88722.0;276804.06
421350;201804;176;104;72;98773.0;68688.0;167461.0
421360;201804;691;506;185;477081.2;175709.06;652790.25
421370;201804;197;151;46;144054.0;43550.1;187604.1
421380;201804;130;105;25;100165.23;23850.0;124015.23
421390;201804;17;13;4;12402.0;3816.0;16218.0
421400;201804;113;95;18;90630.0;17172.0;107802.0
421410;201804;24;19;5;18126.0;4770.0;22896.0
421415;201804;22;21;1;20034.0;954.0;20988.0
421420;201804;149;122;27;115815.6;25471.8;141287.4
421430;201804;15;12;3;11448.0;2862.0;14310.0
421440;201804;56;43;13;41022.0;12402.0;53424.0
421450;201804;98;85;13;81090.0;12402.0;93492.0
421460;201804;59;50;9;46895.77;8586.0;55481.77
421470;201804;69;45;24;42930.0;22896.0;65826.0
421480;201804;640;475;165;452387.0;157401.0;609788.0
421490;201804;22;21;1;19358.0;954.0;20312.0
421500;201804;517;332;185;314925.2;176202.9;491128.1
421505;201804;24;18;6;17172.0;5724.0;22896.0
421507;201804;33;27;6;25758.0;5724.0;31482.0
421510;201804;72;46;26;43884.0;24804.0;68688.0
421520;201804;66;57;9;53615.0;8586.0;62201.0
421530;201804;53;49;4;46746.0;3816.0;50562.0
421535;201804;28;27;1;25491.0;954.0;26445.0
421540;201804;59;51;8;48654.0;7632.0;56286.0
421545;201804;96;74;22;70110.0;20988.0;91098.0
421550;201804;287;209;78;198719.0;74412.0;273131.0
421555;201804;27;22;5;20988.0;4675.0;25663.0
421560;201804;8;7;1;6678.0;954.0;7632.0
421565;201804;125;92;33;87768.0;31482.0;119250.0
421567;201804;30;25;5;23850.0;4770.0;28620.0
421568;201804;33;31;2;29574.0;1908.0;31482.0
421569;201804;8;8;0;7632.0;0.0;7632.0
421570;201804;145;99;46;94446.0;43884.0;138330.0
421575;201804;26;21;5;19771.65;4770.0;24541.65
421580;201804;720;430;290;408599.0;275706.34;684305.3
421590;201804;21;20;1;19080.0;954.0;20034.0
421600;201804;107;73;34;69642.0;31197.0;100839.0
421605;201804;102;72;30;68355.0;28620.0;96975.0
421610;201804;188;149;39;141192.5;37206.0;178398.5
421620;201804;1105;662;443;629048.94;422602.9;1051651.9
421625;201804;23;20;3;19080.0;2862.0;21942.0
421630;201804;281;181;100;171863.8;94542.0;266405.8
421635;201804;16;8;8;7632.0;7632.0;15264.0
421640;201804;101;87;14;82998.0;13356.0;96354.0
421650;201804;279;164;115;156436.92;109690.92;266127.84
421660;201804;2099;1259;840;1198169.2;801046.25;1999215.5
421670;201804;186;131;55;124974.0;52470.0;177444.0
421680;201804;168;153;15;145962.0;14301.0;160263.0
421690;201804;359;247;112;234657.0;105884.58;340541.6
421700;201804;59;37;22;35298.0;20130.0;55428.0
421710;201804;24;24;0;22896.0;0.0;22896.0
421715;201804;10;9;1;8586.0;954.0;9540.0
421720;201804;585;424;161;401879.4;151867.27;553746.7
421725;201804;14;7;7;6678.0;6678.0;13356.0
421730;201804;40;28;12;26004.12;11448.0;37452.12
421740;201804;86;41;45;39114.0;42930.0;82044.0
421750;201804;221;164;57;154010.52;54378.0;208388.52
421755;201804;24;23;1;21942.0;954.0;22896.0
421760;201804;102;73;29;69632.46;27666.0;97298.46
421770;201804;569;384;185;364138.38;176415.3;540553.7
421775;201804;29;20;9;19080.0;8586.0;27666.0
421780;201804;196;155;41;147870.0;39114.0;186984.0
421790;201804;156;131;25;124081.5;23850.0;147931.5
421795;201804;16;13;3;12402.0;2862.0;15264.0
421800;201804;468;302;166;287311.3;158364.0;445675.3
421810;201804;67;54;13;51516.0;12402.0;63918.0
421820;201804;309;212;97;201580.2;92538.0;294118.2
421825;201804;126;105;21;100170.0;20034.0;120204.0
421830;201804;128;97;31;92538.0;29574.0;122112.0
421835;201804;3;3;0;2862.0;0.0;2862.0
421840;201804;60;50;10;47691.0;9540.0;57231.0
421850;201804;76;66;10;62964.0;9536.0;72500.0
421860;201804;41;32;9;30528.0;8586.0;39114.0
421870;201804;981;745;236;701851.7;224335.42;926187.1
421875;201804;53;47;6;44838.0;5724.0;50562.0
421880;201804;162;119;43;113526.0;40736.0;154262.0
421885;201804;27;22;5;20988.0;4770.0;25758.0
421890;201804;111;78;33;74412.0;31482.0;105894.0
421895;201804;40;37;3;35298.0;2862.0;38160.0
421900;201804;151;124;27;117935.1;25722.0;143657.1
421910;201804;65;43;22;41022.0;20988.0;62010.0
421915;201804;33;27;6;25758.0;5724.0;31482.0
421917;201804;39;29;10;27666.0;9540.0;37206.0
421920;201804;33;30;3;28620.0;2862.0;31482.0
421930;201804;746;577;169;548417.25;161199.0;709616.25
421935;201804;57;50;7;47700.0;6678.0;54378.0
421940;201804;39;37;2;35298.0;1908.0;37206.0
421950;201804;825;542;283;510364.3;267486.3;777850.6
421960;201804;40;35;5;33104.0;4770.0;37874.0
421970;201804;374;233;141;221783.12;134483.12;356266.25
421985;201804;31;20;11;19080.0;10494.0;29574.0
422000;201804;0;0;0;0.0;0.0;0.0
430003;201804;207;49;158;46030.5;150732.0;196762.5
430005;201804;36;28;8;26712.0;7632.0;34344.0
430010;201804;276;194;82;184599.0;78228.0;262827.0
430020;201804;151;98;53;93206.0;49608.0;142814.0
430030;201804;130;102;28;97021.8;26712.0;123733.8
430040;201804;2979;1731;1248;1643206.0;1188848.4;2832054.5
430045;201804;68;58;10;55046.0;9540.0;64586.0
430047;201804;6;5;1;4770.0;954.0;5724.0
430050;201804;81;68;13;64872.0;12402.0;77274.0
430055;201804;17;14;3;13356.0;2862.0;16218.0
430057;201804;4;2;2;1908.0;1908.0;3816.0
430060;201804;3686;2204;1482;2095372.9;1409530.2;3504903.2
430063;201804;60;55;5;52470.0;4770.0;57240.0
430064;201804;148;124;24;118296.0;22896.0;141192.0
430066;201804;10;7;3;6678.0;2862.0;9540.0
430070;201804;42;32;10;30528.0;9540.0;40068.0
430080;201804;67;45;22;42230.33;20988.0;63218.33
430085;201804;35;11;24;10494.0;22896.0;33390.0
430087;201804;34;26;8;24661.0;7632.0;32293.0
430090;201804;72;65;7;61723.8;6678.0;68401.8
430100;201804;127;86;41;81090.0;39114.0;120204.0
430105;201804;143;71;72;67734.0;68382.72;136116.72
430107;201804;20;15;5;14310.0;4770.0;19080.0
430110;201804;414;240;174;228149.1;165929.22;394078.3
430120;201804;139;128;11;121158.9;10494.0;131652.9
430130;201804;799;504;295;480195.9;281143.8;761339.7
430140;201804;125;115;10;109710.0;9540.0;119250.0
430150;201804;112;73;39;68879.0;36252.0;105131.0
430155;201804;31;28;3;26712.0;2862.0;29574.0
430160;201804;3812;2253;1559;2128882.2;1483212.6;3612094.8
430163;201804;326;147;179;139189.34;170708.77;309898.1
430165;201804;24;16;8;15264.0;7632.0;22896.0
430170;201804;84;76;8;72504.0;7632.0;80136.0
430175;201804;84;66;18;62964.0;16504.2;79468.2
430180;201804;102;81;21;77274.0;19413.9;96687.9
430185;201804;32;24;8;22896.0;7632.0;30528.0
430187;201804;102;43;59;41022.0;55980.8;97002.8
430190;201804;220;123;97;117294.3;91861.46;209155.77
430192;201804;15;14;1;13356.0;954.0;14310.0
430195;201804;13;8;5;7632.0;4770.0;12402.0
430200;201804;166;148;18;140524.2;17172.0;157696.2
430205;201804;20;19;1;18126.0;954.0;19080.0
430210;201804;631;492;139;465647.4;130745.9;596393.3
430215;201804;15;11;4;10494.0;3816.0;14310.0
430220;201804;65;45;20;42930.0;19080.0;62010.0
430222;201804;13;7;6;6678.0;5724.0;12402.0
430223;201804;14;7;7;6678.0;6678.0;13356.0
430225;201804;4;3;1;2862.0;954.0;3816.0
430230;201804;300;185;115;175536.0;109710.0;285246.0
430235;201804;53;39;14;37206.0;13346.46;50552.46
430237;201804;30;22;8;20988.0;7632.0;28620.0
430240;201804;131;84;47;79945.2;44838.0;124783.2
430245;201804;72;61;11;58194.0;10494.0;68688.0
430250;201804;190;108;82;103022.46;78218.46;181240.92
430258;201804;13;11;2;10494.0;1908.0;12402.0
430260;201804;35;30;5;28620.0;4760.46;33380.46
430265;201804;34;29;5;27646.92;4770.0;32416.92
430270;201804;556;413;143;390612.53;135565.02;526177.56
430280;201804;1034;629;405;596431.25;383870.6;980301.9
430290;201804;375;219;156;207018.8;148824.0;355842.8
430300;201804;2127;1175;952;1117078.5;905148.8;2022227.2
430310;201804;1979;1044;935;988928.4;888938.9;1877867.2
430320;201804;49;41;8;39099.69;7632.0;46731.69
430330;201804;97;87;10;82521.0;9520.92;92041.92
430340;201804;65;58;7;55332.0;6678.0;62010.0
430350;201804;1677;1161;516;1096118.4;489537.44;1585655.9
430355;201804;26;23;3;21942.0;2862.0;24804.0
430360;201804;79;38;41;36252.0;38827.8;75079.8
430367;201804;27;19;8;18126.0;7632.0;25758.0
430370;201804;53;46;7;43884.0;6678.0;50562.0
430380;201804;129;98;31;92919.6;29574.0;122493.6
430390;201804;618;387;231;368864.1;220069.45;588933.56
430400;201804;139;106;33;99406.8;31462.92;130869.72
430410;201804;60;48;12;45792.0;11448.0;57240.0
430420;201804;497;325;172;307570.8;161549.2;469120.0
430430;201804;55;53;2;49926.63;1908.0;51834.63
430435;201804;156;117;39;110664.0;36490.5;147154.5
430440;201804;494;329;165;313866.0;157219.2;471085.2
430450;201804;1203;991;212;938832.1;202238.45;1141070.6
430460;201804;5081;2789;2292;2645417.8;2181330.8;4826748.5
430461;201804;17;15;2;14310.0;1908.0;16218.0
430462;201804;9;6;3;5724.0;2862.0;8586.0
430463;201804;1035;547;488;519414.9;465200.1;984615.0
430465;201804;26;15;11;14310.0;10494.0;24804.0
430466;201804;665;482;183;457920.2;174391.2;632311.4
430467;201804;101;58;43;54091.8;41012.46;95104.26
430468;201804;110;70;40;66780.0;37908.91;104688.91
430469;201804;22;17;5;16218.0;4770.0;20988.0
430470;201804;1161;641;520;604748.4;494124.3;1098872.8
430471;201804;48;36;12;34324.92;11448.0;45772.92
430480;201804;93;56;37;52565.4;35288.46;87853.86
430485;201804;6;6;0;5438.0;0.0;5438.0
430490;201804;88;70;18;65969.7;17172.0;83141.7
430495;201804;37;28;9;26712.0;8586.0;35298.0
430500;201804;195;132;63;125928.0;59726.46;185654.45
430510;201804;3103;2062;1041;1959353.2;991861.9;2951215.2
430511;201804;18;18;0;17172.0;0.0;17172.0
430512;201804;136;95;41;90630.0;39114.0;129744.0
430513;201804;52;44;8;41499.0;7632.0;49131.0
430515;201804;32;30;2;28620.0;1908.0;30528.0
430517;201804;170;150;20;142146.0;19060.92;161206.92
430520;201804;364;252;112;239741.0;106819.38;346560.38
430530;201804;88;53;35;50562.0;33390.0;83952.0
430535;201804;477;318;159;303172.44;151662.16;454834.6
430537;201804;10;10;0;9540.0;0.0;9540.0
430540;201804;71;48;23;45792.0;21942.0;67734.0
430543;201804;373;114;259;108756.0;247086.0;355842.0
430544;201804;41;38;3;36252.0;2862.0;39114.0
430545;201804;354;170;184;161684.0;175039.92;336723.9
430550;201804;44;36;8;34344.0;7632.0;41976.0
430558;201804;6;4;2;3816.0;1908.0;5724.0
430560;201804;47;20;27;19080.0;25758.0;44838.0
430570;201804;107;46;61;43884.0;58136.76;102020.76
430580;201804;123;96;27;91584.0;25710.3;117294.3
430583;201804;14;14;0;13356.0;0.0;13356.0
430585;201804;9;4;5;3816.0;4770.0;8586.0
430587;201804;14;8;6;7632.0;5724.0;13356.0
430590;201804;155;125;30;118009.8;28620.0;146629.8
430593;201804;4;4;0;3816.0;0.0;3816.0
430595;201804;17;13;4;12402.0;3816.0;16218.0
430597;201804;52;27;25;25758.0;23850.0;49608.0
430600;201804;219;155;64;147860.45;60769.8;208630.27
430605;201804;162;102;60;97308.0;57230.46;154538.45
430607;201804;27;22;5;20988.0;4770.0;25758.0
430610;201804;1643;773;870;734723.8;825935.75;1560659.6
430613;201804;2;2;0;1908.0;0.0;1908.0
430620;201804;113;82;31;78084.9;29564.46;107649.36
430630;201804;46;41;5;39114.0;4770.0;43884.0
430632;201804;32;27;5;25758.0;4770.0;30528.0
430635;201804;40;36;4;34344.0;3816.0;38160.0
430637;201804;54;30;24;28620.0;22896.0;51516.0
430640;201804;209;115;94;108279.0;89676.0;197955.0
430642;201804;27;25;2;23850.0;1908.0;25758.0
430645;201804;34;29;5;27666.0;4770.0;32436.0
430650;201804;257;206;51;196238.0;48606.3;244844.3
430655;201804;3;3;0;2862.0;0.0;2862.0
430660;201804;975;477;498;453483.9;473565.8;927049.7
430670;201804;73;51;22;48654.0;20988.0;69642.0
430673;201804;75;42;33;40068.0;31482.0;71550.0
430675;201804;13;10;3;9540.0;2862.0;12402.0
430676;201804;494;301;193;286429.03;184051.06;470480.12
430680;201804;250;175;75;164756.0;71550.0;236306.0
430690;201804;527;309;218;293899.3;206297.06;500196.38
430692;201804;7;5;2;4770.0;1908.0;6678.0
430693;201804;143;95;48;90630.0;45782.46;136412.45
430695;201804;73;65;8;61075.08;7632.0;68707.08
430697;201804;58;35;23;33390.0;21942.0;55332.0
430700;201804;1594;1117;477;1053664.4;454772.0;1508436.4
430705;201804;20;19;1;18126.0;954.0;19080.0
430710;201804;262;169;93;161226.0;88722.0;249948.0
430720;201804;108;91;17;86623.2;16218.0;102841.2
430730;201804;121;102;19;96354.0;17839.8;114193.8
430740;201804;65;43;22;41022.0;20988.0;62010.0
430745;201804;36;29;7;27380.0;6678.0;34058.0
430750;201804;341;227;114;215614.64;107802.0;323416.62
430755;201804;83;47;36;44838.0;34344.0;79182.0
430760;201804;372;225;147;211979.72;140209.92;352189.62
430770;201804;1475;763;712;725212.7;674791.25;1400004.0
430780;201804;311;200;111;189818.72;105827.76;295646.47
430781;201804;29;23;6;21942.0;5724.0;27666.0
430783;201804;51;41;10;38796.13;9540.0;48336.13
430786;201804;6;3;3;2862.0;2862.0;5724.0
430790;201804;501;323;178;306870.12;169516.45;476386.6
430800;201804;154;128;26;122092.92;24804.0;146896.92
430805;201804;41;37;4;35298.0;3816.0;39114.0
430807;201804;35;21;14;20034.0;13356.0;33390.0
430810;201804;73;47;26;44838.0;24804.0;69642.0
430820;201804;136;84;52;80136.0;48940.2;129076.2
430825;201804;12;10;2;9540.0;1908.0;11448.0
430830;201804;233;219;14;208620.92;13356.0;221976.92
430840;201804;126;86;40;82044.0;37492.2;119536.2
430843;201804;5;3;2;2862.0;1908.0;4770.0
430845;201804;68;39;29;37206.0;27666.0;64872.0
430850;201804;570;394;176;374702.6;167791.77;542494.3
430860;201804;155;99;56;93778.2;52746.66;146524.86
430865;201804;64;33;31;30814.2;29259.18;60073.38
430870;201804;81;66;15;62296.2;14310.0;76606.2
430880;201804;160;118;42;112552.92;40068.0;152620.92
430885;201804;7;6;1;5724.0;954.0;6678.0
430890;201804;337;205;132;193910.05;125928.0;319838.03
430900;201804;540;371;169;349736.4;160739.45;510475.88
430905;201804;89;37;52;35298.0;49608.0;84906.0
430910;201804;263;146;117;139284.0;110942.0;250226.0
430912;201804;3;3;0;2862.0;0.0;2862.0
430915;201804;36;28;8;26712.0;7345.8;34057.8
430920;201804;4240;2363;1877;2246823.0;1788208.9;4035031.8
430925;201804;5;4;1;3567.96;954.0;4521.96
430930;201804;2107;1252;855;1186663.8;815423.44;2002087.2
430940;201804;247;153;94;145284.66;89656.92;234941.58
430950;201804;158;128;30;122112.0;28620.0;150732.0
430955;201804;22;14;8;13356.0;7632.0;20988.0
430957;201804;18;17;1;16218.0;954.0;17172.0
430960;201804;238;160;78;150207.3;74412.0;224619.3
430965;201804;106;67;39;63918.0;37206.0;101124.0
430970;201804;79;65;14;62010.0;12402.0;74412.0
430975;201804;35;33;2;31482.0;1908.0;33390.0
430980;201804;44;26;18;24804.0;17172.0;41976.0
430990;201804;115;88;27;83952.0;25758.0;109710.0
430995;201804;114;110;4;103699.8;3816.0;107515.8
431000;201804;291;134;157;125689.2;149778.0;275467.2
431010;201804;335;201;134;190771.38;127836.0;318607.38
431020;201804;1924;1115;809;1055434.6;767674.25;1823108.9
431030;201804;43;34;9;32436.0;8586.0;41022.0
431033;201804;390;193;197;183311.2;187938.0;371249.2
431036;201804;16;9;7;8586.0;6678.0;15264.0
431040;201804;128;77;51;72504.0;48544.29;121048.29
431041;201804;36;24;12;22896.0;11448.0;34344.0
431043;201804;46;27;19;25758.0;18126.0;43884.0
431046;201804;11;6;5;5724.0;4770.0;10494.0
431050;201804;207;132;75;124401.6;70548.3;194949.9
431053;201804;75;45;30;42166.8;28620.0;70786.8
431055;201804;64;42;22;40068.0;20968.92;61036.92
431057;201804;17;17;0;16218.0;0.0;16218.0
431060;201804;1682;1060;622;1003724.7;591536.44;1595261.1
431065;201804;18;11;7;10494.0;6678.0;17172.0
431070;201804;71;66;5;62964.0;4770.0;67734.0
431075;201804;7;7;0;6678.0;0.0;6678.0
431080;201804;135;86;49;81757.8;46746.0;128503.8
431085;201804;30;27;3;25758.0;2862.0;28620.0
431087;201804;14;12;2;11448.0;1908.0;13356.0
431090;201804;54;42;12;40068.0;11448.0;51516.0
431100;201804;1237;737;500;692274.0;477000.0;1169274.0
431110;201804;243;151;92;144054.0;87758.46;231812.45
431112;201804;29;17;12;16218.0;11448.0;27666.0
431113;201804;30;20;10;19080.0;9540.0;28620.0
431115;201804;154;105;49;99533.87;46736.46;146270.33
431120;201804;617;363;254;344356.62;242239.84;586596.5
431123;201804;3;2;1;1908.0;954.0;2862.0
431125;201804;92;82;10;78228.0;9540.0;87768.0
431127;201804;7;3;4;2862.0;3816.0;6678.0
431130;201804;638;409;229;388945.8;218160.72;607106.5
431140;201804;729;493;236;466649.4;225067.69;691717.06
431142;201804;35;27;8;24546.0;7632.0;32178.0
431150;201804;207;152;55;145008.0;52460.46;197468.45
431160;201804;56;50;6;47700.0;5724.0;53424.0
431162;201804;19;14;5;13356.0;4770.0;18126.0
431164;201804;4;4;0;3816.0;0.0;3816.0
431170;201804;104;85;19;81090.0;18126.0;99216.0
431171;201804;53;29;24;27666.0;22886.46;50552.46
431173;201804;1;1;0;954.0;0.0;954.0
431175;201804;201;99;102;93206.0;97298.46;190504.45
431177;201804;76;57;19;54378.0;17439.92;71817.92
431179;201804;12;10;2;9540.0;1908.0;11448.0
431180;201804;440;265;175;252810.0;166931.45;419741.47
431190;201804;91;70;21;66780.0;20034.0;86814.0
431198;201804;72;47;25;44838.0;23850.0;68688.0
431200;201804;20;17;3;16218.0;2862.0;19080.0
431205;201804;23;23;0;21942.0;0.0;21942.0
431210;201804;89;55;34;52137.0;32436.0;84573.0
431213;201804;29;24;5;22896.0;4770.0;27666.0
431215;201804;26;23;3;21942.0;2862.0;24804.0
431217;201804;6;5;1;4770.0;954.0;5724.0
431220;201804;67;57;10;54378.0;9540.0;63918.0
431225;201804;149;98;51;93483.0;48634.92;142117.92
431230;201804;99;87;12;82998.0;11448.0;94446.0
431235;201804;7;7;0;6678.0;0.0;6678.0
431237;201804;24;15;9;14310.0;8586.0;22896.0
431238;201804;14;10;4;9254.0;3816.0;13070.0
431240;201804;996;641;355;609854.6;338154.84;948009.5
431242;201804;36;36;0;34344.0;0.0;34344.0
431244;201804;11;8;3;7632.0;2862.0;10494.0
431245;201804;59;45;14;42930.0;13356.0;56286.0
431247;201804;13;11;2;10494.0;1908.0;12402.0
431250;201804;269;138;131;131585.22;124954.92;256540.14
431260;201804;60;43;17;41022.0;16218.0;57240.0
431261;201804;21;14;7;13356.0;6678.0;20034.0
431262;201804;15;15;0;14310.0;0.0;14310.0
431265;201804;164;88;76;83952.0;72504.0;156456.0
431267;201804;13;12;1;11448.0;954.0;12402.0
431270;201804;316;265;51;252810.0;48654.0;301464.0
431275;201804;40;38;2;36252.0;1908.0;38160.0
431280;201804;20;16;4;14429.25;3816.0;18245.25
431290;201804;21;18;3;17172.0;2862.0;20034.0
431295;201804;5;5;0;4770.0;0.0;4770.0
431300;201804;20;17;3;16218.0;2862.0;19080.0
431301;201804;7;7;0;6678.0;0.0;6678.0
431303;201804;52;35;17;33265.98;15931.8;49197.78
431306;201804;225;117;108;111161.98;103032.0;214193.98
431308;201804;7;5;2;4770.0;1908.0;6678.0
431310;201804;64;55;9;52470.0;8586.0;61056.0
431320;201804;117;68;49;64872.0;46450.26;111322.26
431330;201804;178;116;62;110664.0;59148.0;169812.0
431333;201804;33;27;6;25758.0;5724.0;31482.0
431335;201804;10;5;5;4770.0;4770.0;9540.0
431337;201804;326;152;174;144149.58;164956.34;309105.9
431339;201804;20;17;3;16218.0;2862.0;19080.0
431340;201804;3042;1757;1285;1671662.4;1223087.9;2894750.2
431342;201804;43;26;17;24804.0;16218.0;41022.0
431344;201804;18;17;1;16218.0;954.0;17172.0
431346;201804;4;4;0;3816.0;0.0;3816.0
431349;201804;35;32;3;30528.0;2862.0;33390.0
431350;201804;910;532;378;502979.66;358952.03;861931.7
431360;201804;44;38;6;36252.0;5724.0;41976.0
431365;201804;318;152;166;144988.92;157400.45;302389.38
431370;201804;1333;789;544;749071.94;518455.1;1267527.0
431380;201804;97;84;13;80136.0;12402.0;92538.0
431390;201804;494;275;219;261319.88;208382.22;469702.1
431395;201804;283;123;160;117342.0;152621.0;269963.0
431400;201804;40;30;10;28620.0;9540.0;38160.0
431402;201804;97;66;31;62964.0;29574.0;92538.0
431403;201804;19;11;8;10494.0;7632.0;18126.0
431405;201804;646;348;298;330352.03;283979.0;614331.0
431406;201804;32;28;4;26712.0;3816.0;30528.0
431407;201804;50;40;10;38160.0;9540.0;47700.0
431410;201804;3271;1955;1316;1851732.2;1250822.8;3102555.0
431413;201804;16;13;3;12402.0;2862.0;15264.0
431415;201804;71;52;19;49608.0;18126.0;67734.0
431417;201804;23;12;11;11448.0;10494.0;21942.0
431420;201804;305;215;90;204426.27;85860.0;290286.25
431430;201804;44;17;27;16218.0;25758.0;41976.0
431440;201804;8997;6406;2591;6040374.0;2463959.0;8504333.0
431442;201804;27;14;13;13356.0;12402.0;25758.0
431445;201804;27;21;6;20034.0;5724.0;25758.0
431446;201804;7;6;1;5724.0;954.0;6678.0
431447;201804;85;60;25;57240.0;23850.0;81090.0
431449;201804;51;45;6;42930.0;5724.0;48654.0
431450;201804;412;284;128;269886.6;121396.5;391283.1
431454;201804;0;0;0;0.0;0.0;0.0
431455;201804;50;40;10;38160.0;9540.0;47700.0
431460;201804;531;366;165;347112.9;157123.8;504236.7
431470;201804;116;91;25;86122.54;23600.0;109722.54
431475;201804;11;10;1;9540.0;954.0;10494.0
431477;201804;37;25;12;23850.0;11448.0;35298.0
431478;201804;8;7;1;6678.0;954.0;7632.0
431480;201804;503;319;184;302780.53;175488.3;478268.8
431490;201804;28210;16038;12172;1,52E+14;1,16E+14;2,68E+14
431500;201804;79;53;26;50562.0;24804.0;75366.0
431505;201804;38;22;16;20988.0;15264.0;36252.0
431507;201804;12;10;2;9540.0;1908.0;11448.0
431510;201804;276;183;93;174153.0;87748.92;261901.92
431513;201804;23;18;5;17172.0;4770.0;21942.0
431514;201804;8;7;1;6678.0;954.0;7632.0
431515;201804;80;67;13;63918.0;12402.0;76320.0
431517;201804;3;2;1;1908.0;954.0;2862.0
431520;201804;38;34;4;32436.0;3816.0;36252.0
431530;201804;1599;713;886;679152.8;844820.06;1523972.9
431531;201804;23;21;2;20034.0;1908.0;21942.0
431532;201804;25;17;8;16218.0;7632.0;23850.0
431535;201804;25;16;9;15264.0;8586.0;23850.0
431540;201804;140;125;15;118229.22;14310.0;132539.22
431545;201804;17;15;2;14310.0;1908.0;16218.0
431550;201804;350;202;148;192708.0;141096.6;333804.6
431555;201804;12;11;1;10494.0;954.0;11448.0
431560;201804;4527;3195;1332;3016680.5;1268363.0;4285043.5
431570;201804;794;423;371;400394.2;351063.47;751457.7
431575;201804;36;25;11;23850.0;10494.0;34344.0
431580;201804;96;67;29;62964.0;27666.0;90630.0
431590;201804;139;116;23;109710.0;21942.0;131652.0
431595;201804;12;11;1;10494.0;954.0;11448.0
431600;201804;219;126;93;120204.0;88722.0;208926.0
431610;201804;128;93;35;88054.2;33390.0;121444.2
431620;201804;42;34;8;32436.0;7632.0;40068.0
431630;201804;139;117;22;111618.0;20988.0;132606.0
431640;201804;1353;839;514;794181.5;487829.12;1282010.6
431642;201804;39;36;3;33867.0;2862.0;36729.0
431643;201804;45;20;25;19080.0;23850.0;42930.0
431645;201804;300;173;127;165042.0;120871.8;285913.8
431647;201804;10;10;0;9540.0;0.0;9540.0
431650;201804;36;27;9;25758.0;8586.0;34344.0
431660;201804;282;183;99;172674.0;94446.0;267120.0
431670;201804;220;105;115;97546.5;109681.38;207227.88
431673;201804;3;3;0;2862.0;0.0;2862.0
431675;201804;31;26;5;24517.8;4770.0;29287.8
431680;201804;1099;785;314;744978.6;298459.44;1043438.06
431690;201804;4803;2929;1874;2773023.5;1783877.8;4556901.5
431695;201804;26;20;6;19080.0;5724.0;24804.0
431697;201804;0;0;0;0.0;0.0;0.0
431700;201804;171;132;39;125928.0;37206.0;163134.0
431710;201804;4015;1727;2288;1644878.0;2182253.0;3827131.0
431720;201804;1392;828;564;781972.25;536802.25;1318774.5
431725;201804;1;1;0;954.0;0.0;954.0
431730;201804;1193;811;382;766999.1;364428.0;1131427.1
431740;201804;1366;680;686;643816.5;653893.56;1297710.1
431750;201804;1877;1216;661;1149787.5;628657.94;1778445.4
431755;201804;6;5;1;4770.0;954.0;5724.0
431760;201804;1082;692;390;659786.4;371831.6;1031618.0
431770;201804;396;289;107;275696.47;102058.92;377755.38
431775;201804;29;22;7;20988.0;6678.0;27666.0
431780;201804;562;348;214;330875.8;204146.45;535022.25
431790;201804;152;114;38;107802.0;36204.3;144006.3
431795;201804;14;12;2;11448.0;1908.0;13356.0
431800;201804;3377;1774;1603;1679506.0;1522962.9;3202469.0
431805;201804;16;15;1;14310.0;954.0;15264.0
431810;201804;619;415;204;393276.97;194482.98;587759.94
431820;201804;311;175;136;166950.0;128742.3;295692.3
431830;201804;2334;1412;922;1343708.4;878327.6;2222036.0
431840;201804;516;343;173;323598.4;163802.0;487400.4
431842;201804;34;28;6;26712.0;5724.0;32436.0
431843;201804;12;8;4;7632.0;3816.0;11448.0
431844;201804;14;12;2;11448.0;1908.0;13356.0
431845;201804;29;26;3;24804.0;2862.0;27666.0
431846;201804;28;24;4;22896.0;3816.0;26712.0
431848;201804;14;12;2;11448.0;1908.0;13356.0
431849;201804;9;7;2;6678.0;1908.0;8586.0
431850;201804;801;666;135;633851.5;128551.5;762403.0
431860;201804;103;73;30;69642.0;27666.0;97308.0
431861;201804;4;2;2;1908.0;1908.0;3816.0
431862;201804;52;34;18;32436.0;17172.0;49608.0
431870;201804;3466;2047;1419;1944391.0;1350047.0;3294438.0
431880;201804;948;694;254;657278.0;241362.0;898640.0
431890;201804;1301;807;494;764841.75;469669.0;1234510.8
431900;201804;185;128;57;122112.0;53586.18;175698.19
431910;201804;56;42;14;40068.0;13356.0;53424.0
431912;201804;36;19;17;18126.0;16218.0;34344.0
431915;201804;129;102;27;97308.0;25758.0;123066.0
431920;201804;145;107;38;101791.8;36252.0;138043.8
431930;201804;87;71;16;67734.0;15264.0;82998.0
431935;201804;4;3;1;2862.0;954.0;3816.0
431936;201804;12;11;1;10494.0;954.0;11448.0
431937;201804;18;13;5;12402.0;4770.0;17172.0
431940;201804;459;308;151;291065.4;144044.45;435109.88
431950;201804;480;307;173;291638.88;164890.98;456529.88
431960;201804;721;425;296;401264.03;282222.9;683486.94
431970;201804;71;62;9;59148.0;8586.0;67734.0
431971;201804;2;2;0;1908.0;0.0;1908.0
431973;201804;20;16;4;15264.0;3816.0;19080.0
431975;201804;7;6;1;5724.0;954.0;6678.0
431980;201804;202;128;74;120585.6;70596.0;191181.6
431990;201804;1228;665;563;632889.3;537056.0;1169945.2
432000;201804;1665;900;765;851201.44;726245.25;1577446.6
432010;201804;281;186;95;176330.95;90630.0;266960.97
432020;201804;171;135;36;128790.0;34334.46;163124.45
432023;201804;19;15;4;14310.0;3816.0;18126.0
432026;201804;64;57;7;54378.0;6678.0;61056.0
432030;201804;64;28;36;26712.0;34344.0;61056.0
432032;201804;21;18;3;17172.0;2862.0;20034.0
432035;201804;49;38;11;36252.0;10494.0;46746.0
432040;201804;102;69;33;65826.0;31482.0;97308.0
432045;201804;8;7;1;6678.0;954.0;7632.0
432050;201804;69;42;27;40068.0;25758.0;65826.0
432055;201804;99;72;27;68688.0;25758.0;94446.0
432057;201804;1;0;1;0.0;954.0;954.0
432060;201804;36;33;3;31482.0;2862.0;34344.0
432065;201804;31;28;3;26712.0;2862.0;29574.0
432067;201804;88;78;10;74392.92;9540.0;83932.92
432070;201804;403;302;101;286211.38;96325.92;382537.3
432080;201804;810;557;253;529489.75;241266.69;770756.44
432085;201804;16;12;4;11448.0;3816.0;15264.0
432090;201804;260;162;98;154548.0;93492.0;248040.0
432100;201804;178;118;60;112190.4;57240.0;169430.4
432110;201804;613;420;193;394145.62;183168.0;577313.6
432120;201804;955;576;379;548836.2;361480.12;910316.3
432130;201804;509;368;141;349736.4;133416.9;483153.3
432132;201804;26;23;3;21942.0;2862.0;24804.0
432135;201804;79;65;14;62010.0;13356.0;75366.0
432140;201804;266;212;54;201952.27;51516.0;253468.27
432143;201804;189;120;69;114480.0;65826.0;180306.0
432145;201804;271;189;82;178494.2;77941.8;256436.0
432146;201804;14;13;1;12402.0;954.0;13356.0
432147;201804;134;61;73;58194.0;69618.15;127812.15
432149;201804;18;13;5;12402.0;4770.0;17172.0
432150;201804;838;526;312;500601.97;295564.62;796166.6
432160;201804;1400;724;676;688398.4;643998.44;1332396.9
432162;201804;5;4;1;3816.0;954.0;4770.0
432163;201804;18;14;4;13356.0;3816.0;17172.0
432166;201804;122;92;30;88246.0;28620.0;116866.0
432170;201804;224;122;102;115435.0;97308.0;212743.0
432180;201804;525;319;206;301559.97;196238.0;497797.97
432183;201804;9;7;2;6678.0;1908.0;8586.0
432185;201804;84;73;11;69546.6;10494.0;80040.6
432190;201804;468;259;209;246504.86;199253.52;445758.38
432195;201804;85;74;11;69880.5;10494.0;80374.5
432200;201804;414;269;145;256626.0;138282.84;394908.84
432210;201804;120;78;42;72647.1;40068.0;112715.1
432215;201804;62;58;4;55332.0;3816.0;59148.0
432218;201804;19;18;1;17172.0;954.0;18126.0
432220;201804;684;346;338;329073.62;321944.75;651018.4
432225;201804;13;8;5;7155.0;4770.0;11925.0
432230;201804;142;86;56;81805.5;53424.0;135229.5
432232;201804;16;13;3;12402.0;2862.0;15264.0
432234;201804;4;3;1;2862.0;954.0;3816.0
432235;201804;1;1;0;954.0;0.0;954.0
432237;201804;29;17;12;16218.0;11448.0;27666.0
432240;201804;4229;2354;1875;2236617.2;1781081.4;4017698.8
432250;201804;1030;655;375;622200.25;357559.2;979759.44
432252;201804;39;32;7;29783.88;6678.0;36461.88
432253;201804;60;48;12;45792.0;11448.0;57240.0
432254;201804;23;11;12;10494.0;11448.0;21942.0
432255;201804;14;13;1;12402.0;954.0;13356.0
432260;201804;869;681;188;648615.25;178398.5;827013.75
432270;201804;227;167;60;159318.0;57240.0;216558.0
432280;201804;126;92;34;87291.8;32436.0;119727.8
432285;201804;2;1;1;954.0;954.0;1908.0
432290;201804;70;63;7;58194.0;6678.0;64872.0
432300;201804;4641;2649;1992;2511420.2;1896498.1;4407918.5
432310;201804;118;95;23;90630.0;21942.0;112572.0
432320;201804;20;15;5;14262.3;4770.0;19032.3
432330;201804;15;10;5;9540.0;4770.0;14310.0
432335;201804;7;6;1;5724.0;954.0;6678.0
432340;201804;39;36;3;34344.0;2862.0;37206.0
432345;201804;94;66;28;62964.0;26712.0;89676.0
432350;201804;24;23;1;21942.0;954.0;22896.0
432360;201804;6;4;2;3816.0;1908.0;5724.0
432370;201804;25;25;0;23850.0;0.0;23850.0
432375;201804;39;34;5;32436.0;4770.0;37206.0
432377;201804;7;7;0;6678.0;0.0;6678.0
432380;201804;169;77;92;72790.2;87720.3;160510.5
500020;201804;249;136;113;129744.0;107200.98;236944.98
500025;201804;115;56;59;52470.0;56286.0;108756.0
500060;201804;1397;857;540;817005.6;514554.62;1331560.2
500070;201804;769;367;402;349767.0;383498.47;733265.44
500080;201804;135;103;32;98262.0;30528.0;128790.0
500085;201804;139;113;26;107516.0;23969.25;131485.25
500090;201804;333;160;173;152640.0;165042.0;317682.0
500100;201804;702;376;326;356509.8;310432.0;666941.8
500110;201804;2251;1014;1237;967019.94;1179275.6;2146295.5
500124;201804;312;178;134;169812.0;127549.8;297361.8
500150;201804;326;128;198;122103.0;188532.0;310635.0
500190;201804;521;359;162;341818.2;154062.0;495880.2
500200;201804;200;171;29;162791.0;27666.0;190457.0
500210;201804;1466;523;943;497811.0;898459.0;1396270.0
500215;201804;242;137;105;129250.73;100170.0;229420.73
500220;201804;795;520;275;495835.84;261592.45;757428.3
500230;201804;255;172;83;163372.5;78705.0;242077.5
500240;201804;710;491;219;467650.8;208639.8;676290.6
500260;201804;568;213;355;203202.0;338670.0;541872.0
500270;201804;28372;12062;16310;1,15E+14;1,55E+14;2,70E+14
500280;201804;193;73;120;69642.0;114480.0;184122.0
500290;201804;1198;707;491;673239.0;468405.0;1141644.0
500295;201804;412;251;161;239454.0;153584.45;393038.47
500310;201804;63;20;43;19080.0;41022.0;60102.0
500315;201804;702;422;280;402578.47;266824.25;669402.75
500320;201804;3621;1817;1804;1730991.4;1719512.0;3450503.5
500325;201804;932;518;414;493695.0;393981.44;887676.44
500330;201804;1485;685;800;651268.25;762789.6;1414057.9
500345;201804;326;239;87;227043.2;82998.0;310041.2
500348;201804;242;143;99;136422.0;94427.46;230849.45
500350;201804;140;67;73;63918.0;69642.0;133560.0
500370;201804;5436;2445;2991;2325002.0;2850613.2;5175615.5
500375;201804;351;255;96;242020.64;91584.0;333604.62
500380;201804;591;337;254;321340.6;242306.45;563647.06
500390;201804;72;36;36;34344.0;34344.0;68688.0
500400;201804;222;149;73;142126.92;69633.0;211759.92
500410;201804;564;221;343;210788.16;327074.22;537862.4
500430;201804;552;384;168;366336.0;160272.0;526608.0
500440;201804;204;105;99;99397.43;94446.0;193843.44
500450;201804;413;178;235;169106.8;223835.12;392941.9
500460;201804;312;159;153;151676.45;145962.0;297638.47
500470;201804;442;346;96;328869.66;90621.0;419490.66
500480;201804;116;69;47;65826.0;44838.0;110664.0
500490;201804;108;44;64;41971.23;61056.0;103027.23
500500;201804;1427;501;926;475922.6;882814.6;1358737.2
500510;201804;48;38;10;36252.0;9531.0;45783.0
500515;201804;110;77;33;73458.0;31196.0;104654.0
500520;201804;348;194;154;184027.0;146626.0;330653.0
500525;201804;87;50;37;47700.0;35011.8;82711.8
500540;201804;896;377;519;359305.75;494115.84;853421.6
500560;201804;885;504;381;478326.62;362782.88;841109.5
500568;201804;999;576;423;546928.2;403251.22;950179.44
500570;201804;1214;683;531;648579.5;504253.12;1152832.6
500580;201804;336;171;165;162838.27;157397.0;320235.25
500600;201804;313;157;156;149067.27;148806.0;297873.28
500620;201804;917;645;272;609552.7;259297.2;868849.9
500625;201804;83;71;12;67027.19;11448.0;78475.19
500627;201804;25;12;13;11448.0;12402.0;23850.0
500630;201804;1572;833;739;794005.44;704529.8;1498535.2
500635;201804;518;294;224;280056.25;213552.9;493609.12
500640;201804;426;223;203;210168.0;193643.45;403811.47
500660;201804;5517;2118;3399;2016852.5;3237944.2;5254797.0
500690;201804;570;202;368;192351.23;349365.72;541716.94
500710;201804;358;176;182;167618.0;173610.0;341228.0
500720;201804;973;570;403;542096.7;384252.9;926349.6
500730;201804;198;117;81;111618.0;77269.23;188887.23
500740;201804;846;368;478;349780.94;455737.75;805518.7
500750;201804;140;47;93;44838.0;88693.92;133531.92
500755;201804;122;88;34;83666.0;32436.0;116102.0
500769;201804;746;422;324;402266.03;309083.0;711349.06
500770;201804;435;230;205;219410.45;195560.45;414970.9
500780;201804;171;114;57;108756.0;54378.0;163134.0
500790;201804;1043;515;528;490733.22;503385.47;994118.7
500793;201804;254;137;117;130698.0;111609.0;242307.0
500795;201804;179;128;51;122102.46;48645.0;170747.45
500797;201804;38;30;8;28620.0;7632.0;36252.0
500800;201804;408;176;232;167895.0;221041.8;388936.8
500830;201804;2202;1230;972;1171007.9;926248.7;2097256.5
500840;201804;145;109;36;103986.0;34335.0;138321.0
510010;201804;162;91;71;86804.46;67734.0;154538.45
510020;201804;487;225;262;214356.06;249363.5;463719.56
510025;201804;1673;948;725;903522.1;689114.06;1592636.2
510030;201804;663;341;322;325267.9;306414.7;631682.6
510035;201804;129;59;70;56258.46;66761.46;123019.92
510040;201804;385;173;212;165042.0;201801.27;366843.25
510050;201804;426;233;193;221531.66;183317.45;404849.12
510060;201804;116;57;59;54368.46;56276.46;110644.92
510080;201804;221;89;132;84873.69;125814.06;210687.75
510100;201804;77;34;43;32436.0;41002.92;73438.92
510120;201804;37;22;15;20988.0;14310.0;35298.0
510125;201804;397;243;154;231139.89;146892.92;378032.8
510130;201804;574;335;239;319175.8;227573.1;546748.94
510140;201804;394;130;264;124011.0;251851.23;375862.22
510160;201804;92;40;52;38160.0;49604.0;87764.0
510170;201804;869;526;343;501538.06;326589.38;828127.44
510180;201804;2872;1396;1476;1328789.8;1406190.4;2734980.0
510185;201804;13;7;6;6678.0;5724.0;12402.0
510190;201804;212;72;140;68688.0;133555.23;202243.23
510250;201804;2622;1548;1074;1475751.1;1023473.2;2499224.2
510260;201804;203;145;58;138147.84;55295.46;193443.3
510263;201804;458;251;207;238451.45;196722.6;435174.06
510267;201804;659;366;293;348608.75;279251.44;627860.2
510268;201804;56;29;27;27666.0;25758.0;53424.0
510269;201804;66;30;36;28611.0;34344.0;62955.0
510270;201804;408;206;202;196345.98;192291.48;388637.47
510279;201804;228;168;60;160245.0;56934.92;217179.92
510285;201804;166;73;93;69623.46;88722.0;158345.45
510300;201804;546;297;249;282887.06;237471.84;520358.9
510305;201804;219;101;118;96331.46;112478.22;208809.69
510310;201804;112;57;55;54378.0;52460.46;106838.46
510320;201804;866;541;325;515536.62;309689.38;825226.0
510325;201804;415;167;248;159308.45;236296.27;395604.72
510330;201804;425;240;185;228947.0;176470.92;405417.9
510335;201804;593;321;272;306187.38;258850.98;565038.4
510336;201804;48;36;12;34344.0;11448.0;45792.0
510337;201804;119;48;71;45782.46;67724.46;113506.92
510340;201804;17409;8359;9050;7951654.5;8623633.0;1,66E+14
510343;201804;71;49;22;46736.46;20988.0;67724.46
510345;201804;157;105;52;100160.46;49302.92;149463.38
510350;201804;666;369;297;351084.06;283273.38;634357.44
510360;201804;204;121;83;115425.0;79099.92;194524.92
510370;201804;139;71;68;67705.38;64740.6;132445.98
510380;201804;90;62;28;59148.0;26703.0;85851.0
510385;201804;58;27;31;25758.0;29565.0;55323.0
510390;201804;121;51;70;48654.0;66741.84;115395.84
510395;201804;40;29;11;27666.0;10494.0;38160.0
510410;201804;710;473;237;451238.0;226074.69;677312.7
510420;201804;588;286;302;271899.34;286688.0;558587.3
510450;201804;51;30;21;28620.0;20034.0;48654.0
510452;201804;41;23;18;21942.0;17172.0;39114.0
510454;201804;63;27;36;25758.0;34334.46;60092.46
510455;201804;127;81;46;77254.92;43884.0;121138.92
510460;201804;185;99;86;94107.16;82006.38;176113.55
510480;201804;757;435;322;413863.8;306859.38;720723.2
510490;201804;362;185;177;176110.8;168353.08;344463.88
510500;201804;253;191;62;182204.45;59148.0;241352.45
510510;201804;797;454;343;432230.06;327212.47;759442.5
510515;201804;1147;611;536;582525.4;511297.38;1093822.8
510517;201804;244;104;140;98929.8;133536.69;232466.48
510520;201804;236;154;82;146823.3;77908.3;224731.6
510523;201804;91;64;27;61056.0;25748.46;86804.46
510525;201804;726;408;318;388477.84;303261.3;691739.1
510530;201804;15;11;4;10494.0;3816.0;14310.0
510550;201804;273;118;155;112563.0;147861.0;260424.0
510558;201804;274;134;140;127803.15;133531.92;261335.06
510560;201804;387;241;146;229628.0;139266.0;368894.0
510562;201804;639;449;190;427015.16;180773.45;607788.6
510590;201804;813;423;390;403494.84;372041.7;775536.5
510600;201804;259;142;117;135444.92;111580.92;247025.84
510610;201804;170;82;88;78208.92;83370.46;161579.38
510615;201804;195;80;115;76300.92;109710.0;186010.92
510617;201804;17;10;7;9540.0;6678.0;16218.0
510618;201804;115;54;61;51516.0;57717.0;109233.0
510619;201804;106;74;32;70587.0;30519.0;101106.0
510620;201804;185;103;82;98252.46;78228.0;176480.45
510621;201804;196;124;72;118277.46;68660.46;186937.92
510622;201804;451;290;161;276567.84;153270.38;429838.22
510623;201804;354;237;117;226051.38;111589.38;337640.75
510624;201804;88;42;46;40059.0;43884.0;83943.0
510625;201804;537;332;205;316518.3;194992.52;511510.8
510626;201804;107;67;40;63918.0;38160.0;102078.0
510627;201804;59;43;16;41022.0;15264.0;56286.0
510628;201804;163;97;66;92491.92;62906.76;155398.69
510629;201804;253;161;92;153594.0;86804.46;240398.45
510630;201804;467;238;229;226967.22;218119.95;445087.16
510631;201804;11;3;8;2862.0;7346.0;10208.0
510637;201804;344;193;151;183776.19;143916.84;327693.03
510642;201804;978;544;434;518625.2;413893.44;932518.6
510645;201804;0;0;0;0.0;0.0;0.0
510650;201804;1502;992;510;946214.4;486408.75;1432623.1
510665;201804;85;43;42;40966.0;40068.0;81034.0
510670;201804;65;36;29;34344.0;27666.0;62010.0
510675;201804;1170;705;465;672539.0;443587.22;1116126.2
510677;201804;361;174;187;164990.84;178145.69;343136.53
510680;201804;108;63;45;60084.0;42921.0;103005.0
510682;201804;202;96;106;91262.0;101124.0;192386.0
510685;201804;52;37;15;35298.0;14310.0;49608.0
510700;201804;621;365;256;348091.9;244090.77;592182.7
510704;201804;1068;579;489;550022.2;464949.44;1014971.6
510706;201804;128;63;65;60097.23;61972.92;122070.15
510710;201804;394;267;127;253728.23;121043.68;374771.9
510715;201804;64;47;17;44828.46;16218.0;61046.46
510718;201804;210;113;97;107708.76;92519.46;200228.22
510719;201804;35;19;16;18126.0;15264.0;33390.0
510720;201804;196;131;65;124965.0;61723.8;186688.8
510724;201804;90;37;53;35288.46;50529.38;85817.84
510726;201804;52;27;25;25748.46;23832.0;49580.46
510729;201804;73;34;39;32436.0;37167.84;69603.84
510730;201804;474;264;210;251838.0;200192.45;452030.47
510735;201804;111;43;68;41022.0;64872.0;105894.0
510740;201804;29;16;13;15264.0;12402.0;27666.0
510757;201804;19;15;4;14310.0;3816.0;18126.0
510760;201804;7062;3744;3318;3562217.2;3159109.2;6721326.5
510770;201804;723;343;380;327033.3;362325.3;689358.6
510774;201804;15;6;9;5724.0;8586.0;14310.0
510775;201804;113;85;28;81080.46;26702.46;107782.92
510776;201804;31;8;23;7632.0;21942.0;29574.0
510777;201804;186;82;104;78199.38;99187.38;177386.77
510779;201804;53;24;29;22887.0;27628.92;50515.92
510780;201804;293;163;130;155439.45;123955.0;279394.47
510785;201804;441;239;202;227949.3;192641.22;420590.53
510787;201804;191;97;94;92529.0;89658.23;182187.23
510788;201804;0;0;0;0.0;0.0;0.0
510790;201804;2408;1250;1158;1190628.4;1102632.6;2293261.0
510792;201804;1090;616;474;586881.5;451780.34;1038661.8
510794;201804;118;59;59;56286.0;56257.92;112543.92
510795;201804;2400;1392;1008;1321148.2;958873.6;2280022.0
510800;201804;186;113;73;107792.46;69633.0;177425.45
510805;201804;171;119;52;113526.0;49608.0;163134.0
510810;201804;95;39;56;37123.38;53300.52;90423.9
510820;201804;259;121;138;115007.46;130652.03;245659.48
510830;201804;65;40;25;38160.0;23841.0;62001.0
510835;201804;7;5;2;4770.0;1908.0;6678.0
510840;201804;9282;4589;4693;4362985.0;4469679.5;8832665.0
510850;201804;211;89;122;84896.46;116064.18;200960.64
510860;201804;384;168;216;160085.52;205373.8;365459.3
510880;201804;63;48;15;45773.46;14310.0;60083.46
510885;201804;72;44;28;41957.46;26683.38;68640.84
510890;201804;73;42;31;40068.0;29574.0;69642.0
510895;201804;186;106;80;101124.0;76011.46;177135.45
520005;201804;35;24;11;22896.0;10494.0;33390.0
520010;201804;275;123;152;117342.0;144913.0;262255.0
520013;201804;640;384;256;366308.0;243937.8;610245.8
520015;201804;51;37;14;35298.0;13356.0;48654.0
520017;201804;104;60;44;56954.0;41976.0;98930.0
520020;201804;27;13;14;12402.0;13356.0;25758.0
520025;201804;2005;1086;919;1034861.25;875286.4;1910147.6
520030;201804;790;405;385;385407.0;366669.9;752076.9
520050;201804;80;55;25;52470.0;23850.0;76320.0
520055;201804;44;30;14;28620.0;13356.0;41976.0
520060;201804;177;113;64;107802.0;61056.0;168858.0
520080;201804;594;417;177;397818.0;168858.0;566676.0
520082;201804;20;14;6;13356.0;5724.0;19080.0
520085;201804;100;72;28;68688.0;26712.0;95400.0
520090;201804;93;65;28;62010.0;26712.0;88722.0
520110;201804;9001;3902;5099;3717376.2;4860286.0;8577662.0
520120;201804;14;8;6;7431.66;5724.0;13155.66
520130;201804;760;529;231;504370.8;220365.0;724735.8
520140;201804;11780;6654;5126;6340733.0;4887842.0;1,12E+14
520145;201804;45;34;11;32436.0;10494.0;42930.0
520150;201804;190;148;42;141192.0;40068.0;181260.0
520160;201804;29;22;7;20988.0;6678.0;27666.0
520170;201804;234;146;88;139252.0;83915.0;223167.0
520180;201804;119;62;57;59148.0;54378.0;113526.0
520215;201804;216;133;83;126595.8;78895.8;205491.6
520235;201804;70;53;17;50562.0;16218.0;66780.0
520250;201804;134;80;54;76320.0;51229.8;127549.8
520260;201804;111;69;42;65826.0;39114.0;104940.0
520280;201804;47;33;14;30815.0;13356.0;44171.0
520310;201804;39;27;12;25758.0;11448.0;37206.0
520320;201804;165;106;59;101114.46;56286.0;157400.45
520330;201804;782;411;371;392048.47;353907.0;745955.44
520340;201804;352;200;152;190800.0;144970.45;335770.47
520350;201804;523;238;285;227052.0;271843.0;498895.0
520355;201804;89;51;38;48654.0;36252.0;84906.0
520357;201804;25;18;7;17172.0;6678.0;23850.0
520360;201804;0;0;0;0.0;0.0;0.0
520380;201804;139;72;67;68688.0;63918.0;132606.0
520390;201804;283;118;165;112095.0;157147.5;269242.5
520393;201804;13;10;3;9540.0;2862.0;12402.0
520396;201804;96;56;40;53424.0;38160.0;91584.0
520400;201804;224;131;93;123353.2;88722.0;212075.2
520410;201804;202;104;98;99207.0;93483.0;192690.0
520420;201804;22;15;7;14310.0;6678.0;20988.0
520425;201804;299;128;171;121159.0;162658.2;283817.2
520430;201804;458;238;220;226765.8;209824.0;436589.8
520440;201804;617;418;199;398772.0;189826.92;588598.94
520450;201804;1912;867;1045;826223.44;996284.0;1822507.5
520455;201804;58;41;17;39114.0;16218.0;55332.0
520460;201804;31;16;15;15264.0;14310.0;29574.0
520465;201804;23;19;4;18126.0;3816.0;21942.0
520470;201804;415;256;159;243918.62;151686.0;395604.62
520480;201804;81;46;35;43884.0;33345.0;77229.0
520485;201804;125;42;83;40068.0;78896.0;118964.0
520490;201804;403;296;107;282199.97;102078.0;384277.97
520495;201804;176;107;69;102078.0;65826.0;167904.0
520500;201804;174;131;43;124974.0;41022.0;165996.0
520505;201804;177;92;85;87763.23;81090.0;168853.23
520510;201804;1782;879;903;835239.75;859308.2;1694547.9
520520;201804;37;28;9;26712.0;8586.0;35298.0
520530;201804;230;172;58;161696.31;55322.46;217018.78
520540;201804;530;356;174;338317.03;165996.0;504313.03
520545;201804;161;89;72;84906.0;68688.0;153594.0
520547;201804;54;30;24;28620.0;22896.0;51516.0
520549;201804;1122;546;576;520560.0;549386.0;1069946.0
520551;201804;295;152;143;145008.0;136136.0;281144.0
520552;201804;46;27;19;25758.0;18126.0;43884.0
520570;201804;16;9;7;8586.0;6678.0;15264.0
520580;201804;283;170;113;162161.45;107802.0;269963.47
520590;201804;166;99;67;94446.0;63631.8;158077.8
520620;201804;1168;543;625;517164.47;595668.25;1112832.8
520630;201804;44;26;18;24804.0;17172.0;41976.0
520640;201804;414;235;179;224190.0;170766.0;394956.0
520650;201804;55;39;16;37206.0;15264.0;52470.0
520660;201804;35;19;16;18117.0;15264.0;33381.0
520670;201804;34;29;5;27666.0;4770.0;32436.0
520680;201804;57;37;20;35298.0;19080.0;54378.0
520690;201804;33;10;23;9540.0;21913.92;31453.92
520710;201804;39;35;4;33390.0;3816.0;37206.0
520725;201804;197;125;72;119250.0;68688.0;187938.0
520735;201804;60;42;18;40068.0;17172.0;57240.0
520740;201804;404;200;204;190085.4;194607.0;384692.4
520750;201804;37;27;10;25758.0;9540.0;35298.0
520753;201804;55;38;17;36252.0;16218.0;52470.0
520760;201804;111;75;36;71550.0;34344.0;105894.0
520780;201804;289;218;71;207972.0;67734.0;275706.0
520790;201804;165;82;83;77941.8;79182.0;157123.8
520800;201804;3452;1840;1612;1752677.0;1537170.9;3289848.0
520810;201804;168;120;48;114480.0;45792.0;160272.0
520815;201804;5;5;0;4770.0;0.0;4770.0
520830;201804;139;91;48;86814.0;45505.8;132319.8
520840;201804;350;229;121;217989.0;115434.0;333423.0
520850;201804;110;70;40;66771.0;38007.36;104778.36
520860;201804;1685;1070;615;1019359.56;585566.2;1604925.8
520870;201804;30808;15184;15624;1,45E+14;1,49E+14;2,93E+14
520880;201804;1066;584;482;557136.0;459808.9;1016944.94
520890;201804;796;459;337;436255.4;321393.47;757648.9
520910;201804;1037;548;489;519215.75;466506.0;985721.75
520915;201804;101;76;25;72504.0;23840.46;96344.46
520920;201804;406;198;208;188319.6;198422.45;386742.06
520929;201804;17;16;1;15264.0;954.0;16218.0
520940;201804;73;46;27;43884.0;25758.0;69642.0
520945;201804;21;13;8;12402.0;7632.0;20034.0
520960;201804;45;29;16;27666.0;15264.0;42930.0
520970;201804;328;205;123;194941.0;117055.8;311996.8
520980;201804;87;63;24;60102.0;22896.0;82998.0
520990;201804;475;320;155;305280.0;147870.0;453150.0
520993;201804;128;61;67;58194.0;63909.0;122103.0
520995;201804;242;135;107;127837.0;101506.0;229343.0
521000;201804;1553;906;647;862321.4;616857.0;1479178.4
521010;201804;675;313;362;298275.38;345282.3;643557.7
521015;201804;17;10;7;9540.0;6678.0;16218.0
521020;201804;1464;1021;443;973404.9;422251.22;1395656.1
521030;201804;47;33;14;31482.0;13356.0;44838.0
521040;201804;940;577;363;550220.2;346016.0;896236.2
521056;201804;41;29;12;27666.0;11448.0;39114.0
521060;201804;132;81;51;77274.0;48654.0;125928.0
521080;201804;470;351;119;334559.0;113526.0;448085.0
521090;201804;534;322;212;305375.4;202248.0;507623.4
521100;201804;283;210;73;200331.0;69642.0;269973.0
521120;201804;1054;726;328;691255.9;312617.0;1003872.9
521130;201804;365;261;104;248984.45;98330.6;347315.06
521140;201804;187;108;79;103032.0;75366.0;178398.0
521150;201804;2797;1212;1585;1155238.9;1510531.5;2665770.2
521160;201804;33;17;16;16218.0;15264.0;31482.0
521170;201804;192;113;79;107792.46;75366.0;183158.45
521180;201804;1136;719;417;684295.25;397103.2;1081398.5
521190;201804;2546;1076;1470;1026484.94;1401502.8;2427987.8
521200;201804;47;34;13;32436.0;12402.0;44838.0
521205;201804;14;10;4;9540.0;3816.0;13356.0
521210;201804;145;83;62;79182.0;59148.0;138330.0
521220;201804;819;560;259;531607.75;247030.0;778637.75
521225;201804;31;20;11;19080.0;10494.0;29574.0
521230;201804;110;72;38;68401.8;36252.0;104653.8
521250;201804;6221;3578;2643;3408117.2;2518829.2;5926946.5
521260;201804;22;14;8;13356.0;7632.0;20988.0
521270;201804;143;111;32;105894.0;30528.0;136422.0
521280;201804;437;259;178;246418.2;169812.0;416230.2
521290;201804;30;12;18;11448.0;17172.0;28620.0
521295;201804;99;67;32;63689.04;30528.0;94217.04
521300;201804;230;118;112;112554.0;106488.38;219042.38
521305;201804;35;23;12;21942.0;11448.0;33390.0
521308;201804;1075;783;292;746483.1;278273.0;1024756.1
521310;201804;1352;801;551;762869.4;524462.94;1287332.4
521340;201804;19;16;3;15264.0;2862.0;18126.0
521350;201804;131;96;35;91584.0;33390.0;124974.0
521370;201804;190;121;69;115434.0;65539.8;180973.8
521375;201804;190;107;83;102078.0;78895.8;180973.8
521377;201804;52;35;17;33390.0;16218.0;49608.0
521380;201804;1087;708;379;671284.25;361566.0;1032850.25
521385;201804;15;8;7;7632.0;6678.0;14310.0
521390;201804;106;86;20;81726.04;19080.0;100806.04
521400;201804;326;207;119;197191.8;113478.3;310670.1
521405;201804;150;78;72;74412.0;68688.0;143100.0
521410;201804;65;43;22;41022.0;20988.0;62010.0
521440;201804;207;146;61;138473.1;58194.0;196667.1
521450;201804;719;395;324;376830.0;309096.0;685926.0
521460;201804;1187;729;458;695179.8;436912.9;1132092.8
521470;201804;14;9;5;8586.0;4770.0;13356.0
521480;201804;47;32;15;30501.0;14245.0;44746.0
521483;201804;307;167;140;159032.0;133560.0;292592.0
521486;201804;285;182;103;172836.19;97595.0;270431.2
521487;201804;21;10;11;9540.0;10494.0;20034.0
521490;201804;27;16;11;15264.0;10494.0;25758.0
521500;201804;116;75;41;71550.0;39114.0;110664.0
521520;201804;42;31;11;29574.0;10494.0;40068.0
521523;201804;604;370;234;349952.4;223236.0;573188.44
521525;201804;45;30;15;28620.0;14023.8;42643.8
521530;201804;250;133;117;126882.0;111618.0;238500.0
521540;201804;30;16;14;15264.0;13356.0;28620.0
521550;201804;92;44;48;41661.92;45736.92;87398.84
521560;201804;804;551;253;525208.56;241219.0;766427.56
521565;201804;53;36;17;34344.0;16218.0;50562.0
521570;201804;497;332;165;316718.47;157315.3;474033.75
521580;201804;60;37;23;35298.0;21942.0;57240.0
521590;201804;37;20;17;19080.0;16218.0;35298.0
521600;201804;28;16;12;15264.0;11448.0;26712.0
521630;201804;238;120;118;114470.46;111581.96;226052.42
521640;201804;299;153;146;145962.0;139284.0;285246.0
521645;201804;30;16;14;15264.0;13356.0;28620.0
521680;201804;219;138;81;131652.0;77274.0;208926.0
521690;201804;3;2;1;1908.0;954.0;2862.0
521710;201804;1194;560;634;533667.8;604827.0;1138494.8
521720;201804;544;368;176;351062.47;167866.45;518928.9
521730;201804;626;304;322;290016.0;306081.56;596097.56
521740;201804;926;376;550;359100.9;523509.3;882610.25
521760;201804;1602;876;726;834126.6;692290.0;1526416.6
521770;201804;803;514;289;490356.0;275238.53;765594.56
521800;201804;2077;1290;787;1227118.0;750374.1;1977492.1
521805;201804;33;18;15;17172.0;14310.0;31482.0
521810;201804;92;58;34;54187.8;32436.0;86623.8
521830;201804;962;684;278;650342.25;265203.0;915545.25
521839;201804;93;62;31;59148.0;29574.0;88722.0
521850;201804;1118;594;524;565256.94;499571.7;1064828.6
521860;201804;343;210;133;200340.0;126596.0;326936.0
521870;201804;73;42;31;40068.0;29574.0;69642.0
521878;201804;42;20;22;19080.0;20988.0;40068.0
521880;201804;4544;2054;2490;1957225.4;2373960.2;4331185.5
521890;201804;581;405;176;386370.0;167617.8;553987.8
521900;201804;293;236;57;224507.95;54378.0;278885.97
521910;201804;153;107;46;102078.0;43884.0;145962.0
521920;201804;56;28;28;26712.0;26712.0;53424.0
521925;201804;36;21;15;20034.0;14310.0;34344.0
521930;201804;1127;641;486;611318.5;462714.7;1074033.2
521935;201804;34;26;8;24804.0;7632.0;32436.0
521940;201804;189;94;95;89676.0;90625.23;180301.23
521945;201804;14;12;2;11448.0;1908.0;13356.0
521950;201804;9;5;4;4770.0;3816.0;8586.0
521960;201804;73;54;19;51516.0;18126.0;69642.0
521970;201804;422;272;150;259201.8;143100.0;402301.8
521971;201804;99;50;49;47700.0;46746.0;94446.0
521973;201804;28;13;15;12402.0;14310.0;26712.0
521975;201804;1136;584;552;556183.0;525692.7;1081875.6
521980;201804;243;168;75;160272.0;71550.0;231822.0
521990;201804;72;54;18;51516.0;17172.0;68688.0
522000;201804;286;178;108;169812.0;103032.0;272844.0
522005;201804;21;13;8;12402.0;7632.0;20034.0
522010;201804;1139;638;501;608643.0;477381.6;1086024.6
522015;201804;54;33;21;31473.0;20034.0;51507.0
522020;201804;856;462;394;439794.2;375094.12;814888.3
522026;201804;30;22;8;20988.0;7632.0;28620.0
522028;201804;16;12;4;11448.0;3816.0;15264.0
522040;201804;749;298;451;284274.0;430199.47;714473.44
522045;201804;2105;1326;779;1263682.0;742632.8;2006314.9
522050;201804;167;81;86;77274.0;82044.0;159318.0
522060;201804;558;352;206;335521.8;196428.6;531950.4
522068;201804;135;89;46;84619.8;43884.0;128503.8
522070;201804;11;11;0;10494.0;0.0;10494.0
522100;201804;48;27;21;25490.88;20034.0;45524.88
522108;201804;40;30;10;28620.0;9540.0;38160.0
522119;201804;55;29;26;27666.0;24804.0;52470.0
522130;201804;76;29;47;27657.0;44820.0;72477.0
522140;201804;3724;1885;1839;1793803.2;1752241.9;3546045.2
522145;201804;50;30;20;28620.0;19080.0;47700.0
522150;201804;65;51;14;48654.0;13356.0;62010.0
522155;201804;59;40;19;38151.0;18126.0;56277.0
522157;201804;4;3;1;2862.0;954.0;3816.0
522160;201804;1723;1007;716;959533.2;682768.8;1642302.0
522170;201804;396;266;130;253764.0;124020.0;377784.0
522180;201804;36;20;16;19080.0;15264.0;34344.0
522185;201804;1913;746;1167;707987.2;1112797.0;1820784.1
522190;201804;48;27;21;25758.0;19938.6;45696.6
522200;201804;301;181;120;172674.0;114480.0;287154.0
522205;201804;164;111;53;105894.0;50562.0;156456.0
522220;201804;163;116;47;110664.0;44838.0;155502.0
522230;201804;29;23;6;21942.0;5724.0;27666.0
530010;201804;55625;28569;27056;2,71E+13;2,58E+14;5,29E+14
110001;201805;520;411;109;391110.34;103340.96;494451.3
110002;201805;2790;1689;1101;1609426.2;1049447.5;2658873.8
110003;201805;95;75;20;71550.0;19080.0;90630.0
110004;201805;2016;1294;722;1231575.0;688492.25;1920067.2
110005;201805;444;357;87;339422.9;82998.0;422420.9
110006;201805;455;350;105;333613.8;100150.92;433764.72
110007;201805;83;66;17;62964.0;16218.0;79182.0
110008;201805;240;136;104;128508.9;99216.0;227724.9
110009;201805;798;544;254;517069.2;242117.0;759186.2
110010;201805;1812;1125;687;1072114.5;655256.5;1727371.0
110011;201805;1886;1453;433;1384651.2;413052.34;1797703.5
110012;201805;4109;2392;1717;2275741.0;1636766.6;3912507.5
110013;201805;761;583;178;556172.44;169812.0;725984.44
110014;201805;371;319;52;304305.88;49608.0;353913.88
110015;201805;1437;1159;278;1103258.8;264620.53;1367879.2
110018;201805;1117;668;449;636958.0;428333.22;1065291.2
110020;201805;15397;9051;6346;8587644.0;6041709.5;1,46E+14
110025;201805;652;481;171;456876.12;163125.0;620001.1
110026;201805;41;28;13;26712.0;12402.0;39114.0
110028;201805;1654;1199;455;1139244.6;430476.94;1569721.5
110029;201805;141;125;16;119250.0;15264.0;134514.0
110030;201805;2491;1675;816;1595064.2;777563.44;2372627.8
110032;201805;387;302;85;287799.0;81086.0;368885.0
110033;201805;678;512;166;485424.0;158360.0;643784.0
110034;201805;366;270;96;255268.0;90917.0;346185.0
110037;201805;103;85;18;81090.0;17172.0;98262.0
110040;201805;340;229;111;218466.0;105894.0;324360.0
110045;201805;945;636;309;605198.0;293082.38;898280.4
110050;201805;96;80;16;76320.0;15264.0;91584.0
110060;201805;86;46;40;43884.0;38160.0;82044.0
110070;201805;123;73;50;69642.0;47414.0;117056.0
110080;201805;407;247;160;233415.19;152596.05;386011.22
110090;201805;33;27;6;25758.0;5724.0;31482.0
110092;201805;109;61;48;58194.0;45722.0;103916.0
110094;201805;197;140;57;133560.0;54378.0;187938.0
110100;201805;27;23;4;21942.0;3816.0;25758.0
110110;201805;69;42;27;40068.0;25758.0;65826.0
110120;201805;73;60;13;57240.0;12402.0;69642.0
110130;201805;302;244;58;231301.12;55332.0;286633.12
110140;201805;243;157;86;149587.2;82034.46;231621.66
110143;201805;50;42;8;40068.0;7632.0;47700.0
110145;201805;29;21;8;20034.0;7632.0;27666.0
110146;201805;24;12;12;11448.0;11448.0;22896.0
110147;201805;38;30;8;28620.0;7632.0;36252.0
110148;201805;39;27;12;25706.57;11448.0;37154.57
110149;201805;291;210;81;200053.8;77274.0;277327.8
110150;201805;85;58;27;55332.0;25758.0;81090.0
110155;201805;8;7;1;6678.0;954.0;7632.0
110160;201805;70;59;11;56286.0;10494.0;66780.0
110170;201805;207;168;39;160272.0;37206.0;197478.0
110175;201805;40;29;11;27666.0;10494.0;38160.0
110180;201805;92;80;12;76320.0;11448.0;87768.0
120001;201805;137;94;43;89634.0;40993.0;130627.0
120005;201805;191;119;72;113483.12;68688.0;182171.12
120010;201805;1039;668;371;631058.4;351744.9;982803.3
120013;201805;142;99;43;93737.18;40678.04;134415.22
120017;201805;92;57;35;54269.48;33347.12;87616.6
120020;201805;3521;2807;714;2650648.2;678591.2;3329239.2
120025;201805;595;337;258;318960.22;245050.6;564010.8
120030;201805;1026;862;164;814211.7;155698.12;969909.8
120032;201805;49;41;8;39114.0;7632.0;46746.0
120033;201805;212;186;26;177096.75;24804.0;201900.75
120034;201805;157;114;43;106826.12;40978.24;147804.36
120035;201805;29;21;8;20034.0;7632.0;27666.0
120038;201805;390;249;141;236700.0;134470.23;371170.25
120039;201805;22;21;1;20034.0;954.0;20988.0
120040;201805;14061;9753;4308;9171536.0;4071331.0;1,32E+14
120042;201805;43;37;6;35298.0;5724.0;41022.0
120043;201805;12;3;9;2862.0;8586.0;11448.0
120045;201805;543;351;192;332751.5;182902.6;515654.1
120050;201805;1271;968;303;916966.25;288971.47;1205937.8
120060;201805;1422;1155;267;1091606.0;252085.4;1343691.4
120070;201805;505;360;145;337179.56;137008.66;474188.22
120080;201805;166;106;60;99894.42;56651.42;156545.84
130002;201805;150;105;45;100170.0;42930.0;143100.0
130006;201805;75;43;32;41022.0;30528.0;71550.0
130008;201805;143;78;65;73691.72;61331.72;135023.44
130010;201805;139;75;64;71528.12;61056.0;132584.12
130014;201805;237;171;66;163134.0;62964.0;226098.0
130020;201805;92;48;44;45792.0;41976.0;87768.0
130030;201805;899;550;349;524700.0;332936.47;857636.44
130040;201805;327;164;163;156456.0;154548.28;311004.28
130050;201805;557;307;250;292591.8;238500.0;531091.8
130060;201805;882;601;281;568205.2;265318.88;833524.06
130063;201805;577;320;257;305280.0;245112.36;550392.4
130068;201805;187;122;65;116388.0;61723.8;178111.8
130070;201805;1329;922;407;866068.75;383357.88;1249426.6
130080;201805;665;434;231;413654.4;220365.0;634019.4
130083;201805;71;38;33;35792.7;31482.0;67274.7
130090;201805;372;192;180;181488.95;171720.0;353208.97
130100;201805;1103;515;588;491310.0;560665.8;1051975.8
130110;201805;699;311;388;296544.0;370152.0;666696.0
130115;201805;174;71;103;67734.0;98262.0;165996.0
130120;201805;1629;1020;609;973080.0;580986.0;1554066.0
130130;201805;630;434;196;414036.0;186984.0;601020.0
130140;201805;1515;1137;378;1084035.0;359658.2;1443693.2
130150;201805;421;358;63;341510.12;60102.0;401612.12
130160;201805;468;263;205;250902.0;195570.0;446472.0
130165;201805;24;17;7;16218.0;6678.0;22896.0
130170;201805;936;665;271;634339.4;258534.0;892873.4
130180;201805;152;92;60;87291.0;57240.0;144531.0
130185;201805;2294;1206;1088;1148595.9;1037360.94;2185956.8
130190;201805;3616;2259;1357;2150858.8;1293276.0;3444134.8
130195;201805;291;233;58;222282.0;55332.0;277614.0
130200;201805;176;80;96;76310.46;91584.0;167894.45
130210;201805;79;40;39;38160.0;37206.0;75366.0
130220;201805;183;127;56;121158.0;53424.0;174582.0
130230;201805;333;210;123;200340.0;117342.0;317682.0
130240;201805;1450;915;535;871570.4;509812.84;1381383.2
130250;201805;4746;3072;1674;2925245.0;1596862.6;4522107.5
130255;201805;421;206;215;196524.0;204823.8;401347.8
130260;201805;53772;25818;27954;2,46E+14;2,67E+14;5,13E+13
130270;201805;1511;971;540;925857.0;515160.0;1441017.0
130280;201805;113;68;45;64872.0;42930.0;107802.0
130290;201805;2088;1518;570;1448172.0;543493.8;1991665.8
130300;201805;429;307;122;292591.8;116388.0;408979.8
130310;201805;881;462;419;440748.0;399726.0;840474.0
130320;201805;446;234;212;222282.0;202248.0;424530.0
130330;201805;702;424;278;404496.0;264925.8;669421.8
130340;201805;3284;1963;1321;1868123.2;1258803.2;3126926.5
130350;201805;464;298;166;284270.12;158364.0;442634.12
130353;201805;805;332;473;316442.0;451242.0;767684.0
130356;201805;783;356;427;339624.0;407071.8;746695.8
130360;201805;68;41;27;39114.0;25758.0;64872.0
130370;201805;679;507;172;483678.0;164088.0;647766.0
130380;201805;620;430;190;410220.0;181260.0;591480.0
130390;201805;492;389;103;371106.0;98262.0;469368.0
130395;201805;182;41;141;39114.0;134514.0;173628.0
130400;201805;72;47;25;44838.0;23850.0;68688.0
130406;201805;2071;1301;770;1237540.2;733369.75;1970910.0
130410;201805;496;213;283;203202.0;269962.9;473164.9
130420;201805;3186;2567;619;2445131.5;590526.0;3035657.5
130423;201805;160;75;85;71550.0;81090.0;152640.0
130426;201805;141;83;58;79182.0;55332.0;134514.0
130430;201805;407;269;138;256626.0;131652.0;388278.0
130440;201805;202;69;133;65826.0;126882.0;192708.0
140002;201805;36;14;22;13356.0;20988.0;34344.0
140005;201805;210;128;82;121873.5;78228.0;200101.5
140010;201805;10274;6933;3341;6578525.5;3184992.8;9763518.0
140015;201805;154;68;86;64872.0;82044.0;146916.0
140017;201805;116;78;38;74412.0;36252.0;110664.0
140020;201805;478;319;159;303372.0;151686.0;455058.0
140023;201805;31;18;13;16953.0;12402.0;29355.0
140028;201805;17;12;5;11448.0;4770.0;16218.0
140030;201805;356;256;100;244224.0;95400.0;339624.0
140040;201805;53;37;16;35298.0;15168.6;50466.6
140045;201805;245;114;131;108088.2;124974.0;233062.2
140047;201805;579;398;181;377680.38;171911.0;549591.4
140050;201805;148;97;51;91725.0;48654.0;140379.0
140060;201805;35;24;11;22161.42;10494.0;32655.42
140070;201805;32;29;3;27666.0;2862.0;30528.0
150010;201805;4721;2929;1792;2792358.5;1707068.2;4499426.5
150013;201805;152;107;45;102078.0;42930.0;145008.0
150020;201805;1065;570;495;543780.0;472230.0;1016010.0
150030;201805;721;295;426;281430.0;406404.0;687834.0
150034;201805;196;123;73;117342.0;69642.0;186984.0
150040;201805;1392;828;564;789912.0;538056.0;1327968.0
150050;201805;700;418;282;397770.8;268828.0;666598.8
150060;201805;4716;3064;1652;2919107.2;1575760.5;4494868.0
150070;201805;312;146;166;139284.0;158364.0;297648.0
150080;201805;14453;7285;7168;6939786.0;6830668.0;1,38E+14
150085;201805;386;241;145;229904.45;138330.0;368234.47
150090;201805;759;645;114;615330.0;108756.0;724086.0
150095;201805;346;213;133;202432.12;126061.56;328493.7
150100;201805;57;40;17;38160.0;16218.0;54378.0
150110;201805;173;83;90;79182.0;85860.0;165042.0
150120;201805;431;319;112;304326.0;106848.0;411174.0
150125;201805;54;23;31;21942.0;29574.0;51516.0
150130;201805;1897;1015;882;968310.0;841423.25;1809733.2
150140;201805;54368;25369;28999;2,42E+13;2,77E+14;5,18E+14
150145;201805;181;106;75;101124.0;71550.0;172674.0
150150;201805;2821;1276;1545;1217086.5;1470271.8;2687358.2
150157;201805;439;304;135;290016.0;128785.23;418801.22
150160;201805;124;100;24;95400.0;22896.0;118296.0
150170;201805;3661;2713;948;2586246.2;904105.8;3490352.0
150172;201805;323;221;102;210834.0;97308.0;308142.0
150175;201805;87;53;34;50562.0;32436.0;82998.0
150178;201805;771;520;251;495126.0;239454.0;734580.0
150180;201805;3061;1481;1580;1412063.6;1506719.1;2918782.8
150190;201805;332;213;119;203202.0;113526.0;316728.0
150195;201805;121;60;61;57240.0;58194.0;115434.0
150200;201805;202;96;106;91584.0;101124.0;192708.0
150210;201805;3175;2573;602;2453583.8;574065.5;3027649.2
150215;201805;515;335;180;319590.0;171434.0;491024.0
150220;201805;3872;2624;1248;2501736.8;1188474.4;3690211.0
150230;201805;1141;921;220;878054.06;209880.0;1087934.0
150240;201805;5813;3427;2386;3266202.8;2275949.0;5542151.5
150250;201805;34;16;18;15264.0;17172.0;32436.0
150260;201805;75;45;30;42930.0;28620.0;71550.0
150270;201805;2345;1537;808;1465024.4;769973.8;2234998.0
150275;201805;575;350;225;333900.0;214650.0;548550.0
150276;201805;111;48;63;45792.0;60102.0;105894.0
150277;201805;766;327;439;311939.47;418806.0;730745.44
150280;201805;339;208;131;198432.0;124974.0;323406.0
150285;201805;74;37;37;35298.0;35298.0;70596.0
150290;201805;974;596;378;568288.25;360326.0;928614.25
150293;201805;672;313;359;298402.47;342486.0;640888.44
150295;201805;475;214;261;204156.0;248841.44;452997.44
150300;201805;79;41;38;39114.0;36252.0;75366.0
150304;201805;144;98;46;93492.0;43884.0;137376.0
150307;201805;392;322;70;307188.0;66780.0;373968.0
150309;201805;562;411;151;392094.0;144054.0;536148.0
150310;201805;258;174;84;165996.0;80136.0;246132.0
150320;201805;1798;1247;551;1189356.6;525654.0;1715010.6
150330;201805;2068;1193;875;1137454.2;834750.0;1972204.2
150340;201805;201;135;66;128551.5;62964.0;191515.5
150345;201805;608;329;279;313684.75;266166.0;579850.75
150350;201805;413;323;90;305747.47;85860.0;391607.47
150360;201805;4560;2919;1641;2781088.2;1565504.5;4346592.5
150370;201805;754;534;220;508640.0;209584.8;718224.8
150375;201805;197;104;93;99216.0;88722.0;187938.0
150380;201805;1348;902;446;860508.0;425198.0;1285706.0
150390;201805;737;421;316;401630.0;301464.0;703094.0
150400;201805;99;82;17;78228.0;16218.0;94446.0
150405;201805;1245;823;422;783870.5;402015.6;1185886.1
150410;201805;136;89;47;84906.0;44838.0;129744.0
150420;201805;7419;4061;3358;3872535.2;3201860.2;7074395.5
150430;201805;501;336;165;320544.0;157410.0;477954.0
150440;201805;583;346;237;329321.0;226098.0;555419.0
150442;201805;2161;1165;996;1108157.0;949811.0;2057968.0
150445;201805;520;330;190;314820.0;180306.0;495126.0
150450;201805;261;124;137;118296.0;130698.0;248994.0
150460;201805;765;580;185;551493.06;176470.92;727964.0
150470;201805;1333;805;528;766443.8;503712.0;1270155.8
150475;201805;41;31;10;29574.0;9540.0;39114.0
150480;201805;1251;872;379;831888.0;361279.8;1193167.8
150490;201805;611;335;276;319590.0;263304.0;582894.0
150495;201805;328;232;96;221328.0;91584.0;312912.0
150497;201805;298;204;94;194616.0;89666.46;284282.47
150500;201805;424;287;137;273798.0;130698.0;404496.0
150503;201805;890;430;460;409934.0;438822.0;848756.0
150506;201805;1030;676;354;644904.0;337706.47;982610.44
150510;201805;1235;695;540;662744.0;515160.0;1177904.0
150520;201805;273;183;90;174582.0;85860.0;260442.0
150530;201805;1574;855;719;812522.3;685926.0;1498448.2
150540;201805;240;167;73;159318.0;69642.0;228960.0
150543;201805;723;411;312;391502.53;297361.8;688864.3
150548;201805;501;350;151;333900.0;144054.0;477954.0
150549;201805;61;43;18;41022.0;17172.0;58194.0
150550;201805;2879;1513;1366;1442449.0;1302878.0;2745327.0
150553;201805;3114;1837;1277;1751925.8;1218248.5;2970174.2
150555;201805;143;76;67;72504.0;63918.0;136422.0
150560;201805;52;40;12;38160.0;11448.0;49608.0
150563;201805;74;40;34;38160.0;32436.0;70596.0
150565;201805;168;100;68;95400.0;64872.0;160272.0
150570;201805;400;265;135;252790.92;128790.0;381580.9
150580;201805;1524;647;877;616570.2;836658.0;1453228.2
150590;201805;783;481;302;458874.0;288108.0;746982.0
150600;201805;461;278;183;265212.0;174582.0;439794.0
150610;201805;144;123;21;116493.0;20034.0;136527.0
150611;201805;130;91;39;86814.0;37206.0;124020.0
150613;201805;3214;1975;1239;1884150.0;1181997.0;3066147.0
150616;201805;489;299;190;285008.0;181260.0;466268.0
150618;201805;1174;638;536;608423.56;511344.0;1119767.6
150619;201805;395;303;92;289062.0;87768.0;376830.0
150620;201805;1277;742;535;707868.0;510103.8;1217971.8
150630;201805;303;203;100;193662.0;95400.0;289062.0
150635;201805;486;201;285;191754.0;271890.0;463644.0
150640;201805;60;28;32;26712.0;30528.0;57240.0
150650;201805;2331;1380;951;1316196.4;906963.0;2223159.2
150655;201805;246;183;63;174582.0;60102.0;234684.0
150658;201805;105;60;45;57240.0;42930.0;100170.0
150660;201805;491;346;145;330084.0;138330.0;468414.0
150670;201805;1004;368;636;350776.8;606725.44;957502.25
150680;201805;9914;5425;4489;5168279.0;4280170.5;9448449.0
150690;201805;51;32;19;30528.0;18126.0;48654.0
150700;201805;533;344;189;327985.2;180306.0;508291.2
150710;201805;277;165;112;157410.0;106848.0;264258.0
150715;201805;863;524;339;498913.9;323377.38;822291.3
150720;201805;435;336;99;320544.0;94159.8;414703.8
150730;201805;936;498;438;475083.0;417565.8;892648.8
150740;201805;227;160;67;152640.0;63918.0;216558.0
150745;201805;786;429;357;409266.0;340578.0;749844.0
150746;201805;56;34;22;32436.0;20988.0;53424.0
150747;201805;261;205;56;195570.0;53424.0;248994.0
150750;201805;132;77;55;73458.0;52470.0;125928.0
150760;201805;1721;1121;600;1069434.0;572400.0;1641834.0
150770;201805;371;192;179;183168.0;170590.95;353758.94
150775;201805;96;44;52;41976.0;49608.0;91584.0
150780;201805;190;101;89;96354.0;84906.0;181260.0
150790;201805;881;476;405;454104.0;386370.0;840474.0
150795;201805;1452;847;605;808038.0;577170.0;1385208.0
150796;201805;393;227;166;216558.0;158364.0;374922.0
150797;201805;285;162;123;154548.0;117342.0;271890.0
150800;201805;1411;853;558;812803.25;532332.0;1345135.2
150803;201805;596;494;102;471276.0;97308.0;568584.0
150805;201805;186;119;67;113526.0;63904.46;177430.45
150808;201805;990;546;444;520884.0;423576.0;944460.0
150810;201805;3399;2358;1041;2246089.0;992255.8;3238344.8
150812;201805;422;223;199;212742.0;189846.0;402588.0
150815;201805;967;633;334;602503.5;318636.0;921139.5
150820;201805;1567;960;607;914886.0;579058.94;1493944.9
150830;201805;831;584;247;556182.0;235638.0;791820.0
150835;201805;185;111;74;105894.0;70596.0;176490.0
150840;201805;1352;863;489;823302.0;466506.0;1289808.0
160005;201805;52;30;22;28620.0;20988.0;49608.0
160010;201805;193;121;72;115434.0;68684.0;184118.0
160015;201805;113;63;50;60102.0;47700.0;107802.0
160020;201805;126;71;55;67734.0;52470.0;120204.0
160021;201805;42;22;20;20988.0;19080.0;40068.0
160023;201805;111;65;46;62010.0;43884.0;105894.0
160025;201805;31;14;17;13356.0;16218.0;29574.0
160027;201805;1474;830;644;789053.9;613622.0;1402675.9
160030;201805;15475;7966;7509;7591757.5;7158847.5;1,48E+14
160040;201805;314;181;133;172674.0;126882.0;299556.0
160050;201805;673;340;333;324360.0;317395.8;641755.8
160053;201805;322;184;138;175250.0;131652.0;306902.0
160055;201805;26;19;7;18126.0;6678.0;24804.0
160060;201805;6437;3387;3050;3221454.8;2908742.2;6130197.0
160070;201805;165;100;65;95400.0;62010.0;157410.0
160080;201805;78;41;37;39114.0;35298.0;74412.0
170025;201805;24;15;9;14310.0;8586.0;22896.0
170030;201805;228;186;42;177247.0;40068.0;217315.0
170035;201805;227;109;118;103986.0;112572.0;216558.0
170040;201805;189;146;43;138997.8;41022.0;180019.8
170070;201805;321;193;128;184122.0;122112.0;306234.0
170100;201805;372;269;103;256626.0;98262.0;354888.0
170105;201805;62;51;11;48654.0;10494.0;59148.0
170110;201805;103;63;40;60102.0;38160.0;98262.0
170130;201805;69;32;37;30528.0;35012.0;65540.0
170190;201805;102;67;35;63918.0;33390.0;97308.0
170200;201805;391;261;130;248317.2;123915.76;372232.97
170210;201805;6004;3143;2861;2990612.8;2726132.8;5716745.5
170215;201805;97;46;51;43884.0;48654.0;92538.0
170220;201805;1412;1042;370;992827.8;352694.0;1345521.8
170230;201805;154;101;53;96354.0;50562.0;146916.0
170240;201805;542;356;186;339624.0;177444.0;517068.0
170255;201805;1108;889;219;847896.1;208639.8;1056535.9
170270;201805;37;28;9;26712.0;8395.2;35107.2
170290;201805;80;59;21;56286.0;20034.0;76320.0
170300;201805;82;54;28;50752.8;26712.0;77464.8
170305;201805;44;34;10;32436.0;9540.0;41976.0
170307;201805;63;47;16;44838.0;15264.0;60102.0
170310;201805;103;56;47;53424.0;44838.0;98262.0
170320;201805;18;14;4;13356.0;3816.0;17172.0
170330;201805;21;19;2;18126.0;1908.0;20034.0
170360;201805;23;13;10;12402.0;9540.0;21942.0
170370;201805;122;64;58;61056.0;55332.0;116388.0
170380;201805;80;59;21;56286.0;20034.0;76320.0
170382;201805;45;40;5;38160.0;4770.0;42930.0
170384;201805;131;96;35;91584.0;33390.0;124974.0
170386;201805;61;27;34;25758.0;32436.0;58194.0
170388;201805;48;18;30;17172.0;28620.0;45792.0
170389;201805;23;18;5;17172.0;4770.0;21942.0
170390;201805;56;32;24;30528.0;22896.0;53424.0
170410;201805;35;24;11;22896.0;10494.0;33390.0
170460;201805;17;13;4;12402.0;3816.0;16218.0
170510;201805;29;22;7;20988.0;6678.0;27666.0
170550;201805;1492;849;643;809946.0;612659.0;1422605.0
170555;201805;115;80;35;76320.0;33390.0;109710.0
170560;201805;98;71;27;67734.0;25758.0;93492.0
170600;201805;40;19;21;18126.0;20034.0;38160.0
170610;201805;191;102;89;97150.59;84888.0;182038.6
170625;201805;38;20;18;19080.0;17172.0;36252.0
170650;201805;85;64;21;61056.0;20034.0;81090.0
170700;201805;558;424;134;403256.3;127836.0;531092.3
170710;201805;156;96;60;91584.0;57231.0;148815.0
170720;201805;86;70;16;66780.0;15264.0;82044.0
170730;201805;60;36;24;34344.0;22896.0;57240.0
170740;201805;78;56;22;53424.0;20988.0;74412.0
170755;201805;70;37;33;34678.0;31482.0;66160.0
170765;201805;139;68;71;64252.0;67734.0;131986.0
170770;201805;225;132;93;124830.9;88722.0;213552.9
170820;201805;597;388;209;370152.0;198957.0;569109.0
170825;201805;32;20;12;19080.0;11448.0;30528.0
170830;201805;79;59;20;56095.2;19080.0;75175.2
170900;201805;201;153;48;145962.0;45792.0;191754.0
170930;201805;821;427;394;407034.0;375304.0;782338.0
170950;201805;3042;1322;1720;1260216.2;1638572.5;2898788.8
170980;201805;18;10;8;9540.0;7632.0;17172.0
171050;201805;135;105;30;100170.0;28620.0;128790.0
171070;201805;38;31;7;29574.0;6678.0;36252.0
171090;201805;39;29;10;27666.0;9540.0;37206.0
171110;201805;21;14;7;13356.0;6678.0;20034.0
171150;201805;39;18;21;17172.0;20034.0;37206.0
171180;201805;21;10;11;9540.0;10494.0;20034.0
171190;201805;139;82;57;78228.0;54378.0;132606.0
171195;201805;64;49;15;46746.0;14310.0;61056.0
171200;201805;47;20;27;19080.0;25758.0;44838.0
171215;201805;3;3;0;2862.0;0.0;2862.0
171240;201805;54;44;10;41976.0;9540.0;51516.0
171245;201805;53;48;5;45792.0;4770.0;50562.0
171250;201805;72;38;34;36252.0;32426.46;68678.46
171270;201805;17;13;4;12402.0;3816.0;16218.0
171280;201805;39;36;3;34201.0;2862.0;37063.0
171320;201805;993;562;431;536148.0;409993.94;946141.94
171330;201805;422;203;219;193662.0;208926.0;402588.0
171360;201805;88;64;24;61056.0;22896.0;83952.0
171370;201805;24;13;11;12402.0;10494.0;22896.0
171380;201805;137;111;26;105894.0;24804.0;130698.0
171395;201805;54;33;21;31482.0;20034.0;51516.0
171420;201805;306;203;103;193662.0;97975.8;291637.8
171430;201805;66;53;13;50562.0;12402.0;62964.0
171488;201805;200;106;94;101124.0;89676.0;190800.0
171500;201805;59;32;27;30528.0;25758.0;56286.0
171510;201805;68;45;23;42930.0;21942.0;64872.0
171515;201805;44;37;7;35298.0;6392.0;41690.0
171525;201805;31;26;5;24804.0;4770.0;29574.0
171550;201805;13;7;6;6678.0;5724.0;12402.0
171570;201805;62;30;32;28620.0;30528.0;59148.0
171575;201805;340;211;129;201294.0;123056.46;324350.47
171610;201805;1710;860;850;818541.0;809351.7;1627892.6
171620;201805;131;92;39;87214.68;37206.0;124420.68
171630;201805;50;27;23;25758.0;21942.0;47700.0
171650;201805;272;179;93;170766.0;88722.0;259488.0
171660;201805;264;141;123;134514.0;117338.0;251852.0
171665;201805;48;32;16;30528.0;15264.0;45792.0
171670;201805;428;249;179;234627.27;170193.6;404820.88
171700;201805;63;55;8;52470.0;7632.0;60102.0
171720;201805;25;8;17;7632.0;16218.0;23850.0
171750;201805;101;54;47;51516.0;44838.0;96354.0
171780;201805;73;59;14;56286.0;13356.0;69642.0
171790;201805;78;65;13;61628.4;12402.0;74030.4
171800;201805;34;26;8;24804.0;7632.0;32436.0
171820;201805;2068;1168;900;1112659.8;853992.8;1966652.5
171830;201805;37;29;8;27666.0;7632.0;35298.0
171840;201805;64;37;27;35298.0;25758.0;61056.0
171845;201805;31;20;11;19080.0;10494.0;29574.0
171850;201805;40;29;11;27666.0;10494.0;38160.0
171855;201805;78;61;17;58194.0;16218.0;74412.0
171865;201805;8;7;1;6678.0;954.0;7632.0
171870;201805;31;22;9;20988.0;8586.0;29574.0
171875;201805;78;53;25;50562.0;23850.0;74412.0
171880;201805;29;21;8;20034.0;7632.0;27666.0
171884;201805;46;23;23;21942.0;21942.0;43884.0
171886;201805;117;42;75;40068.0;71263.8;111331.8
171888;201805;24;18;6;17172.0;5724.0;22896.0
171889;201805;19;15;4;14310.0;3816.0;18126.0
171890;201805;56;46;10;43884.0;9540.0;53424.0
171900;201805;42;29;13;27666.0;12402.0;40068.0
172000;201805;39;33;6;31482.0;5724.0;37206.0
172010;201805;41;35;6;32579.1;5724.0;38303.1
172015;201805;26;16;10;15264.0;9253.8;24517.8
172020;201805;131;83;48;79182.0;45792.0;124974.0
172025;201805;32;21;11;20034.0;10494.0;30528.0
172030;201805;34;19;15;18126.0;14310.0;32436.0
172049;201805;73;44;29;41976.0;27666.0;69642.0
172065;201805;148;97;51;92488.0;48654.0;141142.0
172080;201805;91;65;26;60827.84;24804.0;85631.84
172085;201805;25;12;13;11448.0;12402.0;23850.0
172090;201805;402;308;94;293832.0;88913.0;382745.0
172093;201805;24;18;6;17172.0;5724.0;22896.0
172097;201805;17;8;9;7632.0;8300.0;15932.0
172100;201805;4726;2652;2074;2524809.8;1976127.0;4500937.0
172110;201805;81;54;27;51516.0;25758.0;77274.0
172120;201805;1720;1475;245;1401033.6;233346.5;1634380.1
172125;201805;4;4;0;3816.0;0.0;3816.0
172130;201805;17;13;4;12402.0;3816.0;16218.0
172208;201805;193;123;70;117342.0;66780.0;184122.0
172210;201805;422;206;216;196524.0;205778.0;402302.0
210005;201805;2932;1829;1103;1741813.2;1049402.0;2791215.2
210010;201805;190;98;92;93492.0;87768.0;181260.0
210015;201805;31;21;10;20034.0;9540.0;29574.0
210020;201805;346;182;164;173628.0;156456.0;330084.0
210030;201805;347;217;130;207018.0;124011.0;331029.0
210040;201805;154;119;35;113526.0;33390.0;146916.0
210043;201805;256;172;84;164088.0;80136.0;244224.0
210047;201805;599;316;283;301082.4;269972.47;571054.9
210050;201805;300;220;80;209880.0;76320.0;286200.0
210055;201805;42;32;10;30528.0;9540.0;40068.0
210060;201805;560;441;119;420614.78;113526.0;534140.8
210070;201805;413;303;110;289062.0;104940.0;394002.0
210080;201805;102;94;8;89676.0;7632.0;97308.0
210083;201805;305;132;173;125928.0;165042.0;290970.0
210087;201805;42;31;11;29574.0;10494.0;40068.0
210090;201805;490;339;151;323406.0;144054.0;467460.0
210095;201805;487;356;131;339614.47;124974.0;464588.47
210100;201805;691;527;164;502424.1;155502.02;657926.1
210110;201805;148;82;66;78228.0;62964.0;141192.0
210120;201805;5445;4092;1353;3896562.0;1289508.6;5186070.5
210125;201805;215;124;91;118296.0;86814.0;205110.0
210130;201805;547;286;261;271890.0;248974.92;520864.9
210135;201805;34;20;14;19080.0;13356.0;32436.0
210140;201805;4390;3443;947;3281845.5;903200.0;4185045.5
210150;201805;361;229;132;218466.0;125928.0;344394.0
210160;201805;3375;2837;538;2703638.8;512966.0;3216604.8
210170;201805;1131;883;248;842382.0;236592.0;1078974.0
210173;201805;124;103;21;98262.0;20034.0;118296.0
210177;201805;461;224;237;213696.0;226098.0;439794.0
210180;201805;32;17;15;16218.0;14310.0;30528.0
210190;201805;416;264;152;251856.0;145008.0;396864.0
210193;201805;1;1;0;954.0;0.0;954.0
210197;201805;83;54;29;51516.0;27647.88;79163.88
210200;201805;640;506;134;482724.0;127836.0;610560.0
210203;201805;259;173;86;165042.0;82044.0;247086.0
210207;201805;383;297;86;283338.0;82044.0;365382.0
210210;201805;774;706;68;673524.0;64872.0;738396.0
210215;201805;77;65;12;62010.0;11448.0;73458.0
210220;201805;394;323;71;308142.0;67447.8;375589.8
210230;201805;304;231;73;220374.0;69642.0;290016.0
210232;201805;1466;931;535;887888.0;510390.0;1398278.0
210235;201805;155;121;34;115244.0;32436.0;147680.0
210237;201805;46;25;21;23850.0;20034.0;43884.0
210240;201805;92;75;17;71550.0;16218.0;87768.0
210250;201805;185;149;36;142146.0;34344.0;176490.0
210255;201805;348;257;91;245178.0;86814.0;331992.0
210260;201805;419;266;153;253764.0;145962.0;399726.0
210270;201805;691;439;252;418806.0;240408.0;659214.0
210275;201805;50;39;11;37206.0;10494.0;47700.0
210280;201805;1036;663;373;629687.3;354506.5;984193.8
210290;201805;502;327;175;311958.0;166950.0;478908.0
210300;201805;6081;3541;2540;3372905.2;2421968.2;5794873.5
210310;201805;105;72;33;68688.0;31482.0;100170.0
210312;201805;127;81;46;77274.0;43884.0;121158.0
210315;201805;116;85;31;81090.0;29574.0;110664.0
210317;201805;126;89;37;84906.0;35298.0;120204.0
210320;201805;2391;1971;420;1878623.9;400680.0;2279303.8
210325;201805;128;88;40;82998.0;37874.0;120872.0
210330;201805;5472;2823;2649;2688319.8;2527136.5;5215456.0
210340;201805;1391;999;392;952246.0;373897.06;1326143.1
210350;201805;615;505;110;481531.5;104940.0;586471.5
210355;201805;133;106;27;101124.0;25758.0;126882.0
210360;201805;2637;1653;984;1573815.6;938450.0;2512265.5
210370;201805;1242;545;697;519930.0;664938.0;1184868.0
210375;201805;186;96;90;91041.0;85860.0;176901.0
210380;201805;733;546;187;520884.0;178398.0;699282.0
210390;201805;205;168;37;160272.0;35298.0;195570.0
210400;201805;418;352;66;335808.0;62945.0;398753.0
210405;201805;1018;685;333;653490.0;317682.0;971172.0
210407;201805;56;44;12;41976.0;11448.0;53424.0
210408;201805;65;58;7;55332.0;6678.0;62010.0
210409;201805;320;267;53;254718.0;50562.0;305280.0
210410;201805;438;339;99;323406.0;94437.0;417843.0
210420;201805;192;157;35;149778.0;33390.0;183168.0
210430;201805;37;27;10;25758.0;9540.0;35298.0
210440;201805;376;228;148;217512.0;141192.0;358704.0
210450;201805;148;110;38;104940.0;36252.0;141192.0
210455;201805;224;123;101;117342.0;96354.0;213696.0
210460;201805;346;219;127;208926.0;121158.0;330084.0
210462;201805;63;53;10;50562.0;9540.0;60102.0
210465;201805;174;125;49;119250.0;46746.0;165996.0
210467;201805;528;378;150;360612.0;143100.0;503712.0
210470;201805;45;34;11;32436.0;10494.0;42930.0
210480;201805;1313;930;383;887220.0;365382.0;1252602.0
210490;201805;223;135;88;128790.0;83952.0;212742.0
210500;201805;579;303;276;289062.0;263304.0;552366.0
210510;201805;552;430;122;410220.0;116388.0;526608.0
210515;201805;441;241;200;229914.0;190800.0;420714.0
210520;201805;406;355;51;338383.8;48654.0;387037.8
210530;201805;9410;5044;4366;4798873.5;4159332.0;8958206.0
210535;201805;131;93;38;88722.0;36252.0;124974.0
210540;201805;1545;935;610;890845.8;580509.0;1471354.8
210542;201805;1180;589;591;561524.4;563242.0;1124766.4
210545;201805;13;12;1;11448.0;954.0;12402.0
210547;201805;135;115;20;109710.0;19080.0;128790.0
210550;201805;739;519;220;493578.0;209880.0;703458.0
210560;201805;176;147;29;140238.0;27666.0;167904.0
210565;201805;30;21;9;20034.0;8586.0;28620.0
210570;201805;1367;1073;294;1023642.0;280476.0;1304118.0
210580;201805;105;92;13;87768.0;12402.0;100170.0
210590;201805;769;603;166;574498.8;158364.0;732862.8
210592;201805;31;27;4;25758.0;3816.0;29574.0
210594;201805;104;85;19;81090.0;18126.0;99216.0
210596;201805;86;71;15;67734.0;14310.0;82044.0
210598;201805;125;91;34;86814.0;32436.0;119250.0
210600;201805;334;282;52;269028.0;49608.0;318636.0
210610;201805;251;232;19;220374.0;18126.0;238500.0
210620;201805;47;27;20;25758.0;19080.0;44838.0
210630;201805;59;57;2;54378.0;1908.0;56286.0
210632;201805;1105;733;372;699282.0;354411.0;1053693.0
210635;201805;17;14;3;13356.0;2862.0;16218.0
210637;201805;106;74;32;70596.0;30528.0;101124.0
210640;201805;588;515;73;491310.0;69642.0;560952.0
210650;201805;406;328;78;311986.62;73458.0;385444.62
210660;201805;401;289;112;275039.0;106724.0;381763.0
210663;201805;18;11;7;10494.0;6678.0;17172.0
210667;201805;115;37;78;35298.0;74412.0;109710.0
210670;201805;269;236;33;224429.0;31482.0;255911.0
210675;201805;573;297;276;283338.0;263304.0;546642.0
210680;201805;211;130;81;124020.0;77274.0;201294.0
210690;201805;643;507;136;483678.0;129744.0;613422.0
210700;201805;192;142;50;135468.0;47700.0;183168.0
210710;201805;300;167;133;159127.2;126882.0;286009.2
210720;201805;128;107;21;102078.0;20034.0;122112.0
210725;201805;69;60;9;57240.0;8586.0;65826.0
210730;201805;24;18;6;17172.0;5724.0;22896.0
210735;201805;416;278;138;265212.0;131366.0;396578.0
210740;201805;550;462;88;440748.0;83952.0;524700.0
210745;201805;152;110;42;104940.0;40068.0;145008.0
210750;201805;2423;1097;1326;1044583.0;1264984.9;2309568.0
210760;201805;271;198;73;188892.0;69627.69;258519.69
210770;201805;407;314;93;299556.0;88435.8;387991.8
210780;201805;423;304;119;290016.0;113526.0;403542.0
210790;201805;187;145;42;138330.0;40068.0;178398.0
210800;201805;144;106;38;101124.0;36252.0;137376.0
210805;201805;43;39;4;37206.0;3816.0;41022.0
210810;201805;484;371;113;353266.2;107802.0;461068.2
210820;201805;2324;1842;482;1748823.4;459828.0;2208651.5
210825;201805;176;91;85;86814.0;81090.0;167904.0
210830;201805;797;488;309;464598.0;293832.0;758430.0
210840;201805;214;143;71;136422.0;67734.0;204156.0
210845;201805;255;161;94;153594.0;89676.0;243270.0
210850;201805;850;538;312;513252.0;297648.0;810900.0
210860;201805;4142;2134;2008;2034310.2;1915326.8;3949637.0
210870;201805;468;353;115;336762.0;109710.0;446472.0
210880;201805;59;40;19;38160.0;18126.0;56286.0
210890;201805;345;287;58;273798.0;55332.0;329130.0
210900;201805;581;378;203;360608.0;193662.0;554270.0
210905;201805;71;35;36;33390.0;34344.0;67734.0
210910;201805;2010;1487;523;1417308.0;498942.0;1916250.0
210920;201805;232;69;163;65826.0;155502.0;221328.0
210923;201805;81;57;24;54378.0;22896.0;77274.0
210927;201805;437;182;255;173628.0;243270.0;416898.0
210930;201805;63;49;14;46746.0;13356.0;60102.0
210940;201805;94;71;23;67734.0;21942.0;89676.0
210945;201805;193;88;105;83952.0;100170.0;184122.0
210950;201805;516;370;146;352980.0;139279.23;492259.22
210955;201805;76;49;27;46746.0;25758.0;72504.0
210960;201805;2452;1045;1407;995308.4;1341992.0;2337300.5
210970;201805;114;98;16;93492.0;15264.0;108756.0
210975;201805;92;82;10;78228.0;9540.0;87768.0
210980;201805;1236;532;704;507413.53;671330.0;1178743.5
210990;201805;4352;2706;1646;2580423.2;1570284.0;4150707.2
211000;201805;1379;1091;288;1040528.0;274465.8;1314993.8
211003;201805;925;628;297;599112.0;283329.0;882441.0
211010;201805;488;430;58;410220.0;55332.0;465552.0
211020;201805;1613;585;1028;558090.0;980492.56;1538582.6
211023;201805;28;24;4;22609.8;3816.0;26425.8
211027;201805;63;41;22;39114.0;20988.0;60102.0
211030;201805;386;259;127;247086.0;121158.0;368244.0
211040;201805;324;247;77;235352.0;73458.0;308810.0
211050;201805;1176;749;427;714526.94;407067.22;1121594.1
211060;201805;687;581;106;552079.8;101124.0;653203.8
211065;201805;22;18;4;17172.0;3816.0;20988.0
211070;201805;924;750;174;713888.75;165996.0;879884.75
211080;201805;88;84;4;80136.0;3816.0;83952.0
211085;201805;60;32;28;30242.0;26712.0;56954.0
211090;201805;91;73;18;69642.0;17172.0;86814.0
211100;201805;507;406;101;386083.8;96354.0;482437.8
211102;201805;262;174;88;165996.0;83952.0;249948.0
211105;201805;224;151;73;144054.0;69642.0;213696.0
211107;201805;137;79;58;75366.0;55332.0;130698.0
211110;201805;822;525;297;500278.0;283329.0;783607.0
211120;201805;5795;2468;3327;2349094.5;3172866.2;5521961.0
211125;201805;36;28;8;26712.0;7632.0;34344.0
211130;201805;45817;19228;26589;1,83E+14;2,54E+14;4,37E+14
211140;201805;426;359;67;341528.0;63918.0;405446.0
211150;201805;1266;799;467;761912.1;445228.0;1207140.1
211153;201805;167;97;70;92538.0;66780.0;159318.0
211157;201805;63;47;16;44838.0;15264.0;60102.0
211160;201805;708;589;119;561190.5;113526.0;674716.5
211163;201805;0;0;0;0.0;0.0;0.0
211167;201805;8;6;2;5724.0;1908.0;7632.0
211170;201805;446;310;136;295740.0;129744.0;425484.0
211172;201805;122;85;37;81090.0;35298.0;116388.0
211174;201805;277;163;114;155502.0;108756.0;264258.0
211176;201805;517;372;145;354888.0;138330.0;493218.0
211178;201805;95;61;34;58194.0;32436.0;90630.0
211180;201805;208;162;46;154548.0;43721.82;198269.81
211190;201805;65;60;5;57240.0;4770.0;62010.0
211195;201805;25;16;9;15264.0;8586.0;23850.0
211200;201805;157;136;21;129400.56;20034.0;149434.56
211210;201805;530;330;200;314152.2;190800.0;504952.2
211220;201805;3999;2253;1746;2141519.5;1659347.0;3800866.5
211223;201805;97;90;7;85678.74;6678.0;92356.74
211227;201805;68;47;21;44838.0;20034.0;64872.0
211230;201805;783;637;146;607554.9;139264.92;746819.8
211240;201805;418;314;104;299556.0;99216.0;398772.0
211245;201805;207;92;115;87768.0;109710.0;197478.0
211250;201805;1646;1405;241;1339378.1;229914.0;1569292.1
211260;201805;828;648;180;618192.0;171720.0;789912.0
211270;201805;2083;1638;445;1562652.0;423576.2;1986228.2
211280;201805;1834;1097;737;1045584.8;703098.0;1748682.8
211285;201805;206;121;85;115434.0;81090.0;196524.0
211290;201805;689;460;229;438649.2;218466.0;657115.2
211300;201805;808;619;189;590248.06;180306.0;770554.06
211400;201805;1596;902;694;860508.0;662076.0;1522584.0
220005;201805;18;17;1;16218.0;954.0;17172.0
220010;201805;87;66;21;62964.0;19747.8;82711.8
220020;201805;619;487;132;463613.03;125928.0;589541.06
220025;201805;107;103;4;98262.0;3816.0;102078.0
220027;201805;35;28;7;26712.0;6678.0;33390.0
220030;201805;100;82;18;78228.0;17172.0;95400.0
220040;201805;1138;859;279;818322.94;266166.0;1084489.0
220045;201805;38;28;10;26712.0;9540.0;36252.0
220050;201805;653;535;118;509228.97;112552.92;621781.9
220060;201805;173;147;26;140238.0;24804.0;165042.0
220070;201805;99;90;9;85860.0;8586.0;94446.0
220080;201805;11;10;1;9540.0;954.0;10494.0
220090;201805;36;29;7;27380.0;6678.0;34058.0
220095;201805;2;1;1;954.0;954.0;1908.0
220100;201805;28;24;4;22896.0;3816.0;26712.0
220105;201805;26;24;2;22324.0;1908.0;24232.0
220110;201805;208;192;16;182881.8;15264.0;198145.8
220115;201805;50;47;3;44838.0;2862.0;47700.0
220117;201805;20;18;2;17172.0;1908.0;19080.0
220120;201805;1533;1065;468;1014808.94;446452.9;1461261.9
220130;201805;26;25;1;23850.0;954.0;24804.0
220140;201805;99;78;21;73458.0;20034.0;93492.0
220150;201805;456;325;131;310050.0;124974.0;435024.0
220155;201805;4;4;0;3816.0;0.0;3816.0
220157;201805;18;15;3;14310.0;2862.0;17172.0
220160;201805;70;60;10;57240.0;9540.0;66780.0
220170;201805;35;33;2;31482.0;1908.0;33390.0
220173;201805;7;7;0;6678.0;0.0;6678.0
220177;201805;6;5;1;4770.0;954.0;5724.0
220180;201805;63;62;1;59143.23;668.0;59811.23
220190;201805;1054;943;111;899622.0;105894.0;1005516.0
220191;201805;42;37;5;35298.0;4770.0;40068.0
220192;201805;63;60;3;57240.0;2862.0;60102.0
220194;201805;36;32;4;30528.0;3816.0;34344.0
220196;201805;102;84;18;80136.0;17172.0;97308.0
220198;201805;7;5;2;4770.0;1908.0;6678.0
220200;201805;435;356;79;340356.0;75366.0;415722.0
220202;201805;37;33;4;31482.0;3816.0;35298.0
220205;201805;41;35;6;33390.0;5724.0;39114.0
220207;201805;18;17;1;16218.0;954.0;17172.0
220208;201805;85;44;41;41976.0;39114.0;81090.0
220209;201805;31;28;3;26712.0;2862.0;29574.0
220210;201805;15;13;2;12402.0;1908.0;14310.0
220211;201805;28;28;0;26712.0;0.0;26712.0
220213;201805;42;38;4;36252.0;3530.0;39782.0
220217;201805;36;28;8;26712.0;7632.0;34344.0
220220;201805;2044;1303;741;1239456.6;705511.94;1944968.6
220225;201805;16;8;8;7632.0;7632.0;15264.0
220230;201805;944;744;200;709327.6;190160.81;899488.44
220240;201805;146;133;13;126882.0;12402.0;139284.0
220245;201805;34;31;3;28871.04;2862.0;31733.04
220250;201805;110;99;11;94446.0;10494.0;104940.0
220253;201805;44;37;7;35298.0;6678.0;41976.0
220255;201805;28;25;3;23850.0;2862.0;26712.0
220260;201805;685;497;188;474138.0;179352.0;653490.0
220265;201805;18;15;3;14310.0;2862.0;17172.0
220270;201805;683;603;80;574536.94;75843.0;650379.94
220271;201805;45;37;8;35298.0;7632.0;42930.0
220272;201805;27;26;1;24804.0;954.0;25758.0
220273;201805;14;12;2;11448.0;1908.0;13356.0
220275;201805;59;48;11;45792.0;10494.0;56286.0
220277;201805;12;10;2;9540.0;1908.0;11448.0
220280;201805;15;12;3;11448.0;2862.0;14310.0
220285;201805;41;38;3;36252.0;2862.0;39114.0
220290;201805;1388;1185;203;1127198.8;193615.0;1320813.8
220300;201805;53;52;1;49608.0;954.0;50562.0
220310;201805;317;265;52;252806.0;49599.0;302405.0
220320;201805;440;405;35;384940.0;33390.0;418330.0
220323;201805;0;0;0;0.0;0.0;0.0
220325;201805;16;11;5;10494.0;4770.0;15264.0
220327;201805;12;11;1;10494.0;954.0;11448.0
220330;201805;207;141;66;134514.0;62964.0;197478.0
220335;201805;139;121;18;115434.0;17172.0;132606.0
220340;201805;25;15;10;14310.0;9540.0;23850.0
220342;201805;56;48;8;45792.0;7632.0;53424.0
220345;201805;84;76;8;72504.0;7632.0;80136.0
220350;201805;433;376;57;356081.4;54378.0;410459.4
220360;201805;43;31;12;29574.0;11448.0;41022.0
220370;201805;1139;912;227;869284.8;216271.8;1085556.6
220375;201805;26;24;2;22896.0;1908.0;24804.0
220380;201805;38;31;7;29574.0;6678.0;36252.0
220385;201805;28;24;4;22896.0;3816.0;26712.0
220390;201805;2242;1275;967;1211656.5;921224.5;2132881.0
220400;201805;28;26;2;24804.0;1908.0;26712.0
220410;201805;16;15;1;14310.0;954.0;15264.0
220415;201805;13;12;1;11448.0;954.0;12402.0
220420;201805;123;102;21;97308.0;19747.8;117055.8
220430;201805;129;117;12;109949.8;11448.0;121397.8
220435;201805;21;15;6;14305.23;5724.0;20029.23
220440;201805;292;249;43;237546.0;41022.0;278568.0
220450;201805;337;170;167;161014.98;159318.0;320332.97
220455;201805;55;53;2;50562.0;1908.0;52470.0
220460;201805;17;17;0;15550.2;0.0;15550.2
220465;201805;107;69;38;65826.0;36252.0;102078.0
220470;201805;242;213;29;203202.0;27666.0;230868.0
220480;201805;70;59;11;56286.0;10494.0;66780.0
220490;201805;87;75;12;71550.0;11448.0;82998.0
220500;201805;95;83;12;79182.0;11448.0;90630.0
220510;201805;383;303;80;288299.0;76129.2;364428.2
220515;201805;21;17;4;16218.0;3816.0;20034.0
220520;201805;373;335;38;318275.0;36233.0;354508.0
220525;201805;26;18;8;17172.0;7632.0;24804.0
220527;201805;36;27;9;25758.0;7776.0;33534.0
220530;201805;35;14;21;13356.0;20034.0;33390.0
220535;201805;8;8;0;7632.0;0.0;7632.0
220540;201805;62;50;12;47700.0;11448.0;59148.0
220545;201805;58;39;19;37206.0;18126.0;55332.0
220550;201805;646;493;153;469558.8;145962.0;615520.8
220551;201805;27;20;7;19080.0;6678.0;25758.0
220552;201805;7;7;0;6678.0;0.0;6678.0
220553;201805;48;43;5;41022.0;4770.0;45792.0
220554;201805;13;8;5;7345.8;4770.0;12115.8
220555;201805;24;20;4;19080.0;3816.0;22896.0
220556;201805;54;50;4;47700.0;3816.0;51516.0
220557;201805;57;51;6;48654.0;5724.0;54378.0
220558;201805;7;2;5;1908.0;4770.0;6678.0
220559;201805;6;5;1;4770.0;954.0;5724.0
220560;201805;57;36;21;34153.2;20034.0;54187.2
220570;201805;800;482;318;458624.12;303372.0;761996.1
220580;201805;559;513;46;489402.0;43197.92;532599.94
220585;201805;6;5;1;4770.0;954.0;5724.0
220590;201805;14;14;0;13356.0;0.0;13356.0
220595;201805;57;43;14;41022.0;13356.0;54378.0
220600;201805;23;12;11;11448.0;10494.0;21942.0
220605;201805;20;19;1;18126.0;954.0;19080.0
220610;201805;62;53;9;50562.0;8586.0;59148.0
220620;201805;557;436;121;415705.5;115434.0;531139.5
220630;201805;6;4;2;3816.0;1908.0;5724.0
220635;201805;38;34;4;32436.0;3816.0;36252.0
220640;201805;98;77;21;73458.0;20034.0;93492.0
220650;201805;116;110;6;104940.0;5724.0;110664.0
220660;201805;32;26;6;24804.0;5724.0;30528.0
220665;201805;4;4;0;3816.0;0.0;3816.0
220667;201805;16;13;3;12402.0;2862.0;15264.0
220669;201805;26;23;3;21942.0;2862.0;24804.0
220670;201805;71;55;16;52279.2;15264.0;67543.2
220672;201805;65;44;21;41976.0;20034.0;62010.0
220675;201805;36;28;8;26712.0;7632.0;34344.0
220680;201805;35;29;6;27666.0;5724.0;33390.0
220690;201805;45;43;2;41022.0;1908.0;42930.0
220695;201805;58;27;31;25758.0;29574.0;55332.0
220700;201805;1552;1189;363;1132464.8;346302.0;1478766.8
220710;201805;5;3;2;2862.0;1908.0;4770.0
220720;201805;110;90;20;85621.5;18936.9;104558.4
220730;201805;19;18;1;17172.0;954.0;18126.0
220735;201805;3;1;2;954.0;1908.0;2862.0
220740;201805;46;41;5;39114.0;4770.0;43884.0
220750;201805;98;80;18;76320.0;17172.0;93492.0
220755;201805;14;14;0;13356.0;0.0;13356.0
220760;201805;53;50;3;47700.0;2862.0;50562.0
220770;201805;5826;2932;2894;2791918.8;2754739.5;5546658.0
220775;201805;24;10;14;9540.0;13356.0;22896.0
220777;201805;16;15;1;14310.0;954.0;15264.0
220779;201805;18;14;4;13356.0;3816.0;17172.0
220780;201805;877;750;127;714832.2;120872.0;835704.2
220785;201805;13;7;6;6678.0;5724.0;12402.0
220790;201805;1015;807;208;767476.0;198432.0;965908.0
220793;201805;13;13;0;12402.0;0.0;12402.0
220795;201805;22;21;1;20034.0;954.0;20988.0
220800;201805;3954;3022;932;2881349.2;887920.9;3769270.2
220810;201805;60;53;7;50562.0;6678.0;57240.0
220820;201805;242;220;22;209880.0;20988.0;230868.0
220830;201805;1176;997;179;951133.25;170747.0;1121880.2
220840;201805;2443;1622;821;1534609.4;781136.0;2315745.2
220850;201805;53;44;9;41976.0;8586.0;50562.0
220855;201805;14;9;5;8586.0;4770.0;13356.0
220860;201805;8;7;1;6678.0;954.0;7632.0
220865;201805;23;21;2;20034.0;1908.0;21942.0
220870;201805;61;59;2;56286.0;1908.0;58194.0
220880;201805;318;243;75;231154.2;71264.0;302418.2
220885;201805;46;43;3;41022.0;2862.0;43884.0
220887;201805;19;18;1;17172.0;954.0;18126.0
220890;201805;101;89;12;84906.0;11448.0;96354.0
220900;201805;48;27;21;25758.0;20034.0;45792.0
220910;201805;53;45;8;42930.0;7632.0;50562.0
220915;201805;10;9;1;8586.0;954.0;9540.0
220920;201805;41;37;4;35298.0;3816.0;39114.0
220930;201805;41;40;1;38160.0;954.0;39114.0
220935;201805;15;15;0;14310.0;0.0;14310.0
220937;201805;43;40;3;38160.0;2862.0;41022.0
220940;201805;52;48;4;45792.0;3816.0;49608.0
220945;201805;0;0;0;0.0;0.0;0.0
220950;201805;47;43;4;41022.0;3816.0;44838.0
220955;201805;34;30;4;28620.0;3816.0;32436.0
220960;201805;1;1;0;954.0;0.0;954.0
220965;201805;30;27;3;25758.0;2862.0;28620.0
220970;201805;47;40;7;38160.0;6678.0;44838.0
220975;201805;9;8;1;7632.0;954.0;8586.0
220980;201805;34;32;2;30528.0;1908.0;32436.0
220985;201805;65;58;7;55332.0;6678.0;62010.0
220987;201805;31;30;1;28620.0;954.0;29574.0
220990;201805;15;14;1;13356.0;954.0;14310.0
220995;201805;37;32;5;30528.0;4770.0;35298.0
220997;201805;46;38;8;36252.0;7632.0;43884.0
221000;201805;1134;1018;116;967739.6;110377.8;1078117.4
221005;201805;61;55;6;52470.0;5724.0;58194.0
221010;201805;17;14;3;13356.0;2862.0;16218.0
221020;201805;45;43;2;41022.0;1908.0;42930.0
221030;201805;30;24;6;22896.0;5724.0;28620.0
221035;201805;19;19;0;18126.0;0.0;18126.0
221037;201805;12;6;6;5724.0;5724.0;11448.0
221038;201805;25;23;2;21942.0;1908.0;23850.0
221039;201805;23;23;0;21942.0;0.0;21942.0
221040;201805;259;223;36;212742.0;34344.0;247086.0
221050;201805;234;197;37;187938.0;35298.0;223236.0
221060;201805;1735;1525;210;1453334.8;200340.0;1653674.8
221062;201805;28;27;1;25758.0;954.0;26712.0
221063;201805;14;10;4;9540.0;3816.0;13356.0
221065;201805;50;43;7;41022.0;6678.0;47700.0
221070;201805;140;121;19;115434.0;18126.0;133560.0
221080;201805;374;332;42;316728.0;39781.8;356509.8
221090;201805;36;35;1;33390.0;954.0;34344.0
221093;201805;56;37;19;35298.0;18126.0;53424.0
221095;201805;11;10;1;9540.0;954.0;10494.0
221097;201805;20;17;3;16218.0;2862.0;19080.0
221100;201805;24724;14231;10493;1,36E+14;1,00E+14;2,36E+14
221110;201805;1039;762;277;726662.0;264258.0;990920.0
221120;201805;528;392;136;373682.0;129744.0;503426.0
221130;201805;946;772;174;735248.8;165996.0;901244.8
221135;201805;36;33;3;31482.0;2862.0;34344.0
221140;201805;40;32;8;30528.0;7632.0;38160.0
221150;201805;14;11;3;10494.0;2862.0;13356.0
221160;201805;13;13;0;12402.0;0.0;12402.0
221170;201805;13;13;0;12402.0;0.0;12402.0
230010;201805;165;152;13;145008.0;12402.0;157410.0
230015;201805;119;99;20;94446.0;19080.0;113526.0
230020;201805;1566;1333;233;1268753.9;221394.88;1490148.8
230030;201805;1630;1172;458;1112519.0;436932.0;1549451.0
230040;201805;203;179;24;169573.5;22896.0;192469.5
230050;201805;208;152;56;145008.0;53424.0;198432.0
230060;201805;153;126;27;119440.8;25758.0;145198.8
230070;201805;279;249;30;237546.0;28620.0;266166.0
230075;201805;811;706;105;671521.0;99883.8;771404.8
230080;201805;180;155;25;147870.0;23850.0;171720.0
230090;201805;100;68;32;64108.8;30528.0;94636.8
230100;201805;1939;1152;787;1096721.0;750798.0;1847519.0
230110;201805;2645;1693;952;1612723.4;907635.8;2520359.2
230120;201805;944;751;193;714070.25;184103.0;898173.25
230125;201805;139;114;25;108756.0;23850.0;132606.0
230130;201805;464;416;48;396864.0;45792.0;442656.0
230140;201805;202;175;27;166950.0;25758.0;192708.0
230150;201805;156;122;34;116388.0;32436.0;148824.0
230160;201805;921;795;126;757953.0;120204.0;878157.0
230170;201805;584;539;45;509693.7;42930.0;552623.7
230180;201805;79;74;5;70596.0;4770.0;75366.0
230185;201805;410;354;56;336618.9;53424.0;390042.9
230190;201805;2210;1786;424;1699864.5;404179.0;2104043.5
230195;201805;489;427;62;407358.0;59148.0;466506.0
230200;201805;374;325;49;309086.47;46746.0;355832.47
230205;201805;357;229;128;216696.33;122112.0;338808.34
230210;201805;1258;1004;254;956470.2;241552.8;1198023.0
230220;201805;1403;969;434;923662.8;414036.0;1337698.8
230230;201805;892;783;109;746075.7;103986.0;850061.7
230240;201805;1630;1404;226;1337731.8;215604.0;1553335.8
230250;201805;1778;1468;310;1396043.5;295740.0;1691783.5
230260;201805;2943;1780;1163;1693881.1;1108529.8;2802410.8
230270;201805;1343;1078;265;1026194.0;251617.5;1277811.5
230280;201805;2724;2031;693;1931155.8;660454.2;2591610.0
230290;201805;398;362;36;340164.06;34344.0;374508.06
230300;201805;508;377;131;358398.72;124974.0;483372.72
230310;201805;417;314;103;299408.12;98262.0;397670.12
230320;201805;917;781;136;741149.6;129744.0;870893.6
230330;201805;300;241;59;229150.8;56096.0;285246.8
230340;201805;452;363;89;345349.0;84906.0;430255.0
230350;201805;3053;1928;1125;1839264.2;1070675.2;2909939.5
230360;201805;263;214;49;203246.0;46746.0;249992.0
230365;201805;134;108;26;102317.0;24804.0;127121.0
230370;201805;9748;4770;4978;4541864.5;4744603.5;9286468.0
230380;201805;461;397;64;378452.0;60102.6;438554.6
230390;201805;508;279;229;264362.94;218466.0;482828.94
230393;201805;262;215;47;204256.8;44838.0;249094.8
230395;201805;337;275;62;262102.0;59148.0;321250.0
230400;201805;594;473;121;449334.0;114937.92;564271.94
230410;201805;2636;1644;992;1562748.8;945477.0;2508225.8
230420;201805;6016;3942;2074;3742484.2;1974019.1;5716503.5
230423;201805;315;273;42;260442.0;40068.0;300510.0
230425;201805;350;289;61;275105.0;58194.0;333299.0
230426;201805;108;97;11;91812.96;10207.8;102020.76
230427;201805;79;76;3;72504.0;2862.0;75366.0
230428;201805;1356;700;656;667571.06;625824.0;1293395.0
230430;201805;446;361;85;344200.0;81090.0;425290.0
230435;201805;797;563;234;535791.25;221996.61;757787.8
230440;201805;83790;36989;46801;3,52E+13;4,46E+14;7,98E+14
230445;201805;263;183;80;174391.2;76320.0;250711.2
230450;201805;540;437;103;416898.0;98262.0;515160.0
230460;201805;59;50;9;47700.0;8586.0;56286.0
230465;201805;302;246;56;234684.0;53424.0;288108.0
230470;201805;1877;1470;407;1402380.0;387171.1;1789551.1
230480;201805;152;146;6;138997.8;5724.0;144721.8
230490;201805;280;226;54;215604.0;51516.0;267120.0
230495;201805;438;331;107;314891.38;102078.0;416969.38
230500;201805;951;711;240;677340.0;228960.0;906300.0
230510;201805;45;36;9;34344.0;8586.0;42930.0
230520;201805;385;305;80;290970.0;76320.0;367290.0
230523;201805;2062;1293;769;1231171.6;733178.0;1964349.6
230526;201805;298;249;49;237546.0;45955.0;283501.0
230530;201805;673;503;170;476849.6;161226.2;638075.8
230533;201805;182;173;9;165042.0;8586.0;173628.0
230535;201805;345;259;86;247086.0;82044.0;329130.0
230540;201805;1834;1601;233;1524711.0;221709.8;1746420.9
230550;201805;3621;2324;1297;2208102.8;1235988.1;3444091.0
230560;201805;578;443;135;420523.8;127836.0;548359.8
230565;201805;194;140;54;133560.0;50753.0;184313.0
230570;201805;303;267;36;254718.0;34344.0;289062.0
230580;201805;1109;817;292;776990.75;277614.0;1054604.8
230590;201805;960;746;214;708108.1;203679.0;911787.1
230600;201805;258;234;24;222492.06;22896.0;245388.06
230610;201805;338;270;68;257390.0;64872.0;322262.0
230620;201805;165;136;29;128790.0;27666.0;156456.0
230625;201805;723;525;198;499295.78;187738.69;687034.44
230630;201805;1257;993;264;947322.0;251474.4;1198796.4
230640;201805;3557;3067;490;2918683.8;466701.56;3385385.2
230650;201805;398;346;52;329224.38;49593.69;378818.06
230655;201805;644;557;87;530424.8;82932.38;613357.2
230660;201805;345;291;54;277614.0;51229.8;328843.8
230670;201805;425;376;49;358704.0;46746.0;405450.0
230680;201805;196;180;16;171720.0;15264.0;186984.0
230690;201805;861;751;110;716454.0;104940.0;821394.0
230700;201805;699;591;108;563814.0;102745.8;666559.8
230710;201805;732;693;39;660932.0;37206.0;698138.0
230720;201805;149;126;23;119812.86;21942.0;141754.86
230725;201805;238;189;49;180306.0;46737.0;227043.0
230730;201805;11716;6364;5352;6055144.5;5097158.0;1,12E+14
230740;201805;652;524;128;499610.0;121421.46;621031.44
230750;201805;811;693;118;659930.3;112572.0;772502.3
230760;201805;1315;1140;175;1083513.2;166950.0;1250463.2
230763;201805;315;262;53;247992.95;50562.0;298554.94
230765;201805;6874;3236;3638;3082367.2;3469513.8;6551881.0
230770;201805;4956;2543;2413;2416648.5;2300561.5;4717210.0
230780;201805;685;602;83;571168.1;78929.96;650098.06
230790;201805;200;165;35;157410.0;32589.4;189999.4
230800;201805;1122;821;301;782924.1;287154.0;1070078.1
230810;201805;1298;1155;143;1100868.2;136231.2;1237099.5
230820;201805;337;240;97;228007.0;92538.0;320545.0
230830;201805;936;809;127;768272.44;121158.0;889430.44
230835;201805;277;238;39;226098.0;36491.0;262589.0
230837;201805;161;136;25;129744.0;23850.0;153594.0
230840;201805;906;727;179;692318.5;170480.0;862798.5
230850;201805;1473;1283;190;1223505.0;180974.0;1404479.0
230860;201805;299;224;75;213696.0;71550.0;285246.0
230870;201805;1801;1533;268;1461528.0;255100.0;1716628.0
230880;201805;41;29;12;27666.0;11448.0;39114.0
230890;201805;569;523;46;498819.8;43870.0;542689.8
230900;201805;277;210;67;200340.0;63721.0;264061.0
230910;201805;199;160;39;151876.8;37206.0;189082.8
230920;201805;402;316;86;301464.0;82044.0;383508.0
230930;201805;923;648;275;615330.6;262350.0;877680.6
230940;201805;824;663;161;632502.0;153404.0;785906.0
230945;201805;481;402;79;383032.0;75366.0;458398.0
230950;201805;379;324;55;309096.0;52470.0;361566.0
230960;201805;2547;1720;827;1634152.9;788672.0;2422824.8
230970;201805;1736;979;757;933027.25;721300.3;1654327.6
230980;201805;211;180;31;171720.0;29574.0;201294.0
230990;201805;139;112;27;106848.0;25001.47;131849.47
231000;201805;208;188;20;177444.0;19080.0;196524.0
231010;201805;136;107;29;101655.59;27666.0;129321.59
231020;201805;1302;901;401;857933.0;382554.0;1240487.0
231025;201805;961;725;236;688532.2;223598.8;912131.0
231030;201805;1133;949;184;905342.0;175250.0;1080592.0
231040;201805;141;97;44;91793.88;41245.0;133038.88
231050;201805;986;880;106;837755.9;101124.0;938879.9
231060;201805;142;124;18;118296.0;17172.0;135468.0
231070;201805;1431;1009;422;960488.1;402588.0;1363076.1
231080;201805;263;244;19;231965.1;18126.0;250091.1
231085;201805;560;346;214;329131.0;204156.0;533287.0
231090;201805;244;203;41;193662.0;39114.0;232776.0
231095;201805;165;131;34;124974.0;32436.0;157410.0
231100;201805;125;104;21;99216.0;18793.8;118009.8
231110;201805;350;305;45;288780.1;42930.0;331710.1
231120;201805;297;254;43;241357.86;41022.0;282379.88
231123;201805;138;131;7;124974.0;6678.0;131652.0
231126;201805;293;244;49;232776.0;46746.0;279522.0
231130;201805;4571;3562;1009;3389206.5;961513.25;4350720.0
231135;201805;207;176;31;167904.0;28308.4;196212.4
231140;201805;3053;2253;800;2146504.5;762207.8;2908712.5
231150;201805;357;340;17;324360.0;16218.0;340578.0
231160;201805;1201;947;254;900357.06;242087.05;1142444.1
231170;201805;534;352;182;335808.0;173628.0;509436.0
231180;201805;1617;1373;244;1309078.8;232747.38;1541826.1
231190;201805;196;174;22;165996.0;20988.0;186984.0
231195;201805;218;187;31;177674.0;29574.0;207248.0
231200;201805;828;677;151;645858.0;142794.0;788652.0
231210;201805;606;506;100;481770.8;95400.0;577170.8
231220;201805;1037;750;287;713860.1;273798.0;987658.1
231230;201805;1393;1115;278;1062508.0;264448.8;1326956.9
231240;201805;1371;995;376;948943.8;357435.6;1306379.4
231250;201805;110;102;8;97308.0;7632.0;104940.0
231260;201805;288;184;104;175536.0;98930.0;274466.0
231270;201805;1002;838;164;794157.7;156169.8;950327.5
231280;201805;57;44;13;41976.0;12402.0;54378.0
231290;201805;7179;3998;3181;3806996.2;3032329.2;6839325.5
231300;201805;622;576;46;549504.0;43884.0;593388.0
231310;201805;705;654;51;622699.0;48654.0;671353.0
231320;201805;568;435;133;414514.0;126882.0;541396.0
231325;201805;89;80;9;76320.0;8586.0;84906.0
231330;201805;2030;1569;461;1491011.6;437505.6;1928517.2
231335;201805;245;217;28;207018.0;26712.0;233730.0
231340;201805;1622;1197;425;1140794.1;405163.8;1545957.9
231350;201805;1168;958;210;913932.0;199768.0;1113700.0
231355;201805;403;349;54;332946.0;51516.0;384462.0
231360;201805;478;375;103;355040.2;98262.0;453302.2
231370;201805;90;74;16;70596.0;15264.0;85860.0
231375;201805;288;208;80;198432.0;76320.0;274752.0
231380;201805;451;364;87;345660.7;82807.2;428467.88
231390;201805;195;160;35;152640.0;33390.0;186030.0
231395;201805;730;447;283;425140.56;269982.0;695122.56
231400;201805;1064;880;184;836962.8;175193.38;1012156.25
231410;201805;1320;1072;248;1018873.4;235639.0;1254512.4
240010;201805;392;182;210;172393.27;200331.0;372724.25
240020;201805;2191;1715;476;1634523.9;454100.0;2088623.9
240030;201805;130;110;20;104940.0;19080.0;124020.0
240040;201805;32;32;0;30528.0;0.0;30528.0
240050;201805;508;436;72;415090.44;68688.0;483778.44
240060;201805;66;62;4;59148.0;3816.0;62964.0
240070;201805;185;145;40;138330.0;38160.0;176490.0
240080;201805;439;296;143;282380.0;136422.0;418802.0
240090;201805;105;93;12;88416.72;11448.0;99864.72
240100;201805;1445;1360;85;1294467.5;80899.2;1375366.8
240110;201805;992;630;362;600048.25;345348.0;945396.25
240120;201805;139;117;22;111618.0;20988.0;132606.0
240130;201805;287;269;18;255909.55;17172.0;273081.53
240140;201805;79;63;16;60102.0;15264.0;75366.0
240145;201805;687;606;81;577599.3;77064.12;654663.44
240150;201805;20;15;5;14310.0;4741.38;19051.38
240160;201805;44;38;6;36252.0;5724.0;41976.0
240165;201805;35;29;6;27428.0;5724.0;33152.0
240170;201805;94;72;22;68688.0;20988.0;89676.0
240180;201805;78;64;14;61056.0;13356.0;74412.0
240185;201805;44;40;4;38150.46;3816.0;41966.46
240190;201805;12;10;2;9540.0;1908.0;11448.0
240200;201805;3012;1686;1326;1602177.6;1263765.0;2865942.8
240210;201805;165;129;36;123066.0;34344.0;157410.0
240220;201805;1101;790;311;753517.0;296684.47;1050201.5
240230;201805;828;767;61;728884.06;57546.0;786430.06
240240;201805;120;87;33;82998.0;31482.0;114480.0
240250;201805;92;80;12;76320.0;11448.0;87768.0
240260;201805;1802;1339;463;1276719.1;440433.2;1717152.2
240270;201805;190;167;23;158936.4;21942.0;180878.4
240280;201805;43;33;10;31482.0;9540.0;41022.0
240290;201805;50;49;1;46746.0;954.0;47700.0
240300;201805;180;100;80;95400.0;76320.0;171720.0
240310;201805;1999;1095;904;1033898.0;859198.56;1893096.5
240320;201805;206;196;10;186984.0;9540.0;196524.0
240325;201805;4305;2634;1671;2505365.5;1590725.9;4096091.2
240330;201805;65;61;4;58194.0;3816.0;62010.0
240340;201805;103;75;28;71550.0;26712.0;98262.0
240350;201805;89;79;10;75366.0;9540.0;84906.0
240360;201805;402;285;117;271890.0;111618.0;383508.0
240370;201805;38;36;2;34344.0;1908.0;36252.0
240375;201805;69;40;29;38160.0;27666.0;65826.0
240380;201805;233;189;44;180306.0;41881.0;222187.0
240390;201805;16;13;3;12402.0;2862.0;15264.0
240400;201805;76;72;4;68688.0;3816.0;72504.0
240410;201805;11;7;4;6678.0;3816.0;10494.0
240420;201805;883;687;196;653253.4;185934.6;839188.0
240430;201805;262;247;15;234707.66;14310.0;249017.66
240440;201805;69;37;32;35298.0;30528.0;65826.0
240450;201805;209;140;69;132987.8;65826.0;198813.8
240460;201805;61;48;13;45792.0;12402.0;58194.0
240470;201805;234;203;31;193104.86;29574.0;222678.86
240480;201805;14;14;0;13260.6;0.0;13260.6
240485;201805;75;65;10;62010.0;9540.0;71550.0
240490;201805;46;46;0;43674.12;0.0;43674.12
240500;201805;85;67;18;63918.0;17172.0;81090.0
240510;201805;51;36;15;34344.0;14310.0;48654.0
240520;201805;126;120;6;114480.0;5724.0;120204.0
240530;201805;53;47;6;44838.0;5724.0;50562.0
240540;201805;78;67;11;63918.0;10494.0;74412.0
240550;201805;15;13;2;12402.0;1908.0;14310.0
240560;201805;372;275;97;261723.23;92538.0;354261.22
240570;201805;459;286;173;271985.4;165042.0;437027.4
240580;201805;1259;1021;238;968549.9;225894.2;1194444.1
240590;201805;30;28;2;26712.0;1908.0;28620.0
240600;201805;110;107;3;102078.0;2862.0;104940.0
240610;201805;508;426;82;406047.7;77465.0;483512.7
240615;201805;20;19;1;18126.0;954.0;19080.0
240620;201805;95;91;4;86814.0;3816.0;90630.0
240630;201805;34;32;2;30528.0;1908.0;32436.0
240640;201805;26;22;4;20988.0;3816.0;24804.0
240650;201805;233;196;37;186125.9;35298.0;221423.9
240660;201805;98;86;12;82044.0;11448.0;93492.0
240670;201805;290;171;119;161035.3;113526.0;274561.3
240680;201805;49;38;11;36252.0;10494.0;46746.0
240690;201805;49;46;3;43884.0;2862.0;46746.0
240700;201805;195;162;33;154548.0;31482.0;186030.0
240710;201805;1927;1226;701;1169170.9;668744.44;1837915.2
240720;201805;1055;773;282;736288.7;269028.0;1005316.7
240725;201805;65;62;3;59148.0;2862.0;62010.0
240730;201805;133;115;18;109710.0;17172.0;126882.0
240740;201805;239;202;37;191343.78;34344.02;225687.8
240750;201805;36;24;12;22896.0;11448.0;34344.0
240760;201805;33;29;4;27666.0;3816.0;31482.0
240770;201805;148;114;34;108756.0;32436.0;141192.0
240780;201805;694;574;120;546155.44;114480.0;660635.44
240790;201805;38;37;1;35298.0;954.0;36252.0
240800;201805;8644;5868;2776;5557718.0;2641475.2;8199193.0
240810;201805;20045;11036;9009;1,05E+14;8584472.0;1,91E+14
240820;201805;211;133;78;126591.03;74412.0;201003.03
240830;201805;1609;1318;291;1250847.1;276660.0;1527507.1
240840;201805;79;69;10;65826.0;9540.0;75366.0
240850;201805;88;77;11;73458.0;10494.0;83952.0
240860;201805;114;111;3;105894.0;2862.0;108756.0
240870;201805;59;52;7;49608.0;6678.0;56286.0
240880;201805;29;26;3;24794.46;2862.0;27656.46
240890;201805;1164;691;473;655304.75;451238.0;1106542.8
240895;201805;45;33;12;31482.0;11448.0;42930.0
240910;201805;153;138;15;131652.0;14310.0;145962.0
240920;201805;15;12;3;11448.0;2862.0;14310.0
240930;201805;384;348;36;331038.0;34344.0;365382.0
240933;201805;30;23;7;21942.0;6678.0;28620.0
240940;201805;2432;2150;282;2037607.2;266146.9;2303754.2
240950;201805;51;48;3;45792.0;2862.0;48654.0
240960;201805;31;25;6;23850.0;5724.0;29574.0
240970;201805;128;91;37;86814.0;34544.0;121358.0
240980;201805;190;150;40;143100.0;38160.0;181260.0
240990;201805;119;79;40;75366.0;38160.0;113526.0
241000;201805;70;65;5;62010.0;4770.0;66780.0
241010;201805;60;48;12;45792.0;11448.0;57240.0
241020;201805;116;109;7;103986.0;6678.0;110664.0
241025;201805;9;3;6;2862.0;5724.0;8586.0
241030;201805;119;97;22;92538.0;20988.0;113526.0
241040;201805;35;29;6;27666.0;5724.0;33390.0
241050;201805;90;78;12;74412.0;11448.0;85860.0
241060;201805;27;24;3;22896.0;2862.0;25758.0
241070;201805;14;14;0;13356.0;0.0;13356.0
241080;201805;64;57;7;54091.8;6678.0;60769.8
241090;201805;50;40;10;38160.0;9525.69;47685.69
241100;201805;73;63;10;60102.0;9540.0;69642.0
241105;201805;6;2;4;1908.0;3816.0;5724.0
241110;201805;47;45;2;42930.0;1908.0;44838.0
241120;201805;1423;1103;320;1049276.8;305280.0;1354556.8
241140;201805;223;183;40;173629.0;38160.0;211789.0
241142;201805;42;40;2;38160.0;1908.0;40068.0
241150;201805;1212;1066;146;1014246.0;139284.0;1153530.0
241160;201805;22;21;1;20034.0;954.0;20988.0
241170;201805;42;39;3;37206.0;2862.0;40068.0
241180;201805;50;41;9;38939.42;8586.0;47525.42
241190;201805;39;38;1;36252.0;954.0;37206.0
241200;201805;3865;2111;1754;2009313.2;1671395.6;3680709.0
241210;201805;70;59;11;56286.0;9636.0;65922.0
241220;201805;1375;927;448;883834.8;427358.9;1311193.8
241230;201805;247;208;39;198241.2;37206.0;235447.2
241240;201805;52;40;12;38160.0;11448.0;49608.0
241250;201805;1096;1015;81;968024.0;76988.0;1045012.0
241255;201805;47;38;9;36252.0;8586.0;44838.0
241260;201805;631;499;132;476041.22;125928.0;601969.25
241270;201805;45;32;13;30528.0;12402.0;42930.0
241280;201805;97;84;13;80136.0;12402.0;92538.0
241290;201805;108;80;28;76320.0;26712.0;103032.0
241300;201805;78;55;23;52470.0;21942.0;74412.0
241310;201805;51;38;13;36109.0;12402.0;48511.0
241320;201805;27;14;13;13356.0;12402.0;25758.0
241330;201805;60;54;6;51516.0;5724.0;57240.0
241335;201805;63;56;7;52756.2;6678.0;59434.2
241340;201805;187;140;47;133560.0;44838.0;178398.0
241350;201805;59;54;5;51516.0;4770.0;56286.0
241355;201805;41;38;3;36252.0;2862.0;39114.0
241360;201805;46;46;0;43884.0;0.0;43884.0
241370;201805;44;37;7;35173.98;6678.0;41851.98
241380;201805;38;35;3;33390.0;2862.0;36252.0
241390;201805;75;60;15;57049.2;14310.0;71359.2
241400;201805;199;163;36;154834.2;34344.0;189178.2
241410;201805;177;160;17;152640.0;16122.6;168762.6
241415;201805;96;77;19;73458.0;18126.0;91584.0
241420;201805;99;75;24;71550.0;22725.0;94275.0
241430;201805;28;27;1;25758.0;954.0;26712.0
241440;201805;469;391;78;373000.0;74412.0;447412.0
241445;201805;38;36;2;34344.0;1908.0;36252.0
241450;201805;275;224;51;213696.0;48654.0;262350.0
241460;201805;135;123;12;117104.0;11448.0;128552.0
241470;201805;42;35;7;33390.0;6678.0;40068.0
241475;201805;63;61;2;58194.0;1908.0;60102.0
241480;201805;101;72;29;67448.69;27666.0;95114.69
241490;201805;8;7;1;6678.0;954.0;7632.0
241500;201805;46;33;13;31482.0;12402.0;43884.0
250010;201805;99;87;12;82854.9;11448.0;94302.9
250020;201805;27;24;3;22896.0;2862.0;25758.0
250030;201805;807;601;206;572009.2;195475.6;767484.8
250040;201805;331;280;51;267120.0;48367.8;315487.8
250050;201805;230;190;40;180969.8;38160.0;219129.8
250053;201805;55;42;13;40068.0;12402.0;52470.0
250057;201805;0;0;0;0.0;0.0;0.0
250060;201805;452;343;109;327222.0;103699.8;430921.8
250070;201805;706;588;118;558934.0;112572.0;671506.0
250073;201805;7;7;0;6678.0;0.0;6678.0
250077;201805;200;150;50;142708.86;47700.0;190408.86
250080;201805;423;331;92;314153.2;87768.0;401921.2
250090;201805;202;133;69;125928.4;65806.92;191735.31
250100;201805;517;425;92;405450.0;87387.0;492837.0
250110;201805;494;375;119;355966.03;113526.0;469492.03
250115;201805;25;8;17;7632.0;16218.0;23850.0
250120;201805;110;82;28;78228.0;26712.0;104940.0
250130;201805;580;464;116;442656.0;110474.0;553130.0
250135;201805;14;8;6;7632.0;5724.0;13356.0
250140;201805;76;68;8;64872.0;7632.0;72504.0
250150;201805;570;421;149;399107.34;141831.19;540938.5
250153;201805;10;9;1;8586.0;954.0;9540.0
250157;201805;29;24;5;22896.0;4770.0;27666.0
250160;201805;215;168;47;160272.0;44838.0;205110.0
250170;201805;66;46;20;43884.0;19080.0;62964.0
250180;201805;4005;2702;1303;2564051.0;1237964.0;3802015.0
250190;201805;863;567;296;539248.5;281668.5;820917.0
250200;201805;53;44;9;41976.0;8586.0;50562.0
250205;201805;23;20;3;19080.0;2862.0;21942.0
250210;201805;90;78;12;74412.0;11448.0;85860.0
250215;201805;63;54;9;51516.0;8586.0;60102.0
250220;201805;27;21;6;20034.0;5724.0;25758.0
250230;201805;77;70;7;66776.0;6678.0;73454.0
250240;201805;245;204;41;193805.1;39114.0;232919.1
250250;201805;394;336;58;320544.0;55332.0;375876.0
250260;201805;33;30;3;28620.0;2862.0;31482.0
250270;201805;56;45;11;42930.0;10494.0;53424.0
250280;201805;378;317;61;302418.0;58194.0;360612.0
250290;201805;95;90;5;85573.8;4770.0;90343.8
250300;201805;555;379;176;360918.72;167891.0;528809.7
250310;201805;48;43;5;41022.0;4770.0;45792.0
250320;201805;1974;1348;626;1280635.4;595630.8;1876266.1
250330;201805;84;74;10;70596.0;9540.0;80136.0
250340;201805;25;21;4;20034.0;3816.0;23850.0
250350;201805;139;88;51;83665.8;48081.6;131747.4
250355;201805;32;25;7;23850.0;6678.0;30528.0
250360;201805;201;164;37;156456.0;35060.0;191516.0
250370;201805;2389;1617;772;1537660.0;734931.8;2272591.8
250375;201805;16;12;4;11448.0;3816.0;15264.0
250380;201805;53;37;16;35298.0;15264.0;50562.0
250390;201805;42;34;8;32436.0;7632.0;40068.0
250400;201805;15682;7966;7716;7573864.0;7354615.5;1,49E+13
250403;201805;421;343;78;327212.47;74412.0;401624.47
250407;201805;57;49;8;46746.0;7632.0;54378.0
250410;201805;30;25;5;23850.0;4770.0;28620.0
250415;201805;42;28;14;26692.92;13336.92;40029.84
250420;201805;46;38;8;36252.0;7632.0;43884.0
250430;201805;1527;1302;225;1239915.0;214650.0;1454565.0
250435;201805;16;13;3;12402.0;2862.0;15264.0
250440;201805;690;594;96;562743.25;91584.0;654327.25
250450;201805;88;73;15;69642.0;13642.2;83284.2
250460;201805;421;290;131;276660.0;124964.46;401624.47
250470;201805;88;65;23;62010.0;21942.0;83952.0
250480;201805;324;255;69;243270.0;65826.0;309096.0
250485;201805;2;1;1;954.0;954.0;1908.0
250490;201805;208;171;37;163134.0;35298.0;198432.0
250500;201805;77;57;20;54378.0;19080.0;73458.0
250510;201805;734;579;155;551316.8;146861.44;698178.25
250520;201805;173;121;52;115414.92;49603.23;165018.16
250523;201805;112;93;19;88722.0;18126.0;106848.0
250527;201805;102;81;21;77269.23;20034.0;97303.23
250530;201805;6;4;2;3816.0;1908.0;5724.0
250535;201805;25;21;4;20034.0;3816.0;23850.0
250540;201805;124;94;30;88960.5;28620.0;117580.5
250550;201805;69;66;3;62964.0;2862.0;65826.0
250560;201805;38;31;7;29574.0;6678.0;36252.0
250570;201805;150;120;30;114480.0;28620.0;143100.0
250580;201805;133;104;29;98929.8;27666.0;126595.8
250590;201805;20;16;4;15264.0;3816.0;19080.0
250600;201805;1319;892;427;849061.4;407262.6;1256324.0
250610;201805;151;130;21;124020.0;20034.0;144054.0
250620;201805;22;18;4;17172.0;3816.0;20988.0
250625;201805;65;49;16;46746.0;15264.0;62010.0
250630;201805;3016;1934;1082;1836993.6;1031160.75;2868154.5
250640;201805;203;169;34;161226.0;32436.0;193662.0
250650;201805;31;21;10;20034.0;9540.0;29574.0
250660;201805;44;34;10;32436.0;9540.0;41976.0
250670;201805;62;41;21;39114.0;20034.0;59148.0
250680;201805;383;314;69;299556.0;65826.0;365382.0
250690;201805;1834;1267;567;1205136.5;540536.8;1745673.4
250700;201805;921;813;108;772175.6;102822.12;874997.75
250710;201805;446;346;100;330084.0;95400.0;425484.0
250720;201805;104;82;22;78228.0;20988.0;99216.0
250730;201805;376;318;58;302418.6;55332.0;357750.6
250740;201805;51;47;4;44838.0;3816.0;48654.0
250750;201805;20492;12296;8196;1,17E+14;7809050.0;1,95E+14
250760;201805;71;52;19;49608.0;18126.0;67734.0
250770;201805;352;233;119;220374.14;112357.55;332731.7
250780;201805;54;41;13;39114.0;12402.0;51516.0
250790;201805;476;312;164;294786.9;155740.5;450527.4
250800;201805;155;142;13;134752.5;12402.0;147154.5
250810;201805;79;60;19;57240.0;18126.0;75366.0
250820;201805;161;130;31;124020.0;29574.0;153594.0
250830;201805;419;286;133;271842.5;126882.0;398724.5
250840;201805;53;51;2;48654.0;1908.0;50562.0
250850;201805;54;42;12;39381.12;11448.0;50829.12
250855;201805;14;12;2;11448.0;1908.0;13356.0
250860;201805;203;145;58;138330.0;55045.8;193375.8
250870;201805;32;29;3;27666.0;2862.0;30528.0
250880;201805;79;61;18;58136.76;17172.0;75308.76
250890;201805;2424;1789;635;1704893.4;604926.75;2309820.2
250900;201805;116;98;18;93492.0;17172.0;110664.0
250905;201805;124;96;28;91584.0;26712.0;118296.0
250910;201805;1179;840;339;800197.3;323119.8;1123317.1
250915;201805;110;76;34;72504.0;32436.0;104940.0
250920;201805;138;107;31;102078.0;29574.0;131652.0
250930;201805;160;99;61;94446.0;58194.0;152640.0
250933;201805;1;1;0;954.0;0.0;954.0
250937;201805;6;5;1;4770.0;954.0;5724.0
250939;201805;31;22;9;20988.0;8586.0;29574.0
250940;201805;106;79;27;75366.0;25758.0;101124.0
250950;201805;71;47;24;44838.0;22896.0;67734.0
250960;201805;89;49;40;46746.0;38160.0;84906.0
250970;201805;1208;859;349;817865.0;331992.0;1149857.0
250980;201805;92;64;28;61056.0;26712.0;87768.0
250990;201805;165;129;36;122593.77;34301.07;156894.84
251000;201805;75;68;7;64681.2;6678.0;71359.2
251010;201805;103;80;23;76316.0;21163.53;97479.53
251020;201805;80;70;10;65969.1;9540.0;75509.1
251030;201805;43;33;10;31482.0;9540.0;41022.0
251040;201805;53;38;15;36252.0;14310.0;50562.0
251050;201805;23;21;2;20034.0;1908.0;21942.0
251060;201805;52;41;11;38160.0;10494.0;48654.0
251065;201805;3;3;0;2862.0;0.0;2862.0
251070;201805;25;20;5;19071.0;4770.0;23841.0
251080;201805;4712;2285;2427;2168302.0;2308805.0;4477107.0
251090;201805;197;169;28;161226.0;26712.0;187938.0
251100;201805;19;18;1;17172.0;954.0;18126.0
251110;201805;46;37;9;35298.0;8586.0;43884.0
251120;201805;1809;1098;711;1042582.2;678294.0;1720876.2
251130;201805;390;316;74;301354.28;70596.0;371950.28
251140;201805;514;333;181;316538.8;172505.34;489044.12
251150;201805;294;254;40;241544.0;38160.0;279704.0
251160;201805;94;79;15;75362.0;14310.0;89672.0
251170;201805;98;78;20;74383.38;19075.23;93458.61
251180;201805;289;182;107;173619.23;102069.23;275688.47
251190;201805;193;133;60;126553.83;57240.0;183793.83
251200;201805;254;208;46;198432.0;43884.0;242316.0
251203;201805;34;32;2;30528.0;1908.0;32436.0
251207;201805;95;79;16;75366.0;15264.0;90630.0
251210;201805;1414;1017;397;968664.5;378070.2;1346734.8
251220;201805;48;38;10;36252.0;9540.0;45792.0
251230;201805;475;397;78;378738.0;74412.0;453150.0
251240;201805;101;73;28;68688.0;26712.0;95400.0
251250;201805;1330;953;377;906272.9;359515.0;1265787.9
251260;201805;13;8;5;7632.0;4770.0;12402.0
251270;201805;344;256;88;244224.0;83809.0;328033.0
251272;201805;63;58;5;55332.0;4770.0;60102.0
251274;201805;27;22;5;20988.0;4770.0;25758.0
251275;201805;23;16;7;15264.0;6678.0;21942.0
251276;201805;17;13;4;12402.0;3816.0;16218.0
251278;201805;9;7;2;6678.0;1908.0;8586.0
251280;201805;99;94;5;89676.0;4770.0;94446.0
251290;201805;703;530;173;505620.0;165042.0;670662.0
251300;201805;16;14;2;13356.0;1908.0;15264.0
251310;201805;365;262;103;249944.0;98262.0;348206.0
251315;201805;19;18;1;17172.0;954.0;18126.0
251320;201805;61;49;12;46746.0;11448.0;58194.0
251330;201805;80;71;9;67734.0;8586.0;76320.0
251335;201805;11;6;5;5724.0;4770.0;10494.0
251340;201805;699;412;287;393048.0;272773.25;665821.25
251350;201805;37;35;2;33390.0;1908.0;35298.0
251360;201805;66;58;8;55125.94;7632.0;62757.94
251365;201805;15;14;1;13356.0;954.0;14310.0
251370;201805;5305;3608;1697;3436867.0;1617365.5;5054232.5
251380;201805;50;40;10;38160.0;9540.0;47700.0
251385;201805;3;3;0;2862.0;0.0;2862.0
251390;201805;674;534;140;508292.2;132320.0;640612.2
251392;201805;12;7;5;6678.0;4770.0;11448.0
251394;201805;10;10;0;9540.0;0.0;9540.0
251396;201805;16;11;5;10494.0;4770.0;15264.0
251398;201805;18;15;3;14310.0;2862.0;17172.0
251400;201805;41;34;7;32436.0;6678.0;39114.0
251410;201805;35;30;5;28620.0;4770.0;33390.0
251420;201805;105;78;27;74412.0;25758.0;100170.0
251430;201805;39;37;2;35298.0;1908.0;37206.0
251440;201805;33;22;11;20988.0;10494.0;31482.0
251445;201805;54;49;5;46746.0;4770.0;51516.0
251450;201805;420;372;48;353232.8;45792.0;399024.8
251455;201805;2;1;1;954.0;954.0;1908.0
251460;201805;17;13;4;12402.0;3816.0;16218.0
251465;201805;5;2;3;1908.0;2862.0;4770.0
251470;201805;46;36;10;34344.0;9540.0;43884.0
251480;201805;26;24;2;22896.0;1908.0;24804.0
251490;201805;129;90;39;85383.0;36253.0;121636.0
251500;201805;118;95;23;90630.0;21179.0;111809.0
251510;201805;37;28;9;26712.0;8586.0;35298.0
251520;201805;25;25;0;23850.0;0.0;23850.0
251530;201805;4526;3185;1341;3032190.2;1279018.2;4311208.5
251540;201805;73;65;8;62010.0;7632.0;69642.0
251550;201805;414;320;94;304326.2;88924.0;393250.2
251560;201805;24;17;7;16218.0;6678.0;22896.0
251570;201805;19;19;0;18126.0;0.0;18126.0
251580;201805;120;98;22;93492.0;20988.0;114480.0
251590;201805;125;93;32;88903.0;30528.0;119431.0
251593;201805;20;11;9;10494.0;8586.0;19080.0
251597;201805;55;45;10;42930.0;9540.0;52470.0
251600;201805;1097;775;322;737858.5;305579.9;1043438.4
251610;201805;210;158;52;150732.0;48941.0;199673.0
251615;201805;3;3;0;2862.0;0.0;2862.0
251620;201805;4247;2833;1414;2692841.8;1346191.0;4039032.8
251630;201805;454;335;119;319590.0;113517.0;433107.0
251640;201805;149;104;45;99216.0;42930.0;142146.0
251650;201805;266;193;73;182289.1;69642.0;251931.1
251660;201805;224;202;22;191754.1;20797.2;212551.3
251670;201805;358;279;79;264470.0;75366.0;339836.0
251675;201805;3;3;0;2862.0;0.0;2862.0
251680;201805;95;87;8;82998.0;7632.0;90630.0
251690;201805;340;285;55;270936.0;52119.89;323055.88
251700;201805;281;235;46;223603.3;43869.69;267472.97
251710;201805;21;14;7;13356.0;6678.0;20034.0
251720;201805;32;22;10;20988.0;9254.0;30242.0
251740;201805;10;8;2;7632.0;1908.0;9540.0
260005;201805;3134;1784;1350;1690847.4;1286733.1;2977580.5
260010;201805;1473;1053;420;999696.5;398677.3;1398373.8
260020;201805;427;375;52;357750.0;49608.0;407358.0
260030;201805;579;421;158;400866.97;150732.0;551599.0
260040;201805;861;534;327;508348.44;311948.47;820296.9
260050;201805;1137;816;321;778226.0;305662.0;1083888.0
260060;201805;413;375;38;356986.8;36252.0;393238.8
260070;201805;1466;924;542;877374.0;514098.38;1391472.4
260080;201805;727;574;153;546785.1;145962.0;692747.1
260090;201805;575;358;217;341304.12;207018.0;548322.1
260100;201805;230;160;70;151639.2;66780.0;218419.2
260105;201805;234;131;103;124974.0;98262.0;223236.0
260110;201805;2752;2043;709;1949013.0;675576.0;2624589.0
260120;201805;2908;1459;1449;1382168.2;1380058.1;2762226.2
260130;201805;151;103;48;98262.0;45792.0;144054.0
260140;201805;2128;1398;730;1325201.5;694875.44;2020077.0
260150;201805;228;151;77;144054.0;73458.0;217512.0
260160;201805;296;254;42;242316.0;40068.0;282384.0
260170;201805;3375;2066;1309;1964103.4;1247402.9;3211506.2
260180;201805;136;115;21;109710.0;20034.0;129744.0
260190;201805;2266;1602;664;1525157.9;633456.0;2158614.0
260200;201805;896;735;161;700415.06;153308.0;853723.06
260210;201805;1407;999;408;952895.25;387983.12;1340878.4
260220;201805;722;660;62;629640.0;59148.0;688788.0
260230;201805;1200;910;290;865949.0;276660.0;1142609.0
260240;201805;221;168;53;159098.58;50562.0;209660.58
260250;201805;75;59;16;56286.0;15264.0;71550.0
260260;201805;992;711;281;678294.0;268074.0;946368.0
260270;201805;429;349;80;331563.2;76033.8;407597.0
260280;201805;1353;881;472;839997.0;450002.0;1289999.0
260290;201805;6383;3410;2973;3234336.2;2829532.0;6063868.5
260300;201805;861;759;102;722017.6;97022.0;819039.6
260310;201805;501;402;99;382129.47;94446.0;476575.47
260320;201805;882;666;216;635077.2;206064.0;841141.2
260330;201805;34;27;7;25758.0;6678.0;32436.0
260340;201805;68;49;19;46746.0;18126.0;64872.0
260345;201805;5687;3206;2481;3051393.8;2365797.8;5417191.5
260350;201805;476;346;130;328340.1;123067.0;451407.1
260360;201805;285;146;139;139284.0;132606.0;271890.0
260370;201805;656;430;226;407610.4;215464.0;623074.4
260380;201805;597;429;168;409266.0;159127.56;568393.56
260390;201805;297;251;46;238375.98;42930.0;281305.97
260392;201805;99;87;12;82998.0;11448.0;94446.0
260400;201805;4066;2343;1723;2226032.5;1643361.6;3869394.2
260410;201805;14458;7713;6745;7342117.5;6431999.0;1,38E+14
260415;201805;122;110;12;104940.0;11448.0;116388.0
260420;201805;1784;1066;718;1011925.2;683175.6;1695100.9
260430;201805;190;174;16;164784.66;15264.0;180048.66
260440;201805;229;167;62;158594.0;59148.0;217742.0
260450;201805;476;344;132;326891.0;125928.0;452819.0
260460;201805;846;451;395;427584.8;376825.22;804410.0
260470;201805;372;228;144;216748.8;136995.0;353743.8
260480;201805;206;128;78;122112.0;74412.0;196524.0
260490;201805;209;168;41;160272.0;39114.0;199386.0
260500;201805;1136;764;372;726568.2;353791.8;1080360.0
260510;201805;742;588;154;559711.8;145962.0;705673.8
260515;201805;262;233;29;222282.0;27189.0;249471.0
260520;201805;3324;1973;1351;1874942.5;1286545.6;3161488.2
260530;201805;791;642;149;609648.6;142146.0;751794.6
260540;201805;570;433;137;413082.0;129744.72;542826.75
260545;201805;13;10;3;9540.0;2862.0;12402.0
260550;201805;346;215;131;205110.0;124974.0;330084.0
260560;201805;518;387;131;368912.0;124687.8;493599.8
260570;201805;1011;831;180;789769.8;171433.8;961203.6
260580;201805;263;235;28;224190.0;26712.0;250902.0
260590;201805;659;376;283;357292.1;269982.0;627274.06
260600;201805;8185;4185;4000;3970474.8;3812131.5;7782606.5
260610;201805;497;333;164;317682.0;156169.8;473851.8
260620;201805;3641;1896;1745;1797094.8;1661512.0;3458606.8
260630;201805;76;73;3;69642.0;2862.0;72504.0
260640;201805;3676;2008;1668;1912313.6;1591206.2;3503520.0
260650;201805;341;238;103;227052.0;98219.07;325271.06
260660;201805;507;343;164;326840.4;155835.9;482676.3
260670;201805;102;76;26;72504.0;24804.0;97308.0
260680;201805;3667;2045;1622;1934046.4;1547044.9;3481091.2
260690;201805;120;94;26;89676.0;24804.0;114480.0
260700;201805;325;198;127;188128.8;120324.0;308452.8
260710;201805;39;36;3;34344.0;2862.0;37206.0
260720;201805;2228;1337;891;1269291.8;848977.1;2118268.8
260730;201805;606;454;152;433116.0;142813.8;575929.8
260740;201805;62;58;4;55332.0;3816.0;59148.0
260750;201805;640;445;195;424205.62;186030.0;610235.6
260760;201805;623;338;285;322452.0;271890.0;594342.0
260765;201805;982;518;464;490943.8;442417.5;933361.3
260770;201805;220;164;56;156456.0;53424.0;209880.0
260775;201805;821;488;333;464169.8;317673.0;781842.8
260780;201805;274;176;98;167904.0;93492.0;261396.0
260790;201805;12344;6778;5566;6439143.5;5302395.0;1,17E+14
260795;201805;166;115;51;108546.12;48654.0;157200.12
260800;201805;279;228;51;217035.0;48654.0;265689.0
260805;201805;175;112;63;106119.14;60102.0;166221.14
260810;201805;740;643;97;612935.44;92538.0;705473.44
260820;201805;317;214;103;202826.8;98262.0;301088.78
260825;201805;205;141;64;134136.98;61056.0;195192.98
260830;201805;263;169;94;161226.0;89676.0;250902.0
260840;201805;229;167;62;158651.0;58862.0;217513.0
260845;201805;210;146;64;138997.8;61056.0;200053.8
260850;201805;499;361;138;342730.1;131652.0;474382.1
260860;201805;254;191;63;182016.34;60102.0;242118.34
260870;201805;375;271;104;258534.0;99216.0;357750.0
260875;201805;701;490;211;466346.7;201294.0;667640.7
260880;201805;1590;963;627;916743.06;597967.2;1514710.2
260890;201805;2439;1696;743;1611544.0;707869.0;2319413.0
260900;201805;1039;714;325;679853.8;310050.0;989903.8
260910;201805;278;218;60;207972.0;57240.0;265212.0
260915;201805;300;202;98;192708.0;93372.0;286080.0
260920;201805;177;100;77;95400.0;73458.0;168858.0
260930;201805;389;334;55;318636.0;52384.45;371020.44
260940;201805;2777;1523;1254;1448747.9;1195819.9;2644567.8
260950;201805;2015;1169;846;1108873.9;807084.0;1915957.9
260960;201805;14274;7425;6849;7048995.0;6526471.5;1,36E+14
260970;201805;438;374;64;356007.0;61056.0;417063.0
260980;201805;196;172;24;163802.0;22896.0;186698.0
260990;201805;2569;2113;456;2014057.2;434356.2;2448413.5
261000;201805;4356;2577;1779;2445244.8;1695268.4;4140513.2
261010;201805;188;137;51;130698.0;47836.23;178534.23
261020;201805;606;453;153;432019.0;145962.0;577981.0
261030;201805;223;162;61;154548.0;57960.27;212508.27
261040;201805;363;327;36;311958.0;34057.8;346015.8
261050;201805;470;413;57;394002.0;54378.0;448380.0
261060;201805;1324;871;453;829742.75;432162.0;1261904.8
261070;201805;9036;4596;4440;4359767.5;4227949.0;8587717.0
261080;201805;388;292;96;277796.0;91584.0;369380.0
261090;201805;2234;1714;520;1626576.0;495308.0;2121884.0
261100;201805;1094;772;322;734151.6;305318.16;1039469.75
261110;201805;8068;4922;3146;4689403.0;2998412.0;7687815.0
261120;201805;272;225;47;214650.0;44833.23;259483.23
261130;201805;568;329;239;313532.9;227816.0;541348.9
261140;201805;189;122;67;116388.0;63918.0;180306.0
261150;201805;664;389;275;371106.0;261682.2;632788.2
261153;201805;73;70;3;65826.31;2862.0;68688.31
261160;201805;77083;38879;38204;3,70E+14;3,64E+14;7,34E+14
261170;201805;454;339;115;322776.38;109710.0;432486.38
261180;201805;1768;1084;684;1029013.6;652536.0;1681549.6
261190;201805;613;424;189;404099.9;180297.0;584396.94
261200;201805;211;186;25;176679.3;23850.0;200529.3
261210;201805;34;31;3;29574.0;2862.0;32436.0
261220;201805;2555;1801;754;1711982.9;718743.8;2430726.5
261230;201805;327;238;89;227052.0;84891.69;311943.7
261240;201805;442;381;61;359460.94;58194.0;417654.94
261245;201805;223;187;36;178398.0;34344.0;212742.0
261247;201805;152;114;38;108756.0;36252.0;145008.0
261250;201805;2864;1453;1411;1385351.8;1344983.9;2730335.8
261255;201805;252;229;23;218466.0;21942.0;240408.0
261260;201805;866;743;123;708822.0;117342.0;826164.0
261270;201805;172;134;38;127836.0;36252.0;164088.0
261280;201805;159;131;28;124974.0;26712.0;151686.0
261290;201805;126;87;39;82759.5;37206.0;119965.5
261300;201805;1233;878;355;837612.0;338670.0;1176282.0
261310;201805;764;510;254;486540.0;241695.9;728235.9
261320;201805;546;368;178;351052.9;169812.0;520864.9
261330;201805;861;683;178;648583.5;168966.45;817549.94
261340;201805;309;175;134;166950.0;127836.0;294786.0
261350;201805;794;569;225;541872.2;214650.0;756522.2
261360;201805;1225;798;427;760890.4;407358.0;1168248.4
261370;201805;4997;3067;1930;2910802.5;1838298.5;4749101.0
261380;201805;575;422;153;401405.12;145676.0;547081.1
261390;201805;3426;2292;1134;2181788.8;1077975.2;3259764.2
261400;201805;278;251;27;238881.6;25758.0;264639.6
261410;201805;1068;708;360;675432.0;343435.22;1018867.25
261420;201805;893;560;333;532973.25;317663.47;850636.75
261430;201805;329;299;30;284400.0;28333.8;312733.8
261440;201805;116;105;11;100170.0;10494.0;110664.0
261450;201805;2496;2076;420;1977844.2;399669.03;2377513.2
261460;201805;724;577;147;549504.0;140238.0;689742.0
261470;201805;253;195;58;185220.0;55332.0;240552.0
261480;201805;360;293;67;278283.0;63914.0;342197.0
261485;201805;345;210;135;199672.2;128790.0;328462.2
261500;201805;627;424;203;404496.0;193662.0;598158.0
261510;201805;45;30;15;28620.0;14310.0;42930.0
261520;201805;112;99;13;94446.0;12402.0;106848.0
261530;201805;4175;2657;1518;2526582.0;1446918.8;3973500.8
261540;201805;1089;673;416;641578.4;396864.0;1038442.4
261550;201805;285;143;142;135183.0;135448.92;270631.9
261560;201805;801;534;267;506246.2;253564.6;759810.8
261570;201805;370;288;82;274752.0;78228.0;352980.0
261580;201805;377;297;80;282287.8;76320.0;358607.8
261590;201805;194;157;37;149778.0;35298.0;185076.0
261600;201805;294;237;57;225335.0;53901.0;279236.0
261610;201805;104;89;15;84429.0;14310.0;98739.0
261618;201805;66;51;15;48654.0;14310.0;62964.0
261620;201805;199;121;78;115434.0;74412.0;189846.0
261630;201805;590;453;137;429801.6;130698.0;560499.6
261640;201805;6322;3357;2965;3195217.0;2824996.0;6020213.0
261650;201805;487;308;179;293154.66;170766.0;463920.66
270010;201805;528;466;62;444278.0;58385.0;502663.0
270020;201805;306;243;63;231818.0;60102.0;291920.0
270030;201805;9180;5872;3308;5587275.5;3153389.0;8740665.0
270040;201805;1964;1204;760;1148320.2;723799.8;1872120.0
270050;201805;176;129;47;123066.0;44838.0;167904.0
270060;201805;116;65;51;62010.0;48654.0;110664.0
270070;201805;898;652;246;620193.8;234379.27;854573.06
270080;201805;38;32;6;30528.0;5724.0;36252.0
270090;201805;20;16;4;15264.0;3816.0;19080.0
270100;201805;1248;827;421;785867.6;399487.7;1185355.2
270110;201805;149;110;39;104940.0;37206.0;142146.0
270120;201805;228;187;41;177546.55;39114.0;216660.55
270130;201805;249;170;79;161346.12;75366.0;236712.12
270135;201805;98;60;38;57240.0;36252.0;93492.0
270140;201805;1294;785;509;748009.7;484623.2;1232632.9
270150;201805;268;212;56;202248.0;53424.0;255672.0
270160;201805;518;387;131;369198.0;124306.2;493504.2
270170;201805;725;464;261;441511.2;247896.9;689408.1
270180;201805;71;55;16;52152.04;15054.12;67206.16
270190;201805;103;90;13;85860.0;12402.0;98262.0
270200;201805;106;95;11;90439.2;10494.0;100933.2
270210;201805;481;250;231;238500.0;220087.8;458587.8
270220;201805;186;146;40;139284.0;38160.0;177444.0
270230;201805;2101;1252;849;1190232.5;808038.6;1998271.1
270235;201805;732;550;182;524429.56;173262.95;697692.56
270240;201805;3107;2409;698;2287048.5;663100.0;2950148.5
270250;201805;169;117;52;111618.0;49608.0;161226.0
270255;201805;222;191;31;182214.0;29192.4;211406.4
270260;201805;328;260;68;248040.0;64872.0;312912.0
270270;201805;111;46;65;43875.0;62010.0;105885.0
270280;201805;202;125;77;119250.0;73458.0;192708.0
270290;201805;1177;883;294;841146.44;279599.47;1120745.9
270300;201805;276;174;102;165996.0;97021.8;263017.8
270310;201805;916;736;180;700802.25;171005.58;871807.8
270320;201805;876;748;128;711920.8;121825.8;833746.6
270330;201805;274;229;45;217512.0;42930.0;260442.0
270340;201805;59;47;12;44838.0;11448.0;56286.0
270350;201805;93;47;46;44599.5;43884.0;88483.5
270360;201805;73;41;32;39114.0;30528.0;69642.0
270370;201805;52;40;12;38160.0;11448.0;49608.0
270375;201805;69;39;30;37206.0;28620.0;65826.0
270380;201805;1081;612;469;582894.0;447426.0;1030320.0
270390;201805;197;109;88;103986.0;83952.0;187938.0
270400;201805;704;512;192;487233.28;183159.0;670392.25
270410;201805;699;501;198;477636.03;188882.45;666518.5
270420;201805;400;261;139;247296.0;132521.38;379817.38
270430;201805;32447;23178;9269;2,21E+14;8835315.0;3,09E+14
270440;201805;491;385;106;366479.1;100837.8;467316.9
270450;201805;775;404;371;385177.5;352980.66;738158.2
270460;201805;198;152;46;145008.0;43884.0;188892.0
270470;201805;1375;914;461;871602.7;439794.0;1311396.8
270480;201805;533;429;104;406114.7;98500.5;504615.2
270490;201805;24;20;4;19080.0;3816.0;22896.0
270500;201805;515;423;92;403542.0;87768.0;491310.0
270510;201805;738;453;285;432162.0;271890.0;704052.0
270520;201805;373;229;144;218257.0;137376.0;355633.0
270530;201805;65;57;8;54378.0;7632.0;62010.0
270540;201805;123;95;28;90630.0;26712.0;117342.0
270550;201805;1727;1297;430;1237015.1;409738.22;1646753.4
270560;201805;312;145;167;138330.0;159318.0;297648.0
270570;201805;456;303;153;286851.38;145962.0;432813.38
270580;201805;78;58;20;55332.0;19080.0;74412.0
270590;201805;74;61;13;58194.0;12402.0;70596.0
270600;201805;180;148;32;141192.0;30528.0;171720.0
270610;201805;186;150;36;143091.0;34344.0;177435.0
270620;201805;30;29;1;27666.0;954.0;28620.0
270630;201805;3868;2936;932;2787844.5;886972.94;3674817.5
270640;201805;901;662;239;629844.6;227691.8;857536.4
270642;201805;211;178;33;169812.0;31482.0;201294.0
270644;201805;273;187;86;178207.73;82039.23;260246.97
270650;201805;250;146;104;139284.0;99216.0;238500.0
270660;201805;258;208;50;198432.0;47700.0;246132.0
270670;201805;3180;2418;762;2296640.0;724025.7;3020665.8
270680;201805;468;273;195;260433.0;186026.0;446459.0
270690;201805;1119;703;416;668929.75;396854.47;1065784.2
270700;201805;37;27;10;25758.0;9540.0;35298.0
270710;201805;883;665;218;632791.3;207972.0;840763.3
270720;201805;250;188;62;179352.0;58861.8;238213.8
270730;201805;1905;1097;808;1044297.4;768726.2;1813023.6
270740;201805;45;28;17;26712.0;16218.0;42930.0
270750;201805;635;465;170;443420.0;161513.0;604933.0
270760;201805;308;222;86;211788.0;82044.0;293832.0
270770;201805;2751;1752;999;1664134.2;952092.0;2616226.2
270780;201805;92;57;35;54373.23;33372.46;87745.69
270790;201805;268;180;88;171720.0;83952.0;255672.0
270800;201805;1961;1568;393;1494079.2;374177.88;1868257.1
270810;201805;307;241;66;229899.69;62955.23;292854.9
270820;201805;158;102;56;97308.0;53329.0;150637.0
270830;201805;924;669;255;637459.0;242984.0;880443.0
270840;201805;1409;1035;374;986650.9;355128.0;1341778.9
270850;201805;1662;1015;647;962148.4;617219.44;1579367.9
270860;201805;2449;1595;854;1518527.5;811818.56;2330346.0
270870;201805;120;65;55;62010.0;52470.0;114480.0
270880;201805;918;679;239;645930.1;227112.58;873042.75
270890;201805;352;256;96;243775.62;91579.23;335354.84
270895;201805;72;62;10;59148.0;9540.0;68688.0
270900;201805;104;80;24;76320.0;22896.0;99216.0
270910;201805;322;257;65;244033.2;62010.0;306043.2
270915;201805;1837;1103;734;1047364.1;699517.1;1746881.2
270920;201805;480;403;77;384462.0;73458.0;457920.0
270930;201805;6192;4487;1705;4275075.5;1623789.2;5898865.0
270940;201805;2383;1808;575;1722862.9;547578.0;2270441.0
280010;201805;43;38;5;36252.0;4770.0;41022.0
280020;201805;703;607;96;577139.0;90630.0;667769.0
280030;201805;19443;12435;7008;1,18E+14;6657135.0;1,84E+14
280040;201805;338;212;126;202248.0;118773.0;321021.0
280050;201805;377;290;87;276373.8;82998.0;359371.8
280060;201805;328;219;109;206679.44;103986.0;310665.44
280067;201805;990;695;295;660271.94;280476.25;940748.2
280070;201805;130;109;21;103986.0;20034.0;124020.0
280100;201805;617;486;131;460899.66;124784.0;585683.7
280110;201805;74;69;5;65826.0;4770.0;70596.0
280120;201805;631;506;125;482724.0;119250.0;601974.0
280130;201805;1361;852;509;811377.8;485442.9;1296820.8
280140;201805;468;380;88;361661.4;82998.0;444659.4
280150;201805;325;241;84;228470.89;80136.0;308606.88
280160;201805;97;83;14;79182.0;13356.0;92538.0
280170;201805;598;396;202;376587.56;192708.0;569295.56
280190;201805;27;25;2;23850.0;1908.0;25758.0
280200;201805;23;15;8;14310.0;7632.0;21942.0
280210;201805;2762;1945;817;1838064.9;773841.0;2611906.0
280220;201805;41;31;10;29574.0;9540.0;39114.0
280230;201805;318;262;56;249113.62;53424.0;302537.62
280240;201805;112;106;6;100980.9;5724.0;106704.9
280250;201805;18;11;7;10494.0;6678.0;17172.0
280260;201805;81;70;11;66780.0;10494.0;77274.0
280270;201805;160;123;37;117342.0;35298.0;152640.0
280280;201805;194;124;70;118296.0;66780.0;185076.0
280290;201805;3083;2225;858;2110875.8;816935.06;2927810.8
280300;201805;1095;828;267;788247.25;253954.8;1042202.06
280310;201805;107;102;5;96977.29;4770.0;101747.29
280320;201805;650;444;206;423567.0;196524.0;620091.0
280330;201805;357;255;102;243270.0;97183.98;340453.97
280340;201805;419;336;83;319072.56;78419.0;397491.56
280350;201805;3447;2652;795;2520041.2;755691.06;3275732.5
280360;201805;462;292;170;278568.0;161226.0;439794.0
280370;201805;99;88;11;83952.0;10494.0;94446.0
280380;201805;56;42;14;40068.0;13356.0;53424.0
280390;201805;186;155;31;147870.0;29574.0;177444.0
280400;201805;342;232;110;220469.8;104940.0;325409.8
280410;201805;289;234;55;222283.0;52470.0;274753.0
280420;201805;171;143;28;136422.0;26712.0;163134.0
280430;201805;110;81;29;77274.0;27557.63;104831.63
280440;201805;685;531;154;502664.6;146715.66;649380.25
280445;201805;116;108;8;103032.0;7632.0;110664.0
280450;201805;1096;932;164;885733.44;156456.0;1042189.44
280460;201805;755;553;202;520701.44;192708.0;713409.44
280470;201805;190;173;17;165042.0;15265.0;180307.0
280480;201805;2262;1598;664;1509825.2;629591.9;2139417.0
280490;201805;351;323;28;306750.0;26712.0;333462.0
280500;201805;45;40;5;38160.0;4770.0;42930.0
280510;201805;143;111;32;105593.2;30242.0;135835.2
280520;201805;52;38;14;36252.0;13356.0;49608.0
280530;201805;77;54;23;51516.0;21942.0;73458.0
280540;201805;503;402;101;383086.53;96067.8;479154.34
280550;201805;706;652;54;621396.0;51516.0;672912.0
280560;201805;481;419;62;397007.1;59148.0;456155.1
280570;201805;1782;1355;427;1288464.5;406502.84;1694967.2
280580;201805;594;455;139;432689.6;132511.0;565200.6
280590;201805;164;101;63;96074.48;60102.0;156176.48
280600;201805;356;299;57;285246.0;54378.0;339624.0
280610;201805;141;106;35;100918.0;33390.0;134308.0
280620;201805;546;446;100;424530.5;94446.9;518977.4
280630;201805;164;136;28;129744.0;26712.0;156456.0
280640;201805;209;168;41;159443.0;39114.0;198557.0
280650;201805;78;53;25;50562.0;23850.0;74412.0
280660;201805;132;95;37;90630.0;35059.5;125689.5
280670;201805;1635;1023;612;968031.4;580103.94;1548135.2
280680;201805;185;158;27;148948.14;25758.0;174706.14
280690;201805;54;45;9;42930.0;8586.0;51516.0
280700;201805;19;19;0;18126.0;0.0;18126.0
280710;201805;1411;1069;342;1013895.4;325600.2;1339495.6
280720;201805;110;74;36;68036.4;34344.0;102380.4
280730;201805;26;22;4;20988.0;3816.0;24804.0
280740;201805;2410;1781;629;1693348.5;598960.44;2292309.0
280750;201805;293;255;38;243270.0;36252.0;279522.0
280760;201805;885;608;277;578887.2;264258.0;843145.2
290010;201805;202;135;67;128790.0;63918.0;192708.0
290020;201805;178;165;13;157410.0;12402.0;169812.0
290030;201805;596;388;208;369484.2;198432.0;567916.2
290035;201805;140;114;26;105551.7;24804.0;130355.7
290040;201805;274;171;103;163134.0;98262.0;261396.0
290050;201805;81;60;21;57240.0;20034.0;77274.0
290060;201805;254;113;141;107515.8;134514.0;242029.8
290070;201805;5636;2774;2862;2638957.8;2726954.5;5365912.0
290080;201805;500;225;275;214344.72;262331.0;476675.72
290090;201805;389;169;220;161226.0;209880.0;371106.0
290100;201805;1593;1052;541;999413.1;515541.8;1514954.9
290110;201805;764;455;309;432444.2;294257.3;726701.5
290115;201805;211;194;17;184122.0;16218.0;200340.0
290120;201805;776;503;273;479194.2;260442.0;739636.2
290130;201805;412;245;167;233434.27;159318.0;392752.25
290135;201805;296;224;72;213018.66;68688.0;281706.66
290140;201805;303;251;52;239454.0;49417.2;288871.2
290150;201805;130;96;34;91584.0;32436.0;124020.0
290160;201805;247;190;57;180020.58;54378.0;234398.58
290170;201805;89;64;25;61056.0;23850.0;84906.0
290180;201805;155;121;34;115434.0;32436.0;147870.0
290190;201805;448;364;84;346970.0;79849.8;426819.8
290195;201805;311;184;127;175536.0;121158.0;296694.0
290200;201805;281;236;45;225144.0;42930.0;268074.0
290205;201805;140;87;53;82998.0;50562.0;133560.0
290210;201805;1134;825;309;785906.2;294786.0;1080692.2
290220;201805;223;124;99;117819.0;94446.0;212265.0
290225;201805;288;110;178;104940.0;169812.0;274752.0
290230;201805;65;43;22;41022.0;20988.0;62010.0
290240;201805;309;123;186;117055.8;177444.0;294499.8
290250;201805;273;245;28;233034.0;26712.0;259746.0
290260;201805;286;232;54;220279.0;51516.0;271795.0
290265;201805;181;151;30;143237.0;28620.0;171857.0
290270;201805;1397;1156;241;1100964.2;229051.0;1330015.2
290280;201805;467;344;123;328176.0;117342.0;445518.0
290290;201805;1235;718;517;679169.9;493218.0;1172387.9
290300;201805;448;380;68;362229.22;64872.0;427101.22
290310;201805;317;141;176;134514.0;167904.0;302418.0
290320;201805;3964;2462;1502;2345040.8;1430047.0;3775087.8
290323;201805;186;160;26;152354.0;24804.0;177158.0
290327;201805;153;121;32;115162.11;30528.0;145690.11
290330;201805;74;40;34;38160.0;32436.0;70596.0
290340;201805;913;363;550;345329.0;524414.0;869743.0
290350;201805;593;352;241;335808.0;229914.0;565722.0
290360;201805;368;276;92;261397.69;87768.0;349165.7
290370;201805;911;364;547;347256.0;521824.0;869080.0
290380;201805;310;190;120;181260.0;114480.0;295740.0
290390;201805;2502;1564;938;1489083.6;892648.44;2381732.0
290395;201805;243;135;108;128265.8;103032.0;231297.8
290400;201805;281;208;73;198146.0;69642.0;267788.0
290405;201805;253;221;32;210834.0;30528.0;241362.0
290410;201805;568;484;84;458731.62;80136.0;538867.6
290420;201805;239;187;52;178398.0;49608.0;228006.0
290430;201805;495;311;184;296694.0;175536.0;472230.0
290440;201805;72;64;8;61056.0;7632.0;68688.0
290450;201805;232;178;54;169812.0;51516.0;221328.0
290460;201805;1877;1120;757;1066611.8;721415.3;1788027.1
290470;201805;1435;602;833;573179.25;794367.4;1367546.6
290475;201805;588;548;40;521639.0;38160.0;559799.0
290480;201805;289;161;128;152671.8;122112.0;274783.8
290485;201805;231;214;17;204156.0;16218.0;220374.0
290490;201805;1178;852;326;812044.8;310050.2;1122095.0
290500;201805;677;341;336;324360.0;320544.0;644904.0
290510;201805;222;170;52;161226.0;49608.0;210834.0
290515;201805;137;81;56;77274.0;53424.0;130698.0
290520;201805;1409;916;493;872242.6;466794.4;1339037.0
290530;201805;313;286;27;272844.0;25758.0;298602.0
290540;201805;96;58;38;55332.0;36252.0;91584.0
290550;201805;153;129;24;123066.0;22829.22;145895.22
290560;201805;3367;1366;2001;1301866.8;1908759.6;3210626.2
290570;201805;5969;3038;2931;2893640.8;2793359.0;5687000.0
290580;201805;1275;750;525;714259.8;500134.5;1214394.2
290590;201805;533;439;94;418015.0;89676.0;507691.0
290600;201805;1717;1189;528;1129605.0;503712.0;1633317.0
290610;201805;217;195;22;185747.0;20988.0;206735.0
290620;201805;324;287;37;273798.0;35298.0;309096.0
290630;201805;2076;887;1189;843050.7;1129905.2;1972956.0
290640;201805;151;123;28;117342.0;26712.0;144054.0
290650;201805;1704;801;903;763191.0;861462.0;1624653.0
290660;201805;278;227;51;216558.0;48654.0;265212.0
290670;201805;999;519;480;494554.0;457574.38;952128.4
290680;201805;1188;955;233;909829.8;221328.0;1131157.8
290682;201805;293;214;79;203169.3;75347.46;278516.75
290685;201805;233;150;83;142146.0;79182.0;221328.0
290687;201805;936;615;321;584194.1;305280.0;889474.1
290689;201805;130;75;55;71536.0;52455.69;123991.69
290690;201805;649;265;384;252781.92;365456.8;618238.75
290700;201805;238;112;126;106848.0;120204.0;227052.0
290710;201805;704;474;230;452196.0;219420.0;671616.0
290720;201805;1025;830;195;791820.0;185553.0;977373.0
290730;201805;1128;647;481;615378.5;457920.0;1073298.5
290740;201805;15;12;3;11448.0;2862.0;14310.0
290750;201805;1372;625;747;594337.25;710526.1;1304863.4
290755;201805;72;64;8;61056.0;7632.0;68688.0
290760;201805;302;260;42;248040.0;40068.0;288108.0
290770;201805;187;176;11;167894.45;10494.0;178388.45
290780;201805;984;786;198;747900.7;187079.4;934980.06
290790;201805;371;258;113;246132.0;107802.0;353934.0
290800;201805;2632;1056;1576;1004491.06;1502397.4;2506888.5
290810;201805;436;304;132;289730.0;125928.0;415658.0
290820;201805;380;233;147;221314.0;140238.0;361552.0
290830;201805;403;277;126;264258.0;120204.0;384462.0
290840;201805;1703;1047;656;996692.8;623744.5;1620437.2
290850;201805;769;425;344;405259.2;327222.0;732481.2
290860;201805;643;285;358;271890.0;341246.0;613136.0
290870;201805;668;478;190;454791.8;181260.0;636051.8
290880;201805;124;66;58;62964.0;55332.0;118296.0
290890;201805;333;236;97;225144.0;92538.0;317682.0
290900;201805;171;129;42;123066.0;40068.0;163134.0
290910;201805;366;276;90;263304.0;85860.0;349164.0
290920;201805;230;196;34;186984.0;32436.0;219420.0
290930;201805;823;625;198;596250.0;188873.0;785123.0
290940;201805;249;205;44;194806.8;41976.0;236782.8
290950;201805;171;98;73;93492.0;69642.0;163134.0
290960;201805;447;300;147;284960.25;139951.8;424912.03
290970;201805;251;219;32;208735.2;30385.0;239120.2
290980;201805;1503;1066;437;1012814.8;415849.2;1428664.0
290990;201805;371;312;59;297619.9;56230.38;353850.3
291000;201805;867;243;624;231822.0;594752.44;826574.44
291005;201805;2127;903;1224;859267.75;1166919.0;2026186.8
291010;201805;156;140;16;133560.0;15264.0;148824.0
291020;201805;101;80;21;76320.0;20034.0;96354.0
291030;201805;93;68;25;64872.0;23850.0;88722.0
291040;201805;571;286;285;272844.0;271890.0;544734.0
291050;201805;1346;754;592;717817.56;564563.0;1282380.6
291060;201805;1491;822;669;783520.2;638226.0;1421746.2
291070;201805;1891;1397;494;1327360.5;470015.5;1797376.0
291072;201805;7351;2704;4647;2576267.5;4431054.5;7007322.0
291075;201805;206;168;38;160272.0;36252.0;196524.0
291077;201805;51;35;16;33390.0;15264.0;48654.0
291080;201805;19783;8685;11098;8262897.0;1,06E+14;1,88E+14
291085;201805;292;233;59;222282.0;56281.23;278563.22
291090;201805;306;118;188;112286.0;179342.45;291628.47
291100;201805;665;191;474;182214.0;452196.0;634410.0
291110;201805;403;302;101;288088.9;96354.0;384442.9
291120;201805;2514;1194;1320;1138933.0;1257311.5;2396244.5
291125;201805;59;30;29;28620.0;27666.0;56286.0
291130;201805;214;188;26;179352.0;24804.0;204156.0
291140;201805;133;99;34;94160.0;32150.0;126310.0
291150;201805;372;149;223;142146.0;212742.0;354888.0
291160;201805;366;304;62;289062.5;59148.0;348210.5
291165;201805;25;21;4;20034.0;3816.0;23850.0
291170;201805;2943;1473;1470;1401474.1;1399327.6;2800801.8
291180;201805;1324;513;811;489205.38;773560.7;1262766.0
291185;201805;75;73;2;69642.0;1908.0;71550.0
291190;201805;1257;542;715;514296.16;681566.8;1195863.0
291200;201805;167;122;45;116388.0;42930.0;159318.0
291210;201805;2207;862;1345;819209.3;1281318.1;2100527.5
291220;201805;272;203;69;192708.64;65826.0;258534.64
291230;201805;1022;349;673;332088.0;642042.0;974130.0
291240;201805;441;418;23;397532.0;21942.0;419474.0
291250;201805;432;353;79;336762.0;75366.0;412128.0
291260;201805;46;35;11;33390.0;10494.0;43884.0
291270;201805;1209;494;715;471276.0;681823.8;1153099.8
291280;201805;374;170;204;161974.89;194320.27;356295.16
291290;201805;1766;896;870;853067.2;828932.0;1681999.2
291300;201805;222;174;48;165328.2;45792.0;211120.2
291310;201805;228;204;24;194329.8;22896.0;217225.8
291320;201805;1399;998;401;949230.0;381505.28;1330735.2
291330;201805;126;109;17;102173.4;16218.0;118391.4
291340;201805;148;84;64;80136.0;61056.0;141192.0
291345;201805;135;88;47;83952.0;44838.0;128790.0
291350;201805;1592;525;1067;500659.2;1017727.3;1518386.5
291360;201805;8645;4271;4374;4062760.8;4169988.5;8232749.5
291370;201805;1104;612;492;583562.0;469368.0;1052930.0
291380;201805;255;200;55;190800.0;52183.8;242983.8
291390;201805;3899;1702;2197;1618608.2;2094126.0;3712734.2
291400;201805;2089;1494;595;1420125.4;565947.5;1986072.9
291410;201805;154;133;21;125928.0;20034.0;145962.0
291420;201805;112;81;31;77274.0;29574.0;106848.0
291430;201805;168;95;73;89923.0;68688.53;158611.53
291440;201805;497;396;101;375060.3;96354.0;471414.3
291450;201805;898;567;331;539678.8;314820.0;854498.8
291460;201805;1728;1401;327;1334789.1;311958.0;1646747.1
291465;201805;2211;1024;1187;976293.44;1132116.1;2108409.5
291470;201805;2783;1410;1373;1341354.5;1309112.0;2650466.5
291480;201805;11841;5221;6620;4969305.0;6306295.0;1,13E+12
291490;201805;554;232;322;221328.0;307188.0;528516.0
291500;201805;372;203;169;193662.0;161226.0;354888.0
291510;201805;1239;472;767;449127.0;731431.8;1180558.8
291520;201805;959;438;521;417852.0;497024.47;914876.44
291530;201805;1007;267;740;254718.0;705654.75;960372.75
291535;201805;113;95;18;90630.0;17172.0;107802.0
291540;201805;363;105;258;100170.0;245178.6;345348.6
291550;201805;1193;561;632;533288.1;602624.0;1135912.1
291560;201805;5528;2811;2717;2668832.5;2579738.0;5248570.5
291570;201805;206;105;101;100170.0;96354.0;196524.0
291580;201805;1217;740;477;704697.44;455044.22;1159741.8
291590;201805;84;32;52;30384.9;49608.0;79992.9
291600;201805;1363;627;736;597204.0;701840.0;1299044.0
291610;201805;1442;669;773;636942.9;737386.0;1374328.9
291620;201805;587;272;315;259488.0;300128.4;559616.4
291630;201805;496;164;332;156456.0;316728.0;473184.0
291640;201805;3918;1980;1938;1878769.1;1847503.5;3726272.5
291650;201805;419;281;138;266940.0;130852.73;397792.72
291660;201805;439;174;265;165303.95;251712.9;417016.88
291670;201805;223;142;81;134896.0;77274.0;212170.0
291680;201805;692;393;299;374922.0;285141.47;660063.44
291685;201805;588;317;271;302180.0;258343.2;560523.2
291690;201805;569;293;276;279522.0;262341.0;541863.0
291700;201805;922;726;196;691874.2;186030.0;877904.2
291710;201805;1705;794;911;756780.25;868217.06;1624997.4
291720;201805;400;264;136;251851.23;129744.0;381595.22
291730;201805;947;561;386;533524.7;368234.47;901759.2
291733;201805;261;181;80;172387.8;76320.0;248707.8
291735;201805;66;51;15;48654.0;14310.0;62964.0
291740;201805;343;261;82;248994.0;78228.0;327222.0
291750;201805;1952;1299;653;1232201.2;622140.0;1854341.2
291760;201805;3059;1669;1390;1586359.0;1323675.0;2910034.0
291770;201805;808;539;269;512107.25;256626.0;768733.25
291780;201805;47;29;18;27666.0;17172.0;44838.0
291790;201805;170;81;89;77274.0;84906.0;162180.0
291800;201805;10051;4024;6027;3826159.2;5745530.0;9571689.0
291810;201805;1139;821;318;782657.0;303372.0;1086029.0
291820;201805;265;191;74;182214.0;70596.0;252810.0
291830;201805;1084;413;671;392601.0;639171.0;1031772.0
291835;201805;601;553;48;527085.0;45792.0;572877.0
291840;201805;4674;2408;2266;2292440.2;2160916.0;4453356.0
291845;201805;299;102;197;97308.0;187909.38;285217.38
291850;201805;324;281;43;267835.5;41022.0;308857.5
291855;201805;270;108;162;103032.0;154548.0;257580.0
291860;201805;177;111;66;104940.0;62964.0;167904.0
291870;201805;84;34;50;32436.0;47700.0;80136.0
291875;201805;183;165;18;157410.0;17172.0;174582.0
291880;201805;490;386;104;367434.0;99216.0;466650.0
291890;201805;244;81;163;77264.46;154071.2;231335.66
291900;201805;56;32;24;30528.0;22896.0;53424.0
291905;201805;133;93;40;88436.0;38160.0;126596.0
291910;201805;177;144;33;137376.0;31482.0;168858.0
291915;201805;394;349;45;331278.0;42930.0;374208.0
291920;201805;4971;2582;2389;2460726.2;2277441.8;4738168.0
291930;201805;183;106;77;101124.0;73458.0;174582.0
291940;201805;321;177;144;168161.58;136422.0;304583.6
291950;201805;1147;930;217;886457.0;207018.0;1093475.0
291955;201805;1039;621;418;592434.0;398629.0;991063.0
291960;201805;179;126;53;120204.0;50275.8;170479.8
291970;201805;777;588;189;560952.0;180306.0;741258.0
291980;201805;1504;1332;172;1267315.8;163134.4;1430450.1
291990;201805;125;116;9;110664.0;8586.0;119250.0
291992;201805;164;83;81;78418.8;77274.0;155692.8
291995;201805;148;104;44;99216.0;41976.0;141192.0
292000;201805;386;294;92;278282.94;87768.0;366050.94
292010;201805;285;201;84;190800.8;79182.0;269982.8
292020;201805;277;202;75;192708.0;71550.0;264258.0
292030;201805;138;107;31;102078.0;29574.0;131652.0
292040;201805;630;319;311;304326.0;296694.0;601020.0
292045;201805;95;86;9;82044.0;8586.0;90630.0
292050;201805;892;621;271;591424.9;258248.0;849672.9
292060;201805;930;770;160;732673.25;152640.0;885313.25
292070;201805;50;21;29;20034.0;27666.0;47700.0
292080;201805;113;78;35;74412.0;33390.0;107802.0
292090;201805;503;177;326;168667.2;311004.0;479671.2
292100;201805;1410;604;806;574642.7;767656.5;1342299.2
292105;201805;204;172;32;164088.0;30528.0;194616.0
292110;201805;2110;781;1329;744749.6;1265850.5;2010600.1
292120;201805;644;517;127;492085.78;121158.0;613243.8
292130;201805;448;264;184;251856.0;175536.0;427392.0
292140;201805;197;154;43;146916.0;40890.26;187806.27
292145;201805;161;86;75;82044.0;71507.07;153551.06
292150;201805;1426;1141;285;1088514.0;270862.16;1359376.1
292160;201805;179;146;33;138997.8;31482.0;170479.8
292170;201805;1220;1069;151;1018133.3;143996.77;1162130.1
292180;201805;204;144;60;137376.0;57240.0;194616.0
292190;201805;159;96;63;91584.0;60102.0;151686.0
292200;201805;1278;463;815;440730.72;777015.56;1217746.2
292205;201805;118;105;13;99883.8;12402.0;112285.8
292210;201805;374;259;115;245703.0;108994.5;354697.5
292220;201805;22;16;6;15264.0;5724.0;20988.0
292225;201805;38;35;3;33390.0;2862.0;36252.0
292230;201805;923;750;173;712802.0;165042.0;877844.0
292240;201805;615;443;172;421525.0;164088.0;585613.0
292250;201805;1729;1107;622;1056078.0;593388.0;1649466.0
292260;201805;449;254;195;242316.0;185266.8;427582.8
292265;201805;267;188;79;179065.8;75366.0;254431.8
292270;201805;771;336;435;320544.0;414036.8;734580.8
292273;201805;202;111;91;105116.49;86814.0;191930.48
292275;201805;168;84;84;80136.0;79849.8;159985.8
292280;201805;141;100;41;95400.0;39114.0;134514.0
292285;201805;64;54;10;50848.2;9540.0;60388.2
292290;201805;562;376;186;356214.47;177158.0;533372.5
292300;201805;1633;619;1014;589953.8;966522.56;1556476.4
292303;201805;98;67;31;63918.0;29574.0;93492.0
292305;201805;111;79;32;75366.0;30528.0;105894.0
292310;201805;818;519;299;494764.0;283948.16;778712.1
292320;201805;661;497;164;473851.8;156456.0;630307.8
292330;201805;187;100;87;95400.0;82998.0;178398.0
292335;201805;278;215;63;205110.0;60102.0;265212.0
292340;201805;574;398;176;378952.84;167904.0;546856.9
292350;201805;270;145;125;137519.1;118963.8;256482.9
292360;201805;704;534;170;507719.0;162180.0;669899.0
292370;201805;773;591;182;563814.0;173628.0;737442.0
292380;201805;649;501;148;476046.62;141192.0;617238.6
292390;201805;500;188;312;179352.0;295883.5;475235.5
292400;201805;3373;2062;1311;1948599.5;1246527.8;3195127.2
292405;201805;263;175;88;166473.0;83665.8;250138.8
292410;201805;151;88;63;83952.0;60102.0;144054.0
292420;201805;307;262;45;249661.8;42930.0;292591.8
292430;201805;521;408;113;389232.0;107325.0;496557.0
292440;201805;582;496;86;471449.66;81757.8;553207.5
292450;201805;248;191;57;182214.0;54378.0;236592.0
292460;201805;588;436;152;415371.8;144912.6;560284.4
292465;201805;202;167;35;159318.0;32652.09;191970.1
292467;201805;103;60;43;57240.0;41022.0;98262.0
292470;201805;261;178;83;169812.0;79182.0;248994.0
292480;201805;330;220;110;208926.5;104654.0;313580.5
292490;201805;219;144;75;137376.0;71550.0;208926.0
292500;201805;1162;503;659;479651.0;628228.25;1107879.2
292510;201805;3341;1510;1831;1439300.1;1743903.6;3183203.8
292520;201805;1064;506;558;480859.7;532323.0;1013182.7
292525;201805;384;274;110;261391.23;104940.0;366331.22
292530;201805;4251;1741;2510;1657715.0;2393330.0;4051045.0
292540;201805;477;256;221;244224.0;210834.0;455058.0
292550;201805;1059;574;485;546873.8;462185.72;1009059.56
292560;201805;317;298;19;284292.0;18126.0;302418.0
292570;201805;301;230;71;219091.0;67734.0;286825.0
292575;201805;466;301;165;286868.0;157410.0;444278.0
292580;201805;918;580;338;551889.0;322166.0;874055.0
292590;201805;518;445;73;424227.6;69642.0;493869.6
292593;201805;142;112;30;106848.0;28620.0;135468.0
292595;201805;178;136;42;129744.0;40068.0;169812.0
292600;201805;1240;923;317;880225.0;301750.2;1181975.2
292610;201805;128;98;30;93492.0;28362.42;121854.42
292620;201805;528;437;91;416603.0;86814.0;503417.0
292630;201805;1382;796;586;757796.0;557413.1;1315209.1
292640;201805;774;541;233;515780.1;222282.0;738062.1
292650;201805;174;147;27;139952.0;25758.0;165710.0
292660;201805;1988;1431;557;1359350.9;527180.8;1886531.6
292665;201805;137;100;37;95400.0;35298.0;130698.0
292670;201805;399;321;78;306230.0;74412.0;380642.0
292680;201805;257;199;58;189846.0;54855.0;244701.0
292690;201805;186;143;43;136422.0;41022.0;177444.0
292700;201805;927;613;314;583848.8;299556.0;883404.8
292710;201805;99;87;12;82998.0;11448.0;94446.0
292720;201805;840;476;364;453302.62;347066.0;800368.6
292730;201805;199;94;105;88722.5;100170.0;188892.5
292740;201805;66835;33058;33777;3,15E+14;3,22E+14;6,37E+13
292750;201805;374;267;107;253658.94;101267.57;354926.5
292760;201805;323;260;63;247029.5;60102.0;307131.5
292770;201805;791;331;460;315488.0;438840.0;754328.0
292780;201805;414;153;261;145448.28;248994.0;394442.28
292790;201805;739;360;379;343440.0;361327.5;704767.5
292800;201805;1158;709;449;675432.0;428346.0;1103778.0
292805;201805;429;124;305;117771.3;290970.0;408741.3
292810;201805;1477;855;622;814525.8;593092.44;1407618.2
292820;201805;748;603;145;573354.9;138034.8;711389.7
292830;201805;106;84;22;80136.0;20988.0;101124.0
292840;201805;661;543;118;517634.0;112557.69;630191.7
292850;201805;130;87;43;82994.0;41022.0;124016.0
292860;201805;2174;1266;908;1203693.0;866232.0;2069925.0
292870;201805;3414;2285;1129;2178627.8;1077056.5;3255684.2
292880;201805;1469;963;506;914935.9;481484.0;1396419.9
292890;201805;488;420;68;400652.0;64872.0;465524.0
292895;201805;132;87;45;81639.5;42930.0;124569.5
292900;201805;390;286;104;272844.0;99216.0;372060.0
292905;201805;449;232;217;221328.0;207018.0;428346.0
292910;201805;415;315;100;300177.0;95400.0;395577.0
292920;201805;547;243;304;231822.0;290016.0;521838.0
292925;201805;503;466;37;443886.66;35279.0;479165.66
292930;201805;574;356;218;339624.0;207972.0;547596.0
292935;201805;294;127;167;121158.0;159318.0;280476.0
292937;201805;236;161;75;153594.0;71550.0;225144.0
292940;201805;194;147;47;140238.0;44838.0;185076.0
292950;201805;1108;570;538;541634.5;512299.0;1053933.5
292960;201805;551;368;183;351072.0;174582.0;525654.0
292970;201805;273;191;82;181547.0;78228.0;259775.0
292975;201805;155;88;67;83952.0;63728.0;147680.0
292980;201805;253;171;82;162304.44;78228.0;240532.44
292990;201805;1318;975;343;922527.7;327034.94;1249562.6
293000;201805;103;75;28;71550.0;26712.0;98262.0
293010;201805;2675;1633;1042;1552407.1;990031.0;2542438.2
293015;201805;660;526;134;501586.5;127197.0;628783.5
293020;201805;334;274;60;261396.0;57240.0;318636.0
293030;201805;620;540;80;514588.0;76320.0;590908.0
293040;201805;341;268;73;255672.0;69642.0;325314.0
293050;201805;2725;1588;1137;1506397.8;1080568.4;2586966.2
293060;201805;253;203;50;192475.0;46746.8;239221.8
293070;201805;3396;1732;1664;1644717.6;1585997.9;3230715.5
293075;201805;91;59;32;56286.0;30528.0;86814.0
293076;201805;70;46;24;43884.0;22896.0;66780.0
293077;201805;438;267;171;250871.27;163134.0;414005.28
293080;201805;450;399;51;380646.0;48654.0;429300.0
293090;201805;128;111;17;105894.0;16218.0;122112.0
293100;201805;521;367;154;350118.0;146916.0;497034.0
293105;201805;343;236;107;224858.0;102078.0;326936.0
293110;201805;171;120;51;114480.0;48654.0;163134.0
293120;201805;317;214;103;204156.0;98071.2;302227.2
293130;201805;246;166;80;158364.0;76320.0;234684.0
293135;201805;7963;3135;4828;2983476.0;4597656.0;7581132.0
293140;201805;186;120;66;114480.0;62201.0;176681.0
293150;201805;326;278;48;263781.2;45792.0;309573.2
293160;201805;428;246;182;234684.0;173628.0;408312.0
293170;201805;190;132;58;125928.0;54474.0;180402.0
293180;201805;466;318;148;303086.0;141192.0;444278.0
293190;201805;1279;888;391;842502.75;373014.0;1215516.8
293200;201805;531;469;62;446346.0;59148.0;505494.0
293210;201805;354;264;90;251704.0;85144.5;336848.5
293220;201805;2667;1081;1586;1029340.44;1510898.0;2540238.5
293230;201805;1766;639;1127;608175.8;1075158.0;1683333.8
293240;201805;220;201;19;191754.0;18126.0;209880.0
293245;201805;111;93;18;88722.0;17172.0;105894.0
293250;201805;733;275;458;262102.0;436932.0;699034.0
293260;201805;310;260;50;247086.17;47700.0;294786.16
293270;201805;1184;564;620;536148.7;591480.0;1127628.6
293280;201805;240;135;105;128790.0;100170.0;228960.0
293290;201805;3076;2013;1063;1919448.0;1013803.0;2933251.0
293300;201805;712;507;205;481345.5;193089.6;674435.1
293305;201805;151;129;22;123066.0;20988.0;144054.0
293310;201805;136;102;34;97308.0;32436.0;129744.0
293315;201805;159;122;37;116388.0;35298.0;151686.0
293317;201805;98;69;29;65826.0;27666.0;93492.0
293320;201805;971;561;410;534240.5;391140.0;925380.5
293325;201805;189;64;125;61056.0;119211.84;180267.84
293330;201805;12935;6069;6866;5779620.0;6542151.0;1,23E+14
293340;201805;252;182;70;173628.0;65826.0;239454.0
293345;201805;248;197;51;187938.0;48654.0;236592.0
293350;201805;639;346;293;330084.0;278043.3;608127.3
293360;201805;1579;1127;452;1074204.0;430921.8;1505125.8
310010;201805;152;78;74;74412.0;70310.0;144722.0
310020;201805;1055;577;478;548390.5;454104.12;1002494.56
310030;201805;324;262;62;248822.88;59148.0;307970.88
310040;201805;49;30;19;28620.0;18126.0;46746.0
310050;201805;186;124;62;117342.0;58862.0;176204.0
310060;201805;237;166;71;157887.0;67734.0;225621.0
310070;201805;16;8;8;7632.0;7632.0;15264.0
310080;201805;49;27;22;25758.0;20988.0;46746.0
310090;201805;967;512;455;482331.56;432925.6;915257.2
310100;201805;299;226;73;215604.0;69642.0;285246.0
310110;201805;730;390;340;370738.9;323043.0;693781.9
310120;201805;390;212;178;201580.2;169437.94;371018.12
310130;201805;33;21;12;20034.0;11448.0;31482.0
310140;201805;27;15;12;14310.0;11448.0;25758.0
310150;201805;1296;885;411;839379.4;391235.8;1230615.2
310160;201805;2106;1068;1038;1010765.5;987581.2;1998346.8
310163;201805;93;53;40;50562.0;38160.0;88722.0
310170;201805;2603;1094;1509;1042884.2;1437964.6;2480848.8
310180;201805;134;52;82;49608.0;77846.4;127454.4
310190;201805;486;327;159;311958.0;151113.6;463071.6
310200;201805;504;322;182;307188.0;173501.0;480689.0
310205;201805;59;46;13;43884.0;12402.0;56286.0
310210;201805;276;225;51;214650.0;48081.6;262731.6
310220;201805;58;33;25;31482.0;23850.0;55332.0
310230;201805;264;184;80;175345.2;76320.0;251665.2
310240;201805;104;90;14;85621.5;13356.0;98977.5
310250;201805;99;80;19;76320.0;18126.0;94446.0
310260;201805;797;425;372;402494.25;354153.4;756647.7
310270;201805;277;185;92;175937.0;87768.0;263705.0
310280;201805;364;273;91;259692.86;86814.0;346506.88
310285;201805;219;156;63;148515.86;60102.0;208617.86
310290;201805;259;150;109;143100.0;103986.0;247086.0
310300;201805;154;128;26;122112.0;24804.0;146916.0
310310;201805;8;5;3;4770.0;2862.0;7632.0
310320;201805;23;14;9;13356.0;8586.0;21942.0
310330;201805;31;23;8;21942.0;7632.0;29574.0
310340;201805;1716;1109;607;1049019.6;577552.5;1626572.1
310350;201805;2857;1552;1305;1476739.8;1244388.8;2721128.5
310360;201805;40;33;7;31482.0;6678.0;38160.0
310370;201805;127;105;22;100170.0;20702.0;120872.0
310375;201805;107;38;69;36252.0;65807.0;102059.0
310380;201805;53;31;22;28668.0;20988.0;49656.0
310390;201805;103;70;33;66780.0;31482.0;98262.0
310400;201805;2364;1536;828;1461434.0;789625.8;2251059.8
310410;201805;125;68;57;64872.0;54378.0;119250.0
310420;201805;666;354;312;335904.8;296685.06;632589.9
310430;201805;325;216;109;205825.5;103986.0;309811.5
310440;201805;69;41;28;39114.0;26712.0;65826.0
310445;201805;84;66;18;62964.0;17172.0;80136.0
310450;201805;861;539;322;514206.0;306901.8;821107.8
310460;201805;263;190;73;181260.0;69642.0;250902.0
310470;201805;505;323;182;308142.0;173628.0;481770.0
310480;201805;79;57;22;54378.0;20988.0;75366.0
310490;201805;505;240;265;228006.2;252810.0;480816.2
310500;201805;125;53;72;50562.0;68688.0;119250.0
310510;201805;610;398;212;378452.6;202229.45;580682.06
310520;201805;129;87;42;82998.0;40068.0;123066.0
310530;201805;85;39;46;37206.0;43597.8;80803.8
310540;201805;458;283;175;267598.6;166663.8;434262.4
310550;201805;89;59;30;56286.0;28620.0;84906.0
310560;201805;2954;2033;921;1928768.5;877055.1;2805823.8
310570;201805;119;81;38;77274.0;36252.0;113526.0
310590;201805;351;233;118;220899.8;112557.69;333457.5
310600;201805;159;90;69;84095.7;65826.0;149921.7
310610;201805;60;22;38;20988.0;36252.0;57240.0
310620;201805;46079;22098;23981;2,10E+13;2,28E+14;4,38E+12
310630;201805;608;386;222;365525.6;210453.4;575979.0
310640;201805;140;116;24;110282.0;22896.0;133178.0
310650;201805;164;144;20;136136.0;19080.0;155216.0
310660;201805;91;57;34;54378.0;32436.0;86814.0
310665;201805;55;40;15;38160.0;14310.0;52470.0
310670;201805;6417;2937;3480;2794009.2;3315256.2;6109265.5
310680;201805;58;38;20;36252.0;19080.0;55332.0
310690;201805;610;445;165;419561.16;157410.0;576971.2
310700;201805;58;37;21;35298.0;19890.9;55188.9
310710;201805;1247;843;404;802424.44;384843.8;1187268.2
310720;201805;91;29;62;27666.0;59148.0;86814.0
310730;201805;1372;955;417;909830.5;397532.0;1307362.5
310740;201805;994;558;436;529184.4;415410.25;944594.7
310750;201805;248;146;102;138330.19;97308.0;235638.19
310760;201805;71;54;17;51516.0;15932.0;67448.0
310770;201805;92;45;47;42930.0;44838.0;87768.0
310780;201805;402;329;73;313284.6;69642.0;382926.6
310790;201805;101;81;20;77274.0;19080.0;96354.0
310800;201805;456;221;235;210357.0;223903.8;434260.8
310810;201805;169;118;51;111513.2;47700.0;159213.2
310820;201805;354;281;73;268074.0;69355.8;337429.8
310825;201805;198;162;36;154548.0;34344.0;188892.0
310830;201805;465;223;242;212081.94;230725.0;442806.94
310840;201805;385;221;164;210834.0;156456.0;367290.0
310850;201805;110;88;22;83952.0;20988.0;104940.0
310855;201805;379;301;78;287154.0;74412.0;361566.0
310860;201805;1403;1049;354;996736.9;335980.9;1332717.8
310870;201805;55;43;12;41022.0;11448.0;52470.0
310880;201805;84;66;18;62677.8;17172.0;79849.8
310890;201805;312;184;128;175536.0;122112.0;297648.0
310900;201805;636;294;342;277838.28;325962.8;603801.06
310910;201805;247;168;79;158937.2;75366.0;234303.2
310920;201805;486;290;196;272845.2;186984.0;459829.2
310925;201805;40;33;7;31482.0;6392.0;37874.0
310930;201805;1098;664;434;633339.5;413941.06;1047280.6
310940;201805;685;347;338;330437.8;322452.0;652889.8
310945;201805;116;71;45;67734.0;42930.0;110664.0
310950;201805;253;201;52;191754.0;49608.0;241362.0
310960;201805;83;30;53;28620.0;50558.0;79178.0
310970;201805;167;103;64;98262.0;60133.76;158395.77
310980;201805;42;22;20;20988.0;19080.0;40068.0
310990;201805;151;85;66;80804.0;62964.0;143768.0
311000;201805;861;425;436;401921.7;415935.0;817856.7
311010;201805;39;32;7;30528.0;6678.0;37206.0
311020;201805;42;26;16;24804.0;15264.0;40068.0
311030;201805;386;231;155;218359.0;147775.0;366134.0
311040;201805;39;34;5;32436.0;4770.0;37206.0
311050;201805;466;194;272;184504.0;258915.6;443419.6
311060;201805;768;436;332;414513.4;316442.0;730955.4
311070;201805;331;152;179;145008.0;170766.0;315774.0
311080;201805;107;58;49;55332.0;46746.0;102078.0
311090;201805;396;186;210;176204.0;200340.0;376544.0
311100;201805;611;365;246;347923.8;234397.8;582321.6
311110;201805;679;472;207;450001.8;197469.0;647470.8
311115;201805;68;49;19;46746.0;18126.0;64872.0
311120;201805;1058;556;502;529134.0;477906.9;1007040.9
311130;201805;407;240;167;228769.2;159318.0;388087.2
311140;201805;165;84;81;80136.0;76463.1;156599.1
311150;201805;356;234;122;223236.0;116149.5;339385.5
311160;201805;747;538;209;510867.4;198909.0;709776.4
311170;201805;79;59;20;56286.0;18793.8;75079.8
311180;201805;349;234;115;222949.8;109424.0;332373.8
311190;201805;36;18;18;17172.0;17172.0;34344.0
311200;201805;341;238;103;225430.6;98262.0;323692.6
311205;201805;30;20;10;19080.0;9158.4;28238.4
311210;201805;49;41;8;38828.0;7632.0;46460.0
311220;201805;19;17;2;16218.0;1908.0;18126.0
311230;201805;1634;1064;570;1010976.94;543780.0;1554757.0
311240;201805;175;111;64;105690.33;61056.0;166746.33
311250;201805;82;29;53;27666.0;50562.0;78228.0
311260;201805;556;350;206;333900.0;196524.0;530424.0
311265;201805;117;82;35;78228.0;33390.0;111618.0
311270;201805;283;205;78;195570.0;74412.0;269982.0
311280;201805;214;97;117;92538.0;111045.6;203583.6
311290;201805;108;88;20;83952.0;18794.0;102746.0
311300;201805;552;349;203;332946.0;193376.0;526322.0
311310;201805;25;19;6;18126.0;5724.0;23850.0
311320;201805;674;502;172;477954.0;164088.0;642042.0
311330;201805;1036;761;275;725755.5;261396.4;987151.9
311340;201805;2647;1878;769;1783895.9;732263.9;2516159.8
311350;201805;273;208;65;198432.0;62010.0;260442.0
311360;201805;180;106;74;101124.0;70596.0;171720.0
311370;201805;1204;493;711;468328.5;677721.6;1146050.1
311380;201805;7;6;1;5724.0;954.0;6678.0
311390;201805;280;148;132;141192.0;125451.2;266643.2
311400;201805;148;99;49;94446.0;46746.0;141192.0
311410;201805;103;58;45;55046.0;42930.0;97976.0
311420;201805;304;171;133;160976.8;126882.0;287858.8
311430;201805;859;558;301;531379.0;286868.0;818247.0
311440;201805;491;342;149;326268.0;141859.8;468127.8
311450;201805;324;204;120;194616.0;114480.0;309096.0
311455;201805;304;206;98;196228.8;93205.8;289434.6
311460;201805;136;56;80;53424.0;75514.27;128938.27
311470;201805;23;13;10;12402.0;9540.0;21942.0
311480;201805;30;12;18;11448.0;17172.0;28620.0
311490;201805;16;10;6;9540.0;5724.0;15264.0
311500;201805;20;10;10;9540.0;9540.0;19080.0
311510;201805;626;437;189;414955.7;180019.8;594975.5
311520;201805;45;34;11;31768.2;10494.0;42262.2
311530;201805;1804;1350;454;1278457.1;433116.0;1711573.1
311535;201805;69;51;18;48654.0;17172.0;65826.0
311540;201805;35;30;5;28620.0;4770.0;33390.0
311545;201805;189;141;48;134514.0;45792.0;180306.0
311547;201805;32;23;9;21942.0;8586.0;30528.0
311550;201805;655;296;359;282384.0;342467.47;624851.44
311560;201805;43;28;15;26712.0;14310.0;41022.0
311570;201805;302;202;100;192135.6;95400.0;287535.6
311580;201805;314;185;129;176203.8;123066.0;299269.8
311590;201805;33;29;4;27666.0;3816.0;31482.0
311600;201805;91;72;19;68688.0;18126.0;86814.0
311610;201805;260;227;33;215604.5;31482.0;247086.5
311615;201805;101;84;17;79496.82;16027.2;95524.02
311620;201805;20;11;9;10494.0;8586.0;19080.0
311630;201805;86;72;14;68688.0;13356.0;82044.0
311640;201805;125;66;59;62964.0;56286.0;119250.0
311650;201805;131;97;34;91822.5;32436.0;124258.5
311660;201805;410;197;213;187938.0;203202.0;391140.0
311670;201805;169;109;60;103741.0;57240.0;160981.0
311680;201805;223;160;63;151738.95;59338.8;211077.75
311690;201805;18;11;7;10494.0;6678.0;17172.0
311700;201805;200;141;59;134227.8;56286.0;190513.8
311710;201805;212;135;77;128790.0;73458.0;202248.0
311720;201805;38;27;11;25758.0;10494.0;36252.0
311730;201805;551;360;191;342868.0;182214.0;525082.0
311740;201805;40;29;11;27666.0;10494.0;38160.0
311750;201805;716;483;233;458874.8;222282.0;681156.8
311760;201805;65;36;29;34344.0;27666.0;62010.0
311770;201805;405;194;211;183168.62;201294.0;384462.62
311780;201805;170;95;75;90344.0;71233.0;161577.0
311783;201805;82;73;9;69642.0;8586.0;78228.0
311787;201805;34;14;20;13356.0;19080.0;32436.0
311790;201805;264;128;136;122112.0;129744.0;251856.0
311800;201805;640;430;210;406834.3;199672.2;606506.5
311810;201805;43;36;7;34344.0;6678.0;41022.0
311820;201805;107;90;17;85860.0;16218.0;102078.0
311830;201805;1917;1212;705;1150639.5;669192.1;1819831.6
311840;201805;1024;569;455;537962.9;432601.53;970564.44
311850;201805;9;5;4;4770.0;3816.0;8586.0
311860;201805;9483;4305;5178;4090284.5;4932119.0;9022404.0
311870;201805;151;84;67;80136.0;63918.0;144054.0
311880;201805;952;707;245;672942.8;233730.0;906672.8
311890;201805;219;111;108;105894.0;103032.0;208926.0
311900;201805;84;35;49;33390.0;46746.0;80136.0
311910;201805;1400;864;536;822062.6;509245.4;1331308.0
311920;201805;230;150;80;143100.0;76320.0;219420.0
311930;201805;916;525;391;500468.6;372776.0;873244.6
311940;201805;2498;1301;1197;1238817.8;1138694.4;2377512.0
311950;201805;38;27;11;25758.0;10494.0;36252.0
311960;201805;65;46;19;43884.0;18126.0;62010.0
311970;201805;26;17;9;13928.4;8586.0;22514.4
311980;201805;43;33;10;31482.0;9540.0;41022.0
311990;201805;57;40;17;38160.0;16218.0;54378.0
311995;201805;64;45;19;42930.0;18126.0;61056.0
312000;201805;35;25;10;23563.8;9540.0;33103.8
312010;201805;82;60;22;57240.0;20988.0;78228.0
312015;201805;99;75;24;71264.0;22896.0;94160.0
312020;201805;140;87;53;82998.0;50535.42;133533.42
312030;201805;43;34;9;31769.0;8586.0;40355.0
312040;201805;83;53;30;50562.0;28620.0;79182.0
312050;201805;220;116;104;110664.0;99216.0;209880.0
312060;201805;69;42;27;40068.0;25090.2;65158.2
312070;201805;74;46;28;43884.0;26712.0;70596.0
312080;201805;530;241;289;229914.0;275706.0;505620.0
312083;201805;49;36;13;34344.0;12402.0;46746.0
312087;201805;113;91;22;86814.0;20988.0;107802.0
312090;201805;2901;1650;1251;1561130.8;1190072.2;2751203.0
312100;201805;159;113;46;107802.0;43102.0;150904.0
312110;201805;120;73;47;69642.0;44838.0;114480.0
312120;201805;142;106;36;99884.0;34344.0;134228.0
312125;201805;98;55;43;52279.2;41022.0;93301.2
312130;201805;123;82;41;78228.0;39114.0;117342.0
312140;201805;136;106;30;101124.0;28620.0;129744.0
312150;201805;45;35;10;33390.0;9540.0;42930.0
312160;201805;1529;1013;516;961919.2;490852.47;1452771.6
312170;201805;12;10;2;9540.0;1908.0;11448.0
312180;201805;98;60;38;56525.0;35966.0;92491.0
312190;201805;32;28;4;26712.0;3816.0;30528.0
312200;201805;734;634;100;602880.7;95400.0;698280.7
312210;201805;97;64;33;61056.0;31482.0;92538.0
312220;201805;124;92;32;87530.0;30528.0;118058.0
312230;201805;3528;1733;1795;1648924.5;1710526.6;3359451.0
312235;201805;156;103;53;98262.0;50562.0;148824.0
312240;201805;108;71;37;67734.0;35298.0;103032.0
312245;201805;167;113;54;107798.0;51516.0;159314.0
312247;201805;62;44;18;41213.0;17172.0;58385.0
312250;201805;181;83;98;79182.0;93492.0;172674.0
312260;201805;105;70;35;65921.4;33390.0;99311.4
312270;201805;136;85;51;81090.0;48654.0;129744.0
312280;201805;27;17;10;16218.0;9540.0;25758.0
312290;201805;163;112;51;106714.54;47701.0;154415.55
312300;201805;201;132;69;125928.0;65826.0;191754.0
312310;201805;59;54;5;51516.0;4770.0;56286.0
312320;201805;423;263;160;248994.0;151066.1;400060.1
312330;201805;89;78;11;73649.0;10207.8;83856.8
312340;201805;35;16;19;15264.0;18126.0;33390.0
312350;201805;16;10;6;9540.0;5724.0;15264.0
312352;201805;98;66;32;62964.0;30528.0;93492.0
312360;201805;559;253;306;240408.0;291924.0;532332.0
312370;201805;304;179;125;170479.8;119250.0;289729.8
312380;201805;138;88;50;83952.0;47700.0;131652.0
312385;201805;174;141;33;134514.0;31482.0;165996.0
312390;201805;299;187;112;178398.0;106181.0;284579.0
312400;201805;381;290;91;276660.0;86338.0;362998.0
312410;201805;882;284;598;270459.0;569916.0;840375.0
312420;201805;612;488;124;464884.2;118296.0;583180.2
312430;201805;871;642;229;610180.06;217512.2;827692.25
312440;201805;47;35;12;33390.0;11448.0;44838.0
312450;201805;210;129;81;123066.0;77274.0;200340.0
312460;201805;59;29;30;27666.0;28620.0;56286.0
312470;201805;54;35;19;33390.0;18126.0;51516.0
312480;201805;205;126;79;120204.0;75366.0;195570.0
312490;201805;268;185;83;176490.0;79182.0;255672.0
312500;201805;32;18;14;17172.0;13356.0;30528.0
312510;201805;440;168;272;160272.0;258872.39;419144.38
312520;201805;42;15;27;14310.0;25758.0;40068.0
312530;201805;49;37;12;35298.0;11448.0;46746.0
312540;201805;103;90;13;85860.0;12402.0;98262.0
312550;201805;39;30;9;28620.0;8586.0;37206.0
312560;201805;211;156;55;148538.0;52183.8;200721.8
312570;201805;438;264;174;251188.2;165304.45;416492.66
312580;201805;82;43;39;41022.0;37206.0;78228.0
312590;201805;266;210;56;200340.0;53424.0;253764.0
312595;201805;140;125;15;119250.0;14310.0;133560.0
312600;201805;76;46;30;43455.0;28620.0;72075.0
312610;201805;1632;860;772;812746.0;734771.6;1547517.6
312620;201805;191;135;56;128790.0;53419.23;182209.23
312630;201805;64;54;10;51516.0;9540.0;61056.0
312640;201805;48;13;35;12402.0;33390.0;45792.0
312650;201805;151;124;27;118010.0;25472.0;143482.0
312660;201805;71;53;18;50276.0;17172.0;67448.0
312670;201805;865;569;296;541873.0;282170.3;824043.3
312675;201805;41;31;10;29574.0;9540.0;39114.0
312680;201805;85;57;28;53996.4;26712.0;80708.4
312690;201805;237;127;110;121148.46;104653.8;225802.27
312695;201805;32;24;8;22896.0;7632.0;30528.0
312700;201805;214;124;90;118296.0;85860.0;204156.0
312705;201805;77;63;14;60102.0;13356.0;73458.0
312707;201805;95;70;25;66360.24;23850.0;90210.24
312710;201805;1889;1007;882;958617.6;841217.0;1799834.6
312720;201805;66;33;33;31482.0;31482.0;62964.0
312730;201805;288;168;120;159318.0;114480.0;273798.0
312733;201805;52;44;8;41690.0;7632.0;49322.0
312735;201805;22;16;6;15264.0;5724.0;20988.0
312737;201805;67;36;31;34344.0;29574.0;63918.0
312738;201805;56;41;15;39114.0;14310.0;53424.0
312740;201805;75;50;25;47700.0;23850.0;71550.0
312750;201805;70;52;18;49608.0;17172.0;66780.0
312760;201805;270;198;72;188892.0;68688.0;257580.0
312770;201805;7637;3543;4094;3355124.0;3897251.2;7252375.0
312780;201805;432;332;100;316441.8;95400.0;411841.8
312790;201805;20;15;5;14310.0;4770.0;19080.0
312800;201805;1610;1130;480;1070599.2;456966.6;1527565.9
312810;201805;368;239;129;227719.8;123066.0;350785.8
312820;201805;193;146;47;139284.0;44838.0;184122.0
312825;201805;27;18;9;17172.0;8586.0;25758.0
312830;201805;282;167;115;158079.0;109071.0;267150.0
312840;201805;147;109;38;103986.0;36252.0;140238.0
312850;201805;26;23;3;21942.0;2862.0;24804.0
312860;201805;171;104;67;98930.0;63918.0;162848.0
312870;201805;987;517;470;490324.25;448380.0;938704.25
312880;201805;151;103;48;98118.9;45696.6;143815.5
312890;201805;166;114;52;108756.0;49608.0;158364.0
312900;201805;210;157;53;149110.2;50562.0;199672.2
312910;201805;192;98;94;92323.72;89676.0;181999.72
312920;201805;159;89;70;84906.0;66780.0;151686.0
312930;201805;341;247;94;235638.0;89676.0;325314.0
312940;201805;109;73;36;69642.0;34344.0;103986.0
312950;201805;699;463;236;440652.6;225144.0;665796.6
312960;201805;173;134;39;127836.0;37206.0;165042.0
312965;201805;52;48;4;45792.0;3816.0;49608.0
312970;201805;293;235;58;223236.2;55332.0;278568.2
312980;201805;2323;1227;1096;1166067.4;1045007.6;2211075.0
312990;201805;49;28;21;26712.0;20034.0;46746.0
313000;201805;40;25;15;23850.0;14310.0;38160.0
313005;201805;166;128;38;121873.5;35966.0;157839.5
313010;201805;939;381;558;362233.8;532323.0;894556.8
313020;201805;188;99;89;93969.0;84906.0;178875.0
313030;201805;208;135;73;126883.0;69642.0;196525.0
313040;201805;65;25;40;23850.0;38160.0;62010.0
313050;201805;297;206;91;195570.2;86814.0;282384.2
313055;201805;46;34;12;32436.0;11448.0;43884.0
313060;201805;127;88;39;83952.0;36919.8;120871.8
313065;201805;59;38;21;36252.0;20034.0;56286.0
313070;201805;150;80;70;76320.0;66780.0;143100.0
313080;201805;42;18;24;17172.0;22896.0;40068.0
313090;201805;706;488;218;464264.3;207972.0;672236.3
313100;201805;163;64;99;61056.0;94438.0;155494.0
313110;201805;127;75;52;71550.0;49608.0;121158.0
313115;201805;161;88;73;83751.66;69642.0;153393.66
313120;201805;754;413;341;393716.0;324074.0;717790.0
313130;201805;5292;2860;2432;2701797.2;2311467.8;5013265.0
313140;201805;160;82;78;78228.0;74412.0;152640.0
313150;201805;314;250;64;238500.0;60769.8;299269.8
313160;201805;200;145;55;138044.0;52470.0;190514.0
313170;201805;1364;959;405;901866.1;385979.4;1287845.5
313180;201805;330;198;132;188243.28;125928.0;314171.28
313190;201805;743;445;298;421477.4;283529.0;705006.4
313200;201805;24;23;1;21942.0;954.0;22896.0
313210;201805;1040;877;163;833655.2;155497.23;989152.4
313220;201805;238;162;76;153594.0;71788.5;225382.5
313230;201805;269;198;71;187939.0;67734.0;255673.0
313240;201805;1923;1024;899;974026.5;854683.8;1828710.4
313250;201805;1265;942;323;893042.6;306235.8;1199278.4
313260;201805;97;54;43;51516.0;41022.0;92538.0
313270;201805;962;563;399;533430.4;380646.0;914076.4
313280;201805;61;52;9;49131.0;8586.0;57717.0
313290;201805;226;183;43;174296.0;40068.8;214364.8
313300;201805;377;194;183;181929.0;174582.0;356511.0
313310;201805;230;120;110;114480.0;104940.0;219420.0
313320;201805;373;288;85;272797.1;81090.0;353887.1
313330;201805;1365;834;531;794205.2;505382.5;1299587.8
313340;201805;337;234;103;223236.0;98262.0;321498.0
313350;201805;522;353;169;334854.1;161226.0;496080.1
313360;201805;117;69;48;65826.0;45506.0;111332.0
313370;201805;190;70;120;66780.0;114480.0;181260.0
313375;201805;278;168;110;160272.0;104940.0;265212.0
313380;201805;1326;683;643;649693.06;613132.0;1262825.1
313390;201805;49;42;7;39114.8;6678.0;45792.8
313400;201805;424;279;145;266166.0;137758.0;403924.0
313410;201805;19;11;8;10494.0;7632.0;18126.0
313420;201805;4693;2445;2248;2322964.2;2138556.8;4461521.0
313430;201805;143;66;77;62964.0;73172.0;136136.0
313440;201805;1485;1011;474;961966.9;451052.0;1413018.9
313450;201805;63;27;36;25758.0;34057.8;59815.8
313460;201805;374;178;196;168372.0;186984.0;355356.0
313470;201805;537;245;292;233730.0;277900.2;511630.2
313480;201805;157;107;50;101125.0;47700.0;148825.0
313490;201805;514;251;263;238844.05;250855.0;489699.06
313500;201805;22;14;8;13356.0;7632.0;20988.0
313505;201805;976;758;218;722528.2;207685.8;930214.0
313507;201805;96;57;39;54378.0;37206.0;91584.0
313510;201805;2785;1775;1010;1688587.5;962586.0;2651173.5
313520;201805;3616;2820;796;2677536.8;759380.0;3436916.8
313530;201805;44;29;15;27666.0;14310.0;41976.0
313535;201805;107;85;22;80423.0;20988.0;101411.0
313540;201805;72;55;17;52470.0;16218.0;68688.0
313545;201805;116;96;20;91584.0;19080.0;110664.0
313550;201805;231;190;41;181260.0;38828.0;220088.0
313560;201805;331;172;159;164088.0;151686.0;315774.0
313570;201805;61;32;29;30528.0;27666.0;58194.0
313580;201805;1312;718;594;683541.0;564959.4;1248500.4
313590;201805;83;51;32;48654.0;30528.0;79182.0
313600;201805;695;413;282;393716.0;268170.0;661886.0
313610;201805;61;49;12;46126.8;11448.0;57574.8
313620;201805;1368;723;645;678546.56;611447.0;1289993.6
313630;201805;1643;1253;390;1191928.4;371774.0;1563702.4
313640;201805;129;75;54;71550.0;51516.0;123066.0
313650;201805;237;109;128;103986.0;121540.0;225526.0
313652;201805;17;17;0;16218.0;0.0;16218.0
313655;201805;54;31;23;29574.0;21942.0;51516.0
313657;201805;48;45;3;42930.0;2862.0;45792.0
313660;201805;134;92;42;87768.0;40068.0;127836.0
313665;201805;644;314;330;299270.0;314581.5;613851.5
313670;201805;10370;7153;3217;6799128.5;3067206.5;9866335.0
313680;201805;42;31;11;29574.0;10390.0;39964.0
313690;201805;156;118;38;112572.0;36252.0;148824.0
313695;201805;73;54;19;51516.0;18126.0;69642.0
313700;201805;300;241;59;229628.0;56286.0;285914.0
313710;201805;151;101;50;96354.0;47700.0;144054.0
313720;201805;1091;520;571;493599.8;543389.9;1036989.7
313730;201805;60;41;19;39114.0;18126.0;57240.0
313740;201805;162;130;32;124020.0;30528.0;154548.0
313750;201805;442;323;119;307866.53;113526.0;421392.53
313753;201805;241;172;69;163420.2;65826.0;229246.2
313760;201805;1258;455;803;434070.0;763325.5;1197395.5
313770;201805;355;256;99;243032.2;94446.0;337478.2
313780;201805;759;393;366;374922.0;348877.8;723799.8
313790;201805;27;26;1;24804.0;954.0;25758.0
313800;201805;148;90;58;85860.0;55332.0;141192.0
313810;201805;69;41;28;39114.0;26712.0;65826.0
313820;201805;1289;638;651;607698.2;619791.0;1227489.2
313830;201805;67;49;18;46746.0;17172.0;63918.0
313835;201805;55;47;8;44838.0;7632.0;52470.0
313840;201805;1701;1047;654;993497.5;622390.0;1615887.5
313850;201805;183;63;120;60102.0;113900.06;174002.06
313860;201805;485;377;108;356177.3;103032.0;459209.3
313862;201805;173;115;58;109710.0;55332.0;165042.0
313865;201805;89;71;18;67734.0;17172.0;84906.0
313867;201805;50;39;11;37206.0;10494.0;47700.0
313868;201805;26;17;9;15455.0;8586.0;24041.0
313870;201805;129;67;62;63918.0;58862.0;122780.0
313880;201805;356;225;131;214650.0;124401.8;339051.8
313890;201805;323;171;152;162371.8;144435.6;306807.4
313900;201805;907;497;410;473184.5;391093.0;864277.5
313910;201805;138;99;39;94446.0;36252.2;130698.2
313920;201805;615;438;177;417661.2;168338.0;585999.2
313925;201805;32;28;4;26712.0;3816.0;30528.0
313930;201805;810;628;182;598674.0;173605.0;772279.0
313940;201805;1808;1138;670;1081168.4;638512.4;1719680.8
313950;201805;943;600;343;570588.6;326935.8;897524.4
313960;201805;1394;803;591;761798.3;562574.0;1324372.2
313970;201805;118;81;37;77274.0;35298.0;112572.0
313980;201805;211;137;74;130460.0;70596.0;201056.0
313990;201805;372;223;149;212742.0;142066.81;354808.8
314000;201805;931;630;301;597539.9;287149.22;884689.1
314010;201805;77;50;27;47700.0;25758.0;73458.0
314015;201805;53;18;35;17172.0;33390.0;50562.0
314020;201805;50;34;16;32436.0;15264.0;47700.0
314030;201805;86;39;47;37043.82;44838.0;81881.82
314040;201805;43;30;13;28620.0;12402.0;41022.0
314050;201805;319;188;131;179066.0;124163.1;303229.1
314053;201805;100;67;33;62964.4;31482.0;94446.4
314055;201805;304;179;125;170766.0;119250.0;290016.0
314060;201805;146;124;22;117342.0;20988.0;138330.0
314070;201805;1016;509;507;481781.12;483058.0;964839.1
314080;201805;219;143;76;135181.8;71454.88;206636.69
314085;201805;135;88;47;83952.0;44838.0;128790.0
314090;201805;356;257;99;245178.0;94441.23;339619.22
314100;201805;478;392;86;370153.0;81472.0;451625.0
314110;201805;698;376;322;357091.75;306472.6;663564.3
314120;201805;96;54;42;51516.0;40068.0;91584.0
314130;201805;25;12;13;11448.0;12402.0;23850.0
314140;201805;1097;665;432;630765.94;409552.88;1040318.75
314150;201805;163;104;59;99216.0;56286.0;155502.0
314160;201805;352;261;91;246132.8;86624.0;332756.8
314170;201805;74;56;18;53424.0;17172.0;70596.0
314180;201805;733;644;89;614090.0;83952.5;698042.5
314190;201805;103;61;42;58194.0;40068.0;98262.0
314200;201805;588;407;181;387007.6;171720.0;558727.6
314210;201805;284;213;71;202248.0;67448.0;269696.0
314220;201805;312;236;76;223237.0;72218.0;295455.0
314225;201805;64;45;19;42930.0;18126.0;61056.0
314230;201805;105;47;58;44838.0;55332.0;100170.0
314240;201805;139;106;33;101124.0;31482.0;132606.0
314250;201805;60;36;24;34344.0;22896.0;57240.0
314260;201805;190;96;94;91584.0;89676.0;181260.0
314270;201805;331;262;69;249185.0;65540.0;314725.0
314280;201805;691;385;306;367281.0;291924.0;659205.0
314290;201805;558;455;103;432830.5;97975.8;530806.3
314300;201805;412;293;119;276586.0;113479.0;390065.0
314310;201805;1454;979;475;932059.3;453129.97;1385189.2
314315;201805;36;29;7;27666.0;6678.0;34344.0
314320;201805;608;390;218;371487.8;207332.81;578820.6
314330;201805;10688;5374;5314;5115906.0;5065091.0;1,02E+14
314340;201805;576;266;310;253191.8;295168.0;548359.8
314345;201805;32;25;7;23850.0;6678.0;30528.0
314350;201805;190;119;71;113526.0;67734.0;181260.0
314360;201805;76;47;29;44838.0;27666.0;72504.0
314370;201805;57;47;10;44838.0;9540.0;54378.0
314380;201805;92;66;26;62964.0;24804.0;87768.0
314390;201805;3248;2055;1193;1954937.2;1135165.4;3090102.8
314400;201805;686;492;194;466498.2;185076.0;651574.2
314410;201805;436;285;151;271890.0;144054.0;415944.0
314420;201805;19;9;10;8586.0;9540.0;18126.0
314430;201805;2519;896;1623;851036.3;1545639.6;2396676.0
314435;201805;272;157;115;149491.8;108756.0;258247.8
314437;201805;28;22;6;20988.0;5724.0;26712.0
314440;201805;100;72;28;68688.0;26712.0;95400.0
314450;201805;156;115;41;109710.0;39114.0;148824.0
314460;201805;655;302;353;288108.0;336762.0;624870.0
314465;201805;84;56;28;53424.0;26712.0;80136.0
314467;201805;67;56;11;53415.0;10494.0;63909.0
314470;201805;390;202;188;189256.52;178398.5;367655.03
314480;201805;1084;518;566;494172.0;539773.2;1033945.2
314490;201805;88;66;22;62964.0;20988.0;83952.0
314500;201805;313;208;105;198432.0;100170.0;298602.0
314505;201805;126;82;44;78228.0;41976.0;120204.0
314510;201805;227;184;43;175536.0;41022.0;216558.0
314520;201805;1263;655;608;617338.7;578362.9;1195701.6
314530;201805;735;579;156;550640.75;148824.0;699464.75
314535;201805;212;134;78;126786.6;74161.01;200947.61
314537;201805;63;38;25;36252.0;23850.0;60102.0
314540;201805;14;9;5;8586.0;4770.0;13356.0
314545;201805;50;32;18;30528.0;17172.0;47700.0
314550;201805;81;44;37;41976.0;35298.0;77274.0
314560;201805;813;437;376;414417.8;358704.0;773121.8
314570;201805;22;17;5;16218.0;4770.0;20988.0
314580;201805;17;8;9;7632.0;8586.0;16218.0
314585;201805;19;14;5;13356.0;4770.0;18126.0
314587;201805;85;73;12;69642.0;11448.0;81090.0
314590;201805;562;411;151;392094.0;144054.0;536148.0
314600;201805;987;644;343;609981.06;325886.6;935867.7
314610;201805;945;515;430;488448.7;409743.0;898191.7
314620;201805;155;115;40;108183.6;38160.0;146343.6
314625;201805;97;71;26;67162.0;24804.0;91966.0
314630;201805;1240;636;604;605265.3;575643.8;1180909.1
314640;201805;91;60;31;57240.0;29287.8;86527.8
314650;201805;200;116;84;110377.8;79659.0;190036.8
314655;201805;67;52;15;49608.0;14310.0;63918.0
314660;201805;20;15;5;14310.0;4770.0;19080.0
314670;201805;193;153;40;145676.0;38160.0;183836.0
314675;201805;217;126;91;120204.0;86814.0;207018.0
314690;201805;535;297;238;283051.8;227052.0;510103.8
314700;201805;2440;1337;1103;1270205.2;1051074.9;2321280.2
314710;201805;1629;953;676;903584.9;644284.1;1547869.0
314720;201805;411;245;166;232327.62;158364.0;390691.62
314730;201805;515;273;242;259012.0;230859.0;489871.0
314740;201805;690;341;349;323930.7;332946.0;656876.7
314750;201805;21;18;3;17172.0;2862.0;20034.0
314760;201805;324;154;170;146916.0;162170.45;309086.47
314770;201805;122;83;39;79182.0;37206.0;116388.0
314780;201805;21;6;15;5724.0;14310.0;20034.0
314790;201805;2359;1471;888;1396935.2;846474.7;2243410.0
314795;201805;53;45;8;42692.0;7632.0;50324.0
314800;201805;2940;1725;1215;1640364.6;1156811.4;2797176.0
314810;201805;1514;843;671;801885.5;638513.0;1440398.5
314820;201805;90;50;40;47700.0;38160.0;85860.0
314830;201805;208;165;43;156694.5;40736.0;197430.5
314840;201805;81;47;34;44838.0;32436.0;77274.0
314850;201805;353;172;181;164088.0;172674.0;336762.0
314860;201805;704;528;176;502472.06;165853.7;668325.75
314870;201805;1476;762;714;725994.0;681156.0;1407150.0
314875;201805;56;48;8;45792.0;7632.0;53424.0
314880;201805;46;33;13;31482.0;12402.0;43884.0
314890;201805;53;31;22;29574.0;20988.0;50562.0
314900;201805;34;27;7;25758.0;6678.0;32436.0
314910;201805;254;173;81;164755.8;77274.0;242029.8
314915;201805;157;137;20;130698.0;19080.0;149778.0
314920;201805;123;77;46;73458.0;43597.8;117055.8
314930;201805;1041;529;512;502802.34;487818.25;990620.56
314940;201805;52;40;12;38160.0;11448.0;49608.0
314950;201805;37;26;11;24804.0;10494.0;35298.0
314960;201805;58;43;15;41022.0;14310.0;55332.0
314970;201805;140;71;69;67599.0;65826.0;133425.0
314980;201805;306;196;110;184742.1;103986.0;288728.1
314990;201805;466;258;208;246132.0;197526.5;443658.5
314995;201805;200;64;136;61056.0;129734.46;190790.45
315000;201805;94;77;17;73458.0;16218.0;89676.0
315010;201805;46;30;16;28620.0;15264.0;43884.0
315015;201805;178;145;33;137604.95;31482.0;169086.95
315020;201805;72;62;10;59148.0;9540.0;68688.0
315030;201805;116;90;26;84906.0;24804.0;109710.0
315040;201805;67;49;18;46746.0;17172.0;63918.0
315050;201805;205;123;82;117342.0;78228.0;195570.0
315053;201805;39;34;5;32436.0;4770.0;37206.0
315057;201805;98;81;17;76892.4;16218.0;93110.4
315060;201805;72;64;8;59149.16;7632.0;66781.16
315070;201805;101;55;46;52470.0;43884.0;96354.0
315080;201805;374;306;68;291924.0;64872.0;356796.0
315090;201805;110;65;45;62010.0;42930.0;104940.0
315100;201805;79;40;39;38160.0;37206.0;75366.0
315110;201805;291;163;128;154644.0;122112.0;276756.0
315120;201805;1660;851;809;806656.0;769592.6;1576248.6
315130;201805;343;249;94;237546.0;89676.0;327222.0
315140;201805;532;312;220;296026.2;209880.0;505906.2
315150;201805;981;463;518;440749.0;493886.0;934635.0
315160;201805;217;112;105;106848.0;100170.0;207018.0
315170;201805;337;218;119;207019.0;113239.8;320258.8
315180;201805;3224;1367;1857;1301018.5;1767612.9;3068631.2
315190;201805;317;183;134;174201.0;127836.0;302037.0
315200;201805;1195;684;511;650914.2;486635.4;1137549.6
315210;201805;1562;896;666;851637.4;632944.2;1484581.6
315213;201805;45;26;19;24804.0;18126.0;42930.0
315217;201805;215;172;43;164088.0;41022.0;205110.0
315220;201805;1538;1177;361;1121952.4;344012.6;1465965.0
315230;201805;170;124;46;117343.0;43884.0;161227.0
315240;201805;427;275;152;262350.0;143806.5;406156.5
315250;201805;2565;1268;1297;1209094.9;1235756.9;2444851.8
315260;201805;150;92;58;86432.4;55332.0;141764.4
315270;201805;133;92;41;87195.6;38388.96;125584.56
315280;201805;700;458;242;436551.0;230858.45;667409.44
315290;201805;201;118;83;112572.0;78228.49;190800.48
315300;201805;74;50;24;47700.0;22896.0;70596.0
315310;201805;66;60;6;57240.0;5724.0;62964.0
315320;201805;162;92;70;87768.0;66780.0;154548.0
315330;201805;56;48;8;45792.0;7632.0;53424.0
315340;201805;426;300;126;285017.6;120204.0;405221.6
315350;201805;150;89;61;84906.0;58194.0;143100.0
315360;201805;98;53;45;50562.0;42930.0;93492.0
315370;201805;59;36;23;33629.0;21798.9;55427.9
315380;201805;12;7;5;6678.0;4770.0;11448.0
315390;201805;59;13;46;12402.0;43884.0;56286.0
315400;201805;823;616;207;582226.5;197478.0;779704.5
315410;201805;358;219;139;208640.0;132320.0;340960.0
315415;201805;62;47;15;44838.0;14310.0;59148.0
315420;201805;206;156;50;147728.0;47700.0;195428.0
315430;201805;677;395;282;375590.0;268551.8;644141.8
315440;201805;86;58;28;55332.0;26712.0;82044.0
315445;201805;256;205;51;195255.19;48654.0;243909.19
315450;201805;177;133;44;126882.0;41976.0;168858.0
315460;201805;3415;1707;1708;1625417.4;1626991.1;3252408.5
315470;201805;43;21;22;20034.0;20988.0;41022.0
315480;201805;63;24;39;22896.0;37206.0;60102.0
315490;201805;622;385;237;365238.9;226098.0;591336.9
315500;201805;21;13;8;12402.0;7632.0;20034.0
315510;201805;152;101;51;96354.0;48654.0;145008.0
315520;201805;70;61;9;58194.0;8586.0;66780.0
315530;201805;53;28;25;26712.0;23850.0;50562.0
315540;201805;233;152;81;145008.0;77274.0;222282.0
315550;201805;177;142;35;135468.0;33390.0;168858.0
315560;201805;743;592;151;563428.8;144054.0;707482.8
315570;201805;316;166;150;155169.5;143100.0;298269.5
315580;201805;671;440;231;419093.0;220374.0;639467.0
315590;201805;207;107;100;102078.0;95400.0;197478.0
315600;201805;295;216;79;206064.0;75176.0;281240.0
315610;201805;99;48;51;45792.0;48654.0;94446.0
315620;201805;34;27;7;25758.0;6678.0;32436.0
315630;201805;138;94;44;89676.0;41976.0;131652.0
315640;201805;61;36;25;34344.0;23850.0;58194.0
315645;201805;65;46;19;43884.0;17649.0;61533.0
315650;201805;169;123;46;117056.0;43311.6;160367.6
315660;201805;477;208;269;198432.0;256626.0;455058.0
315670;201805;2395;1201;1194;1142969.4;1137903.6;2280873.0
315680;201805;859;582;277;552747.6;264258.0;817005.6
315690;201805;691;474;217;451121.66;207018.0;658139.7
315700;201805;1914;1013;901;962530.4;859554.0;1822084.4
315710;201805;334;93;241;88722.0;229914.0;318636.0
315720;201805;437;278;159;265212.0;151686.0;416898.0
315725;201805;201;161;40;153594.0;38160.0;191754.0
315727;201805;43;22;21;20988.0;20034.0;41022.0
315730;201805;44;42;2;40068.0;1908.0;41976.0
315733;201805;88;58;30;55332.0;28620.0;83952.0
315737;201805;51;39;12;37206.0;11448.0;48654.0
315740;201805;46;40;6;38160.0;5724.0;43884.0
315750;201805;158;123;35;117342.0;33390.0;150732.0
315760;201805;48;34;14;32436.0;13356.0;45792.0
315765;201805;119;77;42;73458.0;40068.0;113526.0
315770;201805;232;141;91;134514.0;86528.0;221042.0
315780;201805;3313;1719;1594;1632686.1;1518292.6;3150978.8
315790;201805;213;161;52;153594.0;49035.6;202629.6
315800;201805;283;205;78;195570.0;74412.0;269982.0
315810;201805;95;57;38;54378.0;35966.0;90344.0
315820;201805;792;571;221;542159.3;210834.0;752993.3
315830;201805;141;81;60;77274.0;57240.0;134514.0
315840;201805;92;65;27;62010.0;25758.0;87768.0
315850;201805;260;193;67;184122.0;63918.0;248040.0
315860;201805;12;4;8;3816.0;7632.0;11448.0
315870;201805;36;27;9;25758.0;8586.0;34344.0
315880;201805;106;69;37;65826.0;35298.0;101124.0
315890;201805;81;60;21;57240.0;20034.0;77274.0
315895;201805;460;311;149;295645.0;141574.0;437219.0
315900;201805;71;34;37;32150.0;35298.0;67448.0
315910;201805;37;24;13;22657.5;12402.0;35059.5
315920;201805;183;119;64;113526.0;60102.9;173628.9
315930;201805;40;14;26;13356.0;24804.0;38160.0
315935;201805;149;117;32;111618.0;30519.0;142137.0
315940;201805;94;69;25;65826.0;23850.0;89676.0
315950;201805;64;45;19;42930.0;18126.0;61056.0
315960;201805;555;260;295;246771.58;280571.6;527343.2
315970;201805;37;28;9;26712.0;8586.0;35298.0
315980;201805;695;327;368;309534.0;351062.47;660596.44
315990;201805;255;152;103;144770.0;97967.0;242737.0
316000;201805;50;33;17;31482.0;15931.8;47413.8
316010;201805;75;63;12;60102.0;11448.0;71550.0
316020;201805;112;93;19;88722.0;18126.0;106848.0
316030;201805;404;214;190;203870.0;180736.0;384606.0
316040;201805;507;220;287;208926.2;273512.0;482438.2
316045;201805;60;53;7;50562.0;6678.0;57240.0
316050;201805;16;14;2;13356.0;1908.0;15264.0
316060;201805;95;62;33;59148.0;31482.0;90630.0
316070;201805;1061;689;372;650839.5;354125.0;1004964.5
316080;201805;101;63;38;59386.5;36252.0;95638.5
316090;201805;42;25;17;23182.2;16218.0;39400.2
316095;201805;72;60;12;56964.0;11448.0;68412.0
316100;201805;311;183;128;173771.3;122112.0;295883.3
316105;201805;34;23;11;21942.0;10494.0;32436.0
316110;201805;1935;1556;379;1473978.5;360898.2;1834876.8
316120;201805;80;60;20;57240.0;18793.8;76033.8
316130;201805;139;107;32;101411.0;30528.0;131939.0
316140;201805;27;20;7;19080.0;6678.0;25758.0
316150;201805;203;142;61;134752.5;58194.0;192946.5
316160;201805;84;50;34;47700.0;32436.0;80136.0
316165;201805;62;45;17;42740.0;15502.5;58242.5
316170;201805;206;140;66;132606.0;62964.0;195570.0
316180;201805;205;90;115;85526.1;109710.0;195236.1
316190;201805;142;103;39;97308.0;37206.0;134514.0
316200;201805;707;393;314;374922.0;298697.4;673619.4
316210;201805;772;518;254;493825.4;242316.0;736141.44
316220;201805;117;79;38;75366.0;36252.0;111618.0
316225;201805;24;14;10;13356.0;9540.0;22896.0
316230;201805;31;19;12;18126.0;11448.0;29574.0
316240;201805;624;502;122;478908.0;116388.0;595296.0
316245;201805;108;90;18;85860.0;17172.0;103032.0
316250;201805;1520;1060;460;1004544.5;437657.12;1442201.6
316255;201805;111;91;20;86432.4;19065.69;105498.09
316257;201805;183;95;88;90630.0;83665.8;174295.8
316260;201805;243;161;82;152297.06;78133.0;230430.06
316265;201805;26;17;9;16218.0;8586.0;24804.0
316270;201805;678;472;206;446997.4;196524.0;643521.4
316280;201805;540;333;207;316411.8;196810.6;513222.4
316290;201805;688;460;228;435691.97;217512.0;653204.0
316292;201805;510;204;306;194616.0;291686.0;486302.0
316294;201805;102;59;43;56286.0;41022.0;97308.0
316295;201805;295;132;163;124003.0;155502.0;279505.0
316300;201805;103;72;31;68688.0;29574.0;98262.0
316310;201805;38;20;18;19080.0;17172.0;36252.0
316320;201805;41;26;15;24804.0;14310.0;39114.0
316330;201805;132;86;46;81090.5;43597.8;124688.3
316340;201805;146;98;48;93492.0;45792.0;139284.0
316350;201805;195;141;54;134348.0;51516.0;185864.0
316360;201805;22;17;5;16218.0;4770.0;20988.0
316370;201805;1088;578;510;547616.5;486244.25;1033860.75
316380;201805;119;89;30;84906.0;28620.0;113526.0
316390;201805;123;87;36;82998.0;34344.0;117342.0
316400;201805;138;104;34;99216.0;32436.0;131652.0
316410;201805;305;224;81;212503.5;77274.0;289777.5
316420;201805;207;147;60;139522.5;57240.0;196762.5
316430;201805;156;79;77;75366.0;73458.0;148824.0
316440;201805;100;47;53;44838.0;50562.0;95400.0
316443;201805;39;35;4;33390.0;3816.0;37206.0
316447;201805;65;51;14;48654.0;13356.0;62010.0
316450;201805;224;169;55;161226.0;52470.0;213696.0
316460;201805;69;28;41;26712.0;39114.0;65826.0
316470;201805;1608;1159;449;1097980.5;426225.16;1524205.6
316480;201805;13;10;3;9540.0;2862.0;12402.0
316490;201805;18;7;11;6678.0;10494.0;17172.0
316500;201805;154;103;51;97975.8;48654.0;146629.8
316510;201805;165;125;40;118248.3;38160.0;156408.3
316520;201805;189;114;75;108183.6;71550.0;179733.6
316530;201805;159;114;45;108756.0;42643.8;151399.8
316540;201805;144;80;64;76320.0;61056.0;137376.0
316550;201805;139;99;40;94446.0;38160.0;132606.0
316553;201805;248;118;130;112349.53;124020.0;236369.53
316555;201805;33;26;7;24804.0;6678.0;31482.0
316556;201805;11;8;3;7632.0;2862.0;10494.0
316557;201805;18;14;4;13356.0;3816.0;17172.0
316560;201805;62;48;14;45792.0;13356.0;59148.0
316570;201805;242;219;23;208688.0;21942.0;230630.0
316580;201805;22;16;6;15264.0;5724.0;20988.0
316590;201805;114;98;16;93492.0;15264.0;108756.0
316600;201805;181;147;34;139952.0;32436.0;172388.0
316610;201805;66;47;19;44551.8;18126.0;62677.8
316620;201805;134;103;31;98262.0;29574.0;127836.0
316630;201805;44;32;12;30528.0;11448.0;41976.0
316640;201805;16;10;6;9540.0;5724.0;15264.0
316650;201805;70;52;18;49608.0;17172.0;66780.0
316660;201805;7;4;3;3816.0;2862.0;6678.0
316670;201805;446;159;287;151667.0;273225.8;424892.8
316680;201805;161;114;47;108756.0;44648.0;153404.0
316690;201805;192;121;71;115434.0;67734.0;183168.0
316695;201805;60;53;7;50562.0;6678.0;57240.0
316700;201805;15;8;7;7632.0;6678.0;14310.0
316710;201805;717;521;196;496796.0;186984.0;683780.0
316720;201805;4913;2503;2410;2373364.2;2293957.0;4667321.5
316730;201805;15;14;1;13356.0;954.0;14310.0
316740;201805;127;80;47;76320.0;44838.0;121158.0
316750;201805;20;14;6;13356.0;5724.0;19080.0
316760;201805;325;262;63;249948.0;60102.0;310050.0
316770;201805;144;81;63;77274.0;60102.0;137376.0
316780;201805;74;44;30;41670.72;28620.0;70290.72
316790;201805;55;43;12;41022.0;11448.0;52470.0
316800;201805;1809;1110;699;1057890.8;665130.2;1723021.0
316805;201805;18;10;8;9540.0;7632.0;17172.0
316810;201805;67;43;24;41022.0;22610.0;63632.0
316820;201805;38;19;19;18126.0;18126.0;36252.0
316830;201805;90;39;51;37206.0;48654.0;85860.0
316840;201805;506;305;201;290684.0;190800.0;481484.0
316850;201805;342;223;119;211358.7;113526.0;324884.7
316860;201805;6041;2679;3362;2541607.5;3202851.2;5744458.5
316870;201805;1480;961;519;907473.5;489690.2;1397163.8
316880;201805;115;64;51;60769.8;48654.0;109423.8
316890;201805;255;170;85;162133.0;81090.0;243223.0
316900;201805;422;289;133;273159.28;126882.0;400041.28
316905;201805;17;9;8;8586.0;7632.0;16218.0
316910;201805;50;25;25;23850.0;23850.0;47700.0
316920;201805;135;104;31;98501.0;29574.0;128075.0
316930;201805;1930;989;941;937736.2;895515.94;1833252.1
316935;201805;865;520;345;495126.72;328176.0;823302.75
316940;201805;1111;640;471;609606.4;448752.25;1058358.6
316950;201805;186;97;89;92538.0;84906.0;177444.0
316960;201805;1116;625;491;594914.8;468118.47;1063033.2
316970;201805;636;495;141;472230.0;134514.0;606744.0
316980;201805;110;67;43;63918.0;41012.46;104930.46
316990;201805;2199;1448;751;1374000.1;714489.94;2088490.1
317000;201805;332;257;75;244892.0;71550.0;316442.0
317005;201805;249;176;73;167904.0;69642.0;237546.0
317010;201805;6296;3465;2831;3284699.5;2698866.2;5983566.0
317020;201805;16286;7186;9100;6823617.0;8664277.0;1,55E+14
317030;201805;83;33;50;31482.0;47483.26;78965.26
317040;201805;3112;1939;1173;1846497.2;1116276.6;2962774.0
317043;201805;76;55;21;52470.0;20034.0;72504.0
317047;201805;36;18;18;17172.0;17168.0;34340.0
317050;201805;178;132;46;125928.0;43884.0;169812.0
317052;201805;128;97;31;92538.0;29574.0;122112.0
317057;201805;204;153;51;145962.0;48082.0;194044.0
317060;201805;57;37;20;35298.0;18793.8;54091.8
317065;201805;58;45;13;42930.0;12402.0;55332.0
317070;201805;1976;938;1038;890083.7;989107.6;1879191.2
317075;201805;109;57;52;54378.0;49608.0;103986.0
317080;201805;834;437;397;415800.9;378548.0;794348.9
317090;201805;634;508;126;482295.5;120204.0;602499.5
317100;201805;426;318;108;301464.0;103032.0;404496.0
317103;201805;109;95;14;90630.0;13356.0;103986.0
317107;201805;37;33;4;31482.0;3816.0;35298.0
317110;201805;106;44;62;41976.0;59148.0;101124.0
317115;201805;41;35;6;33390.0;5724.0;39114.0
317120;201805;1828;931;897;880270.6;855281.0;1735551.6
317130;201805;1941;1239;702;1179057.4;669041.0;1848098.4
317140;201805;10;8;2;7632.0;1908.0;9540.0
317150;201805;268;160;108;152182.0;102268.8;254450.8
317160;201805;311;225;86;214333.0;81758.0;296091.0
317170;201805;207;143;64;136422.0;61056.0;197478.0
317180;201805;438;315;123;299794.5;117342.0;417136.5
317190;201805;257;174;83;165996.0;78895.8;244891.8
317200;201805;817;574;243;535204.0;231584.0;766788.0
317210;201805;156;88;68;82998.2;64872.0;147870.2
317220;201805;20;13;7;12402.0;6678.0;19080.0
320010;201805;623;464;159;439318.5;151686.0;591004.5
320013;201805;132;98;34;93492.0;32436.0;125928.0
320016;201805;282;179;103;170766.0;98262.0;269028.0
320020;201805;723;432;291;409578.75;275706.3;685285.06
320030;201805;152;112;40;106848.0;37826.1;144674.1
320035;201805;139;103;36;98262.0;34344.0;132606.0
320040;201805;505;258;247;245560.0;235638.0;481198.0
320050;201805;120;90;30;85860.0;28620.0;114480.0
320060;201805;1558;735;823;701143.0;784465.6;1485608.6
320070;201805;105;71;34;67734.0;32436.0;100170.0
320080;201805;761;435;326;412159.0;311004.0;723163.0
320090;201805;1208;841;367;798960.9;349259.6;1148220.5
320100;201805;321;184;137;175536.0;130698.0;306234.0
320110;201805;135;86;49;80184.2;46460.0;126644.2
320115;201805;113;91;22;86814.0;20988.0;107802.0
320120;201805;3303;1842;1461;1745728.2;1392240.6;3137968.8
320130;201805;7440;3543;3897;3358746.2;3710965.8;7069712.0
320140;201805;415;270;145;256245.2;138086.0;394331.2
320150;201805;1912;1117;795;1057829.6;758134.25;1815963.9
320160;201805;687;309;378;292583.03;359211.6;651794.6
320170;201805;117;92;25;87005.0;23850.0;110855.0
320180;201805;53;30;23;28620.0;21942.0;50562.0
320190;201805;238;156;82;148051.27;77942.0;225993.27
320200;201805;57;44;13;41976.0;12402.0;54378.0
320210;201805;844;473;371;449716.6;352962.0;802678.6
320220;201805;304;113;191;107802.0;181928.0;289730.0
320225;201805;77;63;14;60102.0;13356.0;73458.0
320230;201805;556;357;199;339052.4;189036.0;528088.4
320240;201805;3118;1561;1557;1486714.8;1482711.8;2969426.5
320245;201805;456;313;143;297457.4;136422.0;433879.4
320250;201805;231;123;108;116388.6;103032.0;219420.6
320255;201805;145;113;32;106495.02;30385.0;136880.02
320260;201805;178;126;52;120204.0;49560.3;169764.3
320265;201805;159;127;32;120348.0;30528.0;150876.0
320270;201805;153;124;29;118296.0;27666.0;145962.0
320280;201805;961;578;383;546452.2;365096.0;911548.2
320290;201805;66;56;10;53424.0;9540.0;62964.0
320300;201805;542;384;158;363589.8;149683.1;513272.9
320305;201805;674;368;306;351072.0;291734.0;642806.0
320310;201805;214;119;95;111571.5;89874.0;201445.5
320313;201805;309;158;151;150732.0;143768.0;294500.0
320316;201805;108;89;19;84906.0;18126.0;103032.0
320320;201805;3324;1511;1813;1435810.0;1726621.8;3162431.8
320330;201805;256;189;67;179643.3;62010.8;241654.1
320332;201805;883;534;349;507579.6;331897.3;839476.9
320334;201805;238;144;94;137090.0;89676.0;226766.0
320335;201805;147;106;41;100170.4;39114.0;139284.4
320340;201805;593;410;183;389996.0;173915.0;563911.0
320350;201805;970;416;554;394385.66;527390.5;921776.1
320360;201805;168;91;77;86528.0;73458.0;159986.0
320370;201805;243;187;56;176706.0;52391.0;229097.0
320380;201805;285;193;92;182453.3;87768.0;270221.3
320390;201805;1125;682;443;648110.8;422002.12;1070112.9
320400;201805;315;225;90;213697.0;85860.0;299557.0
320405;201805;899;386;513;367667.6;489089.9;856757.5
320410;201805;979;498;481;473423.4;458503.34;931926.75
320420;201805;480;244;236;232299.4;225144.0;457443.4
320425;201805;193;105;88;100170.0;83952.0;184122.0
320430;201805;391;223;168;211120.7;160272.0;371392.7
320435;201805;170;115;55;108889.56;52470.0;161359.56
320440;201805;204;123;81;117055.8;77274.0;194329.8
320450;201805;130;77;53;73458.0;50562.0;124020.0
320455;201805;247;201;46;190801.0;43884.0;234685.0
320460;201805;239;154;85;146916.0;81090.0;228006.0
320465;201805;114;77;37;73095.48;35298.0;108393.48
320470;201805;632;401;231;382250.25;220370.0;602620.25
320480;201805;178;120;58;113669.1;55332.0;169001.1
320490;201805;3033;1517;1516;1444309.1;1443747.8;2888057.0
320495;201805;95;58;37;55313.0;35298.0;90611.0
320500;201805;9479;4785;4694;4536644.0;4465953.5;9002598.0
320501;201805;549;278;271;265212.0;258534.0;523746.0
320503;201805;286;203;83;192708.2;79182.0;271890.2
320506;201805;260;195;65;186030.0;62010.0;248040.0
320510;201805;955;446;509;421622.3;484060.1;905682.4
320515;201805;80;67;13;62964.9;12402.0;75366.9
320517;201805;202;142;60;135468.0;57240.0;192708.0
320520;201805;6900;3076;3824;2920143.8;3639770.2;6559914.0
320530;201805;5299;2656;2643;2526044.2;2518172.2;5044216.5
330010;201805;3160;1620;1540;1538106.1;1466080.4;3004186.5
330015;201805;156;64;92;59912.08;87768.0;147680.08
330020;201805;3627;1586;2041;1510755.9;1946542.0;3457297.8
330022;201805;232;132;100;125213.0;94446.8;219659.8
330023;201805;532;183;349;173532.8;332946.0;506478.8
330025;201805;567;120;447;114480.0;425865.8;540345.8
330030;201805;1935;1239;696;1173665.1;660715.7;1834380.9
330040;201805;2379;1223;1156;1164882.1;1101348.2;2266230.5
330045;201805;8309;2630;5679;2501703.8;5411481.5;7913185.0
330050;201805;810;511;299;487494.0;285246.0;772740.0
330060;201805;905;561;344;531380.1;326859.47;858239.56
330070;201805;3473;1320;2153;1254481.0;2052647.5;3307128.5
330080;201805;1499;706;793;669215.3;755282.4;1424497.8
330090;201805;359;214;145;204156.0;138330.0;342486.0
330093;201805;286;129;157;123066.0;149742.0;272808.0
330095;201805;102;54;48;50848.2;45792.0;96640.2
330100;201805;9481;4882;4599;4648004.0;4384155.0;9032159.0
330110;201805;486;212;274;200817.0;261396.0;462213.0
330115;201805;527;304;223;290016.0;212742.0;502758.0
330120;201805;377;194;183;184694.4;173246.8;357941.2
330130;201805;1541;424;1117;403770.97;1065600.0;1469371.0
330140;201805;601;317;284;302400.0;269983.0;572383.0
330150;201805;445;263;182;248994.0;172674.0;421668.0
330160;201805;208;127;81;121158.0;77274.0;198432.0
330170;201805;26961;9509;17452;9049065.0;1,66E+13;2,57E+14
330180;201805;236;151;85;141507.02;80374.5;221881.52
330185;201805;820;330;490;313284.6;466192.8;779477.4
330187;201805;301;90;211;85860.0;201294.0;287154.0
330190;201805;5573;2236;3337;2123496.2;3180488.8;5303985.0
330200;201805;4488;1519;2969;1444394.0;2827649.8;4272044.0
330205;201805;400;243;157;231392.7;149492.0;380884.7
330210;201805;1005;617;388;582371.6;368482.9;950854.5
330220;201805;2572;1544;1028;1469590.5;979758.2;2449348.8
330225;201805;558;302;256;287469.0;243556.2;531025.2
330227;201805;2435;774;1661;735238.44;1584238.2;2319476.8
330230;201805;202;122;80;115721.0;76320.0;192041.0
330240;201805;3662;1923;1739;1829917.4;1656069.9;3485987.2
330245;201805;154;67;87;63918.0;82234.8;146152.8
330250;201805;6502;3382;3120;3214795.5;2967813.2;6182609.0
330260;201805;566;166;400;158364.0;381600.0;539964.0
330270;201805;3390;1252;2138;1193551.0;2039081.2;3232632.2
330280;201805;450;289;161;273914.1;153585.0;427499.1
330285;201805;7070;2316;4754;2204870.5;4532636.5;6737506.5
330290;201805;565;217;348;207018.0;331992.0;539010.0
330300;201805;770;514;256;486826.7;244206.0;731032.7
330310;201805;421;239;182;226098.7;173628.0;399726.7
330320;201805;8224;3123;5101;2971197.8;4859987.0;7831185.0
330330;201805;9253;3638;5615;3463901.2;5352144.0;8816045.0
330340;201805;2645;1580;1065;1505117.0;1015990.94;2521108.0
330350;201805;17955;7100;10855;6746444.0;1,03E+14;1,71E+14
330360;201805;2529;1259;1270;1200113.2;1211571.0;2411684.2
330370;201805;1007;558;449;531378.0;426343.6;957721.6
330380;201805;853;367;486;349392.97;463024.8;812417.75
330385;201805;607;318;289;302419.0;275706.0;578125.0
330390;201805;5174;2876;2298;2728826.5;2189444.5;4918271.0
330395;201805;266;169;97;159509.1;90773.2;250282.3
330400;201805;687;351;336;331420.6;318359.1;649779.7
330410;201805;498;354;144;336048.0;136886.33;472934.34
330411;201805;231;131;100;124793.0;95352.3;220145.3
330412;201805;253;104;149;98930.0;142146.0;241076.0
330414;201805;6094;2483;3611;2364786.5;3442920.2;5807707.0
330415;201805;583;270;313;256626.0;297648.8;554274.8
330420;201805;2272;1195;1077;1137045.6;1025065.0;2162110.5
330430;201805;1790;829;961;788672.8;914791.8;1703464.6
330440;201805;272;126;146;120204.0;139284.0;259488.0
330450;201805;121;51;70;48654.0;66780.0;115434.0
330452;201805;1744;830;914;790353.8;871633.75;1661987.5
330455;201805;110771;39783;70988;3,79E+14;6,77E+14;1,06E+16
330460;201805;263;106;157;101124.0;149778.0;250902.0
330470;201805;1240;676;564;638611.0;538046.44;1176657.5
330475;201805;1406;376;1030;357750.8;982047.6;1339798.4
330480;201805;749;402;347;382840.2;330085.0;712925.2
330490;201805;13692;4796;8896;4569007.0;8480593.0;1,30E+14
330500;201805;1342;614;728;585612.9;694131.0;1279743.9
330510;201805;11234;3797;7437;3613859.0;7088207.5;1,07E+14
330513;201805;103;50;53;47700.0;50562.0;98262.0
330515;201805;848;349;499;329875.0;475665.0;805540.0
330520;201805;2540;948;1592;904173.0;1518615.9;2422789.0
330530;201805;225;118;107;112190.0;101888.0;214078.0
330540;201805;349;174;175;165996.0;166473.0;332469.0
330550;201805;3050;1089;1961;1036474.2;1868504.8;2904979.0
330555;201805;762;286;476;272825.0;453150.8;725975.8
330560;201805;559;209;350;199386.0;333882.0;533268.0
330570;201805;254;178;76;169812.0;72504.0;242316.0
330575;201805;805;336;469;320306.0;445371.5;765677.5
330580;201805;3368;1893;1475;1800020.0;1405615.8;3205635.8
330590;201805;314;151;163;144054.0;155502.0;299556.0
330600;201805;1108;709;399;674249.25;378948.84;1053198.1
330610;201805;1529;841;688;795447.7;652203.9;1447651.6
330615;201805;194;146;48;139284.0;45792.0;185076.0
330620;201805;1046;441;605;419284.6;575739.8;995024.4
330630;201805;3909;2493;1416;2363497.0;1343522.8;3707019.8
350010;201805;593;388;205;368292.66;195570.0;563862.7
350020;201805;40;20;20;19080.0;19080.0;38160.0
350030;201805;524;336;188;319400.0;178162.66;497562.66
350040;201805;129;52;77;49264.56;73458.0;122722.56
350050;201805;289;158;131;150732.0;124717.46;275449.47
350055;201805;84;47;37;44838.0;35298.0;80136.0
350060;201805;75;27;48;25758.0;45792.0;71550.0
350070;201805;816;476;340;449871.12;322693.56;772564.7
350075;201805;65;44;21;41976.0;20034.0;62010.0
350080;201805;53;33;20;30845.96;17839.8;48685.76
350090;201805;97;55;42;52470.0;40063.23;92533.23
350100;201805;294;186;108;176728.5;103032.0;279760.5
350110;201805;58;36;22;34344.0;20988.0;55332.0
350115;201805;161;98;63;92824.2;60102.0;152926.2
350120;201805;111;75;36;71550.0;34344.0;105894.0
350130;201805;357;176;181;167332.0;172674.0;340006.0
350140;201805;35;21;14;19271.0;13356.0;32627.0
350150;201805;70;54;16;51516.0;15264.0;66780.0
350160;201805;2546;986;1560;937575.2;1487069.9;2424645.0
350170;201805;413;249;164;235638.2;156170.0;391808.2
350180;201805;183;98;85;93492.0;81090.0;174582.0
350190;201805;976;501;475;475843.62;452849.7;928693.3
350200;201805;67;24;43;22896.0;40757.08;63653.08
350210;201805;1362;770;592;726879.3;564250.7;1291130.0
350220;201805;668;574;94;543458.75;89676.0;633134.75
350230;201805;83;59;24;56286.0;22896.0;79182.0
350240;201805;62;47;15;44838.0;14310.0;59148.0
350250;201805;1223;609;614;575467.6;584936.7;1160404.2
350260;201805;93;66;27;62964.0;25758.0;88722.0
350270;201805;833;542;291;515990.6;276164.9;792155.5
350275;201805;299;117;182;111237.0;173628.0;284865.0
350280;201805;4745;2430;2315;2306354.8;2205683.0;4512037.5
350290;201805;407;193;214;183940.23;203583.8;387524.03
350300;201805;49;25;24;23850.0;22896.0;46746.0
350310;201805;101;70;31;66780.0;29574.0;96354.0
350315;201805;39;24;15;22896.0;14310.0;37206.0
350320;201805;3286;1632;1654;1551511.5;1577135.8;3128647.2
350330;201805;1685;897;788;851637.94;750448.06;1602086.0
350335;201805;21;14;7;13356.0;6678.0;20034.0
350340;201805;133;63;70;60102.0;66447.0;126549.0
350350;201805;95;48;47;45792.0;44838.0;90630.0
350360;201805;132;88;44;83948.0;41976.0;125924.0
350370;201805;93;54;39;50879.96;37196.46;88076.42
350380;201805;752;319;433;303658.2;412318.8;715977.0
350390;201805;1423;577;846;549662.4;805939.4;1355601.8
350395;201805;25;20;5;19080.0;4770.0;23850.0
350400;201805;1689;903;786;851856.0;746292.2;1598148.1
350410;201805;2258;1017;1241;967128.94;1182991.0;2150120.0
350420;201805;232;141;91;133911.0;86814.0;220725.0
350430;201805;75;43;32;40450.0;30528.0;70978.0
350440;201805;148;108;40;102030.5;38160.0;140190.5
350450;201805;1598;972;626;921122.94;597109.0;1518232.0
350460;201805;334;121;213;115434.0;202915.8;318349.8
350470;201805;15;10;5;9540.0;4770.0;14310.0
350480;201805;161;88;73;83952.0;69642.0;153594.0
350490;201805;240;119;121;112572.8;115434.0;228006.8
350500;201805;38;19;19;18126.0;18126.0;36252.0
350510;201805;165;110;55;104940.0;52470.0;157410.0
350520;201805;455;216;239;202883.95;227369.95;430253.9
350530;201805;452;215;237;205110.0;226098.0;431208.0
350535;201805;69;54;15;51258.42;14310.0;65568.42
350540;201805;371;191;180;182214.0;171434.0;353648.0
350550;201805;2751;1614;1137;1532430.5;1083594.1;2616024.5
350560;201805;647;449;198;428341.22;188534.25;616875.5
350570;201805;4162;1736;2426;1650006.1;2311897.2;3961903.5
350580;201805;379;183;196;173629.0;186970.45;360599.47
350590;201805;896;488;408;464980.0;388278.0;853258.0
350600;201805;6200;3117;3083;2959083.2;2936150.5;5895233.5
350610;201805;1553;793;760;750638.4;725031.0;1475669.4
350620;201805;36;24;12;22896.0;11448.0;34344.0
350630;201805;241;136;105;128790.96;99217.0;228007.95
350635;201805;889;353;536;336476.0;510697.22;847173.2
350640;201805;120;88;32;83952.0;30528.0;114480.0
350650;201805;1888;1239;649;1177266.2;617796.94;1795063.2
350660;201805;758;344;414;327532.06;393998.0;721530.06
350670;201805;314;161;153;153356.0;145962.0;299318.0
350680;201805;178;96;82;91584.0;78228.0;169812.0
350690;201805;196;100;96;95400.0;91584.0;186984.0
350700;201805;718;347;371;328339.97;353934.0;682274.0
350710;201805;337;138;199;130443.56;189846.0;320289.56
350715;201805;51;44;7;41976.0;6678.0;48654.0
350720;201805;17;12;5;11448.0;4770.0;16218.0
350730;201805;43;28;15;26712.0;14310.0;41022.0
350740;201805;212;118;94;112276.26;89676.0;201952.27
350745;201805;20;10;10;9516.0;9540.0;19056.0
350750;201805;2161;1388;773;1315864.8;736805.94;2052670.8
350760;201805;3753;1625;2128;1547913.9;2027272.4;3575186.2
350770;201805;61;41;20;39114.0;19080.0;58194.0
350775;201805;49;36;13;34344.0;12393.0;46737.0
350780;201805;429;214;215;204156.0;205110.0;409266.0
350790;201805;365;157;208;149778.0;198432.0;348210.0
350800;201805;434;245;189;233730.0;180306.0;414036.0
350810;201805;520;420;100;399727.0;95400.0;495127.0
350820;201805;86;52;34;49608.0;32436.0;82044.0
350830;201805;79;45;34;42930.0;32436.0;75366.0
350840;201805;753;330;423;314581.5;402302.0;716883.5
350850;201805;1790;1034;756;980428.3;721183.44;1701611.8
350860;201805;590;346;244;326251.8;232776.0;559027.8
350870;201805;439;299;140;285246.0;133273.8;418519.8
350880;201805;280;150;130;140478.6;123352.2;263830.8
350890;201805;42;26;16;24804.0;15264.0;40068.0
350900;201805;1457;468;989;444842.94;942742.8;1387585.8
350910;201805;27;17;10;16218.0;9540.0;25758.0
350920;201805;606;337;269;321180.03;256626.0;577806.06
350925;201805;1182;635;547;602748.3;520121.4;1122869.8
350930;201805;97;59;38;56286.0;36252.0;92538.0
350940;201805;728;408;320;387705.6;303439.6;691145.2
350945;201805;104;77;27;72922.0;25758.0;98680.0
350950;201805;15471;7430;8041;7060471.0;7661858.5;1,47E+13
350960;201805;1285;600;685;567718.94;653486.0;1221205.0
350970;201805;1114;599;515;568873.94;491014.47;1059888.4
350980;201805;94;64;30;61056.0;28620.0;89676.0
350990;201805;362;130;232;122370.72;221328.0;343698.72
350995;201805;32;16;16;15264.0;15264.0;30528.0
351000;201805;640;453;187;429938.06;178398.0;608336.06
351010;201805;46;27;19;25758.0;18126.0;43884.0
351015;201805;57;41;16;39114.0;15264.0;54378.0
351020;201805;1646;953;693;907738.44;658928.0;1566666.5
351030;201805;331;229;102;215890.2;97308.0;313198.2
351040;201805;855;458;397;435978.0;377784.66;813762.7
351050;201805;3291;1559;1732;1479001.0;1651666.2;3130667.2
351060;201805;5080;2069;3011;1962063.8;2869460.0;4831523.5
351070;201805;413;264;149;249348.92;142146.0;391494.9
351080;201805;815;590;225;562860.0;213696.0;776556.0
351090;201805;63;27;36;25758.0;34344.0;60102.0
351100;201805;460;266;194;251542.48;185071.23;436613.72
351110;201805;2124;1014;1110;962281.94;1056303.6;2018585.6
351120;201805;72;36;36;34344.0;34344.0;68688.0
351130;201805;174;60;114;57240.0;108469.8;165709.8
351140;201805;341;238;103;225607.9;98262.0;323869.9
351150;201805;403;207;196;196572.8;186984.0;383556.8
351160;201805;246;162;84;154548.0;80136.0;234684.0
351170;201805;190;100;90;95400.0;85097.0;180497.0
351190;201805;91;61;30;58194.0;28620.0;86814.0
351200;201805;377;246;131;234080.05;124974.0;359054.03
351210;201805;130;62;68;58893.38;64872.0;123765.38
351220;201805;528;317;211;298845.12;201294.0;500139.12
351230;201805;282;206;76;196524.0;72484.92;269008.9
351240;201805;232;100;132;95213.1;125928.0;221141.1
351250;201805;72;50;22;47476.0;20798.0;68274.0
351260;201805;155;114;41;108756.0;38828.0;147584.0
351270;201805;51;21;30;20034.0;28620.0;48654.0
351280;201805;1117;504;613;477956.47;583970.4;1061926.9
351290;201805;226;101;125;96354.0;118964.0;215318.0
351300;201805;3738;1735;2003;1647993.4;1910541.0;3558534.2
351310;201805;772;398;374;379692.0;356510.0;736202.0
351320;201805;108;66;42;62964.0;40068.0;103032.0
351330;201805;40;27;13;25758.0;12402.0;38160.0
351340;201805;1252;776;476;734034.94;453120.22;1187155.1
351350;201805;2495;1353;1142;1288235.2;1089177.0;2377412.2
351360;201805;783;389;394;370152.0;375558.03;745710.06
351370;201805;368;192;176;183163.23;167267.95;350431.2
351380;201805;8974;4093;4881;3889323.2;4645930.0;8535253.0
351385;201805;30;20;10;19080.0;9540.0;28620.0
351390;201805;286;211;75;200340.02;71550.0;271890.03
351400;201805;66;41;25;39114.0;23812.92;62926.92
351410;201805;447;276;171;262033.05;163134.0;425167.03
351420;201805;60;49;11;46746.0;10494.0;57240.0
351430;201805;71;39;32;37206.0;30528.0;67734.0
351440;201805;790;547;243;519960.75;231818.0;751778.75
351450;201805;257;129;128;123066.0;122112.0;245178.0
351460;201805;120;54;66;51516.0;62964.0;114480.0
351470;201805;139;74;65;70596.0;62010.0;132606.0
351480;201805;524;297;227;282098.97;216438.75;498537.72
351490;201805;289;104;185;99216.0;176490.0;275706.0
351492;201805;31;22;9;20988.0;8586.0;29574.0
351495;201805;27;18;9;17172.0;8586.0;25758.0
351500;201805;3543;1541;2002;1464752.8;1905136.4;3369889.2
351510;201805;1784;746;1038;711398.0;988048.25;1699446.2
351512;201805;21;18;3;17172.0;2862.0;20034.0
351515;201805;195;113;82;107802.0;78228.0;186030.0
351518;201805;778;483;295;459824.0;281430.0;741254.0
351519;201805;77;49;28;46746.0;26712.0;73458.0
351520;201805;146;89;57;84269.96;54378.0;138647.95
351530;201805;23;15;8;14310.0;7632.0;21942.0
351535;201805;136;77;59;73458.0;56286.0;129744.0
351540;201805;459;331;128;313391.0;122112.0;435503.0
351550;201805;1332;810;522;768702.94;496070.88;1264773.9
351560;201805;74;39;35;37206.0;33390.0;70596.0
351565;201805;12;7;5;6678.0;4770.0;11448.0
351570;201805;2558;1322;1236;1258864.4;1178473.6;2437338.0
351580;201805;39;35;4;33390.0;3816.0;37206.0
351590;201805;67;45;22;42930.0;20988.0;63918.0
351600;201805;194;147;47;140238.0;44838.0;185076.0
351610;201805;59;30;29;28620.0;27666.0;56286.0
351620;201805;5925;3390;2535;3223847.5;2417125.0;5640972.5
351630;201805;2557;1321;1236;1254919.4;1176659.2;2431578.8
351640;201805;1674;819;855;779441.4;812713.3;1592154.6
351650;201805;30;25;5;23850.0;4770.0;28620.0
351660;201805;155;99;56;94446.0;53424.0;147870.0
351670;201805;741;464;277;440320.0;264258.0;704578.0
351680;201805;72;59;13;56286.0;12402.0;68688.0
351685;201805;40;25;15;23850.0;14310.0;38160.0
351690;201805;311;220;91;208015.62;86814.0;294829.62
351700;201805;158;110;48;104940.0;45792.0;150732.0
351710;201805;75;53;22;50562.0;20988.0;71550.0
351720;201805;131;62;69;59148.0;65826.0;124974.0
351730;201805;102;73;29;68688.96;27661.23;96350.19
351740;201805;719;487;232;462118.75;221323.23;683442.0
351750;201805;363;154;209;146280.0;199386.0;345666.0
351760;201805;790;615;175;586949.0;166950.0;753899.0
351770;201805;289;246;43;234684.0;41022.0;275706.0
351780;201805;175;99;76;94437.0;72504.0;166941.0
351790;201805;236;121;115;115434.0;109710.0;225144.0
351800;201805;51;33;18;31482.0;17172.0;48654.0
351810;201805;126;84;42;80136.0;40068.0;120204.0
351820;201805;882;636;246;600878.6;234393.23;835271.8
351830;201805;508;182;326;172864.8;311004.0;483868.8
351840;201805;1877;952;925;899264.0;880949.7;1780213.8
351850;201805;230;168;62;159652.8;59148.0;218800.8
351860;201805;754;503;251;474140.84;239163.23;713304.06
351870;201805;5643;2652;2991;2519605.8;2845370.0;5364975.5
351880;201805;18983;8315;10668;7910896.5;1,02E+14;1,81E+14
351885;201805;89;60;29;56525.0;27666.0;84191.0
351890;201805;71;60;11;57240.0;10494.0;67734.0
351900;201805;225;134;91;127169.0;86814.0;213983.0
351905;201805;78;34;44;32436.0;41976.0;74412.0
351907;201805;3149;1378;1771;1311743.0;1687455.8;2999198.8
351910;201805;182;77;105;73458.0;100170.0;173628.0
351920;201805;132;74;58;70596.0;55309.69;125905.69
351925;201805;87;60;27;57240.0;25758.0;82998.0
351930;201805;381;259;122;246990.6;116388.0;363378.6
351940;201805;237;105;132;100170.0;125928.0;226098.0
351950;201805;142;83;59;79182.0;56286.0;135468.0
351960;201805;863;403;460;384280.72;436684.38;820965.06
351970;201805;1918;1027;891;977611.8;849201.0;1826812.9
351980;201805;147;73;74;67734.0;70596.0;138330.0
351990;201805;276;186;90;176490.0;85058.64;261548.64
352000;201805;362;222;140;211788.0;133560.0;345348.0
352010;201805;358;215;143;205110.0;136422.0;341532.0
352020;201805;202;68;134;64872.0;127836.0;192708.0
352030;201805;1024;525;499;500134.5;474455.97;974590.44
352040;201805;578;251;327;239454.0;311958.0;551412.0
352042;201805;285;98;187;93492.0;178112.0;271604.0
352044;201805;397;234;163;222081.86;155502.0;377583.88
352050;201805;3220;1301;1919;1233318.0;1829190.2;3062508.2
352060;201805;106;66;40;62964.0;38160.0;101124.0
352070;201805;104;75;29;70280.0;27666.0;97946.0
352080;201805;65;40;25;37206.0;23850.0;61056.0
352090;201805;173;115;58;109710.0;55332.0;165042.0
352100;201805;253;124;129;118292.0;121914.0;240206.0
352110;201805;111;32;79;30528.0;75366.0;105894.0
352115;201805;71;27;44;25758.0;41976.0;67734.0
352120;201805;96;64;32;61056.0;30528.0;91584.0
352130;201805;220;183;37;174582.0;35298.0;209880.0
352140;201805;185;76;109;72027.0;103986.0;176013.0
352150;201805;121;67;54;62964.04;51516.0;114480.04
352160;201805;131;87;44;82998.0;41976.0;124974.0
352170;201805;374;255;119;242316.05;113526.0;355842.03
352180;201805;618;415;203;394289.5;193658.0;587947.5
352190;201805;258;100;158;95390.46;150693.84;246084.3
352200;201805;31;16;15;15264.0;14310.0;29574.0
352210;201805;3821;1589;2232;1507629.9;2122357.8;3629987.8
352215;201805;54;30;24;28620.0;22438.08;51058.08
352220;201805;6924;2717;4207;2586597.5;4010882.5;6597480.0
352230;201805;3203;2034;1169;1928657.4;1109518.8;3038176.2
352240;201805;2230;1303;927;1240868.8;882061.06;2122929.8
352250;201805;2596;1338;1258;1271701.0;1196068.0;2467769.0
352260;201805;1074;585;489;556336.25;466220.0;1022556.25
352265;201805;61;26;35;24804.0;33390.0;58194.0
352270;201805;413;236;177;224190.92;168802.0;392992.9
352280;201805;402;250;152;237229.0;145003.23;382232.22
352290;201805;177;113;64;107802.0;61056.0;168858.0
352300;201805;102;76;26;72504.0;24804.0;97308.0
352310;201805;5775;2814;2961;2671140.5;2819434.5;5490575.0
352320;201805;963;499;464;472551.84;440604.9;913156.75
352330;201805;527;243;284;231488.1;270650.0;502138.1
352340;201805;1398;683;715;648930.0;678630.3;1327560.2
352350;201805;330;209;121;199386.0;115148.0;314534.0
352360;201805;230;97;133;91631.7;124167.25;215798.95
352370;201805;102;70;32;66780.0;30528.0;97308.0
352380;201805;121;74;47;70596.0;44838.0;115434.0
352390;201805;2457;1119;1338;1064263.9;1273840.5;2338104.5
352400;201805;481;209;272;198670.5;259201.8;457872.3
352410;201805;768;550;218;520910.88;207785.0;728695.9
352420;201805;103;66;37;62964.0;35298.0;98262.0
352430;201805;1771;789;982;747653.8;934195.5;1681849.4
352440;201805;3146;1608;1538;1525112.4;1465304.6;2990417.0
352450;201805;193;162;31;154548.0;29574.0;184122.0
352460;201805;572;290;282;276102.7;268313.2;544415.9
352470;201805;608;204;404;194616.0;385407.0;580023.0
352480;201805;1375;767;608;730445.94;579459.8;1309905.8
352490;201805;83;31;52;29574.0;49608.0;79182.0
352500;201805;1208;536;672;509818.6;639935.2;1149753.8
352510;201805;741;402;339;382554.97;323406.0;705960.94
352520;201805;545;242;303;230868.0;288918.9;519786.9
352530;201805;1744;924;820;881496.0;781898.6;1663394.6
352540;201805;74;49;25;46746.0;23850.0;70596.0
352550;201805;183;105;78;100170.0;73744.2;173914.2
352560;201805;50;40;10;38160.0;9540.0;47700.0
352570;201805;669;351;318;334262.0;303372.0;637634.0
352580;201805;56;37;19;34344.65;18126.0;52470.65
352585;201805;17;5;12;4770.0;11448.0;16218.0
352590;201805;4372;2215;2157;2106992.0;2056877.4;4163869.2
352600;201805;358;246;112;234367.0;106848.0;341215.0
352610;201805;935;433;502;410821.34;478908.0;889729.3
352620;201805;960;389;571;370152.2;544734.0;914886.2
352630;201805;168;66;102;62964.0;97298.46;160262.45
352640;201805;560;393;167;372624.03;159318.0;531942.0
352650;201805;88;58;30;55332.0;28620.0;83952.0
352660;201805;80;47;33;44838.0;31482.0;76320.0
352670;201805;1674;914;760;869425.9;723950.6;1593376.5
352680;201805;895;573;322;543410.56;305726.03;849136.6
352690;201805;4376;2005;2371;1904055.9;2258354.8;4162410.5
352700;201805;110;64;46;60769.8;43884.0;104653.8
352710;201805;1361;730;631;694512.0;598344.8;1292856.8
352720;201805;1341;644;697;612118.2;664361.0;1276479.2
352725;201805;26;24;2;22896.0;1908.0;24804.0
352730;201805;368;185;183;175311.81;174582.0;349893.8
352740;201805;429;269;160;254671.69;152640.0;407311.7
352750;201805;22;14;8;13069.8;7632.0;20701.8
352760;201805;202;145;57;138330.0;54378.0;192708.0
352770;201805;81;63;18;60102.0;17172.0;77274.0
352780;201805;80;45;35;42930.0;33390.0;76320.0
352790;201805;28;23;5;21942.0;4770.0;26712.0
352800;201805;250;171;79;163134.0;75079.8;238213.8
352810;201805;165;109;56;101475.42;53424.0;154899.42
352820;201805;67;52;15;48909.07;14310.0;63219.07
352830;201805;90;62;28;59148.0;26712.0;85860.0
352840;201805;607;314;293;298269.2;279522.0;577791.2
352850;201805;1372;490;882;466792.2;840791.94;1307584.1
352860;201805;134;89;45;84270.0;42930.0;127200.0
352870;201805;47;31;16;29574.0;15264.0;44838.0
352880;201805;191;129;62;123046.92;59148.0;182194.92
352885;201805;29;21;8;20034.0;7632.0;27666.0
352890;201805;57;39;18;37206.0;16886.0;54092.0
352900;201805;4855;2342;2513;2214647.0;2389866.2;4604513.5
352910;201805;39;32;7;30528.0;6678.0;37206.0
352920;201805;705;433;272;412128.0;259488.0;671616.0
352930;201805;1274;618;656;588139.8;622826.6;1210966.5
352940;201805;6373;2762;3611;2624308.0;3441732.8;6066040.5
352950;201805;93;38;55;36252.0;52470.0;88722.0
352960;201805;65;42;23;40068.0;21942.0;62010.0
352965;201805;19;8;11;7632.0;10494.0;18126.0
352970;201805;473;353;120;333554.97;113527.0;447081.97
352980;201805;175;94;81;89676.0;77274.0;166950.0
352990;201805;960;420;540;399677.28;514072.1;913749.4
353000;201805;68;32;36;30528.0;34344.0;64872.0
353010;201805;549;339;210;323406.0;200320.92;523726.9
353020;201805;289;212;77;202248.0;73458.0;275706.0
353030;201805;1208;548;660;521819.47;628953.7;1150773.1
353040;201805;88;54;34;51516.0;32436.0;83952.0
353050;201805;1335;851;484;805264.0;461449.8;1266713.9
353060;201805;8043;3651;4392;3467332.0;4183725.8;7651058.0
353070;201805;1640;1042;598;988118.44;569031.56;1557150.0
353080;201805;1345;714;631;678819.56;601016.0;1279835.5
353090;201805;56;33;23;31482.0;21942.0;53424.0
353100;201805;62;51;11;48654.0;10494.0;59148.0
353110;201805;2073;625;1448;594518.9;1379423.2;1973942.1
353120;201805;80;43;37;41022.0;35298.0;76320.0
353130;201805;871;435;436;413974.53;415822.7;829797.2
353140;201805;566;220;346;209819.0;330084.0;539903.0
353150;201805;364;205;159;194616.0;151676.45;346292.47
353160;201805;102;83;19;79182.0;18126.0;97308.0
353170;201805;196;65;131;62010.0;124946.46;186956.45
353180;201805;960;440;520;417752.7;495556.0;913308.7
353190;201805;485;346;139;329028.9;132320.0;461348.9
353200;201805;195;98;97;93492.0;92538.0;186030.0
353205;201805;25;18;7;17172.0;6678.0;23850.0
353210;201805;88;53;35;50562.0;33390.0;83952.0
353215;201805;54;32;22;30528.0;20988.0;51516.0
353220;201805;85;47;38;44838.0;35298.27;80136.27
353230;201805;161;64;97;61056.0;92538.0;153594.0
353240;201805;301;164;137;156456.0;130698.0;287154.0
353250;201805;206;107;99;102078.0;94446.0;196524.0
353260;201805;460;330;130;313676.5;124010.46;437686.97
353270;201805;68;49;19;46746.0;17458.2;64204.2
353280;201805;95;49;46;46269.0;43884.0;90153.0
353282;201805;123;88;35;83952.0;33390.0;117342.0
353284;201805;24;19;5;18126.0;4770.0;22896.0
353286;201805;1;1;0;954.0;0.0;954.0
353290;201805;80;47;33;44838.0;31473.0;76311.0
353300;201805;401;222;179;210246.45;170731.5;380977.97
353310;201805;53;47;6;44838.0;5724.0;50562.0
353320;201805;62;38;24;36252.0;22896.0;59148.0
353325;201805;59;36;23;34335.0;21638.0;55973.0
353330;201805;68;51;17;48511.0;16218.0;64729.0
353340;201805;624;207;417;196795.89;397232.25;594028.1
353350;201805;917;429;488;408275.62;464295.0;872570.6
353360;201805;110;89;21;84588.04;19748.0;104336.04
353370;201805;118;68;50;64872.0;47700.0;112572.0
353380;201805;26;18;8;17168.0;7632.0;24800.0
353390;201805;1075;515;560;491310.0;534240.0;1025550.0
353400;201805;51;31;20;29574.0;19080.0;48654.0
353410;201805;113;72;41;68688.0;39067.0;107755.0
353420;201805;58;23;35;21942.0;33390.0;55332.0
353430;201805;555;369;186;348305.3;177157.8;525463.1
353440;201805;10245;4471;5774;4253350.0;5501573.5;9754923.0
353450;201805;56;30;26;28620.0;24804.0;53424.0
353460;201805;617;339;278;320237.1;264487.5;584724.6
353470;201805;2148;1169;979;1111273.9;931560.25;2042834.1
353475;201805;237;158;79;148042.95;75366.0;223408.95
353480;201805;188;153;35;145962.0;33390.0;179352.0
353490;201805;237;141;96;134514.0;91584.0;226098.0
353500;201805;190;111;79;104654.96;75366.0;180020.95
353510;201805;100;73;27;69623.46;25748.46;95371.92
353520;201805;208;141;67;134514.0;63918.0;198432.0
353530;201805;476;260;216;248040.0;206064.0;454104.0
353540;201805;361;237;124;225775.27;118296.0;344071.28
353550;201805;742;506;236;478910.88;225144.0;704054.9
353560;201805;637;271;366;257066.8;348564.06;605630.9
353570;201805;60;31;29;29574.0;27666.0;57240.0
353580;201805;360;278;82;264735.0;78228.0;342963.0
353590;201805;89;61;28;57876.04;26712.0;84588.04
353600;201805;275;155;120;147553.0;113844.0;261397.0
353610;201805;114;60;54;57240.0;51516.0;108756.0
353620;201805;574;310;264;293753.5;251569.8;545323.3
353625;201805;51;29;22;27666.0;20988.0;48654.0
353630;201805;238;171;67;158728.6;63918.0;222646.6
353640;201805;126;85;41;80613.0;39114.0;119727.0
353650;201805;885;342;543;324169.2;518022.0;842191.2
353657;201805;24;18;6;17172.0;5724.0;22896.0
353660;201805;253;142;111;135468.0;105607.8;241075.8
353670;201805;768;455;313;433116.2;298602.0;731718.2
353680;201805;101;72;29;68314.0;27666.0;95980.0
353690;201805;47;37;10;35024.0;9540.0;44564.0
353700;201805;281;200;81;190800.0;77274.0;268074.0
353710;201805;426;199;227;188892.8;216272.0;405164.8
353715;201805;46;34;12;32149.8;11448.0;43597.8
353720;201805;361;167;194;159300.0;185076.0;344376.0
353730;201805;1127;695;432;660120.9;412128.0;1072248.9
353740;201805;650;360;290;343153.8;276660.0;619813.8
353750;201805;90;56;34;52892.14;32436.0;85328.14
353760;201805;2785;1045;1740;994871.9;1656357.2;2651229.2
353770;201805;97;81;16;76797.0;15264.0;92061.0
353780;201805;1153;570;583;542063.94;553988.0;1096052.0
353790;201805;513;297;216;281269.5;203465.34;484734.84
353800;201805;3283;1671;1612;1584878.9;1536508.6;3121387.5
353810;201805;236;133;103;126028.71;98253.0;224281.7
353820;201805;187;93;94;88722.0;89051.41;177773.4
353830;201805;48;41;7;39114.0;6678.0;45792.0
353850;201805;168;86;82;82044.0;78228.0;160272.0
353860;201805;471;215;256;204394.5;243937.8;448332.3
353870;201805;5063;2539;2524;2404548.0;2396719.5;4801267.5
353880;201805;683;488;195;464216.4;185076.12;649292.5
353890;201805;583;330;253;314248.0;241076.0;555324.0
353900;201805;129;66;63;62964.0;60102.0;123066.0
353910;201805;177;86;91;82044.0;86814.0;168858.0
353920;201805;452;245;207;231870.6;197035.16;428905.75
353930;201805;1016;596;420;566891.8;399445.8;966337.56
353940;201805;187;102;85;96544.8;80232.0;176776.8
353950;201805;520;320;200;304993.8;190791.0;495784.8
353960;201805;69;56;13;53424.0;12402.0;65826.0
353970;201805;75;45;30;42930.0;28620.0;71550.0
353980;201805;1533;753;780;715702.94;743185.75;1458888.8
353990;201805;75;43;32;41022.0;30528.0;71550.0
354000;201805;372;181;191;172007.0;182019.2;354026.2
354010;201805;93;52;41;49608.0;38637.0;88245.0
354020;201805;543;344;199;327222.0;189846.0;517068.0
354025;201805;53;42;11;40068.0;10494.0;50562.0
354030;201805;65;36;29;34344.0;27666.0;62010.0
354040;201805;98;69;29;65444.4;27666.0;93110.4
354050;201805;191;105;86;99884.0;82044.0;181928.0
354060;201805;775;373;402;355842.0;381267.4;737109.4
354070;201805;873;509;364;484056.03;347256.0;831312.0
354075;201805;215;115;100;109710.0;94446.8;204156.8
354080;201805;293;127;166;120871.8;158364.0;279235.8
354085;201805;19;12;7;11448.0;6678.0;18126.0
354090;201805;315;175;140;166869.0;133560.0;300429.0
354100;201805;5545;2313;3232;2195009.2;3077790.2;5272799.5
354105;201805;82;40;42;38160.0;40068.0;78228.0
354110;201805;48;22;26;20988.0;24804.0;45792.0
354120;201805;149;103;46;98122.97;43884.0;142006.97
354130;201805;702;468;234;446234.0;222946.0;669180.0
354140;201805;3167;1482;1685;1410528.4;1605945.9;3016474.2
354150;201805;659;412;247;390675.47;234207.0;624882.44
354160;201805;712;451;261;429061.5;248708.0;677769.5
354165;201805;22;13;9;12402.0;8586.0;20988.0
354170;201805;177;120;57;113812.2;54378.0;168190.2
354180;201805;63;39;24;36880.0;22896.0;59776.0
354190;201805;212;98;114;91870.2;108756.0;200626.2
354200;201805;131;72;59;68211.0;56286.0;124497.0
354210;201805;68;34;34;32436.0;32436.0;64872.0
354220;201805;643;394;249;375208.2;236306.34;611514.56
354230;201805;165;68;97;64872.0;91584.6;156456.6
354240;201805;316;204;112;193662.48;106211.96;299874.44
354250;201805;95;56;39;53424.0;37206.0;90630.0
354260;201805;1949;909;1040;856568.06;989294.7;1845862.8
354270;201805;95;71;24;67734.0;22896.0;90630.0
354280;201805;39;21;18;20034.0;17172.0;37206.0
354290;201805;144;99;45;93635.1;42930.0;136565.1
354300;201805;424;290;134;276343.0;127678.0;404021.0
354310;201805;103;76;27;71550.2;25758.0;97308.2
354320;201805;182;98;84;93492.0;80136.0;173628.0
354323;201805;16;14;2;13356.0;1908.0;15264.0
354325;201805;107;62;45;58342.0;42930.0;101272.0
354330;201805;2623;878;1745;832977.25;1662564.1;2495541.5
354340;201805;10593;5176;5417;4926021.0;5161091.5;1,01E+14
354350;201805;127;83;44;79182.0;41832.9;121014.9
354360;201805;88;48;40;45792.0;38160.0;83952.0
354370;201805;270;150;120;143100.0;114480.0;257580.0
354380;201805;213;128;85;121326.0;81090.0;202416.0
354390;201805;2787;1016;1771;967599.25;1688735.0;2656334.2
354400;201805;333;176;157;167237.0;149205.8;316442.8
354410;201805;614;298;316;282666.44;300510.2;583176.6
354420;201805;273;171;102;163134.0;97308.0;260442.0
354425;201805;319;184;135;175536.0;128790.0;304326.0
354430;201805;187;118;69;110997.9;65062.8;176060.7
354440;201805;39;27;12;25758.0;11448.0;37206.0
354450;201805;50;36;14;34344.0;13356.0;47700.0
354460;201805;104;60;44;57240.0;41976.0;99216.0
354470;201805;39;26;13;24804.0;12402.0;37206.0
354480;201805;121;62;59;59139.0;56276.46;115415.46
354490;201805;148;91;57;86654.97;54378.0;141032.97
354500;201805;392;195;197;186030.0;187938.0;373968.0
354510;201805;101;69;32;65826.0;30528.0;96354.0
354515;201805;39;14;25;13356.0;23850.0;37206.0
354520;201805;1652;728;924;692755.2;881057.56;1573812.8
354530;201805;659;347;312;329316.8;296504.0;625820.8
354540;201805;282;159;123;151686.0;117337.23;269023.22
354550;201805;42;25;17;23850.0;16218.0;40068.0
354560;201805;162;93;69;88436.0;65816.46;154252.45
354570;201805;137;88;49;83952.0;46746.0;130698.0
354580;201805;1973;935;1038;889413.0;989666.25;1879079.2
354600;201805;270;147;123;137984.12;117327.69;255311.81
354610;201805;73;67;6;62964.58;5724.0;68688.58
354620;201805;64;20;44;19080.0;41976.0;61056.0
354625;201805;18;11;7;10494.0;6674.0;17168.0
354630;201805;317;211;106;200919.34;101124.0;302043.34
354640;201805;805;523;282;495016.38;269028.0;764044.4
354650;201805;75;43;32;40726.8;30499.92;71226.72
354660;201805;807;597;210;565516.44;200340.0;765856.44
354670;201805;278;99;179;93015.0;169813.0;262828.0
354680;201805;1258;474;784;452196.0;747459.0;1199655.0
354690;201805;86;57;29;53425.0;27666.0;81091.0
354700;201805;78;56;22;53424.0;20988.0;74412.0
354710;201805;55;38;17;35615.96;16218.0;51833.96
354720;201805;20;19;1;18126.0;954.0;19080.0
354730;201805;1891;796;1095;756227.2;1044439.2;1800666.4
354740;201805;60;41;19;39114.0;18126.0;57240.0
354750;201805;437;259;178;247077.0;169812.0;416889.0
354760;201805;518;317;201;299857.0;191468.0;491325.0
354765;201805;13;5;8;4770.0;7632.0;12402.0
354770;201805;341;229;112;217642.03;106084.8;323726.84
354780;201805;8169;3315;4854;3150222.8;4625893.5;7776116.0
354790;201805;113;66;47;62964.0;44838.0;107802.0
354800;201805;429;237;192;226098.0;182862.92;408960.9
354805;201805;104;52;52;48972.0;49608.0;98580.0
354810;201805;136;78;58;74412.0;55332.0;129744.0
354820;201805;185;80;105;76111.0;100170.0;176281.0
354830;201805;41;22;19;20988.0;18126.0;39114.0
354840;201805;55;37;18;35298.0;17172.0;52470.0
354850;201805;4568;2027;2541;1925975.0;2419360.0;4345335.0
354860;201805;328;161;167;153594.0;157127.52;310721.53
354870;201805;11969;5437;6532;5159993.5;6220832.0;1,14E+14
354880;201805;3016;1128;1888;1074474.5;1799032.9;2873507.2
354890;201805;2868;1584;1284;1504984.6;1223953.4;2728938.0
354900;201805;60;39;21;37206.0;20034.0;57240.0
354910;201805;1240;654;586;620157.25;559044.0;1179201.2
354920;201805;50;42;8;40068.0;7632.0;47700.0
354925;201805;13;7;6;6678.0;5724.0;12402.0
354930;201805;31;28;3;26442.0;2862.0;29304.0
354940;201805;803;592;211;562099.7;201294.0;763393.7
354950;201805;220;146;74;138855.0;70596.0;209451.0
354960;201805;167;64;103;61056.0;97976.0;159032.0
354970;201805;853;560;293;529381.1;278883.03;808264.1
354980;201805;8441;3122;5319;2970394.2;5071618.0;8042012.5
354990;201805;9191;4353;4838;4138982.8;4609007.0;8747990.0
354995;201805;518;183;335;174582.0;319275.2;493857.2
355000;201805;494;164;330;156451.23;314581.5;471032.72
355010;201805;628;396;232;377784.0;219116.48;596900.5
355020;201805;716;454;262;432157.6;249940.0;682097.56
355030;201805;205345;79677;125668;7,58E+14;1,20E+16;1,96E+16
355040;201805;722;338;384;320401.6;366145.2;686546.8
355050;201805;155;103;52;96991.77;49608.0;146599.77
355060;201805;1541;770;771;729711.9;734342.3;1464054.1
355070;201805;1449;711;738;674470.4;703059.0;1377529.4
355080;201805;200;117;83;111618.0;78294.8;189912.8
355090;201805;299;200;99;188702.0;94446.0;283148.0
355100;201805;4825;2392;2433;2262306.5;2318575.2;4580882.0
355110;201805;269;170;99;161223.0;94446.0;255669.0
355120;201805;80;56;24;53424.0;22896.0;76320.0
355130;201805;54;30;24;28620.0;22896.0;51516.0
355140;201805;185;122;63;115672.5;60102.0;175774.5
355150;201805;681;412;269;391804.0;256149.0;647953.0
355160;201805;458;219;239;206541.95;228006.0;434547.97
355170;201805;2057;1069;988;1018446.9;942532.94;1960979.8
355180;201805;616;263;353;249948.0;335927.25;585875.25
355190;201805;223;152;71;145008.0;67734.0;212742.0
355200;201805;119;69;50;65826.0;47700.0;113526.0
355210;201805;721;415;306;395910.0;291905.47;687815.44
355220;201805;6749;3593;3156;3417235.8;3001325.8;6418561.5
355230;201805;104;62;42;59148.0;40063.23;99211.23
355240;201805;4314;1881;2433;1781744.1;2316658.0;4098402.0
355250;201805;5416;2622;2794;2495513.2;2662068.2;5157581.5
355255;201805;52;32;20;30528.0;19080.0;49608.0
355260;201805;188;114;74;107783.12;70568.46;178351.58
355270;201805;165;98;67;93492.0;63203.0;156695.0
355280;201805;6392;2686;3706;2556212.8;3530250.5;6086463.0
355290;201805;77;58;19;55332.0;18126.0;73458.0
355300;201805;184;118;66;111618.8;62964.0;174582.8
355310;201805;108;60;48;57240.0;45792.0;103032.0
355320;201805;90;47;43;44838.0;40074.6;84912.6
355330;201805;269;152;117;145008.0;111618.0;256626.0
355340;201805;1543;547;996;519231.62;949442.0;1468673.6
355350;201805;141;72;69;68688.0;65826.0;134514.0
355360;201805;185;117;68;111408.12;64872.0;176280.12
355365;201805;25;20;5;19080.0;4770.0;23850.0
355370;201805;1044;595;449;562716.75;427078.56;989795.3
355380;201805;780;520;260;495488.53;247754.0;743242.5
355385;201805;62;43;19;41022.0;18126.0;59148.0
355390;201805;105;61;44;58194.0;41976.0;100170.0
355395;201805;187;114;73;107655.23;69642.0;177297.23
355400;201805;1554;963;591;914703.5;562287.8;1476991.4
355410;201805;4913;2319;2594;2195525.2;2466915.2;4662440.5
355420;201805;51;38;13;36252.0;12402.0;48654.0
355430;201805;347;208;139;197096.4;132606.0;329702.4
355440;201805;85;52;33;49608.0;31482.0;81090.0
355450;201805;458;221;237;208115.94;225048.8;433164.75
355460;201805;69;53;16;49608.42;15264.0;64872.42
355465;201805;52;33;19;31482.0;18126.0;49608.0
355470;201805;180;72;108;67734.1;103032.0;170766.1
355475;201805;13;8;5;7632.0;4770.0;12402.0
355480;201805;463;205;258;193672.34;245464.2;439136.53
355490;201805;115;81;34;77274.0;32436.0;109710.0
355495;201805;55;27;28;25758.0;26712.0;52470.0
355500;201805;1664;934;730;886410.7;696385.44;1582796.1
355510;201805;271;197;74;183239.62;70596.0;253835.62
355520;201805;33;26;7;24518.0;6678.0;31196.0
355530;201805;24;16;8;15264.0;7632.0;22896.0
355535;201805;76;38;38;36252.0;36252.0;72504.0
355540;201805;2377;937;1440;892439.5;1371844.0;2264283.5
355550;201805;65;39;26;37206.0;24804.0;62010.0
355560;201805;240;120;120;114480.0;113843.96;228323.95
355570;201805;31;21;10;20034.0;9540.0;29574.0
355580;201805;275;188;87;179352.0;82707.23;262059.23
355590;201805;24;15;9;14310.0;8586.0;22896.0
355600;201805;271;139;132;132606.0;125637.23;258243.23
355610;201805;213;139;74;132606.0;70596.0;203202.0
355620;201805;1266;589;677;561095.8;645062.2;1206158.0
355630;201805;415;302;113;288108.0;106773.96;394881.97
355635;201805;126;61;65;58194.0;61997.0;120191.0
355640;201805;573;331;242;314820.16;230868.0;545688.2
355645;201805;833;355;478;337191.3;454132.8;791324.1
355650;201805;2160;899;1261;854376.8;1202961.0;2057337.8
355660;201805;258;138;120;131652.0;114480.0;246132.0
355670;201805;495;197;298;187938.0;284005.8;471943.8
355680;201805;204;115;89;108757.0;84620.0;193377.0
355690;201805;86;40;46;38160.0;43540.0;81700.0
355695;201805;15;12;3;11448.0;2862.0;14310.0
355700;201805;1151;591;560;558744.6;533668.0;1092412.6
355710;201805;2195;1201;994;1142117.5;947771.2;2089888.8
355715;201805;20;18;2;17172.0;1908.0;19080.0
355720;201805;209;126;83;118614.08;79182.0;197796.08
355730;201805;95;55;40;51595.95;38160.0;89755.95
410010;201805;133;113;20;107802.0;19080.0;126882.0
410020;201805;104;92;12;87768.0;11448.0;99216.0
410030;201805;165;104;61;98548.4;58194.0;156742.4
410040;201805;971;530;441;505381.5;420524.0;925905.5
410045;201805;26;21;5;20034.0;4770.0;24804.0
410050;201805;481;267;214;254718.0;203297.0;458015.0
410060;201805;277;211;66;201294.0;62964.0;264258.0
410070;201805;307;254;53;242316.0;50562.0;292878.0
410080;201805;167;108;59;103032.0;56286.0;159318.0
410090;201805;75;67;8;63709.0;7632.0;71341.0
410100;201805;298;212;86;201933.19;81233.1;283166.28
410105;201805;47;28;19;26712.0;18126.0;44838.0
410110;201805;316;194;122;185076.0;116388.0;301464.0
410115;201805;27;18;9;17172.0;8586.0;25758.0
410120;201805;440;228;212;217225.8;202248.0;419473.8
410130;201805;44;27;17;25758.0;16218.0;41976.0
410140;201805;3109;1520;1589;1445823.4;1512281.6;2958105.0
410150;201805;2704;1087;1617;1035559.25;1542021.8;2577581.0
410160;201805;506;321;185;305947.8;176490.0;482437.8
410165;201805;68;46;22;43884.0;20988.0;64872.0
410170;201805;167;124;43;116871.0;41022.0;157893.0
410180;201805;2136;1241;895;1179925.2;852372.94;2032298.1
410185;201805;34;30;4;28620.0;3816.0;32436.0
410190;201805;443;277;166;264258.0;158364.0;422622.0
410200;201805;957;716;241;682214.94;229914.0;912128.94
410210;201805;557;290;267;276660.0;254432.0;531092.0
410220;201805;39;21;18;20034.0;17172.0;37206.0
410230;201805;130;69;61;65826.0;58194.0;124020.0
410240;201805;737;485;252;462117.8;240408.0;702525.8
410250;201805;374;274;100;260791.84;95395.23;356187.06
410260;201805;296;174;122;165710.0;116388.0;282098.0
410270;201805;31;19;12;18126.0;11448.0;29574.0
410275;201805;64;47;17;44838.0;16218.0;61056.0
410280;201805;324;185;139;176230.52;132606.0;308836.53
410290;201805;233;146;87;139284.0;82998.0;222282.0
410300;201805;80;64;16;61056.0;15264.0;76320.0
410302;201805;24;16;8;15264.0;7632.0;22896.0
410304;201805;46;32;14;30528.0;13356.0;43884.0
410305;201805;211;115;96;109042.2;91584.0;200626.2
410310;201805;264;168;96;160272.0;91564.92;251836.92
410315;201805;52;37;15;35274.0;14310.0;49584.0
410320;201805;140;99;41;94446.0;39114.0;133560.0
410322;201805;35;25;10;23850.0;9540.0;33390.0
410330;201805;167;119;48;113526.0;45602.0;159128.0
410335;201805;98;60;38;57240.0;36252.0;93492.0
410337;201805;38;33;5;31482.0;4770.0;36252.0
410340;201805;31;29;2;27666.0;1908.0;29574.0
410345;201805;219;138;81;131652.0;77274.0;208926.0
410347;201805;54;41;13;39114.0;12402.0;51516.0
410350;201805;226;136;90;129744.0;85860.0;215604.0
410360;201805;454;275;179;259806.4;170194.0;430000.4
410370;201805;2409;1027;1382;976163.3;1315648.9;2291812.2
410380;201805;222;146;76;139284.0;72504.0;211788.0
410390;201805;370;274;96;261392.0;91584.0;352976.0
410395;201805;34;22;12;20988.0;11448.0;32436.0
410400;201805;844;427;417;406029.2;397279.0;803308.2
410405;201805;91;70;21;66780.0;20034.0;86814.0
410410;201805;40;31;9;29574.0;8586.0;38160.0
410420;201805;1657;821;836;781139.9;796591.0;1577730.9
410425;201805;176;82;94;78038.0;89676.0;167714.0
410430;201805;2195;1292;903;1229420.0;860584.3;2090004.4
410440;201805;389;289;100;274753.0;95400.0;370153.0
410442;201805;357;240;117;228007.0;111618.0;339625.0
410445;201805;418;290;128;276660.0;122112.0;398772.0
410450;201805;412;210;202;200340.0;192708.0;393048.0
410460;201805;412;222;190;211492.8;181260.0;392752.8
410465;201805;186;119;67;112285.8;63918.0;176203.8
410470;201805;221;142;79;135468.0;75366.0;210834.0
410480;201805;5842;2886;2956;2734436.2;2814819.8;5549256.0
410490;201805;1398;922;476;878091.0;452197.0;1330288.0
410500;201805;267;151;116;144054.0;110664.0;254718.0
410510;201805;177;130;47;123447.6;44829.0;168276.6
410520;201805;257;191;66;182214.0;62964.0;245178.0
410530;201805;235;86;149;82044.0;142142.0;224186.0
410540;201805;319;230;89;218843.6;84901.23;303744.84
410550;201805;1620;701;919;668467.8;875526.4;1543994.1
410560;201805;146;114;32;108756.0;30528.0;139284.0
410570;201805;432;302;130;286020.2;124020.0;410040.2
410580;201805;3165;1422;1743;1354829.8;1661392.0;3016221.8
410590;201805;406;287;119;273798.0;113526.0;387324.0
410600;201805;185;159;26;151686.0;24804.0;176490.0
410610;201805;56;45;11;42930.0;10494.0;53424.0
410620;201805;244;175;69;166950.0;65826.0;232776.0
410630;201805;446;258;188;246132.0;178193.0;424325.0
410640;201805;987;609;378;576976.25;359005.28;935981.56
410645;201805;100;75;25;71169.0;23850.0;95019.0
410650;201805;364;249;115;236592.0;109710.0;346302.0
410655;201805;79;61;18;58194.0;17172.0;75366.0
410657;201805;45;19;26;18126.0;24804.0;42930.0
410660;201805;603;423;180;402013.0;171720.0;573733.0
410670;201805;77;64;13;61056.0;12402.0;73458.0
410680;201805;191;157;34;149111.0;32436.0;181547.0
410685;201805;17;11;6;10494.0;5724.0;16218.0
410690;201805;28217;12243;15974;1,17E+14;1,52E+12;2,69E+13
410700;201805;323;235;88;223651.0;83952.0;307603.0
410710;201805;126;102;24;97308.0;22896.0;120204.0
410712;201805;25;15;10;14310.0;9540.0;23850.0
410715;201805;83;61;22;58194.0;20988.0;79182.0
410720;201805;602;359;243;342486.0;231813.0;574299.0
410725;201805;180;129;51;123066.0;48654.0;171720.0
410730;201805;86;52;34;49608.0;32436.0;82044.0
410740;201805;113;80;33;76320.0;31482.0;107802.0
410750;201805;217;162;55;154548.0;52465.23;207013.23
410752;201805;25;15;10;14310.0;9540.0;23850.0
410753;201805;54;24;30;22223.43;28620.0;50843.43
410754;201805;38;23;15;21561.0;14310.0;35871.0
410755;201805;80;55;25;52470.0;23850.0;76320.0
410760;201805;723;408;315;389207.56;300510.0;689717.56
410765;201805;1669;806;863;761980.7;822148.25;1584129.0
410770;201805;104;86;18;82044.0;17172.0;99216.0
410773;201805;46;34;12;32436.0;11448.0;43884.0
410775;201805;177;135;42;128122.2;40068.0;168190.2
410780;201805;78;42;36;40068.0;34344.0;74412.0
410785;201805;52;42;10;40068.0;9540.0;49608.0
410790;201805;71;34;37;32436.0;35298.0;67734.0
410800;201805;295;187;108;177445.0;103032.0;280477.0
410810;201805;26;22;4;20988.0;3530.0;24518.0
410820;201805;176;130;46;123877.0;43884.0;167761.0
410830;201805;8486;3861;4625;3673139.5;4409695.0;8082834.5
410832;201805;104;71;33;67734.0;31482.0;99216.0
410840;201805;1432;793;639;754254.06;608683.0;1362937.0
410845;201805;63;39;24;37206.0;22896.0;60102.0
410850;201805;189;130;59;123734.0;56286.0;180020.0
410855;201805;47;40;7;38160.0;6678.0;44838.0
410860;201805;668;391;277;372060.75;264258.0;636318.75
410865;201805;104;82;22;78228.0;20988.0;99216.0
410870;201805;159;135;24;128790.0;22605.0;151395.0
410880;201805;1123;562;561;535637.6;535130.0;1070767.6
410890;201805;77;54;23;51516.0;21942.0;73458.0
410895;201805;73;56;17;53424.0;16218.0;69642.0
410900;201805;20;13;7;12402.0;6678.0;19080.0
410910;201805;17;15;2;14310.0;1908.0;16218.0
410920;201805;33;22;11;20988.0;10494.0;31482.0
410930;201805;504;324;180;308884.97;171720.0;480604.97
410940;201805;4314;2568;1746;2440044.0;1662706.2;4102750.2
410950;201805;119;87;32;82998.0;30528.0;113526.0
410960;201805;766;341;425;325028.0;405260.0;730288.0
410965;201805;66;51;15;48367.8;14310.0;62677.8
410970;201805;626;450;176;428832.2;167904.0;596736.2
410975;201805;107;63;44;59591.0;41976.0;101567.0
410980;201805;1581;713;868;677655.8;827114.0;1504769.9
410990;201805;270;182;88;173628.0;83665.8;257293.8
411000;201805;63;40;23;38160.0;21942.0;60102.0
411005;201805;25;20;5;19080.0;4770.0;23850.0
411007;201805;240;140;100;133560.0;95400.0;228960.0
411010;201805;577;404;173;385416.0;165042.0;550458.0
411020;201805;298;207;91;197478.0;86814.0;284292.0
411030;201805;19;9;10;8586.0;9540.0;18126.0
411040;201805;50;36;14;34344.0;13356.0;47700.0
411050;201805;221;173;48;164406.72;45665.12;210071.84
411060;201805;512;342;170;326259.0;162180.0;488439.0
411065;201805;63;55;8;52470.0;7632.0;60102.0
411070;201805;1203;797;406;754419.3;386370.0;1140789.2
411080;201805;243;173;70;165125.95;66780.0;231905.95
411090;201805;116;88;28;83952.0;26712.0;110664.0
411095;201805;269;110;159;104463.0;151676.0;256139.0
411100;201805;113;94;19;89676.0;18126.0;107802.0
411110;201805;119;85;34;81090.0;32436.0;113526.0
411120;201805;183;136;47;129744.0;44838.0;174582.0
411125;201805;181;83;98;78533.28;93492.0;172025.28
411130;201805;126;107;19;101440.0;17839.8;119279.8
411140;201805;186;127;59;121136.12;55761.3;176897.42
411150;201805;1229;820;409;781602.7;390186.0;1171788.6
411155;201805;118;82;36;78228.0;34344.0;112572.0
411160;201805;21;10;11;9540.0;10494.0;20034.0
411170;201805;59;52;7;49321.8;6678.0;55999.8
411180;201805;950;625;325;595010.0;310045.22;905055.25
411190;201805;348;201;147;191086.2;140238.0;331324.2
411200;201805;670;442;228;420397.88;216368.3;636766.2
411210;201805;682;366;316;347614.22;301464.0;649078.2
411220;201805;146;110;36;104940.0;34344.0;139284.0
411230;201805;40;36;4;34344.0;3816.0;38160.0
411240;201805;121;83;38;79182.0;36252.0;115434.0
411250;201805;424;311;113;296694.0;107802.0;404496.0
411260;201805;22;15;7;14310.0;6678.0;20988.0
411270;201805;295;158;137;150732.0;130698.0;281430.0
411275;201805;203;179;24;170050.6;22896.0;192946.6
411280;201805;227;162;65;153277.12;62010.0;215287.12
411290;201805;58;43;15;41022.0;14310.0;55332.0
411295;201805;146;115;31;109710.0;29574.0;139284.0
411300;201805;71;37;34;35298.0;32436.0;67734.0
411310;201805;91;70;21;66780.0;20034.0;86814.0
411320;201805;757;546;211;519358.4;199691.28;719049.7
411325;201805;42;26;16;24804.0;15264.0;40068.0
411330;201805;917;589;328;560380.6;312754.0;873134.6
411340;201805;26;17;9;16218.0;8272.0;24490.0
411342;201805;73;54;19;51516.0;18126.0;69642.0
411345;201805;126;64;62;61056.0;59148.0;120204.0
411350;201805;486;388;98;368864.44;92529.2;461393.62
411360;201805;53;34;19;32436.0;18126.0;50562.0
411370;201805;14175;5786;8389;5498789.0;7987277.5;1,35E+14
411373;201805;185;137;48;130698.0;45792.0;176490.0
411375;201805;72;60;12;57240.0;11448.0;68688.0
411380;201805;93;70;23;66780.0;21942.0;88722.0
411390;201805;136;90;46;85860.0;43884.0;129744.0
411400;201805;350;262;88;249939.0;83952.0;333891.0
411410;201805;452;231;221;219706.2;210548.0;430254.2
411420;201805;1025;472;553;447712.2;527085.2;974797.4
411430;201805;413;266;147;253096.2;140229.0;393325.2
411435;201805;35;24;11;22896.0;10494.0;33390.0
411440;201805;470;377;93;358004.75;88722.0;446726.75
411450;201805;427;354;73;337716.0;69642.0;407358.0
411460;201805;762;301;461;286257.62;438345.6;724603.25
411470;201805;86;64;22;61056.0;20988.0;82044.0
411480;201805;634;359;275;339720.4;262063.8;601784.2
411490;201805;293;183;110;174582.0;104940.0;279522.0
411500;201805;112;94;18;89472.33;16791.0;106263.33
411510;201805;215;174;41;165248.06;39114.0;204362.06
411520;201805;5918;2304;3614;2194004.8;3440285.8;5634290.5
411530;201805;110;75;35;71550.0;33390.0;104940.0
411535;201805;47;20;27;19080.0;25758.0;44838.0
411540;201805;348;243;105;230799.9;100170.0;330969.9
411545;201805;55;39;16;37206.0;15264.0;52470.0
411550;201805;73;56;17;53424.0;16218.0;69642.0
411560;201805;386;179;207;170102.38;197478.0;367580.38
411570;201805;775;296;479;282089.0;456776.0;738865.0
411573;201805;33;20;13;19080.0;12402.0;31482.0
411575;201805;264;164;100;156456.0;95400.0;251856.0
411580;201805;1254;504;750;478334.84;713652.4;1191987.2
411585;201805;81;41;40;39114.0;38160.0;77274.0
411590;201805;25;18;7;17172.0;6678.0;23850.0
411600;201805;26;10;16;9540.0;15264.0;24804.0
411605;201805;251;109;142;103539.0;135468.0;239007.0
411610;201805;234;160;74;152640.0;70596.0;223236.0
411620;201805;357;201;156;191277.0;148185.0;339462.0
411630;201805;58;39;19;37206.0;18126.0;55332.0
411640;201805;35;29;6;27666.0;5724.0;33390.0
411650;201805;12;8;4;7632.0;3816.0;11448.0
411660;201805;31;25;6;23850.0;5724.0;29574.0
411670;201805;246;187;59;178398.0;56286.0;234684.0
411680;201805;157;135;22;128790.0;20988.0;149778.0
411690;201805;600;316;284;300886.44;270590.3;571476.75
411695;201805;62;46;16;43884.0;15264.0;59148.0
411700;201805;163;141;22;134514.0;20988.0;155502.0
411705;201805;100;65;35;62010.0;33390.0;95400.0
411710;201805;301;202;99;191641.81;94446.0;286087.8
411720;201805;139;90;49;85860.0;46746.0;132606.0
411721;201805;63;52;11;49608.0;10494.0;60102.0
411722;201805;98;42;56;40068.0;53424.0;93492.0
411725;201805;149;116;33;110091.8;31482.0;141573.8
411727;201805;74;58;16;55332.0;14977.8;70309.8
411729;201805;32;25;7;23850.0;6678.0;30528.0
411730;201805;545;355;190;337079.97;180973.8;518053.75
411740;201805;36;22;14;20988.0;13356.0;34344.0
411745;201805;69;46;23;43093.0;21942.0;65035.0
411750;201805;871;415;456;394813.9;434055.7;828869.56
411760;201805;1190;896;294;853535.2;280467.0;1134002.2
411770;201805;444;296;148;282364.9;141192.0;423556.9
411780;201805;372;242;130;230868.0;124020.0;354888.0
411790;201805;532;298;234;282410.47;223123.14;505533.62
411800;201805;170;133;37;126882.0;35298.0;162180.0
411810;201805;167;128;39;122112.0;37206.0;159318.0
411820;201805;2085;1017;1068;967530.75;1018148.3;1985679.0
411830;201805;12;12;0;11448.0;0.0;11448.0
411840;201805;1963;1218;745;1159777.8;710237.0;1870014.8
411845;201805;50;19;31;18126.0;29574.0;47700.0
411850;201805;1237;711;526;676735.94;499851.03;1176587.0
411860;201805;43;28;15;26426.0;14310.0;40736.0
411870;201805;74;54;20;51516.0;18793.8;70309.8
411880;201805;428;274;154;261282.0;146171.88;407453.88
411885;201805;103;68;35;64872.0;33390.0;98262.0
411890;201805;321;205;116;194330.45;110654.46;304984.9
411900;201805;69;51;18;48654.0;17172.0;65826.0
411910;201805;176;142;34;135458.45;31596.48;167054.94
411915;201805;2113;905;1208;862217.56;1151368.0;2013585.6
411920;201805;126;104;22;99216.0;20988.0;120204.0
411925;201805;14;9;5;8586.0;4770.0;13356.0
411930;201805;803;591;212;561908.0;202248.0;764156.0
411940;201805;588;419;169;399249.0;161201.56;560450.56
411950;201805;902;481;421;458206.2;400966.2;859172.4
411960;201805;981;691;290;656201.56;276660.0;932861.56
411965;201805;24;16;8;15264.0;7632.0;22896.0
411970;201805;73;65;8;62010.0;7632.0;69642.0
411980;201805;196;127;69;121158.0;65826.0;186984.0
411990;201805;5013;2902;2111;2751566.5;2012173.4;4763740.0
411995;201805;461;173;288;165042.0;274752.0;439794.0
412000;201805;301;177;124;167952.77;118286.46;286239.22
412010;201805;47;29;18;27380.0;17172.0;44552.0
412015;201805;45;31;14;29574.0;13356.0;42930.0
412020;201805;25;22;3;20701.8;2862.0;23563.8
412030;201805;60;51;9;48654.0;8586.0;57240.0
412033;201805;55;36;19;34320.0;18126.0;52446.0
412035;201805;68;43;25;41022.0;23850.0;64872.0
412040;201805;36;25;11;23564.0;10494.0;34058.0
412050;201805;201;151;50;144054.0;47700.0;191754.0
412060;201805;750;585;165;555228.75;156419.8;711648.56
412065;201805;50;34;16;32436.0;15264.0;47700.0
412070;201805;156;104;52;98548.2;49608.0;148156.2
412080;201805;281;147;134;140238.0;127836.0;268074.0
412085;201805;33;16;17;15264.0;16218.0;31482.0
412090;201805;752;475;277;451481.2;264258.0;715739.2
412100;201805;249;209;40;198433.0;38160.0;236593.0
412110;201805;71;57;14;54378.0;13356.0;67734.0
412120;201805;310;205;105;194997.6;100170.0;295167.6
412125;201805;78;46;32;43597.8;30528.0;74125.8
412130;201805;47;36;11;33753.0;10494.0;44247.0
412135;201805;29;16;13;15264.0;12402.0;27666.0
412140;201805;315;224;91;213056.81;86814.0;299870.8
412150;201805;255;174;81;165042.05;77274.0;242316.05
412160;201805;84;50;34;47700.0;32436.0;80136.0
412170;201805;657;458;199;436645.8;189846.0;626491.8
412175;201805;38;28;10;26712.0;9540.0;36252.0
412180;201805;198;158;40;150132.61;37539.9;187672.52
412190;201805;334;266;68;253091.44;64872.0;317963.44
412200;201805;196;122;74;116388.0;70596.0;186984.0
412210;201805;73;56;17;53424.0;16218.0;69642.0
412215;201805;241;166;75;158077.8;71263.8;229341.6
412217;201805;71;55;16;52470.0;15264.0;67734.0
412220;201805;827;618;209;589572.0;199386.0;788958.0
412230;201805;340;207;133;195856.2;126845.46;322701.66
412240;201805;1325;649;676;616253.2;642823.44;1259076.6
412250;201805;384;248;136;236592.0;129744.0;366336.0
412260;201805;127;93;34;88722.0;32436.0;121158.0
412265;201805;169;133;36;126277.84;34344.0;160621.84
412270;201805;85;54;31;51516.0;29574.0;81090.0
412280;201805;90;71;19;67734.0;18126.0;85860.0
412290;201805;95;64;31;61056.0;29574.0;90630.0
412300;201805;217;141;76;134514.0;72360.9;206874.9
412310;201805;43;37;6;35298.0;5724.0;41022.0
412320;201805;93;79;14;75366.0;13356.0;88722.0
412330;201805;169;151;18;144054.0;17172.0;161226.0
412340;201805;147;102;45;97308.0;42644.0;139952.0
412350;201805;602;304;298;288704.3;284292.0;572996.3
412360;201805;28;25;3;23850.0;2862.0;26712.0
412370;201805;160;138;22;130698.0;20988.0;151686.0
412380;201805;254;192;62;182881.8;59044.0;241925.8
412382;201805;50;26;24;24804.0;22896.0;47700.0
412385;201805;144;104;40;99216.0;38160.0;137376.0
412390;201805;280;212;68;202248.0;64872.0;267120.0
412395;201805;65;52;13;49608.0;12402.0;62010.0
412400;201805;72;53;19;50562.0;18126.0;68688.0
412402;201805;252;119;133;113521.23;126595.8;240117.03
412405;201805;820;326;494;308310.1;470590.66;778900.75
412410;201805;941;594;347;563814.6;331038.0;894852.6
412420;201805;14;12;2;11448.0;1908.0;13356.0
412430;201805;20;14;6;13356.0;5724.0;19080.0
412440;201805;597;321;276;303970.8;261463.95;565434.75
412450;201805;81;68;13;64872.0;12402.0;77274.0
412460;201805;79;62;17;59148.0;16218.0;75366.0
412470;201805;262;208;54;197668.8;51516.0;249184.8
412480;201805;172;131;41;124020.9;39114.0;163134.9
412490;201805;166;142;24;135468.0;22896.0;158364.0
412500;201805;471;383;88;363807.8;83952.0;447759.8
412510;201805;187;154;33;146169.0;31482.0;177651.0
412520;201805;136;75;61;71550.0;58194.0;129744.0
412530;201805;109;58;51;55332.0;48367.8;103699.8
412535;201805;105;77;28;73440.0;26712.0;100152.0
412540;201805;67;33;34;31482.0;32436.0;63918.0
412545;201805;98;72;26;68688.0;24804.0;93492.0
412550;201805;3541;1599;1942;1519684.8;1850284.9;3369969.8
412555;201805;15;10;5;9540.0;4770.0;14310.0
412560;201805;589;440;149;417170.2;142146.0;559316.2
412570;201805;738;407;331;386427.25;315488.0;701915.25
412575;201805;83;58;25;55332.0;23850.0;79182.0
412580;201805;161;107;54;102078.0;51516.0;153594.0
412590;201805;34;32;2;30528.0;1908.0;32436.0
412600;201805;177;135;42;128790.0;40068.0;168858.0
412610;201805;31;19;12;18126.0;11448.0;29574.0
412620;201805;148;131;17;124974.0;16218.0;141192.0
412625;201805;2189;1172;1017;1115286.2;968340.56;2083626.8
412627;201805;69;55;14;52470.0;13356.0;65826.0
412630;201805;425;286;139;271310.44;132320.0;403630.44
412635;201805;66;20;46;19080.0;43884.0;62964.0
412640;201805;120;80;40;76320.0;38160.0;114480.0
412650;201805;345;216;129;206064.0;123061.23;329125.22
412660;201805;484;296;188;281669.0;179352.0;461021.0
412665;201805;51;45;6;42930.0;5724.0;48654.0
412667;201805;284;193;91;183303.1;86547.8;269850.9
412670;201805;61;52;9;49608.0;8586.0;58194.0
412680;201805;295;233;62;222282.0;59148.0;281430.0
412690;201805;114;73;41;69642.0;38828.0;108470.0
412700;201805;163;112;51;106848.0;48368.0;155216.0
412710;201805;1404;870;534;823972.6;507528.2;1331500.8
412720;201805;230;158;72;150732.0;68688.0;219420.0
412730;201805;200;160;40;152640.0;37206.0;189846.0
412740;201805;420;227;193;216414.9;184122.0;400536.9
412750;201805;468;270;198;256626.0;188892.0;445518.0
412760;201805;262;135;127;128790.0;121158.0;249948.0
412770;201805;2117;1196;921;1136601.0;876804.0;2013405.0
412780;201805;155;123;32;117342.0;30528.0;147870.0
412785;201805;276;140;136;133083.0;129744.0;262827.0
412788;201805;38;23;15;21942.0;14310.0;36252.0
412790;201805;139;114;25;108088.2;23850.0;131938.2
412795;201805;154;113;41;107802.0;39114.0;146916.0
412796;201805;301;211;90;200129.19;85726.44;285855.62
412800;201805;556;364;192;346696.38;183168.0;529864.4
412810;201805;3012;1666;1346;1583813.2;1282839.0;2866652.2
412820;201805;930;609;321;570053.8;304374.1;874427.9
412830;201805;15;12;3;11448.0;2862.0;14310.0
412840;201805;219;156;63;147870.2;60102.0;207972.2
412850;201805;784;533;251;506574.0;239454.0;746028.0
412853;201805;173;93;80;88722.0;76320.0;165042.0
412855;201805;212;116;96;109552.82;91584.0;201136.81
412860;201805;92;69;23;65826.0;21942.0;87768.0
412862;201805;59;44;15;41739.32;14310.0;56049.32
412863;201805;6;5;1;4770.0;954.0;5724.0
412865;201805;44;33;11;31482.0;10494.0;41976.0
412870;201805;107;71;36;67734.0;34344.0;102078.0
412880;201805;100;75;25;71550.0;23850.0;95400.0
420005;201805;38;34;4;32436.0;3244.0;35680.0
420010;201805;364;237;127;224910.34;120872.0;345782.34
420020;201805;76;64;12;61056.0;11448.0;72504.0
420030;201805;29;26;3;24804.0;2862.0;27666.0
420040;201805;106;81;25;77274.0;23850.0;101124.0
420050;201805;55;33;22;31482.0;20988.0;52470.0
420055;201805;20;19;1;18126.0;954.0;19080.0
420060;201805;33;23;10;21942.0;9540.0;31482.0
420070;201805;105;90;15;85860.0;14300.46;100160.46
420075;201805;13;11;2;10494.0;1908.0;12402.0
420080;201805;50;44;6;40306.5;5724.0;46030.5
420090;201805;34;32;2;29750.49;1908.0;31658.49
420100;201805;164;136;28;128790.2;26712.0;155502.2
420110;201805;20;20;0;19080.0;0.0;19080.0
420120;201805;49;38;11;36252.0;10494.0;46746.0
420125;201805;85;68;17;64872.0;16218.0;81090.0
420127;201805;35;31;4;29574.0;3816.0;33390.0
420130;201805;390;248;142;236296.45;135219.95;371516.4
420140;201805;1289;748;541;712267.4;516048.0;1228315.4
420150;201805;45;40;5;38160.0;4770.0;42930.0
420160;201805;38;36;2;34344.0;1908.0;36252.0
420165;201805;18;13;5;12402.0;4770.0;17172.0
420170;201805;65;42;23;40068.0;21942.0;62010.0
420180;201805;22;21;1;20034.0;954.0;20988.0
420190;201805;31;28;3;26712.0;2862.0;29574.0
420195;201805;127;59;68;56286.0;64872.0;121158.0
420200;201805;1284;575;709;543209.6;675281.3;1218490.9
420205;201805;67;35;32;33390.0;30528.0;63918.0
420207;201805;107;62;45;59148.0;42920.46;102068.46
420208;201805;24;19;5;18126.0;3911.4;22037.4
420209;201805;20;16;4;15264.0;3816.0;19080.0
420210;201805;465;221;244;210547.8;232681.14;443228.94
420213;201805;44;35;9;33390.0;8586.0;41976.0
420215;201805;26;22;4;20988.0;3816.0;24804.0
420220;201805;68;43;25;41022.0;23850.0;64872.0
420230;201805;772;438;334;417089.0;318054.47;735143.44
420240;201805;2298;1548;750;1469224.1;715061.2;2184285.2
420243;201805;38;31;7;29574.0;6678.0;36252.0
420245;201805;112;63;49;60102.0;46746.0;106848.0
420250;201805;53;31;22;29574.0;20988.0;50562.0
420253;201805;39;32;7;30528.0;6678.0;37206.0
420257;201805;11;9;2;8586.0;1908.0;10494.0
420260;201805;98;86;12;82044.0;11448.0;93492.0
420270;201805;37;30;7;28616.0;6678.0;35294.0
420280;201805;279;205;74;193855.06;69338.1;263193.16
420285;201805;18;12;6;11448.0;5724.0;17172.0
420287;201805;49;30;19;28620.0;18126.0;46746.0
420290;201805;966;680;286;646780.2;272776.3;919556.5
420300;201805;1385;1097;288;1041960.4;272272.12;1314232.5
420310;201805;58;45;13;42930.0;12402.0;55332.0
420315;201805;35;31;4;29574.0;3816.0;33390.0
420320;201805;852;434;418;413058.16;398768.0;811826.1
420325;201805;0;0;0;0.0;0.0;0.0
420330;201805;122;83;39;79182.0;37091.52;116273.52
420340;201805;157;107;50;101116.0;47680.92;148796.92
420350;201805;249;183;66;172961.0;62964.0;235925.0
420360;201805;753;573;180;544716.2;170099.78;714815.94
420370;201805;110;71;39;67544.0;36920.0;104464.0
420380;201805;1140;815;325;773686.5;309013.03;1082699.5
420390;201805;255;163;92;154243.52;87052.5;241296.02
420395;201805;186;133;53;126118.8;49789.26;175908.06
420400;201805;244;182;62;173056.0;59148.0;232204.0
420410;201805;61;48;13;45792.0;12402.0;58194.0
420415;201805;35;32;3;30528.0;2862.0;33390.0
420417;201805;47;35;12;33390.0;11428.92;44818.92
420419;201805;12;12;0;11448.0;0.0;11448.0
420420;201805;2800;1724;1076;1632360.6;1024216.44;2656577.0
420425;201805;72;61;11;58185.0;10180.26;68365.26
420430;201805;1281;893;388;847929.0;368406.2;1216335.2
420435;201805;16;14;2;13356.0;1908.0;15264.0
420440;201805;108;73;35;69014.68;33238.6;102253.28
420445;201805;23;20;3;19080.0;2862.0;21942.0
420450;201805;79;38;41;36243.0;39114.0;75357.0
420455;201805;254;190;64;181231.92;60964.38;242196.3
420460;201805;2351;1569;782;1492428.1;745794.9;2238223.0
420470;201805;118;84;34;80136.0;32436.0;112572.0
420475;201805;6;6;0;5724.0;0.0;5724.0
420480;201805;869;648;221;612736.1;209785.2;822521.3
420490;201805;111;87;24;82998.0;22896.0;105894.0
420500;201805;672;291;381;275643.2;363474.0;639117.2
420510;201805;19;16;3;15264.0;2862.0;18126.0
420515;201805;26;20;6;19080.0;5724.0;24804.0
420517;201805;12;12;0;11448.0;0.0;11448.0
420519;201805;0;0;0;0.0;0.0;0.0
420520;201805;69;52;17;49608.0;16218.0;65826.0
420530;201805;167;114;53;107781.02;50562.0;158343.02
420535;201805;21;19;2;18126.0;1908.0;20034.0
420540;201805;4924;2908;2016;2762132.2;1917962.0;4680094.5
420543;201805;24;24;0;22896.0;0.0;22896.0
420545;201805;195;139;56;131358.95;53404.92;184763.88
420550;201805;853;686;167;652499.3;159160.73;811660.06
420555;201805;40;28;12;26712.0;11448.0;38160.0
420560;201805;65;52;13;49226.4;12402.0;61628.4
420570;201805;144;84;60;80136.0;57230.46;137366.45
420580;201805;295;131;164;124974.0;156170.0;281144.0
420590;201805;513;366;147;348877.8;139857.0;488734.8
420600;201805;96;49;47;46746.0;44838.0;91584.0
420610;201805;37;35;2;33104.0;1908.0;35012.0
420620;201805;76;62;14;59148.0;13356.0;72504.0
420630;201805;154;113;41;107793.23;39106.0;146899.23
420640;201805;93;83;10;78991.2;9540.0;88531.2
420650;201805;244;130;114;123352.2;108137.23;231489.44
420660;201805;53;41;12;38350.8;11448.0;49798.8
420665;201805;37;28;9;26426.0;8586.0;35012.0
420670;201805;320;242;78;230142.95;74393.46;304536.4
420675;201805;15;14;1;13356.0;954.0;14310.0
420680;201805;35;25;10;23850.0;9540.0;33390.0
420690;201805;176;147;29;140238.0;27666.0;167904.0
420700;201805;649;442;207;421566.3;197225.28;618791.56
420710;201805;152;90;62;85860.0;58861.8;144721.8
420720;201805;109;87;22;82988.46;20988.0;103976.46
420730;201805;540;344;196;327118.5;185689.12;512807.62
420740;201805;47;46;1;43884.0;954.0;44838.0
420750;201805;503;338;165;322165.8;157410.0;479575.8
420757;201805;19;16;3;14453.1;2862.0;17315.1
420760;201805;39;32;7;30528.0;6678.0;37206.0
420765;201805;70;57;13;54378.0;12402.0;66780.0
420768;201805;65;58;7;55332.0;6678.0;62010.0
420770;201805;84;70;14;66780.0;13356.0;80136.0
420775;201805;47;44;3;41022.0;2862.0;43884.0
420780;201805;240;187;53;178388.45;50562.0;228950.45
420785;201805;14;10;4;9540.0;3816.0;13356.0
420790;201805;180;150;30;142998.3;27638.46;170636.77
420800;201805;75;57;18;53614.8;17172.0;70786.8
420810;201805;250;214;36;204147.0;33533.1;237680.1
420820;201805;2324;1386;938;1315890.6;893310.8;2209201.5
420830;201805;583;326;257;308700.94;244214.45;552915.44
420840;201805;150;112;38;106848.0;35548.0;142396.0
420845;201805;450;198;252;188288.06;239168.0;427456.06
420850;201805;234;188;46;179352.0;43884.0;223236.0
420860;201805;62;53;9;50562.0;8586.0;59148.0
420870;201805;118;85;33;81090.0;31482.0;112572.0
420880;201805;172;121;51;115424.46;48654.0;164078.45
420890;201805;869;428;441;404270.84;420132.8;824403.6
420895;201805;10;10;0;9540.0;0.0;9540.0
420900;201805;425;331;94;313715.03;89647.92;403362.97
420910;201805;5835;3278;2557;3115468.8;2434408.0;5549877.0
420915;201805;78;71;7;67734.0;6678.0;74412.0
420917;201805;19;14;5;13356.0;4770.0;18126.0
420920;201805;23;16;7;15264.0;6678.0;21942.0
420930;201805;2640;1609;1031;1528465.8;977702.3;2506168.0
420940;201805;615;445;170;423185.6;160528.08;583713.7
420945;201805;8;6;2;5724.0;1908.0;7632.0
420950;201805;56;51;5;48654.0;4770.0;53424.0
420960;201805;115;90;25;85822.92;23841.0;109663.92
420970;201805;304;244;60;231100.84;57212.46;288313.3
420980;201805;23;23;0;21942.0;0.0;21942.0
420985;201805;63;55;8;52470.0;7632.0;60102.0
420990;201805;71;56;15;53424.0;14310.0;67734.0
421000;201805;33;22;11;20988.0;10494.0;31482.0
421003;201805;68;44;24;41976.0;22887.0;64863.0
421005;201805;8;5;3;4770.0;2862.0;7632.0
421010;201805;771;543;228;516773.0;215452.0;732225.0
421020;201805;30;25;5;23850.0;4770.0;28620.0
421030;201805;131;111;20;105894.0;19080.0;124974.0
421040;201805;71;60;11;57240.0;10494.0;67734.0
421050;201805;318;231;87;218275.2;82998.0;301273.2
421055;201805;24;20;4;19080.0;3816.0;22896.0
421060;201805;81;56;25;53424.0;23850.0;77274.0
421070;201805;52;47;5;44838.0;4770.0;49608.0
421080;201805;36;32;4;30528.0;3816.0;34344.0
421085;201805;25;20;5;19080.0;4770.0;23850.0
421090;201805;43;32;11;30528.0;10494.0;41022.0
421100;201805;129;95;34;90630.0;32436.0;123066.0
421105;201805;220;179;41;170336.8;39090.69;209427.48
421110;201805;109;88;21;83952.0;20034.0;103986.0
421120;201805;153;119;34;113030.46;32416.92;145447.38
421125;201805;14;10;4;9540.0;3816.0;13356.0
421130;201805;820;528;292;502582.06;277528.53;780110.56
421140;201805;32;23;9;21226.5;8586.0;29812.5
421145;201805;40;31;9;29574.0;8586.0;38160.0
421150;201805;108;78;30;74412.0;28620.0;103032.0
421160;201805;61;40;21;38150.46;20034.0;58184.46
421165;201805;18;17;1;16218.0;954.0;17172.0
421170;201805;190;166;24;157336.84;22887.0;180223.84
421175;201805;150;97;53;92538.0;50523.92;143061.92
421180;201805;57;36;21;33982.0;20034.0;54016.0
421185;201805;17;14;3;13356.0;2862.0;16218.0
421187;201805;0;0;0;0.0;0.0;0.0
421189;201805;38;30;8;28620.0;7622.46;36242.46
421190;201805;1536;950;586;905337.44;558347.56;1463685.0
421200;201805;88;66;22;62010.7;20988.0;82998.7
421205;201805;27;18;9;17172.0;8576.46;25748.46
421210;201805;183;123;60;117342.0;57240.0;174582.0
421220;201805;278;220;58;209259.9;55332.0;264591.9
421223;201805;55;46;9;43603.0;8586.0;52189.0
421225;201805;63;40;23;38160.0;21942.0;60102.0
421227;201805;93;70;23;66780.0;21942.0;88722.0
421230;201805;49;36;13;34344.0;12402.0;46746.0
421240;201805;18;18;0;17172.0;0.0;17172.0
421250;201805;357;222;135;210454.0;127998.18;338452.2
421260;201805;28;23;5;21942.0;4770.0;26712.0
421265;201805;0;0;0;0.0;0.0;0.0
421270;201805;53;47;6;44838.0;5724.0;50562.0
421280;201805;335;189;146;180283.0;137566.8;317849.8
421290;201805;322;210;112;200102.0;105437.76;305539.75
421300;201805;26;20;6;19080.0;5724.0;24804.0
421310;201805;55;42;13;39400.2;12402.0;51802.2
421315;201805;29;20;9;19080.0;8586.0;27666.0
421320;201805;133;93;40;88722.0;38160.0;126882.0
421330;201805;108;82;26;76110.12;24795.0;100905.12
421335;201805;40;26;14;24804.0;13356.0;38160.0
421340;201805;293;200;93;189036.05;88722.0;277758.06
421350;201805;177;103;74;97819.0;70596.0;168415.0
421360;201805;693;509;184;480229.7;174755.06;654984.75
421370;201805;198;153;45;145962.0;42596.1;188558.1
421380;201805;128;103;25;98257.23;23850.0;122107.23
421390;201805;17;13;4;12402.0;3816.0;16218.0
421400;201805;115;97;18;92538.0;17172.0;109710.0
421410;201805;24;19;5;18126.0;4770.0;22896.0
421415;201805;22;21;1;20034.0;954.0;20988.0
421420;201805;150;123;27;116769.6;25471.8;142241.4
421430;201805;15;12;3;11448.0;2862.0;14310.0
421440;201805;56;43;13;41022.0;12402.0;53424.0
421450;201805;98;85;13;81090.0;12402.0;93492.0
421460;201805;58;49;9;45941.77;8586.0;54527.77
421470;201805;68;44;24;41976.0;22896.0;64872.0
421480;201805;637;472;165;449525.0;157401.0;606926.0
421490;201805;22;21;1;19358.0;954.0;20312.0
421500;201805;521;334;187;316833.2;178110.9;494944.1
421505;201805;25;19;6;18126.0;5724.0;23850.0
421507;201805;33;27;6;25758.0;5724.0;31482.0
421510;201805;72;46;26;43884.0;24804.0;68688.0
421520;201805;67;58;9;54569.0;8586.0;63155.0
421530;201805;54;49;5;46746.0;4770.0;51516.0
421535;201805;27;26;1;24537.0;954.0;25491.0
421540;201805;59;51;8;48654.0;7632.0;56286.0
421545;201805;96;73;23;69156.0;21942.0;91098.0
421550;201805;286;208;78;197765.0;74412.0;272177.0
421555;201805;28;22;6;20988.0;5629.0;26617.0
421560;201805;8;7;1;6678.0;954.0;7632.0
421565;201805;125;92;33;87768.0;31482.0;119250.0
421567;201805;31;26;5;24804.0;4770.0;29574.0
421568;201805;33;31;2;29574.0;1908.0;31482.0
421569;201805;8;8;0;7632.0;0.0;7632.0
421570;201805;149;101;48;96354.0;45792.0;142146.0
421575;201805;26;21;5;19771.65;4770.0;24541.65
421580;201805;723;431;292;409553.0;277614.34;687167.3
421590;201805;21;20;1;19080.0;954.0;20034.0
421600;201805;107;73;34;69642.0;31197.0;100839.0
421605;201805;104;74;30;70263.0;28620.0;98883.0
421610;201805;188;149;39;141192.5;37206.0;178398.5
421620;201805;1105;662;443;629048.94;422602.9;1051651.9
421625;201805;23;20;3;19080.0;2862.0;21942.0
421630;201805;283;182;101;172817.8;95496.0;268313.8
421635;201805;16;8;8;7632.0;7632.0;15264.0
421640;201805;98;84;14;80136.0;13356.0;93492.0
421650;201805;279;166;113;158344.92;107782.92;266127.84
421660;201805;2113;1268;845;1206755.2;805530.25;2012285.5
421670;201805;186;131;55;124974.0;52470.0;177444.0
421680;201805;169;153;16;145962.0;15255.0;161217.0
421690;201805;358;245;113;232749.0;106838.58;339587.6
421700;201805;58;36;22;34344.0;20130.0;54474.0
421710;201805;24;24;0;22896.0;0.0;22896.0
421715;201805;9;8;1;7632.0;954.0;8586.0
421720;201805;590;427;163;404759.4;153775.27;558534.7
421725;201805;14;7;7;6678.0;6678.0;13356.0
421730;201805;40;28;12;26004.12;11448.0;37452.12
421740;201805;86;41;45;39114.0;42930.0;82044.0
421750;201805;224;166;58;155918.52;55332.0;211250.52
421755;201805;26;24;2;22896.0;1908.0;24804.0
421760;201805;104;74;30;70596.0;28620.0;99216.0
421770;201805;574;388;186;367668.38;177369.3;545037.7
421775;201805;30;20;10;19080.0;9540.0;28620.0
421780;201805;198;156;42;148824.0;40068.0;188892.0
421790;201805;158;133;25;125989.5;23850.0;149839.5
421795;201805;16;13;3;12402.0;2862.0;15264.0
421800;201805;479;309;170;293989.3;162180.0;456169.3
421810;201805;68;54;14;51516.0;13356.0;64872.0
421820;201805;315;216;99;205396.2;94446.0;299842.2
421825;201805;126;105;21;100170.0;20034.0;120204.0
421830;201805;129;97;32;92538.0;30528.0;123066.0
421835;201805;3;3;0;2862.0;0.0;2862.0
421840;201805;60;50;10;47691.0;9540.0;57231.0
421850;201805;77;67;10;63918.0;9536.0;73454.0
421860;201805;41;32;9;30528.0;8586.0;39114.0
421870;201805;980;748;232;704713.7;220543.42;925257.1
421875;201805;52;46;6;43884.0;5724.0;49608.0
421880;201805;163;120;43;114480.0;40736.0;155216.0
421885;201805;27;22;5;20988.0;4770.0;25758.0
421890;201805;115;81;34;77274.0;32436.0;109710.0
421895;201805;43;40;3;38160.0;2862.0;41022.0
421900;201805;155;126;29;119843.1;27630.0;147473.1
421910;201805;65;43;22;41022.0;20988.0;62010.0
421915;201805;33;27;6;25758.0;5724.0;31482.0
421917;201805;41;31;10;29574.0;9540.0;39114.0
421920;201805;34;31;3;29574.0;2862.0;32436.0
421930;201805;742;574;168;545569.25;160245.0;705814.25
421935;201805;57;50;7;47700.0;6678.0;54378.0
421940;201805;40;37;3;35298.0;2862.0;38160.0
421950;201805;828;544;284;513120.1;268461.3;781581.44
421960;201805;41;35;6;33104.0;5702.12;38806.12
421970;201805;375;234;141;222737.12;134483.12;357220.25
421985;201805;31;20;11;19080.0;10494.0;29574.0
422000;201805;0;0;0;0.0;0.0;0.0
430003;201805;208;51;157;47938.5;149778.0;197716.5
430005;201805;35;27;8;25758.0;7632.0;33390.0
430010;201805;275;192;83;182691.0;79182.0;261873.0
430020;201805;153;99;54;94160.0;50562.0;144722.0
430030;201805;130;102;28;97021.8;26712.0;123733.8
430040;201805;2982;1735;1247;1647091.9;1187942.1;2835034.0
430045;201805;69;59;10;56000.0;9540.0;65540.0
430047;201805;6;5;1;4770.0;954.0;5724.0
430050;201805;80;67;13;63918.0;12402.0;76320.0
430055;201805;17;14;3;13356.0;2862.0;16218.0
430057;201805;4;2;2;1908.0;1908.0;3816.0
430060;201805;3680;2201;1479;2092510.9;1407478.2;3499989.2
430063;201805;61;56;5;53424.0;4770.0;58194.0
430064;201805;149;124;25;118296.0;23850.0;142146.0
430066;201805;10;7;3;6678.0;2862.0;9540.0
430070;201805;43;33;10;31482.0;9540.0;41022.0
430080;201805;67;45;22;42230.33;20988.0;63218.33
430085;201805;35;13;22;12402.0;20988.0;33390.0
430087;201805;34;26;8;24661.0;7632.0;32293.0
430090;201805;72;65;7;61723.8;6678.0;68401.8
430100;201805;127;86;41;81090.0;39114.0;120204.0
430105;201805;144;71;73;67257.0;69336.72;136593.72
430107;201805;20;15;5;14310.0;4770.0;19080.0
430110;201805;415;242;173;230057.1;164975.22;395032.3
430120;201805;140;129;11;122112.0;10494.0;132606.0
430130;201805;800;503;297;479241.9;283051.8;762293.7
430140;201805;125;115;10;109710.0;9540.0;119250.0
430150;201805;112;72;40;67925.0;37206.0;105131.0
430155;201805;31;28;3;26712.0;2862.0;29574.0
430160;201805;3803;2251;1552;2128882.2;1478442.6;3607324.8
430163;201805;328;148;180;140143.34;171662.77;311806.1
430165;201805;25;17;8;16218.0;7632.0;23850.0
430170;201805;83;75;8;71550.0;7632.0;79182.0
430175;201805;84;66;18;62964.0;16504.2;79468.2
430180;201805;104;81;23;77274.0;21321.9;98595.9
430185;201805;33;25;8;23850.0;7632.0;31482.0
430187;201805;102;43;59;41022.0;55980.8;97002.8
430190;201805;219;124;95;118248.3;89953.46;208201.77
430192;201805;15;14;1;13356.0;954.0;14310.0
430195;201805;13;8;5;7632.0;4770.0;12402.0
430200;201805;167;148;19;140524.2;18126.0;158650.2
430205;201805;20;19;1;18126.0;954.0;19080.0
430210;201805;632;491;141;464693.4;132653.9;597347.3
430215;201805;16;11;5;10494.0;4770.0;15264.0
430220;201805;67;48;19;45792.0;18126.0;63918.0
430222;201805;13;7;6;6678.0;5724.0;12402.0
430223;201805;15;8;7;7632.0;6678.0;14310.0
430225;201805;4;3;1;2862.0;954.0;3816.0
430230;201805;300;184;116;174582.0;110664.0;285246.0
430235;201805;53;38;15;36252.0;14300.46;50552.46
430237;201805;29;22;7;20988.0;6678.0;27666.0
430240;201805;132;84;48;79945.2;45792.0;125737.2
430245;201805;71;60;11;57240.0;10494.0;67734.0
430250;201805;190;109;81;103976.46;77264.46;181240.92
430258;201805;13;11;2;10494.0;1908.0;12402.0
430260;201805;35;30;5;28620.0;4760.46;33380.46
430265;201805;34;29;5;27646.92;4770.0;32416.92
430270;201805;559;414;145;391706.53;137473.02;529179.56
430280;201805;1040;635;405;601315.75;383870.6;985186.3
430290;201805;377;219;158;207018.8;150732.0;357750.8
430300;201805;2135;1179;956;1119053.2;908974.4;2028027.6
430310;201805;1980;1042;938;987783.4;891819.94;1879603.4
430320;201805;49;41;8;39099.69;7632.0;46731.69
430330;201805;95;85;10;80613.0;9520.92;90133.92
430340;201805;66;58;8;55332.0;7632.0;62964.0
430350;201805;1683;1167;516;1101842.4;490490.62;1592333.0
430355;201805;26;23;3;21942.0;2862.0;24804.0
430360;201805;81;39;42;37206.0;40068.0;77274.0
430367;201805;27;19;8;18126.0;7632.0;25758.0
430370;201805;54;46;8;43884.0;7632.0;51516.0
430380;201805;130;97;33;91965.6;31482.0;123447.6
430390;201805;621;387;234;368864.1;222931.45;591795.56
430400;201805;141;109;32;102268.8;30508.92;132777.72
430410;201805;61;48;13;45792.0;12402.0;58194.0
430420;201805;496;325;171;307570.8;160874.36;468445.16
430430;201805;54;52;2;48972.63;1908.0;50880.63
430435;201805;156;116;40;109710.0;37444.5;147154.5
430440;201805;496;329;167;313866.0;159127.2;472993.2
430450;201805;1197;986;211;933661.44;201284.45;1134945.9
430460;201805;5085;2791;2294;2647306.8;2183219.8;4830526.5
430461;201805;17;15;2;14310.0;1908.0;16218.0
430462;201805;9;6;3;5724.0;2862.0;8586.0
430463;201805;1030;546;484;518460.9;461384.1;979845.0
430465;201805;25;14;11;13356.0;10494.0;23850.0
430466;201805;667;480;187;456012.2;178207.2;634219.4
430467;201805;100;57;43;53137.8;41012.46;94150.26
430468;201805;111;71;40;67734.0;37908.91;105642.91
430469;201805;22;17;5;16218.0;4770.0;20988.0
430470;201805;1162;643;519;607737.56;493170.3;1100907.9
430471;201805;49;37;12;35278.92;11448.0;46726.92
430480;201805;92;55;37;51611.4;35288.46;86899.86
430485;201805;6;6;0;5438.0;0.0;5438.0
430490;201805;89;71;18;66923.7;17172.0;84095.7
430495;201805;40;30;10;28620.0;9540.0;38160.0
430500;201805;193;130;63;124020.0;59726.46;183746.45
430510;201805;3133;2079;1054;1975826.0;1004343.1;2980169.0
430511;201805;18;18;0;17172.0;0.0;17172.0
430512;201805;136;95;41;90630.0;39114.0;129744.0
430513;201805;54;46;8;43407.0;7632.0;51039.0
430515;201805;32;30;2;28620.0;1908.0;30528.0
430517;201805;169;149;20;141192.0;19060.92;160252.92
430520;201805;367;257;110;244511.0;104911.38;349422.38
430530;201805;89;53;36;50562.0;34344.0;84906.0
430535;201805;477;317;160;302218.44;152616.16;454834.6
430537;201805;10;10;0;9540.0;0.0;9540.0
430540;201805;71;48;23;45792.0;21942.0;67734.0
430543;201805;368;110;258;104940.0;246132.0;351072.0
430544;201805;42;39;3;37206.0;2862.0;40068.0
430545;201805;355;170;185;161684.0;175959.58;337643.6
430550;201805;43;36;7;34344.0;6678.0;41022.0
430558;201805;5;3;2;2862.0;1908.0;4770.0
430560;201805;48;20;28;19080.0;26712.0;45792.0
430570;201805;105;45;60;42930.0;57182.76;100112.76
430580;201805;123;96;27;91584.0;25710.3;117294.3
430583;201805;14;14;0;13356.0;0.0;13356.0
430585;201805;9;4;5;3816.0;4770.0;8586.0
430587;201805;14;8;6;7632.0;5724.0;13356.0
430590;201805;155;125;30;118009.8;28620.0;146629.8
430593;201805;4;4;0;3816.0;0.0;3816.0
430595;201805;17;13;4;12402.0;3816.0;16218.0
430597;201805;53;29;24;27666.0;22896.0;50562.0
430600;201805;220;156;64;148814.45;60769.8;209584.27
430605;201805;161;102;59;97308.0;56276.46;153584.45
430607;201805;26;21;5;20034.0;4770.0;24804.0
430610;201805;1641;770;871;731852.25;826603.75;1558456.0
430613;201805;3;3;0;2862.0;0.0;2862.0
430620;201805;114;83;31;79038.9;29564.46;108603.36
430630;201805;46;40;6;38160.0;5724.0;43884.0
430632;201805;32;27;5;25758.0;4770.0;30528.0
430635;201805;40;36;4;34344.0;3816.0;38160.0
430637;201805;57;33;24;31482.0;22896.0;54378.0
430640;201805;207;114;93;107325.0;88722.0;196047.0
430642;201805;27;25;2;23850.0;1908.0;25758.0
430645;201805;35;30;5;28620.0;4770.0;33390.0
430650;201805;255;204;51;194330.0;48606.3;242936.3
430655;201805;3;3;0;2862.0;0.0;2862.0
430660;201805;968;474;494;450621.9;469749.8;920371.7
430670;201805;73;51;22;48654.0;20988.0;69642.0
430673;201805;72;39;33;37206.0;31482.0;68688.0
430675;201805;13;10;3;9540.0;2862.0;12402.0
430676;201805;493;300;193;285475.03;184051.06;469526.12
430680;201805;250;174;76;163516.0;72504.0;236020.0
430690;201805;532;315;217;299623.3;205343.06;504966.38
430692;201805;7;5;2;4770.0;1908.0;6678.0
430693;201805;144;96;48;91584.0;45782.46;137366.45
430695;201805;73;65;8;61075.08;7632.0;68707.08
430697;201805;57;34;23;32436.0;21942.0;54378.0
430700;201805;1590;1117;473;1053877.8;450956.0;1504833.8
430705;201805;20;19;1;18126.0;954.0;19080.0
430710;201805;261;168;93;160272.0;88722.0;248994.0
430720;201805;108;92;16;87577.2;15264.0;102841.2
430730;201805;121;102;19;96354.0;18018.8;114372.8
430740;201805;66;44;22;41976.0;20988.0;62964.0
430745;201805;36;29;7;27380.0;6678.0;34058.0
430750;201805;338;227;111;215614.64;104940.0;320554.62
430755;201805;84;47;37;44838.0;35298.0;80136.0
430760;201805;371;225;146;211979.72;139255.92;351235.62
430770;201805;1469;755;714;717599.75;676650.75;1394250.5
430780;201805;315;202;113;191726.72;107735.76;299462.47
430781;201805;29;23;6;21942.0;5724.0;27666.0
430783;201805;51;41;10;38796.13;9540.0;48336.13
430786;201805;6;3;3;2862.0;2862.0;5724.0
430790;201805;505;327;178;310686.12;169516.45;480202.6
430800;201805;154;128;26;122092.92;24804.0;146896.92
430805;201805;41;37;4;35298.0;3816.0;39114.0
430807;201805;36;22;14;20988.0;13356.0;34344.0
430810;201805;73;47;26;44838.0;24804.0;69642.0
430820;201805;135;84;51;80136.0;47986.2;128122.2
430825;201805;12;10;2;9540.0;1908.0;11448.0
430830;201805;233;220;13;209574.92;12402.0;221976.92
430840;201805;128;87;41;82998.0;38446.2;121444.2
430843;201805;5;3;2;2862.0;1908.0;4770.0
430845;201805;69;39;30;37206.0;28620.0;65826.0
430850;201805;572;396;176;375942.78;167800.77;543743.56
430860;201805;153;98;55;92824.2;51792.66;144616.86
430865;201805;66;36;30;33676.2;28305.18;61981.38
430870;201805;81;66;15;62296.2;14310.0;76606.2
430880;201805;160;119;41;113506.92;39114.0;152620.92
430885;201805;7;6;1;5724.0;954.0;6678.0
430890;201805;335;204;131;192956.05;124974.0;317930.03
430900;201805;539;371;168;349736.4;159785.45;509521.88
430905;201805;89;37;52;35298.0;49608.0;84906.0
430910;201805;265;148;117;141192.0;110942.0;252134.0
430912;201805;4;4;0;3816.0;0.0;3816.0
430915;201805;36;28;8;26712.0;7345.8;34057.8
430920;201805;4262;2376;1886;2259525.5;1796508.6;4056034.2
430925;201805;5;4;1;3567.96;954.0;4521.96
430930;201805;2107;1252;855;1186091.8;815423.44;2001515.2
430940;201805;243;153;90;145284.66;85840.92;231125.58
430950;201805;156;127;29;121158.0;27666.0;148824.0
430955;201805;22;14;8;13356.0;7632.0;20988.0
430957;201805;18;17;1;16218.0;954.0;17172.0
430960;201805;237;158;79;148299.3;75366.0;223665.3
430965;201805;107;68;39;64872.0;37206.0;102078.0
430970;201805;78;65;13;62010.0;11448.0;73458.0
430975;201805;37;33;4;31482.0;3816.0;35298.0
430980;201805;46;28;18;26712.0;17172.0;43884.0
430990;201805;116;88;28;83952.0;26712.0;110664.0
430995;201805;113;109;4;102745.8;3816.0;106561.8
431000;201805;299;138;161;129505.2;153594.0;283099.2
431010;201805;340;206;134;195541.38;127836.0;323377.38
431020;201805;1932;1124;808;1064020.6;766720.25;1830740.9
431030;201805;43;34;9;32436.0;8586.0;41022.0
431033;201805;387;194;193;184265.2;184122.0;368387.2
431036;201805;16;9;7;8586.0;6678.0;15264.0
431040;201805;129;78;51;73458.0;48544.29;122002.29
431041;201805;36;24;12;22896.0;11448.0;34344.0
431043;201805;46;26;20;24804.0;19080.0;43884.0
431046;201805;12;7;5;6678.0;4770.0;11448.0
431050;201805;206;130;76;123446.37;71502.3;194948.67
431053;201805;76;46;30;43120.8;28620.0;71740.8
431055;201805;64;43;21;41022.0;20014.92;61036.92
431057;201805;17;17;0;16218.0;0.0;16218.0
431060;201805;1675;1057;618;1000433.4;587720.44;1588153.8
431065;201805;18;11;7;10494.0;6678.0;17172.0
431070;201805;73;68;5;64872.0;4770.0;69642.0
431075;201805;7;7;0;6678.0;0.0;6678.0
431080;201805;137;87;50;82711.8;47700.0;130411.8
431085;201805;30;27;3;25758.0;2862.0;28620.0
431087;201805;14;12;2;11448.0;1908.0;13356.0
431090;201805;54;42;12;40068.0;11448.0;51516.0
431100;201805;1236;736;500;691320.0;477000.0;1168320.0
431110;201805;246;154;92;146916.0;87472.46;234388.45
431112;201805;29;17;12;16218.0;11448.0;27666.0
431113;201805;31;21;10;20034.0;9540.0;29574.0
431115;201805;155;106;49;100487.87;46736.46;147224.33
431120;201805;618;363;255;344356.62;243193.84;587550.5
431123;201805;3;2;1;1908.0;954.0;2862.0
431125;201805;91;81;10;77274.0;9540.0;86814.0
431127;201805;7;3;4;2862.0;3816.0;6678.0
431130;201805;650;417;233;396577.8;221976.72;618554.5
431140;201805;726;493;233;467603.3;222205.69;689809.0
431142;201805;35;27;8;24546.0;7632.0;32178.0
431150;201805;206;152;54;145008.0;51506.46;196514.45
431160;201805;57;51;6;48654.0;5724.0;54378.0
431162;201805;19;14;5;13356.0;4770.0;18126.0
431164;201805;4;4;0;3816.0;0.0;3816.0
431170;201805;105;85;20;81090.0;19080.0;100170.0
431171;201805;55;30;25;28277.94;23840.46;52118.4
431173;201805;1;1;0;954.0;0.0;954.0
431175;201805;201;98;103;92252.0;98252.46;190504.45
431177;201805;76;57;19;54378.0;17439.92;71817.92
431179;201805;13;11;2;10494.0;1908.0;12402.0
431180;201805;445;269;176;256626.0;167885.45;424511.47
431190;201805;90;69;21;65826.0;20034.0;85860.0
431198;201805;70;47;23;44838.0;21942.0;66780.0
431200;201805;21;17;4;16218.0;3816.0;20034.0
431205;201805;23;23;0;21942.0;0.0;21942.0
431210;201805;90;56;34;53091.0;32436.0;85527.0
431213;201805;30;25;5;23850.0;4770.0;28620.0
431215;201805;25;22;3;20988.0;2862.0;23850.0
431217;201805;7;6;1;5724.0;954.0;6678.0
431220;201805;67;57;10;54378.0;9540.0;63918.0
431225;201805;148;97;51;92529.0;48634.92;141163.92
431230;201805;99;87;12;82998.0;11448.0;94446.0
431235;201805;8;8;0;7632.0;0.0;7632.0
431237;201805;24;16;8;15264.0;7632.0;22896.0
431238;201805;13;10;3;9254.0;2862.0;12116.0
431240;201805;1004;645;359;613670.6;341970.84;955641.5
431242;201805;36;36;0;34344.0;0.0;34344.0
431244;201805;11;8;3;7632.0;2862.0;10494.0
431245;201805;58;44;14;41976.0;13356.0;55332.0
431247;201805;12;10;2;9540.0;1908.0;11448.0
431250;201805;269;138;131;131585.22;124954.92;256540.14
431260;201805;62;45;17;42930.0;16218.0;59148.0
431261;201805;21;14;7;13356.0;6678.0;20034.0
431262;201805;15;15;0;14310.0;0.0;14310.0
431265;201805;160;84;76;80136.0;72504.0;152640.0
431267;201805;13;12;1;11448.0;954.0;12402.0
431270;201805;320;268;52;255672.0;49608.0;305280.0
431275;201805;40;38;2;36252.0;1908.0;38160.0
431280;201805;20;16;4;14429.25;3816.0;18245.25
431290;201805;22;19;3;18126.0;2862.0;20988.0
431295;201805;4;4;0;3816.0;0.0;3816.0
431300;201805;22;19;3;18126.0;2862.0;20988.0
431301;201805;7;7;0;6678.0;0.0;6678.0
431303;201805;52;35;17;33265.98;15931.8;49197.78
431306;201805;225;117;108;111161.98;103032.0;214193.98
431308;201805;7;5;2;4770.0;1908.0;6678.0
431310;201805;64;55;9;52470.0;8586.0;61056.0
431320;201805;120;69;51;65826.0;48358.26;114184.26
431330;201805;178;116;62;110664.0;59148.0;169812.0
431333;201805;33;27;6;25758.0;5724.0;31482.0
431335;201805;10;5;5;4770.0;4770.0;9540.0
431337;201805;329;156;173;147965.58;164002.34;311967.9
431339;201805;20;17;3;16218.0;2862.0;19080.0
431340;201805;3029;1744;1285;1659097.4;1222945.5;2882042.8
431342;201805;42;25;17;23850.0;16218.0;40068.0
431344;201805;18;17;1;16218.0;954.0;17172.0
431346;201805;4;4;0;3816.0;0.0;3816.0
431349;201805;35;32;3;30528.0;2862.0;33390.0
431350;201805;916;536;380;506795.66;360860.03;867655.7
431360;201805;46;40;6;38160.0;5724.0;43884.0
431365;201805;319;153;166;145942.92;157400.45;303343.38
431370;201805;1341;793;548;752887.94;522271.1;1275159.0
431380;201805;98;85;13;81090.0;12402.0;93492.0
431390;201805;500;277;223;263256.5;212198.22;475454.72
431395;201805;283;125;158;119250.0;150713.0;269963.0
431400;201805;39;29;10;27666.0;9540.0;37206.0
431402;201805;103;72;31;68688.0;29574.0;98262.0
431403;201805;19;11;8;10494.0;7632.0;18126.0
431405;201805;643;347;296;329398.03;282071.0;611469.0
431406;201805;30;26;4;24804.0;3816.0;28620.0
431407;201805;51;40;11;38160.0;10494.0;48654.0
431410;201805;3286;1966;1320;1862424.2;1254749.2;3117173.5
431413;201805;16;13;3;12402.0;2862.0;15264.0
431415;201805;70;51;19;48654.0;18126.0;66780.0
431417;201805;23;12;11;11448.0;10494.0;21942.0
431420;201805;307;217;90;206334.27;85860.0;292194.25
431430;201805;43;17;26;16218.0;24804.0;41022.0
431440;201805;8989;6397;2592;6031757.5;2464960.8;8496718.0
431442;201805;27;14;13;13356.0;12402.0;25758.0
431445;201805;26;20;6;19080.0;5724.0;24804.0
431446;201805;7;6;1;5724.0;954.0;6678.0
431447;201805;86;61;25;58194.0;23850.0;82044.0
431449;201805;51;45;6;42930.0;5724.0;48654.0
431450;201805;412;283;129;268932.6;122350.5;391283.1
431454;201805;0;0;0;0.0;0.0;0.0
431455;201805;51;41;10;39114.0;9540.0;48654.0
431460;201805;536;369;167;349974.9;159031.8;509006.7
431470;201805;118;91;27;86122.54;25508.0;111630.54
431475;201805;11;10;1;9540.0;954.0;10494.0
431477;201805;37;25;12;23850.0;11448.0;35298.0
431478;201805;8;7;1;6678.0;954.0;7632.0
431480;201805;506;320;186;303734.53;177396.3;481130.8
431490;201805;28227;16061;12166;1,52E+14;1,16E+14;2,68E+14
431500;201805;79;53;26;50562.0;24804.0;75366.0
431505;201805;35;21;14;20034.0;13356.0;33390.0
431507;201805;12;10;2;9540.0;1908.0;11448.0
431510;201805;275;183;92;174153.0;86785.38;260938.38
431513;201805;22;18;4;17172.0;3816.0;20988.0
431514;201805;9;8;1;7632.0;954.0;8586.0
431515;201805;80;67;13;63918.0;12402.0;76320.0
431517;201805;3;2;1;1908.0;954.0;2862.0
431520;201805;38;34;4;32436.0;3816.0;36252.0
431530;201805;1589;711;878;677912.6;837188.06;1515100.8
431531;201805;23;21;2;20034.0;1908.0;21942.0
431532;201805;24;16;8;15264.0;7632.0;22896.0
431535;201805;25;16;9;15264.0;8586.0;23850.0
431540;201805;140;124;16;117275.22;15264.0;132539.22
431545;201805;17;15;2;14310.0;1908.0;16218.0
431550;201805;351;202;149;192163.27;142050.6;334213.88
431555;201805;12;11;1;10494.0;954.0;11448.0
431560;201805;4546;3208;1338;3029116.5;1274087.0;4303203.5
431570;201805;802;426;376;402130.12;355833.47;757963.56
431575;201805;36;25;11;23850.0;10494.0;34344.0
431580;201805;97;68;29;63918.0;27666.0;91584.0
431590;201805;138;115;23;108756.0;21942.0;130698.0
431595;201805;12;11;1;10494.0;954.0;11448.0
431600;201805;220;127;93;121158.0;88722.0;209880.0
431610;201805;128;93;35;88054.2;33390.0;121444.2
431620;201805;42;34;8;32436.0;7632.0;40068.0
431630;201805;140;116;24;110664.0;22896.0;133560.0
431640;201805;1355;842;513;797223.6;487094.12;1284317.8
431642;201805;39;36;3;33867.0;2862.0;36729.0
431643;201805;45;20;25;19080.0;23850.0;42930.0
431645;201805;300;174;126;165996.0;119917.8;285913.8
431647;201805;9;9;0;8586.0;0.0;8586.0
431650;201805;36;27;9;25758.0;8586.0;34344.0
431660;201805;284;181;103;170766.0;98262.0;269028.0
431670;201805;222;104;118;96592.5;112543.38;209135.88
431673;201805;3;3;0;2862.0;0.0;2862.0
431675;201805;31;26;5;24517.8;4770.0;29287.8
431680;201805;1107;795;312;753535.94;296551.44;1050087.4
431690;201805;4811;2932;1879;2774703.8;1788647.8;4563351.5
431695;201805;26;20;6;19080.0;5724.0;24804.0
431697;201805;0;0;0;0.0;0.0;0.0
431700;201805;175;135;40;128790.0;38160.0;166950.0
431710;201805;4012;1727;2285;1645164.2;2179391.5;3824555.8
431720;201805;1392;833;559;786747.0;532318.44;1319065.5
431725;201805;1;1;0;954.0;0.0;954.0
431730;201805;1194;814;380;769861.1;362520.0;1132381.1
431740;201805;1368;680;688;644102.75;654561.4;1298664.1
431750;201805;1872;1213;659;1146925.5;626749.94;1773675.4
431755;201805;7;6;1;5724.0;954.0;6678.0
431760;201805;1079;689;390;656924.4;371831.6;1028756.0
431770;201805;394;288;106;274742.47;101104.92;375847.38
431775;201805;29;22;7;20988.0;6678.0;27666.0
431780;201805;564;350;214;332783.8;204146.45;536930.25
431790;201805;154;118;36;111618.0;34296.3;145914.3
431795;201805;14;12;2;11448.0;1908.0;13356.0
431800;201805;3379;1775;1604;1680632.0;1524212.4;3204844.5
431805;201805;16;15;1;14310.0;954.0;15264.0
431810;201805;620;415;205;393276.97;195436.98;588713.94
431820;201805;312;176;136;167904.0;128742.3;296646.3
431830;201805;2337;1415;922;1346289.6;878327.6;2224617.2
431840;201805;518;346;172;326460.4;162848.0;489308.4
431842;201805;34;28;6;26712.0;5724.0;32436.0
431843;201805;13;8;5;7632.0;4770.0;12402.0
431844;201805;14;12;2;11448.0;1908.0;13356.0
431845;201805;29;26;3;24804.0;2862.0;27666.0
431846;201805;28;24;4;22896.0;3816.0;26712.0
431848;201805;14;12;2;11448.0;1908.0;13356.0
431849;201805;9;7;2;6678.0;1908.0;8586.0
431850;201805;805;668;137;635759.5;130459.5;766219.0
431860;201805;104;73;31;69642.0;28620.0;98262.0
431861;201805;4;2;2;1908.0;1908.0;3816.0
431862;201805;52;34;18;32436.0;17172.0;49608.0
431870;201805;3466;2049;1417;1945220.8;1348751.9;3293972.5
431880;201805;958;701;257;662715.8;244224.0;906939.8
431890;201805;1306;808;498;765795.75;473485.0;1239280.8
431900;201805;185;129;56;123066.0;52632.18;175698.19
431910;201805;56;42;14;40068.0;13356.0;53424.0
431912;201805;35;19;16;18126.0;15264.0;33390.0
431915;201805;129;102;27;97308.0;25758.0;123066.0
431920;201805;143;105;38;99883.8;36252.0;136135.8
431930;201805;86;70;16;66780.0;15264.0;82044.0
431935;201805;4;3;1;2862.0;954.0;3816.0
431936;201805;13;12;1;11448.0;954.0;12402.0
431937;201805;18;13;5;12402.0;4770.0;17172.0
431940;201805;463;312;151;294881.4;144044.45;438925.88
431950;201805;483;306;177;290684.88;168706.98;459391.88
431960;201805;726;425;301;401264.03;286992.9;688256.94
431970;201805;71;62;9;59148.0;8586.0;67734.0
431971;201805;2;2;0;1908.0;0.0;1908.0
431973;201805;21;17;4;16218.0;3816.0;20034.0
431975;201805;7;6;1;5724.0;954.0;6678.0
431980;201805;204;129;75;121539.6;71550.0;193089.6
431990;201805;1222;655;567;623349.3;540872.0;1164221.2
432000;201805;1673;909;764;858547.25;725291.25;1583838.5
432010;201805;279;183;96;173284.56;91584.0;264868.56
432020;201805;171;136;35;129744.0;33380.46;163124.45
432023;201805;19;15;4;14310.0;3816.0;18126.0
432026;201805;66;60;6;57240.0;5724.0;62964.0
432030;201805;64;28;36;26712.0;34344.0;61056.0
432032;201805;21;18;3;17172.0;2862.0;20034.0
432035;201805;49;38;11;36252.0;10494.0;46746.0
432040;201805;104;71;33;67734.0;31482.0;99216.0
432045;201805;8;7;1;6678.0;954.0;7632.0
432050;201805;69;42;27;40068.0;25758.0;65826.0
432055;201805;101;72;29;68688.0;27666.0;96354.0
432057;201805;1;0;1;0.0;954.0;954.0
432060;201805;36;33;3;31482.0;2862.0;34344.0
432065;201805;30;27;3;25758.0;2862.0;28620.0
432067;201805;88;78;10;74392.92;9540.0;83932.92
432070;201805;409;307;102;290981.38;97279.92;388261.3
432080;201805;811;560;251;532370.9;239358.69;771729.56
432085;201805;16;12;4;11448.0;3816.0;15264.0
432090;201805;262;162;100;154548.0;95400.0;249948.0
432100;201805;178;120;58;114098.4;55332.0;169430.4
432110;201805;622;425;197;395768.25;186984.0;582752.25
432120;201805;957;576;381;548836.2;363388.12;912224.3
432130;201805;509;368;141;349736.4;133416.9;483153.3
432132;201805;26;23;3;21942.0;2862.0;24804.0
432135;201805;79;65;14;62010.0;13356.0;75366.0
432140;201805;268;214;54;203860.27;51516.0;255376.27
432143;201805;192;123;69;117342.0;65826.0;183168.0
432145;201805;273;192;81;181928.6;76987.8;258916.4
432146;201805;14;13;1;12402.0;954.0;13356.0
432147;201805;135;62;73;59148.0;69618.15;128766.15
432149;201805;19;14;5;13356.0;4770.0;18126.0
432150;201805;837;526;311;501555.97;294641.6;796197.56
432160;201805;1396;723;673;687396.7;641136.44;1328533.1
432162;201805;5;4;1;3816.0;954.0;4770.0
432163;201805;18;14;4;13356.0;3816.0;17172.0
432166;201805;122;91;31;87292.0;29574.0;116866.0
432170;201805;224;120;104;113527.0;99216.0;212743.0
432180;201805;529;321;208;303467.97;198146.0;501613.97
432183;201805;10;7;3;6678.0;2862.0;9540.0
432185;201805;83;72;11;68595.18;10494.0;79089.18
432190;201805;464;256;208;243642.86;198299.52;441942.38
432195;201805;85;73;12;68926.5;11448.0;80374.5
432200;201805;419;274;145;261396.0;138282.84;399678.84
432210;201805;119;77;42;71693.1;40068.0;111761.1
432215;201805;60;56;4;53424.0;3816.0;57240.0
432218;201805;19;18;1;17172.0;954.0;18126.0
432220;201805;685;346;339;329073.62;322898.75;651972.4
432225;201805;13;8;5;7155.0;4770.0;11925.0
432230;201805;144;87;57;82759.5;54378.0;137137.5
432232;201805;15;13;2;12402.0;1908.0;14310.0
432234;201805;4;3;1;2862.0;954.0;3816.0
432235;201805;1;1;0;954.0;0.0;954.0
432237;201805;30;17;13;16218.0;12402.0;28620.0
432240;201805;4259;2369;1890;2251184.2;1795105.1;4046289.2
432250;201805;1039;660;379;626970.25;361375.2;988345.44
432252;201805;41;33;8;30737.88;7632.0;38369.88
432253;201805;57;46;11;43884.0;10494.0;54378.0
432254;201805;24;11;13;10494.0;12402.0;22896.0
432255;201805;14;13;1;12402.0;954.0;13356.0
432260;201805;875;687;188;653672.25;178398.5;832070.75
432270;201805;230;167;63;159318.0;60102.0;219420.0
432280;201805;123;89;34;84429.8;32436.0;116865.8
432285;201805;1;1;0;954.0;0.0;954.0
432290;201805;70;63;7;58194.0;6678.0;64872.0
432300;201805;4646;2652;1994;2514301.5;1898415.8;4412717.0
432310;201805;118;95;23;90630.0;21942.0;112572.0
432320;201805;21;16;5;15216.3;4770.0;19986.3
432330;201805;15;10;5;9540.0;4770.0;14310.0
432335;201805;7;6;1;5724.0;954.0;6678.0
432340;201805;40;37;3;35298.0;2862.0;38160.0
432345;201805;96;68;28;64872.0;26712.0;91584.0
432350;201805;23;22;1;20988.0;954.0;21942.0
432360;201805;6;4;2;3816.0;1908.0;5724.0
432370;201805;25;25;0;23850.0;0.0;23850.0
432375;201805;39;34;5;32436.0;4770.0;37206.0
432377;201805;7;7;0;6678.0;0.0;6678.0
432380;201805;171;78;93;73744.2;88674.3;162418.5
500020;201805;247;135;112;128790.0;106246.98;235036.98
500025;201805;116;57;59;53424.0;56286.0;109710.0
500060;201805;1392;854;538;814143.6;512646.62;1326790.2
500070;201805;772;368;404;350721.0;385406.47;736127.44
500080;201805;134;103;31;98262.0;29574.0;127836.0
500085;201805;138;112;26;106562.0;23969.25;130531.25
500090;201805;334;160;174;152640.0;165996.0;318636.0
500100;201805;703;379;324;358799.8;308524.0;667323.8
500110;201805;2246;1013;1233;966065.94;1175469.1;2141535.0
500124;201805;310;177;133;168858.0;126595.8;295453.8
500150;201805;329;130;199;124011.0;189476.45;313487.47
500190;201805;529;364;165;346588.2;156924.0;503512.2
500200;201805;201;171;30;162791.0;28620.0;191411.0
500210;201805;1460;521;939;495903.0;894643.0;1390546.0
500215;201805;241;138;103;129653.46;98262.0;227915.45
500220;201805;795;519;276;494881.84;262546.47;757428.3
500230;201805;260;176;84;167188.5;79659.0;246847.5
500240;201805;706;488;218;464788.8;207685.8;672474.6
500260;201805;567;214;353;204156.0;336762.0;540918.0
500270;201805;28405;12077;16328;1,15E+14;1,56E+14;2,71E+14
500280;201805;192;73;119;69642.0;113526.0;183168.0
500290;201805;1192;706;486;672285.0;463635.0;1135920.0
500295;201805;415;253;162;241362.0;154538.45;395900.47
500310;201805;63;20;43;19080.0;41022.0;60102.0
500315;201805;708;426;282;406394.47;268867.78;675262.25
500320;201805;3610;1814;1796;1728129.4;1711995.0;3440124.2
500325;201805;931;520;411;495603.0;391119.44;886722.44
500330;201805;1477;680;797;646498.25;760000.6;1406498.9
500345;201805;327;240;87;227997.2;82998.0;310995.2
500348;201805;246;143;103;136422.0;98243.46;234665.45
500350;201805;139;66;73;62964.0;69642.0;132606.0
500370;201805;5425;2442;2983;2322140.0;2843590.0;5165730.0
500375;201805;353;256;97;243786.36;92538.0;336324.38
500380;201805;589;335;254;319432.6;242306.45;561739.06
500390;201805;72;36;36;34344.0;34344.0;68688.0
500400;201805;220;148;72;141172.92;68679.0;209851.92
500410;201805;559;221;338;210788.16;322304.22;533092.4
500430;201805;549;383;166;365382.0;158364.0;523746.0
500440;201805;204;105;99;99397.43;94446.0;193843.44
500450;201805;409;177;232;168152.8;221318.45;389471.25
500460;201805;311;157;154;149768.45;146916.0;296684.47
500470;201805;442;347;95;329537.66;89667.0;419204.66
500480;201805;116;69;47;65826.0;44838.0;110664.0
500490;201805;109;44;65;41971.23;62010.0;103981.23
500500;201805;1427;504;923;478789.38;879966.44;1358755.8
500510;201805;49;39;10;37206.0;9531.0;46737.0
500515;201805;109;77;32;73458.0;30242.0;103700.0
500520;201805;348;194;154;184027.0;146626.0;330653.0
500525;201805;88;50;38;47700.0;35965.8;83665.8
500540;201805;898;378;520;360486.75;495069.84;855556.6
500560;201805;889;503;386;478123.03;367266.88;845389.94
500568;201805;1006;581;425;550998.8;405159.22;956158.06
500570;201805;1220;686;534;651451.06;506828.38;1158279.4
500580;201805;336;171;165;162838.27;157397.0;320235.25
500600;201805;314;158;156;150021.27;148806.0;298827.28
500620;201805;924;648;276;612414.6;263113.2;875527.8
500625;201805;81;69;12;65119.19;11448.0;76567.19
500627;201805;25;12;13;11448.0;12402.0;23850.0
500630;201805;1568;834;734;794959.44;699759.8;1494719.2
500635;201805;516;292;224;278148.25;213552.9;491701.12
500640;201805;422;221;201;208260.0;191735.45;399995.47
500660;201805;5526;2117;3409;2015898.5;3247484.2;5263383.0
500690;201805;570;204;366;194259.23;347476.25;541735.5
500710;201805;356;172;184;163802.0;175518.0;339320.0
500720;201805;981;573;408;544958.7;389022.9;933981.6
500730;201805;198;118;80;112572.0;76315.23;188887.23
500740;201805;841;367;474;348826.94;451917.75;800744.7
500750;201805;140;47;93;44838.0;88693.92;133531.92
500755;201805;123;89;34;84620.0;32436.0;117056.0
500769;201805;742;421;321;401303.03;306221.0;707524.06
500770;201805;436;231;205;220364.45;195560.45;415924.9
500780;201805;170;113;57;107802.0;54378.0;162180.0
500790;201805;1045;516;529;491187.25;504625.47;995812.7
500793;201805;253;138;115;131652.0;109701.0;241353.0
500795;201805;177;126;51;120194.46;48645.0;168839.45
500797;201805;39;30;9;28620.0;8586.0;37206.0
500800;201805;408;177;231;168849.0;220087.8;388936.8
500830;201805;2205;1232;973;1171580.4;927202.7;2098783.0
500840;201805;143;108;35;103032.0;33381.0;136413.0
510010;201805;162;91;71;86804.46;67734.0;154538.45
510020;201805;488;228;260;217218.06;247503.95;464722.03
510025;201805;1682;954;728;909246.1;691985.06;1601231.2
510030;201805;669;347;322;330991.9;306414.7;637406.6
510035;201805;129;59;70;56258.46;66761.46;123019.92
510040;201805;389;173;216;165042.0;205617.27;370659.25
510050;201805;427;233;194;221531.66;184271.45;405803.12
510060;201805;115;57;58;54368.46;55322.46;109690.92
510080;201805;221;89;132;84873.69;125814.06;210687.75
510100;201805;78;35;43;33390.0;41002.92;74392.92
510120;201805;37;22;15;20988.0;14310.0;35298.0
510125;201805;395;241;154;229231.89;146892.92;376124.8
510130;201805;570;332;238;316322.8;226628.64;542951.44
510140;201805;392;129;263;123057.0;250897.23;373954.22
510160;201805;93;40;53;38160.0;50558.0;88718.0
510170;201805;866;523;343;498667.06;326589.38;825256.44
510180;201805;2871;1395;1476;1327816.6;1406180.4;2733997.0
510185;201805;12;6;6;5724.0;5724.0;11448.0
510190;201805;212;71;141;67734.0;134509.23;202243.23
510250;201805;2620;1541;1079;1469073.1;1028233.1;2497306.2
510260;201805;200;144;56;137193.84;53387.46;190581.3
510263;201805;458;252;206;239405.45;195768.6;435174.06
510267;201805;668;372;296;353665.75;282113.44;635779.2
510268;201805;56;29;27;27666.0;25758.0;53424.0
510269;201805;66;30;36;28611.0;34344.0;62955.0
510270;201805;410;208;202;198253.98;192281.94;390535.9
510279;201805;231;170;61;162153.0;57888.92;220041.92
510285;201805;166;73;93;69623.46;88722.0;158345.45
510300;201805;537;296;241;281952.12;229839.84;511791.97
510305;201805;214;100;114;95377.46;108662.22;204039.69
510310;201805;113;58;55;55332.0;52460.46;107792.46
510320;201805;871;546;325;520306.62;309900.38;830207.0
510325;201805;412;165;247;157400.45;235342.27;392742.72
510330;201805;424;238;186;227039.0;177424.92;404463.9
510335;201805;593;324;269;309049.38;255321.19;564370.56
510336;201805;48;35;13;33390.0;12402.0;45792.0
510337;201805;120;49;71;46736.46;67724.46;114460.92
510340;201805;17335;8306;9029;7902019.0;8603861.0;1,65E+13
510343;201805;71;49;22;46736.46;20988.0;67724.46
510345;201805;158;105;53;100160.46;50256.92;150417.38
510350;201805;668;370;298;352038.06;284227.38;636265.44
510360;201805;201;118;83;112563.0;79099.92;191662.92
510370;201805;139;71;68;67705.38;64740.6;132445.98
510380;201805;90;63;27;60102.0;25749.0;85851.0
510385;201805;58;27;31;25758.0;29565.0;55323.0
510390;201805;122;52;70;49608.0;66741.84;116349.84
510395;201805;40;29;11;27666.0;10494.0;38160.0
510410;201805;710;474;236;452192.0;225120.69;677312.7
510420;201805;590;289;301;274761.34;285734.0;560495.3
510450;201805;51;30;21;28620.0;20034.0;48654.0
510452;201805;41;23;18;21942.0;17172.0;39114.0
510454;201805;61;27;34;25758.0;32426.46;58184.46
510455;201805;127;81;46;77254.92;43884.0;121138.92
510460;201805;186;100;86;95219.92;82006.38;177226.3
510480;201805;753;432;321;411001.8;305905.38;716907.2
510490;201805;362;185;177;176120.34;168353.08;344473.4
510500;201805;255;194;61;185066.45;58194.0;243260.45
510510;201805;797;457;340;435377.72;324350.47;759728.2
510515;201805;1149;615;534;586341.4;509389.38;1095730.8
510517;201805;247;106;141;100837.8;134490.69;235328.48
510520;201805;238;155;83;147776.77;78862.3;226639.06
510523;201805;93;66;27;62964.0;25748.46;88712.46
510525;201805;730;412;318;392293.84;303270.3;695564.1
510530;201805;15;11;4;10494.0;3816.0;14310.0
510550;201805;271;118;153;112563.0;145953.0;258516.0
510558;201805;274;136;138;129711.15;131623.92;261335.06
510560;201805;395;243;152;231536.0;144990.0;376526.0
510562;201805;640;448;192;426061.16;182681.45;608742.6
510590;201805;807;419;388;399678.84;370124.7;769803.5
510600;201805;258;142;116;135444.92;110626.92;246071.84
510610;201805;170;83;87;79162.92;82685.46;161848.38
510615;201805;195;80;115;76300.92;109710.0;186010.92
510617;201805;18;10;8;9540.0;7632.0;17172.0
510618;201805;116;54;62;51516.0;58671.0;110187.0
510619;201805;104;73;31;69633.0;29565.0;99198.0
510620;201805;184;102;82;97298.46;78228.0;175526.45
510621;201805;196;125;71;119231.46;67706.46;186937.92
510622;201805;452;290;162;276567.84;154224.38;430792.22
510623;201805;353;237;116;226041.84;110635.38;336677.22
510624;201805;88;43;45;41013.0;42930.0;83943.0
510625;201805;538;332;206;316518.3;195946.52;512464.8
510626;201805;108;69;39;65826.0;37206.0;103032.0
510627;201805;61;43;18;41022.0;17172.0;58194.0
510628;201805;164;100;64;95353.92;60998.76;156352.69
510629;201805;256;164;92;156456.0;86804.46;243260.45
510630;201805;466;237;229;226013.22;218119.95;444133.16
510631;201805;11;3;8;2862.0;7346.0;10208.0
510637;201805;343;193;150;183776.19;142962.84;326739.03
510642;201805;974;543;431;517680.2;411031.44;928711.6
510645;201805;0;0;0;0.0;0.0;0.0
510650;201805;1493;985;508;939545.94;484500.75;1424046.6
510665;201805;86;43;43;40966.0;41022.0;81988.0
510670;201805;66;37;29;35298.0;27666.0;62964.0
510675;201805;1178;708;470;674160.44;448357.22;1122517.6
510677;201805;359;175;184;165944.84;175406.22;341351.06
510680;201805;108;63;45;60084.0;42921.0;103005.0
510682;201805;203;97;106;92216.0;101124.0;193340.0
510685;201805;52;37;15;35298.0;14310.0;49608.0
510700;201805;624;362;262;345229.9;249814.77;595044.7
510704;201805;1076;582;494;552838.6;469700.38;1022539.0
510706;201805;129;64;65;61051.23;61972.92;123024.15
510710;201805;396;269;127;255636.23;121043.68;376679.9
510715;201805;65;47;18;44828.46;17172.0;62000.46
510718;201805;212;115;97;109616.76;92519.46;202136.22
510719;201805;35;19;16;18126.0;15264.0;33390.0
510720;201805;197;133;64;126873.0;60769.8;187642.8
510724;201805;90;37;53;35288.46;50529.38;85817.84
510726;201805;52;27;25;25748.46;23832.0;49580.46
510729;201805;74;34;40;32436.0;38121.84;70557.84
510730;201805;474;267;207;254700.0;197330.45;452030.47
510735;201805;108;42;66;40068.0;62964.0;103032.0
510740;201805;29;16;13;15264.0;12402.0;27666.0
510757;201805;20;16;4;15264.0;3816.0;19080.0
510760;201805;7060;3735;3325;3553640.8;3165815.2;6719456.0
510770;201805;718;342;376;326079.3;358509.3;684588.6
510774;201805;15;6;9;5724.0;8586.0;14310.0
510775;201805;113;85;28;81080.46;26702.46;107782.92
510776;201805;31;8;23;7632.0;21942.0;29574.0
510777;201805;184;81;103;77245.38;98233.38;175478.77
510779;201805;53;24;29;22887.0;27628.92;50515.92
510780;201805;290;162;128;154485.45;122047.0;276532.47
510785;201805;445;243;202;231765.3;192641.22;424406.53
510787;201805;192;98;94;93483.0;89658.23;183141.23
510788;201805;0;0;0;0.0;0.0;0.0
510790;201805;2425;1258;1167;1198260.4;1111245.6;2309506.0
510792;201805;1089;617;472;587835.5;449872.34;1037707.8
510794;201805;117;59;58;56286.0;55303.92;111589.92
510795;201805;2397;1387;1010;1316387.9;960876.8;2277264.8
510800;201805;187;113;74;107792.46;70587.0;178379.45
510805;201805;172;118;54;112572.0;51516.0;164088.0
510810;201805;96;39;57;37123.38;54253.98;91377.36
510820;201805;257;120;137;114053.46;129698.03;243751.48
510830;201805;65;40;25;38160.0;23841.0;62001.0
510835;201805;7;5;2;4770.0;1908.0;6678.0
510840;201805;9250;4575;4675;4349121.5;4452536.0;8801657.0
510850;201805;213;90;123;85850.46;117018.18;202868.64
510860;201805;384;168;216;160085.52;205383.34;365468.88
510880;201805;65;50;15;47681.46;14310.0;61991.46
510885;201805;71;43;28;41003.46;26683.38;67686.84
510890;201805;71;41;30;39114.0;28620.0;67734.0
510895;201805;185;107;78;102078.0;74103.46;176181.45
520005;201805;34;23;11;21942.0;10494.0;32436.0
520010;201805;273;122;151;116388.0;143959.0;260347.0
520013;201805;643;390;253;372032.0;241075.8;613107.8
520015;201805;51;37;14;35298.0;13356.0;48654.0
520017;201805;103;59;44;56000.0;41976.0;97976.0
520020;201805;26;13;13;12402.0;12402.0;24804.0
520025;201805;2013;1090;923;1038677.25;879102.4;1917779.6
520030;201805;791;408;383;388269.0;364761.9;753030.9
520050;201805;78;53;25;50562.0;23850.0;74412.0
520055;201805;44;30;14;28620.0;13356.0;41976.0
520060;201805;177;113;64;107802.0;61056.0;168858.0
520080;201805;600;422;178;402588.0;169812.0;572400.0
520082;201805;20;14;6;13356.0;5724.0;19080.0
520085;201805;101;73;28;69642.0;26712.0;96354.0
520090;201805;90;62;28;59148.0;26712.0;85860.0
520110;201805;9037;3924;5113;3738364.2;4874877.0;8613241.0
520120;201805;14;8;6;7431.66;5724.0;13155.66
520130;201805;761;532;229;507232.8;218171.0;725403.8
520140;201805;11745;6639;5106;6326630.0;4868762.0;1,12E+14
520145;201805;45;34;11;32436.0;10494.0;42930.0
520150;201805;191;149;42;142146.0;40068.0;182214.0
520160;201805;30;23;7;21942.0;6678.0;28620.0
520170;201805;234;145;89;138298.0;84869.0;223167.0
520180;201805;125;65;60;62010.0;57240.0;119250.0
520215;201805;218;134;84;127549.8;79849.8;207399.6
520235;201805;70;53;17;50562.0;16218.0;66780.0
520250;201805;131;79;52;75366.0;49321.8;124687.8
520260;201805;111;68;43;64872.0;40068.0;104940.0
520280;201805;47;33;14;30815.0;13356.0;44171.0
520310;201805;38;26;12;24804.0;11448.0;36252.0
520320;201805;165;105;60;100160.46;57240.0;157400.45
520330;201805;782;410;372;391094.47;354861.0;745955.44
520340;201805;349;197;152;187111.2;144989.45;332100.66
520350;201805;523;238;285;227052.0;271843.0;498895.0
520355;201805;86;50;36;47700.0;34344.0;82044.0
520357;201805;25;18;7;17172.0;6678.0;23850.0
520360;201805;0;0;0;0.0;0.0;0.0
520380;201805;140;72;68;68688.0;64872.0;133560.0
520390;201805;283;118;165;112095.0;157147.5;269242.5
520393;201805;13;10;3;9540.0;2862.0;12402.0
520396;201805;99;59;40;56286.0;38160.0;94446.0
520400;201805;222;130;92;122399.2;87768.0;210167.2
520410;201805;202;103;99;98253.0;94437.0;192690.0
520420;201805;22;15;7;14310.0;6678.0;20988.0
520425;201805;298;129;169;122113.0;160750.2;282863.2
520430;201805;461;239;222;227719.8;211732.0;439451.8
520440;201805;612;414;198;394956.0;188872.92;583828.94
520450;201805;1919;864;1055;823427.44;1005824.0;1829251.5
520455;201805;58;41;17;39114.0;16218.0;55332.0
520460;201805;30;15;15;14310.0;14310.0;28620.0
520465;201805;24;20;4;19080.0;3816.0;22896.0
520470;201805;416;255;161;242964.62;153594.0;396558.62
520480;201805;80;46;34;43884.0;32391.0;76275.0
520485;201805;126;43;83;41022.0;78896.0;119918.0
520490;201805;406;294;112;280291.97;106848.0;387139.97
520495;201805;173;106;67;101124.0;63918.0;165042.0
520500;201805;173;130;43;124020.0;41022.0;165042.0
520505;201805;177;92;85;87763.23;81090.0;168853.23
520510;201805;1777;878;899;834285.75;855483.2;1689768.9
520520;201805;35;27;8;25758.0;7632.0;33390.0
520530;201805;228;170;58;160456.12;55322.46;215778.58
520540;201805;532;357;175;339271.03;166950.0;506221.03
520545;201805;159;89;70;84906.0;66780.0;151686.0
520547;201805;54;30;24;28620.0;22896.0;51516.0
520549;201805;1129;551;578;525330.0;551294.0;1076624.0
520551;201805;293;150;143;143100.0;136135.8;279235.8
520552;201805;45;26;19;24804.0;18126.0;42930.0
520570;201805;16;9;7;8586.0;6678.0;15264.0
520580;201805;284;171;113;163124.45;107802.0;270926.47
520590;201805;162;98;64;93492.0;60769.8;154261.8
520620;201805;1169;545;624;519072.47;594714.25;1113786.8
520630;201805;44;26;18;24804.0;17172.0;41976.0
520640;201805;413;234;179;223236.0;170766.0;394002.0
520650;201805;57;40;17;38160.0;16218.0;54378.0
520660;201805;36;19;17;18117.0;16218.0;34335.0
520670;201805;34;29;5;27666.0;4770.0;32436.0
520680;201805;57;37;20;35298.0;19080.0;54378.0
520690;201805;33;10;23;9540.0;21913.92;31453.92
520710;201805;40;36;4;34344.0;3816.0;38160.0
520725;201805;197;125;72;119250.0;68688.0;187938.0
520735;201805;60;42;18;40068.0;17172.0;57240.0
520740;201805;405;200;205;190085.4;195561.0;385646.4
520750;201805;37;27;10;25758.0;9540.0;35298.0
520753;201805;55;37;18;35298.0;17172.0;52470.0
520760;201805;112;76;36;72504.0;34344.0;106848.0
520780;201805;290;219;71;208926.0;67734.0;276660.0
520790;201805;165;83;82;78895.8;78228.0;157123.8
520800;201805;3459;1843;1616;1755539.0;1540986.9;3296526.0
520810;201805;169;122;47;116388.0;44838.0;161226.0
520815;201805;5;5;0;4770.0;0.0;4770.0
520830;201805;139;91;48;86814.0;45505.8;132319.8
520840;201805;350;230;120;218943.0;114480.0;333423.0
520850;201805;110;70;40;66771.0;38007.36;104778.36
520860;201805;1684;1072;612;1021267.56;582704.2;1603971.8
520870;201805;30828;15190;15638;1,45E+14;1,49E+14;2,94E+14
520880;201805;1070;587;483;559998.0;460762.9;1020760.94
520890;201805;794;460;334;437209.4;318531.47;755740.9
520910;201805;1029;544;485;515399.75;462690.0;978089.75
520915;201805;100;75;25;71550.0;23840.46;95390.46
520920;201805;405;195;210;185457.6;200330.45;385788.06
520929;201805;16;15;1;14310.0;954.0;15264.0
520940;201805;73;46;27;43884.0;25758.0;69642.0
520945;201805;21;13;8;12402.0;7632.0;20034.0
520960;201805;45;29;16;27666.0;15264.0;42930.0
520970;201805;326;204;122;193987.0;116101.8;310088.8
520980;201805;86;64;22;61056.0;20988.0;82044.0
520990;201805;478;323;155;308142.0;147870.0;456012.0
520993;201805;127;61;66;58194.0;62964.0;121158.0
520995;201805;242;135;107;127837.0;101506.0;229343.0
521000;201805;1569;916;653;871861.4;622581.0;1494442.4
521010;201805;675;314;361;299229.38;344328.3;643557.7
521015;201805;17;10;7;9540.0;6678.0;16218.0
521020;201805;1466;1021;445;973404.9;424159.22;1397564.1
521030;201805;47;33;14;31482.0;13356.0;44838.0
521040;201805;943;577;366;550220.2;348878.0;899098.2
521056;201805;41;29;12;27666.0;11448.0;39114.0
521060;201805;134;84;50;80136.0;47700.0;127836.0
521080;201805;465;348;117;331983.0;111618.0;443601.0
521090;201805;533;322;211;305626.12;201294.0;506920.12
521100;201805;282;210;72;200331.0;68688.0;269019.0
521120;201805;1055;728;327;692985.8;311663.0;1004648.8
521130;201805;365;261;104;248984.45;98330.6;347315.06
521140;201805;187;107;80;102078.0;76320.0;178398.0
521150;201805;2797;1209;1588;1152376.9;1513393.5;2665770.2
521160;201805;33;16;17;15264.0;16218.0;31482.0
521170;201805;192;113;79;107792.46;75366.0;183158.45
521180;201805;1134;719;415;684295.25;395195.2;1079490.5
521190;201805;2538;1076;1462;1026484.94;1393870.8;2420355.8
521200;201805;47;34;13;32436.0;12402.0;44838.0
521205;201805;13;9;4;8586.0;3816.0;12402.0
521210;201805;147;84;63;80136.0;60102.0;140238.0
521220;201805;820;561;259;532561.75;247030.0;779591.75
521225;201805;31;20;11;19080.0;10494.0;29574.0
521230;201805;110;72;38;68401.8;36252.0;104653.8
521250;201805;6224;3579;2645;3406906.0;2520737.2;5927643.5
521260;201805;22;14;8;13356.0;7632.0;20988.0
521270;201805;143;111;32;105894.0;30528.0;136422.0
521280;201805;437;260;177;247372.2;168858.0;416230.2
521290;201805;31;12;19;11448.0;18126.0;29574.0
521295;201805;98;66;32;62735.04;30528.0;93263.04
521300;201805;231;119;112;113508.0;106488.38;219996.38
521305;201805;35;23;12;21942.0;11448.0;33390.0
521308;201805;1076;786;290;749345.1;276365.0;1025710.1
521310;201805;1351;799;552;760961.4;525416.94;1286378.4
521340;201805;18;15;3;14310.0;2862.0;17172.0
521350;201805;131;96;35;91584.0;33390.0;124974.0
521370;201805;189;122;67;115815.6;63631.8;179447.4
521375;201805;190;107;83;102078.0;78895.8;180973.8
521377;201805;52;35;17;33390.0;16218.0;49608.0
521380;201805;1096;717;379;679870.25;361566.0;1041436.25
521385;201805;15;8;7;7632.0;6678.0;14310.0
521390;201805;106;85;21;80772.04;20034.0;100806.04
521400;201805;322;206;116;196237.8;110616.3;306854.1
521405;201805;148;77;71;73458.0;67734.0;141192.0
521410;201805;63;42;21;40068.0;20034.0;60102.0
521440;201805;206;146;60;138473.1;57240.0;195713.1
521450;201805;716;394;322;375876.0;307188.0;683064.0
521460;201805;1191;733;458;698995.8;436912.9;1135908.8
521470;201805;14;9;5;8586.0;4770.0;13356.0
521480;201805;47;32;15;30501.0;14245.0;44746.0
521483;201805;313;169;144;160940.0;137376.0;298316.0
521486;201805;285;182;103;172836.19;97595.0;270431.2
521487;201805;21;10;11;9540.0;10494.0;20034.0
521490;201805;27;16;11;15264.0;10494.0;25758.0
521500;201805;119;77;42;73458.0;40068.0;113526.0
521520;201805;41;30;11;28620.0;10494.0;39114.0
521523;201805;614;376;238;355387.3;227052.0;582439.3
521525;201805;45;30;15;28620.0;14023.8;42643.8
521530;201805;249;132;117;125928.0;111618.0;237546.0
521540;201805;30;16;14;15264.0;13356.0;28620.0
521550;201805;92;44;48;41661.92;45736.92;87398.84
521560;201805;805;551;254;525368.0;242173.0;767541.0
521565;201805;53;36;17;34344.0;16218.0;50562.0
521570;201805;496;331;165;315764.47;157315.3;473079.75
521580;201805;60;37;23;35298.0;21942.0;57240.0
521590;201805;37;20;17;19080.0;16218.0;35298.0
521600;201805;28;16;12;15264.0;11448.0;26712.0
521630;201805;239;121;118;115424.46;111581.96;227006.42
521640;201805;298;152;146;145008.0;139284.0;284292.0
521645;201805;30;16;14;15264.0;13356.0;28620.0
521680;201805;222;141;81;134514.0;77274.0;211788.0
521690;201805;2;2;0;1908.0;0.0;1908.0
521710;201805;1194;560;634;533667.8;604827.0;1138494.8
521720;201805;543;368;175;351062.47;166912.45;517974.9
521730;201805;632;307;325;292878.0;308943.56;601821.56
521740;201805;922;373;549;356238.9;522555.3;878794.25
521760;201805;1605;875;730;833172.6;696106.0;1529278.6
521770;201805;803;514;289;490356.0;275238.53;765594.56
521800;201805;2069;1292;777;1229025.5;739593.9;1968619.4
521805;201805;34;19;15;18126.0;14310.0;32436.0
521810;201805;92;58;34;54187.8;32436.0;86623.8
521830;201805;961;681;280;646843.44;267111.0;913954.44
521839;201805;93;62;31;59148.0;29574.0;88722.0
521850;201805;1124;597;527;568118.94;502433.7;1070552.6
521860;201805;342;208;134;198432.0;127550.0;325982.0
521870;201805;73;42;31;40068.0;29574.0;69642.0
521878;201805;42;20;22;19080.0;20988.0;40068.0
521880;201805;4554;2056;2498;1959133.4;2381473.8;4340607.0
521890;201805;587;413;174;394002.0;165709.8;559711.8
521900;201805;292;235;57;223553.95;54378.0;277931.97
521910;201805;151;105;46;100170.0;43884.0;144054.0
521920;201805;56;28;28;26712.0;26712.0;53424.0
521925;201805;36;21;15;20034.0;14310.0;34344.0
521930;201805;1131;644;487;614180.0;463668.7;1077848.6
521935;201805;34;26;8;24804.0;7632.0;32436.0
521940;201805;191;96;95;91584.0;90625.23;182209.23
521945;201805;14;12;2;11448.0;1908.0;13356.0
521950;201805;9;5;4;4770.0;3816.0;8586.0
521960;201805;74;55;19;52470.0;18126.0;70596.0
521970;201805;421;271;150;258247.8;143100.0;401347.8
521971;201805;96;49;47;46746.0;44838.0;91584.0
521973;201805;28;13;15;12402.0;14310.0;26712.0
521975;201805;1139;584;555;555706.0;528554.7;1084260.6
521980;201805;242;167;75;159318.0;71550.0;230868.0
521990;201805;74;54;20;51516.0;19080.0;70596.0
522000;201805;285;179;106;170766.0;101124.0;271890.0
522005;201805;21;13;8;12402.0;7632.0;20034.0
522010;201805;1137;637;500;607689.0;476427.6;1084116.6
522015;201805;54;33;21;31473.0;20034.0;51507.0
522020;201805;855;461;394;438840.2;375094.12;813934.3
522026;201805;30;22;8;20988.0;7632.0;28620.0
522028;201805;16;12;4;11448.0;3816.0;15264.0
522040;201805;744;295;449;281412.0;428291.47;709703.44
522045;201805;2116;1335;781;1272554.2;744540.8;2017095.0
522050;201805;168;82;86;78228.0;82044.0;160272.0
522060;201805;556;350;206;333613.8;196428.6;530042.4
522068;201805;135;89;46;84619.8;43884.0;128503.8
522070;201805;11;11;0;10494.0;0.0;10494.0
522100;201805;47;26;21;24536.88;20034.0;44570.88
522108;201805;38;29;9;27666.0;8586.0;36252.0
522119;201805;55;29;26;27666.0;24804.0;52470.0
522130;201805;76;29;47;27657.0;44820.0;72477.0
522140;201805;3738;1891;1847;1799527.2;1759883.5;3559410.8
522145;201805;51;31;20;29574.0;19080.0;48654.0
522150;201805;65;51;14;48654.0;13356.0;62010.0
522155;201805;60;40;20;38151.0;19080.0;57231.0
522157;201805;4;3;1;2862.0;954.0;3816.0
522160;201805;1728;1010;718;962109.0;684676.8;1646785.8
522170;201805;393;264;129;251856.0;123066.0;374922.0
522180;201805;36;20;16;19080.0;15264.0;34344.0
522185;201805;1935;750;1185;712193.25;1129969.0;1842162.2
522190;201805;48;27;21;25758.0;19938.6;45696.6
522200;201805;297;178;119;169812.0;113526.0;283338.0
522205;201805;165;112;53;106848.0;50562.0;157410.0
522220;201805;161;115;46;109710.0;43884.0;153594.0
522230;201805;29;23;6;21942.0;5724.0;27666.0
530010;201805;55575;28511;27064;2,71E+13;2,58E+14;5,28E+14
110001;201806;520;411;109;391110.34;103340.96;494451.3
110002;201806;2779;1681;1098;1602405.9;1046594.5;2649000.2
110003;201806;95;75;20;71550.0;19080.0;90630.0
110004;201806;2016;1297;719;1234437.0;685630.25;1920067.2
110005;201806;442;355;87;337514.9;82998.0;420512.9
110006;201806;449;346;103;329797.8;98242.92;428040.72
110007;201806;82;65;17;62010.0;16218.0;78228.0
110008;201806;241;135;106;127554.9;101124.0;228678.9
110009;201806;799;546;253;518976.88;241163.0;760139.9
110010;201806;1812;1119;693;1066390.5;660980.5;1727371.0
110011;201806;1877;1446;431;1377973.2;411144.34;1789117.5
110012;201806;4112;2382;1730;2266907.0;1649168.6;3916075.5
110013;201806;757;579;178;552356.44;169812.0;722168.44
110014;201806;373;319;54;304305.88;51516.0;355821.88
110015;201806;1434;1159;275;1103118.0;261758.52;1364876.6
110018;201806;1118;668;450;636958.0;429287.22;1066245.2
110020;201806;15375;9018;6357;8556980.0;6053443.5;1,46E+14
110025;201806;652;482;170;457830.12;162171.0;620001.1
110026;201806;41;28;13;26712.0;12402.0;39114.0
110028;201806;1652;1196;456;1136382.6;431430.94;1567813.5
110029;201806;141;125;16;119250.0;15264.0;134514.0
110030;201806;2486;1676;810;1596018.2;771839.44;2367857.8
110032;201806;387;300;87;285891.0;82994.0;368885.0
110033;201806;679;507;172;480654.0;163797.8;644451.8
110034;201806;367;268;99;253360.0;93779.0;347139.0
110037;201806;103;86;17;82044.0;16218.0;98262.0
110040;201806;341;232;109;221328.0;103986.0;325314.0
110045;201806;949;642;307;610922.0;291174.38;902096.4
110050;201806;97;80;17;76320.0;16218.0;92538.0
110060;201806;86;46;40;43884.0;38160.0;82044.0
110070;201806;122;73;49;69642.0;46460.0;116102.0
110080;201806;408;247;161;233415.19;153550.05;386965.22
110090;201806;33;27;6;25758.0;5724.0;31482.0
110092;201806;110;61;49;58194.0;46676.0;104870.0
110094;201806;197;142;55;135468.0;52470.0;187938.0
110100;201806;28;23;5;21942.0;4770.0;26712.0
110110;201806;68;41;27;39114.0;25758.0;64872.0
110120;201806;73;60;13;57240.0;12402.0;69642.0
110130;201806;298;241;57;228439.12;54378.0;282817.12
110140;201806;243;159;84;151495.2;80126.46;231621.66
110143;201806;51;43;8;41022.0;7632.0;48654.0
110145;201806;27;20;7;19080.0;6678.0;25758.0
110146;201806;24;12;12;11448.0;11448.0;22896.0
110147;201806;38;30;8;28620.0;7632.0;36252.0
110148;201806;39;27;12;25706.57;11448.0;37154.57
110149;201806;296;213;83;202915.8;79182.0;282097.8
110150;201806;84;58;26;55332.0;24804.0;80136.0
110155;201806;8;7;1;6678.0;954.0;7632.0
110160;201806;69;58;11;55332.0;10494.0;65826.0
110170;201806;203;166;37;158364.0;35298.0;193662.0
110175;201806;42;31;11;29574.0;10494.0;40068.0
110180;201806;92;80;12;76320.0;11448.0;87768.0
120001;201806;137;94;43;89634.0;40993.0;130627.0
120005;201806;192;120;72;114437.12;68688.0;183125.12
120010;201806;1038;666;372;627931.56;352698.9;980630.5
120013;201806;146;102;44;96600.06;41632.04;138232.1
120017;201806;92;57;35;54269.48;33347.12;87616.6
120020;201806;3539;2823;716;2666541.5;680608.56;3347150.0
120025;201806;588;333;255;315165.22;242188.6;557353.8
120030;201806;1035;866;169;818092.44;160468.12;978560.56
120032;201806;49;41;8;39114.0;7632.0;46746.0
120033;201806;213;186;27;177096.75;25758.0;202854.75
120034;201806;156;112;44;104918.12;41932.24;146850.36
120035;201806;29;21;8;20034.0;7632.0;27666.0
120038;201806;390;251;139;238608.0;132562.23;371170.25
120039;201806;22;21;1;20034.0;954.0;20988.0
120040;201806;14076;9768;4308;9182205.0;4071629.5;1,33E+14
120042;201806;44;38;6;36252.0;5724.0;41976.0
120043;201806;12;3;9;2862.0;8586.0;11448.0
120045;201806;541;350;191;331797.5;181948.6;513746.1
120050;201806;1266;963;303;911305.9;288971.47;1200277.4
120060;201806;1419;1152;267;1094215.4;253632.72;1347848.0
120070;201806;501;357;144;335292.56;136054.66;471347.22
120080;201806;168;106;62;99894.42;58537.54;158431.95
130002;201806;150;105;45;100170.0;42930.0;143100.0
130006;201806;73;41;32;39114.0;30528.0;69642.0
130008;201806;143;78;65;73691.72;61331.72;135023.44
130010;201806;139;75;64;71528.12;61056.0;132584.12
130014;201806;243;176;67;167904.0;63918.0;231822.0
130020;201806;93;49;44;46746.0;41976.0;88722.0
130030;201806;898;549;349;523746.0;332936.47;856682.44
130040;201806;324;163;161;155502.0;152640.28;308142.28
130050;201806;562;307;255;292591.8;243270.0;535861.8
130060;201806;878;600;278;567294.06;262478.75;829772.8
130063;201806;578;322;256;306868.8;244158.36;551027.2
130068;201806;186;122;64;116388.0;60769.8;177157.8
130070;201806;1323;918;405;862340.25;381471.75;1243812.0
130080;201806;665;437;228;416516.4;217503.0;634019.4
130083;201806;71;38;33;35988.0;31482.0;67470.0
130090;201806;372;192;180;181488.95;171720.0;353208.97
130100;201806;1114;512;602;488448.0;574021.8;1062469.8
130110;201806;700;311;389;296544.0;371106.0;667650.0
130115;201806;175;71;104;67734.0;99216.0;166950.0
130120;201806;1631;1018;613;971172.0;584802.0;1555974.0
130130;201806;633;435;198;414990.0;188892.0;603882.0
130140;201806;1510;1137;373;1084035.0;354888.2;1438923.2
130150;201806;420;356;64;339602.12;61056.0;400658.12
130160;201806;467;263;204;250902.0;194616.0;445518.0
130165;201806;27;20;7;19080.0;6678.0;25758.0
130170;201806;929;660;269;629569.4;256626.0;886195.4
130180;201806;149;91;58;86814.0;55332.0;142146.0
130185;201806;2299;1207;1092;1149549.9;1041176.94;2190726.8
130190;201806;3624;2262;1362;2152480.5;1298046.0;3450526.5
130195;201806;291;233;58;222282.0;55332.0;277614.0
130200;201806;175;81;94;77264.46;89676.0;166940.45
130210;201806;78;40;38;38160.0;36252.0;74412.0
130220;201806;184;127;57;121158.0;54378.0;175536.0
130230;201806;332;209;123;199386.0;117342.0;316728.0
130240;201806;1443;913;530;869662.4;505042.84;1374705.2
130250;201806;4751;3074;1677;2926628.2;1599724.6;4526353.0
130255;201806;424;208;216;198432.0;205777.8;404209.8
130260;201806;53872;25862;28010;2,46E+14;2,67E+13;5,14E+14
130270;201806;1511;976;535;930627.0;510390.0;1441017.0
130280;201806;113;69;44;65826.0;41976.0;107802.0
130290;201806;2095;1519;576;1449126.0;549217.8;1998343.8
130300;201806;432;307;125;292591.8;119250.0;411841.8
130310;201806;879;459;420;437886.0;400680.0;838566.0
130320;201806;452;237;215;225144.0;205110.0;430254.0
130330;201806;699;421;278;401634.0;264925.8;666559.8
130340;201806;3301;1969;1332;1873937.5;1269297.2;3143234.8
130350;201806;468;301;167;287132.12;159318.0;446450.12
130353;201806;807;332;475;316442.0;453150.0;769592.0
130356;201806;791;360;431;343440.0;410887.8;754327.8
130360;201806;68;41;27;39114.0;25758.0;64872.0
130370;201806;679;505;174;481770.0;165996.0;647766.0
130380;201806;611;422;189;402588.0;180306.0;582894.0
130390;201806;490;388;102;370152.0;97308.0;467460.0
130395;201806;181;40;141;38160.0;134514.0;172674.0
130400;201806;71;46;25;43884.0;23850.0;67734.0
130406;201806;2075;1299;776;1235632.2;739093.75;1974726.0
130410;201806;502;214;288;204156.0;274732.9;478888.9
130420;201806;3186;2566;620;2444177.2;591480.0;3035657.2
130423;201806;158;75;83;71550.0;79182.0;150732.0
130426;201806;145;86;59;82044.0;56286.0;138330.0
130430;201806;407;270;137;257580.0;130698.0;388278.0
130440;201806;202;69;133;65826.0;126882.0;192708.0
140002;201806;36;14;22;13356.0;20988.0;34344.0
140005;201806;207;126;81;119965.5;77274.0;197239.5
140010;201806;10285;6936;3349;6580011.0;3192624.8;9772636.0
140015;201806;153;67;86;63918.0;82044.0;145962.0
140017;201806;116;79;37;75366.0;35298.0;110664.0
140020;201806;482;320;162;304326.0;154548.0;458874.0
140023;201806;31;18;13;16953.0;12402.0;29355.0
140028;201806;17;12;5;11448.0;4770.0;16218.0
140030;201806;353;252;101;240408.0;96354.0;336762.0
140040;201806;54;38;16;36252.0;15168.6;51420.6
140045;201806;247;114;133;108088.2;126882.0;234970.2
140047;201806;582;403;179;382450.38;170003.0;552453.4
140050;201806;148;97;51;91725.0;48654.0;140379.0
140060;201806;36;25;11;23115.42;10494.0;33609.42
140070;201806;32;29;3;27666.0;2862.0;30528.0
150010;201806;4718;2929;1789;2792358.5;1704206.2;4496564.5
150013;201806;150;105;45;100170.0;42930.0;143100.0
150020;201806;1062;570;492;543780.0;469368.0;1013148.0
150030;201806;720;295;425;281430.0;405450.0;686880.0
150034;201806;195;123;72;117342.0;68688.0;186030.0
150040;201806;1398;839;559;800406.0;533286.0;1333692.0
150050;201806;694;413;281;393000.8;267874.0;660874.8
150060;201806;4739;3070;1669;2924831.2;1591978.5;4516810.0
150070;201806;311;146;165;139284.0;157410.0;296694.0
150080;201806;14421;7261;7160;6916223.0;6823322.0;1,37E+14
150085;201806;385;240;145;228950.45;138330.0;367280.47
150090;201806;760;647;113;617238.0;107802.0;725040.0
150095;201806;346;214;132;203386.12;125107.56;328493.7
150100;201806;57;39;18;37206.0;17172.0;54378.0
150110;201806;172;82;90;78228.0;85860.0;164088.0
150120;201806;432;320;112;305280.0;106848.0;412128.0
150125;201806;54;23;31;21942.0;29574.0;51516.0
150130;201806;1901;1020;881;973080.0;840469.25;1813549.2
150140;201806;54303;25381;28922;2,42E+14;2,76E+14;5,18E+14
150145;201806;179;104;75;99216.0;71550.0;170766.0
150150;201806;2830;1292;1538;1232350.5;1463832.2;2696182.8
150157;201806;435;303;132;289062.0;125923.23;414985.22
150160;201806;121;97;24;92538.0;22896.0;115434.0
150170;201806;3652;2707;945;2581285.5;901243.8;3482529.2
150172;201806;323;220;103;209880.0;98262.0;308142.0
150175;201806;86;52;34;49608.0;32436.0;82044.0
150178;201806;763;514;249;489402.0;237546.0;726948.0
150180;201806;3066;1483;1583;1413971.6;1509581.1;2923552.8
150190;201806;331;212;119;202248.0;113526.0;315774.0
150195;201806;122;61;61;58194.0;58194.0;116388.0
150200;201806;201;96;105;91584.0;100170.0;191754.0
150210;201806;3169;2567;602;2447859.8;573302.5;3021162.2
150215;201806;512;331;181;315774.0;172388.0;488162.0
150220;201806;3859;2616;1243;2494104.8;1183704.4;3677809.0
150230;201806;1141;921;220;878054.06;209880.0;1087934.0
150240;201806;5792;3419;2373;3258570.8;2263611.0;5522181.5
150250;201806;34;16;18;15264.0;17172.0;32436.0
150260;201806;75;45;30;42930.0;28620.0;71550.0
150270;201806;2341;1531;810;1459568.4;771881.8;2231450.0
150275;201806;572;348;224;331992.0;213696.0;545688.0
150276;201806;111;49;62;46746.0;59148.0;105894.0
150277;201806;766;326;440;310985.47;419760.0;730745.44
150280;201806;339;209;130;199386.0;124020.0;323406.0
150285;201806;73;36;37;34344.0;35298.0;69642.0
150290;201806;971;595;376;567334.25;358418.0;925752.25
150293;201806;670;312;358;297448.47;341532.0;638980.44
150295;201806;473;215;258;205110.0;245979.44;451089.44
150300;201806;79;41;38;39114.0;36252.0;75366.0
150304;201806;147;100;47;95400.0;44838.0;140238.0
150307;201806;396;324;72;309096.0;68688.0;377784.0
150309;201806;561;410;151;391140.0;144054.0;535194.0
150310;201806;258;174;84;165996.0;80136.0;246132.0
150320;201806;1799;1246;553;1188402.6;527323.5;1715726.1
150330;201806;2068;1195;873;1139362.2;832842.0;1972204.2
150340;201806;202;136;66;129505.5;62964.0;192469.5
150345;201806;607;327;280;311776.75;267120.0;578896.75
150350;201806;412;322;90;304793.47;85860.0;390653.47
150360;201806;4562;2932;1630;2793537.5;1555010.5;4348548.0
150370;201806;759;538;221;512456.0;210538.8;722994.8
150375;201806;195;102;93;97308.0;88722.0;186030.0
150380;201806;1353;909;444;867186.0;423551.0;1290737.0
150390;201806;736;420;316;400676.0;301464.0;702140.0
150400;201806;102;85;17;81090.0;16218.0;97308.0
150405;201806;1242;822;420;782916.5;400107.6;1183024.1
150410;201806;136;89;47;84906.0;44838.0;129744.0
150420;201806;7422;4076;3346;3887041.2;3190412.2;7077453.5
150430;201806;503;339;164;323406.0;156456.0;479862.0
150440;201806;583;347;236;330275.0;225144.0;555419.0
150442;201806;2184;1179;1005;1121513.0;958479.0;2079992.0
150445;201806;518;329;189;313866.0;179352.0;493218.0
150450;201806;261;126;135;120204.0;128790.0;248994.0
150460;201806;762;577;185;548631.06;176470.92;725102.0
150470;201806;1333;807;526;768351.8;501804.0;1270155.8
150475;201806;42;32;10;30528.0;9540.0;40068.0
150480;201806;1252;872;380;831888.0;362233.8;1194121.8
150490;201806;607;333;274;317682.0;261396.0;579078.0
150495;201806;329;234;95;223236.0;90630.0;313866.0
150497;201806;299;204;95;194616.0;90620.46;285236.47
150500;201806;426;289;137;275706.0;130698.0;406404.0
150503;201806;901;441;460;420428.0;438822.0;859250.0
150506;201806;1021;671;350;640134.0;333890.47;974024.44
150510;201806;1230;694;536;661790.0;511344.0;1173134.0
150520;201806;272;182;90;173628.0;85860.0;259488.0
150530;201806;1578;858;720;815384.3;686880.0;1502264.2
150540;201806;239;167;72;159318.0;68688.0;228006.0
150543;201806;730;415;315;395318.53;300223.8;695542.3
150548;201806;496;346;150;330084.0;143100.0;473184.0
150549;201806;61;44;17;41976.0;16218.0;58194.0
150550;201806;2879;1517;1362;1446265.0;1299062.0;2745327.0
150553;201806;3122;1840;1282;1754501.8;1223018.5;2977520.2
150555;201806;144;77;67;73458.0;63918.0;137376.0
150560;201806;55;42;13;40068.0;12402.0;52470.0
150563;201806;74;40;34;38160.0;32436.0;70596.0
150565;201806;170;102;68;97308.0;64872.0;162180.0
150570;201806;402;266;136;253744.92;129744.0;383488.9
150580;201806;1532;658;874;627089.5;833796.0;1460885.5
150590;201806;787;485;302;462690.0;288108.0;750798.0
150600;201806;465;279;186;266166.0;177444.0;443610.0
150610;201806;144;123;21;116493.0;20034.0;136527.0
150611;201806;130;91;39;86814.0;37206.0;124020.0
150613;201806;3228;1983;1245;1891782.0;1187721.0;3079503.0
150616;201806;492;299;193;285008.0;184122.0;469130.0
150618;201806;1189;641;548;611285.56;522792.0;1134077.6
150619;201806;398;305;93;290970.0;88722.0;379692.0
150620;201806;1278;741;537;706914.0;512011.8;1218925.8
150630;201806;302;202;100;192708.0;95400.0;288108.0
150635;201806;485;201;284;191754.0;270936.0;462690.0
150640;201806;61;28;33;26712.0;31482.0;58194.0
150650;201806;2330;1384;946;1320012.4;902193.8;2222206.2
150655;201806;245;182;63;173628.0;60102.0;233730.0
150658;201806;107;61;46;58194.0;43884.0;102078.0
150660;201806;489;344;145;328176.0;138330.0;466506.0
150670;201806;1013;372;641;354592.8;611495.44;966088.25
150680;201806;9896;5422;4474;5165417.0;4266094.5;9431511.0
150690;201806;51;32;19;30528.0;18126.0;48654.0
150700;201806;531;342;189;326077.2;180306.0;506383.2
150710;201806;277;164;113;156456.0;107802.0;264258.0
150715;201806;861;522;339;497005.9;323377.38;820383.3
150720;201806;431;333;98;317682.0;93205.8;410887.8
150730;201806;939;503;436;479853.0;415657.8;895510.8
150740;201806;228;161;67;153594.0;63918.0;217512.0
150745;201806;783;429;354;409266.0;337716.0;746982.0
150746;201806;56;34;22;32436.0;20988.0;53424.0
150747;201806;258;204;54;194616.0;51516.0;246132.0
150750;201806;132;76;56;72504.0;53424.0;125928.0
150760;201806;1730;1129;601;1077066.0;573354.0;1650420.0
150770;201806;369;192;177;183168.0;168682.95;351850.94
150775;201806;96;44;52;41976.0;49608.0;91584.0
150780;201806;191;101;90;96354.0;85860.0;182214.0
150790;201806;874;475;399;453150.0;380646.0;833796.0
150795;201806;1460;851;609;811854.0;580986.0;1392840.0
150796;201806;388;224;164;213696.0;156456.0;370152.0
150797;201806;285;163;122;155502.0;116388.0;271890.0
150800;201806;1412;856;556;815665.25;530424.0;1346089.2
150803;201806;592;490;102;467460.0;97308.0;564768.0
150805;201806;188;121;67;115434.0;63904.46;179338.45
150808;201806;992;546;446;520884.0;425484.0;946368.0
150810;201806;3396;2359;1037;2247085.5;988439.8;3235525.2
150812;201806;425;225;200;214650.0;190800.0;405450.0
150815;201806;964;635;329;604411.5;313866.0;918277.5
150820;201806;1573;963;610;917748.0;581920.94;1499668.9
150830;201806;827;581;246;553320.0;234684.0;788004.0
150835;201806;187;111;76;105894.0;72504.0;178398.0
150840;201806;1345;860;485;820440.0;462690.0;1283130.0
160005;201806;52;30;22;28620.0;20988.0;49608.0
160010;201806;196;125;71;119250.0;67730.0;186980.0
160015;201806;117;67;50;63918.0;47700.0;111618.0
160020;201806;126;71;55;67734.0;52470.0;120204.0
160021;201806;43;23;20;21942.0;19080.0;41022.0
160023;201806;114;68;46;64872.0;43884.0;108756.0
160025;201806;31;14;17;13356.0;16218.0;29574.0
160027;201806;1478;836;642;794777.9;611714.0;1406491.9
160030;201806;15531;7989;7542;7613701.0;7190043.0;1,48E+14
160040;201806;314;181;133;172674.0;126882.0;299556.0
160050;201806;679;342;337;326268.0;321498.0;647766.0
160053;201806;323;186;137;177158.0;130698.0;307856.0
160055;201806;26;19;7;18126.0;6678.0;24804.0
160060;201806;6459;3410;3049;3243312.5;2907788.2;6151101.0
160070;201806;166;103;63;98262.0;60102.0;158364.0
160080;201806;80;43;37;41022.0;35298.0;76320.0
170025;201806;24;15;9;14310.0;8586.0;22896.0
170030;201806;229;187;42;178201.0;40068.0;218269.0
170035;201806;225;107;118;102078.0;112572.0;214650.0
170040;201806;185;142;43;135181.8;41022.0;176203.8
170070;201806;322;193;129;184122.0;123066.0;307188.0
170100;201806;369;267;102;254718.0;97308.0;352026.0
170105;201806;62;51;11;48654.0;10494.0;59148.0
170110;201806;102;63;39;60102.0;37206.0;97308.0
170130;201806;67;32;35;30528.0;33104.0;63632.0
170190;201806;100;65;35;62010.0;33390.0;95400.0
170200;201806;392;262;130;249271.2;123915.76;373186.97
170210;201806;5993;3143;2850;2990612.8;2715629.8;5706242.5
170215;201806;99;46;53;43884.0;50562.0;94446.0
170220;201806;1415;1044;371;994735.8;353648.0;1348383.8
170230;201806;154;101;53;96354.0;50562.0;146916.0
170240;201806;542;359;183;342486.0;174582.0;517068.0
170255;201806;1105;886;219;845034.1;208639.8;1053673.9
170270;201806;38;28;10;26712.0;9349.2;36061.2
170290;201806;81;60;21;57240.0;20034.0;77274.0
170300;201806;83;55;28;51706.8;26712.0;78418.8
170305;201806;47;35;12;33390.0;11448.0;44838.0
170307;201806;63;47;16;44838.0;15264.0;60102.0
170310;201806;103;56;47;53424.0;44838.0;98262.0
170320;201806;19;15;4;14310.0;3816.0;18126.0
170330;201806;20;18;2;17172.0;1908.0;19080.0
170360;201806;23;13;10;12402.0;9540.0;21942.0
170370;201806;120;63;57;60102.0;54378.0;114480.0
170380;201806;83;61;22;58194.0;20988.0;79182.0
170382;201806;45;40;5;38160.0;4770.0;42930.0
170384;201806;136;101;35;96354.0;33390.0;129744.0
170386;201806;61;27;34;25758.0;32436.0;58194.0
170388;201806;48;18;30;17172.0;28620.0;45792.0
170389;201806;22;18;4;17172.0;3816.0;20988.0
170390;201806;57;33;24;31482.0;22896.0;54378.0
170410;201806;35;24;11;22896.0;10494.0;33390.0
170460;201806;17;13;4;12402.0;3816.0;16218.0
170510;201806;29;22;7;20988.0;6678.0;27666.0
170550;201806;1495;855;640;815670.0;609797.0;1425467.0
170555;201806;113;78;35;74412.0;33390.0;107802.0
170560;201806;98;72;26;68688.0;24804.0;93492.0
170600;201806;39;19;20;18126.0;19080.0;37206.0
170610;201806;189;101;88;96196.59;83934.0;180130.6
170625;201806;38;20;18;19080.0;17172.0;36252.0
170650;201806;82;62;20;59148.0;19080.0;78228.0
170700;201806;556;423;133;402302.3;126595.8;528898.1
170710;201806;157;96;61;91584.0;58185.0;149769.0
170720;201806;84;68;16;64872.0;15264.0;80136.0
170730;201806;62;37;25;35298.0;23850.0;59148.0
170740;201806;79;57;22;54378.0;20988.0;75366.0
170755;201806;69;36;33;34344.0;31482.0;65826.0
170765;201806;138;67;71;63632.0;67734.0;131366.0
170770;201806;224;132;92;124830.9;87768.0;212598.9
170820;201806;596;388;208;370152.0;198003.0;568155.0
170825;201806;32;20;12;19080.0;11448.0;30528.0
170830;201806;79;60;19;57049.2;18126.0;75175.2
170900;201806;199;152;47;145008.0;44838.0;189846.0
170930;201806;814;424;390;404172.0;371488.0;775660.0
170950;201806;3037;1323;1714;1261170.2;1633039.2;2894209.5
170980;201806;18;10;8;9540.0;7632.0;17172.0
171050;201806;135;105;30;100170.0;28620.0;128790.0
171070;201806;38;31;7;29574.0;6678.0;36252.0
171090;201806;40;29;11;27666.0;10494.0;38160.0
171110;201806;20;13;7;12402.0;6678.0;19080.0
171150;201806;39;18;21;17172.0;20034.0;37206.0
171180;201806;22;10;12;9540.0;11448.0;20988.0
171190;201806;139;81;58;77274.0;55332.0;132606.0
171195;201806;65;50;15;47700.0;14310.0;62010.0
171200;201806;46;19;27;18126.0;25758.0;43884.0
171215;201806;3;3;0;2862.0;0.0;2862.0
171240;201806;54;44;10;41976.0;9540.0;51516.0
171245;201806;55;50;5;47700.0;4770.0;52470.0
171250;201806;71;37;34;35298.0;32426.46;67724.46
171270;201806;17;13;4;12402.0;3816.0;16218.0
171280;201806;39;36;3;34201.0;2862.0;37063.0
171320;201806;993;562;431;536148.0;408884.4;945032.4
171330;201806;422;204;218;194616.0;207972.0;402588.0
171360;201806;90;65;25;62010.0;23850.0;85860.0
171370;201806;24;13;11;12402.0;10494.0;22896.0
171380;201806;136;110;26;104940.0;24804.0;129744.0
171395;201806;55;34;21;32436.0;20034.0;52470.0
171420;201806;305;201;104;191754.0;98929.8;290683.8
171430;201806;68;54;14;51516.0;13356.0;64872.0
171488;201806;199;106;93;101124.0;88722.0;189846.0
171500;201806;58;32;26;30528.0;24804.0;55332.0
171510;201806;68;45;23;42930.0;21942.0;64872.0
171515;201806;44;37;7;35298.0;6392.0;41690.0
171525;201806;31;26;5;24804.0;4770.0;29574.0
171550;201806;13;7;6;6678.0;5724.0;12402.0
171570;201806;60;30;30;28620.0;28620.0;57240.0
171575;201806;340;212;128;202248.0;122102.46;324350.47
171610;201806;1706;858;848;816633.0;807443.7;1624076.6
171620;201806;132;94;38;89122.68;36252.0;125374.68
171630;201806;50;27;23;25758.0;21942.0;47700.0
171650;201806;270;178;92;169812.0;87768.0;257580.0
171660;201806;267;143;124;136422.0;118292.0;254714.0
171665;201806;49;33;16;31482.0;15264.0;46746.0
171670;201806;428;248;180;233673.27;171290.03;404963.28
171700;201806;63;55;8;52470.0;7632.0;60102.0
171720;201806;25;9;16;8586.0;15264.0;23850.0
171750;201806;101;55;46;52470.0;43884.0;96354.0
171780;201806;74;60;14;57240.0;13356.0;70596.0
171790;201806;76;64;12;61056.0;11448.0;72504.0
171800;201806;34;26;8;24804.0;7632.0;32436.0
171820;201806;2068;1168;900;1111896.8;853992.8;1965889.5
171830;201806;38;31;7;29574.0;6678.0;36252.0
171840;201806;65;38;27;36252.0;25758.0;62010.0
171845;201806;31;20;11;19080.0;10494.0;29574.0
171850;201806;40;29;11;27666.0;10494.0;38160.0
171855;201806;78;61;17;58194.0;16218.0;74412.0
171865;201806;8;7;1;6678.0;954.0;7632.0
171870;201806;31;22;9;20988.0;8586.0;29574.0
171875;201806;77;52;25;49608.0;23850.0;73458.0
171880;201806;28;20;8;19080.0;7632.0;26712.0
171884;201806;46;23;23;21942.0;21942.0;43884.0
171886;201806;118;43;75;41022.0;71263.8;112285.8
171888;201806;24;18;6;17172.0;5724.0;22896.0
171889;201806;19;15;4;14310.0;3816.0;18126.0
171890;201806;56;46;10;43884.0;9540.0;53424.0
171900;201806;42;29;13;27666.0;12402.0;40068.0
172000;201806;38;33;5;31482.0;4770.0;36252.0
172010;201806;41;35;6;32579.1;5724.0;38303.1
172015;201806;25;16;9;15264.0;8299.8;23563.8
172020;201806;131;83;48;79182.0;45792.0;124974.0
172025;201806;32;21;11;20034.0;10494.0;30528.0
172030;201806;33;19;14;18126.0;13356.0;31482.0
172049;201806;73;44;29;41976.0;27666.0;69642.0
172065;201806;150;98;52;93442.0;49608.0;143050.0
172080;201806;90;64;26;59873.84;24804.0;84677.84
172085;201806;25;12;13;11448.0;12402.0;23850.0
172090;201806;406;312;94;297648.0;88913.0;386561.0
172093;201806;24;18;6;17172.0;5724.0;22896.0
172097;201806;16;8;8;7632.0;7346.0;14978.0
172100;201806;4728;2662;2066;2534349.8;1968495.0;4502845.0
172110;201806;81;53;28;50562.0;26712.0;77274.0
172120;201806;1711;1469;242;1395309.6;230465.5;1625775.1
172125;201806;4;4;0;3816.0;0.0;3816.0
172130;201806;17;13;4;12402.0;3816.0;16218.0
172208;201806;191;121;70;115434.0;66780.0;182214.0
172210;201806;416;202;214;192708.0;203870.0;396578.0
210005;201806;2943;1832;1111;1744675.2;1057034.0;2801709.2
210010;201806;187;96;91;91584.0;86814.0;178398.0
210015;201806;31;21;10;20034.0;9540.0;29574.0
210020;201806;346;183;163;174582.0;155502.0;330084.0
210030;201806;345;216;129;206064.0;123057.0;329121.0
210040;201806;152;117;35;111618.0;33390.0;145008.0
210043;201806;259;175;84;166950.0;80136.0;247086.0
210047;201806;598;319;279;303944.4;266156.47;570100.9
210050;201806;297;217;80;207018.0;76320.0;283338.0
210055;201806;43;33;10;31482.0;9540.0;41022.0
210060;201806;557;441;116;420614.78;110664.0;531278.8
210070;201806;412;303;109;289062.0;103986.0;393048.0
210080;201806;103;94;9;89676.0;8586.0;98262.0
210083;201806;305;135;170;128790.0;162180.0;290970.0
210087;201806;43;32;11;29726.64;10494.0;40220.64
210090;201806;492;341;151;325314.0;144054.0;469368.0
210095;201806;487;355;132;338660.47;125928.0;464588.47
210100;201806;695;529;166;504332.1;157410.02;661742.1
210110;201806;147;81;66;77274.0;62964.0;140238.0
210120;201806;5447;4103;1344;3907253.0;1280922.6;5188175.5
210125;201806;212;122;90;116388.0;85860.0;202248.0
210130;201806;546;286;260;271890.0;248020.92;519910.9
210135;201806;34;20;14;19080.0;13356.0;32436.0
210140;201806;4404;3453;951;3291385.5;907016.0;4198401.5
210150;201806;360;228;132;217512.0;125928.0;343440.0
210160;201806;3385;2848;537;2714132.8;512012.0;3226144.8
210170;201806;1141;893;248;851922.0;236592.0;1088514.0
210173;201806;123;102;21;97308.0;20034.0;117342.0
210177;201806;452;221;231;210834.0;220374.0;431208.0
210180;201806;32;17;15;16218.0;14310.0;30528.0
210190;201806;417;268;149;255672.0;142146.0;397818.0
210193;201806;1;1;0;954.0;0.0;954.0
210197;201806;81;54;27;51516.0;25739.88;77255.88
210200;201806;640;506;134;482285.16;127836.0;610121.2
210203;201806;259;173;86;165042.0;82044.0;247086.0
210207;201806;384;298;86;284292.0;82044.0;366336.0
210210;201806;778;710;68;677340.0;64872.0;742212.0
210215;201806;79;67;12;63918.0;11448.0;75366.0
210220;201806;392;323;69;308142.0;65539.8;373681.8
210230;201806;306;233;73;222282.0;69642.0;291924.0
210232;201806;1472;939;533;895520.0;508482.0;1404002.0
210235;201806;157;122;35;116198.0;33390.0;149588.0
210237;201806;45;24;21;22896.0;20034.0;42930.0
210240;201806;92;75;17;71550.0;16218.0;87768.0
210250;201806;185;149;36;142146.0;34344.0;176490.0
210255;201806;347;257;90;245178.0;85860.0;331038.0
210260;201806;417;266;151;253764.0;144054.0;397818.0
210270;201806;693;441;252;420714.0;240408.0;661122.0
210275;201806;47;36;11;34344.0;10494.0;44838.0
210280;201806;1039;669;370;635411.3;351644.5;987055.8
210290;201806;505;333;172;317682.0;164088.0;481770.0
210300;201806;6054;3533;2521;3365273.2;2403842.2;5769115.5
210310;201806;106;73;33;69642.0;31482.0;101124.0
210312;201806;125;81;44;77274.0;41976.0;119250.0
210315;201806;116;87;29;82998.0;27666.0;110664.0
210317;201806;123;86;37;82044.0;35298.0;117342.0
210320;201806;2382;1966;416;1873853.9;396864.0;2270717.8
210325;201806;128;88;40;82998.0;37874.0;120872.0
210330;201806;5450;2823;2627;2688319.8;2506148.5;5194468.0
210340;201806;1386;998;388;951292.0;370081.06;1321373.1
210350;201806;615;506;109;482485.5;103986.0;586471.5
210355;201806;136;108;28;103032.0;26712.0;129744.0
210360;201806;2620;1647;973;1568091.6;927956.0;2496047.5
210370;201806;1239;547;692;521838.0;660168.0;1182006.0
210375;201806;187;97;90;91995.0;85860.0;177855.0
210380;201806;734;545;189;519930.0;180306.0;700236.0
210390;201806;205;169;36;161226.0;34344.0;195570.0
210400;201806;419;352;67;335808.0;63899.0;399707.0
210405;201806;1018;690;328;658260.0;312912.0;971172.0
210407;201806;54;43;11;41022.0;10494.0;51516.0
210408;201806;64;57;7;54378.0;6678.0;61056.0
210409;201806;321;268;53;255672.0;50562.0;306234.0
210410;201806;440;341;99;325314.0;94437.0;419751.0
210420;201806;192;157;35;149778.0;33390.0;183168.0
210430;201806;37;27;10;25758.0;9540.0;35298.0
210440;201806;375;229;146;218466.0;139284.0;357750.0
210450;201806;149;111;38;105894.0;36252.0;142146.0
210455;201806;223;122;101;116388.0;96354.0;212742.0
210460;201806;343;218;125;207972.0;119250.0;327222.0
210462;201806;64;54;10;51516.0;9540.0;61056.0
210465;201806;174;126;48;120204.0;45792.0;165996.0
210467;201806;533;382;151;364428.0;144054.0;508482.0
210470;201806;46;35;11;33390.0;10494.0;43884.0
210480;201806;1325;940;385;896760.0;367290.0;1264050.0
210490;201806;223;136;87;129744.0;82998.0;212742.0
210500;201806;579;306;273;291924.0;260442.0;552366.0
210510;201806;555;431;124;411174.0;118296.0;529470.0
210515;201806;435;239;196;228006.0;186984.0;414990.0
210520;201806;407;355;52;338383.8;49608.0;387991.8
210530;201806;9436;5057;4379;4810211.5;4169845.2;8980057.0
210535;201806;131;93;38;88722.0;36252.0;124974.0
210540;201806;1546;942;604;897523.8;574785.0;1472308.8
210542;201806;1184;593;591;565340.4;563337.0;1128677.4
210545;201806;13;12;1;11448.0;954.0;12402.0
210547;201806;134;114;20;108756.0;19080.0;127836.0
210550;201806;739;521;218;495486.0;207972.0;703458.0
210560;201806;178;149;29;142146.0;27666.0;169812.0
210565;201806;31;22;9;20988.0;8586.0;29574.0
210570;201806;1369;1075;294;1025550.0;280476.0;1306026.0
210580;201806;108;94;14;89676.0;13356.0;103032.0
210590;201806;771;610;161;581176.8;153594.0;734770.8
210592;201806;31;27;4;25758.0;3816.0;29574.0
210594;201806;104;85;19;81090.0;18126.0;99216.0
210596;201806;90;75;15;71550.0;14310.0;85860.0
210598;201806;124;90;34;85860.0;32436.0;118296.0
210600;201806;332;280;52;267120.0;49608.0;316728.0
210610;201806;252;233;19;221328.0;18126.0;239454.0
210620;201806;47;27;20;25758.0;19080.0;44838.0
210630;201806;61;59;2;56286.0;1908.0;58194.0
210632;201806;1099;729;370;695466.0;352503.0;1047969.0
210635;201806;17;14;3;13356.0;2862.0;16218.0
210637;201806;105;73;32;69642.0;30528.0;100170.0
210640;201806;591;517;74;493218.0;70596.0;563814.0
210650;201806;411;330;81;313894.62;76320.0;390214.62
210660;201806;398;287;111;273131.0;105770.0;378901.0
210663;201806;18;11;7;10494.0;6678.0;17172.0
210667;201806;114;36;78;34344.0;74412.0;108756.0
210670;201806;268;236;32;224429.0;30528.0;254957.0
210675;201806;575;300;275;286200.0;262350.0;548550.0
210680;201806;210;131;79;124974.0;75366.0;200340.0
210690;201806;646;511;135;487494.0;128790.0;616284.0
210700;201806;191;141;50;134514.0;47700.0;182214.0
210710;201806;299;168;131;160081.2;124974.0;285055.2
210720;201806;128;107;21;102078.0;20034.0;122112.0
210725;201806;71;62;9;59148.0;8586.0;67734.0
210730;201806;25;18;7;17172.0;6678.0;23850.0
210735;201806;417;278;139;265212.0;132320.0;397532.0
210740;201806;553;465;88;443610.0;83952.0;527562.0
210745;201806;153;111;42;105894.0;40068.0;145962.0
210750;201806;2418;1090;1328;1037905.0;1266892.9;2304798.0
210760;201806;273;200;73;190800.0;69627.69;260427.69
210770;201806;404;311;93;296694.0;88435.8;385129.8
210780;201806;425;307;118;292878.0;112572.0;405450.0
210790;201806;188;145;43;138330.0;41022.0;179352.0
210800;201806;145;107;38;102078.0;36252.0;138330.0
210805;201806;45;41;4;39114.0;3816.0;42930.0
210810;201806;488;375;113;357082.2;107802.0;464884.2
210820;201806;2323;1841;482;1747869.4;459828.0;2207697.5
210825;201806;174;90;84;85860.0;80136.0;165996.0
210830;201806;798;489;309;465552.0;293832.0;759384.0
210840;201806;211;143;68;136422.0;64872.0;201294.0
210845;201806;252;159;93;151686.0;88722.0;240408.0
210850;201806;846;537;309;512298.0;294786.0;807084.0
210860;201806;4138;2139;1999;2039080.2;1906740.8;3945821.0
210870;201806;469;354;115;337716.0;109710.0;447426.0
210880;201806;60;42;18;40068.0;17172.0;57240.0
210890;201806;348;289;59;275706.0;56286.0;331992.0
210900;201806;581;377;204;359654.0;194616.0;554270.0
210905;201806;69;35;34;33390.0;32436.0;65826.0
210910;201806;2007;1484;523;1414446.0;498942.0;1913388.0
210920;201806;229;68;161;64872.0;153594.0;218466.0
210923;201806;81;57;24;54378.0;22896.0;77274.0
210927;201806;438;183;255;174582.0;243270.0;417852.0
210930;201806;63;49;14;46746.0;13356.0;60102.0
210940;201806;94;71;23;67734.0;21942.0;89676.0
210945;201806;192;87;105;82998.0;100170.0;183168.0
210950;201806;519;375;144;357750.0;137371.23;495121.22
210955;201806;77;50;27;47700.0;25758.0;73458.0
210960;201806;2441;1045;1396;995308.4;1331498.0;2326806.5
210970;201806;114;98;16;93492.0;15264.0;108756.0
210975;201806;93;83;10;79182.0;9540.0;88722.0
210980;201806;1234;535;699;510275.53;666560.0;1176835.5
210990;201806;4343;2707;1636;2581377.2;1560744.0;4142121.2
211000;201806;1373;1087;286;1036712.0;272557.8;1309269.8
211003;201806;929;633;296;603882.0;282375.0;886257.0
211010;201806;489;431;58;411174.0;55332.0;466506.0
211020;201806;1616;589;1027;561906.0;979538.56;1541444.6
211023;201806;28;24;4;22609.8;3816.0;26425.8
211027;201806;66;44;22;41976.0;20988.0;62964.0
211030;201806;385;259;126;247086.0;120204.0;367290.0
211040;201806;324;248;76;236306.0;72504.0;308810.0
211050;201806;1179;753;426;718342.94;406113.22;1124456.1
211060;201806;690;582;108;553142.5;103032.0;656174.5
211065;201806;22;18;4;17172.0;3816.0;20988.0
211070;201806;927;751;176;714842.75;167904.0;882746.75
211080;201806;88;84;4;80136.0;3816.0;83952.0
211085;201806;59;31;28;29288.0;26712.0;56000.0
211090;201806;91;73;18;69642.0;17172.0;86814.0
211100;201806;504;403;101;383221.8;96354.0;479575.8
211102;201806;264;176;88;167904.0;83952.0;251856.0
211105;201806;221;150;71;143100.0;67734.0;210834.0
211107;201806;136;78;58;74412.0;55332.0;129744.0
211110;201806;826;529;297;504094.0;283329.0;787423.0
211120;201806;5783;2472;3311;2353145.5;3157602.2;5510748.0
211125;201806;36;29;7;27666.0;6678.0;34344.0
211130;201806;45820;19295;26525;1,84E+14;2,53E+14;4,37E+13
211140;201806;427;360;67;342482.0;63918.0;406400.0
211150;201806;1285;813;472;775268.1;449998.0;1225266.1
211153;201806;166;98;68;93492.0;64872.0;158364.0
211157;201806;66;49;17;46746.0;16218.0;62964.0
211160;201806;709;590;119;562144.5;113526.0;675670.5
211163;201806;0;0;0;0.0;0.0;0.0
211167;201806;10;8;2;7632.0;1908.0;9540.0
211170;201806;447;311;136;296694.0;129744.0;426438.0
211172;201806;123;86;37;82044.0;35298.0;117342.0
211174;201806;276;163;113;155502.0;107802.0;263304.0
211176;201806;512;370;142;352980.0;135468.0;488448.0
211178;201806;96;62;34;59148.0;32436.0;91584.0
211180;201806;207;161;46;153594.0;43721.82;197315.81
211190;201806;67;62;5;59148.0;4770.0;63918.0
211195;201806;27;17;10;16218.0;9540.0;25758.0
211200;201806;157;136;21;129400.56;20034.0;149434.56
211210;201806;530;330;200;314152.2;190800.0;504952.2
211220;201806;4011;2254;1757;2142473.5;1669841.0;3812314.5
211223;201806;97;91;6;86632.74;5724.0;92356.74
211227;201806;69;48;21;45792.0;20034.0;65826.0
211230;201806;784;637;147;607554.9;140218.92;747773.8
211240;201806;416;313;103;298602.0;98262.0;396864.0
211245;201806;205;91;114;86814.0;108756.0;195570.0
211250;201806;1641;1402;239;1336516.1;228006.0;1564522.1
211260;201806;825;646;179;616284.0;170766.0;787050.0
211270;201806;2077;1637;440;1561698.0;418806.2;1980504.2
211280;201806;1844;1106;738;1054170.8;704052.0;1758222.8
211285;201806;204;120;84;114480.0;80136.0;194616.0
211290;201806;687;461;226;439603.2;215604.0;655207.2
211300;201806;812;624;188;595018.06;179352.0;774370.06
211400;201806;1597;905;692;863370.0;660168.0;1523538.0
220005;201806;18;17;1;16218.0;954.0;17172.0
220010;201806;87;66;21;62964.0;19747.8;82711.8
220020;201806;630;495;135;471245.03;128790.0;600035.06
220025;201806;107;103;4;98262.0;3816.0;102078.0
220027;201806;36;29;7;27666.0;6678.0;34344.0
220030;201806;99;81;18;77274.0;17172.0;94446.0
220040;201806;1133;855;278;814506.94;265212.0;1079719.0
220045;201806;39;28;11;26712.0;10494.0;37206.0
220050;201806;657;539;118;513044.97;112552.92;625597.9
220060;201806;174;148;26;141192.0;24804.0;165996.0
220070;201806;98;89;9;84906.0;8586.0;93492.0
220080;201806;10;9;1;8586.0;954.0;9540.0
220090;201806;36;29;7;27380.0;6678.0;34058.0
220095;201806;2;1;1;954.0;954.0;1908.0
220100;201806;27;23;4;21942.0;3816.0;25758.0
220105;201806;26;24;2;22324.0;1908.0;24232.0
220110;201806;212;194;18;184789.8;17172.0;201961.8
220115;201806;50;47;3;44838.0;2862.0;47700.0
220117;201806;20;18;2;17172.0;1908.0;19080.0
220120;201806;1490;1065;425;1014388.2;405430.9;1419819.1
220130;201806;26;25;1;23850.0;954.0;24804.0
220140;201806;98;77;21;72504.0;20034.0;92538.0
220150;201806;460;329;131;314305.78;124974.0;439279.78
220155;201806;4;4;0;3816.0;0.0;3816.0
220157;201806;18;15;3;14310.0;2862.0;17172.0
220160;201806;73;62;11;59148.0;10494.0;69642.0
220170;201806;37;35;2;33390.0;1908.0;35298.0
220173;201806;7;7;0;6678.0;0.0;6678.0
220177;201806;5;5;0;4770.0;0.0;4770.0
220180;201806;63;62;1;59143.23;770.0;59913.23
220190;201806;1056;946;110;902484.0;104940.0;1007424.0
220191;201806;42;37;5;35298.0;4770.0;40068.0
220192;201806;65;62;3;59148.0;2862.0;62010.0
220194;201806;38;34;4;32436.0;3816.0;36252.0
220196;201806;102;84;18;80136.0;17172.0;97308.0
220198;201806;6;4;2;3816.0;1908.0;5724.0
220200;201806;431;355;76;339402.0;72504.0;411906.0
220202;201806;36;32;4;30528.0;3816.0;34344.0
220205;201806;40;35;5;33390.0;4770.0;38160.0
220207;201806;18;17;1;16218.0;954.0;17172.0
220208;201806;85;45;40;42930.0;38160.0;81090.0
220209;201806;31;28;3;26712.0;2862.0;29574.0
220210;201806;15;13;2;12402.0;1908.0;14310.0
220211;201806;27;27;0;25758.0;0.0;25758.0
220213;201806;42;38;4;36252.0;3530.0;39782.0
220217;201806;36;28;8;26712.0;7632.0;34344.0
220220;201806;2045;1306;739;1242318.6;703603.94;1945922.6
220225;201806;16;8;8;7632.0;7632.0;15264.0
220230;201806;946;746;200;711235.6;190160.81;901396.44
220240;201806;147;134;13;127836.0;12402.0;140238.0
220245;201806;33;30;3;27917.04;2862.0;30779.04
220250;201806;111;100;11;95400.0;10494.0;105894.0
220253;201806;45;38;7;36252.0;6678.0;42930.0
220255;201806;28;25;3;23850.0;2862.0;26712.0
220260;201806;683;495;188;472230.0;179352.0;651582.0
220265;201806;18;14;4;13356.0;3816.0;17172.0
220270;201806;689;609;80;580260.94;75843.0;656103.94
220271;201806;44;37;7;35298.0;6678.0;41976.0
220272;201806;27;27;0;25758.0;0.0;25758.0
220273;201806;15;13;2;12402.0;1908.0;14310.0
220275;201806;58;47;11;44838.0;10494.0;55332.0
220277;201806;12;10;2;9540.0;1908.0;11448.0
220280;201806;15;12;3;11448.0;2862.0;14310.0
220285;201806;41;38;3;36252.0;2862.0;39114.0
220290;201806;1396;1192;204;1133876.8;194569.0;1328445.8
220300;201806;53;52;1;49608.0;954.0;50562.0
220310;201806;314;263;51;250898.0;48645.0;299543.0
220320;201806;435;402;33;382078.0;31482.0;413560.0
220323;201806;0;0;0;0.0;0.0;0.0
220325;201806;16;11;5;10494.0;4770.0;15264.0
220327;201806;13;12;1;11448.0;954.0;12402.0
220330;201806;208;143;65;136422.0;62010.0;198432.0
220335;201806;137;119;18;113526.0;17172.0;130698.0
220340;201806;26;15;11;14310.0;10494.0;24804.0
220342;201806;57;49;8;46746.0;7632.0;54378.0
220345;201806;85;77;8;73458.0;7632.0;81090.0
220350;201806;430;375;55;355127.4;52470.0;407597.4
220360;201806;43;31;12;29574.0;11448.0;41022.0
220370;201806;1123;913;210;870238.8;200053.8;1070292.6
220375;201806;26;24;2;22896.0;1908.0;24804.0
220380;201806;38;31;7;29574.0;6678.0;36252.0
220385;201806;27;23;4;21942.0;3816.0;25758.0
220390;201806;2247;1278;969;1214518.5;923329.5;2137848.0
220400;201806;29;26;3;24804.0;2862.0;27666.0
220410;201806;16;15;1;14310.0;954.0;15264.0
220415;201806;13;12;1;11448.0;954.0;12402.0
220420;201806;125;103;22;98262.0;20701.8;118963.8
220430;201806;128;116;12;108995.8;11448.0;120443.8
220435;201806;21;15;6;14305.23;5724.0;20029.23
220440;201806;288;247;41;235638.0;39114.0;274752.0
220450;201806;336;170;166;161014.98;158364.0;319378.97
220455;201806;54;52;2;49608.0;1908.0;51516.0
220460;201806;18;18;0;16504.2;0.0;16504.2
220465;201806;105;68;37;64872.0;35298.0;100170.0
220470;201806;242;214;28;204156.0;26712.0;230868.0
220480;201806;72;61;11;58194.0;10494.0;68688.0
220490;201806;87;75;12;71550.0;11448.0;82998.0
220500;201806;98;84;14;80136.0;13356.0;93492.0
220510;201806;382;304;78;289253.0;74221.2;363474.2
220515;201806;21;17;4;16218.0;3816.0;20034.0
220520;201806;372;334;38;317321.0;36233.0;353554.0
220525;201806;26;18;8;17172.0;7632.0;24804.0
220527;201806;37;28;9;26712.0;7776.0;34488.0
220530;201806;34;14;20;13356.0;19080.0;32436.0
220535;201806;7;7;0;6678.0;0.0;6678.0
220540;201806;59;50;9;47700.0;8586.0;56286.0
220545;201806;57;39;18;37206.0;17172.0;54378.0
220550;201806;645;494;151;470512.8;144054.0;614566.8
220551;201806;26;19;7;18126.0;6678.0;24804.0
220552;201806;7;7;0;6678.0;0.0;6678.0
220553;201806;49;44;5;41976.0;4770.0;46746.0
220554;201806;13;8;5;7345.8;4770.0;12115.8
220555;201806;25;21;4;20034.0;3816.0;23850.0
220556;201806;52;48;4;45792.0;3816.0;49608.0
220557;201806;57;51;6;48654.0;5724.0;54378.0
220558;201806;7;2;5;1908.0;4770.0;6678.0
220559;201806;6;5;1;4770.0;954.0;5724.0
220560;201806;58;37;21;35107.2;20034.0;55141.2
220570;201806;799;480;319;456716.12;304326.0;761042.1
220580;201806;557;511;46;487474.9;43197.92;530672.8
220585;201806;6;5;1;4770.0;954.0;5724.0
220590;201806;14;14;0;13356.0;0.0;13356.0
220595;201806;57;43;14;41022.0;13356.0;54378.0
220600;201806;23;12;11;11448.0;10494.0;21942.0
220605;201806;20;19;1;18126.0;954.0;19080.0
220610;201806;63;54;9;51516.0;8586.0;60102.0
220620;201806;559;438;121;417613.5;115434.0;533047.5
220630;201806;6;4;2;3816.0;1908.0;5724.0
220635;201806;38;34;4;32436.0;3816.0;36252.0
220640;201806;98;77;21;73458.0;20034.0;93492.0
220650;201806;116;110;6;104940.0;5724.0;110664.0
220660;201806;32;26;6;24804.0;5724.0;30528.0
220665;201806;4;4;0;3816.0;0.0;3816.0
220667;201806;15;13;2;12402.0;1908.0;14310.0
220669;201806;27;24;3;22896.0;2862.0;25758.0
220670;201806;73;57;16;54187.2;15264.0;69451.2
220672;201806;66;45;21;42930.0;20034.0;62964.0
220675;201806;36;28;8;26712.0;7632.0;34344.0
220680;201806;36;30;6;28620.0;5724.0;34344.0
220690;201806;45;43;2;41022.0;1908.0;42930.0
220695;201806;58;27;31;25758.0;29574.0;55332.0
220700;201806;1549;1184;365;1128391.2;348210.0;1476601.2
220710;201806;5;3;2;2862.0;1908.0;4770.0
220720;201806;109;89;20;84667.5;18936.9;103604.4
220730;201806;19;18;1;17172.0;954.0;18126.0
220735;201806;3;1;2;954.0;1908.0;2862.0
220740;201806;46;41;5;39114.0;4770.0;43884.0
220750;201806;99;81;18;77274.0;17172.0;94446.0
220755;201806;14;14;0;13356.0;0.0;13356.0
220760;201806;52;49;3;46746.0;2862.0;49608.0
220770;201806;5744;2937;2807;2796688.8;2671741.5;5468430.0
220775;201806;23;10;13;9540.0;12402.0;21942.0
220777;201806;16;15;1;14310.0;954.0;15264.0
220779;201806;17;13;4;12402.0;3816.0;16218.0
220780;201806;878;751;127;715786.2;120872.0;836658.2
220785;201806;13;8;5;7632.0;4770.0;12402.0
220790;201806;1016;811;205;771292.0;195570.0;966862.0
220793;201806;12;12;0;11448.0;0.0;11448.0
220795;201806;22;21;1;20034.0;954.0;20988.0
220800;201806;3964;3028;936;2886787.2;891967.9;3778755.2
220810;201806;60;53;7;50562.0;6678.0;57240.0
220820;201806;241;220;21;209880.0;20034.0;229914.0
220830;201806;1178;1000;178;953995.25;169793.0;1123788.2
220840;201806;2358;1624;734;1536517.4;698138.0;2234655.2
220850;201806;52;44;8;41976.0;7632.0;49608.0
220855;201806;14;9;5;8586.0;4770.0;13356.0
220860;201806;8;7;1;6678.0;954.0;7632.0
220865;201806;22;20;2;19080.0;1908.0;20988.0
220870;201806;61;59;2;56286.0;1908.0;58194.0
220880;201806;315;240;75;228292.2;71264.0;299556.2
220885;201806;42;39;3;37206.0;2862.0;40068.0
220887;201806;19;18;1;17172.0;954.0;18126.0
220890;201806;101;89;12;84906.0;11448.0;96354.0
220900;201806;49;28;21;26712.0;20034.0;46746.0
220910;201806;54;46;8;43884.0;7632.0;51516.0
220915;201806;10;9;1;8586.0;954.0;9540.0
220920;201806;41;37;4;35298.0;3816.0;39114.0
220930;201806;41;40;1;38160.0;954.0;39114.0
220935;201806;15;15;0;14310.0;0.0;14310.0
220937;201806;44;41;3;39114.0;2862.0;41976.0
220940;201806;52;48;4;45792.0;3816.0;49608.0
220945;201806;0;0;0;0.0;0.0;0.0
220950;201806;48;44;4;41976.0;3816.0;45792.0
220955;201806;33;29;4;27666.0;3816.0;31482.0
220960;201806;1;1;0;954.0;0.0;954.0
220965;201806;29;26;3;24804.0;2862.0;27666.0
220970;201806;47;40;7;38160.0;6678.0;44838.0
220975;201806;9;8;1;7632.0;954.0;8586.0
220980;201806;33;31;2;29574.0;1908.0;31482.0
220985;201806;65;57;8;54378.0;7632.0;62010.0
220987;201806;31;30;1;28620.0;954.0;29574.0
220990;201806;15;14;1;13356.0;954.0;14310.0
220995;201806;37;32;5;30528.0;4770.0;35298.0
220997;201806;45;37;8;35298.0;7632.0;42930.0
221000;201806;1136;1019;117;968951.2;111331.8;1080283.0
221005;201806;63;57;6;54378.0;5724.0;60102.0
221010;201806;17;14;3;13356.0;2862.0;16218.0
221020;201806;43;41;2;39114.0;1908.0;41022.0
221030;201806;30;24;6;22896.0;5724.0;28620.0
221035;201806;21;21;0;20034.0;0.0;20034.0
221037;201806;12;6;6;5724.0;5724.0;11448.0
221038;201806;26;23;3;21942.0;2862.0;24804.0
221039;201806;23;23;0;21942.0;0.0;21942.0
221040;201806;261;224;37;213696.0;35298.0;248994.0
221050;201806;234;198;36;188892.0;34344.0;223236.0
221060;201806;1746;1536;210;1462588.5;200340.0;1662928.5
221062;201806;29;28;1;26712.0;954.0;27666.0
221063;201806;14;10;4;9540.0;3816.0;13356.0
221065;201806;50;43;7;41022.0;6678.0;47700.0
221070;201806;141;122;19;116388.0;18126.0;134514.0
221080;201806;375;333;42;317682.0;39781.8;357463.8
221090;201806;34;33;1;31482.0;954.0;32436.0
221093;201806;56;36;20;34344.0;19080.0;53424.0
221095;201806;11;10;1;9540.0;954.0;10494.0
221097;201806;20;17;3;16218.0;2862.0;19080.0
221100;201806;24791;14293;10498;1,36E+14;1,00E+14;2,36E+14
221110;201806;1043;769;274;733340.0;261396.0;994736.0
221120;201806;531;395;136;376544.0;129744.0;506288.0
221130;201806;941;768;173;731432.8;165042.0;896474.8
221135;201806;36;33;3;31482.0;2862.0;34344.0
221140;201806;41;33;8;31482.0;7632.0;39114.0
221150;201806;14;11;3;10494.0;2862.0;13356.0
221160;201806;12;12;0;11448.0;0.0;11448.0
221170;201806;13;13;0;12402.0;0.0;12402.0
230010;201806;165;152;13;145008.0;12402.0;157410.0
230015;201806;119;99;20;94446.0;19080.0;113526.0
230020;201806;1577;1342;235;1277339.9;223317.19;1500657.0
230030;201806;1634;1176;458;1116335.0;436932.0;1553267.0
230040;201806;204;180;24;170241.5;22896.0;193137.5
230050;201806;209;153;56;145962.0;53424.0;199386.0
230060;201806;156;127;29;120394.8;27666.0;148060.8
230070;201806;283;252;31;240408.0;29574.0;269982.0
230075;201806;817;713;104;678199.0;98929.8;777128.8
230080;201806;178;153;25;145962.0;23850.0;169812.0
230090;201806;102;70;32;66016.8;30528.0;96544.8
230100;201806;1943;1158;785;1102445.0;748890.0;1851335.0
230110;201806;2650;1697;953;1616825.4;908589.8;2525415.2
230120;201806;952;761;191;723610.25;182195.0;905805.25
230125;201806;142;116;26;110664.0;24804.0;135468.0
230130;201806;465;417;48;397818.0;45792.0;443610.0
230140;201806;203;176;27;167904.0;25758.0;193662.0
230150;201806;159;125;34;119250.0;32436.0;151686.0
230160;201806;922;792;130;755091.0;124020.0;879111.0
230170;201806;588;542;46;512555.7;43884.0;556439.7
230180;201806;78;73;5;69642.0;4770.0;74412.0
230185;201806;407;353;54;335664.9;51516.0;387180.9
230190;201806;2205;1782;423;1696048.5;403225.0;2099273.5
230195;201806;490;425;65;405450.0;62010.0;467460.0
230200;201806;371;322;49;306224.47;46746.0;352970.47
230205;201806;354;229;125;216982.53;119250.0;336232.53
230210;201806;1253;1001;252;953035.75;239644.8;1192680.5
230220;201806;1414;976;438;930340.8;417852.0;1348192.8
230230;201806;891;780;111;743929.2;105894.0;849823.2
230240;201806;1637;1412;225;1346126.8;214650.0;1560776.8
230250;201806;1775;1465;310;1393449.1;295740.0;1689189.1
230260;201806;2950;1789;1161;1703135.0;1106621.8;2809756.8
230270;201806;1349;1084;265;1031918.0;251617.5;1283535.5
230280;201806;2726;2029;697;1929276.8;664270.2;2593547.0
230290;201806;399;361;38;339343.78;36252.0;375595.78
230300;201806;512;380;132;361260.72;125928.0;487188.72
230310;201806;417;314;103;299408.12;98262.0;397670.12
230320;201806;924;787;137;747387.8;130698.0;878085.8
230330;201806;303;244;59;232012.8;56096.0;288108.8
230340;201806;454;365;89;347257.0;84906.0;432163.0
230350;201806;3048;1926;1122;1837356.2;1067813.2;2905169.5
230360;201806;267;215;52;204314.0;49608.0;253922.0
230365;201806;134;108;26;102317.0;24804.0;127121.0
230370;201806;9742;4781;4961;4551689.0;4729243.5;9280933.0
230380;201806;462;398;64;379406.0;60102.6;439508.6
230390;201806;511;282;229;267224.94;218466.0;485690.94
230393;201806;265;219;46;206832.95;43884.0;250716.95
230395;201806;337;275;62;262102.0;59148.0;321250.0
230400;201806;593;473;120;449334.0;113983.92;563317.94
230410;201806;2627;1639;988;1557215.8;941790.0;2499005.8
230420;201806;6052;3974;2078;3773012.2;1977835.1;5750847.5
230423;201806;314;273;41;260442.0;39114.0;299556.0
230425;201806;364;300;64;285599.0;61056.0;346655.0
230426;201806;109;98;11;92766.96;10207.8;102974.76
230427;201806;79;76;3;72504.0;2862.0;75366.0
230428;201806;1366;704;662;671367.94;631548.0;1302916.0
230430;201806;446;361;85;344200.0;81090.0;425290.0
230435;201806;805;567;238;539662.44;225812.61;765475.06
230440;201806;83966;37075;46891;3,53E+14;4,47E+14;8,00E+14
230445;201806;268;187;81;178207.2;77274.0;255481.2
230450;201806;534;434;100;414036.0;95400.0;509436.0
230460;201806;58;49;9;46746.0;8586.0;55332.0
230465;201806;302;246;56;234684.0;53424.0;288108.0
230470;201806;1884;1477;407;1409058.0;387171.1;1796229.1
230480;201806;153;147;6;139951.8;5724.0;145675.8
230490;201806;280;226;54;215604.0;51516.0;267120.0
230495;201806;436;329;107;312983.38;102078.0;415061.38
230500;201806;950;710;240;676386.0;228960.0;905346.0
230510;201806;45;36;9;34344.0;8586.0;42930.0
230520;201806;385;304;81;290016.0;77274.0;367290.0
230523;201806;2081;1307;774;1244527.6;737948.0;1982475.6
230526;201806;300;251;49;239454.0;45955.0;285409.0
230530;201806;674;501;173;474941.6;164088.2;639029.8
230533;201806;181;172;9;164088.0;8586.0;172674.0
230535;201806;344;257;87;245178.0;82998.0;328176.0
230540;201806;1838;1606;232;1529481.0;220755.8;1750236.9
230550;201806;3639;2331;1308;2214780.8;1246482.1;3461263.0
230560;201806;578;443;135;420523.8;127836.0;548359.8
230565;201806;199;144;55;137376.0;51707.0;189083.0
230570;201806;304;268;36;255672.0;34344.0;290016.0
230580;201806;1114;823;291;782709.6;276660.0;1059369.6
230590;201806;960;747;213;709062.1;202725.0;911787.1
230600;201806;256;232;24;220584.06;22896.0;243480.06
230610;201806;334;266;68;253574.0;64872.0;318446.0
230620;201806;167;137;30;129744.0;28620.0;158364.0
230625;201806;725;527;198;501203.78;187738.69;688942.44
230630;201806;1273;1007;266;960678.0;253382.4;1214060.4
230640;201806;3589;3100;489;2950165.8;465747.56;3415913.2
230650;201806;396;344;52;327297.38;49593.69;376891.06
230655;201806;653;565;88;538056.8;83886.38;621943.2
230660;201806;348;293;55;279522.0;52183.8;331705.8
230670;201806;425;377;48;359658.0;45792.0;405450.0
230680;201806;195;179;16;170766.0;15264.0;186030.0
230690;201806;864;754;110;719316.0;104940.0;824256.0
230700;201806;703;595;108;567630.0;102726.8;670356.8
230710;201806;733;694;39;662076.0;37206.0;699282.0
230720;201806;149;126;23;119812.86;21942.0;141754.86
230725;201806;240;191;49;182214.0;46580.0;228794.0
230730;201806;11752;6380;5372;6070609.5;5116238.0;1,12E+14
230740;201806;652;523;129;498656.0;122375.46;621031.44
230750;201806;809;692;117;658976.3;111618.0;770594.3
230760;201806;1322;1144;178;1087329.2;169812.0;1257141.2
230763;201806;319;266;53;251808.95;50562.0;302370.94
230765;201806;6904;3250;3654;3095151.0;3484787.2;6579938.5
230770;201806;4947;2541;2406;2414683.2;2293864.5;4708547.5
230780;201806;685;602;83;571406.1;79167.69;650573.8
230790;201806;200;165;35;157410.0;32589.4;189999.4
230800;201806;1119;821;298;782924.1;284292.0;1067216.1
230810;201806;1304;1159;145;1104684.2;138139.2;1242823.5
230820;201806;336;237;99;225145.0;94446.0;319591.0
230830;201806;940;813;127;772088.44;121158.0;893246.44
230835;201806;279;240;39;228006.0;36491.0;264497.0
230837;201806;161;136;25;129744.0;23850.0;153594.0
230840;201806;913;732;181;697088.5;172388.0;869476.5
230850;201806;1485;1294;191;1233999.0;181928.0;1415927.0
230860;201806;297;222;75;211788.0;71550.0;283338.0
230870;201806;1811;1542;269;1470114.0;256054.0;1726168.0
230880;201806;42;30;12;28620.0;11448.0;40068.0
230890;201806;567;521;46;496911.8;43870.0;540781.8
230900;201806;275;209;66;199386.0;62767.0;262153.0
230910;201806;197;159;38;150922.8;36252.0;187174.8
230920;201806;402;316;86;301464.0;82044.0;383508.0
230930;201806;922;649;273;616284.6;260442.0;876726.6
230940;201806;823;661;162;630594.0;154358.0;784952.0
230945;201806;482;404;78;384940.0;74412.0;459352.0
230950;201806;375;321;54;306234.0;51516.0;357750.0
230960;201806;2573;1736;837;1649416.9;798193.0;2447609.8
230970;201806;1747;983;764;936786.2;727978.3;1664764.5
230980;201806;211;179;32;170766.0;30528.0;201294.0
230990;201806;139;112;27;106848.0;25001.47;131849.47
231000;201806;208;188;20;177444.0;19080.0;196524.0
231010;201806;138;108;30;102745.8;28620.0;131365.8
231020;201806;1304;904;400;860795.0;381600.0;1242395.0
231025;201806;969;733;236;695415.2;223598.8;919014.0
231030;201806;1135;945;190;901526.0;180688.0;1082214.0
231040;201806;140;97;43;91793.88;40291.0;132084.88
231050;201806;987;879;108;836801.9;103032.0;939833.9
231060;201806;143;125;18;119250.0;17172.0;136422.0
231070;201806;1434;1013;421;964304.1;401634.0;1365938.1
231080;201806;262;244;18;231965.1;17172.0;249137.1
231085;201806;561;347;214;330085.0;204156.0;534241.0
231090;201806;241;200;41;190800.0;39114.0;229914.0
231095;201806;165;131;34;124974.0;32436.0;157410.0
231100;201806;125;104;21;99216.0;18793.8;118009.8
231110;201806;353;307;46;290688.1;43884.0;334572.1
231120;201806;296;253;43;240403.86;41022.0;281425.88
231123;201806;138;131;7;124974.0;6678.0;131652.0
231126;201806;298;246;52;234684.0;49608.0;284292.0
231130;201806;4565;3557;1008;3384436.5;960559.25;4344996.0
231135;201806;212;181;31;172674.0;28308.4;200982.4
231140;201806;3071;2269;802;2161773.5;764115.8;2925889.5
231150;201806;360;343;17;327222.0;16218.0;343440.0
231160;201806;1211;957;254;909878.6;242087.05;1151965.6
231170;201806;537;357;180;340578.0;171720.0;512298.0
231180;201806;1625;1379;246;1314802.8;234655.38;1549458.1
231190;201806;193;171;22;163134.0;20988.0;184122.0
231195;201806;212;182;30;172904.0;28620.0;201524.0
231200;201806;826;672;154;641088.0;145656.0;786744.0
231210;201806;607;507;100;482724.8;95400.0;578124.8
231220;201806;1032;744;288;708136.1;274752.0;982888.1
231230;201806;1402;1125;277;1072048.0;263494.8;1335542.9
231240;201806;1367;991;376;945127.8;357435.6;1302563.4
231250;201806;110;102;8;97308.0;7632.0;104940.0
231260;201806;291;187;104;178398.0;98930.0;277328.0
231270;201806;1000;833;167;789387.7;159245.23;948632.94
231280;201806;57;44;13;41976.0;12402.0;54378.0
231290;201806;7190;4013;3177;3821306.2;3028513.2;6849819.5
231300;201806;626;580;46;553320.0;43884.0;597204.0
231310;201806;707;656;51;624607.0;48654.0;673261.0
231320;201806;571;437;134;416422.0;127836.0;544258.0
231325;201806;88;79;9;75366.0;8586.0;83952.0
231330;201806;2025;1568;457;1490038.6;433975.6;1924014.1
231335;201806;248;220;28;209880.0;26712.0;236592.0
231340;201806;1628;1203;425;1146518.1;405163.8;1551681.9
231350;201806;1187;974;213;929196.0;202630.0;1131826.0
231355;201806;413;357;56;340578.0;53424.0;394002.0
231360;201806;476;374;102;354086.2;97308.0;451394.2
231370;201806;91;75;16;71550.0;15264.0;86814.0
231375;201806;286;208;78;198432.0;74412.0;272844.0
231380;201806;458;371;87;352338.7;82807.2;435145.88
231390;201806;197;162;35;154548.0;33390.0;187938.0
231395;201806;732;452;280;429910.56;267120.0;697030.56
231400;201806;1068;885;183;841718.5;174239.38;1015957.94
231410;201806;1319;1074;245;1020781.4;232758.0;1253539.4
240010;201806;396;183;213;173430.27;202907.0;376337.25
240020;201806;2192;1718;474;1636146.2;452192.0;2088338.2
240030;201806;131;111;20;105894.0;19080.0;124974.0
240040;201806;32;32;0;30528.0;0.0;30528.0
240050;201806;512;439;73;417952.44;69642.0;487594.44
240060;201806;66;62;4;59148.0;3816.0;62964.0
240070;201806;187;146;41;139284.0;39114.0;178398.0
240080;201806;445;300;145;286196.0;137090.7;423286.72
240090;201806;106;94;12;89370.72;11448.0;100818.72
240100;201806;1442;1359;83;1293513.5;78991.2;1372504.8
240110;201806;981;623;358;593370.25;341246.0;934616.25
240120;201806;138;117;21;111618.0;20034.0;131652.0
240130;201806;285;267;18;254001.55;17172.0;271173.53
240140;201806;80;64;16;61056.0;15264.0;76320.0
240145;201806;693;613;80;584277.3;76110.12;660387.44
240150;201806;20;15;5;14310.0;4741.38;19051.38
240160;201806;44;38;6;36252.0;5724.0;41976.0
240165;201806;34;28;6;26474.0;5724.0;32198.0
240170;201806;93;70;23;66780.0;21942.0;88722.0
240180;201806;78;64;14;61056.0;13356.0;74412.0
240185;201806;44;40;4;38150.46;3816.0;41966.46
240190;201806;12;10;2;9540.0;1908.0;11448.0
240200;201806;3001;1679;1322;1595499.6;1259949.0;2855448.8
240210;201806;167;130;37;124020.0;35298.0;159318.0
240220;201806;1090;788;302;751609.0;288098.47;1039707.44
240230;201806;831;771;60;732700.06;56592.0;789292.06
240240;201806;120;87;33;82998.0;31482.0;114480.0
240250;201806;91;79;12;75366.0;11448.0;86814.0
240260;201806;1802;1343;459;1280535.1;436617.2;1717152.2
240270;201806;191;168;23;159890.4;21942.0;181832.4
240280;201806;42;32;10;30528.0;9540.0;40068.0
240290;201806;50;49;1;46746.0;954.0;47700.0
240300;201806;178;100;78;95400.0;74412.0;169812.0
240310;201806;2011;1099;912;1037714.0;866535.0;1904249.0
240320;201806;206;196;10;186984.0;9540.0;196524.0
240325;201806;4300;2626;1674;2497733.5;1593587.9;4091321.2
240330;201806;66;62;4;59148.0;3816.0;62964.0
240340;201806;104;76;28;72504.0;26712.0;99216.0
240350;201806;89;79;10;75366.0;9540.0;84906.0
240360;201806;420;294;126;280476.0;120204.0;400680.0
240370;201806;40;38;2;36252.0;1908.0;38160.0
240375;201806;69;40;29;38160.0;27666.0;65826.0
240380;201806;231;188;43;179352.0;40927.0;220279.0
240390;201806;16;13;3;12402.0;2862.0;15264.0
240400;201806;76;72;4;68688.0;3816.0;72504.0
240410;201806;11;7;4;6678.0;3816.0;10494.0
240420;201806;900;698;202;663110.4;191658.6;854769.0
240430;201806;262;247;15;234727.89;14310.0;249037.89
240440;201806;71;38;33;36252.0;31482.0;67734.0
240450;201806;207;140;67;132987.8;63918.0;196905.8
240460;201806;60;47;13;44838.0;12402.0;57240.0
240470;201806;234;202;32;192150.86;30528.0;222678.86
240480;201806;14;14;0;13260.6;0.0;13260.6
240485;201806;75;65;10;62010.0;9540.0;71550.0
240490;201806;46;45;1;42720.12;954.0;43674.12
240500;201806;84;67;17;63918.0;16218.0;80136.0
240510;201806;51;36;15;34344.0;14310.0;48654.0
240520;201806;127;121;6;115434.0;5724.0;121158.0
240530;201806;54;48;6;45792.0;5724.0;51516.0
240540;201806;78;67;11;63918.0;10494.0;74412.0
240550;201806;15;13;2;12402.0;1908.0;14310.0
240560;201806;372;276;96;262677.22;91584.0;354261.22
240570;201806;464;289;175;274847.4;166950.0;441797.4
240580;201806;1255;1018;237;965687.9;224940.2;1190628.1
240590;201806;30;28;2;26712.0;1908.0;28620.0
240600;201806;110;107;3;102078.0;2862.0;104940.0
240610;201806;509;426;83;406047.7;78419.0;484466.7
240615;201806;19;18;1;17172.0;954.0;18126.0
240620;201806;96;92;4;87768.0;3816.0;91584.0
240630;201806;35;33;2;31482.0;1908.0;33390.0
240640;201806;25;21;4;20034.0;3816.0;23850.0
240650;201806;235;198;37;188033.9;35298.0;223331.9
240660;201806;99;87;12;82998.0;11448.0;94446.0
240670;201806;293;173;120;162943.3;114480.0;277423.3
240680;201806;49;38;11;36252.0;10494.0;46746.0
240690;201806;49;46;3;43884.0;2862.0;46746.0
240700;201806;192;158;34;150732.0;32436.0;183168.0
240710;201806;1935;1234;701;1176802.9;668735.44;1845538.2
240720;201806;1055;774;281;737241.9;268074.0;1005315.9
240725;201806;66;62;4;59148.0;3816.0;62964.0
240730;201806;133;115;18;109710.0;17172.0;126882.0
240740;201806;240;202;38;191343.78;35298.02;226641.8
240750;201806;37;25;12;23850.0;11448.0;35298.0
240760;201806;33;29;4;27666.0;3816.0;31482.0
240770;201806;148;114;34;108756.0;32436.0;141192.0
240780;201806;690;572;118;544247.44;112572.0;656819.44
240790;201806;38;37;1;35298.0;954.0;36252.0
240800;201806;8668;5886;2782;5576665.5;2646389.2;8223055.0
240810;201806;20067;11040;9027;1,05E+14;8601649.0;1,91E+14
240820;201806;209;132;77;125637.03;73458.0;199095.03
240830;201806;1606;1316;290;1249893.1;276660.0;1526553.1
240840;201806;81;71;10;67734.0;9540.0;77274.0
240850;201806;86;75;11;71550.0;10494.0;82044.0
240860;201806;115;112;3;106848.0;2862.0;109710.0
240870;201806;60;53;7;50562.0;6678.0;57240.0
240880;201806;29;26;3;24794.46;2862.0;27656.46
240890;201806;1169;696;473;660074.75;451238.0;1111312.8
240895;201806;47;34;13;32436.0;12402.0;44838.0
240910;201806;156;141;15;134514.0;14310.0;148824.0
240920;201806;16;13;3;12402.0;2862.0;15264.0
240930;201806;385;349;36;331992.0;34344.0;366336.0
240933;201806;31;24;7;22896.0;6678.0;29574.0
240940;201806;2435;2155;280;2042377.2;264238.9;2306616.2
240950;201806;51;48;3;45792.0;2862.0;48654.0
240960;201806;32;26;6;24804.0;5724.0;30528.0
240970;201806;126;89;37;84906.0;34544.0;119450.0
240980;201806;188;150;38;143100.0;36252.0;179352.0
240990;201806;118;77;41;73458.0;39114.0;112572.0
241000;201806;69;64;5;61056.0;4770.0;65826.0
241010;201806;60;48;12;45792.0;11448.0;57240.0
241020;201806;116;109;7;103986.0;6678.0;110664.0
241025;201806;10;4;6;3816.0;5724.0;9540.0
241030;201806;119;97;22;92538.0;20988.0;113526.0
241040;201806;35;29;6;27666.0;5724.0;33390.0
241050;201806;90;78;12;74412.0;11448.0;85860.0
241060;201806;28;24;4;22896.0;3816.0;26712.0
241070;201806;14;14;0;13356.0;0.0;13356.0
241080;201806;64;57;7;54091.8;6678.0;60769.8
241090;201806;49;40;9;38160.0;8571.69;46731.69
241100;201806;73;63;10;60102.0;9540.0;69642.0
241105;201806;6;2;4;1908.0;3816.0;5724.0
241110;201806;47;45;2;42930.0;1908.0;44838.0
241120;201806;1437;1112;325;1057862.8;310050.0;1367912.8
241140;201806;224;184;40;174583.0;38160.0;212743.0
241142;201806;43;41;2;39114.0;1908.0;41022.0
241150;201806;1214;1068;146;1016154.0;139284.0;1155438.0
241160;201806;22;21;1;20034.0;954.0;20988.0
241170;201806;42;39;3;37206.0;2862.0;40068.0
241180;201806;49;41;8;38939.42;7632.0;46571.42
241190;201806;38;37;1;35298.0;954.0;36252.0
241200;201806;3863;2105;1758;2002539.6;1675211.6;3677751.2
241210;201806;70;59;11;56286.0;9636.0;65922.0
241220;201806;1377;926;451;882939.06;430220.9;1313160.0
241230;201806;246;206;40;196333.2;38160.0;234493.2
241240;201806;51;39;12;37206.0;11448.0;48654.0
241250;201806;1094;1013;81;966116.0;77027.0;1043143.0
241255;201806;47;37;10;35298.0;9540.0;44838.0
241260;201806;637;502;135;478903.22;128790.0;607693.25
241270;201806;46;33;13;31482.0;12402.0;43884.0
241280;201806;98;85;13;81090.0;12402.0;93492.0
241290;201806;109;81;28;77274.0;26712.0;103986.0
241300;201806;79;56;23;53424.0;21942.0;75366.0
241310;201806;51;38;13;36109.0;12402.0;48511.0
241320;201806;28;14;14;13356.0;13356.0;26712.0
241330;201806;60;54;6;51516.0;5724.0;57240.0
241335;201806;62;55;7;51802.2;6678.0;58480.2
241340;201806;187;140;47;133560.0;44838.0;178398.0
241350;201806;59;54;5;51516.0;4770.0;56286.0
241355;201806;39;36;3;34344.0;2862.0;37206.0
241360;201806;46;46;0;43884.0;0.0;43884.0
241370;201806;44;37;7;35173.98;6678.0;41851.98
241380;201806;38;35;3;33390.0;2862.0;36252.0
241390;201806;75;60;15;57049.2;14310.0;71359.2
241400;201806;202;164;38;155788.2;36252.0;192040.2
241410;201806;177;160;17;152640.0;16122.6;168762.6
241415;201806;95;76;19;72504.0;18126.0;90630.0
241420;201806;98;74;24;70596.0;22725.0;93321.0
241430;201806;28;27;1;25758.0;954.0;26712.0
241440;201806;480;399;81;380632.0;77274.0;457906.0
241445;201806;38;36;2;34344.0;1908.0;36252.0
241450;201806;274;223;51;212742.0;48654.0;261396.0
241460;201806;136;124;12;118058.0;11448.0;129506.0
241470;201806;42;35;7;33390.0;6678.0;40068.0
241475;201806;64;62;2;59148.0;1908.0;61056.0
241480;201806;100;71;29;66780.69;27666.0;94446.69
241490;201806;8;7;1;6678.0;954.0;7632.0
241500;201806;47;34;13;32436.0;12402.0;44838.0
250010;201806;101;87;14;82854.9;13356.0;96210.9
250020;201806;27;24;3;22896.0;2862.0;25758.0
250030;201806;807;599;208;570101.2;197383.6;767484.8
250040;201806;334;280;54;267120.0;51229.8;318349.8
250050;201806;229;190;39;180969.8;37206.0;218175.8
250053;201806;54;41;13;39114.0;12402.0;51516.0
250057;201806;0;0;0;0.0;0.0;0.0
250060;201806;450;343;107;327222.0;101791.8;429013.8
250070;201806;707;588;119;558934.0;113526.0;672460.0
250073;201806;7;7;0;6678.0;0.0;6678.0
250077;201806;197;148;49;140800.86;46746.0;187546.86
250080;201806;423;330;93;313199.2;88722.0;401921.2
250090;201806;200;132;68;124974.4;64852.92;189827.31
250100;201806;511;421;90;401634.0;85479.0;487113.0
250110;201806;569;431;138;409390.03;131652.0;541042.0
250115;201806;25;8;17;7632.0;16218.0;23850.0
250120;201806;112;82;30;78228.0;28620.0;106848.0
250130;201806;579;465;114;443610.0;108566.0;552176.0
250135;201806;14;8;6;7632.0;5724.0;13356.0
250140;201806;79;71;8;67734.0;7632.0;75366.0
250150;201806;577;423;154;401154.6;146601.19;547755.75
250153;201806;10;9;1;8586.0;954.0;9540.0
250157;201806;28;23;5;21942.0;4770.0;26712.0
250160;201806;215;168;47;160272.0;44838.0;205110.0
250170;201806;64;45;19;42930.0;18126.0;61056.0
250180;201806;4020;2720;1300;2581223.0;1235102.0;3816325.0
250190;201806;867;570;297;542110.5;282622.5;824733.0
250200;201806;53;44;9;41976.0;8586.0;50562.0
250205;201806;22;19;3;18126.0;2862.0;20988.0
250210;201806;90;78;12;74412.0;11448.0;85860.0
250215;201806;63;54;9;51516.0;8586.0;60102.0
250220;201806;27;21;6;20034.0;5724.0;25758.0
250230;201806;78;71;7;67730.0;6678.0;74408.0
250240;201806;244;203;41;192851.1;39114.0;231965.1
250250;201806;396;338;58;322452.0;55332.0;377784.0
250260;201806;31;28;3;26712.0;2862.0;29574.0
250270;201806;57;45;12;42930.0;11448.0;54378.0
250280;201806;379;317;62;302418.0;59148.0;361566.0
250290;201806;95;90;5;85573.8;4770.0;90343.8
250300;201806;556;380;176;361872.72;167891.0;529763.7
250310;201806;47;42;5;40068.0;4770.0;44838.0
250320;201806;1991;1359;632;1291231.4;601354.8;1892586.1
250330;201806;84;75;9;71550.0;8586.0;80136.0
250340;201806;24;20;4;19080.0;3816.0;22896.0
250350;201806;139;89;50;84619.8;47127.6;131747.4
250355;201806;31;24;7;22896.0;6678.0;29574.0
250360;201806;199;163;36;155502.0;34106.0;189608.0
250370;201806;2376;1606;770;1527166.0;733023.8;2260189.8
250375;201806;16;12;4;11448.0;3816.0;15264.0
250380;201806;53;37;16;35298.0;15264.0;50562.0
250390;201806;42;34;8;32436.0;7632.0;40068.0
250400;201806;15751;7979;7772;7586266.0;7408039.5;1,50E+14
250403;201806;418;342;76;326258.47;72504.0;398762.47
250407;201806;58;50;8;47700.0;7632.0;55332.0
250410;201806;32;27;5;25758.0;4770.0;30528.0
250415;201806;43;29;14;27646.92;13336.92;40983.84
250420;201806;46;38;8;36252.0;7632.0;43884.0
250430;201806;1528;1301;227;1238961.0;216558.0;1455519.0
250435;201806;16;13;3;12402.0;2862.0;15264.0
250440;201806;692;595;97;563697.25;92538.0;656235.25
250450;201806;88;73;15;69642.0;13642.2;83284.2
250460;201806;418;287;131;273798.0;124964.46;398762.47
250470;201806;86;63;23;60102.0;21942.0;82044.0
250480;201806;325;257;68;245178.0;64872.0;310050.0
250485;201806;2;1;1;954.0;954.0;1908.0
250490;201806;209;171;38;163134.0;36252.0;199386.0
250500;201806;77;57;20;54378.0;19080.0;73458.0
250510;201806;736;579;157;551603.0;148769.44;700372.44
250520;201806;173;120;53;114460.92;50557.23;165018.16
250523;201806;113;94;19;89676.0;18126.0;107802.0
250527;201806;102;81;21;77269.23;20034.0;97303.23
250530;201806;7;5;2;4770.0;1908.0;6678.0
250535;201806;25;21;4;20034.0;3816.0;23850.0
250540;201806;121;92;29;87052.5;27666.0;114718.5
250550;201806;70;67;3;63918.0;2862.0;66780.0
250560;201806;39;31;8;29574.0;7632.0;37206.0
250570;201806;150;120;30;114480.0;28620.0;143100.0
250580;201806;131;103;28;98037.8;26712.0;124749.8
250590;201806;20;16;4;15264.0;3816.0;19080.0
250600;201806;1239;833;406;792775.4;387228.6;1180004.0
250610;201806;150;130;20;124020.0;19080.0;143100.0
250620;201806;22;18;4;17172.0;3816.0;20988.0
250625;201806;65;49;16;46746.0;15264.0;62010.0
250630;201806;3017;1937;1080;1839855.6;1029252.75;2869108.5
250640;201806;203;169;34;161226.0;32436.0;193662.0
250650;201806;31;21;10;20034.0;9540.0;29574.0
250660;201806;45;35;10;33390.0;9540.0;42930.0
250670;201806;61;40;21;38160.0;20034.0;58194.0
250680;201806;382;315;67;300510.0;63918.0;364428.0
250690;201806;1843;1272;571;1210020.9;544352.8;1754373.8
250700;201806;928;818;110;777899.6;104730.12;882629.75
250710;201806;449;349;100;332946.0;95400.0;428346.0
250720;201806;104;82;22;78228.0;20988.0;99216.0
250730;201806;379;318;61;302418.6;58194.0;360612.6
250740;201806;52;48;4;45792.0;3816.0;49608.0
250750;201806;20533;12323;8210;1,17E+14;7822797.0;1,95E+14
250760;201806;74;55;19;52470.0;18126.0;70596.0
250770;201806;350;229;121;216558.14;113025.55;329583.7
250780;201806;54;41;13;39114.0;12402.0;51516.0
250790;201806;469;306;163;290016.9;154786.5;444803.4
250800;201806;155;142;13;134752.5;12402.0;147154.5
250810;201806;78;60;18;57240.0;17172.0;74412.0
250820;201806;160;130;30;124020.0;28620.0;152640.0
250830;201806;418;286;132;271842.5;125928.0;397770.5
250840;201806;53;51;2;48654.0;1908.0;50562.0
250850;201806;55;43;12;40335.12;11448.0;51783.12
250855;201806;14;12;2;11448.0;1908.0;13356.0
250860;201806;202;145;57;138330.0;54091.8;192421.8
250870;201806;33;30;3;28620.0;2862.0;31482.0
250880;201806;79;61;18;58184.46;17172.0;75356.46
250890;201806;2430;1793;637;1708824.8;606834.75;2315659.5
250900;201806;121;103;18;98262.0;17172.0;115434.0
250905;201806;124;96;28;91584.0;26712.0;118296.0
250910;201806;1176;836;340;796381.3;323787.8;1120169.1
250915;201806;110;76;34;72504.0;32436.0;104940.0
250920;201806;138;107;31;102078.0;29574.0;131652.0
250930;201806;162;99;63;94446.0;60102.0;154548.0
250933;201806;1;1;0;954.0;0.0;954.0
250937;201806;6;5;1;4770.0;954.0;5724.0
250939;201806;31;22;9;20988.0;8586.0;29574.0
250940;201806;103;76;27;72504.0;25758.0;98262.0
250950;201806;70;47;23;44838.0;21942.0;66780.0
250960;201806;90;49;41;46746.0;39114.0;85860.0
250970;201806;1212;864;348;822635.0;331038.0;1153673.0
250980;201806;91;64;27;61056.0;25758.0;86814.0
250990;201806;165;129;36;122593.77;34301.07;156894.84
251000;201806;76;68;8;64681.2;7632.0;72313.2
251010;201806;103;80;23;76316.0;21163.53;97479.53
251020;201806;80;70;10;65969.1;9540.0;75509.1
251030;201806;43;33;10;31482.0;9540.0;41022.0
251040;201806;53;38;15;36252.0;14310.0;50562.0
251050;201806;23;21;2;20034.0;1908.0;21942.0
251060;201806;51;40;11;37206.0;10494.0;47700.0
251065;201806;3;3;0;2862.0;0.0;2862.0
251070;201806;25;20;5;19071.0;4770.0;23841.0
251080;201806;4705;2278;2427;2162548.8;2308805.0;4471353.5
251090;201806;197;169;28;161226.0;26712.0;187938.0
251100;201806;18;17;1;16218.0;954.0;17172.0
251110;201806;46;37;9;35298.0;8586.0;43884.0
251120;201806;1817;1103;714;1047352.2;681156.0;1728508.2
251130;201806;385;313;72;298492.28;68688.0;367180.28
251140;201806;516;334;182;317492.8;173459.34;490952.12
251150;201806;295;256;39;243452.0;37206.0;280658.0
251160;201806;95;80;15;76316.0;14310.0;90626.0
251170;201806;98;78;20;74383.38;19075.23;93458.61
251180;201806;288;181;107;172665.23;102069.23;274734.47
251190;201806;191;130;61;123691.83;58194.0;181885.83
251200;201806;255;207;48;197478.0;45792.0;243270.0
251203;201806;34;32;2;30528.0;1908.0;32436.0
251207;201806;95;79;16;75366.0;15264.0;90630.0
251210;201806;1414;1016;398;967710.5;379024.2;1346734.8
251220;201806;47;37;10;35298.0;9540.0;44838.0
251230;201806;469;391;78;373014.0;74412.0;447426.0
251240;201806;100;72;28;67734.0;26712.0;94446.0
251250;201806;1342;961;381;913904.9;363331.0;1277235.9
251260;201806;13;8;5;7632.0;4770.0;12402.0
251270;201806;343;256;87;244224.0;82855.0;327079.0
251272;201806;63;58;5;55332.0;4770.0;60102.0
251274;201806;27;22;5;20988.0;4770.0;25758.0
251275;201806;23;16;7;15264.0;6678.0;21942.0
251276;201806;17;13;4;12402.0;3816.0;16218.0
251278;201806;9;7;2;6678.0;1908.0;8586.0
251280;201806;100;95;5;90630.0;4770.0;95400.0
251290;201806;705;532;173;507528.0;165042.0;672570.0
251300;201806;16;14;2;13356.0;1908.0;15264.0
251310;201806;366;263;103;250898.0;98262.0;349160.0
251315;201806;19;18;1;17172.0;954.0;18126.0
251320;201806;60;49;11;46746.0;10494.0;57240.0
251330;201806;81;72;9;68688.0;8586.0;77274.0
251335;201806;12;7;5;6678.0;4770.0;11448.0
251340;201806;697;411;286;392094.0;271819.25;663913.25
251350;201806;37;35;2;33390.0;1908.0;35298.0
251360;201806;68;60;8;57033.94;7632.0;64665.94
251365;201806;15;14;1;13356.0;954.0;14310.0
251370;201806;5300;3604;1696;3433902.0;1616650.0;5050552.0
251380;201806;50;40;10;38160.0;9540.0;47700.0
251385;201806;3;3;0;2862.0;0.0;2862.0
251390;201806;684;543;141;516878.2;133274.0;650152.2
251392;201806;12;7;5;6678.0;4770.0;11448.0
251394;201806;10;10;0;9540.0;0.0;9540.0
251396;201806;14;9;5;8586.0;4770.0;13356.0
251398;201806;18;15;3;14310.0;2862.0;17172.0
251400;201806;41;34;7;32436.0;6678.0;39114.0
251410;201806;36;31;5;29574.0;4770.0;34344.0
251420;201806;104;78;26;74412.0;24804.0;99216.0
251430;201806;39;37;2;35298.0;1908.0;37206.0
251440;201806;33;22;11;20988.0;10494.0;31482.0
251445;201806;54;49;5;46746.0;4770.0;51516.0
251450;201806;419;370;49;351324.8;46746.0;398070.8
251455;201806;2;1;1;954.0;954.0;1908.0
251460;201806;16;12;4;11448.0;3816.0;15264.0
251465;201806;5;2;3;1908.0;2862.0;4770.0
251470;201806;47;37;10;35298.0;9540.0;44838.0
251480;201806;26;24;2;22896.0;1908.0;24804.0
251490;201806;124;86;38;81567.0;35299.0;116866.0
251500;201806;119;95;24;90630.0;22133.0;112763.0
251510;201806;38;29;9;27666.0;8586.0;36252.0
251520;201806;25;25;0;23850.0;0.0;23850.0
251530;201806;4530;3187;1343;3033812.2;1280926.2;4314738.5
251540;201806;74;65;9;62010.0;8586.0;70596.0
251550;201806;412;319;93;303372.2;88198.0;391570.2
251560;201806;24;17;7;16218.0;6678.0;22896.0
251570;201806;19;19;0;18126.0;0.0;18126.0
251580;201806;121;99;22;94446.0;20988.0;115434.0
251590;201806;123;92;31;87949.0;29574.0;117523.0
251593;201806;21;12;9;11448.0;8586.0;20034.0
251597;201806;54;44;10;41976.0;9540.0;51516.0
251600;201806;1096;775;321;737858.5;304625.9;1042484.4
251610;201806;209;158;51;150732.0;47987.0;198719.0
251615;201806;4;3;1;2862.0;954.0;3816.0
251620;201806;4244;2830;1414;2689979.8;1346191.0;4036170.8
251630;201806;451;333;118;317682.0;112563.0;430245.0
251640;201806;150;105;45;100170.0;42930.0;143100.0
251650;201806;267;194;73;183243.1;69642.0;252885.1
251660;201806;225;203;22;192708.1;20797.2;213505.3
251670;201806;357;277;80;262562.0;76320.0;338882.0
251675;201806;3;3;0;2862.0;0.0;2862.0
251680;201806;96;87;9;82998.0;8586.0;91584.0
251690;201806;340;284;56;269982.0;53073.89;323055.88
251700;201806;279;234;45;222649.3;42915.69;265564.97
251710;201806;20;14;6;13356.0;5724.0;19080.0
251720;201806;32;22;10;20988.0;9254.0;30242.0
251740;201806;10;8;2;7632.0;1908.0;9540.0
260005;201806;3148;1785;1363;1691801.4;1299394.1;2991195.5
260010;201806;1477;1058;419;1004573.5;397723.3;1402296.8
260020;201806;426;374;52;356796.0;49608.0;406404.0
260030;201806;582;421;161;400866.97;153594.0;554461.0
260040;201806;851;527;324;501670.44;309086.47;810756.9
260050;201806;1141;817;324;779180.0;308524.0;1087704.0
260060;201806;413;374;39;356032.8;37206.0;393238.8
260070;201806;1465;923;542;876420.0;514098.38;1390518.4
260080;201806;730;575;155;547739.1;147870.0;695609.1
260090;201806;576;358;218;341304.12;207972.0;549276.1
260100;201806;229;160;69;151830.0;65826.0;217656.0
260105;201806;232;131;101;124974.0;96354.0;221328.0
260110;201806;2760;2047;713;1952829.0;679392.0;2632221.0
260120;201806;2913;1457;1456;1380260.2;1386736.1;2766996.2
260130;201806;151;105;46;100170.0;43884.0;144054.0
260140;201806;2144;1409;735;1335694.8;699645.44;2035340.2
260150;201806;228;152;76;145008.0;72504.0;217512.0
260160;201806;298;256;42;244224.0;40068.0;284292.0
260170;201806;3382;2069;1313;1967066.6;1251218.9;3218285.5
260180;201806;140;119;21;113526.0;20034.0;133560.0
260190;201806;2286;1609;677;1531835.9;645858.0;2177694.0
260200;201806;900;740;160;705185.06;152354.0;857539.06
260210;201806;1401;997;404;950987.25;384167.12;1335154.4
260220;201806;725;663;62;632502.0;59148.0;691650.0
260230;201806;1205;913;292;868811.0;278568.0;1147379.0
260240;201806;226;172;54;162914.58;51516.0;214430.58
260250;201806;74;58;16;55332.0;15264.0;70596.0
260260;201806;994;714;280;681156.0;267120.0;948276.0
260270;201806;427;346;81;328701.2;76987.8;405689.0
260280;201806;1404;884;520;842859.0;495794.0;1338653.0
260290;201806;6387;3413;2974;3237198.2;2830486.0;6067684.5
260300;201806;869;767;102;729649.6;97022.0;826671.6
260310;201806;506;404;102;384037.47;97308.0;481345.47
260320;201806;881;665;216;634123.2;206064.0;840187.2
260330;201806;35;28;7;26712.0;6678.0;33390.0
260340;201806;69;50;19;47700.0;18126.0;65826.0
260345;201806;5669;3190;2479;3036129.8;2363889.8;5400019.5
260350;201806;476;349;127;331202.1;121158.0;452360.1
260360;201806;285;147;138;140238.0;131652.0;271890.0
260370;201806;663;432;231;409518.4;220234.0;629752.4
260380;201806;598;430;168;410220.0;159127.56;569347.56
260390;201806;296;250;46;237421.98;42930.0;280351.97
260392;201806;101;89;12;84906.0;11448.0;96354.0
260400;201806;4074;2345;1729;2227462.5;1649085.6;3876548.0
260410;201806;14620;7715;6905;7344261.5;6584639.0;1,39E+14
260415;201806;122;110;12;104940.0;11448.0;116388.0
260420;201806;1785;1069;716;1014787.2;681267.6;1696054.9
260430;201806;191;176;15;166692.66;14310.0;181002.66
260440;201806;228;166;62;157640.0;59148.0;216788.0
260450;201806;475;344;131;326891.0;124974.0;451865.0
260460;201806;847;449;398;425676.8;379687.22;805364.0
260470;201806;373;228;145;216748.8;137949.0;354697.8
260480;201806;206;128;78;122112.0;74412.0;196524.0
260490;201806;209;169;40;161226.0;38160.0;199386.0
260500;201806;1136;763;373;725614.2;354745.8;1080360.0
260510;201806;745;590;155;561645.56;146916.0;708561.56
260515;201806;260;232;28;221328.0;26235.0;247563.0
260520;201806;3326;1974;1352;1875896.5;1287605.6;3163502.2
260530;201806;792;642;150;609975.6;143100.0;753075.6
260540;201806;570;435;135;414990.0;127836.72;542826.75
260545;201806;13;10;3;9540.0;2862.0;12402.0
260550;201806;346;215;131;205110.0;124974.0;330084.0
260560;201806;516;386;130;367958.0;123733.8;491691.8
260570;201806;1013;833;180;791796.8;171433.8;963230.6
260580;201806;262;234;28;223236.0;26712.0;249948.0
260590;201806;662;380;282;361108.1;269028.0;630136.06
260600;201806;8200;4179;4021;3966216.8;3832165.5;7798382.0
260610;201806;496;333;163;317682.0;155215.8;472897.8
260620;201806;3655;1912;1743;1812597.2;1660557.1;3473154.5
260630;201806;77;74;3;70596.0;2862.0;73458.0
260640;201806;3692;2012;1680;1915684.6;1602663.2;3518348.0
260650;201806;331;233;98;222282.0;93449.07;315731.06
260660;201806;508;346;162;329702.4;153927.9;483630.3
260670;201806;102;76;26;72504.0;24804.0;97308.0
260680;201806;3664;2049;1615;1937862.4;1540366.9;3478229.2
260690;201806;121;95;26;90630.0;24804.0;115434.0
260700;201806;326;198;128;188128.8;121278.0;309406.8
260710;201806;38;35;3;33390.0;2862.0;36252.0
260720;201806;2245;1345;900;1276923.8;857808.2;2134731.8
260730;201806;611;461;150;439794.0;140905.8;580699.8
260740;201806;62;58;4;55332.0;3816.0;59148.0
260750;201806;640;446;194;425159.62;185076.0;610235.6
260760;201806;624;337;287;321498.0;273798.0;595296.0
260765;201806;985;518;467;490943.8;445279.5;936223.3
260770;201806;220;165;55;157410.0;52470.0;209880.0
260775;201806;820;487;333;463215.8;317673.0;780888.8
260780;201806;271;174;97;165996.0;92538.0;258534.0
260790;201806;12321;6784;5537;6445627.5;5274728.0;1,17E+14
260795;201806;168;116;52;109500.12;49608.0;159108.12
260800;201806;283;232;51;220851.0;48654.0;269505.0
260805;201806;172;110;62;104211.14;59148.0;163359.14
260810;201806;741;645;96;614080.25;91584.0;705664.25
260820;201806;316;214;102;202826.8;97308.0;300134.78
260825;201806;201;137;64;130524.57;61056.0;191580.56
260830;201806;265;172;93;164088.0;88722.0;252810.0
260840;201806;233;168;65;159605.0;61939.0;221544.0
260845;201806;211;147;64;140238.0;61056.0;201294.0
260850;201806;502;363;139;344638.1;132606.0;477244.1
260860;201806;254;191;63;182016.34;60102.0;242118.34
260870;201806;373;270;103;256340.42;98262.0;354602.4
260875;201806;707;497;210;473024.7;200340.0;673364.7
260880;201806;1583;963;620;916973.3;591289.2;1508262.5
260890;201806;2429;1691;738;1606774.0;703099.0;2309873.0
260900;201806;1038;715;323;680807.8;308142.0;988949.8
260910;201806;277;217;60;207018.0;57240.0;264258.0
260915;201806;303;204;99;194616.0;94326.0;288942.0
260920;201806;176;100;76;95400.0;72504.0;167904.0
260930;201806;390;334;56;318636.0;53338.45;371974.44
260940;201806;2796;1527;1269;1452563.9;1210129.9;2662693.8
260950;201806;2027;1175;852;1114597.9;812808.0;1927405.9
260960;201806;14275;7434;6841;7058585.0;6518839.5;1,36E+14
260970;201806;438;375;63;356961.0;60102.0;417063.0
260980;201806;194;171;23;162848.0;21942.0;184790.0
260990;201806;2563;2112;451;2013103.2;429586.2;2442689.5
261000;201806;4370;2584;1786;2451922.8;1702030.9;4153953.8
261010;201806;186;136;50;129744.0;46882.23;176626.23
261020;201806;612;459;153;437743.0;145962.0;583705.0
261030;201806;223;161;62;153594.0;58914.27;212508.27
261040;201806;362;324;38;309096.0;35965.8;345061.8
261050;201806;471;413;58;394002.0;55332.0;449334.0
261060;201806;1329;875;454;833558.75;433116.0;1266674.8
261070;201806;9058;4599;4459;4363393.0;4245102.5;8608495.0
261080;201806;403;293;110;278750.0;104940.0;383690.0
261090;201806;2246;1726;520;1638224.0;495308.0;2133532.0
261100;201806;1092;768;324;730621.8;307226.16;1037847.94
261110;201806;8098;4941;3157;4709389.0;3009097.0;7718486.0
261120;201806;273;227;46;216558.0;43879.23;260437.23
261130;201806;568;332;236;316204.1;224954.0;541158.1
261140;201806;187;121;66;115434.0;62964.0;178398.0
261150;201806;666;392;274;373968.0;261396.0;635364.0
261153;201806;74;70;4;65826.31;3816.0;69642.31
261160;201806;77183;38965;38218;3,71E+12;3,64E+14;7,35E+14
261170;201806;450;338;112;321822.38;106848.0;428670.38
261180;201806;1770;1087;683;1031875.6;651582.0;1683457.6
261190;201806;612;423;189;403145.9;180297.0;583442.94
261200;201806;214;188;26;178587.3;24804.0;203391.3
261210;201806;35;32;3;30528.0;2862.0;33390.0
261220;201806;2566;1812;754;1722476.9;718743.8;2441220.5
261230;201806;329;240;89;228960.0;84891.69;313851.7
261240;201806;447;386;61;364230.94;58194.0;422424.94
261245;201806;225;189;36;180306.0;34344.0;214650.0
261247;201806;155;118;37;112572.0;35298.0;147870.0
261250;201806;2866;1463;1403;1394891.8;1337351.9;2732243.8
261255;201806;252;229;23;218466.0;21942.0;240408.0
261260;201806;868;746;122;711684.0;116388.0;828072.0
261270;201806;173;135;38;128790.0;36252.0;165042.0
261280;201806;159;132;27;125928.0;25758.0;151686.0
261290;201806;126;87;39;82759.5;37206.0;119965.5
261300;201806;1225;873;352;832842.0;335808.0;1168650.0
261310;201806;765;510;255;486540.0;242649.9;729189.9
261320;201806;538;363;175;346016.0;166950.0;512966.0
261330;201806;864;684;180;649537.5;170874.45;820411.94
261340;201806;307;174;133;165996.0;126882.0;292878.0
261350;201806;798;572;226;544734.2;215604.0;760338.2
261360;201806;1231;799;432;761844.4;411842.0;1173686.4
261370;201806;4996;3078;1918;2921296.5;1826850.5;4748147.0
261380;201806;574;423;151;401643.62;143768.0;545411.6
261390;201806;3448;2297;1151;2187360.2;1094606.5;3281966.8
261400;201806;279;252;27;239835.6;25758.0;265593.6
261410;201806;1079;714;365;681156.0;348205.22;1029361.25
261420;201806;890;558;332;531065.25;316709.47;847774.75
261430;201806;331;301;30;286308.0;28333.8;314641.8
261440;201806;116;105;11;100170.0;10494.0;110664.0
261450;201806;2499;2081;418;1982614.2;398524.03;2381138.2
261460;201806;721;575;146;547596.0;139284.0;686880.0
261470;201806;251;192;59;182358.0;56286.0;238644.0
261480;201806;363;294;69;279237.0;65822.0;345059.0
261485;201806;339;208;131;197764.2;124974.0;322738.2
261500;201806;625;423;202;403542.0;192708.0;596250.0
261510;201806;46;31;15;29574.0;14310.0;43884.0
261520;201806;112;98;14;93492.0;13356.0;106848.0
261530;201806;4172;2645;1527;2515134.0;1455504.8;3970638.8
261540;201806;1090;672;418;640624.4;398772.0;1039396.4
261550;201806;285;144;141;136137.0;134494.92;270631.9
261560;201806;799;534;265;506480.2;251656.6;758136.8
261570;201806;371;288;83;274752.0;79182.0;353934.0
261580;201806;377;297;80;282492.38;76320.0;358812.38
261590;201806;194;157;37;149778.0;35298.0;185076.0
261600;201806;294;237;57;225335.0;53901.0;279236.0
261610;201806;105;91;14;86337.0;13356.0;99693.0
261618;201806;65;51;14;48654.0;13356.0;62010.0
261620;201806;201;123;78;117342.0;74412.0;191754.0
261630;201806;589;453;136;429801.6;129744.0;559545.6
261640;201806;6344;3369;2975;3206665.0;2834536.0;6041201.0
261650;201806;489;311;178;296016.66;169812.0;465828.66
270010;201806;530;469;61;447140.0;57431.0;504571.0
270020;201806;305;242;63;230864.0;60102.0;290966.0
270030;201806;9210;5886;3324;5600760.0;3168653.0;8769413.0
270040;201806;1983;1216;767;1159863.6;730477.8;1890341.5
270050;201806;178;131;47;124974.0;44838.0;169812.0
270060;201806;116;65;51;62010.0;48654.0;110664.0
270070;201806;900;654;246;622101.8;234379.27;856481.06
270080;201806;38;32;6;30528.0;5724.0;36252.0
270090;201806;20;16;4;15264.0;3816.0;19080.0
270100;201806;1249;828;421;786913.5;399487.7;1186401.2
270110;201806;146;108;38;103032.0;36252.0;139284.0
270120;201806;225;185;40;175638.55;38160.0;213798.55
270130;201806;248;171;77;162561.6;73458.0;236019.6
270135;201806;99;61;38;58194.0;36252.0;94446.0
270140;201806;1301;787;514;750577.2;489393.2;1239970.4
270150;201806;266;212;54;202248.0;51516.0;253764.0
270160;201806;522;390;132;372060.0;125260.2;497320.2
270170;201806;727;468;259;446185.8;245845.8;692031.6
270180;201806;71;55;16;52152.04;15054.12;67206.16
270190;201806;102;89;13;84906.0;12402.0;97308.0
270200;201806;107;96;11;91393.2;10494.0;101887.2
270210;201806;481;249;232;237546.0;221041.8;458587.8
270220;201806;184;144;40;137376.0;38160.0;175536.0
270230;201806;2111;1262;849;1199777.2;808038.6;2007815.9
270235;201806;738;557;181;531107.56;172308.95;703416.56
270240;201806;3123;2428;695;2304719.8;660238.0;2964957.8
270250;201806;170;118;52;112572.0;49608.0;162180.0
270255;201806;225;192;33;183168.0;31100.4;214268.4
270260;201806;329;261;68;248994.0;64872.0;313866.0
270270;201806;112;46;66;43875.0;62964.0;106839.0
270280;201806;202;124;78;118296.0;74392.92;192688.92
270290;201806;1181;888;293;845916.44;278645.47;1124561.9
270300;201806;285;183;102;174582.0;97021.8;271603.8
270310;201806;916;737;179;701747.25;170051.58;871798.8
270320;201806;879;751;128;714178.4;121825.8;836004.2
270330;201806;275;229;46;217512.0;43884.0;261396.0
270340;201806;60;48;12;45792.0;11448.0;57240.0
270350;201806;93;47;46;44599.5;43884.0;88483.5
270360;201806;72;40;32;38160.0;30528.0;68688.0
270370;201806;51;39;12;37206.0;11448.0;48654.0
270375;201806;69;39;30;37206.0;28620.0;65826.0
270380;201806;1078;612;466;582894.0;444564.0;1027458.0
270390;201806;196;109;87;103986.0;82998.0;186984.0
270400;201806;701;511;190;486279.28;181260.0;667539.25
270410;201806;698;500;198;476682.03;188882.45;665564.5
270420;201806;401;260;141;246342.0;134429.38;380771.38
270430;201806;32593;23286;9307;2,22E+14;8871386.0;3,10E+14
270440;201806;495;388;107;370152.0;101791.8;471943.8
270450;201806;777;407;370;388039.5;352026.66;740066.2
270460;201806;199;153;46;145962.0;43884.0;189846.0
270470;201806;1377;921;456;878280.7;435024.0;1313304.8
270480;201806;531;429;102;406976.8;96592.5;503569.3
270490;201806;25;20;5;19080.0;4770.0;23850.0
270500;201806;513;422;91;402588.0;86814.0;489402.0
270510;201806;737;451;286;430254.0;272844.0;703098.0
270520;201806;367;226;141;215395.0;134514.0;349909.0
270530;201806;65;57;8;54378.0;7632.0;62010.0
270540;201806;123;94;29;89676.0;27666.0;117342.0
270550;201806;1728;1300;428;1239591.0;407830.22;1647421.2
270560;201806;313;146;167;139284.0;159318.0;298602.0
270570;201806;459;307;152;290667.38;145008.0;435675.38
270580;201806;82;61;21;58194.0;20034.0;78228.0
270590;201806;75;62;13;59148.0;12402.0;71550.0
270600;201806;180;148;32;141192.0;30528.0;171720.0
270610;201806;192;157;35;149769.0;33390.0;183159.0
270620;201806;30;29;1;27666.0;954.0;28620.0
270630;201806;3871;2940;931;2791803.8;886018.94;3677822.5
270640;201806;904;665;239;632706.6;227691.8;860398.4
270642;201806;212;179;33;170766.0;31482.0;202248.0
270644;201806;271;186;85;177253.73;81085.23;258338.97
270650;201806;258;153;105;145962.0;100170.0;246132.0
270660;201806;259;209;50;199386.0;47700.0;247086.0
270670;201806;3183;2421;762;2299025.5;724025.7;3023051.0
270680;201806;467;272;195;259479.0;186026.0;445505.0
270690;201806;1122;705;417;670836.94;397808.47;1068645.4
270700;201806;35;27;8;25758.0;7632.0;33390.0
270710;201806;887;669;218;636805.0;207972.0;844777.0
270720;201806;250;188;62;179352.0;58861.8;238213.8
270730;201806;1917;1109;808;1055745.4;768726.2;1824471.6
270740;201806;45;28;17;26712.0;16218.0;42930.0
270750;201806;635;465;170;443420.0;161513.0;604933.0
270760;201806;308;222;86;211788.0;82044.0;293832.0
270770;201806;2768;1765;1003;1676517.2;955908.0;2632425.2
270780;201806;92;57;35;54373.23;33372.46;87745.69
270790;201806;265;178;87;169812.0;82998.0;252810.0
270800;201806;1969;1573;396;1498849.2;377039.88;1875889.1
270810;201806;304;240;64;228945.69;61047.23;289992.9
270820;201806;158;102;56;97308.0;53329.0;150637.0
270830;201806;912;661;251;629827.0;239168.0;868995.0
270840;201806;1406;1031;375;982834.9;356082.0;1338916.9
270850;201806;1656;1013;643;960240.4;613403.44;1573643.9
270860;201806;2455;1598;857;1521653.6;814680.56;2336334.2
270870;201806;120;65;55;62010.0;52470.0;114480.0
270880;201806;919;681;238;647829.1;226158.58;873987.75
270890;201806;349;254;95;241867.62;90625.23;332492.84
270895;201806;73;63;10;60102.0;9540.0;69642.0
270900;201806;104;80;24;76320.0;22896.0;99216.0
270910;201806;324;257;67;244033.2;63918.0;307951.2
270915;201806;1838;1103;735;1047364.1;700709.6;1748073.8
270920;201806;478;402;76;383508.0;72504.0;456012.0
270930;201806;6182;4478;1704;4266494.5;1622835.2;5889329.5
270940;201806;2395;1817;578;1731448.9;550440.0;2281889.0
280010;201806;43;38;5;36252.0;4770.0;41022.0
280020;201806;713;617;96;585438.1;90630.0;676068.1
280030;201806;19553;12518;7035;1,19E+14;6682854.0;1,85E+14
280040;201806;339;214;125;204156.0;117819.0;321975.0
280050;201806;376;288;88;274465.8;83952.0;358417.8
280060;201806;334;221;113;208587.44;107802.0;316389.44
280067;201806;990;696;294;661225.94;279522.25;940748.2
280070;201806;129;108;21;103032.0;20034.0;123066.0
280100;201806;622;491;131;465383.47;124784.0;590167.5
280110;201806;75;70;5;66780.0;4770.0;71550.0
280120;201806;628;503;125;479862.0;119250.0;599112.0
280130;201806;1370;856;514;815193.8;490212.9;1305406.8
280140;201806;474;385;89;365285.78;83952.0;449237.78
280150;201806;326;242;84;229424.89;80136.0;309560.88
280160;201806;96;82;14;78228.0;13356.0;91584.0
280170;201806;600;395;205;375633.56;195570.0;571203.56
280190;201806;27;25;2;23850.0;1908.0;25758.0
280200;201806;26;18;8;17172.0;7632.0;24804.0
280210;201806;2758;1946;812;1837914.5;769080.5;2606995.0
280220;201806;41;31;10;29574.0;9540.0;39114.0
280230;201806;319;263;56;250067.62;53424.0;303491.62
280240;201806;115;109;6;103842.9;5724.0;109566.9
280250;201806;18;11;7;10494.0;6678.0;17172.0
280260;201806;80;69;11;65826.0;10494.0;76320.0
280270;201806;160;123;37;117342.0;35298.0;152640.0
280280;201806;192;124;68;118296.0;64872.0;183168.0
280290;201806;3101;2239;862;2124329.8;820927.4;2945257.2
280300;201806;1108;842;266;800840.06;253000.8;1053840.9
280310;201806;109;104;5;98885.29;4770.0;103655.29
280320;201806;653;445;208;424521.0;198432.0;622953.0
280330;201806;359;258;101;246132.0;96229.98;342361.97
280340;201806;424;339;85;321934.56;80327.0;402261.56
280350;201806;3456;2666;790;2531872.2;750921.06;3282793.2
280360;201806;462;290;172;276660.0;163134.0;439794.0
280370;201806;97;86;11;82044.0;10494.0;92538.0
280380;201806;56;42;14;40068.0;13356.0;53424.0
280390;201806;186;155;31;147870.0;29574.0;177444.0
280400;201806;343;234;109;222330.1;103986.0;326316.1
280410;201806;288;233;55;221329.0;52470.0;273799.0
280420;201806;172;144;28;137357.0;26712.0;164069.0
280430;201806;111;82;29;78228.0;27557.63;105785.63
280440;201806;686;532;154;503618.6;146715.66;650334.25
280445;201806;116;108;8;103032.0;7632.0;110664.0
280450;201806;1107;945;162;898135.44;154548.0;1052683.5
280460;201806;761;558;203;525236.5;193662.0;718898.5
280470;201806;189;173;16;165042.0;14311.0;179353.0
280480;201806;2276;1612;664;1521992.4;630511.8;2152504.0
280490;201806;353;325;28;308658.0;26712.0;335370.0
280500;201806;43;39;4;37206.0;3816.0;41022.0
280510;201806;142;111;31;105593.2;29288.0;134881.2
280520;201806;54;40;14;38160.0;13356.0;51516.0
280530;201806;78;55;23;52470.0;21942.0;74412.0
280540;201806;508;408;100;388975.8;95113.8;484089.6
280550;201806;707;654;53;623176.5;50562.0;673738.5
280560;201806;487;425;62;402731.1;59148.0;461879.1
280570;201806;1780;1352;428;1285602.5;407456.84;1693059.2
280580;201806;599;457;142;434298.6;135373.0;569671.6
280590;201806;165;102;63;97028.48;60102.0;157130.48
280600;201806;361;303;58;289062.0;55332.0;344394.0
280610;201806;139;105;34;99964.0;32436.0;132400.0
280620;201806;550;451;99;429300.5;94302.9;523603.4
280630;201806;166;138;28;131652.0;26712.0;158364.0
280640;201806;207;166;41;157535.0;39114.0;196649.0
280650;201806;78;53;25;50562.0;23850.0;74412.0
280660;201806;131;94;37;89676.0;35059.5;124735.5
280670;201806;1640;1022;618;967077.4;585827.94;1552905.2
280680;201806;185;158;27;148948.14;25758.0;174706.14
280690;201806;54;45;9;42930.0;8586.0;51516.0
280700;201806;19;19;0;18126.0;0.0;18126.0
280710;201806;1410;1071;339;1015136.4;323406.0;1338542.4
280720;201806;110;74;36;68036.4;34344.0;102380.4
280730;201806;27;23;4;21942.0;3816.0;25758.0
280740;201806;2432;1799;633;1709757.2;602776.44;2312533.8
280750;201806;296;257;39;245178.0;37206.0;282384.0
280760;201806;883;607;276;577550.75;263304.0;840854.75
290010;201806;204;137;67;130698.0;63918.0;194616.0
290020;201806;179;166;13;158364.0;12402.0;170766.0
290030;201806;594;387;207;368530.2;197478.0;566008.2
290035;201806;138;112;26;103643.7;24804.0;128447.7
290040;201806;276;173;103;165042.0;98262.0;263304.0
290050;201806;81;61;20;58194.0;19080.0;77274.0
290060;201806;255;114;141;108469.8;134514.0;242983.8
290070;201806;5615;2768;2847;2633233.8;2712754.8;5345988.5
290080;201806;499;224;275;213390.72;262331.0;475721.72
290090;201806;390;170;220;162180.0;209880.0;372060.0
290100;201806;1597;1055;542;1002275.1;516495.8;1518770.9
290110;201806;768;455;313;432444.2;298073.3;730517.5
290115;201806;212;195;17;185076.0;16218.0;201294.0
290120;201806;774;501;273;477286.2;260442.0;737728.2
290130;201806;412;244;168;232480.27;160272.0;392752.25
290135;201806;297;225;72;213972.66;68688.0;282660.66
290140;201806;301;250;51;238500.0;48463.2;286963.2
290150;201806;131;99;32;94446.0;30528.0;124974.0
290160;201806;249;191;58;180974.58;55332.0;236306.58
290170;201806;89;64;25;61056.0;23850.0;84906.0
290180;201806;157;123;34;117342.0;32436.0;149778.0
290190;201806;448;364;84;346970.0;79849.8;426819.8
290195;201806;314;187;127;178398.0;121158.0;299556.0
290200;201806;279;233;46;222282.0;43884.0;266166.0
290205;201806;142;88;54;83952.0;51516.0;135468.0
290210;201806;1135;823;312;783998.2;297648.0;1081646.2
290220;201806;224;125;99;118773.0;94446.0;213219.0
290225;201806;289;110;179;104940.0;170766.0;275706.0
290230;201806;65;43;22;41022.0;20988.0;62010.0
290240;201806;307;121;186;115147.8;177444.0;292591.8
290250;201806;272;245;27;233034.0;25758.0;258792.0
290260;201806;289;235;54;223141.0;51230.0;274371.0
290265;201806;181;151;30;143237.0;28620.0;171857.0
290270;201806;1392;1149;243;1094286.2;230959.0;1325245.2
290280;201806;471;345;126;329130.0;120204.0;449334.0
290290;201806;1233;718;515;679169.9;491310.0;1170479.9
290300;201806;448;379;69;361275.22;65826.0;427101.22
290310;201806;318;142;176;135468.0;167904.0;303372.0
290320;201806;3985;2476;1509;2358447.8;1437678.2;3796126.0
290323;201806;187;162;25;154262.0;23850.0;178112.0
290327;201806;154;122;32;116116.11;30528.0;146644.11
290330;201806;77;43;34;41022.0;32436.0;73458.0
290340;201806;906;361;545;343421.0;519644.0;863065.0
290350;201806;594;352;242;335808.0;230868.0;566676.0
290360;201806;370;277;93;262351.7;88722.0;351073.7
290370;201806;907;365;542;348210.0;517054.0;865264.0
290380;201806;310;190;120;181260.0;114480.0;295740.0
290390;201806;2499;1558;941;1483359.6;895520.0;2378879.5
290395;201806;242;135;107;128265.8;102078.0;230343.8
290400;201806;281;208;73;198146.0;69642.0;267788.0
290405;201806;252;220;32;209880.0;30528.0;240408.0
290410;201806;576;493;83;467317.62;79182.0;546499.6
290420;201806;237;187;50;178398.0;47700.0;226098.0
290430;201806;495;311;184;296694.0;175536.0;472230.0
290440;201806;72;64;8;61056.0;7632.0;68688.0
290450;201806;231;177;54;168858.0;51516.0;220374.0
290460;201806;1881;1120;761;1066611.8;725231.3;1791843.1
290470;201806;1441;608;833;578903.25;794367.4;1373270.6
290475;201806;589;548;41;521639.0;39114.0;560753.0
290480;201806;289;160;129;152640.0;123066.0;275706.0
290485;201806;231;214;17;204156.0;16218.0;220374.0
290490;201806;1168;842;326;803268.0;310050.2;1113318.2
290500;201806;684;348;336;331038.0;320544.0;651582.0
290510;201806;221;169;52;160558.2;49608.0;210166.2
290515;201806;135;80;55;76320.0;52470.0;128790.0
290520;201806;1414;917;497;871993.5;470610.22;1342603.8
290530;201806;311;283;28;269982.0;26712.0;296694.0
290540;201806;95;57;38;54378.0;36252.0;90630.0
290550;201806;152;127;25;121158.0;23783.22;144941.22
290560;201806;3354;1366;1988;1301866.8;1896357.6;3198224.2
290570;201806;5983;3053;2930;2907950.8;2792215.0;5700166.0
290580;201806;1280;758;522;721891.8;497272.5;1219164.2
290590;201806;539;445;94;423739.0;89676.0;513415.0
290600;201806;1725;1194;531;1134375.0;506545.38;1640920.4
290610;201806;217;195;22;185811.0;20988.0;206799.0
290620;201806;329;292;37;278568.0;35298.0;313866.0
290630;201806;2066;886;1180;842096.7;1121319.2;1963416.0
290640;201806;151;124;27;118296.0;25758.0;144054.0
290650;201806;1722;808;914;769869.0;871956.0;1641825.0
290660;201806;285;231;54;220374.0;51516.0;271890.0
290670;201806;998;518;480;493600.0;457574.38;951174.4
290680;201806;1196;962;234;916507.8;222282.0;1138789.8
290682;201806;293;214;79;203836.3;75347.46;279183.75
290685;201806;233;150;83;142146.0;79182.0;221328.0
290687;201806;930;612;318;581332.1;302418.0;883750.1
290689;201806;132;75;57;71536.0;54363.69;125899.69
290690;201806;646;263;383;250873.92;364502.8;615376.75
290700;201806;238;113;125;107802.0;119250.0;227052.0
290710;201806;707;476;231;454104.0;220374.0;674478.0
290720;201806;1020;828;192;789912.0;182691.0;972603.0
290730;201806;1137;652;485;620148.5;461736.0;1081884.5
290740;201806;16;13;3;12402.0;2862.0;15264.0
290750;201806;1376;629;747;598153.25;710526.1;1308679.4
290755;201806;72;64;8;61056.0;7632.0;68688.0
290760;201806;301;260;41;248040.0;39114.0;287154.0
290770;201806;189;178;11;169802.45;10494.0;180296.45
290780;201806;987;791;196;752670.7;185171.4;937842.06
290790;201806;375;261;114;248994.0;108756.0;357750.0
290800;201806;2624;1055;1569;1003758.06;1495719.4;2499477.5
290810;201806;434;303;131;288776.0;124974.0;413750.0
290820;201806;386;236;150;224176.0;143100.0;367276.0
290830;201806;404;278;126;265212.0;120204.0;385416.0
290840;201806;1712;1054;658;1003370.8;625652.5;1629023.2
290850;201806;774;426;348;406404.0;331038.0;737442.0
290860;201806;640;286;354;272844.0;337430.0;610274.0
290870;201806;662;476;186;452883.8;177444.0;630327.8
290880;201806;125;68;57;64872.0;54378.0;119250.0
290890;201806;335;236;99;225144.0;94446.0;319590.0
290900;201806;171;129;42;123066.0;40068.0;163134.0
290910;201806;365;276;89;263304.0;84906.0;348210.0
290920;201806;231;197;34;187938.0;32436.0;220374.0
290930;201806;827;628;199;599112.0;189827.0;788939.0
290940;201806;250;206;44;195760.8;41976.0;237736.8
290950;201806;170;97;73;92538.0;69642.0;162180.0
290960;201806;449;302;147;286868.25;139951.8;426820.03
290970;201806;252;221;31;210643.2;29574.0;240217.2
290980;201806;1505;1067;438;1013749.75;416803.2;1430553.0
290990;201806;372;312;60;297619.9;57184.38;354804.3
291000;201806;870;245;625;233730.0;595963.8;829693.8
291005;201806;2143;907;1236;863217.75;1178367.0;2041584.8
291010;201806;154;138;16;131652.0;15264.0;146916.0
291020;201806;103;81;22;77274.0;20988.0;98262.0
291030;201806;94;68;26;64872.0;24804.0;89676.0
291040;201806;576;289;287;275706.0;273798.0;549504.0
291050;201806;1352;760;592;723681.44;564768.0;1288449.4
291060;201806;1494;823;671;784474.2;640134.0;1424608.2
291070;201806;1896;1402;494;1332416.5;470015.5;1802432.0
291072;201806;7355;2704;4651;2576267.5;4434880.0;7011147.5
291075;201806;206;168;38;160272.0;36252.0;196524.0
291077;201806;50;34;16;32436.0;15264.0;47700.0
291080;201806;19840;8727;11113;8303728.0;1,06E+14;1,89E+14
291085;201806;295;238;57;227052.0;54373.23;281425.22
291090;201806;304;118;186;112286.0;177434.45;289720.47
291100;201806;665;192;473;183168.0;451242.0;634410.0
291110;201806;404;303;101;289042.9;96354.0;385396.9
291120;201806;2518;1206;1312;1150381.0;1249679.5;2400060.5
291125;201806;60;30;30;28620.0;28620.0;57240.0
291130;201806;214;188;26;179352.0;24804.0;204156.0
291140;201806;134;99;35;94160.0;33104.0;127264.0
291150;201806;371;148;223;141192.0;212742.0;353934.0
291160;201806;371;308;63;292878.5;60102.0;352980.5
291165;201806;24;20;4;19080.0;3816.0;22896.0
291170;201806;2965;1482;1483;1409774.1;1411443.6;2821217.8
291180;201806;1321;510;811;486343.38;773560.7;1259904.0
291185;201806;75;73;2;69642.0;1908.0;71550.0
291190;201806;1267;550;717;522309.78;683474.8;1205784.6
291200;201806;167;123;44;117342.0;41976.0;159318.0
291210;201806;2217;870;1347;826841.3;1283226.1;2110067.5
291220;201806;272;203;69;192708.64;65826.0;258534.64
291230;201806;1024;351;673;333996.0;642042.0;976038.0
291240;201806;438;415;23;394670.0;21942.0;416612.0
291250;201806;439;358;81;341532.0;77274.0;418806.0
291260;201806;46;35;11;33390.0;10494.0;43884.0
291270;201806;1214;496;718;473184.0;684685.8;1157869.8
291280;201806;372;170;202;161974.89;192412.27;354387.16
291290;201806;1760;896;864;853345.2;823208.0;1676553.2
291300;201806;225;177;48;168190.2;45792.0;213982.2
291310;201806;227;203;24;193375.8;22896.0;216271.8
291320;201806;1400;998;402;949230.0;382459.28;1331689.2
291330;201806;130;113;17;105989.4;16218.0;122207.4
291340;201806;151;86;65;82044.0;62010.0;144054.0
291345;201806;135;87;48;82998.0;45792.0;128790.0
291350;201806;1594;526;1068;501613.2;1018681.3;1520294.5
291360;201806;8639;4267;4372;4058657.8;4168366.8;8227024.5
291370;201806;1109;615;494;586424.0;471276.0;1057700.0
291380;201806;260;204;56;194616.0;53137.8;247753.8
291390;201806;3890;1703;2187;1619276.2;2084299.8;3703576.0
291400;201806;2083;1491;592;1418788.8;563085.5;1981874.2
291410;201806;152;132;20;124974.0;19080.0;144054.0
291420;201806;114;84;30;80136.0;28620.0;108756.0
291430;201806;167;95;72;89923.0;67734.53;157657.53
291440;201806;497;398;99;376968.3;94446.0;471414.3
291450;201806;901;567;334;539678.8;317682.0;857360.8
291460;201806;1739;1408;331;1341569.4;315774.0;1657343.4
291465;201806;2212;1025;1187;977247.44;1132116.1;2109363.5
291470;201806;2776;1404;1372;1335630.5;1308158.0;2643788.5
291480;201806;11822;5219;6603;4967397.0;6290410.0;1,13E+14
291490;201806;556;233;323;222282.0;308142.0;530424.0
291500;201806;371;204;167;194616.0;159318.0;353934.0
291510;201806;1244;476;768;452943.0;732385.8;1185328.8
291520;201806;959;437;522;416898.0;497978.47;914876.44
291530;201806;1006;268;738;255672.0;703746.75;959418.75
291535;201806;115;96;19;91584.0;18126.0;109710.0
291540;201806;363;105;258;100170.0;245178.6;345348.6
291550;201806;1196;562;634;534242.1;604532.0;1138774.1
291560;201806;5520;2808;2712;2665952.0;2575083.0;5241035.0
291570;201806;203;103;100;98262.0;95400.0;193662.0
291580;201806;1218;741;477;705861.44;455044.22;1160905.8
291590;201806;84;32;52;30384.9;49608.0;79992.9
291600;201806;1365;626;739;596250.0;704702.0;1300952.0
291610;201806;1462;688;774;655068.9;738368.0;1393436.9
291620;201806;587;273;314;260442.0;299174.4;559616.4
291630;201806;494;163;331;155502.0;315774.0;471276.0
291640;201806;3914;1979;1935;1878736.9;1844632.5;3723369.5
291650;201806;415;278;137;264078.0;129898.73;393976.72
291660;201806;437;175;262;166257.95;248850.9;415108.88
291670;201806;222;142;80;134896.0;76320.0;211216.0
291680;201806;700;397;303;378738.0;288957.47;667695.44
291685;201806;589;318;271;303134.0;258343.2;561477.2
291690;201806;570;294;276;280476.0;262341.0;542817.0
291700;201806;930;731;199;696644.2;188892.0;885536.2
291710;201806;1701;795;906;757734.25;863447.06;1621181.4
291720;201806;400;264;136;251851.23;129744.0;381595.22
291730;201806;952;563;389;535432.7;371096.47;906529.2
291733;201806;263;183;80;174295.8;76320.0;250615.8
291735;201806;65;51;14;48654.0;13356.0;62010.0
291740;201806;350;267;83;254718.0;79182.0;333900.0
291750;201806;1964;1303;661;1236017.2;629772.0;1865789.2
291760;201806;3060;1676;1384;1593037.0;1317951.0;2910988.0
291770;201806;809;540;269;513061.25;256626.0;769687.25
291780;201806;46;28;18;26712.0;17172.0;43884.0
291790;201806;169;81;88;77274.0;83952.0;161226.0
291800;201806;10054;4049;6005;3850123.2;5724575.0;9574698.0
291810;201806;1136;817;319;778554.8;304326.0;1082880.9
291820;201806;266;191;75;182214.0;71550.0;253764.0
291830;201806;1088;415;673;394521.0;641079.0;1035600.0
291835;201806;602;553;49;527085.0;46746.0;573831.0
291840;201806;4673;2410;2263;2293757.2;2157386.2;4451143.5
291845;201806;297;101;196;96354.0;186955.38;283309.38
291850;201806;322;279;43;265927.5;41022.0;306949.5
291855;201806;272;108;164;103032.0;156456.0;259488.0
291860;201806;175;107;68;101124.0;64872.0;165996.0
291870;201806;85;35;50;33390.0;47700.0;81090.0
291875;201806;184;167;17;159318.0;16218.0;175536.0
291880;201806;488;385;103;366480.0;98262.0;464742.0
291890;201806;243;80;163;76310.46;154071.2;230381.66
291900;201806;55;32;23;30528.0;21942.0;52470.0
291905;201806;133;93;40;88436.0;38160.0;126596.0
291910;201806;175;143;32;136422.0;30528.0;166950.0
291915;201806;393;347;46;329370.0;43884.0;373254.0
291920;201806;4978;2591;2387;2469411.5;2275533.8;4744945.5
291930;201806;183;106;77;101124.0;73458.0;174582.0
291940;201806;320;176;144;167207.58;136422.0;303629.6
291950;201806;1150;934;216;890273.0;206064.0;1096337.0
291955;201806;1053;632;421;602928.0;401491.0;1004419.0
291960;201806;178;126;52;120204.0;49321.8;169525.8
291970;201806;775;587;188;559998.0;179352.0;739350.0
291980;201806;1506;1332;174;1267315.8;165042.4;1432358.1
291990;201806;127;118;9;112572.0;8586.0;121158.0
291992;201806;165;85;80;80326.8;76320.0;156646.8
291995;201806;145;102;43;97308.0;41022.0;138330.0
292000;201806;388;296;92;280190.94;87768.0;367958.94
292010;201806;287;203;84;192708.8;79182.0;271890.8
292020;201806;277;201;76;191754.0;72504.0;264258.0
292030;201806;139;108;31;103032.0;29574.0;132606.0
292040;201806;631;322;309;307188.0;294786.0;601974.0
292045;201806;95;86;9;82044.0;8586.0;90630.0
292050;201806;898;627;271;597148.7;258248.0;855396.7
292060;201806;934;772;162;734581.25;154548.0;889129.25
292070;201806;50;21;29;20034.0;27666.0;47700.0
292080;201806;113;79;34;75366.0;32436.0;107802.0
292090;201806;505;178;327;169621.2;311958.0;481579.2
292100;201806;1413;602;811;572734.7;772426.5;1345161.2
292105;201806;204;173;31;165042.0;29574.0;194616.0
292110;201806;2113;780;1333;743795.6;1269094.0;2012889.8
292120;201806;647;518;129;493039.78;123066.0;616105.8
292130;201806;449;263;186;250902.0;177444.0;428346.0
292140;201806;196;154;42;146916.0;39936.26;186852.27
292145;201806;160;85;75;81090.0;71507.07;152597.06
292150;201806;1427;1142;285;1089468.0;270862.16;1360330.1
292160;201806;182;147;35;139951.8;33390.0;173341.8
292170;201806;1214;1065;149;1014317.3;142088.77;1156406.1
292180;201806;206;146;60;139284.0;57240.0;196524.0
292190;201806;160;96;64;91584.0;61056.0;152640.0
292200;201806;1283;466;817;443592.72;778769.56;1222362.2
292205;201806;119;106;13;100837.8;12402.0;113239.8
292210;201806;373;259;114;245703.0;108040.5;353743.5
292220;201806;21;16;5;15264.0;4770.0;20034.0
292225;201806;38;35;3;33390.0;2862.0;36252.0
292230;201806;926;750;176;713946.25;167904.0;881850.25
292240;201806;616;445;171;423433.0;163134.0;586567.0
292250;201806;1732;1110;622;1058940.0;593388.0;1652328.0
292260;201806;447;253;194;241362.0;184312.8;425674.8
292265;201806;267;187;80;178111.8;76320.0;254431.8
292270;201806;771;338;433;322452.0;412128.8;734580.8
292273;201806;202;112;90;106070.49;85860.0;191930.48
292275;201806;168;86;82;82044.0;77941.8;159985.8
292280;201806;139;98;41;93492.0;39114.0;132606.0
292285;201806;64;54;10;50848.2;9540.0;60388.2
292290;201806;563;377;186;357454.66;177158.0;534612.7
292300;201806;1638;621;1017;592148.0;969384.56;1561532.6
292303;201806;95;65;30;62010.0;28620.0;90630.0
292305;201806;109;78;31;74412.0;29574.0;103986.0
292310;201806;817;520;297;495718.0;282040.16;777758.1
292320;201806;662;497;165;473851.8;157410.0;631261.8
292330;201806;186;100;86;95400.0;82044.0;177444.0
292335;201806;281;218;63;207972.0;60102.0;268074.0
292340;201806;578;401;177;381814.84;168858.0;550672.9
292350;201806;272;145;127;137519.1;120871.8;258390.9
292360;201806;703;533;170;506765.0;162180.0;668945.0
292370;201806;769;589;180;561906.0;171720.0;733626.0
292380;201806;652;505;147;479862.62;140238.0;620100.6
292390;201806;503;191;312;182214.0;295883.5;478097.5
292400;201806;3376;2073;1303;1958703.5;1239045.8;3197749.2
292405;201806;262;173;89;164565.0;84619.8;249184.8
292410;201806;151;88;63;83952.0;60102.0;144054.0
292420;201806;305;262;43;249661.8;41022.0;290683.8
292430;201806;524;409;115;390186.0;109233.0;499419.0
292440;201806;585;500;85;475492.8;80803.8;556296.6
292450;201806;251;194;57;185076.0;54378.0;239454.0
292460;201806;585;432;153;411555.8;145866.6;557422.4
292465;201806;202;166;36;158364.0;33606.09;191970.1
292467;201806;102;59;43;56286.0;41022.0;97308.0
292470;201806;265;179;86;170766.0;82044.0;252810.0
292480;201806;331;219;112;207972.5;106562.0;314534.5
292490;201806;220;147;73;140238.0;69642.0;209880.0
292500;201806;1160;503;657;479651.0;626320.25;1105971.2
292510;201806;3344;1507;1837;1436602.1;1749627.6;3186229.8
292520;201806;1070;512;558;486583.7;532323.0;1018906.7
292525;201806;385;276;109;263299.22;103986.0;367285.22
292530;201806;4254;1748;2506;1664607.0;2389514.0;4054121.0
292540;201806;478;256;222;244224.0;211788.0;456012.0
292550;201806;1058;575;483;547827.8;460258.62;1008086.44
292560;201806;318;299;19;285246.0;18126.0;303372.0
292570;201806;303;230;73;219091.0;69642.0;288733.0
292575;201806;465;298;167;284006.0;159318.0;443324.0
292580;201806;923;588;335;559521.0;319304.0;878825.0
292590;201806;523;448;75;427089.6;71550.0;498639.6
292593;201806;143;113;30;107802.0;28620.0;136422.0
292595;201806;182;140;42;133560.0;40068.0;173628.0
292600;201806;1237;917;320;874501.0;304612.2;1179113.2
292610;201806;129;99;30;94446.0;28362.42;122808.42
292620;201806;528;438;90;417557.0;85860.0;503417.0
292630;201806;1383;796;587;757796.0;558367.1;1316163.1
292640;201806;778;544;234;518642.1;223236.0;741878.1
292650;201806;175;148;27;140756.0;25758.0;166514.0
292660;201806;1996;1435;561;1364120.0;530996.8;1895116.9
292665;201806;137;100;37;95400.0;35298.0;130698.0
292670;201806;401;325;76;310046.0;72504.0;382550.0
292680;201806;257;199;58;189846.0;54855.0;244701.0
292690;201806;185;142;43;135468.0;41022.0;176490.0
292700;201806;928;614;314;584802.8;299556.0;884358.8
292710;201806;100;88;12;83952.0;11448.0;95400.0
292720;201806;846;479;367;456164.62;349928.0;806092.6
292730;201806;200;95;105;89676.5;100170.0;189846.5
292740;201806;67073;33158;33915;3,16E+14;3,23E+14;6,39E+14
292750;201806;374;266;108;252810.94;102221.57;355032.5
292760;201806;324;262;62;248937.5;59148.0;308085.5
292770;201806;796;334;462;318350.0;440748.0;759098.0
292780;201806;414;155;259;147356.28;247086.0;394442.28
292790;201806;736;362;374;345348.0;356557.5;701905.5
292800;201806;1158;710;448;676386.0;427105.8;1103491.8
292805;201806;427;123;304;116817.3;290016.0;406833.3
292810;201806;1486;858;628;817542.8;599043.44;1416586.2
292820;201806;746;602;144;572400.9;137080.8;709481.7
292830;201806;105;84;21;80136.0;20034.0;100170.0
292840;201806;655;541;114;515924.0;108741.69;624665.7
292850;201806;128;86;42;82044.0;40068.0;122112.0
292860;201806;2184;1271;913;1208463.0;871002.0;2079465.0
292870;201806;3431;2302;1129;2194845.8;1077056.5;3271902.2
292880;201806;1474;965;509;916843.9;484346.0;1401189.9
292890;201806;492;421;71;401606.0;67734.0;469340.0
292895;201806;134;89;45;83547.5;42930.0;126477.5
292900;201806;394;289;105;275706.0;100170.0;375876.0
292905;201806;451;234;217;223236.0;207018.0;430254.0
292910;201806;413;313;100;298269.0;95400.0;393669.0
292920;201806;544;240;304;228960.0;290016.0;518976.0
292925;201806;498;462;36;440070.66;34325.0;474395.66
292930;201806;576;358;218;341532.0;207972.0;549504.0
292935;201806;293;127;166;121158.0;158364.0;279522.0
292937;201806;237;162;75;154548.0;71550.0;226098.0
292940;201806;195;147;48;140238.0;45792.0;186030.0
292950;201806;1116;570;546;541634.5;519931.0;1061565.5
292960;201806;547;366;181;349164.0;172674.0;521838.0
292970;201806;269;189;80;179639.0;76320.0;255959.0
292975;201806;156;88;68;83952.0;64682.0;148634.0
292980;201806;251;169;82;160396.44;78228.0;238624.44
292990;201806;1315;972;343;919951.9;327034.94;1246986.8
293000;201806;104;76;28;72504.0;26712.0;99216.0
293010;201806;2691;1643;1048;1561947.1;995362.8;2557310.0
293015;201806;660;526;134;501586.5;127197.0;628783.5
293020;201806;334;274;60;261396.0;57240.0;318636.0
293030;201806;619;540;79;514588.0;75366.0;589954.0
293040;201806;343;270;73;257580.0;69642.0;327222.0
293050;201806;2734;1595;1139;1513075.8;1082467.4;2595543.2
293060;201806;255;205;50;194383.0;46746.8;241129.8
293070;201806;3421;1743;1678;1655255.6;1599353.9;3254609.5
293075;201806;90;58;32;55332.0;30528.0;85860.0
293076;201806;72;48;24;45792.0;22896.0;68688.0
293077;201806;441;271;170;254687.27;162180.0;416867.28
293080;201806;448;398;50;379692.0;47700.0;427392.0
293090;201806;130;114;16;108756.0;15264.0;124020.0
293100;201806;523;368;155;351072.0;147870.0;498942.0
293105;201806;342;236;106;224858.0;101124.0;325982.0
293110;201806;172;121;51;115434.0;48654.0;164088.0
293120;201806;318;215;103;205110.0;98071.2;303181.2
293130;201806;245;165;80;157410.0;76320.0;233730.0
293135;201806;7990;3152;4838;3000186.2;4607017.0;7607203.5
293140;201806;185;120;65;114480.0;61247.0;175727.0
293150;201806;328;280;48;266357.0;45792.0;312149.0
293160;201806;430;247;183;235638.0;174582.0;410220.0
293170;201806;191;132;59;125928.0;55428.0;181356.0
293180;201806;464;315;149;300224.0;142146.0;442370.0
293190;201806;1285;889;396;843456.75;377784.0;1221240.8
293200;201806;529;468;61;445392.0;58194.0;503586.0
293210;201806;354;266;88;253612.0;83236.5;336848.5
293220;201806;2670;1079;1591;1027432.44;1515668.0;2543100.5
293230;201806;1766;640;1126;609129.8;1074204.0;1683333.8
293240;201806;219;201;18;191754.0;17172.0;208926.0
293245;201806;112;94;18;89676.0;17172.0;106848.0
293250;201806;738;278;460;264964.0;438840.0;703804.0
293260;201806;310;261;49;248040.17;46746.0;294786.16
293270;201806;1181;561;620;533286.7;591480.0;1124766.6
293280;201806;243;136;107;129744.0;102078.0;231822.0
293290;201806;3074;2020;1054;1926063.0;1005217.0;2931280.0
293300;201806;714;508;206;482299.5;194043.6;676343.1
293305;201806;149;127;22;121158.0;20988.0;142146.0
293310;201806;138;104;34;99216.0;32436.0;131652.0
293315;201806;154;119;35;113526.0;33390.0;146916.0
293317;201806;98;69;29;65826.0;27666.0;93492.0
293320;201806;969;562;407;535194.5;388278.0;923472.5
293325;201806;188;65;123;62010.0;117303.84;179313.84
293330;201806;12956;6084;6872;5793930.0;6548089.0;1,23E+14
293340;201806;252;182;70;173628.0;65826.0;239454.0
293345;201806;243;192;51;183168.0;48654.0;231822.0
293350;201806;640;347;293;331038.0;278043.3;609081.3
293360;201806;1572;1124;448;1071342.0;427105.8;1498447.8
310010;201806;150;77;73;73458.0;69356.0;142814.0
310020;201806;1055;580;475;551459.9;451242.12;1002702.0
310030;201806;329;267;62;253592.88;59148.0;312740.88
310040;201806;49;30;19;28620.0;18126.0;46746.0
310050;201806;186;124;62;117342.0;58862.0;176204.0
310060;201806;240;167;73;158841.0;69642.0;228483.0
310070;201806;16;8;8;7632.0;7632.0;15264.0
310080;201806;49;27;22;25758.0;20988.0;46746.0
310090;201806;973;518;455;488258.88;432925.6;921184.5
310100;201806;299;228;71;217512.0;67734.0;285246.0
310110;201806;731;391;340;371692.9;323120.0;694812.9
310120;201806;392;215;177;204442.2;168483.94;372926.12
310130;201806;33;21;12;20034.0;11448.0;31482.0
310140;201806;26;14;12;13356.0;11448.0;24804.0
310150;201806;1299;886;413;837376.3;393143.8;1230520.1
310160;201806;2106;1072;1034;1014778.6;983765.2;1998543.9
310163;201806;93;53;40;50562.0;38160.0;88722.0
310170;201806;2619;1107;1512;1055286.2;1439598.4;2494884.5
310180;201806;134;51;83;48654.0;78800.4;127454.4
310190;201806;491;331;160;315774.0;152067.6;467841.6
310200;201806;505;322;183;307188.0;174582.0;481770.0
310205;201806;59;46;13;43884.0;12402.0;56286.0
310210;201806;273;221;52;210834.0;49035.6;259869.6
310220;201806;58;34;24;32436.0;22896.0;55332.0
310230;201806;264;184;80;175345.2;76320.0;251665.2
310240;201806;104;90;14;85621.5;13356.0;98977.5
310250;201806;100;80;20;76320.0;19080.0;95400.0
310260;201806;794;427;367;404402.25;349383.4;753785.7
310270;201806;277;185;92;175937.0;87768.0;263705.0
310280;201806;361;272;89;258821.0;84906.0;343727.0
310285;201806;217;155;62;147561.86;59148.0;206709.86
310290;201806;255;148;107;141192.0;102078.0;243270.0
310300;201806;155;129;26;123066.0;24804.0;147870.0
310310;201806;8;6;2;5724.0;1908.0;7632.0
310320;201806;24;14;10;13356.0;9540.0;22896.0
310330;201806;32;24;8;22896.0;7632.0;30528.0
310340;201806;1718;1116;602;1056651.6;572210.5;1628862.1
310350;201806;2855;1552;1303;1476739.8;1242194.6;2718934.5
310360;201806;39;32;7;30528.0;6678.0;37206.0
310370;201806;127;105;22;100170.0;20702.0;120872.0
310375;201806;109;40;69;38160.0;65807.0;103967.0
310380;201806;53;31;22;28668.0;20988.0;49656.0
310390;201806;103;70;33;66780.0;31482.0;98262.0
310400;201806;2372;1539;833;1464296.0;794109.8;2258405.8
310410;201806;124;67;57;63918.0;54378.0;118296.0
310420;201806;664;351;313;333996.2;297639.06;631635.25
310430;201806;323;215;108;204871.5;103032.0;307903.5
310440;201806;71;41;30;39114.0;28620.0;67734.0
310445;201806;82;66;16;62964.0;15264.0;78228.0
310450;201806;855;536;319;511344.0;304047.66;815391.7
310460;201806;264;192;72;183168.0;68688.0;251856.0
310470;201806;504;324;180;309096.0;171720.0;480816.0
310480;201806;78;57;21;54378.0;20034.0;74412.0
310490;201806;515;244;271;231822.2;258534.0;490356.2
310500;201806;126;53;73;50562.0;69642.0;120204.0
310510;201806;603;395;208;375590.6;198423.0;574013.6
310520;201806;130;87;43;82998.0;41022.0;124020.0
310530;201806;87;39;48;37206.0;45505.8;82711.8
310540;201806;462;287;175;271414.6;166663.8;438078.4
310550;201806;87;58;29;55332.0;27666.0;82998.0
310560;201806;2966;2039;927;1934438.5;883733.1;2818171.8
310570;201806;120;81;39;77274.0;37206.0;114480.0
310590;201806;352;234;118;221853.8;112557.69;334411.5
310600;201806;161;91;70;84382.7;66780.0;151162.7
310610;201806;61;23;38;21942.0;36252.0;58194.0
310620;201806;46269;22208;24061;2,11E+14;2,29E+13;4,40E+14
310630;201806;611;389;222;368387.6;210453.4;578841.0
310640;201806;142;116;26;110473.2;24804.0;135277.2
310650;201806;166;146;20;138044.0;19080.0;157124.0
310660;201806;91;57;34;54378.0;32436.0;86814.0
310665;201806;56;41;15;39114.0;14310.0;53424.0
310670;201806;6458;2942;3516;2798779.2;3350231.2;6149010.5
310680;201806;58;38;20;36252.0;19080.0;55332.0
310690;201806;615;448;167;421804.47;159318.0;581122.44
310700;201806;58;37;21;35298.0;19890.9;55188.9
310710;201806;1242;839;403;798608.44;383889.8;1182498.2
310720;201806;91;29;62;27666.0;59148.0;86814.0
310730;201806;1370;957;413;911738.5;393716.0;1305454.5
310740;201806;990;555;435;526322.4;414456.25;940778.7
310750;201806;245;144;101;136422.19;96354.0;232776.19
310760;201806;65;48;17;45792.0;15932.0;61724.0
310770;201806;91;44;47;41976.0;44838.0;86814.0
310780;201806;398;327;71;311376.6;67734.0;379110.6
310790;201806;99;81;18;77274.0;17172.0;94446.0
310800;201806;458;222;236;211311.0;224857.8;436168.8
310810;201806;170;120;50;113421.2;46746.0;160167.2
310820;201806;356;282;74;269028.0;70309.8;339337.8
310825;201806;200;163;37;155502.0;35298.0;190800.0
310830;201806;464;222;242;211127.94;230868.0;441995.94
310840;201806;384;220;164;209880.0;156456.0;366336.0
310850;201806;110;88;22;83952.0;20988.0;104940.0
310855;201806;380;301;79;287154.0;75366.0;362520.0
310860;201806;1407;1053;354;1000699.9;335980.9;1336680.8
310870;201806;54;42;12;40068.0;11448.0;51516.0
310880;201806;82;64;18;60769.8;17172.0;77941.8
310890;201806;313;185;128;176490.0;122112.0;298602.0
310900;201806;638;296;342;279746.28;325962.8;605709.06
310910;201806;246;168;78;158937.2;74412.0;233349.2
310920;201806;485;289;196;271891.2;186984.0;458875.2
310925;201806;39;32;7;30528.0;6392.0;36920.0
310930;201806;1093;659;434;628569.5;413941.06;1042510.6
310940;201806;683;348;335;331705.8;319590.0;651295.8
310945;201806;116;71;45;67734.0;42930.0;110664.0
310950;201806;252;200;52;190800.0;49608.0;240408.0
310960;201806;82;30;52;28620.0;49604.0;78224.0
310970;201806;168;104;64;99216.0;60133.76;159349.77
310980;201806;41;21;20;20034.0;19080.0;39114.0
310990;201806;152;86;66;81758.0;62964.0;144722.0
311000;201806;867;431;436;407645.7;415935.0;823580.7
311010;201806;39;32;7;30528.0;6678.0;37206.0
311020;201806;42;26;16;24804.0;15264.0;40068.0
311030;201806;382;230;152;217512.0;144913.0;362425.0
311040;201806;38;33;5;31482.0;4770.0;36252.0
311050;201806;464;193;271;183550.0;257961.6;441511.6
311060;201806;773;439;334;417375.4;318350.0;735725.4
311070;201806;334;153;181;145962.0;172674.0;318636.0
311080;201806;105;58;47;55332.0;44838.0;100170.0
311090;201806;391;185;206;175250.0;196524.0;371774.0
311100;201806;609;363;246;346015.8;234111.6;580127.4
311110;201806;680;471;209;449047.8;199377.0;648424.8
311115;201806;68;50;18;47700.0;17172.0;64872.0
311120;201806;1065;564;501;536679.56;477047.9;1013727.5
311130;201806;406;240;166;228769.2;158364.0;387133.2
311140;201806;164;83;81;78895.8;76463.1;155358.9
311150;201806;358;234;124;223236.0;118057.5;341293.5
311160;201806;746;538;208;510867.4;197955.0;708822.4
311170;201806;78;58;20;55332.0;18793.8;74125.8
311180;201806;349;234;115;222949.8;109424.0;332373.8
311190;201806;35;17;18;16218.0;17172.0;33390.0
311200;201806;341;238;103;225430.6;98262.0;323692.6
311205;201806;31;21;10;20034.0;9158.4;29192.4
311210;201806;49;41;8;38828.0;7632.0;46460.0
311220;201806;19;17;2;16218.0;1908.0;18126.0
311230;201806;1632;1071;561;1017368.75;535194.0;1552562.8
311240;201806;175;111;64;105690.33;61056.0;166746.33
311250;201806;88;30;58;28620.0;55332.0;83952.0
311260;201806;553;349;204;332946.0;194616.0;527562.0
311265;201806;116;81;35;77274.0;33390.0;110664.0
311270;201806;285;206;79;196524.0;75366.0;271890.0
311280;201806;213;97;116;92538.0;110091.6;202629.6
311290;201806;109;88;21;83952.0;19748.0;103700.0
311300;201806;552;350;202;333900.0;192422.0;526322.0
311310;201806;25;19;6;18126.0;5724.0;23850.0
311320;201806;672;498;174;474138.0;165996.0;640134.0
311330;201806;1042;764;278;728617.5;264258.4;992875.9
311340;201806;2653;1879;774;1783038.1;736756.7;2519794.8
311350;201806;275;209;66;199386.0;62964.0;262350.0
311360;201806;178;106;72;101124.0;68688.0;169812.0
311370;201806;1213;498;715;473098.5;681537.6;1154636.1
311380;201806;7;6;1;5724.0;954.0;6678.0
311390;201806;281;150;131;143100.0;124783.2;267883.2
311400;201806;151;99;52;94446.0;49608.0;144054.0
311410;201806;102;57;45;54092.0;42930.0;97022.0
311420;201806;301;168;133;158364.8;126882.0;285246.8
311430;201806;865;563;302;535195.2;287822.0;823017.2
311440;201806;488;340;148;324360.0;140905.8;465265.8
311450;201806;325;206;119;196524.0;113526.0;310050.0
311455;201806;302;205;97;195274.8;92251.8;287526.6
311460;201806;137;57;80;54378.0;75514.27;129892.27
311470;201806;23;13;10;12402.0;9540.0;21942.0
311480;201806;31;13;18;12402.0;17172.0;29574.0
311490;201806;16;10;6;9540.0;5724.0;15264.0
311500;201806;20;10;10;9540.0;9540.0;19080.0
311510;201806;622;435;187;413047.7;178111.8;591159.5
311520;201806;44;34;10;31768.2;9540.0;41308.2
311530;201806;1821;1366;455;1291067.5;434070.0;1725137.5
311535;201806;69;51;18;48654.0;17172.0;65826.0
311540;201806;34;29;5;27666.0;4770.0;32436.0
311545;201806;190;142;48;135468.0;45792.0;181260.0
311547;201806;33;24;9;22896.0;8586.0;31482.0
311550;201806;655;303;352;289062.0;335789.47;624851.44
311560;201806;42;27;15;25758.0;14310.0;40068.0
311570;201806;300;200;100;190227.6;95400.0;285627.6
311580;201806;313;185;128;176203.8;122112.0;298315.8
311590;201806;33;29;4;27666.0;3816.0;31482.0
311600;201806;91;73;18;69642.0;17172.0;86814.0
311610;201806;257;224;33;212742.5;31482.0;244224.5
311615;201806;105;88;17;83312.82;16027.2;99340.02
311620;201806;20;11;9;10494.0;8586.0;19080.0
311630;201806;86;72;14;68688.0;13356.0;82044.0
311640;201806;128;67;61;63918.0;58194.0;122112.0
311650;201806;129;95;34;89914.5;32436.0;122350.5
311660;201806;414;199;215;189846.0;205110.0;394956.0
311670;201806;168;108;60;102787.0;57240.0;160027.0
311680;201806;221;160;61;151738.95;57430.8;209169.75
311690;201806;18;11;7;10494.0;6678.0;17172.0
311700;201806;201;141;60;134227.8;56572.2;190800.0
311710;201806;212;135;77;128790.0;73458.0;202248.0
311720;201806;37;27;10;25758.0;9540.0;35298.0
311730;201806;559;364;195;346684.0;186030.0;532714.0
311740;201806;39;28;11;26712.0;10494.0;37206.0
311750;201806;713;483;230;458874.8;219420.0;678294.8
311760;201806;64;35;29;33390.0;27666.0;61056.0
311770;201806;400;192;208;181260.62;198432.0;379692.62
311780;201806;173;96;77;91298.0;73141.0;164439.0
311783;201806;83;74;9;70596.0;8586.0;79182.0
311787;201806;34;14;20;13356.0;19080.0;32436.0
311790;201806;266;127;139;121158.0;132606.0;253764.0
311800;201806;653;436;217;412558.3;206350.2;618908.5
311810;201806;43;36;7;34344.0;6678.0;41022.0
311820;201806;107;91;16;86814.0;15264.0;102078.0
311830;201806;1926;1216;710;1154259.2;673429.4;1827688.8
311840;201806;1027;571;456;539877.9;433555.53;973433.44
311850;201806;10;6;4;5724.0;3816.0;9540.0
311860;201806;9477;4303;5174;4088567.8;4929257.0;9017825.0
311870;201806;150;83;67;79182.0;63918.0;143100.0
311880;201806;950;706;244;671988.8;232776.0;904764.8
311890;201806;219;111;108;105894.0;103032.0;208926.0
311900;201806;82;35;47;33390.0;44838.0;78228.0
311910;201806;1406;865;541;823016.6;514015.4;1337032.0
311920;201806;230;149;81;142146.0;77274.0;219420.0
311930;201806;923;526;397;501518.0;378500.0;880018.0
311940;201806;2517;1309;1208;1246449.8;1148377.5;2394827.2
311950;201806;40;28;12;26712.0;11448.0;38160.0
311960;201806;65;46;19;43884.0;18126.0;62010.0
311970;201806;26;17;9;13928.4;8586.0;22514.4
311980;201806;42;32;10;30528.0;9540.0;40068.0
311990;201806;56;40;16;38160.0;15264.0;53424.0
311995;201806;64;45;19;42930.0;18126.0;61056.0
312000;201806;36;25;11;23563.8;10494.0;34057.8
312010;201806;82;60;22;57240.0;20988.0;78228.0
312015;201806;99;75;24;71264.0;22896.0;94160.0
312020;201806;140;87;53;82998.0;50562.0;133560.0
312030;201806;45;36;9;33677.0;8586.0;42263.0
312040;201806;84;53;31;50562.0;29574.0;80136.0
312050;201806;219;117;102;111618.0;97308.0;208926.0
312060;201806;68;41;27;39114.0;25090.2;64204.2
312070;201806;74;46;28;43884.0;26712.0;70596.0
312080;201806;531;241;290;229914.0;276660.0;506574.0
312083;201806;49;36;13;34344.0;12402.0;46746.0
312087;201806;115;93;22;88722.0;20988.0;109710.0
312090;201806;2921;1665;1256;1575249.5;1194842.4;2770091.8
312100;201806;158;112;46;106848.0;43102.0;149950.0
312110;201806;119;73;46;69642.0;43884.0;113526.0
312120;201806;143;106;37;99884.0;35298.0;135182.0
312125;201806;99;56;43;53233.2;41022.0;94255.2
312130;201806;121;81;40;77274.0;38160.0;115434.0
312140;201806;137;107;30;102078.0;28620.0;130698.0
312150;201806;47;36;11;34344.0;10494.0;44838.0
312160;201806;1535;1015;520;963827.2;494668.47;1458495.6
312170;201806;12;10;2;9540.0;1908.0;11448.0
312180;201806;101;62;39;58433.0;36920.0;95353.0
312190;201806;31;27;4;25758.0;3816.0;29574.0
312200;201806;738;636;102;604788.7;97308.0;702096.7
312210;201806;97;64;33;61056.0;31482.0;92538.0
312220;201806;121;88;33;83714.0;31482.0;115196.0
312230;201806;3553;1741;1812;1656556.5;1726983.1;3383539.5
312235;201806;157;104;53;99216.0;50562.0;149778.0
312240;201806;108;71;37;67734.0;35298.0;103032.0
312245;201806;169;115;54;109706.0;51516.0;161222.0
312247;201806;63;44;19;41213.0;18126.0;59339.0
312250;201806;184;85;99;81090.0;94446.0;175536.0
312260;201806;102;68;34;64013.4;32436.0;96449.4
312270;201806;137;86;51;82044.0;48654.0;130698.0
312280;201806;27;17;10;16218.0;9540.0;25758.0
312290;201806;163;112;51;106848.0;47701.0;154549.0
312300;201806;200;131;69;124974.0;65826.0;190800.0
312310;201806;58;53;5;50562.0;4770.0;55332.0
312320;201806;429;267;162;252810.0;152974.1;405784.1
312330;201806;90;79;11;74603.0;10207.8;84810.8
312340;201806;35;16;19;15264.0;18126.0;33390.0
312350;201806;17;11;6;10494.0;5724.0;16218.0
312352;201806;98;66;32;62964.0;30528.0;93492.0
312360;201806;557;252;305;239454.0;290970.0;530424.0
312370;201806;305;178;127;169525.8;121158.0;290683.8
312380;201806;139;90;49;85860.0;46746.0;132606.0
312385;201806;174;141;33;134227.8;31482.0;165709.8
312390;201806;303;190;113;181260.0;107135.0;288395.0
312400;201806;377;288;89;274752.0;84430.0;359182.0
312410;201806;882;287;595;273321.0;567054.0;840375.0
312420;201806;611;484;127;460782.2;121158.0;581940.2
312430;201806;870;642;228;610180.06;216558.2;826738.25
312440;201806;46;34;12;32436.0;11448.0;43884.0
312450;201806;212;130;82;124020.0;78228.0;202248.0
312460;201806;60;29;31;27666.0;29574.0;57240.0
312470;201806;55;36;19;34344.0;18126.0;52470.0
312480;201806;204;125;79;119250.0;75366.0;194616.0
312490;201806;270;186;84;177444.0;80136.0;257580.0
312500;201806;33;18;15;17172.0;14310.0;31482.0
312510;201806;439;167;272;159318.0;258872.39;418190.38
312520;201806;43;15;28;14310.0;26712.0;41022.0
312530;201806;49;37;12;35298.0;11448.0;46746.0
312540;201806;101;88;13;83952.0;12402.0;96354.0
312550;201806;38;30;8;28620.0;7632.0;36252.0
312560;201806;213;158;55;150446.0;52183.8;202629.8
312570;201806;441;264;177;251188.2;168166.45;419354.66
312580;201806;83;44;39;41976.0;37206.0;79182.0
312590;201806;265;209;56;199386.0;53424.0;252810.0
312595;201806;140;125;15;119250.0;14310.0;133560.0
312600;201806;77;46;31;43455.0;29574.0;73029.0
312610;201806;1627;858;769;811284.0;731909.6;1543193.6
312620;201806;192;136;56;129744.0;53419.23;183163.23
312630;201806;64;54;10;51516.0;9540.0;61056.0
312640;201806;47;13;34;12402.0;32436.0;44838.0
312650;201806;154;128;26;121826.0;24518.0;146344.0
312660;201806;72;54;18;51230.0;17172.0;68402.0
312670;201806;868;572;296;544735.0;282170.3;826905.3
312675;201806;41;31;10;29574.0;9540.0;39114.0
312680;201806;86;57;29;53996.4;27666.0;81662.4
312690;201806;238;126;112;120194.46;106561.8;226756.27
312695;201806;31;24;7;22896.0;6678.0;29574.0
312700;201806;213;122;91;116388.0;86814.0;203202.0
312705;201806;76;62;14;59148.0;13356.0;72504.0
312707;201806;96;70;26;66360.24;24804.0;91164.24
312710;201806;1891;1004;887;955215.6;845987.0;1801202.6
312720;201806;66;33;33;31482.0;31482.0;62964.0
312730;201806;288;168;120;159318.0;114480.0;273798.0
312733;201806;51;44;7;41690.0;6678.0;48368.0
312735;201806;22;16;6;15264.0;5724.0;20988.0
312737;201806;68;36;32;34344.0;30528.0;64872.0
312738;201806;52;37;15;35298.0;14310.0;49608.0
312740;201806;75;50;25;47414.0;23850.0;71264.0
312750;201806;70;52;18;49608.0;17172.0;66780.0
312760;201806;272;199;73;189846.0;69642.0;259488.0
312770;201806;7623;3532;4091;3346484.0;3894177.5;7240661.5
312780;201806;432;332;100;316441.8;95400.0;411841.8
312790;201806;21;16;5;15264.0;4770.0;20034.0
312800;201806;1603;1120;483;1062013.2;460782.0;1522795.2
312810;201806;367;238;129;226765.8;123066.0;349831.8
312820;201806;196;148;48;141192.0;45792.0;186984.0
312825;201806;27;18;9;17172.0;8586.0;25758.0
312830;201806;277;167;110;158079.0;104301.0;262380.0
312840;201806;148;109;39;103986.0;37206.0;141192.0
312850;201806;26;23;3;21942.0;2862.0;24804.0
312860;201806;170;103;67;97976.0;63918.0;161894.0
312870;201806;989;519;470;492232.25;448380.0;940612.25
312880;201806;151;103;48;98118.9;45696.6;143815.5
312890;201806;167;115;52;109710.0;49608.0;159318.0
312900;201806;209;156;53;148156.2;50562.0;198718.2
312910;201806;192;99;93;93277.72;88722.0;181999.72
312920;201806;157;88;69;83952.0;65826.0;149778.0
312930;201806;342;250;92;238500.0;87768.0;326268.0
312940;201806;109;73;36;69642.0;34344.0;103986.0
312950;201806;695;459;236;436836.6;225144.0;661980.6
312960;201806;174;135;39;128790.0;37206.0;165996.0
312965;201806;53;49;4;46746.0;3816.0;50562.0
312970;201806;296;236;60;224190.2;57240.0;281430.2
312980;201806;2331;1225;1106;1164159.4;1054547.6;2218707.0
312990;201806;49;28;21;26712.0;20034.0;46746.0
313000;201806;42;25;17;23850.0;16218.0;40068.0
313005;201806;168;129;39;122827.5;36920.0;159747.5
313010;201806;940;383;557;364141.8;531369.0;895510.8
313020;201806;189;100;89;94923.0;84906.0;179829.0
313030;201806;208;135;73;126883.0;69642.0;196525.0
313040;201806;66;26;40;24804.0;38160.0;62964.0
313050;201806;294;205;89;195570.0;84906.0;280476.0
313055;201806;47;35;12;33390.0;11448.0;44838.0
313060;201806;124;86;38;82044.0;35965.8;118009.8
313065;201806;60;39;21;37206.0;20034.0;57240.0
313070;201806;150;80;70;76320.0;66780.0;143100.0
313080;201806;42;18;24;17172.0;22896.0;40068.0
313090;201806;707;489;218;465218.3;207972.0;673190.3
313100;201806;163;63;100;60102.0;95392.0;155494.0
313110;201806;126;73;53;69642.0;50562.0;120204.0
313115;201806;164;90;74;85659.66;70596.0;156255.66
313120;201806;755;412;343;392762.0;325982.0;718744.0
313130;201806;5285;2866;2419;2709783.8;2299542.8;5009326.5
313140;201806;159;82;77;78228.0;73458.0;151686.0
313150;201806;312;247;65;235638.0;61723.8;297361.8
313160;201806;201;148;53;140906.0;50562.0;191468.0
313170;201806;1372;965;407;907321.94;387887.4;1295209.4
313180;201806;326;194;132;184427.28;125928.0;310355.28
313190;201806;742;441;301;418615.2;286391.0;705006.2
313200;201806;24;23;1;21942.0;954.0;22896.0
313210;201806;1043;879;164;835563.2;156451.23;992014.4
313220;201806;243;167;76;158364.0;71788.5;230152.5
313230;201806;267;197;70;186985.0;66780.0;253765.0
313240;201806;1921;1027;894;976697.75;849913.8;1826611.5
313250;201806;1266;944;322;895903.8;305281.8;1201185.6
313260;201806;98;55;43;52470.0;41022.0;93492.0
313270;201806;965;564;401;534384.1;382554.0;916938.1
313280;201806;61;52;9;49131.0;8586.0;57717.0
313290;201806;225;182;43;173342.0;40068.8;213410.8
313300;201806;381;197;184;184791.0;175536.0;360327.0
313310;201806;229;118;111;112572.0;105894.0;218466.0
313320;201806;374;286;88;270889.1;83952.0;354841.1
313330;201806;1365;836;529;796113.2;503474.5;1299587.8
313340;201806;336;233;103;222282.0;98262.0;320544.0
313350;201806;518;350;168;331992.1;160272.0;492264.1
313360;201806;116;69;47;65826.0;44552.0;110378.0
313370;201806;190;69;121;65826.0;115434.0;181260.0
313375;201806;275;165;110;157410.0;104940.0;262350.0
313380;201806;1325;680;645;646831.06;615040.0;1261871.1
313390;201806;47;41;6;38160.8;5724.0;43884.8
313400;201806;416;277;139;264258.0;132034.0;396292.0
313410;201806;20;12;8;11448.0;7632.0;19080.0
313420;201806;4695;2447;2248;2325074.0;2137517.8;4462591.5
313430;201806;143;66;77;62964.0;73172.0;136136.0
313440;201806;1480;1011;469;961394.9;446282.0;1407676.9
313450;201806;63;27;36;25758.0;34057.8;59815.8
313460;201806;373;176;197;167418.0;187938.0;355356.0
313470;201806;536;245;291;233730.0;276946.2;510676.2
313480;201806;157;107;50;101125.0;47700.0;148825.0
313490;201806;513;250;263;238495.23;250855.0;489350.22
313500;201806;21;14;7;13356.0;6678.0;20034.0
313505;201806;983;766;217;729810.2;206731.8;936542.0
313507;201806;96;57;39;54378.0;37206.0;91584.0
313510;201806;2790;1778;1012;1690419.5;964494.0;2654913.5
313520;201806;3629;2836;793;2693146.8;756518.0;3449664.8
313530;201806;44;29;15;27666.0;14310.0;41976.0
313535;201806;107;85;22;80423.0;20988.0;101411.0
313540;201806;71;54;17;51516.0;16218.0;67734.0
313545;201806;115;96;19;91584.0;18126.0;109710.0
313550;201806;234;193;41;184122.0;38828.0;222950.0
313560;201806;330;170;160;162180.0;152640.0;314820.0
313570;201806;61;32;29;30528.0;27666.0;58194.0
313580;201806;1317;725;592;688734.44;563910.0;1252644.5
313590;201806;80;48;32;45792.0;30528.0;76320.0
313600;201806;697;416;281;396578.0;267216.0;663794.0
313610;201806;61;49;12;46126.8;11448.0;57574.8
313620;201806;1362;722;640;677688.4;606677.0;1284365.4
313630;201806;1640;1252;388;1191144.4;369866.0;1561010.4
313640;201806;129;75;54;71550.0;51516.0;123066.0
313650;201806;238;110;128;104940.0;121540.0;226480.0
313652;201806;17;17;0;16218.0;0.0;16218.0
313655;201806;55;32;23;30528.0;21942.0;52470.0
313657;201806;47;44;3;41976.0;2862.0;44838.0
313660;201806;133;90;43;85860.0;41022.0;126882.0
313665;201806;651;316;335;301224.0;319351.5;620575.5
313670;201806;10347;7145;3202;6791600.5;3053149.5;9844750.0
313680;201806;42;31;11;29574.0;10390.0;39964.0
313690;201806;154;116;38;110664.0;36252.0;146916.0
313695;201806;78;59;19;56286.0;18126.0;74412.0
313700;201806;301;243;58;231536.0;55332.0;286868.0
313710;201806;148;101;47;96354.0;44838.0;141192.0
313720;201806;1101;523;578;496461.8;550067.9;1046529.7
313730;201806;61;42;19;40068.0;18126.0;58194.0
313740;201806;162;130;32;124020.0;30528.0;154548.0
313750;201806;443;323;120;308142.0;114480.0;422622.0
313753;201806;240;173;67;164374.2;63918.0;228292.2
313760;201806;1265;458;807;436646.0;767132.0;1203778.0
313770;201806;354;256;98;243032.2;93492.0;336524.2
313780;201806;765;397;368;378738.0;350785.8;729523.8
313790;201806;27;26;1;24804.0;954.0;25758.0
313800;201806;148;91;57;86814.0;54378.0;141192.0
313810;201806;69;41;28;39114.0;26712.0;65826.0
313820;201806;1286;639;647;608366.2;615975.0;1224341.2
313830;201806;67;49;18;46746.0;17172.0;63918.0
313835;201806;56;48;8;45792.0;7632.0;53424.0
313840;201806;1699;1047;652;993497.5;620482.0;1613979.5
313850;201806;184;63;121;60102.0;114854.06;174956.06
313860;201806;481;372;109;351407.3;103986.0;455393.3
313862;201806;173;115;58;109710.0;55332.0;165042.0
313865;201806;88;70;18;66780.0;17172.0;83952.0
313867;201806;48;37;11;35298.0;10494.0;45792.0
313868;201806;27;18;9;16409.0;8586.0;24995.0
313870;201806;128;65;63;62010.0;59816.0;121826.0
313880;201806;359;225;134;214650.0;127263.8;341913.8
313890;201806;324;172;152;163325.8;144435.6;307761.4
313900;201806;909;497;412;473184.5;393001.0;866185.5
313910;201806;138;99;39;94446.0;36252.2;130698.2
313920;201806;618;440;178;419569.2;169292.0;588861.2
313925;201806;32;28;4;26712.0;3816.0;30528.0
313930;201806;817;630;187;600734.0;178375.0;779109.0
313940;201806;1807;1138;669;1081740.8;637558.4;1719299.2
313950;201806;943;600;343;570588.6;326935.8;897524.4
313960;201806;1389;802;587;760844.3;558280.0;1319124.2
313970;201806;120;81;39;77274.0;37206.0;114480.0
313980;201806;215;139;76;132368.0;72504.0;204872.0
313990;201806;376;226;150;215604.0;143100.0;358704.0
314000;201806;928;626;302;593723.9;288103.22;881827.1
314010;201806;77;51;26;48654.0;24804.0;73458.0
314015;201806;51;16;35;15264.0;33390.0;48654.0
314020;201806;50;34;16;32436.0;15264.0;47700.0
314030;201806;85;38;47;36089.82;44838.0;80927.82
314040;201806;44;31;13;29574.0;12402.0;41976.0
314050;201806;319;188;131;179066.0;124163.1;303229.1
314053;201806;98;65;33;61056.4;31482.0;92538.4
314055;201806;305;181;124;172674.0;118296.0;290970.0
314060;201806;146;124;22;117342.0;20988.0;138330.0
314070;201806;1027;514;513;486551.12;488782.0;975333.1
314080;201806;220;143;77;135205.12;72408.88;207614.02
314085;201806;134;89;45;84906.0;42930.0;127836.0
314090;201806;358;258;100;246132.0;95395.23;341527.22
314100;201806;475;390;85;368245.0;80518.0;448763.0
314110;201806;705;385;320;365677.75;304707.6;670385.3
314120;201806;97;55;42;52470.0;40068.0;92538.0
314130;201806;25;12;13;11448.0;12402.0;23850.0
314140;201806;1102;667;435;632673.94;411842.47;1044516.4
314150;201806;163;104;59;99216.0;56286.0;155502.0
314160;201806;349;261;88;246132.8;83762.0;329894.8
314170;201806;76;58;18;55332.0;17172.0;72504.0
314180;201806;730;642;88;612182.0;82998.5;695180.5
314190;201806;103;61;42;58194.0;40068.0;98262.0
314200;201806;590;409;181;388915.6;171720.0;560635.6
314210;201806;282;212;70;201294.0;66494.0;267788.0
314220;201806;311;235;76;222283.0;72218.0;294501.0
314225;201806;65;47;18;44838.0;17172.0;62010.0
314230;201806;108;47;61;44838.0;58194.0;103032.0
314240;201806;139;107;32;102078.0;30528.0;132606.0
314250;201806;60;37;23;35298.0;21942.0;57240.0
314260;201806;189;95;94;90630.0;89676.0;180306.0
314270;201806;328;260;68;247277.0;64586.0;311863.0
314280;201806;697;390;307;372051.0;292878.0;664929.0
314290;201806;561;458;103;435692.5;97975.8;533668.3
314300;201806;407;290;117;273724.0;111571.0;385295.0
314310;201806;1459;985;474;937783.1;452160.0;1389943.1
314315;201806;36;30;6;28620.0;5724.0;34344.0
314320;201806;606;390;216;371487.8;205424.81;576912.6
314330;201806;10697;5389;5308;5129767.0;5059367.0;1,02E+14
314340;201806;574;267;307;254145.8;292306.0;546451.8
314345;201806;32;25;7;23850.0;6678.0;30528.0
314350;201806;191;120;71;114480.0;67734.0;182214.0
314360;201806;78;49;29;46746.0;27666.0;74412.0
314370;201806;57;48;9;45792.0;8586.0;54378.0
314380;201806;94;67;27;63918.0;25758.0;89676.0
314390;201806;3264;2075;1189;1974017.2;1131349.4;3105366.8
314400;201806;683;490;193;464590.2;184122.0;648712.2
314410;201806;436;284;152;270936.0;145008.0;415944.0
314420;201806;19;9;10;8586.0;9540.0;18126.0
314430;201806;2513;899;1614;853798.44;1537244.5;2391043.0
314435;201806;272;157;115;149491.8;108756.0;258247.8
314437;201806;29;22;7;20988.0;6678.0;27666.0
314440;201806;98;71;27;67734.0;25758.0;93492.0
314450;201806;155;114;41;108756.0;39114.0;147870.0
314460;201806;655;306;349;291924.0;332946.0;624870.0
314465;201806;84;56;28;53424.0;26712.0;80136.0
314467;201806;69;58;11;55323.0;10494.0;65817.0
314470;201806;391;204;187;191164.52;177444.5;368609.03
314480;201806;1085;517;568;493218.0;541395.0;1034613.0
314490;201806;88;66;22;62964.0;20988.0;83952.0
314500;201806;313;208;105;198432.0;100170.0;298602.0
314505;201806;127;84;43;80136.0;41022.0;121158.0
314510;201806;232;190;42;181260.0;40068.0;221328.0
314520;201806;1262;654;608;616479.7;579173.8;1195653.5
314530;201806;737;581;156;553474.0;148824.0;702298.0
314535;201806;212;134;78;126786.6;74161.01;200947.61
314537;201806;64;39;25;37206.0;23850.0;61056.0
314540;201806;14;9;5;8586.0;4770.0;13356.0
314545;201806;49;31;18;29574.0;17172.0;46746.0
314550;201806;82;44;38;41976.0;36252.0;78228.0
314560;201806;815;438;377;415371.8;359658.0;775029.8
314570;201806;22;17;5;16218.0;4770.0;20988.0
314580;201806;17;8;9;7632.0;8586.0;16218.0
314585;201806;20;15;5;14310.0;4770.0;19080.0
314587;201806;84;73;11;69642.0;10494.0;80136.0
314590;201806;570;417;153;397818.0;145676.0;543494.0
314600;201806;984;643;341;609027.06;323978.6;933005.7
314610;201806;945;515;430;488448.7;410029.2;898477.9
314620;201806;152;113;39;106423.36;37206.0;143629.36
314625;201806;98;72;26;68116.0;24804.0;92920.0
314630;201806;1238;634;604;603357.3;575643.8;1179001.1
314640;201806;91;59;32;56286.0;30241.8;86527.8
314650;201806;197;115;82;109423.8;77751.0;187174.8
314655;201806;67;52;15;49608.0;14310.0;63918.0
314660;201806;20;16;4;15264.0;3816.0;19080.0
314670;201806;192;151;41;143768.0;39114.0;182882.0
314675;201806;218;127;91;121158.0;86814.0;207972.0
314690;201806;537;299;238;284959.8;227052.0;512011.8
314700;201806;2436;1339;1097;1272255.6;1045350.9;2317606.5
314710;201806;1627;948;679;899434.9;647146.1;1546581.0
314720;201806;409;245;164;232327.62;156456.0;388783.62
314730;201806;516;272;244;258058.0;232767.0;490825.0
314740;201806;691;341;350;323930.7;333900.0;657830.7
314750;201806;20;17;3;16218.0;2862.0;19080.0
314760;201806;327;156;171;148824.0;163124.45;311948.47
314770;201806;122;83;39;79182.0;37206.0;116388.0
314780;201806;21;6;15;5724.0;14310.0;20034.0
314790;201806;2369;1478;891;1402448.5;849336.7;2251785.2
314795;201806;53;45;8;42692.0;7632.0;50324.0
314800;201806;2947;1740;1207;1654674.6;1149416.4;2804091.0
314810;201806;1517;845;672;803793.5;639467.0;1443260.5
314820;201806;91;51;40;48654.0;38160.0;86814.0
314830;201806;207;164;43;155740.5;40736.0;196476.5
314840;201806;82;47;35;44838.0;33390.0;78228.0
314850;201806;353;171;182;163134.0;173628.0;336762.0
314860;201806;707;531;176;504570.88;165710.7;670281.56
314870;201806;1486;777;709;740304.0;676386.0;1416690.0
314875;201806;56;48;8;45792.0;7632.0;53424.0
314880;201806;46;33;13;31482.0;12402.0;43884.0
314890;201806;53;31;22;29574.0;20988.0;50562.0
314900;201806;34;27;7;25758.0;6678.0;32436.0
314910;201806;253;172;81;163801.8;77274.0;241075.8
314915;201806;158;139;19;132606.0;18126.0;150732.0
314920;201806;124;77;47;73458.0;44551.8;118009.8
314930;201806;1040;529;511;502802.34;486921.6;989723.94
314940;201806;52;40;12;38160.0;11448.0;49608.0
314950;201806;38;27;11;25758.0;10494.0;36252.0
314960;201806;55;42;13;40068.0;12402.0;52470.0
314970;201806;141;71;70;67734.0;66780.0;134514.0
314980;201806;304;194;110;182834.1;103986.0;286820.1
314990;201806;468;258;210;246132.0;199434.5;445566.5
314995;201806;207;64;143;61056.0;136412.45;197468.45
315000;201806;93;76;17;72504.0;16218.0;88722.0
315010;201806;46;30;16;28620.0;15264.0;43884.0
315015;201806;178;145;33;137604.95;31482.0;169086.95
315020;201806;72;62;10;59148.0;9540.0;68688.0
315030;201806;117;90;27;84906.0;25758.0;110664.0
315040;201806;66;48;18;45792.0;17172.0;62964.0
315050;201806;203;123;80;117342.0;76320.0;193662.0
315053;201806;40;35;5;33390.0;4492.77;37882.77
315057;201806;97;80;17;75938.4;16218.0;92156.4
315060;201806;72;64;8;59149.16;7632.0;66781.16
315070;201806;100;55;45;52470.0;42930.0;95400.0
315080;201806;373;306;67;291924.0;63918.0;355842.0
315090;201806;112;67;45;63918.0;42930.0;106848.0
315100;201806;80;41;39;39114.0;37206.0;76320.0
315110;201806;292;163;129;154644.0;123066.0;277710.0
315120;201806;1666;850;816;805387.2;776270.6;1581657.9
315130;201806;343;249;94;237546.0;89676.0;327222.0
315140;201806;531;311;220;295072.2;209880.0;504952.2
315150;201806;983;466;517;443611.0;492932.0;936543.0
315160;201806;213;109;104;103986.0;99216.0;203202.0
315170;201806;336;216;120;205111.0;114193.8;319304.8
315180;201806;3203;1359;1844;1293672.5;1755746.9;3049419.2
315190;201806;316;182;134;173247.0;127836.0;301083.0
315200;201806;1199;689;510;655684.2;485681.4;1141365.6
315210;201806;1557;890;667;845913.4;633898.2;1479811.6
315213;201806;44;25;19;23850.0;18126.0;41976.0
315217;201806;215;172;43;164088.0;41022.0;205110.0
315220;201806;1545;1183;362;1127676.4;344966.6;1472643.0
315230;201806;170;124;46;117342.2;43884.0;161226.2
315240;201806;428;277;151;264258.0;142852.5;407110.5
315250;201806;2562;1264;1298;1205278.9;1237233.9;2442512.8
315260;201806;150;91;59;85860.0;56286.0;142146.0
315270;201806;133;92;41;87195.6;38388.96;125584.56
315280;201806;695;455;240;433689.0;228950.45;662639.44
315290;201806;200;117;83;111618.0;78228.49;189846.48
315300;201806;73;49;24;46746.0;22896.0;69642.0
315310;201806;68;62;6;59148.0;5724.0;64872.0
315320;201806;163;93;70;88722.0;66780.0;155502.0
315330;201806;58;50;8;47700.0;7632.0;55332.0
315340;201806;423;299;124;284063.6;118296.0;402359.6
315350;201806;151;90;61;85860.0;58194.0;144054.0
315360;201806;96;52;44;49608.0;41976.0;91584.0
315370;201806;58;35;23;32675.0;21798.9;54473.9
315380;201806;12;7;5;6678.0;4770.0;11448.0
315390;201806;63;14;49;13356.0;46746.0;60102.0
315400;201806;828;620;208;586042.5;197764.2;783806.7
315410;201806;353;217;136;206732.0;129458.0;336190.0
315415;201806;62;47;15;44838.0;14310.0;59148.0
315420;201806;206;156;50;147728.0;47700.0;195428.0
315430;201806;678;393;285;373682.0;271413.8;645095.8
315440;201806;88;61;27;58194.0;25758.0;83952.0
315445;201806;258;206;52;196209.19;49608.0;245817.19
315450;201806;177;133;44;126882.0;41976.0;168858.0
315460;201806;3452;1725;1727;1642589.4;1644831.1;3287420.5
315470;201806;43;21;22;20034.0;20988.0;41022.0
315480;201806;62;24;38;22896.0;36252.0;59148.0
315490;201806;626;389;237;369054.9;226098.0;595152.9
315500;201806;22;14;8;13356.0;7632.0;20988.0
315510;201806;153;102;51;97308.0;48654.0;145962.0
315520;201806;71;62;9;59148.0;8586.0;67734.0
315530;201806;53;28;25;26712.0;23850.0;50562.0
315540;201806;236;155;81;147870.0;77274.0;225144.0
315550;201806;176;141;35;134514.0;33390.0;167904.0
315560;201806;742;593;149;564382.8;142146.0;706528.8
315570;201806;318;167;151;156123.5;144054.0;300177.5
315580;201806;672;441;231;420047.0;220374.0;640421.0
315590;201806;207;108;99;103032.0;94446.0;197478.0
315600;201806;298;218;80;207018.0;76130.0;283148.0
315610;201806;99;48;51;45792.0;48654.0;94446.0
315620;201806;33;27;6;25758.0;5724.0;31482.0
315630;201806;135;90;45;85860.0;42930.0;128790.0
315640;201806;64;38;26;36252.0;24804.0;61056.0
315645;201806;65;46;19;43884.0;17649.0;61533.0
315650;201806;168;122;46;115816.0;43311.6;159127.6
315660;201806;478;209;269;199386.0;256626.0;456012.0
315670;201806;2399;1201;1198;1142969.4;1141719.6;2284689.0
315680;201806;865;587;278;557517.6;265212.0;822729.6
315690;201806;688;470;218;448259.0;207972.0;656231.0
315700;201806;1922;1016;906;965392.4;864229.0;1829621.4
315710;201806;334;94;240;89676.0;228960.0;318636.0
315720;201806;438;282;156;269028.0;148824.0;417852.0
315725;201806;201;161;40;153594.0;38160.0;191754.0
315727;201806;43;22;21;20988.0;20034.0;41022.0
315730;201806;46;44;2;41976.0;1908.0;43884.0
315733;201806;87;57;30;54378.0;28620.0;82998.0
315737;201806;51;39;12;37206.0;11448.0;48654.0
315740;201806;48;40;8;38160.0;7632.0;45792.0
315750;201806;158;122;36;116388.0;34344.0;150732.0
315760;201806;47;34;13;32436.0;12402.0;44838.0
315765;201806;120;77;43;73458.0;41022.0;114480.0
315770;201806;233;143;90;136422.0;85574.0;221996.0
315780;201806;3295;1706;1589;1620952.0;1513522.6;3134474.5
315790;201806;211;160;51;152640.0;48081.6;200721.6
315800;201806;286;205;81;195570.0;77274.0;272844.0
315810;201806;95;57;38;54378.0;35966.0;90344.0
315820;201806;796;577;219;547883.3;208926.0;756809.3
315830;201806;141;81;60;77274.0;57240.0;134514.0
315840;201806;93;65;28;62010.0;26712.0;88722.0
315850;201806;259;194;65;185076.0;62010.0;247086.0
315860;201806;12;4;8;3816.0;7632.0;11448.0
315870;201806;35;27;8;25758.0;7632.0;33390.0
315880;201806;107;70;37;66780.0;35298.0;102078.0
315890;201806;82;61;21;58194.0;20034.0;78228.0
315895;201806;461;312;149;296599.0;141574.0;438173.0
315900;201806;71;34;37;32150.0;35298.0;67448.0
315910;201806;37;24;13;22657.5;12402.0;35059.5
315920;201806;184;118;66;112572.0;62010.9;174582.9
315930;201806;42;14;28;13356.0;26712.0;40068.0
315935;201806;150;118;32;112572.0;30519.0;143091.0
315940;201806;93;69;24;65826.0;22896.0;88722.0
315950;201806;64;45;19;42930.0;18126.0;61056.0
315960;201806;558;259;299;245817.58;284387.6;530205.2
315970;201806;38;30;8;28620.0;7632.0;36252.0
315980;201806;696;327;369;309721.0;352016.47;661737.44
315990;201806;254;152;102;144770.0;97013.0;241783.0
316000;201806;50;33;17;31195.8;15931.8;47127.6
316010;201806;75;63;12;60102.0;11448.0;71550.0
316020;201806;111;92;19;87768.0;18126.0;105894.0
316030;201806;406;215;191;204824.0;181690.0;386514.0
316040;201806;509;216;293;205110.2;279236.0;484346.2
316045;201806;60;53;7;50562.0;6678.0;57240.0
316050;201806;16;14;2;13356.0;1908.0;15264.0
316060;201806;94;61;33;58194.0;31482.0;89676.0
316070;201806;1072;697;375;658805.4;356987.0;1015792.4
316080;201806;103;65;38;61294.5;36252.0;97546.5
316090;201806;41;25;16;23182.2;15264.0;38446.2
316095;201806;73;61;12;57918.0;11448.0;69366.0
316100;201806;312;184;128;175011.3;122112.0;297123.3
316105;201806;34;23;11;21942.0;10494.0;32436.0
316110;201806;1922;1549;373;1467300.5;355174.2;1822474.8
316120;201806;80;60;20;57240.0;18793.8;76033.8
316130;201806;138;106;32;100457.0;30528.0;130985.0
316140;201806;26;19;7;18126.0;6678.0;24804.0
316150;201806;206;143;63;135706.5;60102.0;195808.5
316160;201806;84;50;34;47700.0;32436.0;80136.0
316165;201806;61;45;16;42740.0;14548.5;57288.5
316170;201806;205;139;66;131652.0;62964.0;194616.0
316180;201806;205;90;115;85526.1;109710.0;195236.1
316190;201806;140;103;37;97308.0;35298.0;132606.0
316200;201806;706;393;313;374922.0;297743.4;672665.4
316210;201806;769;516;253;491917.4;241362.0;733279.44
316220;201806;116;80;36;76320.0;34344.0;110664.0
316225;201806;24;14;10;13356.0;9540.0;22896.0
316230;201806;31;19;12;18126.0;11448.0;29574.0
316240;201806;628;505;123;481770.0;117342.0;599112.0
316245;201806;110;92;18;87768.0;17172.0;104940.0
316250;201806;1519;1060;459;1003398.9;436703.12;1440102.0
316255;201806;110;90;20;85478.4;19065.69;104544.09
316257;201806;186;96;90;91584.0;85573.8;177157.8
316260;201806;242;160;82;151343.06;78133.0;229476.06
316265;201806;27;18;9;17172.0;8586.0;25758.0
316270;201806;678;470;208;445094.4;198432.0;643526.4
316280;201806;539;330;209;313549.8;198718.6;512268.4
316290;201806;696;464;232;439604.2;221328.0;660932.2
316292;201806;516;205;311;195283.8;296456.0;491739.8
316294;201806;101;58;43;55332.0;41022.0;96354.0
316295;201806;297;133;164;124957.0;156456.0;281413.0
316300;201806;103;73;30;69642.0;28620.0;98262.0
316310;201806;38;20;18;18793.8;17172.0;35965.8
316320;201806;42;27;15;25758.0;14310.0;40068.0
316330;201806;131;85;46;80136.5;43597.8;123734.3
316340;201806;146;99;47;94446.0;44838.0;139284.0
316350;201806;193;140;53;133394.0;50562.0;183956.0
316360;201806;23;17;6;16218.0;5724.0;21942.0
316370;201806;1090;582;508;551432.5;484336.25;1035768.75
316380;201806;121;92;29;87768.0;27666.0;115434.0
316390;201806;124;89;35;84906.0;33390.0;118296.0
316400;201806;139;105;34;100170.0;32436.0;132606.0
316410;201806;306;225;81;213075.08;77274.0;290349.1
316420;201806;207;147;60;139522.5;57240.0;196762.5
316430;201806;156;80;76;76320.0;72504.0;148824.0
316440;201806;100;47;53;44838.0;50562.0;95400.0
316443;201806;39;35;4;33390.0;3816.0;37206.0
316447;201806;65;51;14;48654.0;13356.0;62010.0
316450;201806;222;166;56;158364.0;53424.0;211788.0
316460;201806;71;29;42;27666.0;40068.0;67734.0
316470;201806;1620;1167;453;1105612.5;430041.16;1535653.6
316480;201806;13;10;3;9540.0;2862.0;12402.0
316490;201806;18;7;11;6678.0;10494.0;17172.0
316500;201806;153;102;51;97021.8;48654.0;145675.8
316510;201806;164;125;39;118248.3;37206.0;155454.3
316520;201806;185;110;75;104940.0;71550.0;176490.0
316530;201806;158;113;45;107802.0;42643.8;150445.8
316540;201806;143;79;64;75366.0;61056.0;136422.0
316550;201806;139;99;40;94446.0;38160.0;132606.0
316553;201806;250;117;133;111395.53;126882.0;238277.53
316555;201806;34;27;7;24954.0;6678.0;31632.0
316556;201806;11;8;3;7632.0;2862.0;10494.0
316557;201806;18;14;4;13356.0;3816.0;17172.0
316560;201806;62;48;14;45792.0;13356.0;59148.0
316570;201806;243;220;23;209642.0;21942.0;231584.0
316580;201806;22;16;6;15264.0;5724.0;20988.0
316590;201806;114;98;16;93492.0;15264.0;108756.0
316600;201806;180;146;34;139095.0;32436.0;171531.0
316610;201806;66;47;19;44551.8;18126.0;62677.8
316620;201806;136;104;32;99216.0;30528.0;129744.0
316630;201806;43;31;12;29574.0;11448.0;41022.0
316640;201806;16;10;6;9540.0;5724.0;15264.0
316650;201806;70;52;18;49608.0;17172.0;66780.0
316660;201806;7;4;3;3816.0;2862.0;6678.0
316670;201806;445;158;287;150713.0;273225.8;423938.8
316680;201806;163;115;48;109710.0;45602.0;155312.0
316690;201806;194;124;70;118296.0;66780.0;185076.0
316695;201806;60;53;7;50562.0;6678.0;57240.0
316700;201806;15;8;7;7632.0;6678.0;14310.0
316710;201806;719;520;199;495842.0;189846.0;685688.0
316720;201806;4930;2509;2421;2379088.2;2304512.5;4683600.5
316730;201806;15;14;1;13356.0;954.0;14310.0
316740;201806;127;80;47;76320.0;44838.0;121158.0
316750;201806;21;14;7;13356.0;6678.0;20034.0
316760;201806;327;263;64;250902.0;61056.0;311958.0
316770;201806;143;80;63;76320.0;60102.0;136422.0
316780;201806;75;45;30;42624.72;28620.0;71244.72
316790;201806;56;43;13;41022.0;12402.0;53424.0
316800;201806;1799;1105;694;1053120.8;660646.2;1713767.0
316805;201806;18;10;8;9540.0;7632.0;17172.0
316810;201806;67;44;23;41976.0;21942.0;63918.0
316820;201806;41;20;21;19080.0;20034.0;39114.0
316830;201806;93;41;52;39114.0;49608.0;88722.0
316840;201806;507;306;201;291638.0;190800.0;482438.0
316850;201806;339;221;118;209450.7;112572.0;322022.7
316860;201806;6051;2686;3365;2548285.5;3205713.2;5753998.5
316870;201806;1474;960;514;906589.5;484920.2;1391509.8
316880;201806;116;65;51;61723.8;48654.0;110377.8
316890;201806;254;169;85;161179.0;81090.0;242269.0
316900;201806;425;292;133;276021.28;126882.0;402903.28
316905;201806;17;9;8;8586.0;7632.0;16218.0
316910;201806;52;25;27;23850.0;25758.0;49608.0
316920;201806;136;105;31;99455.0;29574.0;129029.0
316930;201806;1933;987;946;935828.2;900285.94;1836114.1
316935;201806;870;523;347;496795.2;330084.0;826879.2
316940;201806;1111;642;469;611514.4;446844.25;1058358.6
316950;201806;184;95;89;90630.0;84906.0;175536.0
316960;201806;1114;624;490;593960.8;467164.47;1061125.2
316970;201806;639;498;141;474806.0;134514.0;609320.0
316980;201806;109;67;42;63918.0;40058.46;103976.46
316990;201806;2213;1458;755;1383540.1;717074.56;2100614.8
317000;201806;335;257;78;244892.0;74412.0;319304.0
317005;201806;248;177;71;168858.0;67734.0;236592.0
317010;201806;6314;3473;2841;3293214.0;2708406.2;6001620.5
317020;201806;16309;7203;9106;6839913.0;8671880.0;1,55E+14
317030;201806;82;33;49;31482.0;46529.26;78011.26
317040;201806;3109;1941;1168;1848405.2;1111506.6;2959912.0
317043;201806;75;54;21;51516.0;20034.0;71550.0
317047;201806;36;18;18;17172.0;17168.0;34340.0
317050;201806;180;134;46;127836.0;43884.0;171720.0
317052;201806;129;98;31;93492.0;29574.0;123066.0
317057;201806;204;153;51;145962.0;48082.0;194044.0
317060;201806;57;37;20;35298.0;18793.8;54091.8
317065;201806;58;45;13;42930.0;12402.0;55332.0
317070;201806;1995;940;1055;891991.7;1005325.6;1897317.2
317075;201806;108;57;51;54378.0;48654.0;103032.0
317080;201806;834;438;396;416754.9;377594.0;794348.9
317090;201806;635;509;126;483249.5;120204.0;603453.5
317100;201806;426;319;107;302418.0;102078.0;404496.0
317103;201806;110;96;14;91584.0;13356.0;104940.0
317107;201806;38;34;4;32436.0;3816.0;36252.0
317110;201806;105;44;61;41976.0;58194.0;100170.0
317115;201806;41;35;6;33390.0;5724.0;39114.0
317120;201806;1847;943;904;891718.6;861959.0;1753677.6
317130;201806;1949;1252;697;1189647.0;664271.0;1853918.0
317140;201806;10;7;3;6678.0;2862.0;9540.0
317150;201806;271;160;111;152354.0;105130.8;257484.8
317160;201806;310;224;86;213379.0;81758.0;295137.0
317170;201806;209;143;66;136422.0;62964.0;199386.0
317180;201806;435;313;122;297886.5;116388.0;414274.5
317190;201806;253;170;83;162180.0;78895.8;241075.8
317200;201806;816;574;242;535204.0;230630.0;765834.0
317210;201806;155;88;67;82998.2;63918.0;146916.2
317220;201806;19;13;6;12402.0;5724.0;18126.0
320010;201806;620;462;158;437410.5;150732.0;588142.5
320013;201806;133;98;35;93492.0;33390.0;126882.0
320016;201806;283;180;103;171720.0;98262.0;269982.0
320020;201806;722;432;290;409578.75;274752.3;684331.06
320030;201806;152;112;40;106848.0;37826.1;144674.1
320035;201806;137;101;36;96354.0;34344.0;130698.0
320040;201806;503;258;245;245273.8;233444.0;478717.8
320050;201806;119;89;30;84906.0;28620.0;113526.0
320060;201806;1578;747;831;712591.0;792097.6;1504688.6
320070;201806;105;70;35;66780.0;33390.0;100170.0
320080;201806;762;436;326;413113.0;311004.0;724117.0
320090;201806;1216;843;373;800868.9;354983.6;1155852.5
320100;201806;324;186;138;177444.0;131652.0;309096.0
320110;201806;136;87;49;81138.2;46460.0;127598.2
320115;201806;113;91;22;86814.0;20988.0;107802.0
320120;201806;3313;1842;1471;1746014.4;1400476.9;3146491.2
320130;201806;7460;3539;3921;3355493.8;3733843.8;7089337.5
320140;201806;418;271;147;257199.2;139994.0;397193.2
320150;201806;1925;1119;806;1059737.6;768628.25;1828365.9
320160;201806;683;310;373;293537.03;354576.06;648113.06
320170;201806;119;94;25;88913.0;23850.0;112763.0
320180;201806;52;30;22;28620.0;20988.0;49608.0
320190;201806;236;155;81;147097.27;76988.0;224085.27
320200;201806;57;45;12;42930.0;11448.0;54378.0
320210;201806;848;475;373;451624.6;354870.0;806494.6
320220;201806;306;114;192;108756.0;182882.0;291638.0
320225;201806;77;63;14;60102.0;13356.0;73458.0
320230;201806;564;366;198;347638.4;188082.0;535720.4
320240;201806;3148;1573;1575;1498162.8;1499883.8;2998046.5
320245;201806;458;314;144;298411.4;137376.0;435787.4
320250;201806;231;123;108;116388.6;103032.0;219420.6
320255;201806;145;114;31;107449.02;29431.0;136880.02
320260;201806;178;125;53;119250.0;50514.3;169764.3
320265;201806;160;127;33;120348.0;31482.0;151830.0
320270;201806;150;123;27;117342.0;25758.0;143100.0
320280;201806;969;577;392;545498.2;373682.0;919180.2
320290;201806;67;57;10;54378.0;9540.0;63918.0
320300;201806;541;385;156;364543.8;147775.1;512318.9
320305;201806;675;368;307;351072.0;292688.0;643760.0
320310;201806;215;120;95;112525.5;89874.0;202399.5
320313;201806;306;157;149;149778.0;141860.0;291638.0
320316;201806;107;88;19;83952.0;18126.0;102078.0
320320;201806;3342;1519;1823;1444062.0;1736161.8;3180223.8
320330;201806;256;189;67;179643.3;62010.8;241654.1
320332;201806;889;537;352;510441.6;334759.3;845200.9
320334;201806;239;144;95;137090.0;90630.0;227720.0
320335;201806;146;105;41;99216.4;39114.0;138330.4
320340;201806;587;405;182;385226.0;172961.0;558187.0
320350;201806;967;415;552;393431.66;525196.5;918628.1
320360;201806;169;92;77;87482.0;73458.0;160940.0
320370;201806;243;188;55;177660.0;51437.0;229097.0
320380;201806;285;195;90;184361.3;85860.0;270221.3
320390;201806;1134;689;445;654788.8;423910.12;1078698.9
320400;201806;317;228;89;216559.0;84906.0;301465.0
320405;201806;905;387;518;368621.6;493859.9;862481.5
320410;201806;985;503;482;478193.4;459457.34;937650.75
320420;201806;482;247;235;235161.4;224190.0;459351.4
320425;201806;192;104;88;99216.0;83952.0;183168.0
320430;201806;392;223;169;211120.7;161226.0;372346.7
320435;201806;170;114;56;107935.56;53424.0;161359.56
320440;201806;203;123;80;117055.8;76320.0;193375.8
320450;201806;130;77;53;73458.0;50562.0;124020.0
320455;201806;250;205;45;194617.0;42930.0;237547.0
320460;201806;235;149;86;142146.0;82044.0;224190.0
320465;201806;114;77;37;73095.48;35298.0;108393.48
320470;201806;639;407;232;387974.25;221324.0;609298.25
320480;201806;179;120;59;113669.1;56286.0;169955.1
320490;201806;3035;1518;1517;1445263.1;1443777.6;2889040.8
320495;201806;95;58;37;55313.0;35298.0;90611.0
320500;201806;9512;4787;4725;4538542.5;4495527.5;9034070.0
320501;201806;550;279;271;266166.0;258534.0;524700.0
320503;201806;288;204;84;193662.2;80136.0;273798.2
320506;201806;258;193;65;184122.0;62010.0;246132.0
320510;201806;960;451;509;426392.3;484060.1;910452.4
320515;201806;81;68;13;63918.9;12402.0;76320.9
320517;201806;207;147;60;140238.0;57240.0;197478.0
320520;201806;6918;3083;3835;2926821.8;3651027.5;6577849.0
320530;201806;5316;2659;2657;2528906.2;2531533.0;5060439.0
330010;201806;3138;1617;1521;1535244.1;1447473.1;2982717.2
330015;201806;159;66;93;61820.08;88722.0;150542.08
330020;201806;3643;1597;2046;1520944.5;1951312.0;3472256.5
330022;201806;231;130;101;123305.0;95400.8;218705.8
330023;201806;540;186;354;176394.8;337716.0;514110.8
330025;201806;578;120;458;114480.0;436359.8;550839.8
330030;201806;1943;1248;695;1182251.1;659761.7;1842012.9
330040;201806;2387;1229;1158;1169515.9;1102589.2;2272105.2
330045;201806;8338;2653;5685;2522834.8;5417205.5;7940040.0
330050;201806;825;526;299;501804.0;285246.0;787050.0
330060;201806;921;569;352;538535.1;334491.47;873026.56
330070;201806;3461;1318;2143;1250470.0;2043107.5;3293577.5
330080;201806;1497;703;794;666353.3;755950.4;1422303.8
330090;201806;358;213;145;203202.0;138330.0;341532.0
330093;201806;281;126;155;120204.0;147834.0;268038.0
330095;201806;102;54;48;50848.2;45792.0;96640.2
330100;201806;9475;4869;4606;4633999.0;4390833.0;9024832.0
330110;201806;485;215;270;202725.1;257580.0;460305.1
330115;201806;534;307;227;292878.0;216558.0;509436.0
330120;201806;375;194;181;183931.2;171720.4;355651.6
330130;201806;1546;424;1122;403770.97;1070370.0;1474141.0
330140;201806;596;314;282;299529.0;268075.0;567604.0
330150;201806;446;261;185;247086.0;175536.0;422622.0
330160;201806;210;130;80;124020.0;76320.0;200340.0
330170;201806;27020;9514;17506;9053988.0;1,67E+14;2,57E+13
330180;201806;235;149;86;139599.02;81328.5;220927.52
330185;201806;826;331;495;314238.6;470962.8;785201.4
330187;201806;306;95;211;90630.0;201294.0;291924.0
330190;201806;5585;2253;3332;2138283.2;3175718.8;5314002.0
330200;201806;4523;1513;3010;1437489.0;2866477.8;4303967.0
330205;201806;402;243;159;231392.7;151400.0;382792.7
330210;201806;1006;617;389;581688.0;369436.9;951124.94
330220;201806;2569;1536;1033;1461013.5;984528.2;2445541.8
330225;201806;566;303;263;288423.0;250234.2;538657.2
330227;201806;2425;771;1654;732376.44;1577560.2;2309936.8
330230;201806;203;122;81;115721.0;77274.0;192995.0
330240;201806;3679;1939;1740;1845162.2;1657023.5;3502185.8
330245;201806;155;67;88;63918.0;83188.8;147106.8
330250;201806;6526;3395;3131;3227197.5;2978307.2;6205505.0
330260;201806;565;163;402;155502.0;383508.0;539010.0
330270;201806;3410;1253;2157;1194505.0;2057207.2;3251712.2
330280;201806;452;289;163;273914.1;155493.0;429407.1
330285;201806;7098;2331;4767;2218417.2;4545132.5;6763549.5
330290;201806;564;216;348;206064.0;331992.0;538056.0
330300;201806;785;521;264;493218.7;251838.0;745056.7
330310;201806;421;241;180;228006.7;171720.0;399726.7
330320;201806;8273;3130;5143;2978058.0;4899769.0;7877827.5
330330;201806;9219;3633;5586;3457547.0;5325426.5;8782973.0
330340;201806;2652;1578;1074;1503376.9;1024576.94;2527953.8
330350;201806;18020;7108;10912;6752105.5;1,04E+14;1,71E+14
330360;201806;2501;1247;1254;1188665.2;1196307.0;2384972.2
330370;201806;1015;557;458;530424.0;434929.6;965353.6
330380;201806;852;363;489;345576.97;465409.8;810986.75
330385;201806;609;317;292;301465.0;278568.0;580033.0
330390;201806;5188;2876;2312;2728888.5;2202800.5;4931689.0
330395;201806;281;174;107;164279.1;100313.2;264592.3
330400;201806;699;366;333;345730.6;315211.1;660941.7
330410;201806;498;355;143;337002.0;135932.33;472934.34
330411;201806;231;131;100;124793.0;95352.3;220145.3
330412;201806;255;104;151;98930.0;144054.0;242984.0
330414;201806;6078;2484;3594;2365740.5;3426225.2;5791966.0
330415;201806;591;275;316;261396.0;300510.8;561906.8
330420;201806;2269;1190;1079;1131035.8;1026973.0;2158008.8
330430;201806;1793;838;955;797258.8;909067.8;1706326.6
330440;201806;268;123;145;117342.0;138330.0;255672.0
330450;201806;121;51;70;48654.0;66780.0;115434.0
330452;201806;1753;836;917;796077.8;874495.75;1670573.5
330455;201806;110862;39789;71073;3,79E+14;6,77E+14;1,06E+14
330460;201806;261;106;155;101124.0;147870.0;248994.0
330470;201806;1232;670;562;632887.0;536138.44;1169025.5
330475;201806;1401;375;1026;356796.8;978231.6;1335028.4
330480;201806;761;404;357;384748.2;339625.0;724373.2
330490;201806;13724;4800;8924;4572585.0;8507310.0;1,31E+14
330500;201806;1339;612;727;583704.9;693177.0;1276881.9
330510;201806;11254;3811;7443;3627215.0;7093931.5;1,07E+14
330513;201806;105;52;53;49608.0;50562.0;100170.0
330515;201806;852;350;502;330829.0;478527.0;809356.0
330520;201806;2566;954;1612;909897.0;1537695.9;2447593.0
330530;201806;223;118;105;112334.0;99980.0;212314.0
330540;201806;349;175;174;166950.0;165519.0;332469.0
330550;201806;3045;1080;1965;1028126.2;1872320.8;2900447.0
330555;201806;763;288;475;274733.0;452196.8;726929.8
330560;201806;572;209;363;199386.0;346284.0;545670.0
330570;201806;254;177;77;168858.0;73458.0;242316.0
330575;201806;802;340;462;324122.0;438693.5;762815.5
330580;201806;3382;1899;1483;1805744.0;1413303.8;3219047.8
330590;201806;310;151;159;144054.0;151686.0;295740.0
330600;201806;1106;712;394;677111.25;374178.84;1051290.1
330610;201806;1533;840;693;794493.75;656973.9;1451467.6
330615;201806;191;142;49;135468.0;46746.0;182214.0
330620;201806;1068;437;631;414228.5;600543.8;1014772.3
330630;201806;3931;2504;1427;2373991.0;1354110.8;3728101.8
350010;201806;597;391;206;371154.66;196524.0;567678.7
350020;201806;39;19;20;18126.0;19080.0;37206.0
350030;201806;525;337;188;320354.0;178162.66;498516.66
350040;201806;127;51;76;48310.56;72504.0;120814.56
350050;201806;287;156;131;148824.0;124717.46;273541.47
350055;201806;87;50;37;47700.0;35298.0;82998.0
350060;201806;75;27;48;25758.0;45792.0;71550.0
350070;201806;812;472;340;444840.6;322693.56;767534.1
350075;201806;64;43;21;41022.0;20034.0;61056.0
350080;201806;53;33;20;30845.96;17839.8;48685.76
350090;201806;96;54;42;51516.0;40063.23;91579.23
350100;201806;292;184;108;174820.5;103032.0;277852.5
350110;201806;57;35;22;33390.0;20988.0;54378.0
350115;201806;160;98;62;92824.2;59148.0;151972.2
350120;201806;110;74;36;70596.0;34344.0;104940.0
350130;201806;354;173;181;164472.0;172674.0;337146.0
350140;201806;34;20;14;18317.0;13356.0;31673.0
350150;201806;70;54;16;51516.0;15264.0;66780.0
350160;201806;2559;992;1567;943299.2;1493845.9;2437145.0
350170;201806;412;249;163;235638.2;155216.0;390854.2
350180;201806;183;98;85;93492.0;81090.0;174582.0
350190;201806;991;517;474;491216.62;451895.5;943112.1
350200;201806;67;25;42;23850.0;39803.08;63653.08
350210;201806;1360;768;592;725639.1;564250.7;1289889.8
350220;201806;673;579;94;548228.75;89676.0;637904.75
350230;201806;84;60;24;57240.0;22896.0;80136.0
350240;201806;60;45;15;42930.0;14310.0;57240.0
350250;201806;1231;607;624;573737.0;594476.7;1168213.6
350260;201806;92;66;26;62964.0;24804.0;87768.0
350270;201806;827;538;289;512174.6;274256.9;786431.5
350275;201806;302;118;184;112191.0;175536.0;287727.0
350280;201806;4756;2438;2318;2312747.0;2208545.0;4521292.0
350290;201806;409;195;214;186025.23;203583.8;389609.03
350300;201806;49;24;25;22896.0;23850.0;46746.0
350310;201806;100;69;31;65826.0;29574.0;95400.0
350315;201806;39;24;15;22896.0;14310.0;37206.0
350320;201806;3298;1637;1661;1556337.8;1583813.2;3140151.0
350330;201806;1688;900;788;854500.94;750162.06;1604663.0
350335;201806;21;14;7;13356.0;6678.0;20034.0
350340;201806;132;62;70;59148.0;66447.0;125595.0
350350;201806;94;47;47;44838.0;44838.0;89676.0
350360;201806;127;83;44;79178.0;41976.0;121154.0
350370;201806;94;54;40;50562.96;38150.46;88713.42
350380;201806;757;324;433;308428.2;412318.8;720747.0
350390;201806;1425;576;849;548708.4;808801.4;1357509.8
350395;201806;25;20;5;19080.0;4770.0;23850.0
350400;201806;1677;893;784;842315.94;744384.2;1586700.1
350410;201806;2261;1020;1241;969990.94;1183000.0;2152991.0
350420;201806;233;142;91;134865.0;86814.0;221679.0
350430;201806;74;43;31;40450.0;29574.0;70024.0
350440;201806;147;108;39;102030.5;37206.0;139236.5
350450;201806;1603;978;625;926050.94;596155.0;1522206.0
350460;201806;333;122;211;116388.0;201007.8;317395.8
350470;201806;15;10;5;9540.0;4770.0;14310.0
350480;201806;164;88;76;83952.0;72504.0;156456.0
350490;201806;240;119;121;112572.8;115434.0;228006.8
350500;201806;38;19;19;18126.0;18126.0;36252.0
350510;201806;166;111;55;105894.0;52470.0;158364.0
350520;201806;454;215;239;201929.95;227369.95;429299.9
350530;201806;455;216;239;206064.0;228006.0;434070.0
350535;201806;69;54;15;51258.42;14310.0;65568.42
350540;201806;368;189;179;180306.0;170480.0;350786.0
350550;201806;2764;1638;1126;1555358.6;1073000.6;2628359.2
350560;201806;649;450;199;429295.22;189488.25;618783.5
350570;201806;4156;1736;2420;1650006.1;2306173.2;3956179.5
350580;201806;377;182;195;172675.0;186016.45;358691.47
350590;201806;894;489;405;465934.0;385416.0;851350.0
350600;201806;6225;3127;3098;2967240.0;2950460.5;5917700.5
350610;201806;1553;788;765;746186.4;729801.0;1475987.4
350620;201806;36;24;12;22896.0;11448.0;34344.0
350630;201806;241;136;105;128790.96;99217.0;228007.95
350635;201806;893;359;534;342200.0;508864.0;851064.0
350640;201806;118;86;32;82044.0;30528.0;112572.0
350650;201806;1890;1239;651;1177266.2;619609.5;1796875.9
350660;201806;751;339;412;322762.06;392090.0;714852.06
350670;201806;316;162;154;154310.0;146916.0;301226.0
350680;201806;176;94;82;89676.0;78228.0;167904.0
350690;201806;200;102;98;97308.0;93492.0;190800.0
350700;201806;718;345;373;326431.97;355842.0;682274.0
350710;201806;341;136;205;128535.56;195570.0;324105.56
350715;201806;52;44;8;41976.0;7632.0;49608.0
350720;201806;17;11;6;10494.0;5724.0;16218.0
350730;201806;42;27;15;25758.0;14310.0;40068.0
350740;201806;214;119;95;113230.26;90630.0;203860.27
350745;201806;19;9;10;8562.0;9540.0;18102.0
350750;201806;2153;1383;770;1311094.8;733943.94;2045038.8
350760;201806;3745;1627;2118;1549821.9;2016492.6;3566314.5
350770;201806;61;41;20;39114.0;19080.0;58194.0
350775;201806;49;36;13;34344.0;12393.0;46737.0
350780;201806;427;214;213;204156.0;203202.0;407358.0
350790;201806;362;155;207;147870.0;197478.0;345348.0
350800;201806;440;248;192;236592.0;183168.0;419760.0
350810;201806;519;419;100;398773.0;95400.0;494173.0
350820;201806;85;51;34;48654.0;32436.0;81090.0
350830;201806;80;45;35;42930.0;33390.0;76320.0
350840;201806;761;332;429;316489.5;407739.8;724229.3
350850;201806;1794;1038;756;985007.8;721183.44;1706191.2
350860;201806;600;352;248;331975.8;236592.0;568567.8
350870;201806;439;299;140;285246.0;133273.8;418519.8
350880;201806;283;152;131;142386.6;124306.2;266692.8
350890;201806;41;26;15;24804.0;14310.0;39114.0
350900;201806;1465;474;991;450729.94;944650.8;1395380.8
350910;201806;27;17;10;16218.0;9540.0;25758.0
350920;201806;606;336;270;320226.03;257580.0;577806.06
350925;201806;1196;639;557;606564.3;529661.4;1136225.8
350930;201806;98;58;40;55332.0;38160.0;93492.0
350940;201806;728;409;319;388919.34;302485.6;691404.94
350945;201806;104;77;27;72922.0;25758.0;98680.0
350950;201806;15548;7453;8095;7082413.0;7713908.5;1,48E+14
350960;201806;1276;593;683;561803.94;651578.0;1213382.0
350970;201806;1116;596;520;565375.6;495784.47;1061160.1
350980;201806;94;64;30;61056.0;28620.0;89676.0
350990;201806;360;127;233;120204.72;222282.0;342486.72
350995;201806;32;17;15;16218.0;14310.0;30528.0
351000;201806;636;448;188;425168.06;179352.0;604520.06
351010;201806;46;27;19;25758.0;18126.0;43884.0
351015;201806;53;37;16;35298.0;15264.0;50562.0
351020;201806;1647;957;690;911554.44;656066.0;1567620.5
351030;201806;332;232;100;218752.2;95400.0;314152.2
351040;201806;853;453;400;432162.0;380646.66;812808.7
351050;201806;3307;1552;1755;1472323.0;1673608.2;3145931.2
351060;201806;5073;2073;3000;1965879.8;2858966.0;4824845.5
351070;201806;412;265;147;250505.92;140238.0;390743.9
351080;201806;811;586;225;559044.0;213696.0;772740.0
351090;201806;63;27;36;25758.0;34344.0;60102.0
351100;201806;456;265;191;250588.48;182209.23;432797.72
351110;201806;2113;1010;1103;958792.9;1049625.6;2008418.5
351120;201806;72;36;36;34344.0;34344.0;68688.0
351130;201806;175;60;115;57240.0;109423.8;166663.8
351140;201806;342;240;102;227719.84;97308.0;325027.84
351150;201806;404;207;197;196572.8;187938.0;384510.8
351160;201806;246;163;83;155502.0;79182.0;234684.0
351170;201806;190;101;89;96354.0;84143.0;180497.0
351190;201806;91;61;30;58194.0;28620.0;86814.0
351200;201806;374;247;127;235034.05;121158.0;356192.03
351210;201806;128;61;67;57939.38;63918.0;121857.38
351220;201806;531;320;211;301707.12;201294.0;503001.12
351230;201806;285;209;76;199386.0;72484.92;271870.9
351240;201806;230;98;132;93492.0;125928.0;219420.0
351250;201806;72;50;22;47476.0;20988.0;68464.0
351260;201806;153;111;42;105894.0;39782.0;145676.0
351270;201806;51;21;30;20034.0;28620.0;48654.0
351280;201806;1115;502;613;476048.47;583970.4;1060018.9
351290;201806;229;103;126;98262.0;119918.0;218180.0
351300;201806;3734;1737;1997;1650138.4;1904817.0;3554955.2
351310;201806;764;396;368;377784.0;350786.0;728570.0
351320;201806;109;67;42;63918.0;40068.0;103986.0
351330;201806;40;27;13;25758.0;12402.0;38160.0
351340;201806;1249;779;470;736896.94;447586.22;1184483.1
351350;201806;2519;1370;1149;1304453.2;1095568.9;2400022.0
351360;201806;790;391;399;372060.0;380328.03;752388.06
351370;201806;373;190;183;181255.23;173945.95;355201.2
351380;201806;8953;4093;4860;3889037.0;4626182.0;8515219.0
351385;201806;30;20;10;19080.0;9540.0;28620.0
351390;201806;286;212;74;201294.02;70596.0;271890.03
351400;201806;66;41;25;39114.0;23812.92;62926.92
351410;201806;449;277;172;262987.03;164088.0;427075.03
351420;201806;60;49;11;46746.0;10494.0;57240.0
351430;201806;70;38;32;36252.0;30528.0;66780.0
351440;201806;791;550;241;522218.75;229910.0;752128.75
351450;201806;257;128;129;122112.0;123066.0;245178.0
351460;201806;118;54;64;51516.0;61056.0;112572.0
351470;201806;137;72;65;67447.8;62010.0;129457.8
351480;201806;524;298;226;283052.97;215484.75;498537.72
351490;201806;288;107;181;102078.0;172674.0;274752.0
351492;201806;31;22;9;20988.0;8586.0;29574.0
351495;201806;28;19;9;18126.0;8586.0;26712.0
351500;201806;3542;1538;2004;1461604.4;1907190.4;3368794.8
351510;201806;1789;747;1042;712352.0;991864.25;1704216.2
351512;201806;21;18;3;17172.0;2862.0;20034.0
351515;201806;194;111;83;105894.0;79182.0;185076.0
351518;201806;778;479;299;456008.0;285246.0;741254.0
351519;201806;75;47;28;44838.0;26712.0;71550.0
351520;201806;142;87;55;82361.96;52470.0;134831.95
351530;201806;23;15;8;14310.0;7632.0;21942.0
351535;201806;135;77;58;73458.0;55332.0;128790.0
351540;201806;455;328;127;310529.0;121158.0;431687.0
351550;201806;1327;808;519;765777.94;493208.88;1258986.8
351560;201806;73;39;34;37206.0;32436.0;69642.0
351565;201806;11;7;4;6678.0;3816.0;10494.0
351570;201806;2558;1323;1235;1259818.4;1177519.6;2437338.0
351580;201806;39;35;4;33390.0;3816.0;37206.0
351590;201806;68;46;22;43884.0;20988.0;64872.0
351600;201806;193;146;47;139284.0;44838.0;184122.0
351610;201806;58;30;28;28620.0;26712.0;55332.0
351620;201806;5923;3395;2528;3228423.8;2409531.2;5637955.0
351630;201806;2554;1319;1235;1253174.1;1175705.2;2428879.2
351640;201806;1684;824;860;784211.4;817197.1;1601408.5
351650;201806;31;26;5;24804.0;4770.0;29574.0
351660;201806;158;102;56;96354.0;53424.0;149778.0
351670;201806;734;456;278;432688.0;265212.0;697900.0
351680;201806;71;58;13;55332.0;12402.0;67734.0
351685;201806;38;25;13;23850.0;12402.0;36252.0
351690;201806;312;221;91;208969.62;86814.0;295783.62
351700;201806;157;108;49;103032.0;46746.0;149778.0
351710;201806;76;53;23;50562.0;21942.0;72504.0
351720;201806;131;61;70;58194.0;66780.0;124974.0
351730;201806;101;72;29;67734.96;27661.23;95396.19
351740;201806;718;484;234;459485.38;223231.23;682716.6
351750;201806;366;155;211;147234.0;201294.0;348528.0
351760;201806;787;612;175;584087.0;166950.0;751037.0
351770;201806;294;249;45;237546.0;42930.0;280476.0
351780;201806;173;100;73;95391.0;69642.0;165033.0
351790;201806;236;122;114;116388.0;108756.0;225144.0
351800;201806;52;33;19;31482.0;18126.0;49608.0
351810;201806;127;85;42;81090.0;40068.0;121158.0
351820;201806;880;632;248;597206.6;236301.23;833507.8
351830;201806;515;184;331;174772.8;315774.0;490546.8
351840;201806;1880;951;929;898310.0;884764.94;1783075.0
351850;201806;232;171;61;162514.8;58194.0;220708.8
351860;201806;754;505;249;476048.84;237255.23;713304.06
351870;201806;5636;2652;2984;2517889.0;2839723.2;5357612.0
351880;201806;18890;8265;10625;7863780.5;1,01E+14;1,80E+14
351885;201806;89;60;29;56525.0;27666.0;84191.0
351890;201806;71;60;11;57240.0;10494.0;67734.0
351900;201806;227;134;93;127169.0;88722.0;215891.0
351905;201806;78;34;44;32436.0;41976.0;74412.0
351907;201806;3162;1380;1782;1313651.0;1697949.8;3011600.8
351910;201806;183;76;107;72504.0;102078.0;174582.0
351920;201806;132;74;58;70596.0;55309.69;125905.69
351925;201806;87;60;27;57240.0;25758.0;82998.0
351930;201806;380;257;123;245082.6;117342.0;362424.6
351940;201806;237;105;132;100170.0;125928.0;226098.0
351950;201806;141;82;59;78228.0;56286.0;134514.0
351960;201806;867;404;463;385234.72;439546.38;824781.06
351970;201806;1919;1031;888;981427.8;846571.0;1827998.9
351980;201806;149;75;74;69642.0;70596.0;140238.0
351990;201806;275;185;90;175536.0;85058.64;260594.64
352000;201806;363;223;140;212742.0;133560.0;346302.0
352010;201806;355;213;142;203202.0;135468.0;338670.0
352020;201806;202;68;134;64872.0;127836.0;192708.0
352030;201806;1033;529;504;503950.5;479225.97;983176.44
352040;201806;583;253;330;241362.0;314820.0;556182.0
352042;201806;282;97;185;92538.0;176303.0;268841.0
352044;201806;393;232;161;220173.86;153594.0;373767.88
352050;201806;3261;1311;1950;1242724.9;1858764.2;3101489.2
352060;201806;105;65;40;62010.0;37874.0;99884.0
352070;201806;105;76;29;71234.0;27666.0;98900.0
352080;201806;67;42;25;39114.0;23850.0;62964.0
352090;201806;172;116;56;110664.0;53424.0;164088.0
352100;201806;260;128;132;121822.0;124776.0;246598.0
352110;201806;111;31;80;29574.0;76320.0;105894.0
352115;201806;69;25;44;23850.0;41976.0;65826.0
352120;201806;97;65;32;60770.0;30528.0;91298.0
352130;201806;219;182;37;173628.0;35298.0;208926.0
352140;201806;183;75;108;71073.0;103032.0;174105.0
352150;201806;121;67;54;62964.04;51516.0;114480.04
352160;201806;130;84;46;80136.0;43884.0;124020.0
352170;201806;372;255;117;242316.05;111618.0;353934.03
352180;201806;620;417;203;396197.5;193658.0;589855.5
352190;201806;257;99;158;94436.46;150693.84;245130.3
352200;201806;31;16;15;15264.0;14310.0;29574.0
352210;201806;3824;1588;2236;1506675.9;2126197.0;3632872.8
352215;201806;55;30;25;28620.0;23392.08;52012.08
352220;201806;6940;2720;4220;2589459.5;4023379.5;6612839.0
352230;201806;3226;2053;1173;1944303.9;1114288.5;3058592.2
352240;201806;2244;1310;934;1247546.8;888739.06;2136285.8
352250;201806;2599;1339;1260;1272655.0;1197976.0;2470631.0
352260;201806;1069;586;483;557513.25;460496.0;1018009.25
352265;201806;59;26;33;24804.0;31482.0;56286.0
352270;201806;411;235;176;223236.92;167848.0;391084.9
352280;201806;407;255;152;241999.0;145003.23;387002.22
352290;201806;178;113;65;107802.0;62010.0;169812.0
352300;201806;101;76;25;72504.0;23850.0;96354.0
352310;201806;5782;2796;2986;2654465.0;2843062.0;5497527.0
352320;201806;955;493;462;466827.84;438697.1;905524.94
352330;201806;523;243;280;231488.1;266834.0;498322.1
352340;201806;1395;678;717;644637.0;681015.3;1325652.2
352350;201806;325;204;121;194616.0;115148.0;309764.0
352360;201806;227;96;131;90677.7;122377.52;213055.22
352370;201806;100;69;31;65826.0;29574.0;95400.0
352380;201806;123;74;49;70596.0;46746.0;117342.0
352390;201806;2450;1115;1335;1060447.9;1271188.5;2331636.5
352400;201806;481;207;274;196762.5;261109.8;457872.3
352410;201806;768;548;220;519002.88;209880.0;728882.9
352420;201806;105;68;37;64872.0;35298.0;100170.0
352430;201806;1767;785;982;743837.8;933591.5;1677429.4
352440;201806;3178;1612;1566;1528164.5;1492016.8;3020181.2
352450;201806;195;163;32;155502.0;30528.0;186030.0
352460;201806;578;292;286;278010.7;272129.2;550139.9
352470;201806;614;207;407;197478.0;388269.0;585747.0
352480;201806;1380;774;606;737123.94;577551.8;1314675.8
352490;201806;83;31;52;29574.0;49608.0;79182.0
352500;201806;1206;533;673;506956.6;641557.0;1148513.6
352510;201806;745;405;340;385416.97;324360.0;709776.94
352520;201806;553;247;306;235638.0;291780.9;527418.9
352530;201806;1728;919;809;876726.0;771404.6;1648130.6
352540;201806;74;49;25;46746.0;23850.0;70596.0
352550;201806;183;104;79;99216.0;74698.2;173914.2
352560;201806;50;40;10;38160.0;9540.0;47700.0
352570;201806;673;348;325;331675.0;310030.9;641705.94
352580;201806;55;37;18;34344.65;17172.0;51516.65
352585;201806;17;5;12;4770.0;11448.0;16218.0
352590;201806;4367;2218;2149;2109567.8;2049245.4;4158813.2
352600;201806;359;246;113;233730.95;107802.0;341532.97
352610;201806;934;432;502;409867.34;478908.0;888775.3
352620;201806;955;391;564;372060.2;538056.0;910116.2
352630;201806;169;66;103;62964.0;98252.46;161216.45
352640;201806;563;391;172;370716.03;164088.0;534804.0
352650;201806;89;59;30;56286.0;28620.0;84906.0
352660;201806;80;47;33;44838.0;31482.0;76320.0
352670;201806;1677;912;765;867517.9;728447.56;1595965.5
352680;201806;897;578;319;547894.4;302864.03;850758.4
352690;201806;4398;2022;2376;1920273.9;2263124.8;4183398.5
352700;201806;107;63;44;59815.8;41976.0;101791.8
352710;201806;1369;731;638;695179.8;605023.6;1300203.4
352720;201806;1345;644;701;612118.2;668177.0;1280295.2
352725;201806;25;23;2;21942.0;1908.0;23850.0
352730;201806;367;184;183;174357.81;174582.0;348939.8
352740;201806;427;270;157;255625.69;149778.0;405403.7
352750;201806;22;14;8;13069.8;7632.0;20701.8
352760;201806;201;145;56;138330.0;53424.0;191754.0
352770;201806;83;65;18;62010.0;17172.0;79182.0
352780;201806;80;45;35;42930.0;33390.0;76320.0
352790;201806;30;24;6;22896.0;5724.0;28620.0
352800;201806;248;172;76;164088.0;72217.8;236305.8
352810;201806;165;110;55;102429.42;52470.0;154899.42
352820;201806;66;51;15;48228.52;14310.0;62538.52
352830;201806;93;64;29;61056.0;27666.0;88722.0
352840;201806;608;314;294;298269.2;280476.0;578745.2
352850;201806;1383;494;889;470608.2;847469.94;1318078.1
352860;201806;134;89;45;84270.0;42930.0;127200.0
352870;201806;46;30;16;28620.0;15264.0;43884.0
352880;201806;190;128;62;122092.92;59148.0;181240.92
352885;201806;29;21;8;20034.0;7632.0;27666.0
352890;201806;57;39;18;37206.0;16886.0;54092.0
352900;201806;4845;2332;2513;2205357.0;2389861.5;4595218.5
352910;201806;39;32;7;30528.0;6678.0;37206.0
352920;201806;705;433;272;412128.0;259488.0;671616.0
352930;201806;1262;611;651;581461.8;618056.1;1199517.9
352940;201806;6390;2754;3636;2616853.2;3465010.5;6081864.0
352950;201806;93;38;55;36252.0;52470.0;88722.0
352960;201806;64;41;23;39114.0;21942.0;61056.0
352965;201806;19;8;11;7632.0;10494.0;18126.0
352970;201806;472;352;120;332600.97;113527.0;446127.97
352980;201806;177;96;81;91584.0;76988.0;168572.0
352990;201806;955;418;537;397769.28;511210.1;908979.4
353000;201806;68;32;36;30528.0;34344.0;64872.0
353010;201806;550;339;211;323406.0;201274.92;524680.94
353020;201806;285;208;77;198432.0;73458.0;271890.0
353030;201806;1217;552;665;525635.44;633723.7;1159359.1
353040;201806;88;54;34;51516.0;32436.0;83952.0
353050;201806;1351;861;490;814804.0;467173.8;1281977.9
353060;201806;7978;3633;4345;3450534.5;4138887.0;7589421.5
353070;201806;1656;1055;601;1000520.44;571893.56;1572414.0
353080;201806;1352;723;629;687405.56;599108.0;1286513.5
353090;201806;56;33;23;31482.0;21942.0;53424.0
353100;201806;61;50;11;47700.0;10494.0;58194.0
353110;201806;2062;623;1439;592610.9;1370837.2;1963448.1
353120;201806;82;44;38;41976.0;36252.0;78228.0
353130;201806;864;431;433;410848.03;412960.12;823808.2
353140;201806;570;223;347;212681.0;331038.0;543719.0
353150;201806;362;203;159;192708.0;151676.45;344384.47
353160;201806;102;83;19;79182.0;18126.0;97308.0
353170;201806;197;65;132;62010.0;125900.46;187910.45
353180;201806;958;442;516;419660.7;491740.0;911400.7
353190;201806;489;350;139;332844.9;132320.0;465164.9
353200;201806;196;99;97;94446.0;92538.0;186984.0
353205;201806;25;18;7;17172.0;6678.0;23850.0
353210;201806;86;51;35;48654.0;33390.0;82044.0
353215;201806;53;31;22;29574.0;20988.0;50562.0
353220;201806;85;47;38;44838.0;35298.27;80136.27
353230;201806;161;63;98;60102.0;93492.0;153594.0
353240;201806;303;166;137;158364.0;130698.0;289062.0
353250;201806;206;107;99;102078.0;94446.0;196524.0
353260;201806;462;332;130;315584.5;124010.46;439594.97
353270;201806;67;49;18;46746.0;16504.2;63250.2
353280;201806;95;49;46;46269.0;43884.0;90153.0
353282;201806;122;87;35;82998.0;33390.0;116388.0
353284;201806;25;20;5;19080.0;4770.0;23850.0
353286;201806;1;1;0;954.0;0.0;954.0
353290;201806;81;47;34;44838.0;32427.0;77265.0
353300;201806;401;222;179;210961.95;170766.0;381727.97
353310;201806;54;47;7;44838.0;6678.0;51516.0
353320;201806;62;38;24;36252.0;22896.0;59148.0
353325;201806;58;35;23;33381.0;21638.0;55019.0
353330;201806;67;50;17;47557.0;16218.0;63775.0
353340;201806;623;206;417;195841.89;397232.25;593074.1
353350;201806;915;430;485;409229.62;461525.0;870754.6
353360;201806;110;88;22;83634.04;20702.0;104336.04
353370;201806;121;68;53;64872.0;50562.0;115434.0
353380;201806;26;18;8;17168.0;7632.0;24800.0
353390;201806;1075;518;557;494172.0;531378.0;1025550.0
353400;201806;51;31;20;29574.0;19080.0;48654.0
353410;201806;113;71;42;67734.0;40021.0;107755.0
353420;201806;58;23;35;21942.0;33390.0;55332.0
353430;201806;563;372;191;351167.3;181927.8;533095.1
353440;201806;10280;4483;5797;4266179.5;5523515.5;9789695.0
353450;201806;56;31;25;29574.0;23850.0;53424.0
353460;201806;613;337;276;319282.84;262579.5;581862.3
353470;201806;2136;1163;973;1105549.9;925836.25;2031386.1
353475;201806;236;159;77;148996.95;73458.0;222454.95
353480;201806;189;153;36;145962.0;34344.0;180306.0
353490;201806;238;142;96;135468.0;91584.0;227052.0
353500;201806;191;111;80;104940.96;76320.0;181260.95
353510;201806;100;72;28;68669.46;26702.46;95371.92
353520;201806;205;139;66;132606.0;62964.0;195570.0
353530;201806;466;252;214;240408.0;204156.0;444564.0
353540;201806;363;239;124;227683.27;118296.0;345979.28
353550;201806;745;506;239;478910.88;228006.0;706916.9
353560;201806;635;269;366;255346.89;348564.06;603910.94
353570;201806;60;31;29;29574.0;27666.0;57240.0
353580;201806;359;278;81;264735.0;77274.0;342009.0
353590;201806;89;61;28;57876.04;26712.0;84588.04
353600;201806;270;154;116;146599.0;110028.0;256627.0
353610;201806;113;60;53;57240.0;50562.0;107802.0
353620;201806;581;313;268;296615.5;255385.8;552001.3
353625;201806;50;28;22;26712.0;20988.0;47700.0
353630;201806;237;170;67;157774.6;63918.0;221692.6
353640;201806;126;84;42;79659.0;40068.0;119727.0
353650;201806;892;347;545;328939.2;519930.0;848869.2
353657;201806;24;18;6;17172.0;5724.0;22896.0
353660;201806;254;143;111;136422.0;105711.97;242133.97
353670;201806;770;455;315;433116.2;300510.0;733626.2
353680;201806;101;72;29;68450.0;27666.0;96116.0
353690;201806;46;36;10;34070.0;9540.0;43610.0
353700;201806;280;199;81;189846.0;77274.0;267120.0
353710;201806;441;201;240;190800.8;228674.0;419474.8
353715;201806;46;34;12;32149.8;11448.0;43597.8
353720;201806;356;161;195;153576.0;186030.0;339606.0
353730;201806;1114;689;425;655350.9;405450.0;1060800.9
353740;201806;652;359;293;342199.8;279522.0;621721.8
353750;201806;89;55;34;51938.14;32436.0;84374.14
353760;201806;2773;1039;1734;988670.9;1650633.2;2639304.2
353770;201806;96;80;16;75843.0;15264.0;91107.0
353780;201806;1157;571;586;543017.94;556850.0;1099868.0
353790;201806;509;293;216;277453.5;203465.34;480918.84
353800;201806;3268;1664;1604;1579283.9;1528881.4;3108165.2
353810;201806;236;133;103;126028.71;98253.0;224281.7
353820;201806;188;92;96;87768.0;90959.41;178727.4
353830;201806;48;41;7;39114.0;6678.0;45792.0
353850;201806;168;86;82;82044.0;78228.0;160272.0
353860;201806;472;217;255;206302.5;242983.8;449286.3
353870;201806;5091;2552;2539;2416949.5;2410743.5;4827693.0
353880;201806;681;487;194;463262.4;184122.12;647384.5
353890;201806;585;328;257;312340.0;244892.0;557232.0
353900;201806;129;65;64;62010.0;61056.0;123066.0
353910;201806;177;87;90;82998.0;85860.0;168858.0
353920;201806;450;245;205;232538.4;195127.16;427665.56
353930;201806;1018;597;421;567845.8;400399.8;968245.56
353940;201806;186;100;86;94636.8;81186.0;175822.8
353950;201806;525;320;205;304993.8;195561.0;500554.8
353960;201806;69;56;13;53424.0;12402.0;65826.0
353970;201806;74;44;30;41976.0;28620.0;70596.0
353980;201806;1536;752;784;715034.94;746779.2;1461814.1
353990;201806;74;42;32;40068.0;30528.0;70596.0
354000;201806;372;183;189;173915.0;180111.2;354026.2
354010;201806;93;52;41;49608.0;38637.0;88245.0
354020;201806;540;342;198;325314.0;188892.0;514206.0
354025;201806;53;42;11;40068.0;10494.0;50562.0
354030;201806;63;35;28;33390.0;26712.0;60102.0
354040;201806;98;69;29;65444.4;27666.0;93110.4
354050;201806;192;105;87;99884.0;82998.0;182882.0
354060;201806;765;369;396;352026.0;375543.4;727569.4
354070;201806;873;510;363;485010.03;346302.0;831312.0
354075;201806;217;115;102;109710.0;96354.8;206064.8
354080;201806;291;125;166;118963.8;158364.0;277327.8
354085;201806;19;12;7;11448.0;6678.0;18126.0
354090;201806;315;174;141;165915.0;134514.0;300429.0
354100;201806;5566;2322;3244;2203639.8;3089238.2;5292878.0
354105;201806;85;42;43;40068.0;41022.0;81090.0
354110;201806;48;22;26;20988.0;24804.0;45792.0
354120;201806;147;102;45;97168.97;42930.0;140098.97
354130;201806;703;465;238;443372.0;226762.0;670134.0
354140;201806;3166;1483;1683;1411959.4;1604037.9;3015997.2
354150;201806;653;411;242;389881.03;229437.0;619318.06
354160;201806;714;452;262;430015.5;249662.0;679677.5
354165;201806;23;14;9;13356.0;8586.0;21942.0
354170;201806;177;119;58;112858.2;55332.0;168190.2
354180;201806;66;41;25;38788.0;23850.0;62638.0
354190;201806;211;98;113;91870.2;107802.0;199672.2
354200;201806;131;73;58;69165.0;55332.0;124497.0
354210;201806;68;34;34;32436.0;32436.0;64872.0
354220;201806;633;389;244;370438.2;231536.34;601974.56
354230;201806;164;68;96;64872.0;90630.6;155502.6
354240;201806;317;205;112;194616.48;106848.0;301464.5
354250;201806;94;56;38;53424.0;36252.0;89676.0
354260;201806;1967;918;1049;865411.06;997594.7;1863005.8
354270;201806;94;71;23;67734.0;21942.0;89676.0
354280;201806;39;22;17;20988.0;16218.0;37206.0
354290;201806;141;99;42;93635.1;40068.0;133703.1
354300;201806;420;285;135;271573.0;128632.0;400205.0
354310;201806;103;76;27;71550.2;25758.0;97308.2
354320;201806;180;97;83;92538.0;79182.0;171720.0
354323;201806;16;14;2;13356.0;1908.0;15264.0
354325;201806;107;62;45;58342.0;42930.0;101272.0
354330;201806;2635;877;1758;832023.25;1674966.1;2506989.5
354340;201806;10607;5183;5424;4932717.0;5167769.5;1,01E+14
354350;201806;127;83;44;79182.0;41832.9;121014.9
354360;201806;88;49;39;46746.0;37206.0;83952.0
354370;201806;266;148;118;141192.0;112572.0;253764.0
354380;201806;211;126;85;119418.0;81090.0;200508.0
354390;201806;2777;1008;1769;959971.25;1686827.0;2646798.2
354400;201806;330;174;156;165329.0;148251.8;313580.8
354410;201806;621;299;322;283620.44;306234.2;589854.6
354420;201806;273;171;102;163134.0;97308.0;260442.0
354425;201806;314;182;132;173628.0;125928.0;299556.0
354430;201806;188;119;69;111951.9;65062.8;177014.7
354440;201806;40;28;12;26712.0;11448.0;38160.0
354450;201806;50;36;14;34344.0;13356.0;47700.0
354460;201806;106;61;45;58194.0;42838.0;101032.0
354470;201806;40;27;13;25758.0;12402.0;38160.0
354480;201806;118;59;59;56277.0;56276.46;112553.46
354490;201806;146;91;55;86654.97;52470.0;139124.97
354500;201806;394;195;199;186030.0;189846.0;375876.0
354510;201806;103;70;33;66780.0;31482.0;98262.0
354515;201806;39;14;25;13356.0;23850.0;37206.0
354520;201806;1643;718;925;683215.2;882011.56;1565226.8
354530;201806;676;356;320;337902.8;304136.0;642038.8
354540;201806;281;158;123;150732.0;117337.23;268069.22
354550;201806;42;25;17;23850.0;16218.0;40068.0
354560;201806;159;91;68;86528.0;64862.46;151390.45
354570;201806;136;87;49;82998.0;46746.0;129744.0
354580;201806;1977;934;1043;888459.0;994436.25;1882895.2
354600;201806;268;146;122;137030.12;116373.69;253403.81
354610;201806;71;65;6;61056.58;5724.0;66780.58
354620;201806;62;19;43;18126.0;41022.0;59148.0
354625;201806;18;11;7;10494.0;6674.0;17168.0
354630;201806;319;212;107;201873.34;102078.0;303951.34
354640;201806;806;525;281;496924.38;268074.0;764998.4
354650;201806;76;44;32;41680.8;30499.92;72180.72
354660;201806;805;595;210;563846.94;200340.0;764186.94
354670;201806;276;98;178;92300.0;168859.0;261159.0
354680;201806;1269;480;789;457920.0;752229.0;1210149.0
354690;201806;84;55;29;51517.0;27666.0;79183.0
354700;201806;77;55;22;52470.0;20988.0;73458.0
354710;201806;56;39;17;36569.96;16218.0;52787.96
354720;201806;20;19;1;18126.0;954.0;19080.0
354730;201806;1878;795;1083;756227.2;1032991.2;1789218.4
354740;201806;61;42;19;40068.0;18126.0;58194.0
354750;201806;433;255;178;243261.0;169812.0;413073.0
354760;201806;516;315;201;297949.0;191468.0;489417.0
354765;201806;12;5;7;4770.0;6678.0;11448.0
354770;201806;344;230;114;218596.03;107992.8;326588.84
354780;201806;8163;3328;4835;3162624.8;4608730.0;7771355.0
354790;201806;113;66;47;62964.0;44838.0;107802.0
354800;201806;436;239;197;228006.0;187632.92;415638.9
354805;201806;104;52;52;48972.0;49608.0;98580.0
354810;201806;136;78;58;74412.0;55332.0;129744.0
354820;201806;185;79;106;75157.0;101124.0;176281.0
354830;201806;42;23;19;21942.0;18126.0;40068.0
354840;201806;58;39;19;37206.0;18126.0;55332.0
354850;201806;4576;2032;2544;1930984.0;2422890.0;4353874.0
354860;201806;326;160;166;152640.0;156256.52;308896.53
354870;201806;12020;5453;6567;5174399.0;6254661.0;1,14E+13
354880;201806;3028;1128;1900;1074474.5;1810480.9;2884955.2
354890;201806;2874;1591;1283;1511662.5;1222999.4;2734661.8
354900;201806;60;39;21;37206.0;20034.0;57240.0
354910;201806;1239;650;589;616532.25;561906.0;1178438.2
354920;201806;49;41;8;39114.0;7632.0;46746.0
354925;201806;13;7;6;6678.0;5724.0;12402.0
354930;201806;31;28;3;26442.0;2862.0;29304.0
354940;201806;813;596;217;565915.7;207018.0;772933.7
354950;201806;221;147;74;139571.0;70596.0;210167.0
354960;201806;164;64;100;61056.0;95114.0;156170.0
354970;201806;866;567;299;536059.1;284607.03;820666.1
354980;201806;8449;3120;5329;2969122.2;5081138.5;8050260.5
354990;201806;9198;4354;4844;4139936.8;4614712.0;8754649.0
354995;201806;519;183;336;174582.0;320229.2;494811.2
355000;201806;489;164;325;156451.23;309811.5;466262.72
355010;201806;623;393;230;374922.0;217208.48;592130.5
355020;201806;718;453;265;431203.6;252802.0;684005.56
355030;201806;205831;79813;126018;7,59E+12;1,20E+16;1,96E+16
355040;201806;724;340;384;322309.6;366145.2;688454.8
355050;201806;155;103;52;96991.77;49608.0;146599.77
355060;201806;1549;768;781;727822.94;743882.3;1471705.2
355070;201806;1445;706;739;670654.2;704013.0;1374667.1
355080;201806;200;115;85;109710.0;80202.8;189912.8
355090;201806;298;197;101;185840.0;96354.0;282194.0
355100;201806;4858;2386;2472;2255778.5;2356076.8;4611855.0
355110;201806;269;170;99;161223.0;94446.0;255669.0
355120;201806;80;57;23;54378.0;21942.0;76320.0
355130;201806;54;30;24;28620.0;22896.0;51516.0
355140;201806;185;122;63;115672.5;60102.0;175774.5
355150;201806;684;412;272;391804.0;259011.0;650815.0
355160;201806;457;217;240;204633.95;228960.0;433593.97
355170;201806;2064;1069;995;1018842.25;947334.75;1966177.0
355180;201806;622;266;356;252810.0;338789.25;591599.25
355190;201806;222;151;71;144054.0;67734.0;211788.0
355200;201806;120;69;51;65826.0;48654.0;114480.0
355210;201806;724;412;312;393048.0;297629.47;690677.44
355220;201806;6760;3597;3163;3421051.8;3008003.8;6429055.5
355230;201806;107;63;44;60102.0;41971.23;102073.23
355240;201806;4350;1885;2465;1786037.1;2347414.8;4133452.0
355250;201806;5426;2614;2812;2487941.2;2679240.2;5167181.5
355255;201806;50;31;19;29574.0;18126.0;47700.0
355260;201806;187;113;74;106829.12;70568.46;177397.58
355270;201806;167;98;69;93492.0;65111.0;158603.0
355280;201806;6408;2679;3729;2550286.8;3552404.5;6102691.0
355290;201806;76;57;19;54378.0;18126.0;72504.0
355300;201806;185;119;66;112572.8;62964.0;175536.8
355310;201806;107;59;48;56286.0;45792.0;102078.0
355320;201806;90;47;43;44838.0;40074.6;84912.6
355330;201806;272;153;119;145962.0;113526.0;259488.0
355340;201806;1551;539;1012;511599.62;964420.0;1476019.6
355350;201806;142;72;70;68688.0;66780.0;135468.0
355360;201806;182;115;67;109500.12;63918.0;173418.12
355365;201806;25;20;5;19080.0;4770.0;23850.0
355370;201806;1054;605;449;571293.75;427078.56;998372.3
355380;201806;782;519;263;494534.53;250616.0;745150.5
355385;201806;63;44;19;41976.0;18126.0;60102.0
355390;201806;106;62;44;59148.0;41976.0;101124.0
355395;201806;186;113;73;106701.23;69642.0;176343.23
355400;201806;1552;960;592;912795.3;563241.8;1476037.1
355410;201806;4925;2332;2593;2207471.5;2464721.0;4672192.5
355420;201806;51;38;13;36252.0;12402.0;48654.0
355430;201806;348;210;138;199004.4;131652.0;330656.4
355440;201806;85;51;34;48654.0;32436.0;81090.0
355450;201806;460;225;235;211931.94;222854.6;434786.53
355460;201806;70;54;16;50562.42;15264.0;65826.42
355465;201806;52;33;19;31482.0;18126.0;49608.0
355470;201806;179;71;108;66780.1;103032.0;169812.1
355475;201806;13;8;5;7632.0;4770.0;12402.0
355480;201806;468;210;258;198442.34;245464.2;443906.53
355490;201806;115;81;34;77274.0;32436.0;109710.0
355495;201806;54;27;27;25758.0;25758.0;51516.0
355500;201806;1650;927;723;878778.7;689707.44;1568486.1
355510;201806;271;198;73;184193.62;69642.0;253835.62
355520;201806;33;26;7;24518.0;6678.0;31196.0
355530;201806;24;16;8;15264.0;7632.0;22896.0
355535;201806;78;38;40;36252.0;38160.0;74412.0
355540;201806;2376;934;1442;889577.5;1373752.0;2263329.5
355550;201806;65;39;26;37206.0;24804.0;62010.0
355560;201806;240;120;120;114480.0;113843.96;228323.95
355570;201806;31;21;10;20034.0;9540.0;29574.0
355580;201806;269;184;85;175536.0;80799.23;256335.23
355590;201806;24;15;9;14310.0;8586.0;22896.0
355600;201806;270;139;131;132606.0;124683.23;257289.23
355610;201806;216;143;73;136422.0;69642.0;206064.0
355620;201806;1274;591;683;563003.8;650900.2;1213904.0
355630;201806;415;302;113;288108.0;106848.96;394956.97
355635;201806;125;60;65;57240.0;61997.0;119237.0
355640;201806;577;333;244;316728.16;232776.0;549504.2
355645;201806;835;358;477;340053.3;453178.8;793232.1
355650;201806;2149;892;1257;846611.5;1199159.5;2045770.9
355660;201806;256;138;118;131652.0;112572.0;244224.0
355670;201806;500;199;301;189846.0;286867.8;476713.8
355680;201806;205;118;87;111619.0;82712.0;194331.0
355690;201806;86;40;46;38160.0;43540.0;81700.0
355695;201806;15;12;3;11448.0;2862.0;14310.0
355700;201806;1145;585;560;553020.6;533668.0;1086688.6
355710;201806;2198;1206;992;1146887.5;946177.2;2093064.8
355715;201806;20;18;2;17172.0;1908.0;19080.0
355720;201806;206;124;82;116706.08;78228.0;194934.08
355730;201806;93;53;40;49687.95;38160.0;87847.95
410010;201806;132;112;20;106848.0;19080.0;125928.0
410020;201806;104;92;12;87768.0;11448.0;99216.0
410030;201806;164;104;60;98548.4;57240.0;155788.4
410040;201806;976;534;442;508529.7;421478.0;930007.7
410045;201806;26;21;5;20034.0;4770.0;24804.0
410050;201806;481;267;214;254718.0;203488.2;458206.2
410060;201806;278;212;66;202248.0;62964.0;265212.0
410070;201806;311;258;53;246132.0;50562.0;296694.0
410080;201806;167;108;59;103032.0;56286.0;159318.0
410090;201806;74;66;8;62755.0;7632.0;70387.0
410100;201806;299;214;85;203841.19;80279.1;284120.28
410105;201806;46;27;19;25758.0;18126.0;43884.0
410110;201806;312;191;121;182214.0;115434.0;297648.0
410115;201806;28;19;9;18126.0;8586.0;26712.0
410120;201806;441;227;214;216271.8;204156.0;420427.8
410130;201806;45;28;17;26712.0;16218.0;42930.0
410140;201806;3107;1522;1585;1446205.0;1508369.6;2954574.5
410150;201806;2713;1091;1622;1039375.25;1546791.8;2586167.0
410160;201806;499;316;183;301177.8;174582.0;475759.8
410165;201806;65;43;22;41022.0;20988.0;62010.0
410170;201806;167;124;43;116871.0;41022.0;157893.0
410180;201806;2132;1239;893;1178017.2;850464.94;2028482.1
410185;201806;34;30;4;28620.0;3816.0;32436.0
410190;201806;446;279;167;266166.0;159318.0;425484.0
410200;201806;951;711;240;677349.56;228960.0;906309.56
410210;201806;559;292;267;278568.0;254432.0;533000.0
410220;201806;40;21;19;20034.0;18126.0;38160.0
410230;201806;130;70;60;66780.0;57240.0;124020.0
410240;201806;734;485;249;462117.8;237546.0;699663.8
410250;201806;376;278;98;264607.84;93487.23;358095.06
410260;201806;299;177;122;168572.0;116388.0;284960.0
410270;201806;30;19;11;18126.0;10494.0;28620.0
410275;201806;63;46;17;43884.0;16218.0;60102.0
410280;201806;325;188;137;179092.52;130698.0;309790.53
410290;201806;231;146;85;139284.0;81090.0;220374.0
410300;201806;80;64;16;61056.0;15264.0;76320.0
410302;201806;24;16;8;15264.0;7632.0;22896.0
410304;201806;46;32;14;30528.0;13356.0;43884.0
410305;201806;212;116;96;109996.2;91584.0;201580.2
410310;201806;264;168;96;160272.0;91564.92;251836.92
410315;201806;51;36;15;34320.0;14310.0;48630.0
410320;201806;141;98;43;93492.0;41022.0;134514.0
410322;201806;34;24;10;22896.0;9540.0;32436.0
410330;201806;168;120;48;114480.0;45602.0;160082.0
410335;201806;97;58;39;55332.0;37206.0;92538.0
410337;201806;39;34;5;32436.0;4770.0;37206.0
410340;201806;31;29;2;27666.0;1908.0;29574.0
410345;201806;220;139;81;132606.0;77274.0;209880.0
410347;201806;54;41;13;39114.0;12402.0;51516.0
410350;201806;228;137;91;130698.0;86814.0;217512.0
410360;201806;461;282;179;266484.4;170194.0;436678.4
410370;201806;2415;1037;1378;985703.3;1311832.9;2297536.2
410380;201806;218;142;76;135468.0;72504.0;207972.0
410390;201806;367;272;95;259484.0;90630.0;350114.0
410395;201806;34;22;12;20988.0;10781.0;31769.0
410400;201806;844;426;418;405075.2;397422.1;802497.3
410405;201806;93;71;22;67734.0;20988.0;88722.0
410410;201806;40;31;9;29574.0;8586.0;38160.0
410420;201806;1662;822;840;782093.9;800407.0;1582500.9
410425;201806;176;82;94;78038.0;89676.0;167714.0
410430;201806;2188;1288;900;1225604.0;857722.3;2083326.4
410440;201806;387;288;99;273799.0;94446.0;368245.0
410442;201806;356;240;116;228007.0;110664.0;338671.0
410445;201806;415;291;124;277614.0;118296.0;395910.0
410450;201806;410;209;201;199386.0;191754.0;391140.0
410460;201806;415;225;190;214354.27;181260.0;395614.25
410465;201806;187;120;67;113239.8;63918.0;177157.8
410470;201806;222;143;79;136422.0;75366.0;211788.0
410480;201806;5882;2903;2979;2752705.2;2836804.8;5589510.0
410490;201806;1398;923;475;879045.0;451243.0;1330288.0
410500;201806;268;151;117;144054.0;111618.0;255672.0
410510;201806;176;129;47;123066.0;44829.0;167895.0
410520;201806;253;190;63;181260.0;60102.0;241362.0
410530;201806;234;86;148;82044.0;141188.0;223232.0
410540;201806;315;227;88;215981.6;83947.23;299928.84
410550;201806;1614;698;916;665605.8;872664.4;1538270.1
410560;201806;144;112;32;106848.0;30528.0;137376.0
410570;201806;428;298;130;282204.2;124020.0;406224.2
410580;201806;3159;1422;1737;1354419.8;1656622.0;3011041.8
410590;201806;405;284;121;270936.0;115434.0;386370.0
410600;201806;187;160;27;152640.0;25758.0;178398.0
410610;201806;56;45;11;42930.0;10494.0;53424.0
410620;201806;241;173;68;165042.0;64872.0;229914.0
410630;201806;445;257;188;245178.0;178193.0;423371.0
410640;201806;993;617;376;584801.25;357097.28;941898.56
410645;201806;99;74;25;70215.0;23850.0;94065.0
410650;201806;365;249;116;236592.0;110664.0;347256.0
410655;201806;78;60;18;57240.0;17172.0;74412.0
410657;201806;43;18;25;17172.0;23850.0;41022.0
410660;201806;604;426;178;404875.0;169812.0;574687.0
410670;201806;76;63;13;60102.0;12402.0;72504.0
410680;201806;192;159;33;151018.2;31482.0;182500.2
410685;201806;15;10;5;9540.0;4770.0;14310.0
410690;201806;28207;12268;15939;1,17E+14;1,52E+14;2,69E+14
410700;201806;322;235;87;223904.0;82998.0;306902.0
410710;201806;125;102;23;97308.0;21942.0;119250.0
410712;201806;23;15;8;14310.0;7632.0;21942.0
410715;201806;84;62;22;59148.0;20988.0;80136.0
410720;201806;604;361;243;344394.0;231813.0;576207.0
410725;201806;180;129;51;123066.0;48654.0;171720.0
410730;201806;86;52;34;49608.0;32436.0;82044.0
410740;201806;112;80;32;76320.0;30528.0;106848.0
410750;201806;213;158;55;150732.0;52465.23;203197.23
410752;201806;25;15;10;14310.0;9540.0;23850.0
410753;201806;53;23;30;21269.43;28620.0;49889.43
410754;201806;38;23;15;21561.0;14310.0;35871.0
410755;201806;80;55;25;52470.0;23850.0;76320.0
410760;201806;726;410;316;390829.56;301464.0;692293.56
410765;201806;1662;800;862;756482.7;821194.25;1577677.0
410770;201806;107;87;20;82998.0;19080.0;102078.0
410773;201806;48;35;13;33390.0;12402.0;45792.0
410775;201806;176;134;42;127168.2;40068.0;167236.2
410780;201806;78;42;36;40068.0;34344.0;74412.0
410785;201806;52;42;10;40068.0;9540.0;49608.0
410790;201806;72;34;38;32436.0;36252.0;68688.0
410800;201806;294;185;109;175537.0;103986.0;279523.0
410810;201806;26;22;4;20988.0;3530.0;24518.0
410820;201806;177;131;46;124831.0;43884.0;168715.0
410830;201806;8481;3857;4624;3669864.0;4408741.0;8078605.0
410832;201806;103;70;33;66780.0;31482.0;98262.0
410840;201806;1432;797;635;758070.06;604343.0;1362413.0
410845;201806;65;41;24;38828.0;22896.0;61724.0
410850;201806;191;132;59;125642.0;56286.0;181928.0
410855;201806;49;42;7;40068.0;6678.0;46746.0
410860;201806;664;387;277;368244.75;264258.0;632502.75
410865;201806;104;82;22;78228.0;20988.0;99216.0
410870;201806;160;135;25;128790.0;23850.0;152640.0
410880;201806;1128;567;561;540407.6;535130.0;1075537.6
410890;201806;77;54;23;51516.0;21942.0;73458.0
410895;201806;72;55;17;52470.0;16218.0;68688.0
410900;201806;20;12;8;11448.0;7632.0;19080.0
410910;201806;17;15;2;14310.0;1908.0;16218.0
410920;201806;33;22;11;20988.0;10494.0;31482.0
410930;201806;509;326;183;310792.97;174582.0;485374.97
410940;201806;4312;2556;1756;2428815.5;1671960.4;4100775.8
410950;201806;118;86;32;82044.0;30528.0;112572.0
410960;201806;769;344;425;327890.0;405260.0;733150.0
410965;201806;66;51;15;48367.8;14310.0;62677.8
410970;201806;624;447;177;425970.2;168858.0;594828.2
410975;201806;111;64;47;60545.0;44838.0;105383.0
410980;201806;1589;713;876;677655.8;834746.0;1512401.9
410990;201806;271;181;90;172674.0;85573.8;258247.8
411000;201806;62;39;23;37206.0;21942.0;59148.0
411005;201806;25;20;5;19080.0;4770.0;23850.0
411007;201806;243;140;103;133560.0;98262.0;231822.0
411010;201806;581;403;178;384462.0;169812.0;554274.0
411020;201806;294;203;91;193662.0;86814.0;280476.0
411030;201806;20;10;10;9540.0;9540.0;19080.0
411040;201806;50;36;14;34344.0;13356.0;47700.0
411050;201806;220;172;48;163473.72;45665.12;209138.84
411060;201806;513;345;168;329121.0;160272.0;489393.0
411065;201806;64;56;8;53424.0;7632.0;61056.0
411070;201806;1204;797;407;754478.3;387324.0;1141802.2
411080;201806;242;173;69;165042.0;65826.0;230868.0
411090;201806;115;87;28;82998.0;26712.0;109710.0
411095;201806;270;111;159;105417.0;151676.0;257093.0
411100;201806;115;96;19;91584.0;18126.0;109710.0
411110;201806;121;85;36;81090.0;34344.0;115434.0
411120;201806;184;136;48;129744.0;45792.0;175536.0
411125;201806;183;83;100;78533.28;95400.0;173933.28
411130;201806;125;106;19;100486.0;17839.8;118325.8
411140;201806;185;126;59;120182.12;55761.3;175943.42
411150;201806;1229;816;413;777786.7;394002.0;1171788.6
411155;201806;120;83;37;79182.0;35298.0;114480.0
411160;201806;20;9;11;8586.0;10494.0;19080.0
411170;201806;57;52;5;49321.8;4770.0;54091.8
411180;201806;956;630;326;599780.0;310999.22;910779.25
411190;201806;341;197;144;187270.2;137376.0;324646.2
411200;201806;673;442;231;420397.88;219230.3;639628.2
411210;201806;682;368;314;349522.22;299556.0;649078.2
411220;201806;146;109;37;103986.0;35298.0;139284.0
411230;201806;41;37;4;35298.0;3816.0;39114.0
411240;201806;123;84;39;80136.0;37206.0;117342.0
411250;201806;426;312;114;297648.0;108756.0;406404.0
411260;201806;21;14;7;13356.0;6678.0;20034.0
411270;201806;296;158;138;150732.0;131652.0;282384.0
411275;201806;203;179;24;170050.6;22896.0;192946.6
411280;201806;228;162;66;153277.12;62964.0;216241.12
411290;201806;58;43;15;41022.0;14310.0;55332.0
411295;201806;146;115;31;109710.0;29574.0;139284.0
411300;201806;70;36;34;34344.0;32436.0;66780.0
411310;201806;91;69;22;65826.0;20988.0;86814.0
411320;201806;757;548;209;520980.2;197783.28;718763.5
411325;201806;41;25;16;23850.0;15264.0;39114.0
411330;201806;919;592;327;563242.6;311227.6;874470.2
411340;201806;26;17;9;16218.0;8272.0;24490.0
411342;201806;73;54;19;51516.0;18126.0;69642.0
411345;201806;125;63;62;60102.0;59148.0;119250.0
411350;201806;491;391;100;371535.62;94437.2;465972.84
411360;201806;54;35;19;33390.0;18126.0;51516.0
411370;201806;14240;5818;8422;5528812.5;8019086.0;1,35E+14
411373;201806;186;138;48;131652.0;45792.0;177444.0
411375;201806;72;60;12;57240.0;11448.0;68688.0
411380;201806;93;70;23;66780.0;21942.0;88722.0
411390;201806;135;90;45;85860.0;42930.0;128790.0
411400;201806;351;263;88;250893.0;83952.0;334845.0
411410;201806;447;232;215;220660.2;204824.0;425484.2
411420;201806;1028;474;554;449620.2;528039.2;977659.4
411430;201806;414;266;148;253096.2;141183.0;394279.2
411435;201806;36;25;11;23850.0;10494.0;34344.0
411440;201806;474;381;93;361601.34;88722.0;450323.34
411450;201806;425;354;71;337716.0;67734.0;405450.0
411460;201806;765;303;462;288165.62;439299.6;727465.25
411470;201806;86;64;22;61056.0;20988.0;82044.0
411480;201806;634;359;275;339937.4;262063.8;602001.2
411490;201806;293;182;111;173628.0;105894.0;279522.0
411500;201806;113;94;19;89472.33;17459.0;106931.33
411510;201806;217;176;41;167156.06;39114.0;206270.06
411520;201806;5917;2308;3609;2198010.8;3435982.8;5633993.5
411530;201806;112;78;34;74412.0;32436.0;106848.0
411535;201806;46;19;27;18126.0;25758.0;43884.0
411540;201806;352;245;107;232707.9;102078.0;334785.9
411545;201806;55;39;16;37206.0;15264.0;52470.0
411550;201806;73;56;17;53424.0;16218.0;69642.0
411560;201806;387;178;209;169148.38;199386.0;368534.38
411570;201806;780;299;481;284951.0;458684.0;743635.0
411573;201806;33;20;13;19080.0;12402.0;31482.0
411575;201806;265;164;101;156456.0;96354.0;252810.0
411580;201806;1251;502;749;476647.84;712698.4;1189346.2
411585;201806;81;41;40;39114.0;38160.0;77274.0
411590;201806;25;18;7;17172.0;6678.0;23850.0
411600;201806;28;12;16;11448.0;15264.0;26712.0
411605;201806;251;109;142;103820.0;135468.0;239288.0
411610;201806;235;161;74;153594.0;70596.0;224190.0
411620;201806;361;204;157;194139.0;149139.0;343278.0
411630;201806;58;39;19;37206.0;18126.0;55332.0
411640;201806;34;28;6;26712.0;5724.0;32436.0
411650;201806;12;8;4;7632.0;3816.0;11448.0
411660;201806;32;25;7;23850.0;6678.0;30528.0
411670;201806;245;186;59;177444.0;56286.0;233730.0
411680;201806;155;133;22;126882.0;20988.0;147870.0
411690;201806;600;317;283;301840.44;269636.3;571476.75
411695;201806;62;46;16;43884.0;15264.0;59148.0
411700;201806;163;141;22;134514.0;20988.0;155502.0
411705;201806;101;66;35;62964.0;33390.0;96354.0
411710;201806;302;203;99;192595.81;94446.0;287041.8
411720;201806;139;90;49;85860.0;46746.0;132606.0
411721;201806;64;53;11;50562.0;10494.0;61056.0
411722;201806;98;42;56;40068.0;53424.0;93492.0
411725;201806;151;118;33;111999.8;31482.0;143481.8
411727;201806;73;57;16;54378.0;14977.8;69355.8
411729;201806;33;26;7;24804.0;6678.0;31482.0
411730;201806;542;352;190;334217.97;180973.8;515191.75
411740;201806;37;23;14;21942.0;13356.0;35298.0
411745;201806;69;46;23;43093.0;21942.0;65035.0
411750;201806;865;414;451;393859.9;429285.7;823145.56
411760;201806;1191;896;295;853535.2;281421.0;1134956.2
411770;201806;447;299;148;285226.9;141192.0;426418.9
411780;201806;372;241;131;229914.0;124974.0;354888.0
411790;201806;533;300;233;284318.47;221978.34;506296.8
411800;201806;169;133;36;126882.0;34344.0;161226.0
411810;201806;164;126;38;120204.0;36252.0;156456.0
411820;201806;2087;1020;1067;970485.44;1017194.3;1987679.8
411830;201806;12;12;0;11448.0;0.0;11448.0
411840;201806;1955;1214;741;1155961.8;706421.0;1862382.8
411845;201806;50;19;31;18126.0;29574.0;47700.0
411850;201806;1232;705;527;671002.4;500805.03;1171807.4
411860;201806;43;28;15;26426.0;14310.0;40736.0
411870;201806;74;54;20;51516.0;18793.8;70309.8
411880;201806;427;273;154;260328.0;146171.88;406499.88
411885;201806;104;69;35;65826.0;33390.0;99216.0
411890;201806;322;205;117;193173.98;111608.46;304782.44
411900;201806;69;51;18;48654.0;17172.0;65826.0
411910;201806;177;141;36;134504.45;33504.48;168008.94
411915;201806;2112;912;1200;868895.56;1143498.0;2012393.6
411920;201806;125;104;21;99216.0;20034.0;119250.0
411925;201806;14;9;5;8586.0;4770.0;13356.0
411930;201806;801;588;213;559046.0;203202.0;762248.0
411940;201806;590;418;172;398295.0;164063.56;562358.56
411950;201806;900;479;421;456298.2;400966.2;857264.4
411960;201806;979;690;289;655405.7;275706.0;931111.7
411965;201806;25;17;8;16218.0;7632.0;23850.0
411970;201806;72;64;8;61056.0;7632.0;68688.0
411980;201806;198;127;71;120871.8;67734.0;188605.8
411990;201806;5024;2915;2109;2763772.5;2010265.4;4774038.0
411995;201806;457;172;285;164088.0;271890.0;435978.0
412000;201806;306;182;124;172722.77;118286.46;291009.22
412010;201806;47;28;19;26712.0;18126.0;44838.0
412015;201806;45;31;14;29574.0;13356.0;42930.0
412020;201806;26;23;3;21655.8;2862.0;24517.8
412030;201806;59;50;9;47700.0;8586.0;56286.0
412033;201806;55;36;19;34320.0;18126.0;52446.0
412035;201806;69;44;25;41976.0;23850.0;65826.0
412040;201806;37;26;11;24518.0;10494.0;35012.0
412050;201806;200;150;50;143100.0;47700.0;190800.0
412060;201806;747;582;165;552303.1;156419.8;708722.94
412065;201806;50;34;16;32436.0;15264.0;47700.0
412070;201806;159;107;52;101410.2;49608.0;151018.2
412080;201806;282;148;134;141192.0;127836.0;269028.0
412085;201806;33;16;17;15264.0;16218.0;31482.0
412090;201806;756;480;276;456251.2;263304.0;719555.2
412100;201806;249;209;40;198433.0;38160.0;236593.0
412110;201806;70;57;13;54378.0;12402.0;66780.0
412120;201806;310;205;105;194997.6;100170.0;295167.6
412125;201806;79;46;33;43597.8;31482.0;75079.8
412130;201806;47;36;11;33753.0;10494.0;44247.0
412135;201806;30;17;13;16218.0;12402.0;28620.0
412140;201806;318;225;93;214010.81;88722.0;302732.8
412150;201806;253;175;78;165996.05;74412.0;240408.05
412160;201806;85;51;34;48654.0;32436.0;81090.0
412170;201806;663;464;199;442369.8;189846.0;632215.8
412175;201806;38;28;10;26712.0;9540.0;36252.0
412180;201806;195;155;40;147270.61;37539.9;184810.52
412190;201806;332;264;68;251183.44;64872.0;316055.44
412200;201806;197;123;74;117342.0;70596.0;187938.0
412210;201806;74;57;17;54378.0;16218.0;70596.0
412215;201806;238;164;74;156169.8;70309.8;226479.6
412217;201806;71;55;16;52470.0;15264.0;67734.0
412220;201806;828;618;210;589572.0;200340.0;789912.0
412230;201806;337;205;132;193948.2;125891.46;319839.66
412240;201806;1328;648;680;615297.9;646544.06;1261841.9
412250;201806;383;246;137;234684.0;130698.0;365382.0
412260;201806;126;92;34;87768.0;32436.0;120204.0
412265;201806;170;134;36;127231.84;34344.0;161575.84
412270;201806;85;54;31;51516.0;29574.0;81090.0
412280;201806;92;73;19;69642.0;18126.0;87768.0
412290;201806;96;64;32;61056.0;30528.0;91584.0
412300;201806;215;140;75;133560.0;71406.9;204966.9
412310;201806;43;37;6;35298.0;5724.0;41022.0
412320;201806;92;78;14;74412.0;13356.0;87768.0
412330;201806;170;150;20;143100.0;19080.0;162180.0
412340;201806;148;103;45;98262.0;42644.0;140906.0
412350;201806;607;306;301;290636.3;287154.0;577790.3
412360;201806;28;25;3;23850.0;2862.0;26712.0
412370;201806;158;138;20;129935.0;19080.0;149015.0
412380;201806;252;191;61;181927.8;58090.0;240017.8
412382;201806;51;27;24;25758.0;22896.0;48654.0
412385;201806;142;102;40;97308.0;38160.0;135468.0
412390;201806;280;212;68;202248.0;64872.0;267120.0
412395;201806;67;52;15;49608.0;14310.0;63918.0
412400;201806;74;54;20;51516.0;19080.0;70596.0
412402;201806;253;120;133;114475.23;126595.8;241071.03
412405;201806;816;327;489;309264.03;465820.66;775084.7
412410;201806;945;595;350;564768.6;333900.0;898668.6
412420;201806;14;12;2;11448.0;1908.0;13356.0
412430;201806;21;15;6;14310.0;5724.0;20034.0
412440;201806;603;328;275;310623.94;260509.95;571133.9
412450;201806;80;68;12;64872.0;11448.0;76320.0
412460;201806;79;62;17;59148.0;16218.0;75366.0
412470;201806;265;210;55;199576.8;52470.0;252046.8
412480;201806;171;130;41;123066.9;39114.0;162180.9
412490;201806;166;142;24;135468.0;22896.0;158364.0
412500;201806;469;381;88;361899.8;83952.0;445851.8
412510;201806;185;153;32;145215.0;30528.0;175743.0
412520;201806;135;74;61;70596.0;58194.0;128790.0
412530;201806;107;57;50;54378.0;47413.8;101791.8
412535;201806;107;77;30;73440.0;28620.0;102060.0
412540;201806;68;34;34;32436.0;32436.0;64872.0
412545;201806;96;71;25;67734.0;23850.0;91584.0
412550;201806;3539;1598;1941;1519064.6;1849330.9;3368395.5
412555;201806;14;10;4;9540.0;3816.0;13356.0
412560;201806;587;439;148;416216.2;141192.0;557408.2
412570;201806;733;406;327;385473.25;311672.0;697145.25
412575;201806;83;58;25;55332.0;23850.0;79182.0
412580;201806;162;108;54;103032.0;51516.0;154548.0
412590;201806;32;30;2;28620.0;1908.0;30528.0
412600;201806;179;136;43;129744.0;41022.0;170766.0
412610;201806;31;19;12;18126.0;11448.0;29574.0
412620;201806;147;130;17;124020.0;16218.0;140238.0
412625;201806;2195;1174;1021;1116908.0;972156.56;2089064.6
412627;201806;70;56;14;53424.0;13356.0;66780.0
412630;201806;424;284;140;269402.44;133283.0;402685.44
412635;201806;66;20;46;19080.0;43884.0;62964.0
412640;201806;120;80;40;76320.0;38160.0;114480.0
412650;201806;348;218;130;207972.0;124015.23;331987.22
412660;201806;481;297;184;282623.0;175536.0;458159.0
412665;201806;51;45;6;42930.0;5724.0;48654.0
412667;201806;287;197;90;187119.1;85593.36;272712.47
412670;201806;60;51;9;48654.0;8586.0;57240.0
412680;201806;296;234;62;223236.0;59148.0;282384.0
412690;201806;116;74;42;70596.0;39782.0;110378.0
412700;201806;161;111;50;105894.0;47414.0;153308.0
412710;201806;1410;872;538;825594.6;511344.2;1336938.8
412720;201806;229;158;71;150732.0;67734.0;218466.0
412730;201806;199;160;39;152640.0;36252.0;188892.0
412740;201806;423;231;192;220230.9;183168.0;403398.9
412750;201806;469;269;200;255672.0;190630.97;446302.97
412760;201806;264;136;128;129744.0;122112.0;251856.0
412770;201806;2123;1200;923;1140417.0;878901.0;2019318.0
412780;201806;151;119;32;113526.0;30528.0;144054.0
412785;201806;273;139;134;132129.0;127836.0;259965.0
412788;201806;38;23;15;21942.0;14310.0;36252.0
412790;201806;137;113;24;107134.2;22896.0;130030.2
412795;201806;152;113;39;107802.0;37206.0;145008.0
412796;201806;298;211;87;200129.19;82864.44;282993.62
412800;201806;556;362;194;344788.38;185076.0;529864.4
412810;201806;3011;1664;1347;1581904.5;1283793.0;2865697.5
412820;201806;933;611;322;571961.8;305328.88;877290.7
412830;201806;15;12;3;11448.0;2862.0;14310.0
412840;201806;224;160;64;151686.2;61056.0;212742.2
412850;201806;781;531;250;504666.0;238500.0;743166.0
412853;201806;172;93;79;88722.0;75366.0;164088.0
412855;201806;215;117;98;110506.82;93492.0;203998.81
412860;201806;90;67;23;63918.0;21942.0;85860.0
412862;201806;59;43;16;41022.0;15264.0;56286.0
412863;201806;7;6;1;5724.0;954.0;6678.0
412865;201806;43;32;11;30528.0;10494.0;41022.0
412870;201806;107;71;36;67734.0;34344.0;102078.0
412880;201806;99;74;25;70596.0;23850.0;94446.0
420005;201806;39;34;5;32436.0;4198.0;36634.0
420010;201806;368;240;128;227772.34;121826.0;349598.34
420020;201806;76;64;12;61056.0;11448.0;72504.0
420030;201806;29;26;3;24804.0;2862.0;27666.0
420040;201806;106;81;25;77274.0;23850.0;101124.0
420050;201806;55;34;21;32436.0;20034.0;52470.0
420055;201806;20;19;1;18126.0;954.0;19080.0
420060;201806;33;24;9;22896.0;8586.0;31482.0
420070;201806;102;87;15;82998.0;14300.46;97298.46
420075;201806;12;11;1;10494.0;954.0;11448.0
420080;201806;50;44;6;40306.5;5724.0;46030.5
420090;201806;34;32;2;29750.49;1908.0;31658.49
420100;201806;165;137;28;129744.2;26712.0;156456.2
420110;201806;19;19;0;18126.0;0.0;18126.0
420120;201806;50;38;12;36252.0;11448.0;47700.0
420125;201806;86;69;17;65826.0;16218.0;82044.0
420127;201806;35;31;4;29574.0;3816.0;33390.0
420130;201806;392;246;146;234388.45;139035.95;373424.4
420140;201806;1286;744;542;708451.4;517002.0;1225453.4
420150;201806;45;40;5;38160.0;4770.0;42930.0
420160;201806;38;36;2;34344.0;1908.0;36252.0
420165;201806;19;14;5;13356.0;4770.0;18126.0
420170;201806;66;42;24;40068.0;22896.0;62964.0
420180;201806;22;21;1;20034.0;954.0;20988.0
420190;201806;31;28;3;26712.0;2862.0;29574.0
420195;201806;126;59;67;56286.0;63918.0;120204.0
420200;201806;1285;579;706;547025.6;672467.3;1219492.9
420205;201806;66;35;31;33390.0;29574.0;62964.0
420207;201806;107;61;46;58194.0;43874.46;102068.46
420208;201806;22;17;5;16218.0;3911.4;20129.4
420209;201806;20;16;4;15264.0;3816.0;19080.0
420210;201806;464;223;241;212455.8;229828.69;442284.47
420213;201806;44;35;9;33390.0;8586.0;41976.0
420215;201806;26;22;4;20988.0;3816.0;24804.0
420220;201806;67;43;24;41022.0;22896.0;63918.0
420230;201806;773;436;337;415181.0;320916.47;736097.44
420240;201806;2292;1542;750;1462116.8;715061.2;2177178.0
420243;201806;37;30;7;28620.0;6678.0;35298.0
420245;201806;114;63;51;60102.0;48654.0;108756.0
420250;201806;54;32;22;30528.0;20988.0;51516.0
420253;201806;41;33;8;31482.0;7632.0;39114.0
420257;201806;12;10;2;9540.0;1908.0;11448.0
420260;201806;99;86;13;82044.0;12402.0;94446.0
420270;201806;38;31;7;29570.0;6678.0;36248.0
420280;201806;282;208;74;197661.95;69338.1;267000.06
420285;201806;19;12;7;11448.0;6678.0;18126.0
420287;201806;49;30;19;28620.0;18126.0;46746.0
420290;201806;977;688;289;653524.94;275638.3;929163.25
420300;201806;1392;1105;287;1049592.4;271318.12;1320910.5
420310;201806;58;46;12;43884.0;11448.0;55332.0
420315;201806;35;31;4;29574.0;3816.0;33390.0
420320;201806;850;432;418;411150.16;398768.0;809918.1
420325;201806;0;0;0;0.0;0.0;0.0
420330;201806;124;84;40;80136.0;38045.52;118181.52
420340;201806;160;109;51;103024.0;48634.92;151658.92
420350;201806;251;185;66;174869.0;62964.0;237833.0
420360;201806;759;576;183;547578.2;172961.78;720539.94
420370;201806;110;71;39;67544.0;36920.0;104464.0
420380;201806;1136;814;322;772732.3;306151.03;1078883.4
420390;201806;256;165;91;156151.52;86098.5;242250.02
420395;201806;185;132;53;125928.0;49668.58;175596.58
420400;201806;243;182;61;172419.0;58194.0;230613.0
420410;201806;62;48;14;45792.0;13356.0;59148.0
420415;201806;33;31;2;29574.0;1908.0;31482.0
420417;201806;48;35;13;33390.0;12382.92;45772.92
420419;201806;12;12;0;11448.0;0.0;11448.0
420420;201806;2809;1724;1085;1632448.0;1032802.44;2665250.5
420425;201806;73;61;12;58185.0;11134.26;69319.26
420430;201806;1274;888;386;843444.6;366498.2;1209942.8
420435;201806;16;14;2;13356.0;1908.0;15264.0
420440;201806;106;72;34;68060.68;32284.6;100345.28
420445;201806;22;19;3;18126.0;2862.0;20988.0
420450;201806;79;37;42;35298.0;40068.0;75366.0
420455;201806;214;158;56;150694.92;53359.38;204054.3
420460;201806;2355;1565;790;1487390.8;753417.4;2240808.0
420470;201806;119;85;34;81090.0;32436.0;113526.0
420475;201806;6;6;0;5724.0;0.0;5724.0
420480;201806;872;652;220;616552.1;208831.0;825383.1
420490;201806;111;87;24;82998.0;22896.0;105894.0
420500;201806;669;291;378;275643.2;360612.0;636255.2
420510;201806;19;16;3;15264.0;2862.0;18126.0
420515;201806;26;20;6;19080.0;5724.0;24804.0
420517;201806;10;10;0;9540.0;0.0;9540.0
420519;201806;0;0;0;0.0;0.0;0.0
420520;201806;69;52;17;49608.0;16218.0;65826.0
420530;201806;169;114;55;107781.02;52470.0;160251.02
420535;201806;21;19;2;18126.0;1908.0;20034.0
420540;201806;4966;2931;2035;2784312.8;1936087.1;4720400.0
420543;201806;26;26;0;24804.0;0.0;24804.0
420545;201806;197;139;58;131652.0;55312.92;186964.92
420550;201806;851;684;167;649408.3;159160.73;808569.06
420555;201806;39;27;12;25758.0;11448.0;37206.0
420560;201806;66;53;13;50180.4;12402.0;62582.4
420570;201806;147;85;62;81090.0;59138.46;140228.45
420580;201806;294;132;162;125928.0;154262.0;280190.0
420590;201806;517;369;148;351739.8;140811.0;492550.8
420600;201806;97;48;49;45792.0;46746.0;92538.0
420610;201806;38;36;2;34058.0;1908.0;35966.0
420620;201806;76;62;14;59148.0;13356.0;72504.0
420630;201806;155;114;41;108747.23;39106.0;147853.23
420640;201806;94;83;11;78991.2;10494.0;89485.2
420650;201806;243;128;115;121444.2;109091.23;230535.44
420660;201806;53;41;12;38350.8;11448.0;49798.8
420665;201806;38;28;10;26426.0;9540.0;35966.0
420670;201806;321;242;79;230142.95;75347.46;305490.4
420675;201806;15;14;1;13356.0;954.0;14310.0
420680;201806;36;26;10;24804.0;9540.0;34344.0
420690;201806;176;145;31;138330.0;29574.0;167904.0
420700;201806;653;444;209;423474.3;199124.28;622598.56
420710;201806;151;89;62;84906.0;58861.8;143767.8
420720;201806;109;88;21;83942.46;20034.0;103976.46
420730;201806;547;348;199;330934.5;188560.12;519494.62
420740;201806;46;45;1;42930.0;954.0;43884.0
420750;201806;501;335;166;319303.8;158364.0;477667.8
420757;201806;19;16;3;14453.1;2862.0;17315.1
420760;201806;38;31;7;29574.0;6678.0;36252.0
420765;201806;70;57;13;54378.0;12402.0;66780.0
420768;201806;65;58;7;55332.0;6678.0;62010.0
420770;201806;84;70;14;66780.0;13356.0;80136.0
420775;201806;46;43;3;40068.0;2862.0;42930.0
420780;201806;241;189;52;180296.45;49608.0;229904.45
420785;201806;14;10;4;9540.0;3816.0;13356.0
420790;201806;176;146;30;139191.3;27638.46;166829.77
420800;201806;75;57;18;53614.8;17172.0;70786.8
420810;201806;253;217;36;207009.0;33533.1;240542.1
420820;201806;2335;1387;948;1317464.8;903043.8;2220508.5
420830;201806;588;329;259;311571.94;246122.45;557694.44
420840;201806;151;113;38;107802.0;35548.0;143350.0
420845;201806;451;198;253;188507.06;240122.0;428629.06
420850;201806;232;186;46;177444.0;43884.0;221328.0
420860;201806;63;54;9;51516.0;8586.0;60102.0
420870;201806;118;85;33;81090.0;31482.0;112572.0
420880;201806;172;121;51;115424.46;48654.0;164078.45
420890;201806;875;429;446;405224.84;424902.6;830127.44
420895;201806;10;10;0;9540.0;0.0;9540.0
420900;201806;425;331;94;313715.03;89638.38;403353.4
420910;201806;5820;3268;2552;3106799.2;2429898.2;5536697.5
420915;201806;78;71;7;67734.0;6678.0;74412.0
420917;201806;19;14;5;13356.0;4770.0;18126.0
420920;201806;23;16;7;15264.0;6678.0;21942.0
420930;201806;2713;1665;1048;1581889.8;993865.8;2575755.5
420940;201806;616;446;170;424139.6;160528.08;584667.7
420945;201806;8;6;2;5724.0;1908.0;7632.0
420950;201806;57;52;5;49608.0;4770.0;54378.0
420960;201806;114;89;25;84868.92;23841.0;108709.92
420970;201806;304;244;60;231100.84;57212.46;288313.3
420980;201806;23;23;0;21942.0;0.0;21942.0
420985;201806;63;55;8;52470.0;7632.0;60102.0
420990;201806;72;57;15;54378.0;14310.0;68688.0
421000;201806;34;23;11;21942.0;10494.0;32436.0
421003;201806;69;45;24;42930.0;22887.0;65817.0
421005;201806;8;5;3;4770.0;2862.0;7632.0
421010;201806;767;539;228;512957.0;216406.2;729363.2
421020;201806;30;25;5;23850.0;4770.0;28620.0
421030;201806;130;110;20;104320.0;19080.0;123400.0
421040;201806;70;60;10;57240.0;9540.0;66780.0
421050;201806;320;231;89;218275.2;84906.0;303181.2
421055;201806;24;20;4;19080.0;3816.0;22896.0
421060;201806;80;56;24;53424.0;22896.0;76320.0
421070;201806;51;46;5;43884.0;4770.0;48654.0
421080;201806;34;31;3;29574.0;2862.0;32436.0
421085;201806;25;20;5;19080.0;4770.0;23850.0
421090;201806;43;32;11;30528.0;10494.0;41022.0
421100;201806;129;96;33;91584.0;31482.0;123066.0
421105;201806;220;178;42;169382.8;40044.69;209427.48
421110;201806;112;91;21;86193.9;20034.0;106227.9
421120;201806;157;122;35;115892.46;33370.92;149263.38
421125;201806;16;12;4;11448.0;3816.0;15264.0
421130;201806;819;528;291;502582.06;276574.53;779156.56
421140;201806;32;23;9;21226.5;8586.0;29812.5
421145;201806;40;31;9;29574.0;8586.0;38160.0
421150;201806;108;79;29;75366.0;27666.0;103032.0
421160;201806;63;42;21;40058.46;20034.0;60092.46
421165;201806;17;16;1;15264.0;954.0;16218.0
421170;201806;192;167;25;158290.84;23841.0;182131.84
421175;201806;149;97;52;92538.0;49569.92;142107.92
421180;201806;57;36;21;33982.0;20034.0;54016.0
421185;201806;17;14;3;13356.0;2862.0;16218.0
421187;201806;0;0;0;0.0;0.0;0.0
421189;201806;38;30;8;28620.0;7622.46;36242.46
421190;201806;1552;957;595;912015.44;566361.56;1478377.0
421200;201806;89;68;21;63918.7;20034.0;83952.7
421205;201806;27;19;8;18126.0;7632.0;25758.0
421210;201806;184;124;60;118296.0;57240.0;175536.0
421220;201806;277;219;58;208305.9;55332.0;263637.9
421223;201806;55;46;9;43694.0;8586.0;52280.0
421225;201806;65;43;22;41022.0;20988.0;62010.0
421227;201806;95;71;24;67734.0;22896.0;90630.0
421230;201806;53;40;13;38160.0;12402.0;50562.0
421240;201806;18;18;0;17172.0;0.0;17172.0
421250;201806;356;221;135;209500.0;127998.18;337498.2
421260;201806;28;23;5;21942.0;4770.0;26712.0
421265;201806;0;0;0;0.0;0.0;0.0
421270;201806;53;47;6;44838.0;5724.0;50562.0
421280;201806;335;188;147;179352.0;138520.8;317872.8
421290;201806;322;209;113;199148.0;105676.26;304824.25
421300;201806;25;20;5;19080.0;4770.0;23850.0
421310;201806;55;42;13;39400.2;12402.0;51802.2
421315;201806;29;20;9;19080.0;8586.0;27666.0
421320;201806;133;93;40;88722.0;38160.0;126882.0
421330;201806;108;82;26;76110.12;24795.0;100905.12
421335;201806;38;25;13;23850.0;12402.0;36252.0
421340;201806;293;199;94;188082.05;89676.0;277758.06
421350;201806;178;105;73;99727.0;69642.0;169369.0
421360;201806;690;507;183;479418.7;173801.06;653219.75
421370;201806;195;150;45;143100.0;42596.1;185696.1
421380;201806;127;103;24;98257.23;22896.0;121153.23
421390;201806;15;11;4;10494.0;3816.0;14310.0
421400;201806;117;99;18;94446.0;17172.0;111618.0
421410;201806;23;19;4;18126.0;3816.0;21942.0
421415;201806;22;21;1;20034.0;954.0;20988.0
421420;201806;149;122;27;115815.6;25758.0;141573.6
421430;201806;15;11;4;10494.0;3816.0;14310.0
421440;201806;57;44;13;41976.0;12402.0;54378.0
421450;201806;97;84;13;80136.0;12402.0;92538.0
421460;201806;58;49;9;45941.77;8586.0;54527.77
421470;201806;69;45;24;42930.0;22896.0;65826.0
421480;201806;634;470;164;447617.0;156447.0;604064.0
421490;201806;22;21;1;19358.0;954.0;20312.0
421500;201806;518;331;187;313971.2;178110.9;492082.1
421505;201806;26;19;7;18126.0;6678.0;24804.0
421507;201806;33;27;6;25758.0;5724.0;31482.0
421510;201806;73;47;26;44838.0;24804.0;69642.0
421520;201806;67;58;9;54569.0;8586.0;63155.0
421530;201806;53;48;5;45792.0;4770.0;50562.0
421535;201806;27;26;1;24537.0;954.0;25491.0
421540;201806;57;49;8;46746.0;7632.0;54378.0
421545;201806;96;73;23;69156.0;21942.0;91098.0
421550;201806;289;210;79;199673.0;75366.0;275039.0
421555;201806;27;21;6;20034.0;5629.0;25663.0
421560;201806;8;7;1;6678.0;954.0;7632.0
421565;201806;124;91;33;86814.0;31482.0;118296.0
421567;201806;31;26;5;24804.0;4770.0;29574.0
421568;201806;32;30;2;28620.0;1908.0;30528.0
421569;201806;7;7;0;6678.0;0.0;6678.0
421570;201806;150;102;48;97308.0;45792.0;143100.0
421575;201806;27;22;5;20725.65;4770.0;25495.65
421580;201806;726;431;295;409553.0;280476.34;690029.3
421590;201806;22;21;1;20034.0;954.0;20988.0
421600;201806;109;75;34;71550.0;31197.0;102747.0
421605;201806;104;74;30;70263.0;28620.0;98883.0
421610;201806;186;148;38;140238.5;36252.0;176490.5
421620;201806;1101;660;441;627140.94;420694.9;1047835.8
421625;201806;22;20;2;19080.0;1908.0;20988.0
421630;201806;290;184;106;174725.8;100266.0;274991.8
421635;201806;16;8;8;7632.0;7632.0;15264.0
421640;201806;97;83;14;79182.0;13356.0;92538.0
421650;201806;280;165;115;157390.92;109690.92;267081.84
421660;201806;2135;1283;852;1220176.5;811636.25;2031812.8
421670;201806;186;130;56;124020.0;53424.0;177444.0
421680;201806;170;154;16;146916.0;15255.0;162171.0
421690;201806;360;248;112;235611.0;105884.58;341495.6
421700;201806;59;37;22;35298.0;20130.0;55428.0
421710;201806;24;24;0;22896.0;0.0;22896.0
421715;201806;8;7;1;6678.0;954.0;7632.0
421720;201806;590;426;164;403805.4;154729.27;558534.7
421725;201806;13;6;7;5724.0;6678.0;12402.0
421730;201806;40;28;12;26004.12;11448.0;37452.12
421740;201806;87;42;45;40068.0;42930.0;82998.0
421750;201806;224;167;57;156872.52;54378.0;211250.52
421755;201806;26;24;2;22896.0;1908.0;24804.0
421760;201806;106;76;30;72504.0;28620.0;101124.0
421770;201806;572;386;186;365760.38;177369.3;543129.7
421775;201806;29;19;10;18126.0;9540.0;27666.0
421780;201806;196;154;42;146916.0;40068.0;186984.0
421790;201806;160;133;27;125989.5;25758.0;151747.5
421795;201806;16;13;3;12402.0;2862.0;15264.0
421800;201806;486;314;172;298759.3;164088.0;462847.3
421810;201806;69;55;14;52470.0;13356.0;65826.0
421820;201806;315;217;98;206350.2;93492.0;299842.2
421825;201806;125;104;21;99216.0;20034.0;119250.0
421830;201806;129;98;31;93492.0;29574.0;123066.0
421835;201806;3;3;0;2862.0;0.0;2862.0
421840;201806;59;49;10;46737.0;9540.0;56277.0
421850;201806;77;67;10;63918.0;9536.0;73454.0
421860;201806;42;33;9;31482.0;8586.0;40068.0
421870;201806;975;744;231;700711.5;219589.42;920300.94
421875;201806;53;46;7;43884.0;6678.0;50562.0
421880;201806;164;121;43;115434.0;40736.0;156170.0
421885;201806;27;22;5;20988.0;4770.0;25758.0
421890;201806;119;83;36;79182.0;34344.0;113526.0
421895;201806;43;40;3;38160.0;2862.0;41022.0
421900;201806;153;124;29;117935.1;27630.0;145565.1
421910;201806;65;43;22;41022.0;20988.0;62010.0
421915;201806;33;28;5;26712.0;4770.0;31482.0
421917;201806;41;31;10;29574.0;9540.0;39114.0
421920;201806;33;30;3;28620.0;2862.0;31482.0
421930;201806;749;581;168;552247.25;160245.0;712492.25
421935;201806;57;50;7;47700.0;6678.0;54378.0
421940;201806;40;37;3;35298.0;2862.0;38160.0
421950;201806;834;551;283;518605.47;267508.2;786113.7
421960;201806;42;35;7;33104.0;6656.12;39760.12
421970;201806;373;235;138;223691.12;131621.12;355312.25
421985;201806;33;21;12;20034.0;11448.0;31482.0
422000;201806;0;0;0;0.0;0.0;0.0
430003;201806;208;52;156;48892.5;148824.0;197716.5
430005;201806;35;27;8;25758.0;7632.0;33390.0
430010;201806;276;193;83;183645.0;79182.0;262827.0
430020;201806;153;100;53;95114.0;50562.0;145676.0
430030;201806;132;104;28;98929.8;26712.0;125641.8
430040;201806;2989;1740;1249;1651861.9;1189840.6;2841702.5
430045;201806;68;59;9;55999.8;8586.0;64585.8
430047;201806;6;5;1;4770.0;954.0;5724.0
430050;201806;80;67;13;63918.0;12402.0;76320.0
430055;201806;17;14;3;13356.0;2862.0;16218.0
430057;201806;4;2;2;1908.0;1908.0;3816.0
430060;201806;3659;2186;1473;2078200.9;1401754.2;3479955.2
430063;201806;62;57;5;54378.0;4770.0;59148.0
430064;201806;150;124;26;118296.0;24804.0;143100.0
430066;201806;10;7;3;6678.0;2862.0;9540.0
430070;201806;43;33;10;31482.0;9540.0;41022.0
430080;201806;67;45;22;42230.33;20988.0;63218.33
430085;201806;34;12;22;11448.0;20988.0;32436.0
430087;201806;33;25;8;23707.0;7632.0;31339.0
430090;201806;72;65;7;61723.8;6678.0;68401.8
430100;201806;126;85;41;80136.0;39114.0;119250.0
430105;201806;143;72;71;68323.0;67428.72;135751.72
430107;201806;20;15;5;14310.0;4770.0;19080.0
430110;201806;413;242;171;230057.1;163067.22;393124.3
430120;201806;139;128;11;121158.0;10494.0;131652.0
430130;201806;798;500;298;476379.9;284005.8;760385.7
430140;201806;123;113;10;107802.0;9540.0;117342.0
430150;201806;112;72;40;67925.0;37206.0;105131.0
430155;201806;32;29;3;27666.0;2862.0;30528.0
430160;201806;3799;2253;1546;2130790.2;1472718.6;3603508.8
430163;201806;331;150;181;142051.34;172645.38;314696.72
430165;201806;25;17;8;16218.0;7632.0;23850.0
430170;201806;82;74;8;70596.0;7632.0;78228.0
430175;201806;84;65;19;62010.0;17458.2;79468.2
430180;201806;104;81;23;77274.0;21321.9;98595.9
430185;201806;34;25;9;23850.0;8586.0;32436.0
430187;201806;100;41;59;39114.0;55980.8;95094.8
430190;201806;220;125;95;119202.3;89953.46;209155.77
430192;201806;15;14;1;13356.0;954.0;14310.0
430195;201806;14;9;5;8586.0;4770.0;13356.0
430200;201806;167;148;19;140524.2;18126.0;158650.2
430205;201806;20;19;1;18126.0;954.0;19080.0
430210;201806;635;494;141;467555.4;132653.9;600209.3
430215;201806;16;11;5;10494.0;4770.0;15264.0
430220;201806;68;49;19;46746.0;18126.0;64872.0
430222;201806;12;7;5;6678.0;4770.0;11448.0
430223;201806;13;7;6;6678.0;5724.0;12402.0
430225;201806;4;3;1;2862.0;954.0;3816.0
430230;201806;296;182;114;172674.0;108756.0;281430.0
430235;201806;52;36;16;34344.0;15254.46;49598.46
430237;201806;29;22;7;20988.0;6678.0;27666.0
430240;201806;131;84;47;79945.2;44838.0;124783.2
430245;201806;71;60;11;57240.0;10494.0;67734.0
430250;201806;191;110;81;104930.46;77264.46;182194.92
430258;201806;13;11;2;10494.0;1908.0;12402.0
430260;201806;34;29;5;27666.0;4760.46;32426.46
430265;201806;34;29;5;27646.92;4770.0;32416.92
430270;201806;558;413;145;390898.75;137473.02;528371.75
430280;201806;1049;642;407;607993.75;385778.6;993772.3
430290;201806;376;218;158;206064.8;150732.0;356796.8
430300;201806;2132;1172;960;1113614.9;912790.4;2026405.2
430310;201806;1982;1045;937;990645.4;890865.94;1881511.4
430320;201806;50;42;8;40053.69;7632.0;47685.69
430330;201806;95;85;10;80613.0;9520.92;90133.92
430340;201806;67;59;8;56286.0;7632.0;63918.0
430350;201806;1680;1167;513;1101188.9;487628.62;1588817.5
430355;201806;26;23;3;21942.0;2862.0;24804.0
430360;201806;82;39;43;37206.0;41022.0;78228.0
430367;201806;28;19;9;18126.0;8586.0;26712.0
430370;201806;56;48;8;45792.0;7632.0;53424.0
430380;201806;129;96;33;91011.6;31482.0;122493.6
430390;201806;618;385;233;366956.1;221405.06;588361.2
430400;201806;140;108;32;101124.0;30508.92;131632.92
430410;201806;61;48;13;45792.0;12402.0;58194.0
430420;201806;497;326;171;308524.8;161637.56;470162.38
430430;201806;53;51;2;48018.63;1908.0;49926.63
430435;201806;156;116;40;109710.0;37444.5;147154.5
430440;201806;497;331;166;315774.0;158173.2;473947.2
430450;201806;1189;983;206;930799.44;196514.45;1127313.9
430460;201806;5103;2802;2301;2657848.5;2189213.8;4847062.5
430461;201806;17;15;2;14310.0;1908.0;16218.0
430462;201806;9;6;3;5724.0;2862.0;8586.0
430463;201806;1036;549;487;521322.9;464246.1;985569.0
430465;201806;26;14;12;13356.0;11448.0;24804.0
430466;201806;669;482;187;457920.2;178207.2;636127.4
430467;201806;99;57;42;53137.8;40058.46;93196.26
430468;201806;111;70;41;66780.0;38862.91;105642.91
430469;201806;22;17;5;16218.0;4770.0;20988.0
430470;201806;1160;641;519;605829.56;493170.3;1098999.9
430471;201806;49;37;12;35278.92;11448.0;46726.92
430480;201806;92;55;37;51611.4;35288.46;86899.86
430485;201806;6;6;0;5438.0;0.0;5438.0
430490;201806;88;71;17;66923.7;16218.0;83141.7
430495;201806;38;27;11;25758.0;10494.0;36252.0
430500;201806;193;129;64;123066.0;60680.46;183746.45
430510;201806;3155;2092;1063;1987850.8;1013025.0;3000875.8
430511;201806;16;16;0;15264.0;0.0;15264.0
430512;201806;137;96;41;91584.0;39114.0;130698.0
430513;201806;52;44;8;41499.0;7632.0;49131.0
430515;201806;32;30;2;28620.0;1908.0;30528.0
430517;201806;169;150;19;142146.0;18106.92;160252.92
430520;201806;371;260;111;247373.0;105865.38;353238.38
430530;201806;89;52;37;49608.0;35298.0;84906.0
430535;201806;477;318;159;302886.44;151658.16;454544.6
430537;201806;10;10;0;9540.0;0.0;9540.0
430540;201806;73;50;23;47700.0;21942.0;69642.0
430543;201806;368;112;256;106848.0;244224.0;351072.0
430544;201806;42;39;3;37206.0;2862.0;40068.0
430545;201806;354;170;184;161684.0;175005.58;336689.6
430550;201806;43;35;8;33390.0;7632.0;41022.0
430558;201806;5;3;2;2862.0;1908.0;4770.0
430560;201806;49;21;28;20034.0;26712.0;46746.0
430570;201806;104;45;59;42930.0;56228.76;99158.76
430580;201806;123;98;25;93492.0;22609.8;116101.8
430583;201806;14;14;0;13356.0;0.0;13356.0
430585;201806;8;3;5;2862.0;4770.0;7632.0
430587;201806;14;8;6;7632.0;5724.0;13356.0
430590;201806;154;124;30;117055.8;28620.0;145675.8
430593;201806;4;4;0;3816.0;0.0;3816.0
430595;201806;18;14;4;13356.0;3816.0;17172.0
430597;201806;51;27;24;25758.0;22896.0;48654.0
430600;201806;220;155;65;147860.45;61723.8;209584.27
430605;201806;160;101;59;96354.0;56276.46;152630.45
430607;201806;27;22;5;20988.0;4770.0;25758.0
430610;201806;1640;766;874;728036.25;829179.75;1557216.0
430613;201806;3;3;0;2862.0;0.0;2862.0
430620;201806;111;80;31;76176.9;29564.46;105741.36
430630;201806;45;39;6;37206.0;5724.0;42930.0
430632;201806;32;27;5;25758.0;4770.0;30528.0
430635;201806;41;37;4;35298.0;3816.0;39114.0
430637;201806;56;32;24;30528.0;22896.0;53424.0
430640;201806;207;114;93;107325.0;88722.0;196047.0
430642;201806;27;25;2;23850.0;1908.0;25758.0
430645;201806;35;29;6;27666.0;5724.0;33390.0
430650;201806;254;204;50;194330.0;47652.3;241982.3
430655;201806;4;4;0;3816.0;0.0;3816.0
430660;201806;969;474;495;450621.9;470703.8;921325.7
430670;201806;72;50;22;47700.0;20988.0;68688.0
430673;201806;69;38;31;36252.0;29574.0;65826.0
430675;201806;13;10;3;9540.0;2862.0;12402.0
430676;201806;492;299;193;284540.12;184051.06;468591.2
430680;201806;248;171;77;160653.8;73458.0;234111.8
430690;201806;535;319;216;303420.25;204389.06;507809.3
430692;201806;7;5;2;4770.0;1908.0;6678.0
430693;201806;146;98;48;93492.0;45782.46;139274.45
430695;201806;73;65;8;61075.08;7632.0;68707.08
430697;201806;57;35;22;33390.0;20988.0;54378.0
430700;201806;1582;1111;471;1048353.56;449047.8;1497401.4
430705;201806;19;18;1;17172.0;954.0;18126.0
430710;201806;262;170;92;162180.0;87768.0;249948.0
430720;201806;108;92;16;87577.2;15264.0;102841.2
430730;201806;119;102;17;96354.0;16218.0;112572.0
430740;201806;65;43;22;41022.0;20988.0;62010.0
430745;201806;36;29;7;27380.0;6678.0;34058.0
430750;201806;341;227;114;215614.64;107802.0;323416.62
430755;201806;83;47;36;44838.0;34344.0;79182.0
430760;201806;366;220;146;207209.72;139255.92;346465.62
430770;201806;1456;752;704;714737.7;666462.9;1381200.5
430780;201806;314;202;112;191726.72;106781.76;298508.47
430781;201806;28;23;5;21942.0;4770.0;26712.0
430783;201806;52;42;10;39750.13;9540.0;49290.13
430786;201806;6;3;3;2862.0;2862.0;5724.0
430790;201806;504;324;180;308205.72;171424.45;479630.2
430800;201806;158;130;28;124000.92;26712.0;150712.92
430805;201806;41;37;4;35298.0;3816.0;39114.0
430807;201806;38;25;13;23850.0;12402.0;36252.0
430810;201806;76;50;26;47700.0;24804.0;72504.0
430820;201806;136;85;51;81090.0;47986.2;129076.2
430825;201806;12;10;2;9540.0;1908.0;11448.0
430830;201806;234;221;13;210528.92;12402.0;222930.92
430840;201806;127;86;41;82044.0;38446.2;120490.2
430843;201806;5;3;2;2862.0;1908.0;4770.0
430845;201806;70;39;31;37206.0;29574.0;66780.0
430850;201806;570;396;174;375943.6;165892.77;541836.3
430860;201806;155;98;57;92824.2;53700.66;146524.86
430865;201806;67;37;30;34630.2;28305.18;62935.38
430870;201806;81;66;15;62296.2;14310.0;76606.2
430880;201806;161;120;41;114460.92;39114.0;153574.92
430885;201806;7;6;1;5724.0;954.0;6678.0
430890;201806;334;205;129;193910.05;123066.0;316976.03
430900;201806;538;370;168;348496.4;159785.45;508281.88
430905;201806;90;37;53;35298.0;50562.0;85860.0
430910;201806;265;147;118;140238.0;111896.0;252134.0
430912;201806;4;4;0;3816.0;0.0;3816.0
430915;201806;36;28;8;26712.0;7345.8;34057.8
430920;201806;4296;2383;1913;2266269.8;1822362.6;4088632.2
430925;201806;5;4;1;3567.96;954.0;4521.96
430930;201806;2104;1248;856;1183229.8;816373.44;1999603.2
430940;201806;249;157;92;149100.66;87748.92;236849.58
430950;201806;156;126;30;120204.0;28620.0;148824.0
430955;201806;22;14;8;13356.0;7632.0;20988.0
430957;201806;18;17;1;16218.0;954.0;17172.0
430960;201806;236;157;79;147345.3;75366.0;222711.3
430965;201806;108;68;40;64872.0;38160.0;103032.0
430970;201806;79;66;13;62964.0;11448.0;74412.0
430975;201806;36;32;4;30528.0;3816.0;34344.0
430980;201806;47;29;18;27666.0;17172.0;44838.0
430990;201806;117;89;28;84906.0;26712.0;111618.0
430995;201806;113;109;4;102745.8;3816.0;106561.8
431000;201806;300;136;164;127597.2;156456.0;284053.2
431010;201806;338;203;135;192803.4;128790.0;321593.4
431020;201806;1932;1127;805;1066882.6;763858.25;1830740.9
431030;201806;42;33;9;31482.0;8586.0;40068.0
431033;201806;385;194;191;184265.2;182214.0;366479.2
431036;201806;14;9;5;8586.0;4770.0;13356.0
431040;201806;131;79;52;74412.0;49498.29;123910.29
431041;201806;36;24;12;22896.0;11448.0;34344.0
431043;201806;46;26;20;24804.0;19080.0;43884.0
431046;201806;12;7;5;6678.0;4770.0;11448.0
431050;201806;204;129;75;122493.6;71263.8;193757.4
431053;201806;75;45;30;42166.8;28620.0;70786.8
431055;201806;64;43;21;41022.0;20014.92;61036.92
431057;201806;17;17;0;16218.0;0.0;16218.0
431060;201806;1672;1054;618;997571.4;587720.44;1585291.8
431065;201806;19;11;8;10494.0;7632.0;18126.0
431070;201806;71;66;5;62964.0;4770.0;67734.0
431075;201806;7;7;0;6678.0;0.0;6678.0
431080;201806;136;87;49;82711.8;46746.0;129457.8
431085;201806;30;27;3;25758.0;2862.0;28620.0
431087;201806;13;11;2;10494.0;1908.0;12402.0
431090;201806;55;43;12;41022.0;11448.0;52470.0
431100;201806;1234;737;497;692274.0;474138.0;1166412.0
431110;201806;245;155;90;147870.0;85564.46;233434.45
431112;201806;28;17;11;16218.0;10494.0;26712.0
431113;201806;32;22;10;20988.0;9540.0;30528.0
431115;201806;154;107;47;101441.87;44828.46;146270.33
431120;201806;614;363;251;344347.1;239396.92;583744.0
431123;201806;3;2;1;1908.0;954.0;2862.0
431125;201806;91;81;10;77274.0;9540.0;86814.0
431127;201806;8;4;4;3816.0;3816.0;7632.0
431130;201806;656;423;233;402015.6;221976.72;623992.3
431140;201806;733;497;236;471419.3;225067.69;696487.0
431142;201806;35;27;8;24546.0;7632.0;32178.0
431150;201806;204;149;55;142146.0;52460.46;194606.45
431160;201806;56;50;6;47700.0;5724.0;53424.0
431162;201806;19;14;5;13356.0;4770.0;18126.0
431164;201806;4;4;0;3816.0;0.0;3816.0
431170;201806;104;84;20;80136.0;19080.0;99216.0
431171;201806;58;33;25;31243.5;23840.46;55083.96
431173;201806;1;1;0;954.0;0.0;954.0
431175;201806;202;99;103;93206.0;98252.46;191458.45
431177;201806;75;56;19;53424.0;17439.92;70863.92
431179;201806;13;11;2;10494.0;1908.0;12402.0
431180;201806;448;274;174;260680.5;165977.45;426657.97
431190;201806;89;69;20;65826.0;19080.0;84906.0
431198;201806;70;48;22;45792.0;20988.0;66780.0
431200;201806;21;17;4;16218.0;3816.0;20034.0
431205;201806;23;23;0;21942.0;0.0;21942.0
431210;201806;90;56;34;53091.0;32436.0;85527.0
431213;201806;30;25;5;23850.0;4770.0;28620.0
431215;201806;25;22;3;20988.0;2862.0;23850.0
431217;201806;5;4;1;3816.0;954.0;4770.0
431220;201806;67;57;10;54378.0;9540.0;63918.0
431225;201806;149;99;50;94437.0;47680.92;142117.92
431230;201806;96;84;12;80136.0;11448.0;91584.0
431235;201806;8;8;0;7632.0;0.0;7632.0
431237;201806;26;18;8;17172.0;7632.0;24804.0
431238;201806;13;10;3;9254.0;2862.0;12116.0
431240;201806;1004;646;358;614624.6;341207.62;955832.25
431242;201806;36;36;0;34344.0;0.0;34344.0
431244;201806;11;8;3;7632.0;2862.0;10494.0
431245;201806;55;41;14;39114.0;13356.0;52470.0
431247;201806;12;10;2;9540.0;1908.0;11448.0
431250;201806;273;141;132;134447.22;125908.92;260356.14
431260;201806;62;46;16;43884.0;15264.0;59148.0
431261;201806;20;13;7;12402.0;6678.0;19080.0
431262;201806;15;15;0;14310.0;0.0;14310.0
431265;201806;159;83;76;79182.0;72504.0;151686.0
431267;201806;13;12;1;11448.0;954.0;12402.0
431270;201806;317;265;52;252810.0;49608.0;302418.0
431275;201806;40;38;2;36252.0;1908.0;38160.0
431280;201806;20;16;4;14429.25;3816.0;18245.25
431290;201806;23;19;4;18126.0;3816.0;21942.0
431295;201806;4;4;0;3816.0;0.0;3816.0
431300;201806;23;20;3;19080.0;2862.0;21942.0
431301;201806;7;7;0;6678.0;0.0;6678.0
431303;201806;52;35;17;33265.98;15931.8;49197.78
431306;201806;226;119;107;113069.98;102078.0;215147.98
431308;201806;7;5;2;4770.0;1908.0;6678.0
431310;201806;65;56;9;53424.0;8586.0;62010.0
431320;201806;121;72;49;68668.92;46450.26;115119.18
431330;201806;172;109;63;103986.0;60102.0;164088.0
431333;201806;33;27;6;25758.0;5724.0;31482.0
431335;201806;10;5;5;4770.0;4770.0;9540.0
431337;201806;327;156;171;147965.58;162094.14;310059.72
431339;201806;21;18;3;17172.0;2862.0;20034.0
431340;201806;3016;1739;1277;1654189.6;1215322.5;2869512.0
431342;201806;41;24;17;22896.0;16218.0;39114.0
431344;201806;18;17;1;16218.0;954.0;17172.0
431346;201806;4;4;0;3816.0;0.0;3816.0
431349;201806;35;32;3;30528.0;2862.0;33390.0
431350;201806;916;537;379;507749.66;359906.03;867655.7
431360;201806;46;41;5;39114.0;4770.0;43884.0
431365;201806;319;152;167;144988.92;158354.45;303343.38
431370;201806;1348;797;551;756703.94;525343.06;1282047.0
431380;201806;97;84;13;80136.0;12402.0;92538.0
431390;201806;500;277;223;263256.5;212436.72;475693.22
431395;201806;281;124;157;118296.0;149759.0;268055.0
431400;201806;39;29;10;27666.0;9540.0;37206.0
431402;201806;103;72;31;68688.0;29574.0;98262.0
431403;201806;20;12;8;11448.0;7632.0;19080.0
431405;201806;642;345;297;327490.03;283025.0;610515.0
431406;201806;31;27;4;25758.0;3816.0;29574.0
431407;201806;53;42;11;40068.0;10494.0;50562.0
431410;201806;3282;1968;1314;1863752.5;1249024.5;3112777.0
431413;201806;16;13;3;12402.0;2862.0;15264.0
431415;201806;70;51;19;48654.0;18126.0;66780.0
431417;201806;23;12;11;11448.0;10494.0;21942.0
431420;201806;304;214;90;203472.27;85860.0;289332.25
431430;201806;43;18;25;17172.0;23850.0;41022.0
431440;201806;8981;6386;2595;6022781.0;2467822.8;8490604.0
431442;201806;28;15;13;14310.0;12402.0;26712.0
431445;201806;26;20;6;19080.0;5724.0;24804.0
431446;201806;7;6;1;5724.0;954.0;6678.0
431447;201806;87;62;25;59148.0;23850.0;82998.0
431449;201806;51;45;6;42930.0;5724.0;48654.0
431450;201806;413;283;130;268932.6;123304.5;392237.1
431454;201806;0;0;0;0.0;0.0;0.0
431455;201806;50;40;10;38160.0;9540.0;47700.0
431460;201806;537;369;168;349974.9;159985.8;509960.7
431470;201806;115;89;26;84214.54;24554.0;108768.54
431475;201806;11;10;1;9540.0;954.0;10494.0
431477;201806;37;25;12;23850.0;11448.0;35298.0
431478;201806;8;7;1;6678.0;954.0;7632.0
431480;201806;507;319;188;302780.53;179304.3;482084.8
431490;201806;28236;16082;12154;1,53E+14;1,16E+13;2,68E+13
431500;201806;79;54;25;51197.66;23850.0;75047.66
431505;201806;37;22;15;20988.0;14310.0;35298.0
431507;201806;12;10;2;9540.0;1908.0;11448.0
431510;201806;273;182;91;173199.0;85831.38;259030.38
431513;201806;23;19;4;18126.0;3816.0;21942.0
431514;201806;9;8;1;7632.0;954.0;8586.0
431515;201806;80;67;13;63918.0;12402.0;76320.0
431517;201806;4;2;2;1908.0;1908.0;3816.0
431520;201806;37;33;4;31482.0;3816.0;35298.0
431530;201806;1593;715;878;681728.6;837188.06;1518916.8
431531;201806;23;21;2;20034.0;1908.0;21942.0
431532;201806;26;18;8;17172.0;7632.0;24804.0
431535;201806;26;16;10;15264.0;9540.0;24804.0
431540;201806;140;124;16;117275.22;15264.0;132539.22
431545;201806;17;15;2;14310.0;1908.0;16218.0
431550;201806;353;202;151;192421.8;143958.6;336380.4
431555;201806;13;12;1;11448.0;954.0;12402.0
431560;201806;4535;3198;1337;3020029.2;1273133.0;4293162.0
431570;201806;806;429;377;405164.2;356787.47;761951.7
431575;201806;36;25;11;23850.0;10494.0;34344.0
431580;201806;93;66;27;62010.0;25758.0;87768.0
431590;201806;135;113;22;106848.0;20988.0;127836.0
431595;201806;11;10;1;9540.0;954.0;10494.0
431600;201806;216;124;92;118296.0;87768.0;206064.0
431610;201806;128;93;35;87481.8;33390.0;120871.8
431620;201806;43;35;8;33390.0;7632.0;41022.0
431630;201806;140;116;24;110664.0;22896.0;133560.0
431640;201806;1349;837;512;793346.8;486140.12;1279487.0
431642;201806;39;36;3;33867.0;2862.0;36729.0
431643;201806;44;20;24;19080.0;22896.0;41976.0
431645;201806;301;173;128;165042.0;121825.8;286867.8
431647;201806;10;10;0;9540.0;0.0;9540.0
431650;201806;36;27;9;25758.0;8586.0;34344.0
431660;201806;289;187;102;176490.0;97308.0;273798.0
431670;201806;225;107;118;99454.5;112543.38;211997.88
431673;201806;3;3;0;2862.0;0.0;2862.0
431675;201806;30;25;5;23563.8;4770.0;28333.8
431680;201806;1116;804;312;762150.6;296551.44;1058702.0
431690;201806;4816;2934;1882;2776297.5;1791223.8;4567521.5
431695;201806;26;20;6;19080.0;5724.0;24804.0
431697;201806;0;0;0;0.0;0.0;0.0
431700;201806;178;137;41;130698.0;39114.0;169812.0
431710;201806;4023;1734;2289;1651842.2;2182000.5;3833842.8
431720;201806;1394;836;558;788082.6;531364.44;1319447.1
431725;201806;1;1;0;954.0;0.0;954.0
431730;201806;1196;813;383;768241.25;365382.0;1133623.2
431740;201806;1370;685;685;648872.75;651699.4;1300572.1
431750;201806;1864;1207;657;1141201.5;624841.94;1766043.4
431755;201806;7;6;1;5724.0;954.0;6678.0
431760;201806;1072;689;383;656924.4;365153.6;1022078.0
431770;201806;394;289;105;275029.47;100150.92;375180.38
431775;201806;28;21;7;20034.0;6678.0;26712.0
431780;201806;561;352;209;334691.8;199376.45;534068.25
431790;201806;157;119;38;112572.0;36204.3;148776.3
431795;201806;14;12;2;11448.0;1908.0;13356.0
431800;201806;3376;1770;1606;1675290.0;1526378.6;3201668.8
431805;201806;17;15;2;14310.0;1908.0;16218.0
431810;201806;614;411;203;389460.97;193528.98;582989.94
431820;201806;310;175;135;166950.0;127836.0;294786.0
431830;201806;2332;1413;919;1344381.6;875465.6;2219847.2
431840;201806;521;350;171;330276.4;161894.0;492170.4
431842;201806;34;28;6;26712.0;5724.0;32436.0
431843;201806;12;8;4;7632.0;3816.0;11448.0
431844;201806;14;12;2;11448.0;1908.0;13356.0
431845;201806;29;26;3;24804.0;2862.0;27666.0
431846;201806;27;23;4;21942.0;3816.0;25758.0
431848;201806;15;12;3;11448.0;2862.0;14310.0
431849;201806;9;7;2;6678.0;1908.0;8586.0
431850;201806;813;673;140;640529.5;133321.5;773851.0
431860;201806;107;75;32;71550.0;29574.0;101124.0
431861;201806;4;2;2;1908.0;1908.0;3816.0
431862;201806;52;34;18;32436.0;17172.0;49608.0
431870;201806;3454;2038;1416;1934898.8;1347826.0;3282724.8
431880;201806;958;700;258;661761.8;245178.0;906939.8
431890;201806;1299;804;495;761407.3;470623.0;1232030.4
431900;201806;180;127;53;121158.0;49770.18;170928.19
431910;201806;56;43;13;41022.0;12402.0;53424.0
431912;201806;35;19;16;18126.0;15264.0;33390.0
431915;201806;125;99;26;94446.0;24804.0;119250.0
431920;201806;145;106;39;100837.8;37206.0;138043.8
431930;201806;85;69;16;65110.5;15264.0;80374.5
431935;201806;4;3;1;2862.0;954.0;3816.0
431936;201806;13;12;1;11448.0;954.0;12402.0
431937;201806;18;13;5;12402.0;4770.0;17172.0
431940;201806;461;311;150;293927.4;141850.95;435778.38
431950;201806;486;308;178;291438.1;169660.44;461098.53
431960;201806;732;425;307;401264.03;292716.9;693980.94
431970;201806;73;64;9;61056.0;8586.0;69642.0
431971;201806;3;3;0;2862.0;0.0;2862.0
431973;201806;22;17;5;16218.0;4770.0;20988.0
431975;201806;7;6;1;5724.0;954.0;6678.0
431980;201806;205;129;76;122255.1;72504.0;194759.1
431990;201806;1223;656;567;624303.3;540872.0;1165175.2
432000;201806;1677;911;766;860455.25;727199.25;1587654.5
432010;201806;281;185;96;175192.56;91584.0;266776.56
432020;201806;171;137;34;130698.0;32426.46;163124.45
432023;201806;18;14;4;13356.0;3816.0;17172.0
432026;201806;67;61;6;58194.0;5724.0;63918.0
432030;201806;64;28;36;26712.0;34344.0;61056.0
432032;201806;21;18;3;17172.0;2862.0;20034.0
432035;201806;50;39;11;37206.0;10494.0;47700.0
432040;201806;103;71;32;67734.0;30528.0;98262.0
432045;201806;8;7;1;6678.0;954.0;7632.0
432050;201806;67;40;27;38160.0;25758.0;63918.0
432055;201806;102;73;29;69642.0;27666.0;97308.0
432057;201806;1;0;1;0.0;954.0;954.0
432060;201806;35;32;3;30528.0;2862.0;33390.0
432065;201806;29;26;3;24804.0;2862.0;27666.0
432067;201806;87;77;10;73438.92;9540.0;82978.92
432070;201806;411;306;105;290027.38;100141.92;390169.3
432080;201806;812;562;250;534278.9;238404.69;772683.56
432085;201806;16;12;4;11448.0;3816.0;15264.0
432090;201806;258;160;98;152640.0;93492.0;246132.0
432100;201806;179;119;60;113192.1;57240.0;170432.1
432110;201806;623;425;198;395767.44;187938.0;583705.44
432120;201806;957;580;377;552652.2;359572.12;912224.3
432130;201806;508;369;139;350690.4;131508.9;482199.3
432132;201806;25;22;3;20988.0;2862.0;23850.0
432135;201806;79;65;14;62010.0;13356.0;75366.0
432140;201806;269;213;56;202906.27;53424.0;256330.27
432143;201806;192;123;69;117342.0;65826.0;183168.0
432145;201806;271;190;81;180020.6;76987.8;257008.4
432146;201806;14;13;1;12402.0;954.0;13356.0
432147;201806;136;62;74;59148.0;70572.15;129720.15
432149;201806;18;13;5;12402.0;4770.0;17172.0
432150;201806;833;523;310;498693.97;293718.16;792412.1
432160;201806;1384;718;666;682626.7;634458.44;1317085.1
432162;201806;4;3;1;2862.0;954.0;3816.0
432163;201806;18;14;4;13356.0;3816.0;17172.0
432166;201806;120;90;30;86338.0;28620.0;114958.0
432170;201806;223;122;101;115435.0;96354.0;211789.0
432180;201806;520;318;202;300605.6;192422.0;493027.6
432183;201806;10;7;3;6678.0;2862.0;9540.0
432185;201806;82;71;11;67734.0;10494.0;78228.0
432190;201806;458;256;202;243832.86;192585.06;436417.9
432195;201806;85;73;12;69642.0;11448.0;81090.0
432200;201806;412;267;145;254718.0;138282.84;393000.84
432210;201806;121;78;43;72647.1;41022.0;113669.1
432215;201806;60;56;4;53424.0;3816.0;57240.0
432218;201806;20;19;1;18126.0;954.0;19080.0
432220;201806;684;343;341;326230.62;324806.75;651037.4
432225;201806;14;8;6;7155.0;5724.0;12879.0
432230;201806;145;87;58;82759.5;55332.0;138091.5
432232;201806;16;14;2;13356.0;1908.0;15264.0
432234;201806;4;3;1;2862.0;954.0;3816.0
432235;201806;2;2;0;1908.0;0.0;1908.0
432237;201806;29;16;13;15264.0;12402.0;27666.0
432240;201806;4279;2384;1895;2264918.0;1799973.1;4064891.0
432250;201806;1040;665;375;631740.25;357559.2;989299.44
432252;201806;42;34;8;31691.88;7632.0;39323.88
432253;201806;58;46;12;43884.0;11448.0;55332.0
432254;201806;24;11;13;10494.0;12402.0;22896.0
432255;201806;14;13;1;12402.0;954.0;13356.0
432260;201806;879;691;188;657507.3;178398.5;835905.8
432270;201806;231;168;63;160272.0;60102.0;220374.0
432280;201806;123;90;33;85383.8;31482.0;116865.8
432285;201806;1;1;0;954.0;0.0;954.0
432290;201806;70;63;7;57907.8;6678.0;64585.8
432300;201806;4648;2659;1989;2517474.2;1893731.4;4411205.5
432310;201806;116;93;23;88722.0;21942.0;110664.0
432320;201806;20;16;4;15216.3;3816.0;19032.3
432330;201806;17;12;5;11448.0;4770.0;16218.0
432335;201806;7;6;1;5724.0;954.0;6678.0
432340;201806;40;37;3;35298.0;2862.0;38160.0
432345;201806;97;69;28;65826.0;26712.0;92538.0
432350;201806;23;22;1;20988.0;954.0;21942.0
432360;201806;6;4;2;3816.0;1908.0;5724.0
432370;201806;25;25;0;23850.0;0.0;23850.0
432375;201806;38;33;5;31482.0;4770.0;36252.0
432377;201806;7;7;0;6678.0;0.0;6678.0
432380;201806;168;76;92;71836.2;87720.3;159556.5
500020;201806;247;137;110;130698.0;104338.98;235036.98
500025;201806;117;58;59;54378.0;56286.0;110664.0
500060;201806;1393;857;536;817005.6;510729.62;1327735.2
500070;201806;775;370;405;352629.0;386360.47;738989.44
500080;201806;132;102;30;97308.0;28620.0;125928.0
500085;201806;138;112;26;106562.0;23969.25;130531.25
500090;201806;335;160;175;152640.0;166950.0;319590.0
500100;201806;700;379;321;358800.12;305662.0;664462.1
500110;201806;2233;1007;1226;960351.44;1168781.6;2129133.0
500124;201806;311;178;133;169812.0;126595.8;296407.8
500150;201806;330;131;199;124965.0;189476.45;314441.47
500190;201806;527;363;164;345634.2;155970.0;501604.2
500200;201806;198;168;30;159929.0;28620.0;188549.0
500210;201806;1451;520;931;494911.38;887001.44;1381912.9
500215;201806;242;139;103;131648.42;98262.0;229910.42
500220;201806;781;507;274;483433.84;260638.45;744072.3
500230;201806;260;176;84;167188.5;79659.0;246847.5
500240;201806;700;487;213;463834.8;202915.8;666750.6
500260;201806;577;217;360;207018.0;343440.0;550458.0
500270;201806;28439;12107;16332;1,15E+14;1,56E+14;2,71E+14
500280;201806;190;71;119;67734.0;113526.0;181260.0
500290;201806;1189;705;484;671536.0;461727.0;1133263.0
500295;201806;414;251;163;239454.0;155492.45;394946.47
500310;201806;63;20;43;19080.0;41022.0;60102.0
500315;201806;707;424;283;404486.47;269972.47;674458.94
500320;201806;3611;1820;1791;1733853.4;1707234.0;3441087.2
500325;201806;925;514;411;489879.0;391119.44;880998.44
500330;201806;1476;684;792;650314.25;755234.6;1405548.9
500345;201806;320;238;82;226089.2;78228.0;304317.2
500348;201806;243;143;100;136422.0;95381.46;231803.45
500350;201806;139;66;73;62964.0;69642.0;132606.0
500370;201806;5414;2435;2979;2315462.0;2839774.0;5155236.0
500375;201806;352;255;97;243005.84;92538.0;335543.84
500380;201806;593;338;255;322294.6;243260.45;565555.06
500390;201806;72;36;36;34344.0;34344.0;68688.0
500400;201806;217;146;71;139264.92;67725.0;206989.92
500410;201806;558;219;339;208880.16;323258.22;532138.4
500430;201806;547;382;165;364428.0;157410.0;521838.0
500440;201806;204;105;99;99397.43;94446.0;193843.44
500450;201806;403;173;230;164336.8;219410.45;383747.25
500460;201806;309;157;152;149768.45;145008.0;294776.47
500470;201806;443;345;98;327629.66;92529.0;420158.66
500480;201806;113;67;46;63918.0;43884.0;107802.0
500490;201806;106;41;65;39109.23;62010.0;101119.23
500500;201806;1428;504;924;478798.9;880914.9;1359713.8
500510;201806;48;38;10;36252.0;9531.0;45783.0
500515;201806;109;77;32;73458.0;30242.0;103700.0
500520;201806;345;192;153;182691.0;145672.0;328363.0
500525;201806;87;49;38;46746.0;35965.8;82711.8
500540;201806;906;382;524;364361.75;498885.84;863247.6
500560;201806;882;499;383;474307.03;365057.84;839364.9
500568;201806;1004;579;425;548804.6;405159.22;953963.9
500570;201806;1221;683;538;648112.06;510358.72;1158470.8
500580;201806;339;173;166;164746.27;158351.0;323097.25
500600;201806;312;158;154;150021.27;146898.0;296919.28
500620;201806;929;653;276;617471.6;263113.2;880584.8
500625;201806;80;68;12;64165.19;11448.0;75613.19
500627;201806;26;13;13;12402.0;12402.0;24804.0
500630;201806;1561;830;731;791143.44;697087.8;1488231.2
500635;201806;521;297;224;282918.25;213552.9;496471.12
500640;201806;428;224;204;211122.0;194597.45;405719.47
500660;201806;5529;2109;3420;2008524.1;3257978.2;5266502.5
500690;201806;570;205;365;195213.23;346522.25;541735.5
500710;201806;358;172;186;163802.0;177426.0;341228.0
500720;201806;981;572;409;544004.7;389976.9;933981.6
500730;201806;199;119;80;113526.0;76315.23;189841.23
500740;201806;840;369;471;350738.94;449055.75;799794.7
500750;201806;142;48;94;45792.0;89647.92;135439.92
500755;201806;125;90;35;85574.0;33390.0;118964.0
500769;201806;746;427;319;407022.28;304313.0;711335.25
500770;201806;434;230;204;219410.45;194606.45;414016.9
500780;201806;171;114;57;108756.0;54378.0;163134.0
500790;201806;1034;516;518;491759.25;494131.47;985890.7
500793;201806;255;139;116;132606.0;110655.0;243261.0
500795;201806;177;126;51;120194.46;48645.0;168839.45
500797;201806;41;31;10;29574.0;9540.0;39114.0
500800;201806;410;178;232;169803.0;221041.8;390844.8
500830;201806;2215;1238;977;1177304.1;931018.7;2108322.8
500840;201806;140;105;35;100170.0;33381.0;133551.0
510010;201806;165;91;74;86804.46;70567.38;157371.84
510020;201806;490;230;260;219126.06;247503.95;466630.03
510025;201806;1681;955;726;910200.1;690077.06;1600277.2
510030;201806;674;350;324;333853.9;308326.7;642180.6
510035;201806;128;58;70;55304.46;66761.46;122065.92
510040;201806;387;174;213;165996.0;202755.27;368751.25
510050;201806;426;234;192;222485.66;182344.45;404830.12
510060;201806;114;57;57;54368.46;54368.46;108736.92
510080;201806;221;90;131;85827.69;124860.06;210687.75
510100;201806;76;34;42;32436.0;40048.92;72484.92
510120;201806;38;23;15;21942.0;14310.0;36252.0
510125;201806;393;241;152;229231.89;144984.92;374216.8
510130;201806;570;330;240;314414.8;228536.64;542951.44
510140;201806;392;129;263;123057.0;250897.23;373954.22
510160;201806;92;41;51;39114.0;48650.0;87764.0
510170;201806;868;526;342;501529.06;325635.38;827164.44
510180;201806;2868;1398;1470;1330697.1;1400465.9;2731163.0
510185;201806;11;6;5;5724.0;4770.0;10494.0
510190;201806;213;71;142;67734.0;135463.23;203197.23
510250;201806;2609;1539;1070;1467146.5;1019647.1;2486793.8
510260;201806;201;145;56;138147.84;53387.46;191535.3
510263;201806;452;248;204;235588.58;193860.6;429449.16
510267;201806;669;375;294;356241.75;280195.9;636437.7
510268;201806;55;29;26;27666.0;24804.0;52470.0
510269;201806;68;30;38;28611.0;36252.0;64863.0
510270;201806;407;206;201;196345.98;191327.94;387673.9
510279;201806;233;172;61;164061.0;57888.92;221949.92
510285;201806;168;73;95;69623.46;90630.0;160253.45
510300;201806;533;293;240;279090.12;228885.84;507975.97
510305;201806;210;99;111;94423.46;105818.22;200241.69
510310;201806;113;58;55;55332.0;52460.46;107792.46
510320;201806;873;546;327;520316.2;311808.38;832124.56
510325;201806;414;166;248;158354.45;236296.27;394650.72
510330;201806;425;238;187;227039.0;178378.92;405417.9
510335;201806;594;325;269;310003.38;255809.78;565813.2
510336;201806;48;35;13;33390.0;12402.0;45792.0
510337;201806;121;50;71;47690.46;67724.46;115414.92
510340;201806;17289;8279;9010;7876229.5;8585793.0;1,65E+14
510343;201806;73;52;21;49598.46;20034.0;69632.46
510345;201806;159;106;53;101114.46;50256.92;151371.38
510350;201806;672;373;299;354900.06;285181.38;640081.44
510360;201806;199;117;82;111609.0;78145.92;189754.92
510370;201806;142;72;70;68659.38;66648.6;135307.98
510380;201806;90;63;27;60102.0;25749.0;85851.0
510385;201806;58;27;31;25758.0;29565.0;55323.0
510390;201806;122;52;70;49608.0;66741.84;116349.84
510395;201806;40;29;11;27666.0;10494.0;38160.0
510410;201806;706;471;235;449330.0;224166.69;673496.7
510420;201806;589;286;303;271898.8;287670.62;559569.44
510450;201806;52;30;22;28620.0;20988.0;49608.0
510452;201806;42;25;17;23850.0;16218.0;40068.0
510454;201806;59;26;33;24804.0;31472.46;56276.46
510455;201806;127;80;47;76300.92;44838.0;121138.92
510460;201806;186;100;86;95219.92;82006.38;177226.3
510480;201806;750;431;319;410047.8;303988.38;714036.2
510490;201806;359;184;175;175166.34;166464.16;341630.5
510500;201806;253;193;60;184112.45;57240.0;241352.45
510510;201806;796;456;340;434424.25;324350.47;758774.75
510515;201806;1151;614;537;585396.4;512251.38;1097647.8
510517;201806;247;105;142;99883.8;135444.69;235328.48
510520;201806;237;155;82;147776.77;77917.84;225694.6
510523;201806;93;66;27;62964.0;25748.46;88712.46
510525;201806;737;418;319;398017.84;304224.3;702242.1
510530;201806;15;11;4;10494.0;3816.0;14310.0
510550;201806;268;118;150;112563.0;143091.0;255654.0
510558;201806;270;134;136;127803.15;129715.92;257519.06
510560;201806;397;244;153;232490.0;145944.0;378434.0
510562;201806;636;446;190;424153.16;180773.45;604926.6
510590;201806;808;419;389;399669.84;371078.7;770748.5
510600;201806;259;142;117;135444.92;111580.92;247025.84
510610;201806;169;82;87;78208.92;82702.46;160911.38
510615;201806;198;83;115;79162.92;109710.0;188872.92
510617;201806;18;10;8;9540.0;7632.0;17172.0
510618;201806;117;54;63;51516.0;59625.0;111141.0
510619;201806;102;72;30;68679.0;28611.0;97290.0
510620;201806;183;101;82;96344.46;78228.0;174572.45
510621;201806;199;126;73;120185.46;69614.46;189799.92
510622;201806;453;291;162;277521.84;154224.38;431746.22
510623;201806;349;234;115;223179.84;109681.38;332861.22
510624;201806;88;44;44;41967.0;41976.0;83943.0
510625;201806;534;330;204;314619.3;194038.52;508657.8
510626;201806;106;68;38;64872.0;36252.0;101124.0
510627;201806;60;42;18;40068.0;17172.0;57240.0
510628;201806;164;100;64;95353.92;60998.76;156352.69
510629;201806;257;164;93;156456.0;87758.46;244214.45
510630;201806;467;237;230;226013.22;219073.95;445087.16
510631;201806;11;3;8;2862.0;7346.0;10208.0
510637;201806;343;192;151;182822.19;143916.84;326739.03
510642;201806;978;545;433;519588.2;412939.44;932527.6
510645;201806;0;0;0;0.0;0.0;0.0
510650;201806;1478;978;500;932867.94;476868.75;1409736.6
510665;201806;85;43;42;40966.0;40068.0;81034.0
510670;201806;65;37;28;35298.0;26712.0;62010.0
510675;201806;1166;700;466;667768.25;444541.22;1112309.5
510677;201806;356;175;181;165944.84;172544.22;338489.06
510680;201806;106;61;45;58176.0;42921.0;101097.0
510682;201806;200;96;104;91262.0;99216.0;190478.0
510685;201806;52;37;15;35298.0;14310.0;49608.0
510700;201806;620;359;261;342367.9;248860.77;591228.7
510704;201806;1081;585;496;555700.6;471608.38;1027309.0
510706;201806;129;64;65;61051.23;61972.92;123024.15
510710;201806;391;267;124;253728.23;118181.68;371909.9
510715;201806;65;47;18;44828.46;17172.0;62000.46
510718;201806;213;116;97;110570.76;92519.46;203090.22
510719;201806;36;19;17;18126.0;16218.0;34344.0
510720;201806;197;132;65;125919.0;61723.8;187642.8
510724;201806;90;36;54;34334.46;51483.38;85817.84
510726;201806;54;28;26;26702.46;24786.0;51488.46
510729;201806;75;34;41;32436.0;39075.84;71511.84
510730;201806;472;267;205;254700.0;195422.45;450122.47
510735;201806;109;42;67;40068.0;63918.0;103986.0
510740;201806;31;18;13;17172.0;12402.0;29574.0
510757;201806;20;16;4;15264.0;3816.0;19080.0
510760;201806;7050;3724;3326;3543147.2;3167723.0;6710870.5
510770;201806;715;341;374;325125.3;356601.3;681726.6
510774;201806;15;6;9;5724.0;8586.0;14310.0
510775;201806;112;84;28;80126.46;26702.46;106828.92
510776;201806;28;7;21;6678.0;20034.0;26712.0
510777;201806;185;81;104;77245.38;99187.38;176432.77
510779;201806;51;23;28;21933.0;26674.92;48607.92
510780;201806;294;165;129;157347.45;123001.0;280348.47
510785;201806;444;240;204;228903.3;194549.22;423452.53
510787;201806;191;96;95;91575.0;90612.23;182187.23
510788;201806;0;0;0;0.0;0.0;0.0
510790;201806;2418;1259;1159;1199205.4;1103668.8;2302874.2
510792;201806;1088;616;472;586881.5;449872.34;1036753.8
510794;201806;117;59;58;56286.0;55303.92;111589.92
510795;201806;2393;1387;1006;1316378.1;957060.8;2273439.0
510800;201806;187;113;74;107792.46;70587.0;178379.45
510805;201806;171;117;54;111618.0;51516.0;163134.0
510810;201806;97;40;57;38077.38;54253.98;92331.36
510820;201806;256;119;137;113099.46;129698.03;242797.48
510830;201806;66;40;26;38160.0;24795.0;62955.0
510835;201806;7;5;2;4770.0;1908.0;6678.0
510840;201806;9269;4574;4695;4348881.5;4471644.0;8820526.0
510850;201806;215;89;126;84896.46;120034.54;204931.0
510860;201806;384;167;217;159131.52;206346.88;365478.4
510880;201806;68;51;17;48635.46;16218.0;64853.46
510885;201806;71;43;28;41003.46;26683.38;67686.84
510890;201806;70;40;30;38160.0;28620.0;66780.0
510895;201806;184;108;76;103032.0;72195.46;175227.45
520005;201806;34;23;11;21942.0;10494.0;32436.0
520010;201806;275;122;153;116388.0;145867.0;262255.0
520013;201806;641;389;252;371078.0;240121.8;611199.8
520015;201806;51;37;14;35298.0;13356.0;48654.0
520017;201806;102;58;44;55046.0;41976.0;97022.0
520020;201806;25;13;12;12402.0;11448.0;23850.0
520025;201806;2008;1089;919;1037723.25;875286.4;1913009.6
520030;201806;792;408;384;388269.0;365715.9;753984.9
520050;201806;77;52;25;49608.0;23850.0;73458.0
520055;201806;44;30;14;28620.0;13356.0;41976.0
520060;201806;177;113;64;107802.0;61056.0;168858.0
520080;201806;600;421;179;401634.0;170766.0;572400.0
520082;201806;20;14;6;13356.0;5724.0;19080.0
520085;201806;102;74;28;70596.0;26712.0;97308.0
520090;201806;90;62;28;59148.0;26712.0;85860.0
520110;201806;9060;3937;5123;3750766.2;4884702.0;8635468.0
520120;201806;14;8;6;7431.66;5724.0;13155.66
520130;201806;765;531;234;506278.8;222941.0;729219.8
520140;201806;11744;6641;5103;6328261.5;4865900.0;1,12E+14
520145;201806;45;34;11;32436.0;10494.0;42930.0
520150;201806;189;147;42;140238.0;40068.0;180306.0
520160;201806;30;23;7;21942.0;6678.0;28620.0
520170;201806;231;143;88;136390.0;83915.0;220305.0
520180;201806;126;66;60;62964.0;57240.0;120204.0
520215;201806;220;135;85;128503.8;80803.8;209307.6
520235;201806;70;53;17;50562.0;16218.0;66780.0
520250;201806;134;80;54;76320.0;51229.8;127549.8
520260;201806;111;68;43;64872.0;40068.0;104940.0
520280;201806;46;32;14;29861.0;13356.0;43217.0
520310;201806;37;25;12;23850.0;11448.0;35298.0
520320;201806;167;106;61;101114.46;58194.0;159308.45
520330;201806;784;412;372;393002.47;354861.0;747863.44
520340;201806;348;197;151;187938.0;144035.45;331973.47
520350;201806;524;238;286;227052.0;272797.0;499849.0
520355;201806;86;51;35;48654.0;33390.0;82044.0
520357;201806;25;18;7;17172.0;6678.0;23850.0
520360;201806;0;0;0;0.0;0.0;0.0
520380;201806;141;72;69;68688.0;65826.0;134514.0
520390;201806;282;118;164;112095.0;156193.5;268288.5
520393;201806;14;11;3;10494.0;2862.0;13356.0
520396;201806;99;59;40;56286.0;38160.0;94446.0
520400;201806;222;131;91;123353.2;86814.0;210167.2
520410;201806;199;101;98;96345.0;93483.0;189828.0
520420;201806;22;15;7;14310.0;6678.0;20988.0
520425;201806;298;130;168;123067.0;159796.2;282863.2
520430;201806;462;239;223;227719.8;212686.0;440405.8
520440;201806;610;413;197;394002.0;187918.92;581920.94
520450;201806;1928;866;1062;825335.44;1012215.75;1837551.2
520455;201806;59;42;17;40068.0;16218.0;56286.0
520460;201806;32;16;16;15264.0;15264.0;30528.0
520465;201806;25;21;4;20034.0;3816.0;23850.0
520470;201806;419;257;162;244872.62;154548.0;399420.62
520480;201806;80;46;34;43884.0;32391.0;76275.0
520485;201806;123;42;81;40068.0;76988.0;117056.0
520490;201806;409;298;111;284107.97;105894.0;390001.97
520495;201806;172;105;67;100170.0;63918.0;164088.0
520500;201806;173;130;43;124020.0;41022.0;165042.0
520505;201806;176;90;86;85855.23;82044.0;167899.23
520510;201806;1766;875;891;831415.25;847786.56;1679201.9
520520;201806;34;27;7;25758.0;6678.0;32436.0
520530;201806;228;170;58;160456.12;55322.46;215778.58
520540;201806;526;353;173;335455.03;165042.0;500497.03
520545;201806;156;89;67;84906.0;63918.0;148824.0
520547;201806;54;30;24;28620.0;22896.0;51516.0
520549;201806;1133;551;582;525330.0;555110.0;1080440.0
520551;201806;296;154;142;146916.0;135182.0;282098.0
520552;201806;45;26;19;24804.0;18126.0;42930.0
520570;201806;16;9;7;8586.0;6678.0;15264.0
520580;201806;284;171;113;163124.45;107802.0;270926.47
520590;201806;164;101;63;96354.0;59815.8;156169.8
520620;201806;1175;550;625;523842.47;595668.25;1119510.8
520630;201806;43;26;17;24804.0;16218.0;41022.0
520640;201806;412;234;178;223236.0;169812.0;393048.0
520650;201806;60;40;20;38160.0;19080.0;57240.0
520660;201806;36;19;17;18117.0;16218.0;34335.0
520670;201806;34;29;5;27666.0;4770.0;32436.0
520680;201806;57;37;20;35298.0;19080.0;54378.0
520690;201806;33;10;23;9540.0;21913.92;31453.92
520710;201806;40;36;4;34344.0;3816.0;38160.0
520725;201806;198;127;71;121158.0;67734.0;188892.0
520735;201806;60;42;18;40068.0;17172.0;57240.0
520740;201806;407;201;206;191039.4;196515.0;387554.4
520750;201806;37;27;10;25758.0;9540.0;35298.0
520753;201806;55;37;18;35298.0;17172.0;52470.0
520760;201806;111;75;36;71550.0;34344.0;105894.0
520780;201806;289;219;70;208926.0;66780.0;275706.0
520790;201806;163;82;81;77941.8;77274.0;155215.8
520800;201806;3460;1845;1615;1757638.0;1540032.9;3297671.0
520810;201806;172;125;47;119250.0;44838.0;164088.0
520815;201806;5;5;0;4770.0;0.0;4770.0
520830;201806;138;92;46;87768.0;43597.8;131365.8
520840;201806;348;230;118;218943.0;112572.0;331515.0
520850;201806;113;72;41;68669.46;38961.36;107630.82
520860;201806;1687;1079;608;1027945.56;578888.2;1606833.8
520870;201806;30850;15192;15658;1,45E+14;1,49E+14;2,94E+14
520880;201806;1075;588;487;560952.0;464578.9;1025530.94
520890;201806;802;466;336;442933.4;320439.47;763372.9
520910;201806;1024;543;481;513777.94;458874.0;972651.94
520915;201806;102;77;25;73458.0;23840.46;97298.46
520920;201806;410;199;211;189273.6;201284.45;390558.06
520929;201806;16;15;1;14310.0;954.0;15264.0
520940;201806;75;48;27;45792.0;25758.0;71550.0
520945;201806;21;13;8;12402.0;7632.0;20034.0
520960;201806;45;29;16;27666.0;15264.0;42930.0
520970;201806;323;202;121;192079.0;115147.8;307226.8
520980;201806;84;64;20;61056.0;19080.0;80136.0
520990;201806;479;322;157;307188.0;149778.0;456966.0
520993;201806;129;62;67;59148.0;63918.0;123066.0
520995;201806;242;135;107;127837.0;101506.0;229343.0
521000;201806;1569;918;651;873769.6;620673.0;1494442.6
521010;201806;672;313;359;298275.38;342429.3;640704.7
521015;201806;17;10;7;9540.0;6678.0;16218.0
521020;201806;1461;1022;439;973691.1;418444.22;1392135.4
521030;201806;47;34;13;32436.0;12402.0;44838.0
521040;201806;942;579;363;552128.2;346016.0;898144.2
521056;201806;41;29;12;27666.0;11448.0;39114.0
521060;201806;132;83;49;79182.0;46746.0;125928.0
521080;201806;464;348;116;331983.0;110664.0;442647.0
521090;201806;529;319;210;302699.44;200340.0;503039.44
521100;201806;281;209;72;199377.0;68688.0;268065.0
521120;201806;1051;727;324;692985.8;308801.0;1001786.8
521130;201806;362;259;103;247076.45;97376.6;344453.06
521140;201806;186;106;80;101124.0;76320.0;177444.0
521150;201806;2800;1217;1583;1159436.9;1508887.5;2668324.2
521160;201806;32;16;16;15264.0;15264.0;30528.0
521170;201806;192;113;79;107792.46;75366.0;183158.45
521180;201806;1136;717;419;682387.25;399011.2;1081398.5
521190;201806;2534;1076;1458;1026484.94;1390054.8;2416539.8
521200;201806;47;34;13;32436.0;12402.0;44838.0
521205;201806;12;9;3;8586.0;2862.0;11448.0
521210;201806;145;83;62;79182.0;59148.0;138330.0
521220;201806;822;564;258;535423.75;246076.0;781499.75
521225;201806;32;21;11;20034.0;10494.0;30528.0
521230;201806;109;72;37;68401.8;35298.0;103699.8
521250;201806;6239;3583;2656;3411665.8;2531231.2;5942897.0
521260;201806;23;15;8;14310.0;7632.0;21942.0
521270;201806;142;110;32;104940.0;30528.0;135468.0
521280;201806;437;260;177;247372.2;168858.0;416230.2
521290;201806;32;12;20;11448.0;19080.0;30528.0
521295;201806;98;66;32;62735.04;30528.0;93263.04
521300;201806;225;115;110;109692.0;104589.38;214281.38
521305;201806;35;23;12;21942.0;11448.0;33390.0
521308;201806;1092;807;285;769627.7;271595.0;1041222.7
521310;201806;1353;797;556;759062.4;529232.94;1288295.4
521340;201806;18;15;3;14310.0;2862.0;17172.0
521350;201806;131;96;35;91584.0;33390.0;124974.0
521370;201806;189;123;66;117055.2;62677.8;179733.0
521375;201806;189;106;83;101124.0;78895.8;180019.8
521377;201806;52;35;17;33390.0;16218.0;49608.0
521380;201806;1101;718;383;680824.25;365382.0;1046206.25
521385;201806;15;8;7;7632.0;6678.0;14310.0
521390;201806;107;85;22;80772.04;20988.0;101760.04
521400;201806;325;208;117;198145.8;111570.3;309716.1
521405;201806;149;78;71;74412.0;67734.0;142146.0
521410;201806;63;42;21;40068.0;20034.0;60102.0
521440;201806;204;145;59;137519.1;56286.0;193805.1
521450;201806;719;396;323;377784.0;308142.0;685926.0
521460;201806;1190;735;455;700903.8;434050.9;1134954.8
521470;201806;14;9;5;8586.0;4770.0;13356.0
521480;201806;47;32;15;30501.0;14245.0;44746.0
521483;201806;315;171;144;162848.0;137376.0;300224.0
521486;201806;284;182;102;172836.19;96641.0;269477.2
521487;201806;21;10;11;9540.0;10494.0;20034.0
521490;201806;27;16;11;15264.0;10494.0;25758.0
521500;201806;120;78;42;74412.0;40068.0;114480.0
521520;201806;41;30;11;28620.0;10494.0;39114.0
521523;201806;616;380;236;359203.3;225144.0;584347.3
521525;201806;45;30;15;28620.0;14023.8;42643.8
521530;201806;248;132;116;125928.0;110664.0;236592.0
521540;201806;31;17;14;16218.0;13356.0;29574.0
521550;201806;90;42;48;39753.92;45736.92;85490.84
521560;201806;801;547;254;521552.0;242173.0;763725.0
521565;201806;53;36;17;34344.0;16218.0;50562.0
521570;201806;501;335;166;319580.47;158269.3;477849.75
521580;201806;60;37;23;35298.0;21942.0;57240.0
521590;201806;37;20;17;19080.0;16218.0;35298.0
521600;201806;28;16;12;15264.0;11448.0;26712.0
521630;201806;242;123;119;117332.46;112535.96;229868.42
521640;201806;302;154;148;146916.0;141192.0;288108.0
521645;201806;30;16;14;15264.0;13356.0;28620.0
521680;201806;222;141;81;134514.0;77274.0;211788.0
521690;201806;2;2;0;1908.0;0.0;1908.0
521710;201806;1191;557;634;530805.8;604540.8;1135346.6
521720;201806;540;367;173;350108.47;165004.45;515112.9
521730;201806;631;307;324;292878.0;307989.56;600867.56
521740;201806;917;372;545;354859.9;518739.3;873599.25
521760;201806;1623;895;728;852252.6;694198.0;1546450.6
521770;201806;808;513;295;489402.0;280962.53;770364.56
521800;201806;2069;1287;782;1223714.9;744476.7;1968191.5
521805;201806;34;19;15;18126.0;14310.0;32436.0
521810;201806;92;58;34;54187.8;32436.0;86623.8
521830;201806;957;679;278;645572.25;265203.0;910775.25
521839;201806;91;60;31;57240.0;29574.0;86814.0
521850;201806;1126;597;529;568118.94;504341.7;1072460.6
521860;201806;344;210;134;200340.0;127550.0;327890.0
521870;201806;73;42;31;40068.0;29574.0;69642.0
521878;201806;42;20;22;19080.0;20988.0;40068.0
521880;201806;4574;2063;2511;1965811.4;2393985.0;4359796.5
521890;201806;591;416;175;396864.0;166663.8;563527.8
521900;201806;293;236;57;224507.95;54378.0;278885.97
521910;201806;150;104;46;99216.0;43884.0;143100.0
521920;201806;54;27;27;25758.0;25758.0;51516.0
521925;201806;36;21;15;20034.0;14310.0;34344.0
521930;201806;1126;641;485;611318.0;461769.7;1073087.6
521935;201806;34;26;8;24804.0;7632.0;32436.0
521940;201806;191;96;95;91584.0;90625.23;182209.23
521945;201806;14;12;2;11448.0;1908.0;13356.0
521950;201806;9;5;4;4770.0;3816.0;8586.0
521960;201806;76;56;20;53424.0;19080.0;72504.0
521970;201806;420;269;151;256339.8;144054.0;400393.8
521971;201806;96;49;47;46746.0;44838.0;91584.0
521973;201806;28;13;15;12402.0;14310.0;26712.0
521975;201806;1160;588;572;560664.56;544772.7;1105437.2
521980;201806;243;167;76;159318.0;72504.0;231822.0
521990;201806;73;53;20;50562.0;19080.0;69642.0
522000;201806;286;180;106;171720.0;101124.0;272844.0
522005;201806;20;12;8;11448.0;7632.0;19080.0
522010;201806;1143;639;504;609597.0;480243.6;1089840.6
522015;201806;54;33;21;31473.0;20034.0;51507.0
522020;201806;859;464;395;441702.2;376048.12;817750.3
522026;201806;29;21;8;20034.0;7632.0;27666.0
522028;201806;16;12;4;11448.0;3816.0;15264.0
522040;201806;747;294;453;280458.0;432107.47;712565.44
522045;201806;2133;1352;781;1289058.2;744540.8;2033599.0
522050;201806;167;81;86;77274.0;82044.0;159318.0
522060;201806;558;351;207;334567.8;197382.6;531950.4
522068;201806;133;88;45;83665.8;42930.0;126595.8
522070;201806;11;11;0;10494.0;0.0;10494.0
522100;201806;47;26;21;24536.88;20034.0;44570.88
522108;201806;38;29;9;27666.0;8586.0;36252.0
522119;201806;55;29;26;27666.0;24804.0;52470.0
522130;201806;74;27;47;25749.0;44820.0;70569.0
522140;201806;3745;1896;1849;1804297.2;1761791.5;3566088.8
522145;201806;51;31;20;29574.0;19080.0;48654.0
522150;201806;65;51;14;48654.0;13356.0;62010.0
522155;201806;59;40;19;38151.0;18126.0;56277.0
522157;201806;4;3;1;2862.0;954.0;3816.0
522160;201806;1733;1011;722;963349.2;688492.8;1651842.0
522170;201806;392;263;129;250902.0;123066.0;373968.0
522180;201806;37;20;17;19080.0;16218.0;35298.0
522185;201806;1944;753;1191;715055.25;1135693.0;1850748.2
522190;201806;48;27;21;25758.0;19938.6;45696.6
522200;201806;295;178;117;169812.0;111618.0;281430.0
522205;201806;167;112;55;106848.0;52470.0;159318.0
522220;201806;162;116;46;110664.0;43884.0;154548.0
522230;201806;31;25;6;23850.0;5724.0;29574.0
530010;201806;55619;28556;27063;2,71E+13;2,58E+13;5,29E+13
110001;201807;522;412;110;392084.47;104294.96;496379.4
110002;201807;2781;1688;1093;1609083.9;1041824.5;2650908.2
110003;201807;95;75;20;71550.0;19080.0;90630.0
110004;201807;2011;1298;713;1235412.9;679906.25;1915319.1
110005;201807;442;354;88;336560.9;83952.0;420512.9
110006;201807;452;349;103;332659.8;98242.92;430902.72
110007;201807;82;65;17;62010.0;16218.0;78228.0
110008;201807;240;134;106;126600.9;101124.0;227724.9
110009;201807;797;549;248;521838.88;236393.0;758231.9
110010;201807;1815;1119;696;1066390.5;663680.2;1730070.8
110011;201807;1865;1441;424;1373203.2;404486.47;1777689.6
110012;201807;4134;2399;1735;2283265.2;1654099.1;3937364.5
110013;201807;767;587;180;559988.44;171720.0;731708.44
110014;201807;376;322;54;307188.0;51516.0;358704.0
110015;201807;1432;1157;275;1100759.1;262044.72;1362803.9
110018;201807;1114;667;447;636004.0;426425.22;1062429.2
110020;201807;15410;9039;6371;8578066.0;6068795.0;1,46E+14
110025;201807;655;484;171;459738.12;163125.0;622863.1
110026;201807;41;28;13;26712.0;12402.0;39114.0
110028;201807;1645;1194;451;1134474.6;426946.94;1561421.5
110029;201807;140;124;16;118296.0;15264.0;133560.0
110030;201807;2481;1676;805;1596160.8;767069.44;2363230.2
110032;201807;387;302;85;287799.0;81086.0;368885.0
110033;201807;680;506;174;479721.0;165709.8;645430.8
110034;201807;369;270;99;255268.0;93779.0;349047.0
110037;201807;104;87;17;82998.0;16218.0;99216.0
110040;201807;342;232;110;221328.0;104940.0;326268.0
110045;201807;949;642;307;610657.0;291174.38;901831.4
110050;201807;96;79;17;75366.0;16218.0;91584.0
110060;201807;86;46;40;43884.0;38160.0;82044.0
110070;201807;121;73;48;69642.0;45506.0;115148.0
110080;201807;406;247;159;233415.19;151662.16;385077.34
110090;201807;35;28;7;26712.0;6678.0;33390.0
110092;201807;109;61;48;58194.0;45722.0;103916.0
110094;201807;196;141;55;134514.0;52470.0;186984.0
110100;201807;29;23;6;21942.0;5724.0;27666.0
110110;201807;68;41;27;39114.0;25758.0;64872.0
110120;201807;72;59;13;56286.0;12402.0;68688.0
110130;201807;299;241;58;228439.12;55332.0;283771.12
110140;201807;243;158;85;150541.2;81080.46;231621.66
110143;201807;52;44;8;41976.0;7632.0;49608.0
110145;201807;26;20;6;19080.0;5724.0;24804.0
110146;201807;24;12;12;11448.0;11448.0;22896.0
110147;201807;38;30;8;28620.0;7632.0;36252.0
110148;201807;39;27;12;25706.57;11448.0;37154.57
110149;201807;297;213;84;202915.8;80136.0;283051.8
110150;201807;84;58;26;55332.0;24804.0;80136.0
110155;201807;8;7;1;6678.0;954.0;7632.0
110160;201807;70;59;11;56286.0;10494.0;66780.0
110170;201807;203;165;38;157410.0;36252.0;193662.0
110175;201807;43;31;12;29574.0;11448.0;41022.0
110180;201807;93;81;12;77274.0;11448.0;88722.0
120001;201807;136;93;43;88680.0;40993.0;129673.0
120005;201807;192;120;72;114437.12;68688.0;183125.12
120010;201807;1041;670;371;632488.56;352007.72;984496.25
120013;201807;146;102;44;97101.54;41785.2;138886.73
120017;201807;93;58;35;55245.36;33347.12;88592.48
120020;201807;3571;2854;717;2696224.8;681606.4;3377831.2
120025;201807;588;333;255;315208.1;242209.6;557417.7
120030;201807;1044;875;169;826742.3;160511.0;987253.3
120032;201807;49;41;8;39114.0;7632.0;46746.0
120033;201807;218;190;28;180912.75;26712.0;207624.75
120034;201807;156;113;43;105894.0;41000.12;146894.12
120035;201807;29;21;8;20034.0;7632.0;27666.0
120038;201807;387;250;137;237696.88;130654.24;368351.12
120039;201807;21;20;1;19080.0;954.0;20034.0
120040;201807;14095;9779;4316;9245060.0;4097297.8;1,33E+14
120042;201807;46;40;6;38160.0;5724.0;43884.0
120043;201807;12;3;9;2862.0;8586.0;11448.0
120045;201807;541;350;191;331991.78;180880.06;512871.84
120050;201807;1266;963;303;912282.06;289014.34;1201296.4
120060;201807;1422;1156;266;1098943.2;252810.0;1351753.2
120070;201807;503;359;144;339213.4;136957.78;476171.2
120080;201807;169;106;63;100441.42;59732.22;160173.64
130002;201807;150;105;45;100170.0;42930.0;143100.0
130006;201807;74;41;33;39114.0;31482.0;70596.0
130008;201807;142;77;65;72737.72;61331.72;134069.44
130010;201807;139;75;64;71528.12;61056.0;132584.12
130014;201807;247;178;69;169812.0;65826.0;235638.0
130020;201807;94;50;44;47700.0;41976.0;89676.0
130030;201807;900;550;350;524700.0;333890.47;858590.44
130040;201807;323;163;160;155502.0;151686.28;307188.28
130050;201807;567;309;258;294499.8;246132.0;540631.8
130060;201807;878;601;277;568226.2;261854.72;830080.94
130063;201807;577;322;255;307188.0;243204.36;550392.4
130068;201807;186;122;64;116388.0;60769.8;177157.8
130070;201807;1328;919;409;863114.6;385331.53;1248446.1
130080;201807;666;437;229;416516.4;218457.0;634973.4
130083;201807;71;38;33;35988.0;31482.0;67470.0
130090;201807;373;193;180;182442.95;171720.0;354162.97
130100;201807;1129;511;618;487494.0;589285.8;1076779.8
130110;201807;702;311;391;296544.0;373014.0;669558.0
130115;201807;175;72;103;68688.0;98262.0;166950.0
130120;201807;1630;1018;612;971172.0;583848.0;1555020.0
130130;201807;633;435;198;414990.0;188892.0;603882.0
130140;201807;1508;1136;372;1083102.9;353934.2;1437037.1
130150;201807;422;358;64;341532.0;61056.0;402588.0
130160;201807;465;262;203;249948.0;193662.0;443610.0
130165;201807;26;19;7;18126.0;6678.0;24804.0
130170;201807;926;659;267;628615.4;254718.0;883333.4
130180;201807;149;91;58;86814.0;55332.0;142146.0
130185;201807;2305;1208;1097;1150524.0;1045946.94;2196471.0
130190;201807;3628;2267;1361;2157250.5;1297092.0;3454342.5
130195;201807;290;232;58;221328.0;55332.0;276660.0
130200;201807;175;81;94;77264.46;89676.0;166940.45
130210;201807;78;40;38;38160.0;36252.0;74412.0
130220;201807;184;127;57;121158.0;54378.0;175536.0
130230;201807;332;208;124;198432.0;118296.0;316728.0
130240;201807;1440;913;527;869662.4;502180.84;1371843.2
130250;201807;4778;3091;1687;2941760.5;1609264.6;4551025.0
130255;201807;426;208;218;198432.0;207685.8;406117.8
130260;201807;54079;26029;28050;2,48E+14;2,68E+13;5,15E+14
130270;201807;1515;982;533;936351.0;508482.0;1444833.0
130280;201807;115;71;44;67734.0;41976.0;109710.0
130290;201807;2102;1523;579;1452942.0;552079.8;2005021.8
130300;201807;433;308;125;293545.8;119250.0;412795.8
130310;201807;883;460;423;438840.0;403542.0;842382.0
130320;201807;452;238;214;226098.0;204156.0;430254.0
130330;201807;702;422;280;402588.0;266833.8;669421.8
130340;201807;3322;1981;1341;1885581.4;1277597.0;3163178.5
130350;201807;467;300;167;286178.12;159318.0;445496.12
130353;201807;811;338;473;322166.0;451242.0;773408.0
130356;201807;794;363;431;346302.0;410887.8;757189.8
130360;201807;68;41;27;39114.0;25758.0;64872.0
130370;201807;684;509;175;485586.0;166950.0;652536.0
130380;201807;611;422;189;402588.0;180306.0;582894.0
130390;201807;490;389;101;371106.0;96354.0;467460.0
130395;201807;182;40;142;38160.0;135468.0;173628.0
130400;201807;70;45;25;42930.0;23850.0;66780.0
130406;201807;2085;1299;786;1235632.2;748612.75;1984245.0
130410;201807;501;214;287;204156.0;273778.9;477934.9
130420;201807;3176;2561;615;2439407.2;586710.0;3026117.2
130423;201807;161;74;87;70596.0;82998.0;153594.0
130426;201807;145;86;59;82044.0;56286.0;138330.0
130430;201807;406;270;136;257580.0;129744.0;387324.0
130440;201807;204;69;135;65826.0;128790.0;194616.0
140002;201807;35;14;21;13356.0;20034.0;33390.0
140005;201807;207;127;80;120919.5;76320.0;197239.5
140010;201807;10287;6934;3353;6578540.0;3196440.8;9774981.0
140015;201807;153;67;86;63918.0;82044.0;145962.0
140017;201807;118;79;39;75366.0;37206.0;112572.0
140020;201807;480;319;161;303372.0;153594.0;456966.0
140023;201807;32;18;14;16953.0;13356.0;30309.0
140028;201807;17;12;5;11448.0;4770.0;16218.0
140030;201807;350;251;99;239454.0;94446.0;333900.0
140040;201807;54;38;16;36252.0;15168.6;51420.6
140045;201807;246;113;133;107134.2;126882.0;234016.2
140047;201807;583;406;177;385312.38;168095.0;553407.4
140050;201807;150;97;53;91725.0;50562.0;142287.0
140060;201807;36;25;11;23115.42;10494.0;33609.42
140070;201807;32;29;3;27666.0;2862.0;30528.0
150010;201807;4710;2928;1782;2791404.5;1697528.2;4488932.5
150013;201807;151;106;45;101124.0;42930.0;144054.0
150020;201807;1054;568;486;541872.0;463644.0;1005516.0
150030;201807;718;294;424;280476.0;404496.0;684972.0
150034;201807;197;125;72;119250.0;68688.0;187938.0
150040;201807;1401;842;559;803268.0;533286.0;1336554.0
150050;201807;690;414;276;393954.8;263104.0;657058.8
150060;201807;4754;3079;1675;2934180.2;1597702.5;4531883.0
150070;201807;310;144;166;137376.0;158364.0;295740.0
150080;201807;14412;7269;7143;6924665.0;6807104.0;1,37E+14
150085;201807;397;248;149;236582.45;142146.0;378728.47
150090;201807;758;644;114;614376.0;108756.0;723132.0
150095;201807;348;216;132;205294.12;125107.56;330401.7
150100;201807;55;38;17;36252.0;16218.0;52470.0
150110;201807;171;82;89;78228.0;84906.0;163134.0
150120;201807;433;320;113;305280.0;107802.0;413082.0
150125;201807;55;23;32;21942.0;30528.0;52470.0
150130;201807;1910;1026;884;978804.0;843331.25;1822135.2
150140;201807;54282;25400;28882;2,42E+14;2,75E+14;5,17E+14
150145;201807;184;106;78;101124.0;74412.0;175536.0
150150;201807;2834;1296;1538;1236166.5;1463832.2;2699998.8
150157;201807;432;301;131;287154.0;124969.23;412123.22
150160;201807;121;97;24;92538.0;22896.0;115434.0
150170;201807;3654;2712;942;2586055.5;898381.8;3484437.2
150172;201807;326;223;103;212742.0;98262.0;311004.0
150175;201807;84;51;33;48654.0;31482.0;80136.0
150178;201807;762;513;249;488448.0;237546.0;725994.0
150180;201807;3079;1485;1594;1415879.6;1520361.4;2936241.0
150190;201807;331;213;118;203202.0;112572.0;315774.0
150195;201807;123;62;61;59148.0;58194.0;117342.0
150200;201807;200;96;104;91584.0;99216.0;190800.0
150210;201807;3166;2566;600;2446905.8;571394.5;3018300.2
150215;201807;515;335;180;319590.0;171434.0;491024.0
150220;201807;3856;2620;1236;2497920.8;1177026.4;3674947.0
150230;201807;1142;923;219;879962.06;208926.0;1088888.0
150240;201807;5794;3427;2367;3266202.8;2258109.0;5524311.5
150250;201807;33;16;17;15264.0;16218.0;31482.0
150260;201807;76;46;30;43884.0;28620.0;72504.0
150270;201807;2350;1535;815;1463384.4;776651.8;2240036.0
150275;201807;571;349;222;332946.0;211788.0;544734.0
150276;201807;112;49;63;46746.0;60102.0;106848.0
150277;201807;772;329;443;313847.47;422622.0;736469.44
150280;201807;339;209;130;199386.0;124020.0;323406.0
150285;201807;74;37;37;35298.0;35298.0;70596.0
150290;201807;967;592;375;564472.25;357464.0;921936.25
150293;201807;668;311;357;296684.47;340578.0;637262.44
150295;201807;472;215;257;205110.0;245025.44;450135.44
150300;201807;78;41;37;39114.0;35298.0;74412.0
150304;201807;147;100;47;95400.0;44838.0;140238.0
150307;201807;392;323;69;308142.0;65826.0;373968.0
150309;201807;562;411;151;392094.0;144054.0;536148.0
150310;201807;258;174;84;165996.0;80136.0;246132.0
150320;201807;1790;1240;550;1182678.6;524461.5;1707140.1
150330;201807;2065;1196;869;1140316.2;829026.0;1969342.2
150340;201807;201;136;65;129505.5;62010.0;191515.5
150345;201807;604;327;277;311776.75;264258.0;576034.75
150350;201807;410;321;89;303839.47;84906.0;388745.47
150360;201807;4569;2940;1629;2801169.5;1554056.5;4355226.0
150370;201807;764;541;223;515318.0;212446.8;727764.8
150375;201807;195;103;92;98262.0;87768.0;186030.0
150380;201807;1365;918;447;875772.0;426438.0;1302210.0
150390;201807;735;420;315;400676.0;300510.0;701186.0
150400;201807;104;86;18;82044.0;17172.0;99216.0
150405;201807;1244;819;425;780054.5;404877.6;1184932.1
150410;201807;137;90;47;85860.0;44838.0;130698.0
150420;201807;7429;4087;3342;3897625.2;3186596.2;7084221.5
150430;201807;508;341;167;325314.0;159318.0;484632.0
150440;201807;584;348;236;331229.0;225144.0;556373.0
150442;201807;2180;1180;1000;1121656.1;953709.0;2075365.1
150445;201807;524;336;188;320544.0;178398.0;498942.0
150450;201807;270;135;135;128790.0;128790.0;257580.0
150460;201807;761;576;185;547677.06;176470.92;724148.0
150470;201807;1332;808;524;769305.8;499896.0;1269201.8
150475;201807;42;32;10;30528.0;9540.0;40068.0
150480;201807;1255;874;381;833796.0;363187.8;1196983.8
150490;201807;607;333;274;317682.0;261396.0;579078.0
150495;201807;331;235;96;224190.0;91584.0;315774.0
150497;201807;301;207;94;197478.0;89666.46;287144.47
150500;201807;424;288;136;274752.0;129744.0;404496.0
150503;201807;896;438;458;417566.0;436914.0;854480.0
150506;201807;1020;672;348;641088.0;331982.47;973070.44
150510;201807;1236;696;540;663698.0;515160.0;1178858.0
150520;201807;273;183;90;174582.0;85860.0;260442.0
150530;201807;1585;864;721;821108.3;687834.0;1508942.2
150540;201807;239;167;72;159318.0;68688.0;228006.0
150543;201807;731;417;314;397226.53;299269.8;696496.3
150548;201807;493;344;149;328176.0;142146.0;470322.0
150549;201807;62;45;17;42930.0;16218.0;59148.0
150550;201807;2870;1511;1359;1439841.0;1296200.0;2736041.0
150553;201807;3149;1859;1290;1771674.6;1230650.5;3002325.0
150555;201807;145;77;68;73458.0;64872.0;138330.0
150560;201807;55;42;13;40068.0;12402.0;52470.0
150563;201807;75;41;34;39114.0;32436.0;71550.0
150565;201807;169;101;68;96354.0;64872.0;161226.0
150570;201807;406;269;137;256606.92;130698.0;387304.9
150580;201807;1569;694;875;661694.4;834750.0;1496444.4
150590;201807;793;493;300;470322.0;286200.0;756522.0
150600;201807;464;281;183;268074.0;174582.0;442656.0
150610;201807;144;123;21;116493.0;20034.0;136527.0
150611;201807;129;91;38;86814.0;36252.0;123066.0
150613;201807;3234;1993;1241;1901322.0;1183905.0;3085227.0
150616;201807;495;300;195;285962.0;186030.0;471992.0
150618;201807;1204;650;554;619871.56;528516.0;1148387.6
150619;201807;400;307;93;292878.0;88722.0;381600.0
150620;201807;1278;745;533;710730.0;508195.8;1218925.8
150630;201807;302;201;101;191754.0;96354.0;288108.0
150635;201807;488;205;283;195570.0;269982.0;465552.0
150640;201807;61;28;33;26712.0;31482.0;58194.0
150650;201807;2327;1381;946;1317150.4;902193.8;2219344.2
150655;201807;244;182;62;173628.0;59148.0;232776.0
150658;201807;107;61;46;58194.0;43884.0;102078.0
150660;201807;494;346;148;330084.0;141192.0;471276.0
150670;201807;1018;375;643;357454.8;613403.44;970858.25
150680;201807;9900;5435;4465;5177533.0;4257560.5;9435093.0
150690;201807;51;32;19;30528.0;18126.0;48654.0
150700;201807;530;341;189;325123.2;180306.0;505429.2
150710;201807;279;165;114;157410.0;108756.0;266166.0
150715;201807;860;524;336;498913.9;320515.38;819429.3
150720;201807;430;333;97;317682.0;92251.8;409933.8
150730;201807;941;502;439;478899.0;418519.8;897418.8
150740;201807;226;160;66;152640.0;62964.0;215604.0
150745;201807;786;431;355;411174.0;338670.0;749844.0
150746;201807;54;33;21;31482.0;20034.0;51516.0
150747;201807;259;205;54;195570.0;51516.0;247086.0
150750;201807;133;76;57;72504.0;54378.0;126882.0
150760;201807;1733;1135;598;1082790.0;570492.0;1653282.0
150770;201807;368;193;175;184122.0;166774.95;350896.94
150775;201807;96;44;52;41976.0;49608.0;91584.0
150780;201807;190;100;90;95400.0;85860.0;181260.0
150790;201807;870;472;398;450288.0;379692.0;829980.0
150795;201807;1465;855;610;815670.0;581940.0;1397610.0
150796;201807;387;224;163;213696.0;155502.0;369198.0
150797;201807;284;162;122;154548.0;116388.0;270936.0
150800;201807;1414;856;558;815665.25;532332.0;1347997.2
150803;201807;588;487;101;464598.0;96354.0;560952.0
150805;201807;187;120;67;114480.0;63904.46;178384.45
150808;201807;999;551;448;525654.0;427392.0;953046.0
150810;201807;3397;2355;1042;2243513.2;993181.2;3236694.5
150812;201807;428;228;200;217512.0;190800.0;408312.0
150815;201807;971;640;331;609181.5;315774.0;924955.5
150820;201807;1572;965;607;919656.0;579058.94;1498714.9
150830;201807;825;579;246;551412.0;234684.0;786096.0
150835;201807;187;111;76;105894.0;72504.0;178398.0
150840;201807;1342;860;482;820440.0;459828.0;1280268.0
160005;201807;50;29;21;27666.0;20034.0;47700.0
160010;201807;198;126;72;120204.0;68684.0;188888.0
160015;201807;114;66;48;62964.0;45792.0;108756.0
160020;201807;126;71;55;67734.0;52470.0;120204.0
160021;201807;43;23;20;21942.0;19080.0;41022.0
160023;201807;115;69;46;65826.0;43884.0;109710.0
160025;201807;31;14;17;13356.0;16218.0;29574.0
160027;201807;1471;833;638;792106.7;607898.0;1400004.8
160030;201807;15555;8012;7543;7635643.0;7190997.5;1,48E+13
160040;201807;314;182;132;173628.0;125928.0;299556.0
160050;201807;679;341;338;325314.0;322452.0;647766.0
160053;201807;323;185;138;176204.0;131652.0;307856.0
160055;201807;25;18;7;17172.0;6678.0;23850.0
160060;201807;6473;3408;3065;3240450.5;2923052.2;6163503.0
160070;201807;166;102;64;97308.0;61056.0;158364.0
160080;201807;82;45;37;42930.0;35298.0;78228.0
170025;201807;24;15;9;14310.0;8586.0;22896.0
170030;201807;230;187;43;178201.0;41022.0;219223.0
170035;201807;225;107;118;102078.0;112572.0;214650.0
170040;201807;188;144;44;137089.8;41976.0;179065.8
170070;201807;324;195;129;186030.0;123066.0;309096.0
170100;201807;368;267;101;254718.0;96354.0;351072.0
170105;201807;62;51;11;48654.0;10494.0;59148.0
170110;201807;104;64;40;61056.0;38160.0;99216.0
170130;201807;66;32;34;30528.0;32150.0;62678.0
170190;201807;100;65;35;62010.0;33390.0;95400.0
170200;201807;391;263;128;250225.2;122007.76;372232.97
170210;201807;5999;3159;2840;3005876.8;2707043.8;5712920.5
170215;201807;99;46;53;43884.0;50562.0;94446.0
170220;201807;1410;1042;368;993781.8;350786.0;1344567.8
170230;201807;154;101;53;96354.0;50562.0;146916.0
170240;201807;539;357;182;340578.0;173628.0;514206.0
170255;201807;1104;885;219;844080.1;208639.8;1052719.9
170270;201807;38;28;10;26712.0;9349.2;36061.2
170290;201807;86;65;21;62010.0;20034.0;82044.0
170300;201807;85;57;28;53614.8;26712.0;80326.8
170305;201807;47;36;11;34344.0;10494.0;44838.0
170307;201807;65;49;16;46746.0;15264.0;62010.0
170310;201807;103;56;47;53424.0;44838.0;98262.0
170320;201807;21;17;4;16218.0;3816.0;20034.0
170330;201807;23;21;2;20034.0;1908.0;21942.0
170360;201807;23;13;10;12402.0;9540.0;21942.0
170370;201807;120;63;57;60102.0;54378.0;114480.0
170380;201807;83;61;22;58194.0;20988.0;79182.0
170382;201807;45;40;5;38160.0;4770.0;42930.0
170384;201807;136;101;35;96354.0;33390.0;129744.0
170386;201807;62;27;35;25758.0;33390.0;59148.0
170388;201807;49;19;30;18126.0;28620.0;46746.0
170389;201807;22;18;4;17172.0;3816.0;20988.0
170390;201807;57;33;24;31482.0;22896.0;54378.0
170410;201807;35;24;11;22896.0;10494.0;33390.0
170460;201807;17;13;4;12402.0;3816.0;16218.0
170510;201807;29;22;7;20988.0;6678.0;27666.0
170550;201807;1510;871;639;830934.0;608843.0;1439777.0
170555;201807;112;78;34;74412.0;32436.0;106848.0
170560;201807;98;72;26;68688.0;24804.0;93492.0
170600;201807;39;19;20;18126.0;19080.0;37206.0
170610;201807;189;100;89;95242.59;84418.0;179660.6
170625;201807;38;20;18;19080.0;17172.0;36252.0
170650;201807;82;62;20;59148.0;19080.0;78228.0
170700;201807;559;426;133;404575.5;126595.8;531171.3
170710;201807;159;98;61;93492.0;58185.0;151677.0
170720;201807;83;67;16;63918.0;15264.0;79182.0
170730;201807;62;37;25;35298.0;23850.0;59148.0
170740;201807;78;57;21;54378.0;20034.0;74412.0
170755;201807;69;36;33;34344.0;31482.0;65826.0
170765;201807;139;68;71;64586.0;67734.0;132320.0
170770;201807;224;132;92;124830.9;87768.0;212598.9
170820;201807;593;387;206;369198.0;196095.0;565293.0
170825;201807;32;20;12;19080.0;11448.0;30528.0
170830;201807;80;61;19;58003.2;18126.0;76129.2
170900;201807;198;151;47;144054.0;44838.0;188892.0
170930;201807;821;430;391;409896.0;372442.0;782338.0
170950;201807;3027;1319;1708;1257354.2;1627315.2;2884669.5
170980;201807;18;10;8;9540.0;7632.0;17172.0
171050;201807;136;106;30;101124.0;28620.0;129744.0
171070;201807;38;31;7;29574.0;6678.0;36252.0
171090;201807;41;30;11;28620.0;10494.0;39114.0
171110;201807;20;13;7;12402.0;6678.0;19080.0
171150;201807;40;19;21;18126.0;20034.0;38160.0
171180;201807;22;10;12;9540.0;11448.0;20988.0
171190;201807;140;81;59;77274.0;56286.0;133560.0
171195;201807;65;50;15;47700.0;14310.0;62010.0
171200;201807;46;19;27;18126.0;25758.0;43884.0
171215;201807;3;3;0;2862.0;0.0;2862.0
171240;201807;55;45;10;42930.0;9540.0;52470.0
171245;201807;56;51;5;48654.0;4770.0;53424.0
171250;201807;70;37;33;35298.0;31472.46;66770.46
171270;201807;17;13;4;12402.0;3816.0;16218.0
171280;201807;39;36;3;34201.0;2862.0;37063.0
171320;201807;993;564;429;538056.0;407086.44;945142.44
171330;201807;423;205;218;195570.0;207972.0;403542.0
171360;201807;90;65;25;62010.0;23850.0;85860.0
171370;201807;24;13;11;12402.0;10494.0;22896.0
171380;201807;136;110;26;104940.0;24804.0;129744.0
171395;201807;55;34;21;32436.0;20034.0;52470.0
171420;201807;306;201;105;191754.0;99883.8;291637.8
171430;201807;66;53;13;50562.0;12402.0;62964.0
171488;201807;198;106;92;101124.0;87768.0;188892.0
171500;201807;58;32;26;30528.0;24804.0;55332.0
171510;201807;68;45;23;42930.0;21942.0;64872.0
171515;201807;42;35;7;33390.0;6392.0;39782.0
171525;201807;31;27;4;25758.0;3816.0;29574.0
171550;201807;12;7;5;6678.0;4770.0;11448.0
171570;201807;59;30;29;28620.0;27666.0;56286.0
171575;201807;336;210;126;200340.0;120194.46;320534.47
171610;201807;1708;863;845;821403.0;804581.7;1625984.6
171620;201807;135;94;41;89122.68;39114.0;128236.68
171630;201807;50;27;23;25758.0;21942.0;47700.0
171650;201807;271;179;92;170766.0;87768.0;258534.0
171660;201807;267;143;124;136422.0;118292.0;254714.0
171665;201807;49;33;16;31482.0;15264.0;46746.0
171670;201807;432;251;181;236538.69;172387.8;408926.47
171700;201807;64;56;8;53424.0;7632.0;61056.0
171720;201807;25;9;16;8586.0;15264.0;23850.0
171750;201807;105;57;48;54378.0;45792.0;100170.0
171780;201807;74;59;15;56286.0;14310.0;70596.0
171790;201807;76;64;12;61056.0;11448.0;72504.0
171800;201807;36;28;8;26712.0;7632.0;34344.0
171820;201807;2065;1169;896;1112850.8;850176.8;1963027.5
171830;201807;38;31;7;29574.0;6678.0;36252.0
171840;201807;66;39;27;37206.0;25758.0;62964.0
171845;201807;33;20;13;19080.0;12402.0;31482.0
171850;201807;41;30;11;28620.0;10494.0;39114.0
171855;201807;78;61;17;58194.0;16218.0;74412.0
171865;201807;9;8;1;7632.0;954.0;8586.0
171870;201807;31;22;9;20988.0;8586.0;29574.0
171875;201807;79;54;25;51516.0;23850.0;75366.0
171880;201807;28;20;8;19080.0;7632.0;26712.0
171884;201807;47;24;23;22896.0;21942.0;44838.0
171886;201807;121;46;75;43884.0;71263.8;115147.8
171888;201807;24;18;6;17172.0;5724.0;22896.0
171889;201807;19;15;4;14310.0;3816.0;18126.0
171890;201807;57;47;10;44838.0;9540.0;54378.0
171900;201807;43;30;13;28620.0;12402.0;41022.0
172000;201807;38;33;5;31482.0;4770.0;36252.0
172010;201807;41;35;6;32579.1;5724.0;38303.1
172015;201807;25;16;9;15264.0;8299.8;23563.8
172020;201807;132;84;48;80136.0;45792.0;125928.0
172025;201807;32;21;11;20034.0;10494.0;30528.0
172030;201807;35;20;15;19080.0;14310.0;33390.0
172049;201807;72;44;28;41976.0;26712.0;68688.0
172065;201807;146;93;53;88672.0;50562.0;139234.0
172080;201807;90;64;26;59873.84;24804.0;84677.84
172085;201807;25;12;13;11448.0;12402.0;23850.0
172090;201807;409;313;96;298602.0;90821.0;389423.0
172093;201807;24;18;6;17172.0;5724.0;22896.0
172097;201807;16;8;8;7632.0;7346.0;14978.0
172100;201807;4753;2682;2071;2553429.8;1972597.2;4526027.0
172110;201807;81;54;27;51516.0;25758.0;77274.0
172120;201807;1708;1467;241;1393401.6;229511.5;1622913.1
172125;201807;4;4;0;3816.0;0.0;3816.0
172130;201807;17;13;4;12402.0;3816.0;16218.0
172208;201807;192;122;70;116388.0;66780.0;183168.0
172210;201807;412;199;213;189846.0;202916.0;392762.0
210005;201807;2961;1837;1124;1749445.2;1069150.0;2818595.2
210010;201807;187;96;91;91584.0;86814.0;178398.0
210015;201807;31;21;10;20034.0;9540.0;29574.0
210020;201807;345;184;161;175536.0;153594.0;329130.0
210030;201807;348;219;129;208926.0;123057.0;331983.0
210040;201807;151;117;34;111618.0;32436.0;144054.0
210043;201807;264;180;84;171720.0;80136.0;251856.0
210047;201807;596;319;277;303944.4;264248.47;568192.9
210050;201807;299;217;82;207018.0;78228.0;285246.0
210055;201807;43;33;10;31482.0;9540.0;41022.0
210060;201807;558;442;116;421568.78;110664.0;532232.8
210070;201807;415;307;108;292878.0;103032.0;395910.0
210080;201807;103;94;9;89676.0;8586.0;98262.0
210083;201807;308;135;173;128790.0;165042.0;293832.0
210087;201807;43;32;11;29726.64;10494.0;40220.64
210090;201807;489;339;150;323406.0;143100.0;466506.0
210095;201807;484;354;130;337706.47;124020.0;461726.47
210100;201807;697;531;166;506240.1;157410.02;663650.1
210110;201807;146;81;65;77274.0;62010.0;139284.0
210120;201807;5441;4108;1333;3912113.0;1270428.6;5182541.5
210125;201807;213;123;90;117342.0;85860.0;203202.0
210130;201807;541;286;255;271890.0;243250.92;515140.9
210135;201807;34;20;14;19080.0;13356.0;32436.0
210140;201807;4411;3462;949;3299810.8;905108.0;4204919.0
210150;201807;362;229;133;218466.0;126882.0;345348.0
210160;201807;3392;2853;539;2718902.8;513920.0;3232822.8
210170;201807;1153;904;249;862416.0;237546.0;1099962.0
210173;201807;124;103;21;98262.0;20034.0;118296.0
210177;201807;450;222;228;211788.0;217512.0;429300.0
210180;201807;33;17;16;16218.0;15264.0;31482.0
210190;201807;420;270;150;257580.0;143100.0;400680.0
210193;201807;1;1;0;954.0;0.0;954.0
210197;201807;80;53;27;50562.0;25739.88;76301.88
210200;201807;640;507;133;483239.16;126882.0;610121.2
210203;201807;259;174;85;165996.0;81090.0;247086.0
210207;201807;387;301;86;287154.0;82044.0;369198.0
210210;201807;778;710;68;677340.0;64872.0;742212.0
210215;201807;80;68;12;64872.0;11448.0;76320.0
210220;201807;394;325;69;310050.0;65539.8;375589.8
210230;201807;309;236;73;225144.0;69642.0;294786.0
210232;201807;1480;947;533;903152.0;508473.0;1411625.0
210235;201807;159;125;34;119060.0;32436.0;151496.0
210237;201807;45;24;21;22896.0;20034.0;42930.0
210240;201807;92;75;17;71550.0;16218.0;87768.0
210250;201807;185;149;36;142146.0;34344.0;176490.0
210255;201807;347;257;90;245178.0;85860.0;331038.0
210260;201807;418;267;151;254718.0;144054.0;398772.0
210270;201807;695;444;251;423576.0;239454.0;663030.0
210275;201807;49;37;12;35298.0;11448.0;46746.0
210280;201807;1046;676;370;642089.3;351644.5;993733.8
210290;201807;504;333;171;317682.0;163134.0;480816.0
210300;201807;6052;3545;2507;3377961.0;2390486.2;5768447.5
210310;201807;106;72;34;68688.0;32436.0;101124.0
210312;201807;124;81;43;77274.0;41022.0;118296.0
210315;201807;115;87;28;82998.0;26712.0;109710.0
210317;201807;125;87;38;82998.0;36252.0;119250.0
210320;201807;2384;1964;420;1871945.9;400680.0;2272625.8
210325;201807;128;89;39;83952.0;36920.0;120872.0
210330;201807;5431;2821;2610;2686697.8;2489930.5;5176628.5
210340;201807;1385;997;388;950338.0;370081.06;1320419.1
210350;201807;616;508;108;484393.5;103032.0;587425.5
210355;201807;137;110;27;104940.0;25758.0;130698.0
210360;201807;2625;1653;972;1573815.6;927002.0;2500817.5
210370;201807;1237;550;687;524700.0;655398.0;1180098.0
210375;201807;189;98;91;92949.0;86814.0;179763.0
210380;201807;734;548;186;522792.0;177444.0;700236.0
210390;201807;207;171;36;163134.0;34344.0;197478.0
210400;201807;424;357;67;340578.0;63899.0;404477.0
210405;201807;1018;690;328;658260.0;312912.0;971172.0
210407;201807;54;43;11;41022.0;10494.0;51516.0
210408;201807;64;57;7;54378.0;6678.0;61056.0
210409;201807;322;269;53;256626.0;50562.0;307188.0
210410;201807;440;341;99;325314.0;94437.0;419751.0
210420;201807;193;158;35;150732.0;33390.0;184122.0
210430;201807;37;27;10;25758.0;9540.0;35298.0
210440;201807;373;227;146;216558.0;139284.0;355842.0
210450;201807;150;112;38;106848.0;36252.0;143100.0
210455;201807;222;121;101;115434.0;96354.0;211788.0
210460;201807;344;218;126;207972.0;120204.0;328176.0
210462;201807;64;54;10;51516.0;9540.0;61056.0
210465;201807;174;126;48;120204.0;45792.0;165996.0
210467;201807;535;383;152;365382.0;145008.0;510390.0
210470;201807;45;35;10;33390.0;9540.0;42930.0
210480;201807;1318;936;382;892944.0;364428.0;1257372.0
210490;201807;222;136;86;129744.0;82044.0;211788.0
210500;201807;581;310;271;295740.0;258534.0;554274.0
210510;201807;556;430;126;410220.0;120204.0;530424.0
210515;201807;436;241;195;229914.0;186030.0;415944.0
210520;201807;407;356;51;339337.8;48654.0;387991.8
210530;201807;9453;5059;4394;4813065.5;4184404.2;8997470.0
210535;201807;131;93;38;88722.0;36252.0;124974.0
210540;201807;1548;946;602;901339.8;572877.0;1474216.8
210542;201807;1183;590;593;562478.4;565436.0;1127914.4
210545;201807;12;11;1;10494.0;954.0;11448.0
210547;201807;132;113;19;107802.0;18126.0;125928.0
210550;201807;742;523;219;497394.0;208926.0;706320.0
210560;201807;178;149;29;142146.0;27666.0;169812.0
210565;201807;30;22;8;20988.0;7632.0;28620.0
210570;201807;1372;1078;294;1027172.25;280476.0;1307648.2
210580;201807;110;96;14;91584.0;13356.0;104940.0
210590;201807;773;614;159;584992.8;151686.0;736678.8
210592;201807;31;27;4;25758.0;3816.0;29574.0
210594;201807;105;86;19;82044.0;18126.0;100170.0
210596;201807;90;75;15;71550.0;14310.0;85860.0
210598;201807;125;91;34;86814.0;32436.0;119250.0
210600;201807;333;281;52;268074.0;49608.0;317682.0
210610;201807;253;234;19;222282.0;18126.0;240408.0
210620;201807;47;27;20;25758.0;19080.0;44838.0
210630;201807;61;59;2;56286.0;1908.0;58194.0
210632;201807;1097;730;367;696420.0;349641.0;1046061.0
210635;201807;18;15;3;14310.0;2862.0;17172.0
210637;201807;105;73;32;69642.0;30528.0;100170.0
210640;201807;592;519;73;495126.0;69642.0;564768.0
210650;201807;413;332;81;315802.62;76320.0;392122.62
210660;201807;404;293;111;278855.0;105770.0;384625.0
210663;201807;19;11;8;10494.0;7632.0;18126.0
210667;201807;113;35;78;33390.0;74412.0;107802.0
210670;201807;267;235;32;223475.0;30528.0;254003.0
210675;201807;573;300;273;286200.0;260442.0;546642.0
210680;201807;210;132;78;125928.0;74412.0;200340.0
210690;201807;647;512;135;488448.0;128790.0;617238.0
210700;201807;191;141;50;134514.0;47700.0;182214.0
210710;201807;297;169;128;161035.2;122112.0;283147.2
210720;201807;129;108;21;103032.0;20034.0;123066.0
210725;201807;71;62;9;59148.0;8586.0;67734.0
210730;201807;25;18;7;17172.0;6678.0;23850.0
210735;201807;415;278;137;265212.0;130412.0;395624.0
210740;201807;554;466;88;444564.0;83952.0;528516.0
210745;201807;156;114;42;108756.0;40068.0;148824.0
210750;201807;2423;1094;1329;1041721.0;1267846.9;2309568.0
210760;201807;270;199;71;189846.0;67719.69;257565.69
210770;201807;405;312;93;297648.0;88435.8;386083.8
210780;201807;424;307;117;292878.0;111618.0;404496.0
210790;201807;189;146;43;139284.0;41022.0;180306.0
210800;201807;149;110;39;104940.0;37206.0;142146.0
210805;201807;45;41;4;39114.0;3816.0;42930.0
210810;201807;492;378;114;359944.2;108756.0;468700.2
210820;201807;2321;1840;481;1746915.4;458874.0;2205789.5
210825;201807;172;89;83;84906.0;79182.0;164088.0
210830;201807;799;492;307;468414.0;291924.0;760338.0
210840;201807;211;143;68;136422.0;64872.0;201294.0
210845;201807;251;159;92;151686.0;87768.0;239454.0
210850;201807;846;537;309;512298.0;294786.0;807084.0
210860;201807;4134;2143;1991;2042896.2;1899108.8;3942005.0
210870;201807;475;358;117;341532.0;111618.0;453150.0
210880;201807;62;44;18;41976.0;17172.0;59148.0
210890;201807;348;290;58;276660.0;55332.0;331992.0
210900;201807;585;380;205;362516.0;195570.0;558086.0
210905;201807;69;35;34;33390.0;32436.0;65826.0
210910;201807;2009;1486;523;1416354.0;498942.0;1915296.0
210920;201807;227;69;158;65826.0;150732.0;216558.0
210923;201807;80;58;22;55332.0;20988.0;76320.0
210927;201807;436;183;253;174582.0;241362.0;415944.0
210930;201807;63;49;14;46746.0;13356.0;60102.0
210940;201807;94;71;23;67734.0;21942.0;89676.0
210945;201807;197;92;105;87768.0;100170.0;187938.0
210950;201807;523;378;145;360612.0;138325.23;498937.22
210955;201807;75;50;25;47700.0;23850.0;71550.0
210960;201807;2442;1050;1392;1000078.4;1327682.0;2327760.5
210970;201807;116;100;16;95400.0;15264.0;110664.0
210975;201807;92;83;9;79182.0;8586.0;87768.0
210980;201807;1221;535;686;510275.53;654158.0;1164433.5
210990;201807;4352;2716;1636;2589963.2;1560744.0;4150707.2
211000;201807;1375;1089;286;1038620.0;272557.8;1311177.8
211003;201807;926;633;293;603882.0;279513.0;883395.0
211010;201807;492;433;59;413082.0;56286.0;469368.0
211020;201807;1614;591;1023;563814.0;975722.56;1539536.6
211023;201807;28;24;4;22609.8;3816.0;26425.8
211027;201807;66;44;22;41976.0;20988.0;62964.0
211030;201807;383;258;125;246132.0;119250.0;365382.0
211040;201807;323;249;74;237260.0;70596.0;307856.0
211050;201807;1185;759;426;724066.94;406113.22;1130180.1
211060;201807;691;584;107;555228.0;102078.0;657306.0
211065;201807;22;18;4;17172.0;3816.0;20988.0
211070;201807;928;754;174;717704.75;165996.0;883700.75
211080;201807;87;83;4;79182.0;3816.0;82998.0
211085;201807;60;32;28;30242.0;26712.0;56954.0
211090;201807;91;73;18;69642.0;17172.0;86814.0
211100;201807;506;405;101;386083.8;96354.0;482437.8
211102;201807;262;176;86;167904.0;82044.0;249948.0
211105;201807;220;149;71;142146.0;67734.0;209880.0
211107;201807;136;78;58;74412.0;55332.0;129744.0
211110;201807;825;529;296;504094.0;282375.0;786469.0
211120;201807;5784;2487;3297;2366934.2;3144246.2;5511180.5
211125;201807;34;27;7;25758.0;6678.0;32436.0
211130;201807;45822;19364;26458;1,84E+14;2,52E+14;4,37E+14
211140;201807;428;362;66;344390.0;62964.0;407354.0
211150;201807;1292;823;469;784808.1;447136.0;1231944.1
211153;201807;167;99;68;94446.0;64872.0;159318.0
211157;201807;63;49;14;46746.0;13356.0;60102.0
211160;201807;711;591;120;563098.5;114480.0;677578.5
211163;201807;0;0;0;0.0;0.0;0.0
211167;201807;10;8;2;7632.0;1908.0;9540.0
211170;201807;447;311;136;296694.0;129744.0;426438.0
211172;201807;122;85;37;81090.0;35298.0;116388.0
211174;201807;270;161;109;153594.0;103986.0;257580.0
211176;201807;515;373;142;355842.0;135468.0;491310.0
211178;201807;96;62;34;59148.0;32436.0;91584.0
211180;201807;209;163;46;155502.0;43721.82;199223.81
211190;201807;67;61;6;58194.0;5724.0;63918.0
211195;201807;29;19;10;18126.0;9540.0;27666.0
211200;201807;156;136;20;129400.56;19080.0;148480.56
211210;201807;527;330;197;314152.2;187938.0;502090.2
211220;201807;4027;2270;1757;2157737.5;1669841.0;3827578.5
211223;201807;96;91;5;86632.74;4770.0;91402.74
211227;201807;68;48;20;45792.0;19080.0;64872.0
211230;201807;779;636;143;606744.0;136402.92;743146.94
211240;201807;415;313;102;298602.0;97308.0;395910.0
211245;201807;203;91;112;86814.0;106848.0;193662.0
211250;201807;1647;1408;239;1342240.1;228006.0;1570246.1
211260;201807;826;651;175;621054.0;166950.0;788004.0
211270;201807;2071;1635;436;1559790.0;414990.2;1974780.2
211280;201807;1851;1114;737;1061802.8;703098.0;1764900.8
211285;201807;206;121;85;115434.0;81090.0;196524.0
211290;201807;692;465;227;443419.2;216558.0;659977.2
211300;201807;813;625;188;595972.06;179352.0;775324.06
211400;201807;1600;911;689;869094.0;657306.0;1526400.0
220005;201807;18;17;1;16218.0;954.0;17172.0
220010;201807;88;68;20;64872.0;18793.8;83665.8
220020;201807;630;498;132;474107.03;125928.0;600035.06
220025;201807;107;103;4;98262.0;3816.0;102078.0
220027;201807;36;29;7;27666.0;6678.0;34344.0
220030;201807;98;81;17;77274.0;16218.0;93492.0
220040;201807;1134;856;278;815460.94;265212.0;1080673.0
220045;201807;38;28;10;26712.0;9540.0;36252.0
220050;201807;663;544;119;517814.97;113506.92;631321.9
220060;201807;174;148;26;141192.0;24804.0;165996.0
220070;201807;98;89;9;84906.0;8586.0;93492.0
220080;201807;12;10;2;9540.0;1908.0;11448.0
220090;201807;35;28;7;26712.0;6678.0;33390.0
220095;201807;2;1;1;954.0;954.0;1908.0
220100;201807;27;23;4;21942.0;3816.0;25758.0
220105;201807;26;24;2;22324.0;1908.0;24232.0
220110;201807;213;195;18;185743.8;17172.0;202915.8
220115;201807;50;47;3;44838.0;2862.0;47700.0
220117;201807;20;18;2;17172.0;1908.0;19080.0
220120;201807;1484;1073;411;1022255.25;392074.9;1414330.1
220130;201807;27;26;1;24804.0;954.0;25758.0
220140;201807;97;76;21;71550.0;20034.0;91584.0
220150;201807;463;332;131;317167.78;124974.0;442141.78
220155;201807;4;4;0;3816.0;0.0;3816.0
220157;201807;18;15;3;14310.0;2862.0;17172.0
220160;201807;73;62;11;59148.0;10494.0;69642.0
220170;201807;37;35;2;33390.0;1908.0;35298.0
220173;201807;7;7;0;6678.0;0.0;6678.0
220177;201807;5;5;0;4770.0;0.0;4770.0
220180;201807;64;63;1;60097.23;954.0;61051.23
220190;201807;1061;950;111;906300.0;105894.0;1012194.0
220191;201807;43;38;5;36252.0;4770.0;41022.0
220192;201807;67;64;3;61056.0;2862.0;63918.0
220194;201807;41;37;4;35298.0;3816.0;39114.0
220196;201807;102;84;18;80136.0;17172.0;97308.0
220198;201807;5;4;1;3816.0;954.0;4770.0
220200;201807;431;356;75;340356.0;71550.0;411906.0
220202;201807;36;32;4;30528.0;3816.0;34344.0
220205;201807;39;35;4;33390.0;3816.0;37206.0
220207;201807;18;17;1;16218.0;954.0;17172.0
220208;201807;83;44;39;41976.0;37206.0;79182.0
220209;201807;31;28;3;26712.0;2862.0;29574.0
220210;201807;15;13;2;12402.0;1908.0;14310.0
220211;201807;27;27;0;25758.0;0.0;25758.0
220213;201807;43;39;4;37206.0;3530.0;40736.0
220217;201807;37;29;8;27666.0;7632.0;35298.0
220220;201807;2055;1315;740;1250903.9;704557.94;1955461.8
220225;201807;16;8;8;7632.0;7632.0;15264.0
220230;201807;947;746;201;711235.6;191114.81;902350.44
220240;201807;147;134;13;127836.0;12402.0;140238.0
220245;201807;33;30;3;27917.04;2862.0;30779.04
220250;201807;112;101;11;96354.0;10494.0;106848.0
220253;201807;43;36;7;34344.0;6678.0;41022.0
220255;201807;28;25;3;23850.0;2862.0;26712.0
220260;201807;682;495;187;472230.0;178398.0;650628.0
220265;201807;14;11;3;10494.0;2862.0;13356.0
220270;201807;693;613;80;584076.94;75843.0;659919.94
220271;201807;43;36;7;34344.0;6678.0;41022.0
220272;201807;28;28;0;26712.0;0.0;26712.0
220273;201807;15;13;2;12402.0;1908.0;14310.0
220275;201807;58;47;11;44838.0;10494.0;55332.0
220277;201807;13;11;2;10494.0;1908.0;12402.0
220280;201807;15;12;3;11448.0;2862.0;14310.0
220285;201807;43;40;3;38160.0;2862.0;41022.0
220290;201807;1398;1195;203;1136738.8;193615.0;1330353.8
220300;201807;52;50;2;47700.0;1908.0;49608.0
220310;201807;316;266;50;253760.0;47691.0;301451.0
220320;201807;434;401;33;381124.0;31482.0;412606.0
220323;201807;0;0;0;0.0;0.0;0.0
220325;201807;16;11;5;10494.0;4770.0;15264.0
220327;201807;13;12;1;11448.0;954.0;12402.0
220330;201807;207;143;64;136422.0;61056.0;197478.0
220335;201807;137;119;18;113526.0;17172.0;130698.0
220340;201807;28;17;11;16218.0;10494.0;26712.0
220342;201807;57;49;8;46746.0;7632.0;54378.0
220345;201807;84;76;8;72504.0;7632.0;80136.0
220350;201807;428;374;54;354173.4;51516.0;405689.4
220360;201807;43;31;12;29574.0;11448.0;41022.0
220370;201807;1129;916;213;873100.8;202915.8;1076016.6
220375;201807;26;24;2;22896.0;1908.0;24804.0
220380;201807;39;32;7;30528.0;6678.0;37206.0
220385;201807;26;23;3;21942.0;2862.0;24804.0
220390;201807;2255;1280;975;1216426.5;929053.5;2145480.0
220400;201807;29;26;3;24804.0;2862.0;27666.0
220410;201807;16;15;1;14310.0;954.0;15264.0
220415;201807;14;13;1;12402.0;954.0;13356.0
220420;201807;125;103;22;98262.0;20701.8;118963.8
220430;201807;128;116;12;108995.8;11448.0;120443.8
220435;201807;21;15;6;14305.23;5724.0;20029.23
220440;201807;288;247;41;235638.0;39114.0;274752.0
220450;201807;338;171;167;161968.98;159318.0;321286.97
220455;201807;55;53;2;50562.0;1908.0;52470.0
220460;201807;18;18;0;16504.2;0.0;16504.2
220465;201807;106;69;37;65826.0;35298.0;101124.0
220470;201807;240;212;28;202248.0;26712.0;228960.0
220480;201807;72;61;11;58194.0;10494.0;68688.0
220490;201807;87;75;12;71550.0;11448.0;82998.0
220500;201807;100;84;16;80136.0;15264.0;95400.0
220510;201807;380;302;78;287345.0;74221.2;361566.2
220515;201807;22;18;4;17172.0;3816.0;20988.0
220520;201807;370;332;38;315413.0;36233.0;351646.0
220525;201807;25;17;8;16218.0;7632.0;23850.0
220527;201807;38;29;9;27666.0;7776.0;35442.0
220530;201807;34;14;20;13356.0;19080.0;32436.0
220535;201807;7;7;0;6678.0;0.0;6678.0
220540;201807;59;50;9;47700.0;8586.0;56286.0
220545;201807;57;39;18;37206.0;17172.0;54378.0
220550;201807;649;496;153;472420.8;145962.0;618382.8
220551;201807;26;19;7;18126.0;6678.0;24804.0
220552;201807;9;9;0;8586.0;0.0;8586.0
220553;201807;49;44;5;41976.0;4770.0;46746.0
220554;201807;13;8;5;7345.8;4770.0;12115.8
220555;201807;25;22;3;20988.0;2862.0;23850.0
220556;201807;51;47;4;44838.0;3816.0;48654.0
220557;201807;57;51;6;48654.0;5724.0;54378.0
220558;201807;7;2;5;1908.0;4770.0;6678.0
220559;201807;5;5;0;4770.0;0.0;4770.0
220560;201807;58;37;21;35107.2;20034.0;55141.2
220570;201807;792;480;312;456716.12;297648.0;754364.1
220580;201807;555;509;46;485566.9;43197.92;528764.8
220585;201807;6;5;1;4770.0;954.0;5724.0
220590;201807;14;14;0;13356.0;0.0;13356.0
220595;201807;59;44;15;41976.0;14310.0;56286.0
220600;201807;24;12;12;11448.0;11448.0;22896.0
220605;201807;20;19;1;18126.0;954.0;19080.0
220610;201807;63;54;9;51516.0;8586.0;60102.0
220620;201807;557;439;118;418567.5;112572.0;531139.5
220630;201807;6;4;2;3816.0;1908.0;5724.0
220635;201807;38;34;4;32436.0;3816.0;36252.0
220640;201807;97;76;21;72504.0;20034.0;92538.0
220650;201807;113;107;6;102078.0;5724.0;107802.0
220660;201807;32;26;6;24804.0;5724.0;30528.0
220665;201807;4;4;0;3816.0;0.0;3816.0
220667;201807;16;13;3;12402.0;2862.0;15264.0
220669;201807;28;25;3;23850.0;2862.0;26712.0
220670;201807;75;59;16;56095.2;15264.0;71359.2
220672;201807;65;44;21;41976.0;20034.0;62010.0
220675;201807;36;28;8;26712.0;7632.0;34344.0
220680;201807;37;31;6;29574.0;5724.0;35298.0
220690;201807;45;43;2;41022.0;1908.0;42930.0
220695;201807;58;27;31;25758.0;29574.0;55332.0
220700;201807;1566;1197;369;1140793.2;352026.0;1492819.2
220710;201807;5;3;2;2862.0;1908.0;4770.0
220720;201807;108;88;20;83713.5;18936.9;102650.4
220730;201807;19;18;1;17172.0;954.0;18126.0
220735;201807;3;1;2;954.0;1908.0;2862.0
220740;201807;47;42;5;40068.0;4770.0;44838.0
220750;201807;99;82;17;78228.0;16218.0;94446.0
220755;201807;14;14;0;13356.0;0.0;13356.0
220760;201807;52;49;3;46746.0;2862.0;49608.0
220770;201807;5670;2951;2719;2810998.8;2587789.5;5398788.0
220775;201807;23;11;12;10494.0;11448.0;21942.0
220777;201807;17;16;1;15264.0;954.0;16218.0
220779;201807;17;13;4;12402.0;3816.0;16218.0
220780;201807;879;752;127;716740.2;120872.0;837612.2
220785;201807;14;8;6;7632.0;5724.0;13356.0
220790;201807;1018;810;208;770338.0;198432.0;968770.0
220793;201807;12;12;0;11448.0;0.0;11448.0
220795;201807;21;20;1;19080.0;954.0;20034.0
220800;201807;3973;3036;937;2894138.0;892921.9;3787059.8
220810;201807;61;54;7;51516.0;6678.0;58194.0
220820;201807;241;220;21;209880.0;20034.0;229914.0
220830;201807;1185;1007;178;960673.25;169793.0;1130466.2
220840;201807;2347;1631;716;1544149.4;679916.94;2224066.2
220850;201807;53;45;8;42930.0;7632.0;50562.0
220855;201807;13;8;5;7632.0;4770.0;12402.0
220860;201807;8;7;1;6678.0;954.0;7632.0
220865;201807;23;21;2;20034.0;1908.0;21942.0
220870;201807;63;61;2;58194.0;1908.0;60102.0
220880;201807;320;245;75;233062.2;71264.0;304326.2
220885;201807;41;38;3;36252.0;2862.0;39114.0
220887;201807;19;18;1;17172.0;954.0;18126.0
220890;201807;101;89;12;84906.0;11448.0;96354.0
220900;201807;50;28;22;26712.0;20988.0;47700.0
220910;201807;55;47;8;44838.0;7632.0;52470.0
220915;201807;10;9;1;8586.0;954.0;9540.0
220920;201807;40;36;4;34344.0;3816.0;38160.0
220930;201807;41;40;1;38160.0;954.0;39114.0
220935;201807;15;15;0;14310.0;0.0;14310.0
220937;201807;44;41;3;39114.0;2862.0;41976.0
220940;201807;53;49;4;46746.0;3816.0;50562.0
220945;201807;0;0;0;0.0;0.0;0.0
220950;201807;48;44;4;41976.0;3816.0;45792.0
220955;201807;34;31;3;29574.0;2862.0;32436.0
220960;201807;1;1;0;954.0;0.0;954.0
220965;201807;29;26;3;24804.0;2862.0;27666.0
220970;201807;48;41;7;39114.0;6678.0;45792.0
220975;201807;9;8;1;7632.0;954.0;8586.0
220980;201807;33;31;2;29574.0;1908.0;31482.0
220985;201807;67;59;8;56286.0;7632.0;63918.0
220987;201807;31;29;2;27666.0;1908.0;29574.0
220990;201807;16;15;1;14310.0;954.0;15264.0
220995;201807;37;32;5;30528.0;4770.0;35298.0
220997;201807;48;38;10;36252.0;9540.0;45792.0
221000;201807;1137;1022;115;971965.9;109423.8;1081389.6
221005;201807;63;57;6;54378.0;5724.0;60102.0
221010;201807;17;14;3;13356.0;2862.0;16218.0
221020;201807;43;41;2;39114.0;1908.0;41022.0
221030;201807;30;24;6;22896.0;5724.0;28620.0
221035;201807;22;22;0;20988.0;0.0;20988.0
221037;201807;12;6;6;5724.0;5724.0;11448.0
221038;201807;26;23;3;21942.0;2862.0;24804.0
221039;201807;23;23;0;21942.0;0.0;21942.0
221040;201807;261;224;37;213696.0;35298.0;248994.0
221050;201807;234;199;35;189846.0;33390.0;223236.0
221060;201807;1757;1545;212;1471179.6;202248.0;1673427.6
221062;201807;29;28;1;26712.0;954.0;27666.0
221063;201807;14;10;4;9540.0;3816.0;13356.0
221065;201807;50;43;7;41022.0;6678.0;47700.0
221070;201807;140;121;19;115434.0;18126.0;133560.0
221080;201807;377;334;43;318636.0;40735.8;359371.8
221090;201807;34;33;1;31482.0;954.0;32436.0
221093;201807;56;36;20;34344.0;19080.0;53424.0
221095;201807;11;10;1;9540.0;954.0;10494.0
221097;201807;20;17;3;16218.0;2862.0;19080.0
221100;201807;24894;14368;10526;1,37E+14;1,00E+14;2,37E+14
221110;201807;1046;772;274;736202.0;261396.0;997598.0
221120;201807;533;396;137;377498.0;130698.0;508196.0
221130;201807;943;769;174;732386.8;165996.0;898382.8
221135;201807;35;32;3;30528.0;2862.0;33390.0
221140;201807;40;33;7;31482.0;6678.0;38160.0
221150;201807;14;11;3;10494.0;2862.0;13356.0
221160;201807;12;12;0;11448.0;0.0;11448.0
221170;201807;13;13;0;12402.0;0.0;12402.0
230010;201807;167;153;14;145962.0;13356.0;159318.0
230015;201807;122;101;21;96354.0;20034.0;116388.0
230020;201807;1593;1353;240;1287833.9;228058.56;1515892.4
230030;201807;1639;1182;457;1122059.0;435978.0;1558037.0
230040;201807;206;181;25;171195.5;23850.0;195045.5
230050;201807;212;155;57;147870.0;54378.0;202248.0
230060;201807;155;126;29;119440.8;27666.0;147106.8
230070;201807;283;253;30;241362.0;28620.0;269982.0
230075;201807;832;727;105;691555.0;99883.8;791438.8
230080;201807;181;156;25;148824.0;23850.0;172674.0
230090;201807;100;69;31;65062.8;29574.0;94636.8
230100;201807;1944;1160;784;1104314.9;747917.0;1852231.9
230110;201807;2665;1710;955;1629227.4;910497.8;2539725.2
230120;201807;957;766;191;728361.1;182195.0;910556.1
230125;201807;146;120;26;114480.0;24804.0;139284.0
230130;201807;468;419;49;399726.0;46746.0;446472.0
230140;201807;203;176;27;167904.0;25758.0;193662.0
230150;201807;160;126;34;120204.0;32436.0;152640.0
230160;201807;920;792;128;755091.0;122112.0;877203.0
230170;201807;591;544;47;514463.7;44838.0;559301.7
230180;201807;78;73;5;69642.0;4770.0;74412.0
230185;201807;409;356;53;338526.9;50562.0;389088.9
230190;201807;2218;1793;425;1706542.5;405133.0;2111675.5
230195;201807;493;429;64;409266.0;61056.0;470322.0
230200;201807;374;325;49;309086.47;46746.0;355832.47
230205;201807;352;227;125;215074.53;119250.0;334324.53
230210;201807;1260;1006;254;957230.5;241533.8;1198764.2
230220;201807;1431;986;445;939880.8;424511.0;1364391.8
230230;201807;892;780;112;743929.2;106848.0;850777.2
230240;201807;1641;1416;225;1349942.8;214650.0;1564592.8
230250;201807;1777;1468;309;1396311.1;294786.0;1691097.1
230260;201807;2969;1817;1152;1729847.0;1098054.8;2827901.8
230270;201807;1350;1082;268;1030010.0;254479.5;1284489.5
230280;201807;2733;2030;703;1930221.2;669994.2;2600215.5
230290;201807;402;362;40;340278.72;38160.0;378438.72
230300;201807;516;384;132;365076.72;125928.0;491004.72
230310;201807;423;316;107;301316.12;102078.0;403394.12
230320;201807;924;787;137;747387.8;130698.0;878085.8
230330;201807;302;242;60;230104.8;57050.0;287154.8
230340;201807;453;364;89;346303.0;84906.0;431209.0
230350;201807;3045;1932;1113;1843061.2;1059227.2;2902288.5
230360;201807;270;215;55;204314.0;52470.0;256784.0
230365;201807;134;108;26;102317.0;24804.0;127121.0
230370;201807;9786;4812;4974;4581293.5;4741792.5;9323086.0
230380;201807;468;403;65;384176.0;61056.6;445232.6
230390;201807;515;286;229;271890.0;218466.0;490356.0
230393;201807;266;220;46;207786.95;43884.0;251670.95
230395;201807;337;274;63;261148.0;60102.0;321250.0
230400;201807;594;474;120;450288.0;113983.92;564271.94
230410;201807;2624;1639;985;1557215.8;938928.0;2496143.8
230420;201807;6103;4014;2089;3811153.0;1988329.1;5799482.0
230423;201807;314;273;41;260442.0;39114.0;299556.0
230425;201807;369;305;64;290369.0;61056.0;351425.0
230426;201807;112;98;14;92766.96;13069.8;105836.76
230427;201807;79;76;3;72504.0;2862.0;75366.0
230428;201807;1370;706;664;673275.94;633456.0;1306732.0
230430;201807;451;366;85;348969.2;81090.0;430059.2
230435;201807;810;571;239;543582.44;226766.61;770349.06
230440;201807;84263;37233;47030;3,54E+14;4,48E+14;8,02E+14
230445;201807;271;189;82;180115.2;78228.0;258343.2
230450;201807;536;436;100;415944.0;95400.0;511344.0
230460;201807;59;49;10;46746.0;9540.0;56286.0
230465;201807;303;247;56;235638.0;53424.0;289062.0
230470;201807;1897;1492;405;1423368.0;385263.1;1808631.1
230480;201807;152;146;6;138997.8;5724.0;144721.8
230490;201807;284;229;55;218466.0;52470.0;270936.0
230495;201807;440;331;109;314891.38;103986.0;418877.38
230500;201807;955;713;242;679248.0;230868.0;910116.0
230510;201807;45;36;9;34344.0;8586.0;42930.0
230520;201807;385;306;79;291924.0;75366.0;367290.0
230523;201807;2103;1318;785;1255001.8;748422.94;2003424.6
230526;201807;298;250;48;238500.0;45001.0;283501.0
230530;201807;675;502;173;475895.6;164088.2;639983.8
230533;201807;182;173;9;165042.0;8586.0;173628.0
230535;201807;350;263;87;250902.0;82998.0;333900.0
230540;201807;1835;1607;228;1530435.0;216939.8;1747374.9
230550;201807;3660;2344;1316;2227182.8;1254686.5;3481869.2
230560;201807;580;444;136;422431.4;128790.0;551221.4
230565;201807;202;147;55;140238.0;51706.8;191944.8
230570;201807;302;267;35;254718.0;33390.0;288108.0
230580;201807;1106;817;289;776966.6;274752.0;1051718.6
230590;201807;961;748;213;710016.1;202725.0;912741.1
230600;201807;257;234;23;222492.06;21942.0;244434.06
230610;201807;335;267;68;254528.0;64872.0;319400.0
230620;201807;170;140;30;132606.0;28620.0;161226.0
230625;201807;722;525;197;499295.78;186784.69;686080.44
230630;201807;1283;1017;266;970218.0;253382.4;1223600.4
230640;201807;3653;3162;491;3009027.8;467636.56;3476664.2
230650;201807;401;349;52;332038.75;49593.69;381632.44
230655;201807;662;574;88;546642.8;83843.76;630486.56
230660;201807;349;294;55;280476.0;52183.8;332659.8
230670;201807;425;377;48;359658.0;45792.0;405450.0
230680;201807;197;180;17;171720.0;16218.0;187938.0
230690;201807;868;757;111;722178.0;105894.0;828072.0
230700;201807;710;602;108;574022.0;102726.8;676748.8
230710;201807;733;694;39;662076.0;37206.0;699282.0
230720;201807;151;128;23;121720.86;21942.0;143662.86
230725;201807;242;192;50;183168.0;47691.0;230859.0
230730;201807;11802;6406;5396;6095498.5;5138791.0;1,12E+13
230740;201807;649;523;126;498656.0;119513.46;618169.44
230750;201807;811;691;120;658022.3;114480.0;772502.3
230760;201807;1328;1150;178;1093053.2;169812.0;1262865.2
230763;201807;317;263;54;248946.95;51516.0;300462.94
230765;201807;6971;3282;3689;3125621.8;3518139.2;6643761.0
230770;201807;4949;2540;2409;2413334.8;2296154.0;4709488.5
230780;201807;688;604;84;573314.1;80121.69;653435.8
230790;201807;205;170;35;162180.0;32589.4;194769.4
230800;201807;1117;816;301;778153.94;287154.0;1065308.0
230810;201807;1304;1159;145;1104684.2;138139.2;1242823.5
230820;201807;335;236;99;223905.0;94446.0;318351.0
230830;201807;938;812;126;771134.44;120204.0;891338.44
230835;201807;279;241;38;228960.0;35537.0;264497.0
230837;201807;164;139;25;132606.0;23850.0;156456.0
230840;201807;913;731;182;696134.5;173342.0;869476.5
230850;201807;1487;1297;190;1236861.0;180974.0;1417835.0
230860;201807;295;221;74;210834.0;70596.0;281430.0
230870;201807;1814;1544;270;1472003.0;257008.0;1729011.0
230880;201807;41;30;11;28620.0;10494.0;39114.0
230890;201807;566;519;47;495003.8;44824.0;539827.8
230900;201807;274;209;65;199386.0;61813.0;261199.0
230910;201807;198;160;38;151876.8;36252.0;188128.8
230920;201807;404;317;87;302418.0;82998.0;385416.0
230930;201807;928;653;275;620100.6;262350.0;882450.6
230940;201807;831;667;164;636318.0;156266.0;792584.0
230945;201807;483;403;80;383986.0;76320.0;460306.0
230950;201807;376;322;54;307188.0;51516.0;358704.0
230960;201807;2586;1749;837;1661799.8;798193.0;2459992.8
230970;201807;1754;988;766;941556.8;729848.25;1671405.0
230980;201807;213;180;33;171720.0;31482.0;203202.0
230990;201807;139;112;27;106848.0;25001.47;131849.47
231000;201807;207;187;20;176490.0;19080.0;195570.0
231010;201807;139;109;30;103699.8;28620.0;132319.8
231020;201807;1302;903;399;859841.0;380646.0;1240487.0
231025;201807;988;750;238;712382.2;225525.8;937908.0
231030;201807;1130;943;187;899618.0;177826.0;1077444.0
231040;201807;140;97;43;91793.88;40291.0;132084.88
231050;201807;987;879;108;836801.9;103032.0;939833.9
231060;201807;146;128;18;122112.0;17172.0;139284.0
231070;201807;1441;1014;427;966212.0;407358.0;1373570.0
231080;201807;261;244;17;231965.1;16218.0;248183.1
231085;201807;563;349;214;331993.0;204156.0;536149.0
231090;201807;240;199;41;189846.0;39114.0;228960.0
231095;201807;166;132;34;125928.0;32436.0;158364.0
231100;201807;127;107;20;102078.0;17839.8;119917.8
231110;201807;355;309;46;292596.1;43884.0;336480.1
231120;201807;293;251;42;238490.34;40068.0;278558.34
231123;201807;139;132;7;125928.0;6678.0;132606.0
231126;201807;302;249;53;237260.0;50562.0;287822.0
231130;201807;4565;3559;1006;3386344.5;958937.25;4345282.0
231135;201807;212;183;29;174582.0;26782.0;201364.0
231140;201807;3083;2276;807;2168451.5;768885.8;2937337.5
231150;201807;363;346;17;330084.0;16218.0;346302.0
231160;201807;1209;957;252;909887.56;240179.05;1150066.6
231170;201807;537;357;180;340578.0;171720.0;512298.0
231180;201807;1643;1396;247;1331020.8;235609.38;1566630.1
231190;201807;193;171;22;163134.0;20988.0;184122.0
231195;201807;213;183;30;173858.0;28620.0;202478.0
231200;201807;834;677;157;645858.0;148518.0;794376.0
231210;201807;606;507;99;482724.8;94446.0;577170.8
231220;201807;1040;750;290;713860.1;276660.0;990520.1
231230;201807;1405;1127;278;1073956.0;264448.8;1338404.9
231240;201807;1375;999;376;952759.8;357690.6;1310450.4
231250;201807;111;103;8;98262.0;7632.0;105894.0
231260;201807;290;186;104;177444.0;98930.0;276374.0
231270;201807;1005;836;169;791944.4;161226.0;953170.4
231280;201807;57;44;13;41976.0;12402.0;54378.0
231290;201807;7213;4029;3184;3836551.2;3034905.2;6871456.5
231300;201807;627;581;46;554274.0;43884.0;598158.0
231310;201807;711;660;51;628423.0;48654.0;677077.0
231320;201807;571;435;136;414514.0;129744.0;544258.0
231325;201807;88;79;9;75366.0;8586.0;83952.0
231330;201807;2026;1567;459;1489084.6;435883.6;1924968.1
231335;201807;249;221;28;210834.0;26712.0;237546.0
231340;201807;1629;1202;427;1145564.1;407071.8;1552635.9
231350;201807;1197;987;210;941598.0;199768.0;1141366.0
231355;201807;427;371;56;353934.0;53424.0;407358.0
231360;201807;478;377;101;356948.2;96354.0;453302.2
231370;201807;92;76;16;72504.0;15264.0;87768.0
231375;201807;291;213;78;203202.0;74412.0;277614.0
231380;201807;466;379;87;359970.7;82807.2;442777.88
231390;201807;197;161;36;153594.0;34344.0;187938.0
231395;201807;734;456;278;433726.56;265212.0;698938.56
231400;201807;1069;887;182;843640.8;173285.38;1016926.25
231410;201807;1320;1078;242;1024597.4;229896.0;1254493.4
240010;201807;393;180;213;170568.27;202906.8;373475.06
240020;201807;2199;1730;469;1647594.2;447422.0;2095016.2
240030;201807;133;113;20;107802.0;19080.0;126882.0
240040;201807;32;32;0;30528.0;0.0;30528.0
240050;201807;515;441;74;419860.44;70596.0;490456.44
240060;201807;66;62;4;59148.0;3816.0;62964.0
240070;201807;190;149;41;142146.0;39114.0;181260.0
240080;201807;453;304;149;290012.0;141102.7;431114.72
240090;201807;104;92;12;87462.72;11448.0;98910.72
240100;201807;1444;1362;82;1296375.5;78037.2;1374412.8
240110;201807;992;632;360;601956.25;343297.0;945253.25
240120;201807;139;118;21;112572.0;20034.0;132606.0
240130;201807;285;267;18;254001.55;17172.0;271173.53
240140;201807;81;64;17;61056.0;16218.0;77274.0
240145;201807;696;615;81;586185.3;77064.12;663249.44
240150;201807;20;15;5;14310.0;4741.38;19051.38
240160;201807;44;38;6;36252.0;5724.0;41976.0
240165;201807;35;29;6;27428.0;5724.0;33152.0
240170;201807;93;71;22;67257.0;20988.0;88245.0
240180;201807;78;64;14;61056.0;13356.0;74412.0
240185;201807;44;40;4;38150.46;3816.0;41966.46
240190;201807;12;10;2;9540.0;1908.0;11448.0
240200;201807;3018;1691;1327;1606947.6;1264719.0;2871666.8
240210;201807;168;131;37;124974.0;35298.0;160272.0
240220;201807;1090;787;303;750655.0;289052.47;1039707.44
240230;201807;834;774;60;735562.06;56592.0;792154.06
240240;201807;122;88;34;83952.0;32436.0;116388.0
240250;201807;88;78;10;74412.0;9540.0;83952.0
240260;201807;1803;1343;460;1280535.1;437571.2;1718106.2
240270;201807;190;167;23;158936.4;21942.0;180878.4
240280;201807;42;32;10;30528.0;9540.0;40068.0
240290;201807;50;49;1;46746.0;954.0;47700.0
240300;201807;177;99;78;94446.0;74412.0;168858.0
240310;201807;2025;1112;913;1050116.0;867498.4;1917614.4
240320;201807;206;196;10;186984.0;9540.0;196524.0
240325;201807;4307;2634;1673;2505365.5;1592919.9;4098285.2
240330;201807;66;62;4;59148.0;3816.0;62964.0
240340;201807;104;76;28;72504.0;26712.0;99216.0
240350;201807;89;79;10;75366.0;9540.0;84906.0
240360;201807;429;302;127;288108.0;121158.0;409266.0
240370;201807;41;39;2;37206.0;1908.0;39114.0
240375;201807;68;41;27;39114.0;25758.0;64872.0
240380;201807;230;188;42;179352.0;39973.0;219325.0
240390;201807;16;13;3;12402.0;2862.0;15264.0
240400;201807;76;72;4;68688.0;3816.0;72504.0
240410;201807;11;7;4;6678.0;3816.0;10494.0
240420;201807;898;696;202;661458.4;191658.6;853117.0
240430;201807;263;247;16;234727.89;15264.0;249991.89
240440;201807;76;43;33;41022.0;31482.0;72504.0
240450;201807;210;142;68;134895.8;64872.0;199767.8
240460;201807;60;47;13;44838.0;12402.0;57240.0
240470;201807;234;202;32;191864.66;30528.0;222392.66
240480;201807;14;14;0;13260.6;0.0;13260.6
240485;201807;75;64;11;61056.0;10494.0;71550.0
240490;201807;46;45;1;42720.12;954.0;43674.12
240500;201807;85;67;18;63918.0;17172.0;81090.0
240510;201807;50;35;15;33390.0;14310.0;47700.0
240520;201807;126;121;5;115434.0;4770.0;120204.0
240530;201807;54;48;6;45792.0;5724.0;51516.0
240540;201807;78;67;11;63918.0;10494.0;74412.0
240550;201807;15;13;2;12402.0;1908.0;14310.0
240560;201807;371;275;96;261723.23;91584.0;353307.22
240570;201807;470;293;177;278663.4;168858.0;447521.4
240580;201807;1258;1018;240;965687.9;227802.2;1193490.1
240590;201807;30;28;2;26712.0;1908.0;28620.0
240600;201807;110;107;3;102078.0;2862.0;104940.0
240610;201807;511;428;83;407955.7;78419.0;486374.7
240615;201807;19;18;1;17172.0;954.0;18126.0
240620;201807;96;92;4;87768.0;3816.0;91584.0
240630;201807;35;33;2;31482.0;1908.0;33390.0
240640;201807;26;22;4;20988.0;3816.0;24804.0
240650;201807;237;198;39;188033.9;37206.0;225239.9
240660;201807;99;87;12;82998.0;11448.0;94446.0
240670;201807;292;171;121;161035.3;115434.0;276469.3
240680;201807;49;38;11;36252.0;10494.0;46746.0
240690;201807;49;46;3;43884.0;2862.0;46746.0
240700;201807;192;158;34;150732.0;32436.0;183168.0
240710;201807;1936;1235;701;1176993.6;668735.44;1845729.1
240720;201807;1062;776;286;739149.9;272844.0;1011993.9
240725;201807;66;61;5;58194.0;4770.0;62964.0
240730;201807;134;116;18;110664.0;17172.0;127836.0
240740;201807;241;203;38;192297.78;35298.02;227595.8
240750;201807;38;26;12;24804.0;11448.0;36252.0
240760;201807;33;29;4;27666.0;3816.0;31482.0
240770;201807;151;116;35;110664.0;33390.0;144054.0
240780;201807;684;568;116;540431.44;110664.0;651095.44
240790;201807;39;38;1;36252.0;954.0;37206.0
240800;201807;8722;5925;2797;5613979.5;2661605.5;8275585.0
240810;201807;20084;11070;9014;1,05E+14;8589008.0;1,91E+12
240820;201807;210;135;75;128499.03;71550.0;200049.03
240830;201807;1612;1320;292;1253136.8;278568.0;1531704.8
240840;201807;82;72;10;68688.0;9540.0;78228.0
240850;201807;87;76;11;72504.0;10494.0;82998.0
240860;201807;115;112;3;106848.0;2862.0;109710.0
240870;201807;60;53;7;50562.0;6678.0;57240.0
240880;201807;29;26;3;24794.46;2862.0;27656.46
240890;201807;1177;702;475;665798.75;453146.0;1118944.8
240895;201807;47;34;13;32436.0;12402.0;44838.0
240910;201807;157;142;15;135468.0;14310.0;149778.0
240920;201807;16;13;3;12402.0;2862.0;15264.0
240930;201807;385;349;36;331992.0;34344.0;366336.0
240933;201807;31;24;7;22896.0;6678.0;29574.0
240940;201807;2438;2157;281;2044285.2;265192.9;2309478.2
240950;201807;51;48;3;45792.0;2862.0;48654.0
240960;201807;32;26;6;24804.0;5724.0;30528.0
240970;201807;126;89;37;84906.0;34544.0;119450.0
240980;201807;187;149;38;142146.0;36252.0;178398.0
240990;201807;119;78;41;74412.0;39114.0;113526.0
241000;201807;69;64;5;61056.0;4770.0;65826.0
241010;201807;60;48;12;45792.0;11448.0;57240.0
241020;201807;112;105;7;100170.0;6678.0;106848.0
241025;201807;10;4;6;3816.0;5724.0;9540.0
241030;201807;119;97;22;92538.0;20988.0;113526.0
241040;201807;35;29;6;27666.0;5724.0;33390.0
241050;201807;90;78;12;74412.0;11448.0;85860.0
241060;201807;28;24;4;22896.0;3816.0;26712.0
241070;201807;14;14;0;13356.0;0.0;13356.0
241080;201807;64;57;7;54091.8;6678.0;60769.8
241090;201807;49;41;8;39114.0;7617.69;46731.69
241100;201807;76;66;10;62964.0;9540.0;72504.0
241105;201807;6;2;4;1908.0;3816.0;5724.0
241110;201807;46;44;2;41976.0;1908.0;43884.0
241120;201807;1440;1113;327;1058816.8;311958.0;1370774.8
241140;201807;222;183;39;173629.0;37206.0;210835.0
241142;201807;42;40;2;38160.0;1908.0;40068.0
241150;201807;1225;1078;147;1025694.0;140238.0;1165932.0
241160;201807;22;21;1;20034.0;954.0;20988.0
241170;201807;43;39;4;37206.0;3816.0;41022.0
241180;201807;49;41;8;38939.42;7632.0;46571.42
241190;201807;38;37;1;35298.0;954.0;36252.0
241200;201807;3883;2121;1762;2017899.6;1679027.6;3696927.2
241210;201807;70;59;11;56286.0;9636.0;65922.0
241220;201807;1386;934;452;890571.06;431174.9;1321746.0
241230;201807;244;204;40;194425.2;38160.0;232585.2
241240;201807;53;40;13;38160.0;12402.0;50562.0
241250;201807;1096;1013;83;966116.0;79182.0;1045298.0
241255;201807;47;37;10;35298.0;9540.0;44838.0
241260;201807;638;503;135;479857.22;128790.0;608647.25
241270;201807;46;33;13;31482.0;12402.0;43884.0
241280;201807;98;85;13;81090.0;12402.0;93492.0
241290;201807;108;81;27;77274.0;25758.0;103032.0
241300;201807;79;56;23;53424.0;21942.0;75366.0
241310;201807;51;38;13;36109.0;12402.0;48511.0
241320;201807;28;14;14;13356.0;13356.0;26712.0
241330;201807;60;54;6;51516.0;5724.0;57240.0
241335;201807;62;55;7;51802.2;6678.0;58480.2
241340;201807;186;139;47;132606.0;44838.0;177444.0
241350;201807;61;56;5;53424.0;4770.0;58194.0
241355;201807;40;37;3;35298.0;2862.0;38160.0
241360;201807;47;47;0;44838.0;0.0;44838.0
241370;201807;45;38;7;36127.98;6678.0;42805.98
241380;201807;38;35;3;33390.0;2862.0;36252.0
241390;201807;74;59;15;56095.2;14310.0;70405.2
241400;201807;203;165;38;156742.2;36252.0;192994.2
241410;201807;179;162;17;154548.0;16122.6;170670.6
241415;201807;97;77;20;73458.0;19080.0;92538.0
241420;201807;99;75;24;71550.0;22725.0;94275.0
241430;201807;28;27;1;25758.0;954.0;26712.0
241440;201807;486;403;83;384448.0;79182.0;463630.0
241445;201807;38;36;2;34344.0;1908.0;36252.0
241450;201807;276;226;50;215604.0;47700.0;263304.0
241460;201807;135;123;12;117104.0;11448.0;128552.0
241470;201807;43;36;7;34344.0;6678.0;41022.0
241475;201807;64;62;2;59148.0;1908.0;61056.0
241480;201807;101;72;29;67734.69;27666.0;95400.69
241490;201807;8;7;1;6678.0;954.0;7632.0
241500;201807;47;34;13;32436.0;12402.0;44838.0
250010;201807;101;87;14;82854.9;13356.0;96210.9
250020;201807;30;26;4;24804.0;3816.0;28620.0
250030;201807;816;606;210;576779.2;199291.6;776070.8
250040;201807;335;281;54;268074.0;51229.8;319303.8
250050;201807;231;191;40;181923.8;38160.0;220083.8
250053;201807;54;41;13;39114.0;12402.0;51516.0
250057;201807;0;0;0;0.0;0.0;0.0
250060;201807;451;344;107;328176.0;101791.8;429967.8
250070;201807;706;586;120;557026.0;114480.0;671506.0
250073;201807;7;7;0;6678.0;0.0;6678.0
250077;201807;198;148;50;140800.86;47700.0;188500.86
250080;201807;425;331;94;314153.2;89676.0;403829.2
250090;201807;200;131;69;124020.4;65806.92;189827.31
250100;201807;513;422;91;402588.0;86433.0;489021.0
250110;201807;561;422;139;400804.03;132606.0;533410.0
250115;201807;25;8;17;7632.0;16218.0;23850.0
250120;201807;111;82;29;78228.0;27666.0;105894.0
250130;201807;574;462;112;440748.0;106658.0;547406.0
250135;201807;14;8;6;7632.0;5724.0;13356.0
250140;201807;80;72;8;68688.0;7632.0;76320.0
250150;201807;577;426;151;404850.6;143739.19;548589.75
250153;201807;10;9;1;8586.0;954.0;9540.0
250157;201807;28;23;5;21942.0;4770.0;26712.0
250160;201807;215;168;47;160272.0;44838.0;205110.0
250170;201807;63;44;19;41976.0;18126.0;60102.0
250180;201807;4045;2741;1304;2601851.2;1238918.0;3840769.2
250190;201807;865;570;295;542110.5;281430.0;823540.5
250200;201807;52;43;9;41022.0;8586.0;49608.0
250205;201807;23;20;3;19080.0;2862.0;21942.0
250210;201807;90;78;12;74412.0;11448.0;85860.0
250215;201807;63;54;9;51516.0;8586.0;60102.0
250220;201807;27;21;6;20034.0;5724.0;25758.0
250230;201807;78;71;7;67730.0;6678.0;74408.0
250240;201807;244;202;42;191897.1;40068.0;231965.1
250250;201807;401;342;59;326268.0;56286.0;382554.0
250260;201807;31;28;3;26712.0;2862.0;29574.0
250270;201807;58;45;13;42930.0;12402.0;55332.0
250280;201807;378;316;62;301464.0;59148.0;360612.0
250290;201807;94;89;5;84619.8;4770.0;89389.8
250300;201807;557;380;177;361872.72;168845.0;530717.7
250310;201807;45;41;4;39114.0;3816.0;42930.0
250320;201807;2002;1368;634;1299817.4;603281.8;1903099.1
250330;201807;81;72;9;68688.0;8586.0;77274.0
250340;201807;24;20;4;19080.0;3816.0;22896.0
250350;201807;137;87;50;82711.8;47127.6;129839.4
250355;201807;31;24;7;22896.0;6678.0;29574.0
250360;201807;201;164;37;156456.0;35298.0;191754.0
250370;201807;2385;1614;771;1534798.0;734931.0;2269729.0
250375;201807;15;11;4;10494.0;3816.0;14310.0
250380;201807;53;38;15;36252.0;14310.0;50562.0
250390;201807;41;34;7;32436.0;6678.0;39114.0
250400;201807;15802;8003;7799;7609200.5;7433797.5;1,50E+14
250403;201807;419;342;77;326258.47;73458.0;399716.47
250407;201807;58;50;8;47700.0;7632.0;55332.0
250410;201807;33;28;5;26712.0;4770.0;31482.0
250415;201807;43;29;14;27646.92;13336.92;40983.84
250420;201807;47;39;8;37206.0;7632.0;44838.0
250430;201807;1528;1299;229;1237053.0;218466.0;1455519.0
250435;201807;16;13;3;12402.0;2862.0;15264.0
250440;201807;692;594;98;562940.25;93492.0;656432.25
250450;201807;89;73;16;69642.0;14596.2;84238.2
250460;201807;419;289;130;275706.0;124010.46;399716.47
250470;201807;86;63;23;60102.0;21942.0;82044.0
250480;201807;328;260;68;248040.0;64872.0;312912.0
250485;201807;2;1;1;954.0;954.0;1908.0
250490;201807;212;174;38;165996.0;36252.0;202248.0
250500;201807;79;58;21;55332.0;20034.0;75366.0
250510;201807;737;578;159;550649.0;150677.44;701326.44
250520;201807;175;121;54;115414.92;51511.23;166926.16
250523;201807;113;94;19;89676.0;18126.0;107802.0
250527;201807;102;81;21;77269.23;20034.0;97303.23
250530;201807;7;5;2;4770.0;1908.0;6678.0
250535;201807;25;21;4;20034.0;3816.0;23850.0
250540;201807;124;95;29;89914.5;27666.0;117580.5
250550;201807;71;68;3;64872.0;2862.0;67734.0
250560;201807;40;32;8;30528.0;7632.0;38160.0
250570;201807;152;122;30;116388.0;28620.0;145008.0
250580;201807;128;100;28;95175.8;26712.0;121887.8
250590;201807;20;16;4;15264.0;3816.0;19080.0
250600;201807;1252;846;406;805177.4;387324.0;1192501.4
250610;201807;150;130;20;124020.0;19080.0;143100.0
250620;201807;22;18;4;17172.0;3816.0;20988.0
250625;201807;66;50;16;47700.0;15264.0;62964.0
250630;201807;3022;1939;1083;1841768.4;1032125.06;2873893.5
250640;201807;205;171;34;163134.0;32436.0;195570.0
250650;201807;30;20;10;19080.0;9540.0;28620.0
250660;201807;45;35;10;33390.0;9540.0;42930.0
250670;201807;60;39;21;37206.0;20034.0;57240.0
250680;201807;382;315;67;300510.0;63918.0;364428.0
250690;201807;1854;1283;571;1220543.5;544352.8;1764896.4
250700;201807;932;819;113;777782.5;107592.12;885374.6
250710;201807;450;349;101;332946.0;96354.0;429300.0
250720;201807;106;83;23;79182.0;21942.0;101124.0
250730;201807;376;316;60;300510.6;57240.0;357750.6
250740;201807;52;48;4;45792.0;3816.0;49608.0
250750;201807;20572;12352;8220;1,17E+14;7832223.0;1,96E+13
250760;201807;74;55;19;52470.0;18126.0;70596.0
250770;201807;352;231;121;218466.14;113025.35;331491.5
250780;201807;54;41;13;39114.0;12402.0;51516.0
250790;201807;470;307;163;290970.9;154786.5;445757.4
250800;201807;154;142;12;134752.5;11448.0;146200.5
250810;201807;79;61;18;58194.0;17172.0;75366.0
250820;201807;158;129;29;123066.0;27666.0;150732.0
250830;201807;419;287;132;272796.5;125928.0;398724.5
250840;201807;52;50;2;47700.0;1908.0;49608.0
250850;201807;54;42;12;40068.0;11448.0;51516.0
250855;201807;14;12;2;11448.0;1908.0;13356.0
250860;201807;203;146;57;139284.0;54091.8;193375.8
250870;201807;33;30;3;28620.0;2862.0;31482.0
250880;201807;78;60;18;57230.46;17172.0;74402.46
250890;201807;2455;1820;635;1734753.6;604926.75;2339680.2
250900;201807;125;106;19;101124.0;18126.0;119250.0
250905;201807;123;95;28;90630.0;26712.0;117342.0
250910;201807;1181;843;338;803059.3;321879.8;1124939.1
250915;201807;111;76;35;72504.0;33390.0;105894.0
250920;201807;139;108;31;103032.0;29574.0;132606.0
250930;201807;165;102;63;97308.0;60102.0;157410.0
250933;201807;1;1;0;954.0;0.0;954.0
250937;201807;6;5;1;4770.0;954.0;5724.0
250939;201807;32;23;9;21942.0;8586.0;30528.0
250940;201807;103;77;26;73458.0;24804.0;98262.0
250950;201807;70;47;23;44838.0;21942.0;66780.0
250960;201807;91;50;41;47700.0;39114.0;86814.0
250970;201807;1212;866;346;824543.0;329130.0;1153673.0
250980;201807;92;65;27;62010.0;25758.0;87768.0
250990;201807;165;129;36;122593.77;34301.07;156894.84
251000;201807;76;68;8;64681.2;7632.0;72313.2
251010;201807;103;80;23;76316.0;21163.53;97479.53
251020;201807;78;68;10;64061.1;9540.0;73601.1
251030;201807;45;35;10;33390.0;9540.0;42930.0
251040;201807;53;38;15;36252.0;14310.0;50562.0
251050;201807;23;21;2;20034.0;1908.0;21942.0
251060;201807;49;38;11;35298.0;10494.0;45792.0
251065;201807;3;3;0;2862.0;0.0;2862.0
251070;201807;25;20;5;19071.0;4770.0;23841.0
251080;201807;4704;2280;2424;2164723.8;2306610.8;4471334.5
251090;201807;197;169;28;161226.0;26712.0;187938.0
251100;201807;18;17;1;16218.0;954.0;17172.0
251110;201807;45;36;9;34344.0;8586.0;42930.0
251120;201807;1819;1105;714;1049260.2;681156.0;1730416.2
251130;201807;383;313;70;298492.28;66780.0;365272.28
251140;201807;522;340;182;323216.8;173459.34;496676.12
251150;201807;296;257;39;244406.0;37206.0;281612.0
251160;201807;97;82;15;78224.0;14310.0;92534.0
251170;201807;98;78;20;74383.38;19075.23;93458.61
251180;201807;290;184;106;175527.23;101115.23;276642.47
251190;201807;191;130;61;123691.83;58194.0;181885.83
251200;201807;256;208;48;198432.0;45792.0;244224.0
251203;201807;34;32;2;30528.0;1908.0;32436.0
251207;201807;95;79;16;75366.0;15264.0;90630.0
251210;201807;1416;1018;398;969618.5;379024.2;1348642.8
251220;201807;47;37;10;35298.0;9540.0;44838.0
251230;201807;469;391;78;373014.0;74412.0;447426.0
251240;201807;99;72;27;67734.0;25758.0;93492.0
251250;201807;1339;957;382;910088.9;364285.0;1274373.9
251260;201807;13;8;5;7632.0;4770.0;12402.0
251270;201807;344;257;87;245178.0;82855.0;328033.0
251272;201807;63;58;5;55332.0;4770.0;60102.0
251274;201807;27;22;5;20988.0;4770.0;25758.0
251275;201807;23;16;7;15264.0;6678.0;21942.0
251276;201807;17;13;4;12402.0;3816.0;16218.0
251278;201807;8;7;1;6678.0;954.0;7632.0
251280;201807;101;96;5;91584.0;4770.0;96354.0
251290;201807;707;534;173;509436.0;165042.0;674478.0
251300;201807;17;14;3;13356.0;2862.0;16218.0
251310;201807;369;265;104;252806.0;99216.0;352022.0
251315;201807;19;18;1;17172.0;954.0;18126.0
251320;201807;61;50;11;47700.0;10494.0;58194.0
251330;201807;80;71;9;67734.0;8586.0;76320.0
251335;201807;12;7;5;6678.0;4770.0;11448.0
251340;201807;697;412;285;393048.0;270865.25;663913.25
251350;201807;37;35;2;33390.0;1908.0;35298.0
251360;201807;74;65;9;61803.94;8586.0;70389.94
251365;201807;15;14;1;13356.0;954.0;14310.0
251370;201807;5322;3617;1705;3446304.0;1625236.0;5071540.0
251380;201807;49;39;10;37206.0;9540.0;46746.0
251385;201807;3;3;0;2862.0;0.0;2862.0
251390;201807;686;543;143;516878.2;135182.0;652060.2
251392;201807;12;7;5;6678.0;4770.0;11448.0
251394;201807;10;10;0;9317.4;0.0;9317.4
251396;201807;15;10;5;9540.0;4770.0;14310.0
251398;201807;18;15;3;14310.0;2862.0;17172.0
251400;201807;41;34;7;32436.0;6678.0;39114.0
251410;201807;36;31;5;29574.0;4770.0;34344.0
251420;201807;104;78;26;74412.0;24804.0;99216.0
251430;201807;40;37;3;35298.0;2862.0;38160.0
251440;201807;33;22;11;20988.0;10494.0;31482.0
251445;201807;54;49;5;46746.0;4770.0;51516.0
251450;201807;416;367;49;348462.8;46746.0;395208.8
251455;201807;2;1;1;954.0;954.0;1908.0
251460;201807;16;12;4;11448.0;3816.0;15264.0
251465;201807;5;2;3;1908.0;2862.0;4770.0
251470;201807;47;37;10;35298.0;9540.0;44838.0
251480;201807;26;24;2;22896.0;1908.0;24804.0
251490;201807;123;85;38;80613.0;35299.0;115912.0
251500;201807;119;95;24;90630.0;22133.0;112763.0
251510;201807;37;28;9;26712.0;8586.0;35298.0
251520;201807;25;25;0;23850.0;0.0;23850.0
251530;201807;4531;3190;1341;3037021.2;1279018.2;4316039.5
251540;201807;75;66;9;62964.0;8586.0;71550.0
251550;201807;412;319;93;303372.2;88198.0;391570.2
251560;201807;24;17;7;16218.0;6678.0;22896.0
251570;201807;20;20;0;19080.0;0.0;19080.0
251580;201807;122;100;22;95400.0;20988.0;116388.0
251590;201807;123;91;32;86995.0;30528.0;117523.0
251593;201807;23;14;9;13356.0;8586.0;21942.0
251597;201807;53;44;9;41976.0;8586.0;50562.0
251600;201807;1095;776;319;738812.5;302717.9;1041530.4
251610;201807;209;158;51;150732.0;47987.0;198719.0
251615;201807;3;3;0;2862.0;0.0;2862.0
251620;201807;4244;2831;1413;2690933.8;1345237.0;4036170.8
251630;201807;449;331;118;315774.0;112563.0;428337.0
251640;201807;149;105;44;100170.0;41976.0;142146.0
251650;201807;270;197;73;186105.1;69642.0;255747.1
251660;201807;226;204;22;194616.0;20797.2;215413.2
251670;201807;359;278;81;263516.0;77274.0;340790.0
251675;201807;3;3;0;2862.0;0.0;2862.0
251680;201807;98;88;10;83952.0;9540.0;93492.0
251690;201807;343;287;56;272844.0;53073.89;325917.88
251700;201807;283;238;45;226465.3;42915.69;269380.97
251710;201807;21;14;7;13356.0;6678.0;20034.0
251720;201807;32;22;10;20988.0;9254.0;30242.0
251740;201807;10;8;2;7632.0;1908.0;9540.0
260005;201807;3180;1803;1377;1708973.4;1312777.1;3021750.5
260010;201807;1490;1064;426;1010297.5;404401.3;1414698.8
260020;201807;426;375;51;357750.0;48654.0;406404.0
260030;201807;580;420;160;399912.97;152640.0;552553.0
260040;201807;853;530;323;504532.44;308132.47;812664.9
260050;201807;1143;820;323;782042.0;307570.0;1089612.0
260060;201807;412;373;39;355078.8;37206.0;392284.8
260070;201807;1464;923;541;876420.0;513144.38;1389564.4
260080;201807;732;576;156;548693.1;148824.0;697517.1
260090;201807;576;361;215;344166.12;205110.0;549276.1
260100;201807;229;161;68;152784.0;64872.0;217656.0
260105;201807;232;131;101;124974.0;96354.0;221328.0
260110;201807;2770;2056;714;1961415.0;680346.0;2641761.0
260120;201807;2922;1460;1462;1383122.2;1392460.1;2775582.2
260130;201807;154;107;47;102078.0;44838.0;146916.0
260140;201807;2149;1408;741;1334740.8;705369.44;2040110.2
260150;201807;225;149;76;142146.0;72504.0;214650.0
260160;201807;300;257;43;245178.0;41022.0;286200.0
260170;201807;3399;2069;1330;1967066.6;1267436.9;3234503.5
260180;201807;141;119;22;113526.0;20988.0;134514.0
260190;201807;2296;1616;680;1538513.9;648720.0;2187234.0
260200;201807;901;739;162;704231.06;154262.0;858493.06
260210;201807;1415;1009;406;962435.25;385435.12;1347870.4
260220;201807;724;661;63;630594.0;60102.0;690696.0
260230;201807;1205;911;294;866903.0;280476.0;1147379.0
260240;201807;225;171;54;162180.0;51516.0;213696.0
260250;201807;76;60;16;57240.0;15264.0;72504.0
260260;201807;996;717;279;684018.0;266166.0;950184.0
260270;201807;428;346;82;328701.2;77941.8;406643.0
260280;201807;1403;888;515;846675.0;491024.0;1337699.0
260290;201807;6402;3428;2974;3251841.5;2830486.0;6082327.5
260300;201807;877;774;103;736327.6;97976.0;834303.6
260310;201807;509;406;103;385945.47;98262.0;484207.47
260320;201807;879;662;217;631261.2;207018.0;838279.2
260330;201807;36;27;9;25758.0;8586.0;34344.0
260340;201807;69;50;19;47700.0;18126.0;65826.0
260345;201807;5651;3176;2475;3022773.8;2360073.8;5382847.5
260350;201807;482;354;128;335972.1;122112.0;458084.1
260360;201807;284;146;138;139284.0;131652.0;270936.0
260370;201807;667;438;229;415242.4;218326.0;633568.4
260380;201807;604;434;170;414036.0;161035.56;575071.56
260390;201807;298;252;46;239329.98;42930.0;282259.97
260392;201807;100;88;12;83952.0;11448.0;95400.0
260400;201807;4067;2341;1726;2224696.8;1646233.2;3870930.0
260410;201807;14743;7729;7014;7358255.0;6688911.0;1,40E+14
260415;201807;121;110;11;104940.0;10494.0;115434.0
260420;201807;1791;1072;719;1017611.06;684272.6;1701883.6
260430;201807;192;177;15;167646.66;14310.0;181956.66
260440;201807;227;164;63;155732.0;60102.0;215834.0
260450;201807;477;345;132;327845.0;125928.0;453773.0
260460;201807;849;452;397;428538.8;378733.22;807272.0
260470;201807;372;229;143;217702.8;136116.0;353818.8
260480;201807;207;130;77;124020.0;73458.0;197478.0
260490;201807;211;171;40;163134.0;38160.0;201294.0
260500;201807;1136;765;371;727522.2;353647.8;1081170.0
260510;201807;744;592;152;563814.0;144054.0;707868.0
260515;201807;259;231;28;220374.0;26235.0;246609.0
260520;201807;3338;1987;1351;1888298.5;1286651.6;3174950.2
260530;201807;795;645;150;612837.75;143100.0;755937.75
260540;201807;567;432;135;412128.0;127836.72;539964.75
260545;201807;13;10;3;9540.0;2862.0;12402.0
260550;201807;348;217;131;207018.0;124974.0;331992.0
260560;201807;521;390;131;371774.0;124687.8;496461.8
260570;201807;1018;835;183;793871.8;174295.8;968167.6
260580;201807;263;235;28;224190.0;26712.0;250902.0
260590;201807;659;378;281;359200.1;268074.0;627274.06
260600;201807;8212;4199;4013;3985268.0;3824533.5;7809801.5
260610;201807;492;332;160;316728.0;152353.8;469081.8
260620;201807;3668;1917;1751;1817367.2;1668522.1;3485889.5
260630;201807;78;75;3;71550.0;2862.0;74412.0
260640;201807;3723;2031;1692;1933810.6;1614111.2;3547922.0
260650;201807;324;231;93;220374.0;88106.67;308480.66
260660;201807;508;348;160;331610.4;152640.0;484250.4
260670;201807;103;76;27;72504.0;25758.0;98262.0
260680;201807;3670;2053;1617;1941678.4;1541988.9;3483667.2
260690;201807;121;95;26;90630.0;24804.0;115434.0
260700;201807;326;199;127;189082.8;120324.0;309406.8
260710;201807;38;35;3;33390.0;2862.0;36252.0
260720;201807;2248;1346;902;1277877.8;859716.2;2137593.8
260730;201807;611;463;148;441702.0;138997.8;580699.8
260740;201807;61;57;4;54378.0;3816.0;58194.0
260750;201807;633;440;193;419435.62;184122.0;603557.6
260760;201807;622;335;287;319590.0;273798.0;593388.0
260765;201807;987;520;467;492851.8;445279.5;938131.3
260770;201807;221;166;55;158364.0;52470.0;210834.0
260775;201807;819;488;331;464169.8;315765.0;779934.8
260780;201807;268;174;94;165996.0;89676.0;255672.0
260790;201807;12314;6779;5535;6440857.5;5272963.0;1,17E+14
260795;201807;168;117;51;110454.12;48654.0;159108.12
260800;201807;283;235;48;223713.0;45792.0;269505.0
260805;201807;171;110;61;104211.14;58194.0;162405.14
260810;201807;742;648;94;616942.25;89676.0;706618.25
260820;201807;315;213;102;201872.8;97308.0;299180.78
260825;201807;201;137;64;130524.57;61056.0;191580.56
260830;201807;262;170;92;162180.0;87768.0;249948.0
260840;201807;234;168;66;159605.0;62964.0;222569.0
260845;201807;211;146;65;139284.0;62010.0;201294.0
260850;201807;504;365;139;346546.1;132606.0;479152.1
260860;201807;254;191;63;182016.34;60102.0;242118.34
260870;201807;375;273;102;259202.42;97308.0;356510.4
260875;201807;713;503;210;478748.7;200340.0;679088.7
260880;201807;1591;970;621;923707.3;592243.2;1515950.5
260890;201807;2436;1701;735;1615969.8;700237.0;2316206.8
260900;201807;1040;717;323;682715.8;308142.0;990857.8
260910;201807;279;219;60;208926.0;57240.0;266166.0
260915;201807;303;204;99;194616.0;94326.0;288942.0
260920;201807;178;101;77;96354.0;73458.0;169812.0
260930;201807;391;335;56;319590.0;53338.45;372928.44
260940;201807;2828;1547;1281;1471007.8;1221577.9;2692585.5
260950;201807;2037;1182;855;1121275.9;815670.0;1936945.9
260960;201807;14257;7425;6832;7049980.0;6509538.0;1,36E+14
260970;201807;438;375;63;356961.0;60102.0;417063.0
260980;201807;194;171;23;162847.8;21942.0;184789.8
260990;201807;2577;2124;453;2024551.2;431494.2;2456045.5
261000;201807;4384;2590;1794;2458410.0;1709570.8;4167980.8
261010;201807;186;137;49;130698.0;45928.23;176626.23
261020;201807;610;456;154;434881.0;146916.0;581797.0
261030;201807;225;163;62;155502.0;58914.27;214416.27
261040;201807;365;325;40;310050.0;37873.8;347923.8
261050;201807;474;416;58;396864.0;55332.0;452196.0
261060;201807;1332;880;452;837088.56;431208.0;1268296.5
261070;201807;9077;4610;4467;4373624.0;4253695.5;8627319.0
261080;201807;407;296;111;281612.0;105894.0;387506.0
261090;201807;2246;1726;520;1637822.0;495308.0;2133130.0
261100;201807;1088;764;324;726805.8;307226.16;1034031.94
261110;201807;8120;4957;3163;4723899.0;3014820.5;7738719.5
261120;201807;274;229;45;218466.0;42925.23;261391.23
261130;201807;571;334;237;318112.1;225908.0;544020.1
261140;201807;191;125;66;119250.0;62964.0;182214.0
261150;201807;669;395;274;376830.0;260155.8;636985.8
261153;201807;74;70;4;65826.31;3816.0;69642.31
261160;201807;77351;39002;38349;3,71E+14;3,66E+13;7,37E+14
261170;201807;449;337;112;320868.38;106848.0;427716.38
261180;201807;1791;1103;688;1047139.6;656352.0;1703491.6
261190;201807;618;429;189;408822.22;180297.0;589119.25
261200;201807;216;191;25;181449.3;23850.0;205299.3
261210;201807;34;31;3;29574.0;2862.0;32436.0
261220;201807;2598;1835;763;1744418.9;727329.8;2471748.5
261230;201807;332;244;88;232776.0;83937.69;316713.7
261240;201807;450;387;63;365184.94;60102.0;425286.94
261245;201807;224;188;36;179352.0;34344.0;213696.0
261247;201807;156;119;37;113526.0;35298.0;148824.0
261250;201807;2867;1462;1405;1393928.2;1339259.9;2733188.0
261255;201807;253;230;23;219420.0;21942.0;241362.0
261260;201807;869;749;120;714546.0;114480.0;829026.0
261270;201807;176;137;39;130698.0;37206.0;167904.0
261280;201807;161;134;27;127836.0;25758.0;153594.0
261290;201807;125;87;38;82759.5;36252.0;119011.5
261300;201807;1237;882;355;841428.0;338670.0;1180098.0
261310;201807;768;512;256;487711.3;243603.9;731315.2
261320;201807;541;364;177;346970.0;168858.0;515828.0
261330;201807;893;706;187;670525.5;177552.45;848077.94
261340;201807;306;173;133;165042.0;126882.0;291924.0
261350;201807;805;576;229;548550.2;218466.0;767016.2
261360;201807;1242;804;438;766614.4;417566.0;1184180.4
261370;201807;5028;3093;1935;2935606.5;1843068.5;4778675.0
261380;201807;576;424;152;402597.62;144722.0;547319.6
261390;201807;3462;2305;1157;2194992.2;1100489.5;3295481.8
261400;201807;278;251;27;238881.6;25758.0;264639.6
261410;201807;1078;715;363;682110.0;346297.22;1028407.25
261420;201807;891;563;328;535835.25;312893.47;848728.75
261430;201807;330;300;30;285354.0;28333.8;313687.8
261440;201807;118;107;11;102078.0;10494.0;112572.0
261450;201807;2501;2081;420;1982613.5;400432.03;2383045.5
261460;201807;721;577;144;549504.0;137376.0;686880.0
261470;201807;252;193;59;183312.0;56247.84;239559.84
261480;201807;363;293;70;278283.0;66776.0;345059.0
261485;201807;336;205;131;194902.2;124974.0;319876.2
261500;201807;624;423;201;403542.0;191754.0;595296.0
261510;201807;48;33;15;31482.0;14310.0;45792.0
261520;201807;109;96;13;91584.0;12402.0;103986.0
261530;201807;4185;2651;1534;2520858.0;1462182.8;3983040.8
261540;201807;1093;671;422;639670.4;402588.0;1042258.4
261550;201807;285;144;141;136280.0;134494.92;270774.9
261560;201807;801;533;268;505526.2;254518.6;760044.8
261570;201807;373;290;83;276660.0;79182.0;355842.0
261580;201807;379;297;82;282574.0;78228.0;360802.0
261590;201807;193;156;37;148824.0;35298.0;184122.0
261600;201807;295;237;58;225335.0;54855.0;280190.0
261610;201807;108;94;14;89199.0;13356.0;102555.0
261618;201807;65;51;14;48654.0;13356.0;62010.0
261620;201807;202;123;79;117342.0;75366.0;192708.0
261630;201807;586;452;134;428847.6;127836.0;556683.6
261640;201807;6376;3383;2993;3220020.5;2851708.0;6071728.5
261650;201807;493;313;180;297924.66;171720.0;469644.66
270010;201807;531;470;61;448094.0;57431.0;505525.0
270020;201807;308;246;62;234680.0;59148.0;293828.0
270030;201807;9224;5901;3323;5615638.0;3167413.0;8783051.0
270040;201807;2012;1240;772;1182759.6;735247.8;1918007.5
270050;201807;178;131;47;124974.0;44838.0;169812.0
270060;201807;117;65;52;62010.0;49608.0;111618.0
270070;201807;900;654;246;622592.6;234379.27;856971.9
270080;201807;38;32;6;30528.0;5724.0;36252.0
270090;201807;20;16;4;15264.0;3816.0;19080.0
270100;201807;1262;839;423;797407.5;401395.7;1198803.2
270110;201807;145;107;38;102078.0;36252.0;138330.0
270120;201807;228;187;41;177546.55;39114.0;216660.55
270130;201807;246;169;77;160653.6;73458.0;234111.6
270135;201807;101;63;38;60102.0;36252.0;96354.0
270140;201807;1307;792;515;755347.2;490347.2;1245694.4
270150;201807;267;213;54;203202.0;51516.0;254718.0
270160;201807;525;392;133;373968.0;126214.2;500182.2
270170;201807;735;474;261;451909.8;247753.8;699663.6
270180;201807;70;54;16;51198.04;15054.12;66252.16
270190;201807;101;89;12;84906.0;11448.0;96354.0
270200;201807;108;97;11;92347.2;10494.0;102841.2
270210;201807;483;249;234;237546.0;222949.8;460495.8
270220;201807;185;145;40;138330.0;38160.0;176490.0
270230;201807;2118;1267;851;1203975.2;809946.6;2013921.9
270235;201807;741;560;181;533969.56;172308.95;706278.56
270240;201807;3127;2434;693;2309379.5;658330.0;2967709.5
270250;201807;172;119;53;113526.0;50562.0;164088.0
270255;201807;224;192;32;183168.0;30146.4;213314.4
270260;201807;333;265;68;252810.0;64872.0;317682.0
270270;201807;113;47;66;44829.0;62964.0;107793.0
270280;201807;202;123;79;117342.0;75346.92;192688.92
270290;201807;1185;895;290;852594.44;275783.47;1128377.9
270300;201807;287;184;103;175536.0;97975.8;273511.8
270310;201807;919;739;180;702414.5;171015.12;873429.6
270320;201807;882;753;129;716690.8;122779.8;839470.6
270330;201807;274;228;46;216558.0;43884.0;260442.0
270340;201807;60;48;12;45792.0;11448.0;57240.0
270350;201807;91;46;45;43645.5;42930.0;86575.5
270360;201807;74;41;33;39114.0;31482.0;70596.0
270370;201807;51;39;12;37206.0;11448.0;48654.0
270375;201807;68;39;29;37206.0;27666.0;64872.0
270380;201807;1076;611;465;581940.0;443610.0;1025550.0
270390;201807;195;109;86;103986.0;82044.0;186030.0
270400;201807;706;515;191;490095.28;182214.0;672309.25
270410;201807;698;500;198;476682.03;188882.45;665564.5
270420;201807;405;264;141;250158.0;134429.38;384587.38
270430;201807;32736;23398;9338;2,23E+13;8900693.0;3,12E+14
270440;201807;492;385;107;367290.0;101791.8;469081.8
270450;201807;779;412;367;392809.5;349164.66;741974.2
270460;201807;198;152;46;145008.0;43884.0;188892.0
270470;201807;1383;926;457;882745.44;435978.0;1318723.4
270480;201807;532;429;103;406976.8;97546.5;504523.3
270490;201807;25;20;5;19080.0;4770.0;23850.0
270500;201807;512;420;92;400680.0;87768.0;488448.0
270510;201807;741;454;287;433116.0;273798.0;706914.0
270520;201807;365;224;141;213487.0;134514.0;348001.0
270530;201807;65;57;8;53710.2;7632.0;61342.2
270540;201807;122;93;29;88722.0;27666.0;116388.0
270550;201807;1736;1311;425;1250085.0;404968.22;1655053.2
270560;201807;313;146;167;139284.0;159318.0;298602.0
270570;201807;461;309;152;292796.56;144625.53;437422.1
270580;201807;82;61;21;58194.0;20034.0;78228.0
270590;201807;74;61;13;58194.0;12402.0;70596.0
270600;201807;181;149;32;142146.0;30528.0;172674.0
270610;201807;194;159;35;151677.0;33390.0;185067.0
270620;201807;30;29;1;27666.0;954.0;28620.0
270630;201807;3891;2960;931;2810883.8;886009.44;3696893.0
270640;201807;902;663;239;631452.6;227691.8;859144.4
270642;201807;213;181;32;172674.0;30528.0;203202.0
270644;201807;271;185;86;176299.73;82039.23;258338.97
270650;201807;263;153;110;145962.0;104940.0;250902.0
270660;201807;258;209;49;199386.0;46746.0;246132.0
270670;201807;3186;2426;760;2303795.5;722122.44;3025918.0
270680;201807;469;273;196;260433.0;186980.0;447413.0
270690;201807;1122;708;414;673679.9;394946.47;1068626.4
270700;201807;35;27;8;25758.0;7632.0;33390.0
270710;201807;890;672;218;639667.0;207972.0;847639.0
270720;201807;251;189;62;180306.0;58861.8;239167.8
270730;201807;1934;1128;806;1073012.8;766818.2;1839831.0
270740;201807;45;28;17;26712.0;16218.0;42930.0
270750;201807;643;472;171;450098.0;162467.0;612565.0
270760;201807;304;218;86;207972.0;82044.0;290016.0
270770;201807;2786;1773;1013;1684149.0;965448.0;2649597.0
270780;201807;91;56;35;53419.23;33372.46;86791.69
270790;201807;264;177;87;168858.0;82998.0;251856.0
270800;201807;1967;1576;391;1501711.2;372269.88;1873981.1
270810;201807;302;240;62;228945.69;59139.23;288084.9
270820;201807;159;104;55;99216.0;52375.0;151591.0
270830;201807;917;664;253;632689.0;241076.0;873765.0
270840;201807;1413;1038;375;989512.9;356082.0;1345594.9
270850;201807;1657;1013;644;960240.4;614357.44;1574597.9
270860;201807;2468;1604;864;1527886.4;821358.56;2349245.0
270870;201807;120;64;56;61056.0;53424.0;114480.0
270880;201807;916;681;235;647829.1;223305.58;871134.75
270890;201807;348;254;94;241867.62;89671.23;331538.84
270895;201807;73;63;10;60102.0;9540.0;69642.0
270900;201807;104;80;24;76320.0;22896.0;99216.0
270910;201807;325;258;67;244987.2;63918.0;308905.2
270915;201807;1848;1111;737;1055005.1;701377.4;1756382.5
270920;201807;482;406;76;387324.0;72504.0;459828.0
270930;201807;6181;4485;1696;4273013.5;1615307.2;5888320.5
270940;201807;2401;1823;578;1737172.9;550440.0;2287613.0
280010;201807;43;38;5;36252.0;4770.0;41022.0
280020;201807;710;616;94;584484.1;88722.0;673206.1
280030;201807;19705;12662;7043;1,20E+14;6690486.0;1,87E+14
280040;201807;338;215;123;205110.0;115911.0;321021.0
280050;201807;377;288;89;274465.8;84906.0;359371.8
280060;201807;332;220;112;207633.44;106848.0;314481.44
280067;201807;989;694;295;659317.94;280476.25;939794.2
280070;201807;130;109;21;103986.0;20034.0;124020.0
280100;201807;623;494;129;468245.47;122876.0;591121.5
280110;201807;75;70;5;66780.0;4770.0;71550.0
280120;201807;628;503;125;479862.0;119250.0;599112.0
280130;201807;1394;873;521;831411.8;496890.9;1328302.8
280140;201807;477;388;89;368339.4;83952.0;452291.4
280150;201807;330;244;86;231332.89;82044.0;313376.88
280160;201807;95;81;14;77274.0;13356.0;90630.0
280170;201807;598;396;202;376587.56;192708.0;569295.56
280190;201807;27;25;2;23850.0;1908.0;25758.0
280200;201807;27;19;8;18126.0;7632.0;25758.0
280210;201807;2775;1959;816;1850180.8;772896.5;2623077.2
280220;201807;41;31;10;29574.0;9540.0;39114.0
280230;201807;321;265;56;251975.62;53424.0;305399.62
280240;201807;115;110;5;104796.9;4770.0;109566.9
280250;201807;17;11;6;10494.0;5724.0;16218.0
280260;201807;80;69;11;65826.0;10494.0;76320.0
280270;201807;161;124;37;118296.0;35298.0;153594.0
280280;201807;193;125;68;119250.0;64872.0;184122.0
280290;201807;3127;2261;866;2145031.8;824853.25;2969885.0
280300;201807;1112;849;263;807499.0;250138.8;1057637.8
280310;201807;107;102;5;96977.29;4770.0;101747.29
280320;201807;654;447;207;426429.0;197478.0;623907.0
280330;201807;359;259;100;247086.0;95275.98;342361.97
280340;201807;426;341;85;323842.56;80327.0;404169.56
280350;201807;3463;2671;792;2536022.2;752829.06;3288851.2
280360;201807;464;291;173;277614.0;164088.0;441702.0
280370;201807;97;86;11;82044.0;10494.0;92538.0
280380;201807;56;43;13;41022.0;12402.0;53424.0
280390;201807;184;156;28;148824.0;26712.0;175536.0
280400;201807;344;235;109;223284.1;103986.0;327270.1
280410;201807;286;232;54;220375.0;51516.0;271891.0
280420;201807;174;146;28;139265.0;26712.0;165977.0
280430;201807;112;82;30;78228.0;28511.63;106739.63
280440;201807;688;533;155;504572.6;147669.66;652242.25
280445;201807;118;110;8;104940.0;7632.0;112572.0
280450;201807;1112;950;162;902905.44;154548.0;1057453.5
280460;201807;760;560;200;526330.06;190800.0;717130.06
280470;201807;189;173;16;165042.0;14311.0;179353.0
280480;201807;2294;1625;669;1535212.1;635281.8;2170494.0
280490;201807;353;326;27;309612.0;25758.0;335370.0
280500;201807;43;39;4;37206.0;3816.0;41022.0
280510;201807;142;111;31;105593.2;29288.0;134881.2
280520;201807;55;41;14;39114.0;13356.0;52470.0
280530;201807;77;54;23;51516.0;21942.0;73458.0
280540;201807;507;408;99;389096.75;94159.8;483256.53
280550;201807;712;658;54;627024.6;51516.0;678540.6
280560;201807;492;430;62;407501.1;59148.0;466649.1
280570;201807;1781;1355;426;1288464.5;405548.84;1694013.2
280580;201807;601;458;143;435361.6;136327.0;571688.6
280590;201807;167;104;63;98936.48;60102.0;159038.48
280600;201807;364;306;58;291924.0;55332.0;347256.0
280610;201807;139;105;34;99964.0;32436.0;132400.0
280620;201807;551;453;98;430445.5;93348.9;523794.4
280630;201807;165;137;28;130698.0;26712.0;157410.0
280640;201807;206;164;42;155627.0;40068.0;195695.0
280650;201807;78;53;25;50562.0;23850.0;74412.0
280660;201807;132;96;36;91584.0;34105.5;125689.5
280670;201807;1657;1032;625;976188.06;592505.94;1568694.0
280680;201807;183;158;25;148948.14;23850.0;172798.14
280690;201807;55;45;10;42930.0;9540.0;52470.0
280700;201807;19;19;0;18126.0;0.0;18126.0
280710;201807;1410;1074;336;1017521.4;320544.0;1338065.4
280720;201807;109;73;36;67082.4;34344.0;101426.4
280730;201807;26;22;4;20988.0;3816.0;24804.0
280740;201807;2435;1802;633;1712619.2;602776.44;2315395.8
280750;201807;301;261;40;248994.0;38160.0;287154.0
280760;201807;896;618;278;588236.4;265212.0;853448.4
290010;201807;206;139;67;132606.0;63918.0;196524.0
290020;201807;179;166;13;158364.0;12402.0;170766.0
290030;201807;597;388;209;369484.2;199386.0;568870.2
290035;201807;139;113;26;105313.2;24804.0;130117.2
290040;201807;276;173;103;165042.0;98262.0;263304.0
290050;201807;81;61;20;58194.0;19080.0;77274.0
290060;201807;255;114;141;108469.8;134514.0;242983.8
290070;201807;5622;2773;2849;2638003.8;2714662.8;5352666.5
290080;201807;496;222;274;211482.72;261377.0;472859.72
290090;201807;390;171;219;163134.0;208926.0;372060.0
290100;201807;1604;1061;543;1008142.2;517449.8;1525592.0
290110;201807;771;458;313;434841.2;298068.53;732909.75
290115;201807;213;195;18;185076.0;17172.0;202248.0
290120;201807;775;502;273;478240.2;260442.0;738682.2
290130;201807;415;246;169;234388.27;161226.0;395614.25
290135;201807;299;226;73;214926.66;69642.0;284568.66
290140;201807;301;250;51;238500.0;48463.2;286963.2
290150;201807;132;100;32;95400.0;30528.0;125928.0
290160;201807;251;191;60;180974.58;57240.0;238214.58
290170;201807;89;64;25;61056.0;23850.0;84906.0
290180;201807;157;124;33;118296.0;31482.0;149778.0
290190;201807;448;365;83;347924.0;78895.8;426819.8
290195;201807;314;187;127;178398.0;121158.0;299556.0
290200;201807;280;234;46;223236.0;43884.0;267120.0
290205;201807;145;88;57;83952.0;54378.0;138330.0
290210;201807;1139;826;313;786860.2;298602.0;1085462.2
290220;201807;224;125;99;118773.0;94446.0;213219.0
290225;201807;290;111;179;105894.0;170766.0;276660.0
290230;201807;65;43;22;41022.0;20988.0;62010.0
290240;201807;308;121;187;115147.8;178398.0;293545.8
290250;201807;270;246;24;233988.0;22896.0;256884.0
290260;201807;287;234;53;222187.0;50562.0;272749.0
290265;201807;183;152;31;144191.0;29574.0;173765.0
290270;201807;1396;1155;241;1100010.2;228765.0;1328775.2
290280;201807;469;344;125;328176.0;119250.0;447426.0
290290;201807;1237;725;512;685847.9;488448.0;1174295.9
290300;201807;452;381;71;363183.22;67734.0;430917.22
290310;201807;318;142;176;135468.0;167904.0;303372.0
290320;201807;4001;2484;1517;2365634.8;1445310.2;3810944.8
290323;201807;186;162;24;154544.0;22896.0;177440.0
290327;201807;155;122;33;116116.11;31482.0;147598.11
290330;201807;77;43;34;41022.0;32436.0;73458.0
290340;201807;904;363;541;345329.0;515828.0;861157.0
290350;201807;596;355;241;338670.0;229914.0;568584.0
290360;201807;368;276;92;261397.69;87768.0;349165.7
290370;201807;909;368;541;351072.0;516100.0;867172.0
290380;201807;310;190;120;181260.0;114480.0;295740.0
290390;201807;2502;1561;941;1486221.6;895520.0;2381741.5
290395;201807;243;135;108;128265.8;103032.0;231297.8
290400;201807;282;209;73;199100.0;69642.0;268742.0
290405;201807;250;218;32;207972.0;30528.0;238500.0
290410;201807;580;497;83;471133.62;79182.0;550315.6
290420;201807;239;188;51;179352.0;48654.0;228006.0
290430;201807;492;308;184;293832.0;175536.0;469368.0
290440;201807;73;65;8;62010.0;7632.0;69642.0
290450;201807;230;177;53;168858.0;50562.0;219420.0
290460;201807;1880;1119;761;1065657.8;725231.3;1790889.1
290470;201807;1441;608;833;578903.25;794367.4;1373270.6
290475;201807;588;548;40;521647.0;38160.0;559807.0
290480;201807;292;163;129;155502.0;123066.0;278568.0
290485;201807;231;215;16;205110.0;15264.0;220374.0
290490;201807;1172;842;330;803268.0;313866.2;1117134.2
290500;201807;690;352;338;334854.0;322452.0;657306.0
290510;201807;220;169;51;160558.2;48654.0;209212.2
290515;201807;135;80;55;76320.0;52470.0;128790.0
290520;201807;1421;922;499;877013.56;472518.22;1349531.8
290530;201807;314;285;29;271890.0;27666.0;299556.0
290540;201807;95;58;37;55332.0;35298.0;90630.0
290550;201807;152;127;25;121158.0;23783.22;144941.22
290560;201807;3350;1377;1973;1312360.8;1882047.6;3194408.2
290570;201807;6019;3070;2949;2925027.5;2810151.0;5735178.5
290580;201807;1282;761;521;724753.8;496318.5;1221072.2
290590;201807;541;446;95;424693.0;90630.0;515323.0
290600;201807;1728;1196;532;1136283.0;507499.38;1643782.4
290610;201807;218;196;22;186765.0;20988.0;207753.0
290620;201807;335;298;37;284292.0;35298.0;319590.0
290630;201807;2062;880;1182;836372.7;1123876.0;1960248.8
290640;201807;150;122;28;116388.0;26712.0;143100.0
290650;201807;1720;810;910;771777.0;868140.0;1639917.0
290660;201807;288;232;56;221328.0;53424.0;274752.0
290670;201807;1001;517;484;492646.0;461390.38;954036.4
290680;201807;1197;961;236;915553.8;224190.0;1139743.8
290682;201807;291;214;77;203845.3;73439.46;277284.75
290685;201807;232;149;83;141192.0;79182.0;220374.0
290687;201807;924;608;316;577516.1;301464.0;878980.1
290689;201807;131;75;56;71536.0;53409.69;124945.69
290690;201807;650;266;384;253735.92;365456.8;619192.75
290700;201807;246;117;129;111618.0;123066.0;234684.0
290710;201807;708;477;231;455058.0;220374.0;675432.0
290720;201807;1025;833;192;794396.0;182691.0;977087.0
290730;201807;1142;655;487;623010.5;463644.0;1086654.5
290740;201807;16;13;3;12402.0;2862.0;15264.0
290750;201807;1378;632;746;601015.25;710368.8;1311384.0
290755;201807;73;64;9;61056.0;8586.0;69642.0
290760;201807;303;261;42;248994.0;40068.0;289062.0
290770;201807;190;178;12;169802.45;11162.0;180964.45
290780;201807;986;789;197;750763.44;186125.4;936888.9
290790;201807;374;261;113;248994.0;107802.0;356796.0
290800;201807;2616;1058;1558;1006685.06;1485225.4;2491910.5
290810;201807;438;306;132;291638.0;125928.0;417566.0
290820;201807;388;236;152;224176.0;145008.0;369184.0
290830;201807;408;283;125;269982.0;119250.0;389232.0
290840;201807;1713;1056;657;1005278.8;624698.5;1629977.2
290850;201807;776;426;350;406404.0;332946.0;739350.0
290860;201807;644;289;355;275706.0;338384.0;614090.0
290870;201807;662;476;186;452883.8;177444.0;630327.8
290880;201807;125;68;57;64872.0;54378.0;119250.0
290890;201807;335;237;98;226098.0;93492.0;319590.0
290900;201807;171;129;42;123066.0;40068.0;163134.0
290910;201807;366;277;89;264258.0;84906.0;349164.0
290920;201807;232;198;34;188892.0;32436.0;221328.0
290930;201807;832;633;199;603882.0;189827.0;793709.0
290940;201807;250;206;44;195760.8;41976.0;237736.8
290950;201807;170;97;73;92538.0;69642.0;162180.0
290960;201807;449;303;146;287822.25;138997.8;426820.03
290970;201807;252;222;30;211597.2;28620.0;240217.2
290980;201807;1512;1068;444;1014703.75;422527.2;1437231.0
290990;201807;378;317;61;302389.9;58138.38;360528.3
291000;201807;868;244;624;232776.0;595009.8;827785.8
291005;201807;2150;908;1242;864171.75;1184091.0;2048262.8
291010;201807;155;139;16;132606.0;15264.0;147870.0
291020;201807;103;81;22;77274.0;20988.0;98262.0
291030;201807;96;70;26;66780.0;24804.0;91584.0
291040;201807;576;291;285;277614.0;271890.0;549504.0
291050;201807;1360;764;596;727497.44;568584.0;1296081.4
291060;201807;1506;830;676;791152.2;644904.0;1436056.2
291070;201807;1898;1401;497;1331462.5;472877.5;1804340.0
291072;201807;7390;2714;4676;2585501.2;4458720.5;7044222.0
291075;201807;209;170;39;161703.0;37206.0;198909.0
291077;201807;49;33;16;31482.0;15264.0;46746.0
291080;201807;19885;8769;11116;8343796.0;1,06E+14;1,89E+14
291085;201807;294;237;57;226098.0;54373.23;280471.22
291090;201807;305;120;185;114194.0;176480.45;290674.47
291100;201807;664;193;471;184122.0;449334.0;633456.0
291110;201807;403;302;101;288088.9;96354.0;384442.9
291120;201807;2521;1214;1307;1158013.0;1245863.5;2403876.5
291125;201807;61;31;30;29574.0;28620.0;58194.0
291130;201807;216;190;26;181260.0;24804.0;206064.0
291140;201807;137;102;35;97022.0;33104.0;130126.0
291150;201807;371;147;224;140238.0;213696.0;353934.0
291160;201807;372;309;63;293832.5;60102.0;353934.5
291165;201807;24;20;4;19080.0;3816.0;22896.0
291170;201807;2978;1490;1488;1417406.1;1416229.1;2833635.2
291180;201807;1320;511;809;487297.38;771671.75;1258969.1
291185;201807;75;73;2;69642.0;1908.0;71550.0
291190;201807;1269;553;716;524879.8;682234.8;1207114.6
291200;201807;168;124;44;118296.0;41976.0;160272.0
291210;201807;2221;877;1344;833519.3;1280364.1;2113883.5
291220;201807;275;206;69;195570.64;65826.0;261396.64
291230;201807;1026;351;675;334568.0;643950.0;978518.0
291240;201807;437;414;23;393716.0;21942.0;415658.0
291250;201807;436;356;80;339624.0;76320.0;415944.0
291260;201807;47;36;11;34344.0;10494.0;44838.0
291270;201807;1208;492;716;469368.0;682777.8;1152145.8
291280;201807;374;172;202;163882.89;192698.45;356581.34
291290;201807;1758;896;862;853353.2;821014.0;1674367.2
291300;201807;225;177;48;168190.2;45792.0;213982.2
291310;201807;227;203;24;193662.0;22896.0;216558.0
291320;201807;1402;1000;402;951138.0;382459.28;1333597.2
291330;201807;129;113;16;105989.4;15264.0;121253.4
291340;201807;155;88;67;83952.0;63918.0;147870.0
291345;201807;134;87;47;82998.0;44838.0;127836.0
291350;201807;1598;528;1070;503521.2;1020589.3;1524110.5
291360;201807;8615;4268;4347;4059611.8;4144516.8;8204128.5
291370;201807;1111;619;492;590240.0;469368.0;1059608.0
291380;201807;262;206;56;196524.0;53137.8;249661.8
291390;201807;3891;1704;2187;1620230.2;2084299.8;3704530.0
291400;201807;2083;1492;591;1419742.8;562131.5;1981874.2
291410;201807;153;133;20;125928.0;19080.0;145008.0
291420;201807;114;84;30;80136.0;28620.0;108756.0
291430;201807;167;95;72;89923.0;67734.53;157657.53
291440;201807;499;400;99;378876.3;94446.0;473322.3
291450;201807;899;565;334;537770.8;317682.0;855452.8
291460;201807;1749;1417;332;1350053.1;316728.0;1666781.1
291465;201807;2216;1033;1183;984879.3;1128262.0;2113141.5
291470;201807;2782;1411;1371;1342461.1;1307195.0;2649656.0
291480;201807;11810;5233;6577;4980467.0;6265892.0;1,12E+14
291490;201807;559;237;322;226098.0;307188.0;533286.0
291500;201807;370;205;165;195570.0;157410.0;352980.0
291510;201807;1242;476;766;452943.0;730477.8;1183420.8
291520;201807;959;436;523;415944.0;498932.47;914876.44
291530;201807;1006;270;736;257580.0;701838.75;959418.75
291535;201807;117;98;19;93492.0;18126.0;111618.0
291540;201807;363;106;257;101124.0;244224.6;345348.6
291550;201807;1191;559;632;531380.1;602624.0;1134004.1
291560;201807;5509;2806;2703;2664273.8;2566286.8;5230560.5
291570;201807;203;102;101;97308.0;96354.0;193662.0
291580;201807;1232;750;482;714447.44;459814.22;1174261.8
291590;201807;85;34;51;32242.9;48654.0;80896.9
291600;201807;1374;631;743;601020.0;708518.0;1309538.0
291610;201807;1465;683;782;650408.56;746000.0;1396408.6
291620;201807;583;272;311;259488.0;296312.4;555800.4
291630;201807;496;165;331;157410.0;315774.0;473184.0
291640;201807;3905;1975;1930;1874768.8;1839862.5;3714631.2
291650;201807;417;279;138;265213.0;130852.73;396065.72
291660;201807;433;172;261;163395.95;247896.9;411292.88
291670;201807;224;143;81;135850.0;77274.0;213124.0
291680;201807;695;393;302;374922.0;288003.47;662925.44
291685;201807;592;323;269;307904.0;256435.2;564339.2
291690;201807;573;296;277;282384.0;263295.0;545679.0
291700;201807;936;737;199;702368.2;188892.0;891260.2
291710;201807;1698;797;901;759642.25;858677.06;1618319.4
291720;201807;402;264;138;251851.23;131652.0;383503.22
291730;201807;953;563;390;535146.7;372050.47;907197.2
291733;201807;265;183;82;174295.8;78228.0;252523.8
291735;201807;66;52;14;49608.0;13356.0;62964.0
291740;201807;352;269;83;256626.0;79182.0;335808.0
291750;201807;1977;1312;665;1244256.2;633588.0;1877844.2
291760;201807;3054;1676;1378;1593037.0;1312227.0;2905264.0
291770;201807;806;538;268;511153.25;255672.0;766825.25
291780;201807;46;28;18;26712.0;17172.0;43884.0
291790;201807;167;80;87;76320.0;82998.0;159318.0
291800;201807;10044;4066;5978;3867294.2;5698857.0;9566151.0
291810;201807;1136;818;318;779508.8;303372.0;1082880.9
291820;201807;267;192;75;183168.0;71550.0;254718.0
291830;201807;1092;420;672;399291.0;640125.0;1039416.0
291835;201807;603;554;49;528386.0;46746.0;575132.0
291840;201807;4681;2419;2262;2301773.2;2156432.2;4458205.5
291845;201807;296;101;195;96354.0;186001.38;282355.38
291850;201807;327;284;43;270697.5;41022.0;311719.5
291855;201807;269;106;163;101124.0;155502.0;256626.0
291860;201807;173;105;68;99216.0;64872.0;164088.0
291870;201807;85;35;50;33390.0;47700.0;81090.0
291875;201807;186;169;17;161226.0;16218.0;177444.0
291880;201807;490;386;104;367434.0;99216.0;466650.0
291890;201807;242;80;162;76310.46;153117.2;229427.66
291900;201807;55;32;23;30528.0;21942.0;52470.0
291905;201807;133;93;40;88436.0;38160.0;126596.0
291910;201807;177;144;33;137376.0;31482.0;168858.0
291915;201807;393;347;46;329370.0;43884.0;373254.0
291920;201807;5001;2598;2403;2475058.0;2290797.8;4765856.0
291930;201807;184;107;77;102078.0;73458.0;175536.0
291940;201807;321;176;145;167207.58;137376.0;304583.6
291950;201807;1149;935;214;891227.0;204156.0;1095383.0
291955;201807;1076;644;432;614376.0;411985.0;1026361.0
291960;201807;181;129;52;123066.0;49321.8;172387.8
291970;201807;776;589;187;561906.0;178398.0;740304.0
291980;201807;1509;1334;175;1269541.6;165996.4;1435538.0
291990;201807;129;120;9;114480.0;8586.0;123066.0
291992;201807;165;86;79;81280.8;75366.0;156646.8
291995;201807;144;101;43;96354.0;41022.0;137376.0
292000;201807;388;297;91;281144.94;86814.0;367958.94
292010;201807;288;204;84;193662.8;79182.0;272844.8
292020;201807;277;200;77;190800.0;73458.0;264258.0
292030;201807;139;108;31;103032.0;29574.0;132606.0
292040;201807;633;324;309;309096.0;294786.0;603882.0
292045;201807;95;86;9;82044.0;8586.0;90630.0
292050;201807;903;633;270;602872.7;257294.0;860166.7
292060;201807;937;776;161;738397.25;153594.0;891991.25
292070;201807;50;21;29;20034.0;27666.0;47700.0
292080;201807;117;82;35;78228.0;33390.0;111618.0
292090;201807;504;178;326;169621.2;311004.0;480625.2
292100;201807;1413;607;806;577504.7;767370.5;1344875.2
292105;201807;205;174;31;165996.0;29574.0;195570.0
292110;201807;2113;779;1334;742860.75;1270202.9;2013063.5
292120;201807;650;520;130;494947.78;124020.0;618967.8
292130;201807;453;265;188;252810.0;179352.0;432162.0
292140;201807;195;154;41;146916.0;38982.26;185898.27
292145;201807;162;86;76;81758.0;72461.07;154219.06
292150;201807;1428;1143;285;1090422.0;270862.16;1361284.1
292160;201807;180;145;35;138043.8;33390.0;171433.8
292170;201807;1205;1057;148;1006685.3;141134.77;1147820.1
292180;201807;208;148;60;141192.0;57240.0;198432.0
292190;201807;161;97;64;92538.0;61056.0;153594.0
292200;201807;1286;468;818;445500.72;779723.56;1225224.2
292205;201807;121;108;13;102745.8;12402.0;115147.8
292210;201807;367;255;112;241887.0;106848.0;348735.0
292220;201807;21;16;5;15264.0;4770.0;20034.0
292225;201807;38;35;3;33390.0;2862.0;36252.0
292230;201807;935;754;181;717762.25;172674.0;890436.25
292240;201807;621;449;172;427249.0;164088.0;591337.0
292250;201807;1730;1113;617;1061802.0;588332.0;1650134.0
292260;201807;445;251;194;239454.0;184312.8;423766.8
292265;201807;265;187;78;178111.8;74412.0;252523.8
292270;201807;775;341;434;325314.0;413082.8;738396.8
292273;201807;202;112;90;106070.49;85860.0;191930.48
292275;201807;169;86;83;82044.0;78895.8;160939.8
292280;201807;139;99;40;94446.0;38160.0;132606.0
292285;201807;64;54;10;50848.2;9540.0;60388.2
292290;201807;566;381;185;361089.4;176204.0;537293.44
292300;201807;1645;624;1021;595010.0;973200.56;1568210.6
292303;201807;97;68;29;64872.0;27666.0;92538.0
292305;201807;109;78;31;74412.0;29574.0;103986.0
292310;201807;823;527;296;502396.0;281086.16;783482.1
292320;201807;661;498;163;474805.8;155502.0;630307.8
292330;201807;185;100;85;95400.0;81090.0;176490.0
292335;201807;281;219;62;208926.0;59148.0;268074.0
292340;201807;579;403;176;383722.84;167904.0;551626.9
292350;201807;271;145;126;137519.1;119917.8;257436.9
292360;201807;705;534;171;507719.0;163134.0;670853.0
292370;201807;767;587;180;559998.0;171720.0;731718.0
292380;201807;651;505;146;480816.4;139284.0;620100.44
292390;201807;501;190;311;181260.0;294929.5;476189.5
292400;201807;3393;2088;1305;1973013.5;1241089.8;3214103.2
292405;201807;262;174;88;165519.0;83665.8;249184.8
292410;201807;150;88;62;83952.0;59148.0;143100.0
292420;201807;306;262;44;249661.8;41976.0;291637.8
292430;201807;528;412;116;393048.0;110187.0;503235.0
292440;201807;588;502;86;477400.8;81757.8;559158.6
292450;201807;249;192;57;183168.0;54378.0;237546.0
292460;201807;586;433;153;412023.8;145866.6;557890.4
292465;201807;205;170;35;162180.0;32652.09;194832.1
292467;201807;105;62;43;59148.0;41022.0;100170.0
292470;201807;267;180;87;171720.0;82998.0;254718.0
292480;201807;338;222;116;210834.5;110378.0;321212.5
292490;201807;223;149;74;142146.0;70596.0;212742.0
292500;201807;1157;502;655;478697.0;624526.25;1103223.2
292510;201807;3346;1517;1829;1446264.1;1741995.6;3188259.8
292520;201807;1079;519;560;493261.7;534231.0;1027492.7
292525;201807;387;278;109;265207.22;103986.0;369193.22
292530;201807;4258;1753;2505;1669683.0;2388560.0;4058243.0
292540;201807;476;256;220;244224.0;209880.0;454104.0
292550;201807;1060;574;486;546873.8;463082.47;1009956.3
292560;201807;322;303;19;289062.0;18126.0;307188.0
292570;201807;303;231;72;220045.0;68688.0;288733.0
292575;201807;466;298;168;284006.0;160272.0;444278.0
292580;201807;928;590;338;561429.0;322166.0;883595.0
292590;201807;522;448;74;427089.6;70596.0;497685.6
292593;201807;142;112;30;106848.0;28620.0;135468.0
292595;201807;183;141;42;134514.0;40068.0;174582.0
292600;201807;1243;923;320;880225.0;304612.2;1184837.2
292610;201807;130;100;30;95400.0;28362.42;123762.42
292620;201807;531;441;90;420419.0;85860.0;506279.0
292630;201807;1381;796;585;757796.0;556459.1;1314255.1
292640;201807;787;549;238;523412.1;227052.0;750464.1
292650;201807;176;149;27;141710.0;25758.0;167468.0
292660;201807;1999;1436;563;1365074.0;532904.8;1897978.9
292665;201807;140;103;37;98262.0;35298.0;133560.0
292670;201807;404;327;77;311954.0;73458.0;385412.0
292680;201807;259;201;58;191754.0;54855.0;246609.0
292690;201807;188;145;43;138330.0;41022.0;179352.0
292700;201807;929;618;311;588618.8;296694.0;885312.8
292710;201807;102;90;12;85860.0;11448.0;97308.0
292720;201807;844;478;366;455210.62;348974.0;804184.6
292730;201807;200;94;106;88722.5;101124.0;189846.5
292740;201807;67364;33328;34036;3,17E+14;3,24E+13;6,42E+13
292750;201807;375;266;109;252810.94;103175.57;355986.5
292760;201807;324;262;62;248937.5;59148.0;308085.5
292770;201807;796;334;462;318350.0;440748.0;759098.0
292780;201807;412;155;257;147356.28;245178.0;392534.28
292790;201807;744;367;377;350118.0;359419.5;709537.5
292800;201807;1156;709;447;675432.0;426151.8;1101583.8
292805;201807;427;124;303;117771.3;289062.0;406833.3
292810;201807;1495;859;636;818627.8;606734.44;1425362.2
292820;201807;745;603;142;573354.9;135172.8;708527.7
292830;201807;103;82;21;78228.0;20034.0;98262.0
292840;201807;660;546;114;520694.0;108741.69;629435.7
292850;201807;130;87;43;82998.0;41022.0;124020.0
292860;201807;2209;1290;919;1226589.0;876726.0;2103315.0
292870;201807;3429;2306;1123;2198661.8;1071332.5;3269994.2
292880;201807;1471;965;506;916843.9;481558.0;1398401.9
292890;201807;492;421;71;401606.0;67734.0;469340.0
292895;201807;137;91;46;86123.3;43884.0;130007.3
292900;201807;394;288;106;274752.0;101124.0;375876.0
292905;201807;454;235;219;224190.0;208926.0;433116.0
292910;201807;418;316;102;301131.0;97308.0;398439.0
292920;201807;548;244;304;232776.0;290016.0;522792.0
292925;201807;501;464;37;441978.66;35279.0;477257.66
292930;201807;579;361;218;344394.0;207972.0;552366.0
292935;201807;291;126;165;120204.0;157410.0;277614.0
292937;201807;236;162;74;154548.0;70596.0;225144.0
292940;201807;195;148;47;141192.0;44838.0;186030.0
292950;201807;1126;578;548;548287.3;521839.0;1070126.2
292960;201807;555;375;180;357750.0;171720.0;529470.0
292970;201807;267;188;79;178685.0;75366.0;254051.0
292975;201807;155;87;68;82998.0;64682.0;147680.0
292980;201807;253;171;82;162304.44;78228.0;240532.44
292990;201807;1314;976;338;923767.9;322264.94;1246032.8
293000;201807;105;76;29;72504.0;27666.0;100170.0
293010;201807;2703;1648;1055;1566049.4;1002289.94;2568339.2
293015;201807;660;526;134;501586.5;127197.0;628783.5
293020;201807;334;274;60;261396.0;57240.0;318636.0
293030;201807;617;539;78;513634.0;74412.0;588046.0
293040;201807;342;269;73;256626.0;69642.0;326268.0
293050;201807;2745;1600;1145;1517845.8;1088477.4;2606323.2
293060;201807;256;206;50;195337.0;46746.8;242083.8
293070;201807;3439;1756;1683;1667657.6;1604361.9;3272019.5
293075;201807;91;59;32;56286.0;30528.0;86814.0
293076;201807;71;48;23;45792.0;21942.0;67734.0
293077;201807;445;275;170;258503.27;162180.0;420683.28
293080;201807;451;402;49;383508.0;46746.0;430254.0
293090;201807;131;115;16;109710.0;15264.0;124974.0
293100;201807;522;368;154;351072.0;146916.0;497988.0
293105;201807;340;236;104;224858.0;99216.0;324074.0
293110;201807;174;123;51;117342.0;48654.0;165996.0
293120;201807;318;215;103;205110.0;98071.2;303181.2
293130;201807;246;166;80;158364.0;76320.0;234684.0
293135;201807;8015;3162;4853;3009726.2;4621703.5;7631429.5
293140;201807;185;120;65;114480.0;61247.0;175727.0
293150;201807;329;281;48;267311.0;45792.0;313103.0
293160;201807;430;247;183;235638.0;174582.0;410220.0
293170;201807;190;131;59;124974.0;55428.0;180402.0
293180;201807;468;319;149;304040.0;142146.0;446186.0
293190;201807;1297;900;397;853950.75;378738.0;1232688.8
293200;201807;532;470;62;447300.0;58337.1;505637.1
293210;201807;357;267;90;254566.0;85144.5;339710.5
293220;201807;2672;1081;1591;1029340.44;1515668.0;2545008.5
293230;201807;1773;646;1127;614057.8;1075158.0;1689215.8
293240;201807;219;201;18;191754.0;17172.0;208926.0
293245;201807;112;94;18;89676.0;17172.0;106848.0
293250;201807;737;279;458;265918.0;436932.0;702850.0
293260;201807;310;261;49;248040.17;46746.0;294786.16
293270;201807;1175;560;615;532332.7;586710.0;1119042.6
293280;201807;249;141;108;134514.0;103032.0;237546.0
293290;201807;3075;2022;1053;1928034.0;1004549.0;2932583.0
293300;201807;714;507;207;481631.7;194997.6;676629.3
293305;201807;148;127;21;121158.0;20034.0;141192.0
293310;201807;138;104;34;99216.0;32436.0;131652.0
293315;201807;151;116;35;110664.0;33390.0;144054.0
293317;201807;96;68;28;64872.0;26712.0;91584.0
293320;201807;969;564;405;537102.5;386370.0;923472.5
293325;201807;188;64;124;61056.0;118257.84;179313.84
293330;201807;12999;6109;6890;5818161.0;6565514.0;1,24E+14
293340;201807;255;184;71;175536.0;66780.0;242316.0
293345;201807;242;192;50;183168.0;47700.0;230868.0
293350;201807;641;348;293;331992.0;278043.3;610035.3
293360;201807;1575;1128;447;1075158.0;426151.8;1501309.8
310010;201807;153;79;74;75366.0;70310.0;145676.0
310020;201807;1056;582;474;553367.9;450001.9;1003369.8
310030;201807;334;272;62;258362.88;59148.0;317510.88
310040;201807;49;30;19;28620.0;18126.0;46746.0
310050;201807;187;124;63;117914.4;59816.0;177730.4
310060;201807;240;168;72;159795.0;68402.0;228197.0
310070;201807;16;8;8;7632.0;7632.0;15264.0
310080;201807;48;26;22;24804.0;20988.0;45792.0
310090;201807;972;520;452;490166.88;430063.6;920230.5
310100;201807;298;228;70;217512.0;66780.0;284292.0
310110;201807;736;394;342;374554.9;325018.47;699573.4
310120;201807;393;214;179;202916.2;170391.94;373308.12
310130;201807;33;21;12;20034.0;11448.0;31482.0
310140;201807;26;14;12;13356.0;11448.0;24804.0
310150;201807;1290;882;408;833560.3;388373.8;1221934.1
310160;201807;2101;1069;1032;1012005.75;981857.2;1993862.9
310163;201807;93;53;40;50562.0;38160.0;88722.0
310170;201807;2628;1117;1511;1064826.2;1438919.4;2503745.5
310180;201807;135;52;83;49608.0;78800.4;128408.4
310190;201807;490;332;158;316728.0;150159.6;466887.6
310200;201807;506;325;181;310050.0;172674.0;482724.0
310205;201807;58;45;13;42930.0;12402.0;55332.0
310210;201807;271;220;51;209880.0;48654.0;258534.0
310220;201807;58;35;23;33390.0;21942.0;55332.0
310230;201807;266;185;81;176299.2;77274.0;253573.2
310240;201807;100;87;13;82759.5;12402.0;95161.5
310250;201807;99;79;20;75366.0;19080.0;94446.0
310260;201807;793;427;366;404402.25;348429.4;752831.7
310270;201807;274;185;89;175937.0;84906.0;260843.0
310280;201807;361;272;89;258821.0;84906.0;343727.0
310285;201807;217;155;62;147561.86;59148.0;206709.86
310290;201807;255;146;109;139284.0;103986.0;243270.0
310300;201807;154;127;27;121158.0;25758.0;146916.0
310310;201807;9;7;2;6678.0;1908.0;8586.0
310320;201807;24;14;10;13356.0;9540.0;22896.0
310330;201807;32;24;8;22896.0;7632.0;30528.0
310340;201807;1726;1125;601;1065237.6;571256.5;1636494.1
310350;201807;2859;1551;1308;1475785.8;1246964.6;2722750.5
310360;201807;39;32;7;30528.0;6678.0;37206.0
310370;201807;127;104;23;99216.0;21656.0;120872.0
310375;201807;112;41;71;39114.0;67715.0;106829.0
310380;201807;53;31;22;28668.0;20988.0;49656.0
310390;201807;103;70;33;66780.0;31482.0;98262.0
310400;201807;2383;1548;835;1472596.0;796017.8;2268613.8
310410;201807;125;68;57;64872.0;54378.0;119250.0
310420;201807;667;354;313;336858.2;297639.06;634497.25
310430;201807;326;217;109;206779.5;103986.0;310765.5
310440;201807;70;41;29;39114.0;27666.0;66780.0
310445;201807;82;66;16;62964.0;15264.0;78228.0
310450;201807;854;537;317;512298.0;302418.0;814716.0
310460;201807;264;192;72;183168.0;68688.0;251856.0
310470;201807;506;326;180;311004.0;171720.0;482724.0
310480;201807;79;57;22;54378.0;20988.0;75366.0
310490;201807;515;244;271;231822.0;258534.0;490356.0
310500;201807;126;53;73;50562.0;69642.0;120204.0
310510;201807;600;396;204;376544.6;194607.0;571151.6
310520;201807;131;88;43;83952.0;41022.0;124974.0
310530;201807;87;39;48;37206.0;45505.8;82711.8
310540;201807;464;287;177;271414.6;168571.8;439986.4
310550;201807;86;57;29;54378.0;27666.0;82044.0
310560;201807;2988;2054;934;1948748.5;890415.9;2839164.5
310570;201807;120;81;39;77274.0;37206.0;114480.0
310590;201807;353;235;118;222235.8;112557.69;334793.5
310600;201807;161;91;70;84382.7;66780.0;151162.7
310610;201807;61;24;37;22896.0;35298.0;58194.0
310620;201807;46399;22279;24120;2,12E+14;2,30E+14;4,41E+14
310630;201807;613;393;220;371631.2;208545.4;580176.6
310640;201807;146;120;26;114289.2;24804.0;139093.2
310650;201807;166;146;20;138044.0;19080.0;157124.0
310660;201807;94;58;36;55332.0;34344.0;89676.0
310665;201807;56;40;16;38160.0;15264.0;53424.0
310670;201807;6462;2938;3524;2795726.2;3358680.0;6154406.5
310680;201807;59;39;20;37206.0;19080.0;56286.0
310690;201807;617;449;168;421701.97;160272.0;581974.0
310700;201807;59;38;21;36252.0;19890.9;56142.9
310710;201807;1241;841;400;800516.44;381027.8;1181544.2
310720;201807;91;29;62;27666.0;59148.0;86814.0
310730;201807;1369;958;411;912692.5;391808.0;1304500.5
310740;201807;987;552;435;523460.4;414456.25;937916.7
310750;201807;245;143;102;135468.19;97308.0;232776.19
310760;201807;65;48;17;45792.0;15932.0;61724.0
310770;201807;95;44;51;41976.0;48654.0;90630.0
310780;201807;396;324;72;308514.6;68688.0;377202.6
310790;201807;99;81;18;77274.0;17172.0;94446.0
310800;201807;459;223;236;212265.0;224857.8;437122.8
310810;201807;169;118;51;111513.2;47700.0;159213.2
310820;201807;357;283;74;269982.0;70309.8;340291.8
310825;201807;200;163;37;155502.0;35298.0;190800.0
310830;201807;469;224;245;213035.94;233730.0;446765.94
310840;201807;380;218;162;207972.0;154548.0;362520.0
310850;201807;107;85;22;81090.0;20988.0;102078.0
310855;201807;380;300;80;286200.0;76320.0;362520.0
310860;201807;1407;1054;353;1001653.9;335026.9;1336680.8
310870;201807;54;42;12;40068.0;11448.0;51516.0
310880;201807;82;64;18;60769.8;17172.0;77941.8
310890;201807;314;186;128;177444.0;122112.0;299556.0
310900;201807;638;297;341;280700.28;325008.8;605709.06
310910;201807;244;166;78;157029.2;74412.0;231441.2
310920;201807;484;288;196;270937.2;186984.0;457921.2
310925;201807;42;34;8;32436.0;7346.0;39782.0
310930;201807;1093;662;431;631431.5;411078.3;1042509.8
310940;201807;682;350;332;333613.8;316728.0;650341.8
310945;201807;116;71;45;67734.0;42930.0;110664.0
310950;201807;252;200;52;190800.0;49608.0;240408.0
310960;201807;84;30;54;28620.0;51512.0;80132.0
310970;201807;168;104;64;99216.0;60133.76;159349.77
310980;201807;42;22;20;20988.0;19080.0;40068.0
310990;201807;153;86;67;81758.0;63918.0;145676.0
311000;201807;864;424;440;400967.7;419751.0;820718.7
311010;201807;39;32;7;30528.0;6678.0;37206.0
311020;201807;42;26;16;24804.0;15264.0;40068.0
311030;201807;384;230;154;217512.0;146535.0;364047.0
311040;201807;40;35;5;33390.0;4770.0;38160.0
311050;201807;465;192;273;182596.0;259869.6;442465.6
311060;201807;771;437;334;414799.6;318350.0;733149.6
311070;201807;336;155;181;147870.0;172674.0;320544.0
311080;201807;106;58;48;55332.0;45792.0;101124.0
311090;201807;390;185;205;175536.0;195570.0;371106.0
311100;201807;610;363;247;346015.8;235065.6;581081.4
311110;201807;681;470;211;448093.8;201285.0;649378.8
311115;201807;69;51;18;48654.0;17172.0;65826.0
311120;201807;1068;569;499;539628.2;475139.9;1014768.1
311130;201807;407;240;167;228769.2;159318.0;388087.2
311140;201807;163;83;80;78895.8;75509.1;154404.9
311150;201807;358;233;125;222282.0;119011.5;341293.5
311160;201807;743;536;207;508959.4;197001.0;705960.4
311170;201807;78;58;20;55332.0;18793.8;74125.8
311180;201807;352;235;117;223903.8;111332.0;335235.8
311190;201807;35;17;18;16218.0;17172.0;33390.0
311200;201807;339;238;101;225430.6;96354.0;321784.6
311205;201807;31;21;10;20034.0;9158.4;29192.4
311210;201807;49;42;7;39782.0;6678.0;46460.0
311220;201807;19;17;2;16218.0;1908.0;18126.0
311230;201807;1630;1069;561;1015460.75;535194.0;1550654.8
311240;201807;179;114;65;108552.33;62010.0;170562.33
311250;201807;89;30;59;28620.0;56286.0;84906.0
311260;201807;552;347;205;331038.0;195570.0;526608.0
311265;201807;114;80;34;76320.0;32436.0;108756.0
311270;201807;285;206;79;196524.0;75366.0;271890.0
311280;201807;214;97;117;92538.0;111045.6;203583.6
311290;201807;107;87;20;82998.0;18794.0;101792.0
311300;201807;554;353;201;336762.0;191468.0;528230.0
311310;201807;25;19;6;18126.0;5724.0;23850.0
311320;201807;671;498;173;474138.0;165042.0;639180.0
311330;201807;1046;766;280;730525.5;266166.4;996691.9
311340;201807;2656;1883;773;1786854.1;735802.7;2522656.8
311350;201807;275;209;66;199386.0;62964.0;262350.0
311360;201807;176;106;70;101124.0;66780.0;167904.0
311370;201807;1209;496;713;471190.5;679629.6;1150820.1
311380;201807;7;6;1;5724.0;954.0;6678.0
311390;201807;282;150;132;143100.0;125737.2;268837.2
311400;201807;150;99;51;94446.0;48654.0;143100.0
311410;201807;101;57;44;54092.0;41976.0;96068.0
311420;201807;300;167;133;157410.8;126882.0;284292.8
311430;201807;869;565;304;537103.2;289730.0;826833.2
311440;201807;490;342;148;326268.0;140905.8;467173.8
311450;201807;324;203;121;193662.0;115434.0;309096.0
311455;201807;305;207;98;197182.8;93373.45;290556.25
311460;201807;137;58;79;55332.0;74560.27;129892.27
311470;201807;23;13;10;12402.0;9540.0;21942.0
311480;201807;33;15;18;14310.0;17172.0;31482.0
311490;201807;16;10;6;9540.0;5724.0;15264.0
311500;201807;20;10;10;9540.0;9540.0;19080.0
311510;201807;630;439;191;416863.7;181729.1;598592.8
311520;201807;45;35;10;32722.2;9540.0;42262.2
311530;201807;1821;1366;455;1291165.1;434070.0;1725235.1
311535;201807;69;51;18;48654.0;17172.0;65826.0
311540;201807;34;29;5;27666.0;4770.0;32436.0
311545;201807;191;143;48;136422.0;45792.0;182214.0
311547;201807;33;24;9;22896.0;8586.0;31482.0
311550;201807;662;309;353;294786.0;336531.47;631317.44
311560;201807;43;28;15;26712.0;14310.0;41022.0
311570;201807;299;200;99;190227.6;94446.0;284673.6
311580;201807;314;186;128;177157.8;122112.0;299269.8
311590;201807;33;29;4;27666.0;3816.0;31482.0
311600;201807;92;74;18;70596.0;17172.0;87768.0
311610;201807;253;220;33;208926.5;31482.0;240408.5
311615;201807;106;89;17;84266.82;16027.2;100294.02
311620;201807;20;11;9;10494.0;8586.0;19080.0
311630;201807;85;71;14;67734.0;13356.0;81090.0
311640;201807;128;67;61;63918.0;58194.0;122112.0
311650;201807;129;95;34;89914.5;32436.0;122350.5
311660;201807;410;197;213;187938.0;203202.0;391140.0
311670;201807;167;107;60;101833.0;57240.0;159073.0
311680;201807;222;160;62;151738.95;58384.8;210123.75
311690;201807;18;11;7;10494.0;6678.0;17172.0
311700;201807;201;141;60;134227.8;56572.2;190800.0
311710;201807;210;133;77;126882.0;73458.0;200340.0
311720;201807;37;27;10;25472.0;9540.0;35012.0
311730;201807;564;367;197;349546.0;187938.0;537484.0
311740;201807;39;28;11;26712.0;10494.0;37206.0
311750;201807;712;480;232;456966.8;221328.0;678294.8
311760;201807;65;36;29;34344.0;27666.0;62010.0
311770;201807;395;191;204;180306.62;194616.0;374922.62
311780;201807;174;96;78;91298.0;74095.0;165393.0
311783;201807;84;75;9;71550.0;8586.0;80136.0
311787;201807;34;14;20;13356.0;19080.0;32436.0
311790;201807;264;126;138;120204.0;131652.0;251856.0
311800;201807;661;443;218;419236.3;207304.2;626540.5
311810;201807;45;38;7;36252.0;6678.0;42930.0
311820;201807;110;94;16;89676.0;15264.0;104940.0
311830;201807;1935;1219;716;1156835.1;679153.4;1835988.5
311840;201807;1031;573;458;542064.9;434223.34;976288.25
311850;201807;11;7;4;6678.0;3816.0;10494.0
311860;201807;9487;4317;5170;4101923.8;4925679.5;9027603.0
311870;201807;149;83;66;79182.0;62964.0;142146.0
311880;201807;951;707;244;672942.8;232776.0;905718.8
311890;201807;220;111;109;105894.0;103986.0;209880.0
311900;201807;83;35;48;33390.0;45792.0;79182.0
311910;201807;1409;867;542;824924.6;514969.4;1339894.0
311920;201807;230;149;81;142146.0;77274.0;219420.0
311930;201807;920;528;392;503426.0;373730.0;877156.0
311940;201807;2546;1326;1220;1262667.8;1160541.0;2423208.8
311950;201807;41;29;12;27666.0;11448.0;39114.0
311960;201807;65;46;19;43884.0;18126.0;62010.0
311970;201807;26;17;9;13928.4;8586.0;22514.4
311980;201807;43;33;10;31195.8;9540.0;40735.8
311990;201807;56;40;16;38160.0;15264.0;53424.0
311995;201807;64;45;19;42930.0;18126.0;61056.0
312000;201807;36;25;11;23563.8;10494.0;34057.8
312010;201807;83;61;22;58194.0;20988.0;79182.0
312015;201807;99;75;24;71264.0;22896.0;94160.0
312020;201807;140;87;53;82712.0;50562.0;133274.0
312030;201807;46;37;9;34631.0;8586.0;43217.0
312040;201807;82;52;30;49608.0;28620.0;78228.0
312050;201807;217;117;100;111618.0;95400.0;207018.0
312060;201807;68;41;27;39114.0;25090.2;64204.2
312070;201807;75;47;28;44838.0;26712.0;71550.0
312080;201807;536;244;292;232776.0;278568.0;511344.0
312083;201807;50;37;13;35298.0;12402.0;47700.0
312087;201807;114;92;22;87768.0;20988.0;108756.0
312090;201807;2947;1683;1264;1591659.5;1202474.4;2794133.8
312100;201807;158;111;47;105894.0;44056.0;149950.0
312110;201807;116;73;43;69642.0;41022.0;110664.0
312120;201807;143;106;37;100059.0;35298.0;135357.0
312125;201807;98;57;41;54187.2;39114.0;93301.2
312130;201807;121;81;40;77274.0;38160.0;115434.0
312140;201807;137;107;30;102078.0;28620.0;130698.0
312150;201807;48;37;11;35298.0;10494.0;45792.0
312160;201807;1539;1015;524;963731.8;498484.47;1462216.2
312170;201807;12;10;2;9540.0;1908.0;11448.0
312180;201807;102;63;39;59387.0;36920.0;96307.0
312190;201807;31;27;4;25758.0;3816.0;29574.0
312200;201807;743;640;103;608604.7;98262.0;706866.7
312210;201807;96;63;33;60102.0;31482.0;91584.0
312220;201807;125;91;34;86576.0;32436.0;119012.0
312230;201807;3576;1751;1825;1666096.5;1739680.6;3405777.0
312235;201807;156;103;53;98262.0;50562.0;148824.0
312240;201807;106;71;35;67734.0;33390.0;101124.0
312245;201807;168;115;53;109706.0;50562.0;160268.0
312247;201807;62;44;18;41213.0;17172.0;58385.0
312250;201807;184;85;99;81090.0;94446.0;175536.0
312260;201807;103;69;34;64968.2;32436.0;97404.2
312270;201807;138;85;53;81090.0;50562.0;131652.0
312280;201807;26;16;10;15264.0;9540.0;24804.0
312290;201807;162;111;51;105894.0;47701.0;153595.0
312300;201807;201;132;69;125928.0;65826.0;191754.0
312310;201807;57;52;5;49608.0;4770.0;54378.0
312320;201807;429;269;160;254718.0;151066.1;405784.1
312330;201807;88;77;11;73458.0;10207.8;83665.8
312340;201807;35;16;19;15264.0;18126.0;33390.0
312350;201807;18;11;7;10494.0;6678.0;17172.0
312352;201807;98;66;32;62964.0;30528.0;93492.0
312360;201807;559;254;305;241362.0;290970.0;532332.0
312370;201807;309;181;128;172387.8;122112.0;294499.8
312380;201807;138;90;48;85860.0;45792.0;131652.0
312385;201807;173;140;33;133273.8;31482.0;164755.8
312390;201807;301;189;112;180306.0;106181.0;286487.0
312400;201807;379;290;89;276660.0;84430.0;361090.0
312410;201807;891;287;604;273321.0;575640.0;848961.0
312420;201807;612;484;128;460782.2;122112.0;582894.2
312430;201807;868;641;227;609226.06;215604.2;824830.25
312440;201807;46;34;12;32436.0;11448.0;43884.0
312450;201807;214;132;82;125928.0;78228.0;204156.0
312460;201807;60;28;32;26712.0;30528.0;57240.0
312470;201807;55;36;19;34344.0;18126.0;52470.0
312480;201807;203;124;79;118296.0;75366.0;193662.0
312490;201807;271;187;84;178398.0;80136.0;258534.0
312500;201807;34;19;15;18126.0;14310.0;32436.0
312510;201807;445;170;275;162180.0;261734.39;423914.38
312520;201807;43;15;28;14310.0;26712.0;41022.0
312530;201807;49;37;12;35298.0;11448.0;46746.0
312540;201807;101;88;13;83952.0;12402.0;96354.0
312550;201807;39;31;8;29574.0;7632.0;37206.0
312560;201807;211;156;55;148538.0;52183.8;200721.8
312570;201807;440;262;178;249280.2;169263.45;418543.66
312580;201807;83;44;39;41976.0;37206.0;79182.0
312590;201807;267;211;56;201294.0;53424.0;254718.0
312595;201807;140;125;15;119250.0;14310.0;133560.0
312600;201807;75;46;29;43455.0;27666.0;71121.0
312610;201807;1624;858;766;811094.0;729047.6;1540141.6
312620;201807;193;138;55;131652.0;52465.23;184117.23
312630;201807;64;54;10;51516.0;9540.0;61056.0
312640;201807;47;13;34;12402.0;32436.0;44838.0
312650;201807;152;127;25;120872.0;23564.0;144436.0
312660;201807;72;54;18;51230.0;17172.0;68402.0
312670;201807;872;576;296;548551.0;282170.3;830721.3
312675;201807;41;32;9;30528.0;8586.0;39114.0
312680;201807;86;57;29;53996.4;27666.0;81662.4
312690;201807;237;125;112;119240.46;106561.8;225802.27
312695;201807;31;24;7;22896.0;6678.0;29574.0
312700;201807;215;123;92;117342.0;87768.0;205110.0
312705;201807;78;64;14;61056.0;13356.0;74412.0
312707;201807;109;80;29;75900.24;27666.0;103566.24
312710;201807;1888;1002;886;954261.6;845033.0;1799294.6
312720;201807;66;33;33;31482.0;31482.0;62964.0
312730;201807;289;169;120;160272.0;114480.0;274752.0
312733;201807;52;45;7;42644.0;6678.0;49322.0
312735;201807;22;16;6;15264.0;5724.0;20988.0
312737;201807;69;38;31;36252.0;29574.0;65826.0
312738;201807;53;38;15;36252.0;14310.0;50562.0
312740;201807;76;51;25;48368.0;23850.0;72218.0
312750;201807;70;52;18;49608.0;17172.0;66780.0
312760;201807;269;198;71;188892.0;67734.0;256626.0
312770;201807;7650;3549;4101;3363524.8;3903929.2;7267454.0
312780;201807;432;332;100;316441.8;95400.0;411841.8
312790;201807;21;16;5;15264.0;4770.0;20034.0
312800;201807;1604;1121;483;1063175.2;460591.2;1523766.5
312810;201807;371;241;130;229627.8;124020.0;353647.8
312820;201807;195;147;48;140238.0;45792.0;186030.0
312825;201807;26;17;9;16218.0;8586.0;24804.0
312830;201807;278;167;111;158079.0;105255.0;263334.0
312840;201807;150;109;41;103986.0;39114.0;143100.0
312850;201807;29;25;4;23850.0;3816.0;27666.0
312860;201807;169;102;67;97022.0;63918.0;160940.0
312870;201807;990;519;471;492232.25;449334.0;941566.25
312880;201807;151;103;48;98118.9;45696.6;143815.5
312890;201807;167;115;52;109710.0;49608.0;159318.0
312900;201807;209;156;53;148156.2;50562.0;198718.2
312910;201807;189;95;94;89539.72;89676.0;179215.72
312920;201807;158;88;70;83952.0;66780.0;150732.0
312930;201807;346;252;94;240408.0;89676.0;330084.0
312940;201807;109;74;35;70596.0;33390.0;103986.0
312950;201807;695;457;238;434928.6;227052.0;661980.6
312960;201807;174;134;40;127836.0;38160.0;165996.0
312965;201807;55;51;4;48654.0;3816.0;52470.0
312970;201807;297;237;60;225144.2;57240.0;282384.2
312980;201807;2344;1229;1115;1166736.0;1063133.6;2229869.5
312990;201807;49;28;21;26712.0;20034.0;46746.0
313000;201807;40;23;17;21942.0;16218.0;38160.0
313005;201807;168;129;39;122827.5;36920.0;159747.5
313010;201807;939;382;557;363187.8;531369.0;894556.8
313020;201807;191;100;91;94923.0;86814.0;181737.0
313030;201807;207;135;72;126883.0;68688.0;195571.0
313040;201807;68;26;42;24804.0;40068.0;64872.0
313050;201807;294;205;89;195570.0;84906.0;280476.0
313055;201807;47;35;12;33390.0;11448.0;44838.0
313060;201807;124;86;38;82044.0;35965.8;118009.8
313065;201807;60;39;21;37206.0;20034.0;57240.0
313070;201807;150;80;70;76320.0;66780.0;143100.0
313080;201807;42;18;24;17172.0;22896.0;40068.0
313090;201807;710;491;219;467126.3;208926.0;676052.3
313100;201807;165;64;101;61056.0;96346.0;157402.0
313110;201807;128;73;55;69642.0;52470.0;122112.0
313115;201807;171;94;77;89475.66;73458.0;162933.66
313120;201807;758;415;343;395624.0;325982.0;721606.0
313130;201807;5321;2883;2438;2726885.0;2316847.5;5043732.5
313140;201807;157;81;76;77274.0;72504.0;149778.0
313150;201807;313;248;65;236592.0;61723.8;298315.8
313160;201807;199;147;52;139952.0;49608.0;189560.0
313170;201807;1382;972;410;913999.94;390749.4;1304749.4
313180;201807;326;193;133;183473.28;126882.0;310355.28
313190;201807;743;444;299;420237.0;284483.0;704720.0
313200;201807;24;23;1;21942.0;954.0;22896.0
313210;201807;1046;881;165;837471.2;157405.23;994876.4
313220;201807;242;167;75;158364.0;70834.5;229198.5
313230;201807;267;197;70;186985.0;66780.0;253765.0
313240;201807;1934;1031;903;979941.75;858499.8;1838441.5
313250;201807;1270;949;321;900673.8;304327.8;1205001.6
313260;201807;98;55;43;52470.0;41022.0;93492.0
313270;201807;961;563;398;533430.1;379692.0;913122.1
313280;201807;60;52;8;49131.0;7632.0;56763.0
313290;201807;227;183;44;174296.0;41022.8;215318.8
313300;201807;382;198;184;185745.0;175536.0;361281.0
313310;201807;230;118;112;112572.0;106848.0;219420.0
313320;201807;375;286;89;270889.1;84906.0;355795.1
313330;201807;1365;838;527;798021.2;501566.5;1299587.8
313340;201807;334;233;101;222282.0;96354.0;318636.0
313350;201807;517;350;167;331992.1;159318.0;491310.1
313360;201807;114;69;45;65826.0;42644.0;108470.0
313370;201807;189;69;120;65826.0;114480.0;180306.0
313375;201807;274;163;111;155502.0;105894.0;261396.0
313380;201807;1339;692;647;657039.06;616948.0;1273987.1
313390;201807;49;44;5;41022.8;4770.0;45792.8
313400;201807;422;283;139;269982.0;132034.0;402016.0
313410;201807;21;13;8;12402.0;7632.0;20034.0
313420;201807;4698;2446;2252;2324204.5;2141445.5;4465650.0
313430;201807;142;66;76;62964.0;72307.0;135271.0
313440;201807;1485;1013;472;962933.9;449144.0;1412077.9
313450;201807;63;27;36;25758.0;34057.8;59815.8
313460;201807;377;177;200;168372.0;190800.0;359172.0
313470;201807;534;247;287;235638.0;273130.2;508768.2
313480;201807;156;108;48;102079.0;45792.0;147871.0
313490;201807;515;250;265;238495.23;252763.0;491258.22
313500;201807;21;14;7;13356.0;6678.0;20034.0
313505;201807;988;770;218;733158.75;207685.8;940844.56
313507;201807;99;60;39;57240.0;37206.0;94446.0
313510;201807;2788;1783;1005;1694904.0;957816.0;2652720.0
313520;201807;3626;2842;784;2699965.0;747932.0;3447897.0
313530;201807;45;30;15;28620.0;14310.0;42930.0
313535;201807;106;84;22;79469.0;20988.0;100457.0
313540;201807;72;54;18;51516.0;17172.0;68688.0
313545;201807;115;96;19;91584.0;18126.0;109710.0
313550;201807;233;192;41;183168.0;38828.0;221996.0
313560;201807;330;169;161;161226.0;153594.0;314820.0
313570;201807;60;32;28;30528.0;26712.0;57240.0
313580;201807;1325;732;593;695657.0;564864.0;1260521.0
313590;201807;79;47;32;44838.0;30528.0;75366.0
313600;201807;697;417;280;397532.0;266323.0;663855.0
313610;201807;59;47;12;44218.8;11448.0;55666.8
313620;201807;1368;722;646;678356.2;611351.6;1289707.8
313630;201807;1645;1257;388;1195580.4;369866.0;1565446.4
313640;201807;129;75;54;71550.0;51516.0;123066.0
313650;201807;237;109;128;103986.0;121540.0;225526.0
313652;201807;17;17;0;16218.0;0.0;16218.0
313655;201807;56;33;23;31482.0;21942.0;53424.0
313657;201807;47;44;3;41976.0;2862.0;44838.0
313660;201807;134;90;44;85860.0;41993.17;127853.17
313665;201807;658;317;341;302418.0;325075.5;627493.5
313670;201807;10318;7139;3179;6785877.0;3031621.5;9817498.0
313680;201807;41;30;11;28620.0;10390.0;39010.0
313690;201807;154;115;39;109710.0;37206.0;146916.0
313695;201807;78;59;19;56286.0;18126.0;74412.0
313700;201807;304;246;58;234398.0;55332.0;289730.0
313710;201807;145;99;46;94446.0;43884.0;138330.0
313720;201807;1104;527;577;500564.0;549113.9;1049677.9
313730;201807;61;42;19;40068.0;18126.0;58194.0
313740;201807;163;131;32;124974.0;30528.0;155502.0
313750;201807;441;322;119;307188.0;113526.0;420714.0
313753;201807;247;180;67;171052.2;63918.0;234970.2
313760;201807;1271;459;812;437600.0;771902.0;1209502.0
313770;201807;358;261;97;248024.2;92538.0;340562.2
313780;201807;766;397;369;378738.0;351739.8;730477.8
313790;201807;29;28;1;26712.0;954.0;27666.0
313800;201807;146;90;56;85860.0;53424.0;139284.0
313810;201807;69;41;28;39114.0;26712.0;65826.0
313820;201807;1280;639;641;608366.2;610251.0;1218617.2
313830;201807;68;49;19;46746.0;18126.0;64872.0
313835;201807;57;48;9;45792.0;8586.0;54378.0
313840;201807;1703;1053;650;999221.5;618574.0;1617795.5
313850;201807;183;62;121;59148.0;114854.06;174002.06
313860;201807;480;370;110;349499.3;104940.0;454439.3
313862;201807;174;115;59;109710.0;56286.0;165996.0
313865;201807;91;73;18;69642.0;17172.0;86814.0
313867;201807;48;37;11;35298.0;10494.0;45792.0
313868;201807;28;19;9;17363.0;8586.0;25949.0
313870;201807;127;65;62;62010.0;58862.0;120872.0
313880;201807;357;225;132;214650.0;125355.8;340005.8
313890;201807;325;173;152;164279.8;144435.6;308715.4
313900;201807;908;496;412;472230.5;393001.0;865231.5
313910;201807;139;100;39;95400.0;36252.2;131652.2
313920;201807;621;442;179;421477.2;170246.0;591723.2
313925;201807;32;28;4;26712.0;3816.0;30528.0
313930;201807;821;634;187;604550.0;178375.0;782925.0
313940;201807;1819;1149;670;1092234.8;638512.4;1730747.2
313950;201807;939;597;342;567726.6;325981.8;893708.4
313960;201807;1395;804;591;762752.3;560668.0;1323420.2
313970;201807;122;82;40;78228.0;38160.0;116388.0
313980;201807;215;139;76;132368.0;72504.0;204872.0
313990;201807;376;226;150;215604.0;143100.0;358704.0
314000;201807;928;626;302;593723.9;288103.22;881827.1
314010;201807;78;51;27;48654.0;25758.0;74412.0
314015;201807;53;16;37;15264.0;35298.0;50562.0
314020;201807;50;34;16;32436.0;15264.0;47700.0
314030;201807;83;37;46;35135.82;43884.0;79019.82
314040;201807;45;30;15;28620.0;14310.0;42930.0
314050;201807;314;187;127;178112.0;121158.0;299270.0
314053;201807;97;64;33;60102.4;31482.0;91584.4
314055;201807;300;179;121;170766.0;115434.0;286200.0
314060;201807;145;123;22;116388.0;20988.0;137376.0
314070;201807;1039;522;517;494183.12;492598.0;986781.1
314080;201807;220;143;77;135468.0;72408.88;207876.88
314085;201807;134;89;45;84906.0;42930.0;127836.0
314090;201807;357;258;99;246132.0;94441.23;340573.22
314100;201807;477;392;85;370153.0;80518.0;450671.0
314110;201807;716;391;325;371401.75;309477.6;680879.3
314120;201807;97;55;42;52470.0;40068.0;92538.0
314130;201807;24;11;13;10494.0;12402.0;22896.0
314140;201807;1107;672;435;637658.0;411842.47;1049500.5
314150;201807;163;104;59;99216.0;56286.0;155502.0
314160;201807;351;262;89;247086.8;84716.0;331802.8
314170;201807;78;60;18;57240.0;17172.0;74412.0
314180;201807;730;643;87;613136.0;82044.5;695180.5
314190;201807;101;60;41;57240.0;39114.0;96354.0
314200;201807;589;409;180;388915.6;170766.0;559681.6
314210;201807;282;214;68;203202.0;64586.0;267788.0
314220;201807;311;234;77;221329.0;73172.0;294501.0
314225;201807;65;47;18;44838.0;17172.0;62010.0
314230;201807;107;46;61;43884.0;58194.0;102078.0
314240;201807;139;107;32;102078.0;30528.0;132606.0
314250;201807;60;37;23;35298.0;21942.0;57240.0
314260;201807;188;95;93;90630.0;88722.0;179352.0
314270;201807;330;262;68;249948.0;64837.0;314785.0
314280;201807;696;389;307;371097.0;292878.0;663975.0
314290;201807;559;457;102;434738.5;97021.8;531760.3
314300;201807;403;288;115;272579.5;109663.0;382242.5
314310;201807;1449;977;472;930151.1;450267.97;1380419.1
314315;201807;35;29;6;27666.0;5724.0;33390.0
314320;201807;610;394;216;375303.8;205424.81;580728.6
314330;201807;10689;5394;5295;5135014.0;5046965.0;1,02E+14
314340;201807;571;266;305;253191.8;290398.0;543589.8
314345;201807;33;26;7;24804.0;6678.0;31482.0
314350;201807;191;120;71;114480.0;67734.0;182214.0
314360;201807;80;50;30;47700.0;28620.0;76320.0
314370;201807;57;48;9;45792.0;8586.0;54378.0
314380;201807;92;66;26;62964.0;24804.0;87768.0
314390;201807;3293;2096;1197;1994051.2;1138981.4;3133032.8
314400;201807;687;493;194;467452.2;185076.0;652528.2
314410;201807;439;285;154;271890.0;146916.0;418806.0
314420;201807;18;9;9;8586.0;8586.0;17172.0
314430;201807;2512;901;1611;854466.7;1534382.5;2388849.2
314435;201807;273;159;114;151399.8;107802.0;259201.8
314437;201807;28;22;6;20988.0;5724.0;26712.0
314440;201807;97;71;26;67734.0;24804.0;92538.0
314450;201807;155;114;41;108756.0;39114.0;147870.0
314460;201807;652;305;347;290970.0;331038.0;622008.0
314465;201807;84;56;28;53424.0;26712.0;80136.0
314467;201807;70;57;13;54369.0;12402.0;66771.0
314470;201807;392;205;187;192118.52;177444.5;369563.03
314480;201807;1086;516;570;492264.0;543534.94;1035798.94
314490;201807;88;66;22;62964.0;20988.0;83952.0
314500;201807;314;208;106;198432.0;101124.0;299556.0
314505;201807;128;85;43;81090.0;41022.0;122112.0
314510;201807;231;191;40;182214.0;38160.0;220374.0
314520;201807;1270;659;611;619760.3;581749.8;1201510.1
314530;201807;735;582;153;554593.0;145962.0;700555.0
314535;201807;213;134;79;126786.6;75115.01;201901.61
314537;201807;64;39;25;37206.0;23850.0;61056.0
314540;201807;14;9;5;8586.0;4770.0;13356.0
314545;201807;49;31;18;29574.0;17172.0;46746.0
314550;201807;82;44;38;41976.0;36252.0;78228.0
314560;201807;822;443;379;420141.8;361566.0;781707.8
314570;201807;22;17;5;16218.0;4770.0;20988.0
314580;201807;16;8;8;7632.0;7632.0;15264.0
314585;201807;22;17;5;16218.0;4770.0;20988.0
314587;201807;84;73;11;69642.0;10494.0;80136.0
314590;201807;583;428;155;406705.5;147584.0;554289.5
314600;201807;975;638;337;604257.06;320162.6;924419.7
314610;201807;945;514;431;487494.7;410983.2;898477.9
314620;201807;151;112;39;105607.8;37206.0;142813.8
314625;201807;97;72;25;68116.0;23850.0;91966.0
314630;201807;1235;632;603;601449.3;574689.8;1176139.1
314640;201807;91;59;32;56286.0;30241.8;86527.8
314650;201807;195;112;83;106561.8;78705.0;185266.8
314655;201807;65;50;15;47700.0;14310.0;62010.0
314660;201807;20;16;4;15264.0;3816.0;19080.0
314670;201807;193;153;40;145676.0;38160.0;183836.0
314675;201807;219;129;90;123066.0;85860.0;208926.0
314690;201807;541;300;241;285913.8;229914.0;515827.8
314700;201807;2434;1337;1097;1270491.5;1045584.9;2316076.5
314710;201807;1625;945;680;897526.7;648100.1;1545626.8
314720;201807;413;248;165;235189.62;157410.0;392599.62
314730;201807;517;272;245;257772.0;233721.0;491493.0
314740;201807;690;341;349;323930.7;332946.0;656876.7
314750;201807;20;17;3;16218.0;2862.0;19080.0
314760;201807;328;157;171;149778.0;163124.45;312902.47
314770;201807;122;83;39;79182.0;37206.0;116388.0
314780;201807;21;6;15;5724.0;14310.0;20034.0
314790;201807;2376;1490;886;1414107.2;844414.0;2258521.2
314795;201807;55;47;8;44600.0;7632.0;52232.0
314800;201807;2954;1741;1213;1655628.6;1155198.6;2810827.2
314810;201807;1518;843;675;801885.5;642329.0;1444214.5
314820;201807;93;52;41;49608.0;39114.0;88722.0
314830;201807;208;166;42;157648.5;39782.0;197430.5
314840;201807;81;46;35;43884.0;33390.0;77274.0
314850;201807;352;171;181;163134.0;172674.0;335808.0
314860;201807;711;533;178;506478.88;167618.7;674097.56
314870;201807;1480;773;707;736488.0;674478.0;1410966.0
314875;201807;57;49;8;46746.0;7632.0;54378.0
314880;201807;47;34;13;32436.0;12402.0;44838.0
314890;201807;55;33;22;31482.0;20988.0;52470.0
314900;201807;33;26;7;24804.0;6678.0;31482.0
314910;201807;252;172;80;163801.8;76320.0;240121.8
314915;201807;162;142;20;135468.0;19080.0;154548.0
314920;201807;124;77;47;73458.0;44551.8;118009.8
314930;201807;1045;528;517;501848.34;492645.6;994493.94
314940;201807;51;40;11;38160.0;10494.0;48654.0
314950;201807;38;27;11;25758.0;10494.0;36252.0
314960;201807;54;41;13;39114.0;12402.0;51516.0
314970;201807;144;74;70;70596.0;66780.0;137376.0
314980;201807;305;195;110;183788.1;103986.0;287774.1
314990;201807;469;258;211;246132.0;200388.5;446520.5
314995;201807;204;64;140;61056.0;133550.45;194606.45
315000;201807;92;75;17;71550.0;16218.0;87768.0
315010;201807;46;30;16;28620.0;15264.0;43884.0
315015;201807;176;144;32;136650.95;30528.0;167178.95
315020;201807;72;62;10;59148.0;9540.0;68688.0
315030;201807;119;91;28;85860.0;26712.0;112572.0
315040;201807;66;48;18;45792.0;17172.0;62964.0
315050;201807;200;121;79;115434.0;75080.0;190514.0
315053;201807;40;35;5;33390.0;4626.9;38016.9
315057;201807;97;80;17;75938.4;16218.0;92156.4
315060;201807;73;64;9;59149.16;8586.0;67735.16
315070;201807;102;57;45;54378.0;42930.0;97308.0
315080;201807;374;307;67;292878.0;63918.0;356796.0
315090;201807;111;67;44;63918.0;41976.0;105894.0
315100;201807;82;41;41;39114.0;39114.0;78228.0
315110;201807;293;163;130;154644.0;124020.0;278664.0
315120;201807;1664;846;818;801571.2;778178.6;1579749.9
315130;201807;346;251;95;239454.0;90630.0;330084.0
315140;201807;533;312;221;296026.2;210834.0;506860.2
315150;201807;986;469;517;446473.0;492932.0;939405.0
315160;201807;215;109;106;103986.0;101124.0;205110.0
315170;201807;334;215;119;204157.0;113239.8;317396.8
315180;201807;3201;1352;1849;1286708.2;1760990.8;3047699.0
315190;201807;319;185;134;176109.0;127836.0;303945.0
315200;201807;1204;693;511;659500.2;486635.4;1146135.6
315210;201807;1568;892;676;847821.4;642484.2;1490305.6
315213;201807;44;25;19;23850.0;18126.0;41976.0
315217;201807;213;170;43;162180.0;41022.0;203202.0
315220;201807;1549;1188;361;1132062.4;344012.6;1476075.0
315230;201807;169;124;45;118010.0;42930.0;160940.0
315240;201807;424;274;150;261396.0;141898.5;403294.5
315250;201807;2562;1261;1301;1202416.9;1240572.9;2442989.8
315260;201807;150;91;59;85860.0;56286.0;142146.0
315270;201807;132;91;41;86241.6;38388.96;124630.56
315280;201807;693;452;241;430827.0;229904.45;660731.44
315290;201807;201;118;83;112572.0;78228.49;190800.48
315300;201807;72;50;22;47700.0;20988.0;68688.0
315310;201807;68;62;6;59148.0;5724.0;64872.0
315320;201807;163;93;70;88722.0;66780.0;155502.0
315330;201807;58;50;8;47700.0;7632.0;55332.0
315340;201807;416;297;119;282155.6;113526.0;395681.6
315350;201807;152;91;61;86814.0;58194.0;145008.0
315360;201807;96;52;44;49608.0;41976.0;91584.0
315370;201807;59;35;24;32675.0;22896.0;55571.0
315380;201807;12;7;5;6678.0;4770.0;11448.0
315390;201807;64;14;50;13356.0;47700.0;61056.0
315400;201807;837;629;208;594628.5;197764.2;792392.7
315410;201807;355;217;138;206732.0;131366.0;338098.0
315415;201807;63;48;15;45792.0;14310.0;60102.0
315420;201807;205;156;49;147728.0;46746.0;194474.0
315430;201807;677;393;284;373682.0;270459.8;644141.8
315440;201807;87;60;27;57240.0;25758.0;82998.0
315445;201807;256;206;50;196209.19;47700.0;243909.19
315450;201807;177;133;44;126882.0;41976.0;168858.0
315460;201807;3485;1755;1730;1671209.4;1647693.1;3318902.5
315470;201807;43;21;22;20034.0;20988.0;41022.0
315480;201807;64;25;39;23850.0;37206.0;61056.0
315490;201807;633;394;239;373824.9;228006.0;601830.9
315500;201807;22;14;8;13356.0;7632.0;20988.0
315510;201807;154;103;51;98262.0;48654.0;146916.0
315520;201807;74;65;9;62010.0;8586.0;70596.0
315530;201807;54;29;25;27666.0;23850.0;51516.0
315540;201807;235;155;80;147870.0;76320.0;224190.0
315550;201807;179;143;36;136422.0;34344.0;170766.0
315560;201807;742;592;150;563428.8;143100.0;706528.8
315570;201807;319;166;153;155169.5;145485.0;300654.5
315580;201807;672;440;232;419093.0;221328.0;640421.0
315590;201807;207;108;99;103032.0;94446.0;197478.0
315600;201807;293;216;77;205825.5;73458.0;279283.5
315610;201807;101;49;52;46746.0;49608.0;96354.0
315620;201807;33;27;6;25758.0;5724.0;31482.0
315630;201807;136;90;46;85860.0;43884.0;129744.0
315640;201807;65;39;26;37206.0;24804.0;62010.0
315645;201807;66;47;19;44838.0;17649.0;62487.0
315650;201807;169;123;46;116770.0;43311.6;160081.6
315660;201807;479;210;269;200340.0;256626.0;456966.0
315670;201807;2430;1206;1224;1147739.4;1166523.6;2314263.0
315680;201807;863;585;278;555609.6;265212.0;820821.6
315690;201807;684;471;213;449213.0;203202.0;652415.0
315700;201807;1914;1010;904;959668.4;862321.0;1821989.4
315710;201807;331;91;240;86814.0;228960.0;315774.0
315720;201807;439;284;155;270936.0;147870.0;418806.0
315725;201807;203;162;41;154548.0;39114.0;193662.0
315727;201807;44;22;22;20988.0;20988.0;41976.0
315730;201807;46;44;2;41976.0;1908.0;43884.0
315733;201807;90;59;31;56286.0;29574.0;85860.0
315737;201807;51;39;12;37206.0;11448.0;48654.0
315740;201807;47;39;8;37206.0;7632.0;44838.0
315750;201807;158;121;37;115434.0;35298.0;150732.0
315760;201807;48;34;14;32436.0;13356.0;45792.0
315765;201807;122;78;44;74412.0;41976.0;116388.0
315770;201807;231;142;89;135468.0;84620.0;220088.0
315780;201807;3321;1726;1595;1640032.0;1518960.4;3158992.2
315790;201807;212;161;51;153594.0;48081.6;201675.6
315800;201807;288;208;80;198432.0;76320.0;274752.0
315810;201807;99;59;40;56286.0;37874.0;94160.0
315820;201807;798;579;219;549791.3;208926.0;758717.3
315830;201807;142;82;60;78228.0;57240.0;135468.0
315840;201807;94;66;28;62964.0;26712.0;89676.0
315850;201807;258;194;64;185076.0;61056.0;246132.0
315860;201807;12;4;8;3816.0;7632.0;11448.0
315870;201807;36;28;8;26712.0;7632.0;34344.0
315880;201807;109;72;37;68688.0;35298.0;103986.0
315890;201807;82;61;21;58194.0;20034.0;78228.0
315895;201807;465;313;152;297553.0;144436.0;441989.0
315900;201807;72;34;38;32150.0;36252.0;68402.0
315910;201807;39;25;14;23611.5;13356.0;36967.5
315920;201807;178;117;61;111618.0;57240.9;168858.9
315930;201807;44;15;29;14310.0;27666.0;41976.0
315935;201807;151;118;33;112572.0;31473.0;144045.0
315940;201807;91;67;24;63918.0;22896.0;86814.0
315950;201807;64;45;19;42930.0;18126.0;61056.0
315960;201807;558;261;297;247725.38;282479.6;530205.0
315970;201807;38;30;8;28620.0;7632.0;36252.0
315980;201807;700;329;371;311551.75;353934.0;665485.75
315990;201807;255;150;105;142862.0;99875.0;242737.0
316000;201807;50;33;17;31195.8;15931.8;47127.6
316010;201807;76;64;12;61056.0;11448.0;72504.0
316020;201807;111;92;19;87768.0;18126.0;105894.0
316030;201807;407;217;190;206732.0;180736.0;387468.0
316040;201807;510;216;294;205110.2;280190.0;485300.2
316045;201807;61;54;7;51516.0;6678.0;58194.0
316050;201807;16;14;2;13356.0;1908.0;15264.0
316060;201807;96;62;34;59148.0;32436.0;91584.0
316070;201807;1079;699;380;660713.4;361757.0;1022470.4
316080;201807;103;65;38;61294.5;36252.0;97546.5
316090;201807;41;25;16;23182.2;15264.0;38446.2
316095;201807;73;61;12;57918.0;11448.0;69366.0
316100;201807;312;185;127;175965.3;121158.0;297123.3
316105;201807;35;24;11;22896.0;10494.0;33390.0
316110;201807;1917;1545;372;1463484.5;354220.2;1817704.8
316120;201807;79;59;20;56286.0;18793.8;75079.8
316130;201807;137;106;31;100457.0;29574.0;130031.0
316140;201807;26;19;7;18126.0;6678.0;24804.0
316150;201807;207;144;63;136660.5;60102.0;196762.5
316160;201807;86;52;34;49608.0;32436.0;82044.0
316165;201807;64;47;17;44648.0;15502.5;60150.5
316170;201807;204;138;66;130698.0;62964.0;193662.0
316180;201807;207;91;116;86480.1;110664.0;197144.1
316190;201807;139;102;37;96354.0;35298.0;131652.0
316200;201807;702;392;310;373968.0;294881.4;668849.4
316210;201807;769;517;252;494805.4;240408.0;735213.44
316220;201807;113;78;35;74412.0;33390.0;107802.0
316225;201807;25;14;11;13356.0;10494.0;23850.0
316230;201807;31;19;12;18126.0;11448.0;29574.0
316240;201807;633;509;124;485586.0;118296.0;603882.0
316245;201807;110;92;18;87768.0;17172.0;104940.0
316250;201807;1524;1062;462;1005244.5;439565.12;1444809.6
316255;201807;110;90;20;85478.4;19065.69;104544.09
316257;201807;185;97;88;92538.0;83665.8;176203.8
316260;201807;245;161;84;152297.06;80041.0;232338.06
316265;201807;27;18;9;17172.0;8586.0;25758.0
316270;201807;677;472;205;447283.4;195570.0;642853.4
316280;201807;542;331;211;314503.8;200626.6;515130.4
316290;201807;700;466;234;441512.2;223236.0;664748.2
316292;201807;518;207;311;197191.8;296456.0;493647.8
316294;201807;100;57;43;54378.0;41022.0;95400.0
316295;201807;300;133;167;125434.0;159318.0;284752.0
316300;201807;103;73;30;69642.0;28620.0;98262.0
316310;201807;38;20;18;18793.8;17172.0;35965.8
316320;201807;41;25;16;23850.0;15264.0;39114.0
316330;201807;130;85;45;80136.5;42643.8;122780.3
316340;201807;146;99;47;94446.0;44838.0;139284.0
316350;201807;194;141;53;134348.0;50562.0;184910.0
316360;201807;23;17;6;16218.0;5724.0;21942.0
316370;201807;1089;581;508;549810.7;484336.25;1034146.94
316380;201807;122;93;29;88722.0;27666.0;116388.0
316390;201807;125;89;36;84906.0;34344.0;119250.0
316400;201807;138;104;34;99216.0;32436.0;131652.0
316410;201807;308;225;83;213266.7;79182.0;292448.7
316420;201807;207;147;60;139522.5;57240.0;196762.5
316430;201807;154;79;75;75366.0;71550.0;146916.0
316440;201807;98;47;51;44838.0;48654.0;93492.0
316443;201807;38;35;3;33390.0;2862.0;36252.0
316447;201807;65;51;14;48654.0;13356.0;62010.0
316450;201807;223;167;56;159318.0;53424.0;212742.0
316460;201807;70;29;41;27666.0;39114.0;66780.0
316470;201807;1629;1178;451;1116106.5;428132.78;1544239.2
316480;201807;13;10;3;9540.0;2862.0;12402.0
316490;201807;18;7;11;6678.0;10494.0;17172.0
316500;201807;154;103;51;97975.8;48654.0;146629.8
316510;201807;164;125;39;118248.3;37206.0;155454.3
316520;201807;186;111;75;105894.0;71550.0;177444.0
316530;201807;161;113;48;107802.0;45505.8;153307.8
316540;201807;144;80;64;76320.0;61056.0;137376.0
316550;201807;137;98;39;93492.0;37206.0;130698.0
316553;201807;250;117;133;111395.53;126882.0;238277.53
316555;201807;35;27;8;24954.0;7632.0;32586.0
316556;201807;11;8;3;7632.0;2862.0;10494.0
316557;201807;18;14;4;13356.0;3816.0;17172.0
316560;201807;63;49;14;46746.0;13356.0;60102.0
316570;201807;243;220;23;209642.0;21942.0;231584.0
316580;201807;22;16;6;15264.0;5724.0;20988.0
316590;201807;114;98;16;93492.0;15264.0;108756.0
316600;201807;182;149;33;141383.0;31482.0;172865.0
316610;201807;68;48;20;45505.8;19080.0;64585.8
316620;201807;135;104;31;99216.0;29574.0;128790.0
316630;201807;45;33;12;31482.0;11448.0;42930.0
316640;201807;16;10;6;9540.0;5724.0;15264.0
316650;201807;70;53;17;50562.0;16218.0;66780.0
316660;201807;8;4;4;3816.0;3816.0;7632.0
316670;201807;445;159;286;151667.0;272271.8;423938.8
316680;201807;162;115;47;109710.0;44648.0;154358.0
316690;201807;193;124;69;118296.0;65826.0;184122.0
316695;201807;61;54;7;51516.0;6678.0;58194.0
316700;201807;15;8;7;7632.0;6678.0;14310.0
316710;201807;718;522;196;497750.0;186984.0;684734.0
316720;201807;4938;2513;2425;2382894.8;2308595.5;4691490.0
316730;201807;15;14;1;13356.0;954.0;14310.0
316740;201807;129;82;47;78228.0;44838.0;123066.0
316750;201807;21;14;7;13356.0;6678.0;20034.0
316760;201807;326;263;63;250902.0;60102.0;311004.0
316770;201807;140;77;63;73458.0;60102.0;133560.0
316780;201807;76;46;30;43578.72;28620.0;72198.72
316790;201807;57;44;13;41976.0;12402.0;54378.0
316800;201807;1797;1106;691;1054074.8;658738.0;1712812.8
316805;201807;18;10;8;9540.0;7632.0;17172.0
316810;201807;68;44;24;41976.0;22896.0;64872.0
316820;201807;42;20;22;19080.0;20988.0;40068.0
316830;201807;94;41;53;39114.0;50562.0;89676.0
316840;201807;506;306;200;291638.0;189846.0;481484.0
316850;201807;338;221;117;210166.2;111618.0;321784.2
316860;201807;6055;2693;3362;2554963.5;3201611.0;5756574.5
316870;201807;1479;964;515;910787.1;485874.2;1396661.2
316880;201807;118;65;53;61723.8;50562.0;112285.8
316890;201807;251;169;82;161179.0;78228.0;239407.0
316900;201807;422;291;131;275067.28;124974.0;400041.28
316905;201807;16;9;7;8586.0;6678.0;15264.0
316910;201807;52;25;27;23850.0;25758.0;49608.0
316920;201807;135;105;30;99455.0;28620.0;128075.0
316930;201807;1932;988;944;936781.5;898382.7;1835164.2
316935;201807;873;525;348;498942.72;331038.0;829980.75
316940;201807;1110;640;470;609606.4;447798.25;1057404.6
316950;201807;185;96;89;91584.0;84906.0;176490.0
316960;201807;1120;628;492;597776.8;469072.47;1066849.2
316970;201807;641;499;142;475560.0;135468.0;611028.0
316980;201807;110;67;43;63918.0;41012.46;104930.46
316990;201807;2207;1457;750;1382777.0;712582.75;2095359.8
317000;201807;333;256;77;243938.0;73458.0;317396.0
317005;201807;247;176;71;167904.0;67734.0;235638.0
317010;201807;6357;3492;2865;3311340.0;2731016.0;6042356.0
317020;201807;16342;7225;9117;6861714.5;8682457.0;1,55E+14
317030;201807;81;32;49;30528.0;46529.26;77057.26
317040;201807;3115;1939;1176;1844467.2;1119138.6;2963605.8
317043;201807;75;54;21;51516.0;20034.0;71550.0
317047;201807;36;18;18;17172.0;17168.0;34340.0
317050;201807;180;135;45;128790.0;42930.0;171720.0
317052;201807;129;98;31;93492.0;29574.0;123066.0
317057;201807;198;148;50;141192.0;47128.0;188320.0
317060;201807;58;38;20;36252.0;18793.8;55045.8
317065;201807;58;46;12;43884.0;11448.0;55332.0
317070;201807;2008;948;1060;899623.7;1010095.6;1909719.2
317075;201807;108;57;51;54378.0;48654.0;103032.0
317080;201807;833;438;395;416754.9;376640.0;793394.9
317090;201807;636;508;128;482295.5;122112.0;604407.5
317100;201807;428;322;106;305280.0;101124.0;406404.0
317103;201807;110;96;14;91584.0;13356.0;104940.0
317107;201807;39;34;5;32436.0;4770.0;37206.0
317110;201807;105;44;61;41976.0;58194.0;100170.0
317115;201807;40;34;6;32436.0;5724.0;38160.0
317120;201807;1843;935;908;884086.6;865775.0;1749861.6
317130;201807;1957;1261;696;1196829.6;663317.0;1860146.6
317140;201807;9;7;2;6678.0;1908.0;8586.0
317150;201807;273;161;112;153308.0;106084.8;259392.8
317160;201807;311;226;85;215287.0;80804.0;296091.0
317170;201807;210;143;67;136422.0;63918.0;200340.0
317180;201807;436;316;120;300748.5;114480.0;415228.5
317190;201807;255;172;83;164088.0;78895.8;242983.8
317200;201807;821;576;245;536365.2;233492.0;769857.2
317210;201807;156;89;67;83952.2;63918.0;147870.2
317220;201807;19;13;6;12402.0;5724.0;18126.0
320010;201807;626;469;157;444088.5;149778.0;593866.5
320013;201807;134;99;35;94446.0;33390.0;127836.0
320016;201807;284;180;104;171720.0;99216.0;270936.0
320020;201807;722;431;291;408624.75;275706.3;684331.06
320030;201807;154;112;42;106848.0;39734.1;146582.1
320035;201807;138;102;36;97308.0;34344.0;131652.0
320040;201807;505;260;245;247181.8;233444.0;480625.8
320050;201807;119;89;30;84906.0;28620.0;113526.0
320060;201807;1574;747;827;712591.0;788281.6;1500872.6
320070;201807;105;70;35;66780.0;33390.0;100170.0
320080;201807;767;439;328;415975.0;312912.0;728887.0
320090;201807;1218;846;372;803730.9;354029.6;1157760.5
320100;201807;326;188;138;179352.0;131652.0;311004.0
320110;201807;138;89;49;83046.2;46460.0;129506.2
320115;201807;113;91;22;86814.0;20988.0;107802.0
320120;201807;3313;1843;1470;1746968.4;1399587.1;3146555.5
320130;201807;7469;3538;3931;3354568.8;3743383.8;7097952.5
320140;201807;424;276;148;262637.0;140948.0;403585.0
320150;201807;1931;1119;812;1059737.6;774352.25;1834089.9
320160;201807;683;310;373;293537.03;354727.0;648264.0
320170;201807;120;95;25;89867.0;23850.0;113717.0
320180;201807;51;29;22;27666.0;20988.0;48654.0
320190;201807;237;156;81;148051.27;76988.0;225039.27
320200;201807;56;44;12;41976.0;11448.0;53424.0
320210;201807;845;475;370;451624.6;352008.0;803632.6
320220;201807;307;115;192;109710.0;182882.0;292592.0
320225;201807;78;64;14;61056.0;13356.0;74412.0
320230;201807;570;370;200;351454.4;189990.0;541444.4
320240;201807;3151;1581;1570;1505794.8;1495113.8;3000908.5
320245;201807;458;315;143;299365.4;136422.0;435787.4
320250;201807;233;124;109;117342.6;103986.0;221328.6
320255;201807;147;114;33;107449.02;31339.0;138788.02
320260;201807;180;126;54;120204.0;51468.3;171672.3
320265;201807;160;127;33;120348.0;31482.0;151830.0
320270;201807;150;123;27;117342.0;25758.0;143100.0
320280;201807;978;581;397;549314.2;378452.0;927766.2
320290;201807;67;57;10;54378.0;9540.0;63918.0
320300;201807;547;389;158;368359.8;149683.1;518042.9
320305;201807;678;372;306;354888.0;291734.0;646622.0
320310;201807;214;119;95;111571.5;89874.0;201445.5
320313;201807;305;156;149;148824.0;141860.0;290684.0
320316;201807;107;88;19;83952.0;18126.0;102078.0
320320;201807;3348;1530;1818;1454556.0;1731391.8;3185947.8
320330;201807;256;189;67;179643.3;62010.8;241654.1
320332;201807;888;538;350;511395.6;332851.3;844246.9
320334;201807;241;146;95;138998.0;90630.0;229628.0
320335;201807;144;103;41;97308.4;39114.0;136422.4
320340;201807;587;406;181;386180.0;172007.0;558187.0
320350;201807;969;418;551;396511.66;524242.47;920754.1
320360;201807;170;92;78;87482.0;74412.0;161894.0
320370;201807;244;188;56;177660.0;52391.0;230051.0
320380;201807;285;195;90;184361.3;85860.0;270221.3
320390;201807;1136;689;447;654788.8;425818.12;1080606.9
320400;201807;319;230;89;217988.0;84906.0;302894.0
320405;201807;904;390;514;371483.6;490043.9;861527.5
320410;201807;987;505;482;480101.4;459495.0;939596.4
320420;201807;482;249;233;237069.4;222282.0;459351.4
320425;201807;193;104;89;99216.0;84906.0;184122.0
320430;201807;393;225;168;213028.7;160272.0;373300.7
320435;201807;171;115;56;108889.56;53424.0;162313.56
320440;201807;202;122;80;116388.0;76320.0;192708.0
320450;201807;132;77;55;73458.0;52470.0;125928.0
320455;201807;253;206;47;195571.0;44838.0;240409.0
320460;201807;242;153;89;145962.0;84906.0;230868.0
320465;201807;114;77;37;73095.48;35298.0;108393.48
320470;201807;643;409;234;389882.25;223232.0;613114.25
320480;201807;181;121;60;114623.1;57240.0;171863.1
320490;201807;3053;1527;1526;1453849.1;1452780.0;2906629.0
320495;201807;96;58;38;55313.0;36252.0;91565.0
320500;201807;9536;4797;4739;4548278.5;4508502.5;9056781.0
320501;201807;550;279;271;266166.0;258534.0;524700.0
320503;201807;286;203;83;192708.2;79182.0;271890.2
320506;201807;260;195;65;186030.0;62010.0;248040.0
320510;201807;966;454;512;429254.3;486922.1;916176.4
320515;201807;81;68;13;63918.9;12402.0;76320.9
320517;201807;207;147;60;140238.0;57240.0;197478.0
320520;201807;6954;3098;3856;2941131.8;3671061.5;6612193.0
320530;201807;5345;2675;2670;2543217.0;2543935.0;5087152.0
330010;201807;3143;1628;1515;1545738.1;1441558.1;2987296.2
330015;201807;158;66;92;61820.08;87768.0;149588.08
330020;201807;3658;1603;2055;1525672.8;1959612.0;3485284.8
330022;201807;233;132;101;125213.0;95400.8;220613.8
330023;201807;540;186;354;176394.8;337716.0;514110.8
330025;201807;592;119;473;113526.0;450870.8;564396.8
330030;201807;1954;1258;696;1191791.1;660715.7;1852506.9
330040;201807;2406;1243;1163;1183008.4;1107645.2;2290653.8
330045;201807;8376;2666;5710;2535236.8;5441050.5;7976287.5
330050;201807;835;534;301;509436.0;287154.0;796590.0
330060;201807;925;571;354;540443.1;336399.47;876842.56
330070;201807;3456;1316;2140;1248839.5;2040245.5;3289085.0
330080;201807;1496;702;794;664731.5;755950.4;1420681.9
330090;201807;362;215;147;205110.0;140238.0;345348.0
330093;201807;285;128;157;122112.0;149742.0;271854.0
330095;201807;101;53;48;49894.2;45792.0;95686.2
330100;201807;9533;4909;4624;4671078.5;4408005.0;9079083.0
330110;201807;485;215;270;202725.1;257580.0;460305.1
330115;201807;540;308;232;293832.0;221328.0;515160.0
330120;201807;376;195;181;184885.2;171720.4;356605.6
330130;201807;1545;420;1125;399954.97;1073232.0;1473187.0
330140;201807;600;318;282;303345.0;268075.0;571420.0
330150;201807;451;264;187;249948.0;178398.0;428346.0
330160;201807;211;132;79;125928.0;75366.0;201294.0
330170;201807;27076;9524;17552;9063897.0;1,67E+14;2,58E+14
330180;201807;234;148;86;138645.02;81328.5;219973.52
330185;201807;832;333;499;316146.6;474778.8;790925.4
330187;201807;306;94;212;89676.0;202248.0;291924.0
330190;201807;5597;2263;3334;2147823.2;3177626.8;5325450.0
330200;201807;4570;1508;3062;1433673.0;2916085.8;4349759.0
330205;201807;407;245;162;233300.7;154262.0;387562.7
330210;201807;1012;621;391;585504.0;371344.9;956848.94
330220;201807;2584;1549;1035;1473415.5;986436.2;2459851.8
330225;201807;565;302;263;287469.0;250234.2;537703.2
330227;201807;2431;773;1658;734284.44;1581376.2;2315660.8
330230;201807;204;123;81;116675.0;77274.0;193949.0
330240;201807;3690;1950;1740;1855647.2;1657007.5;3512654.8
330245;201807;155;68;87;64300.0;82234.8;146534.8
330250;201807;6536;3401;3135;3232921.5;2982123.2;6215045.0
330260;201807;565;163;402;155502.0;383508.0;539010.0
330270;201807;3430;1255;2175;1196413.0;2074379.2;3270792.2
330280;201807;452;289;163;273914.1;155493.0;429407.1
330285;201807;7134;2342;4792;2228911.2;4569461.5;6798372.5
330290;201807;566;216;350;206064.0;333900.0;539964.0
330300;201807;791;524;267;496080.7;254700.0;750780.7
330310;201807;423;242;181;228960.7;172674.0;401634.7
330320;201807;8324;3157;5167;3003816.0;4923524.0;7927340.0
330330;201807;9222;3645;5577;3469339.0;5316813.5;8786153.0
330340;201807;2650;1581;1069;1506357.2;1019806.94;2526164.2
330350;201807;18062;7113;10949;6755908.0;1,04E+14;1,72E+14
330360;201807;2487;1240;1247;1181987.2;1189629.0;2371616.2
330370;201807;1026;560;466;533286.0;442513.9;975799.9
330380;201807;855;364;491;346530.97;467376.8;813907.75
330385;201807;613;320;293;304327.0;279522.0;583849.0
330390;201807;5216;2883;2333;2735790.5;2222834.5;4958625.0
330395;201807;282;172;110;163134.3;103175.2;266309.5
330400;201807;708;372;336;351454.6;318426.88;669881.5
330410;201807;500;358;142;339864.0;134978.33;474842.34
330411;201807;234;132;102;125747.0;97260.3;223007.3
330412;201807;256;104;152;98930.0;145008.0;243938.0
330414;201807;6089;2493;3596;2374326.5;3427370.0;5801696.5
330415;201807;592;275;317;261368.34;301464.8;562833.1
330420;201807;2268;1186;1082;1127446.8;1029835.0;2157281.8
330430;201807;1791;839;952;797926.8;906205.8;1704132.6
330440;201807;269;124;145;118296.0;138330.0;256626.0
330450;201807;122;52;70;49608.0;66780.0;116388.0
330452;201807;1779;847;932;806571.8;888805.75;1695377.5
330455;201807;110922;39862;71060;3,80E+14;6,77E+14;1,06E+15
330460;201807;260;108;152;103032.0;145008.0;248040.0
330470;201807;1239;677;562;639565.0;536138.44;1175703.5
330475;201807;1406;375;1031;356796.8;983001.6;1339798.4
330480;201807;775;409;366;389518.2;348211.0;737729.2
330490;201807;13826;4843;8983;4614560.5;8563615.0;1,32E+14
330500;201807;1341;609;732;580842.9;697947.0;1278789.9
330510;201807;11286;3839;7447;3653879.5;7096841.5;1,08E+14
330513;201807;104;52;52;49608.0;49608.0;99216.0
330515;201807;856;349;507;328634.8;483297.0;811931.8
330520;201807;2587;955;1632;910851.0;1556775.9;2467627.0
330530;201807;221;117;104;111380.0;99026.0;210406.0
330540;201807;352;176;176;167904.0;167427.0;335331.0
330550;201807;3032;1078;1954;1026218.2;1861826.8;2888045.0
330555;201807;768;290;478;276641.0;455058.8;731699.8
330560;201807;592;208;384;198432.0;366318.0;564750.0
330570;201807;256;179;77;170766.0;73458.0;244224.0
330575;201807;805;340;465;324122.0;441555.5;765677.5
330580;201807;3401;1907;1494;1813089.8;1423797.8;3236887.5
330590;201807;314;152;162;145008.0;154548.0;299556.0
330600;201807;1108;710;398;675203.25;377994.84;1053198.1
330610;201807;1543;842;701;796401.75;664605.9;1461007.6
330615;201807;191;143;48;136422.0;45792.0;182214.0
330620;201807;1075;434;641;411366.5;610083.8;1021450.3
330630;201807;3954;2519;1435;2387232.2;1361742.8;3748975.2
350010;201807;595;392;203;372108.66;193662.0;565770.7
350020;201807;38;19;19;18126.0;18126.0;36252.0
350030;201807;524;337;187;320354.0;177208.66;497562.66
350040;201807;126;51;75;48310.56;71550.0;119860.56
350050;201807;289;157;132;149778.0;125671.46;275449.47
350055;201807;88;50;38;47700.0;36252.0;83952.0
350060;201807;77;28;49;26712.0;46746.0;73458.0
350070;201807;817;479;338;451518.6;320785.56;772304.1
350075;201807;63;43;20;41022.0;19080.0;60102.0
350080;201807;52;33;19;30845.96;16974.16;47820.12
350090;201807;96;54;42;51516.0;40063.23;91579.23
350100;201807;294;186;108;176728.5;103032.0;279760.5
350110;201807;57;35;22;33390.0;20988.0;54378.0
350115;201807;163;100;63;94732.2;60102.0;154834.2
350120;201807;110;74;36;70596.0;34344.0;104940.0
350130;201807;354;173;181;164756.0;172674.0;337430.0
350140;201807;36;22;14;20225.0;13356.0;33581.0
350150;201807;69;54;15;51516.0;14310.0;65826.0
350160;201807;2580;1007;1573;957609.2;1499569.9;2457179.0
350170;201807;410;250;160;236592.2;152354.0;388946.2
350180;201807;183;98;85;93492.0;81090.0;174582.0
350190;201807;999;522;477;495986.62;454876.7;950863.3
350200;201807;68;25;43;23850.0;40757.08;64607.08
350210;201807;1355;763;592;720869.1;564250.7;1285119.8
350220;201807;676;580;96;549182.75;91584.0;640766.75
350230;201807;82;58;24;55332.0;22896.0;78228.0
350240;201807;60;45;15;42930.0;14310.0;57240.0
350250;201807;1236;609;627;575645.0;597528.7;1173173.6
350260;201807;93;66;27;62964.0;25758.0;88722.0
350270;201807;828;538;290;511697.6;275210.9;786908.5
350275;201807;302;119;183;113145.0;174582.0;287727.0
350280;201807;4746;2435;2311;2309966.0;2201871.8;4511837.5
350290;201807;410;198;212;188887.23;201675.8;390563.03
350300;201807;54;30;24;28620.0;22896.0;51516.0
350310;201807;101;70;31;66780.0;29574.0;96354.0
350315;201807;40;25;15;23850.0;14310.0;38160.0
350320;201807;3328;1656;1672;1574694.5;1594316.8;3169011.2
350330;201807;1689;901;788;855168.75;750576.06;1605744.8
350335;201807;21;14;7;13356.0;6678.0;20034.0
350340;201807;132;62;70;59148.0;66447.0;125595.0
350350;201807;95;48;47;45792.0;44838.0;90630.0
350360;201807;126;82;44;78224.0;41976.0;120200.0
350370;201807;93;54;39;50562.96;37196.46;87759.42
350380;201807;768;329;439;312912.2;418042.8;730955.0
350390;201807;1432;579;853;551570.4;812617.4;1364187.8
350395;201807;24;19;5;18126.0;4770.0;22896.0
350400;201807;1668;889;779;838500.0;739614.2;1578114.1
350410;201807;2261;1020;1241;969990.94;1183282.0;2153273.0
350420;201807;236;145;91;137727.0;86814.0;224541.0
350430;201807;73;42;31;39496.0;29574.0;69070.0
350440;201807;147;109;38;102984.5;36252.0;139236.5
350450;201807;1622;997;625;944972.94;596155.0;1541128.0
350460;201807;333;121;212;115434.0;201961.8;317395.8
350470;201807;15;10;5;9540.0;4770.0;14310.0
350480;201807;163;86;77;82044.0;73458.0;155502.0
350490;201807;239;119;120;112572.8;114480.0;227052.8
350500;201807;39;20;19;19080.0;18126.0;37206.0
350510;201807;166;111;55;105894.0;52470.0;158364.0
350520;201807;456;216;240;202883.95;228323.95;431207.9
350530;201807;451;213;238;203202.0;227052.0;430254.0
350535;201807;68;53;15;50304.42;14310.0;64614.42
350540;201807;370;191;179;182214.0;170479.8;352693.8
350550;201807;2772;1645;1127;1562036.6;1073668.5;2635705.0
350560;201807;650;451;199;430249.22;189488.25;619737.5
350570;201807;4153;1735;2418;1649052.1;2304265.2;3953317.5
350580;201807;376;182;194;172675.0;185062.45;357737.47
350590;201807;896;492;404;468796.0;384462.0;853258.0
350600;201807;6225;3130;3095;2969982.2;2947598.5;5917580.5
350610;201807;1559;790;769;748948.4;733617.0;1482565.4
350620;201807;35;23;12;21942.0;11448.0;33390.0
350630;201807;242;137;105;129744.96;99217.0;228961.95
350635;201807;903;366;537;348878.0;511726.0;860604.0
350640;201807;120;87;33;82998.0;31482.0;114480.0
350650;201807;1893;1242;651;1180128.2;619609.5;1799737.9
350660;201807;748;336;412;319900.06;393044.0;712944.06
350670;201807;322;168;154;159843.2;146916.0;306759.2
350680;201807;177;95;82;90630.0;78228.0;168858.0
350690;201807;202;104;98;99216.0;93492.0;192708.0
350700;201807;727;357;370;337243.94;352980.0;690223.94
350710;201807;341;136;205;128535.56;195570.0;324105.56
350715;201807;53;44;9;41976.0;8586.0;50562.0
350720;201807;17;11;6;10494.0;5724.0;16218.0
350730;201807;41;26;15;24804.0;14310.0;39114.0
350740;201807;214;118;96;112276.26;91584.0;203860.27
350745;201807;18;8;10;7608.0;9540.0;17148.0
350750;201807;2159;1381;778;1309186.8;741575.94;2050762.8
350760;201807;3760;1629;2131;1551729.9;2028894.2;3580624.0
350770;201807;60;40;20;38160.0;19080.0;57240.0
350775;201807;49;36;13;34344.0;12393.0;46737.0
350780;201807;427;212;215;202248.0;205093.0;407341.0
350790;201807;359;154;205;146916.0;195570.0;342486.0
350800;201807;443;251;192;239454.0;183168.0;422622.0
350810;201807;522;422;100;401635.0;95400.0;497035.0
350820;201807;86;52;34;49608.0;32436.0;82044.0
350830;201807;82;46;36;43884.0;34344.0;78228.0
350840;201807;765;330;435;314581.5;413454.8;728036.3
350850;201807;1793;1045;748;991685.8;713551.44;1705237.2
350860;201807;603;354;249;333883.8;237546.0;571429.8
350870;201807;439;298;141;284292.0;134227.8;418519.8
350880;201807;288;157;131;147156.6;124306.2;271462.8
350890;201807;41;26;15;24804.0;14310.0;39114.0
350900;201807;1465;475;990;451683.94;943696.8;1395380.8
350910;201807;26;16;10;15264.0;9540.0;24804.0
350920;201807;603;334;269;318318.03;256626.0;574944.06
350925;201807;1205;643;562;610380.3;534431.4;1144811.8
350930;201807;97;57;40;54378.0;38160.0;92538.0
350940;201807;724;408;316;387991.8;299623.6;687615.4
350945;201807;104;76;28;71968.0;26712.0;98680.0
350950;201807;15646;7480;8166;7108271.0;7782838.0;1,49E+14
350960;201807;1279;594;685;562757.94;653486.0;1216244.0
350970;201807;1112;594;518;562828.44;493876.47;1056704.9
350980;201807;93;64;29;61056.0;27666.0;88722.0
350990;201807;363;129;234;122112.72;223236.0;345348.72
350995;201807;32;17;15;16218.0;14310.0;30528.0
351000;201807;636;446;190;423260.06;181260.0;604520.06
351010;201807;47;28;19;26712.0;18126.0;44838.0
351015;201807;54;38;16;36252.0;15264.0;51516.0
351020;201807;1648;959;689;913462.44;655112.0;1568574.5
351030;201807;332;231;101;217798.2;96354.0;314152.2
351040;201807;850;452;398;431208.0;378738.66;809946.7
351050;201807;3328;1558;1770;1478047.0;1687918.2;3165965.2
351060;201807;5068;2082;2986;1974594.8;2845610.0;4820204.5
351070;201807;416;266;150;251543.92;143100.0;394643.9
351080;201807;812;585;227;558090.0;215545.95;773635.94
351090;201807;63;28;35;26712.0;33390.0;60102.0
351100;201807;455;264;191;249634.48;182209.23;431843.72
351110;201807;2107;1003;1104;952591.9;1050579.6;2003171.5
351120;201807;73;37;36;35298.0;34344.0;69642.0
351130;201807;175;60;115;57240.0;109423.8;166663.8
351140;201807;342;239;103;226765.84;98262.0;325027.84
351150;201807;409;212;197;201342.8;187938.0;389280.8
351160;201807;249;165;84;157410.0;80136.0;237546.0
351170;201807;190;101;89;96354.0;84143.0;180497.0
351190;201807;91;61;30;58194.0;28620.0;86814.0
351200;201807;372;245;127;233126.05;121158.0;354284.03
351210;201807;128;61;67;57939.38;63918.0;121857.38
351220;201807;537;324;213;305523.12;203202.0;508725.12
351230;201807;286;210;76;200340.0;72484.92;272824.9
351240;201807;231;97;134;92538.0;127836.0;220374.0
351250;201807;73;51;22;48430.0;20988.0;69418.0
351260;201807;154;111;43;105894.0;40736.0;146630.0
351270;201807;51;21;30;20034.0;28620.0;48654.0
351280;201807;1116;504;612;477956.47;583016.4;1060972.9
351290;201807;230;104;126;99216.0;119918.0;219134.0
351300;201807;3734;1745;1989;1658256.0;1897185.0;3555441.0
351310;201807;770;400;370;381600.0;352694.0;734294.0
351320;201807;110;68;42;64872.0;40068.0;104940.0
351330;201807;40;27;13;25758.0;12402.0;38160.0
351340;201807;1254;780;474;737850.94;450293.4;1188144.4
351350;201807;2546;1400;1146;1333073.2;1092706.9;2425780.0
351360;201807;793;393;400;373968.0;381282.03;755250.06
351370;201807;373;190;183;181255.23;173945.95;355201.2
351380;201807;8965;4092;4873;3887097.0;4638202.0;8525299.0
351385;201807;30;20;10;19080.0;9540.0;28620.0
351390;201807;284;211;73;200340.02;69642.0;269982.03
351400;201807;66;41;25;39114.0;23812.92;62926.92
351410;201807;453;281;172;266803.03;164088.0;430891.03
351420;201807;60;49;11;46746.0;10494.0;57240.0
351430;201807;72;39;33;37206.0;31482.0;68688.0
351440;201807;796;555;241;527241.75;229910.0;757151.75
351450;201807;256;128;128;122112.0;122112.0;244224.0
351460;201807;118;54;64;51516.0;61056.0;112572.0
351470;201807;139;73;66;68401.8;62964.0;131365.8
351480;201807;525;297;228;282098.97;217392.75;499491.72
351490;201807;288;107;181;102078.0;172674.0;274752.0
351492;201807;31;22;9;20988.0;8586.0;29574.0
351495;201807;28;19;9;18126.0;8586.0;26712.0
351500;201807;3547;1538;2009;1461652.2;1911960.4;3373612.8
351510;201807;1796;751;1045;716168.0;994726.25;1710894.2
351512;201807;21;18;3;17172.0;2862.0;20034.0
351515;201807;195;112;83;106848.0;79182.0;186030.0
351518;201807;785;488;297;464594.0;283338.0;747932.0
351519;201807;74;48;26;45792.0;24804.0;70596.0
351520;201807;141;87;54;82361.96;51516.0;133877.95
351530;201807;23;15;8;14310.0;7632.0;21942.0
351535;201807;134;77;57;73458.0;54378.0;127836.0
351540;201807;457;329;128;311483.0;122112.0;433595.0
351550;201807;1329;807;522;764887.94;496070.88;1260958.8
351560;201807;73;39;34;37206.0;32436.0;69642.0
351565;201807;11;7;4;6678.0;3816.0;10494.0
351570;201807;2560;1326;1234;1262680.4;1176565.6;2439246.0
351580;201807;39;35;4;33390.0;3816.0;37206.0
351590;201807;69;46;23;43884.0;21942.0;65826.0
351600;201807;194;147;47;140238.0;44838.0;185076.0
351610;201807;58;30;28;28620.0;26712.0;55332.0
351620;201807;5922;3396;2526;3230427.2;2407776.2;5638203.5
351630;201807;2552;1321;1231;1255205.6;1172151.2;2427356.8
351640;201807;1686;826;860;785885.2;816911.1;1602796.2
351650;201807;32;27;5;25758.0;4770.0;30528.0
351660;201807;156;102;54;96354.0;51516.0;147870.0
351670;201807;732;454;278;430780.0;265212.0;695992.0
351680;201807;71;58;13;55332.0;12402.0;67734.0
351685;201807;38;25;13;23850.0;12402.0;36252.0
351690;201807;313;220;93;208968.94;88722.0;297690.94
351700;201807;158;109;49;103986.0;46746.0;150732.0
351710;201807;76;53;23;50562.0;21942.0;72504.0
351720;201807;130;61;69;58194.0;65826.0;124020.0
351730;201807;99;69;30;64586.96;28615.23;93202.19
351740;201807;715;482;233;457665.97;222277.23;679943.2
351750;201807;364;153;211;145326.0;201294.0;346620.0
351760;201807;783;608;175;580271.0;166950.0;747221.0
351770;201807;293;248;45;236592.0;42930.0;279522.0
351780;201807;175;101;74;96345.0;70596.0;166941.0
351790;201807;240;126;114;120204.0;108756.0;228960.0
351800;201807;52;33;19;31482.0;18126.0;49608.0
351810;201807;127;85;42;81090.0;40068.0;121158.0
351820;201807;878;629;249;594344.6;237255.23;831599.8
351830;201807;517;185;332;175726.8;316728.0;492454.8
351840;201807;1890;963;927;909758.0;882856.94;1792615.0
351850;201807;234;173;61;164422.8;58194.0;222616.8
351860;201807;751;505;246;476048.84;234393.23;710442.06
351870;201807;5656;2677;2979;2541765.0;2834953.2;5376718.0
351880;201807;18904;8262;10642;7861002.5;1,01E+14;1,80E+14
351885;201807;90;61;29;57479.0;27666.0;85145.0
351890;201807;71;60;11;57240.0;10494.0;67734.0
351900;201807;231;137;94;130031.0;89676.0;219707.0
351905;201807;79;33;46;31482.0;43884.0;75366.0
351907;201807;3174;1387;1787;1320329.0;1702433.6;3022762.8
351910;201807;182;75;107;71550.0;102078.0;173628.0
351920;201807;133;75;58;71550.0;55309.69;126859.69
351925;201807;88;60;28;57240.0;26712.0;83952.0
351930;201807;381;256;125;244128.6;119250.0;363378.6
351940;201807;237;105;132;100170.0;125928.0;226098.0
351950;201807;142;82;60;78228.0;57240.0;135468.0
351960;201807;874;406;468;387142.72;444316.38;831459.06
351970;201807;1921;1034;887;984289.8;845617.0;1829906.9
351980;201807;149;75;74;69642.0;70596.0;140238.0
351990;201807;276;185;91;175536.0;86012.64;261548.64
352000;201807;361;222;139;211788.0;132606.0;344394.0
352010;201807;361;219;142;208926.0;134991.0;343917.0
352020;201807;203;68;135;64872.0;128790.0;193662.0
352030;201807;1035;529;506;503950.5;481133.97;985084.44
352040;201807;581;252;329;240408.0;313866.0;554274.0
352042;201807;281;97;184;92538.0;175536.0;268074.0
352044;201807;394;234;160;222081.86;152640.0;374721.88
352050;201807;3282;1317;1965;1249154.2;1873074.2;3122228.5
352060;201807;106;66;40;62964.0;37874.0;100838.0
352070;201807;103;75;28;70280.0;26712.0;96992.0
352080;201807;67;42;25;39114.0;23850.0;62964.0
352090;201807;172;116;56;110664.0;53424.0;164088.0
352100;201807;262;131;131;124684.0;123822.0;248506.0
352110;201807;112;32;80;30528.0;76320.0;106848.0
352115;201807;69;25;44;23850.0;41976.0;65826.0
352120;201807;95;65;30;60770.0;28620.0;89390.0
352130;201807;219;182;37;173628.0;35298.0;208926.0
352140;201807;182;75;107;71073.0;101792.0;172865.0
352150;201807;121;67;54;62964.04;51516.0;114480.04
352160;201807;130;84;46;80136.0;43884.0;124020.0
352170;201807;373;257;116;244224.05;110664.0;354888.03
352180;201807;616;415;201;394289.5;191750.0;586039.5
352190;201807;258;100;158;95390.46;150693.84;246084.3
352200;201807;32;17;15;16218.0;14310.0;30528.0
352210;201807;3842;1597;2245;1514960.9;2134525.2;3649486.0
352215;201807;55;30;25;28620.0;23392.08;52012.08
352220;201807;6984;2735;4249;2604119.5;4050759.2;6654878.5
352230;201807;3245;2060;1185;1951890.4;1125736.5;3077626.8
352240;201807;2241;1308;933;1245638.8;887785.06;2133423.8
352250;201807;2605;1347;1258;1280398.0;1196092.6;2476490.8
352260;201807;1066;582;484;553697.25;461450.0;1015147.25
352265;201807;59;26;33;24804.0;31482.0;56286.0
352270;201807;410;234;176;222282.92;167848.0;390130.9
352280;201807;412;260;152;246769.0;145003.23;391772.22
352290;201807;177;112;65;106848.0;62010.0;168858.0
352300;201807;101;76;25;72504.0;23850.0;96354.0
352310;201807;5777;2800;2977;2657995.0;2834698.5;5492693.5
352320;201807;948;495;453;468735.84;430111.1;898846.94
352330;201807;519;241;278;229580.1;264926.0;494506.1
352340;201807;1390;679;711;645591.0;675290.5;1320881.5
352350;201807;325;204;121;194616.0;115148.0;309764.0
352360;201807;230;99;131;93539.7;122377.52;215917.22
352370;201807;100;68;32;64872.0;30528.0;95400.0
352380;201807;123;74;49;70596.0;46746.0;117342.0
352390;201807;2459;1115;1344;1060447.9;1279774.5;2340222.5
352400;201807;481;207;274;196762.5;261109.8;457872.3
352410;201807;774;554;220;524676.9;209880.0;734556.9
352420;201807;107;70;37;66780.0;35298.0;102078.0
352430;201807;1763;786;977;744791.8;928821.5;1673613.4
352440;201807;3191;1619;1572;1534400.5;1497740.8;3032141.2
352450;201807;195;163;32;155502.0;30528.0;186030.0
352460;201807;580;293;287;278964.7;273083.2;552047.9
352470;201807;628;213;415;203202.0;395901.0;599103.0
352480;201807;1382;779;603;741893.94;574689.8;1316583.8
352490;201807;83;31;52;29574.0;49608.0;79182.0
352500;201807;1209;533;676;506956.6;644419.0;1151375.6
352510;201807;745;406;339;386370.97;323406.0;709776.94
352520;201807;555;248;307;236592.0;292734.9;529326.9
352530;201807;1719;911;808;869094.0;770450.6;1639544.6
352540;201807;74;48;26;45792.0;24804.0;70596.0
352550;201807;182;105;77;100170.0;72790.2;172960.2
352560;201807;50;40;10;38160.0;9540.0;47700.0
352570;201807;672;349;323;332629.0;308122.9;640751.94
352580;201807;58;39;19;36252.65;18126.0;54378.65
352585;201807;16;5;11;4770.0;10494.0;15264.0
352590;201807;4382;2230;2152;2120333.0;2052097.9;4172430.8
352600;201807;365;250;115;237546.95;109710.0;347256.97
352610;201807;941;428;513;406051.34;489259.28;895310.6
352620;201807;963;393;570;373968.2;543144.0;917112.2
352630;201807;170;66;104;62964.0;99206.46;162170.45
352640;201807;564;394;170;373292.03;162180.0;535472.0
352650;201807;90;60;30;57240.0;28620.0;85860.0
352660;201807;80;47;33;44838.0;31482.0;76320.0
352670;201807;1699;919;780;874195.9;743016.3;1617212.1
352680;201807;899;577;322;546940.4;305726.03;852666.4
352690;201807;4427;2034;2393;1932007.9;2279342.8;4211350.5
352700;201807;107;63;44;59815.8;41976.0;101791.8
352710;201807;1366;732;634;696133.8;601207.6;1297341.4
352720;201807;1347;648;699;615934.2;666269.0;1282203.2
352725;201807;25;23;2;21942.0;1908.0;23850.0
352730;201807;368;185;183;175311.81;174582.0;349893.8
352740;201807;426;271;155;256579.69;147870.0;404449.7
352750;201807;22;14;8;13069.8;7632.0;20701.8
352760;201807;199;144;55;137376.0;52470.0;189846.0
352770;201807;82;65;17;62010.0;16218.0;78228.0
352780;201807;80;44;36;41976.0;34344.0;76320.0
352790;201807;31;25;6;23850.0;5724.0;29574.0
352800;201807;249;173;76;165042.0;72217.8;237259.8
352810;201807;167;112;55;104337.42;52470.0;156807.42
352820;201807;66;51;15;48228.52;14310.0;62538.52
352830;201807;93;64;29;61056.0;27666.0;88722.0
352840;201807;616;319;297;303039.2;283338.0;586377.2
352850;201807;1379;492;887;468700.2;845561.94;1314262.1
352860;201807;133;89;44;84270.0;41976.0;126246.0
352870;201807;47;31;16;29574.0;15264.0;44838.0
352880;201807;191;129;62;123046.92;59148.0;182194.92
352885;201807;29;21;8;20034.0;7632.0;27666.0
352890;201807;57;39;18;37206.0;16886.0;54092.0
352900;201807;4855;2339;2516;2212382.8;2392718.8;4605101.5
352910;201807;39;32;7;30528.0;6678.0;37206.0
352920;201807;703;430;273;409266.0;260442.0;669708.0
352930;201807;1256;610;646;580507.8;613286.1;1193793.9
352940;201807;6397;2749;3648;2612135.2;3476462.5;6088598.0
352950;201807;96;39;57;37206.0;54378.0;91584.0
352960;201807;64;41;23;39114.0;21942.0;61056.0
352965;201807;19;8;11;7632.0;10494.0;18126.0
352970;201807;478;360;118;340232.97;111619.0;451851.97
352980;201807;177;95;82;90630.0;77942.0;168572.0
352990;201807;973;424;549;403513.38;522678.2;926191.56
353000;201807;68;32;36;30528.0;34344.0;64872.0
353010;201807;553;339;214;323406.0;204136.92;527542.94
353020;201807;284;207;77;197478.0;73458.0;270936.0
353030;201807;1226;558;668;530547.0;636585.7;1167132.6
353040;201807;90;55;35;52470.0;33390.0;85860.0
353050;201807;1345;859;486;813084.0;463357.8;1276441.9
353060;201807;7951;3608;4343;3426353.5;4136979.0;7563332.5
353070;201807;1659;1058;601;1003382.44;571893.56;1575276.0
353080;201807;1358;731;627;695037.56;597200.0;1292237.5
353090;201807;55;32;23;30528.0;21942.0;52470.0
353100;201807;60;49;11;46746.0;10494.0;57240.0
353110;201807;2056;624;1432;593564.9;1364159.2;1957724.1
353120;201807;82;44;38;41976.0;36252.0;78228.0
353130;201807;875;436;439;414818.34;418684.12;833502.5
353140;201807;574;228;346;217451.0;330084.0;547535.0
353150;201807;360;201;159;190800.0;151676.45;342476.47
353160;201807;101;82;19;78228.0;18126.0;96354.0
353170;201807;196;65;131;62010.0;124946.46;186956.45
353180;201807;962;444;518;421282.5;493648.0;914930.5
353190;201807;491;349;142;331890.9;135182.0;467072.9
353200;201807;197;100;97;95400.0;92538.0;187938.0
353205;201807;26;19;7;18126.0;6678.0;24804.0
353210;201807;85;51;34;48654.0;32436.0;81090.0
353215;201807;53;31;22;29574.0;20988.0;50562.0
353220;201807;85;48;37;45792.0;34344.27;80136.27
353230;201807;159;63;96;60102.0;91584.0;151686.0
353240;201807;303;166;137;158364.0;130698.0;289062.0
353250;201807;205;106;99;101124.0;94446.0;195570.0
353260;201807;468;335;133;318446.5;126872.46;445318.97
353270;201807;66;48;18;45792.0;16504.2;62296.2
353280;201807;94;49;45;46556.0;42930.0;89486.0
353282;201807;124;89;35;84906.0;33390.0;118296.0
353284;201807;25;20;5;19080.0;4770.0;23850.0
353286;201807;1;1;0;954.0;0.0;954.0
353290;201807;79;45;34;42930.0;32427.0;75357.0
353300;201807;411;229;182;216924.45;173628.0;390552.47
353310;201807;55;48;7;45792.0;6678.0;52470.0
353320;201807;62;38;24;36252.0;22896.0;59148.0
353325;201807;58;35;23;33381.0;21638.0;55019.0
353330;201807;67;50;17;47557.0;16218.0;63775.0
353340;201807;623;206;417;195841.89;397232.25;593074.1
353350;201807;908;429;479;408275.62;455995.0;864270.6
353360;201807;111;90;21;85542.04;19748.0;105290.04
353370;201807;121;67;54;63918.0;51516.0;115434.0
353380;201807;26;18;8;17168.0;7632.0;24800.0
353390;201807;1090;521;569;497034.0;542826.0;1039860.0
353400;201807;51;31;20;29574.0;19080.0;48654.0
353410;201807;112;70;42;66780.0;40021.0;106801.0
353420;201807;59;24;35;22896.0;33390.0;56286.0
353430;201807;569;375;194;354029.3;184626.8;538656.1
353440;201807;10331;4500;5831;4282018.0;5555965.5;9837983.0
353450;201807;55;31;24;29574.0;22896.0;52470.0
353460;201807;617;339;278;321190.84;264487.5;585678.3
353470;201807;2137;1164;973;1106508.6;925836.25;2032344.9
353475;201807;236;159;77;148996.95;73458.0;222454.95
353480;201807;190;154;36;146916.0;34344.0;181260.0
353490;201807;237;141;96;134514.0;91584.0;226098.0
353500;201807;192;112;80;105894.96;76320.0;182214.95
353510;201807;99;72;27;68669.46;25748.46;94417.92
353520;201807;203;137;66;130698.0;62964.0;193662.0
353530;201807;467;253;214;241362.0;204156.0;445518.0
353540;201807;366;242;124;230545.27;118296.0;348841.28
353550;201807;744;505;239;477956.88;228006.0;705962.9
353560;201807;635;270;365;256300.89;347609.53;603910.44
353570;201807;61;31;30;29574.0;28620.0;58194.0
353580;201807;359;278;81;264735.0;77274.0;342009.0
353590;201807;89;61;28;57876.04;26712.0;84588.04
353600;201807;269;152;117;144691.0;110982.0;255673.0
353610;201807;115;60;55;57240.0;52470.0;109710.0
353620;201807;584;314;270;298285.0;257293.8;555578.8
353625;201807;52;30;22;28620.0;20988.0;49608.0
353630;201807;237;170;67;157774.6;63918.0;221692.6
353640;201807;127;85;42;80613.0;40068.0;120681.0
353650;201807;890;345;545;327031.2;519930.0;846961.2
353657;201807;24;18;6;17172.0;5724.0;22896.0
353660;201807;253;142;111;135468.0;105894.0;241362.0
353670;201807;772;457;315;435024.2;300510.0;735534.2
353680;201807;102;73;29;69404.0;27666.0;97070.0
353690;201807;45;36;9;34070.0;8586.0;42656.0
353700;201807;278;197;81;187938.0;77274.0;265212.0
353710;201807;445;204;241;193662.8;229628.0;423290.8
353715;201807;46;33;13;31195.8;12402.0;43597.8
353720;201807;359;164;195;156438.0;186030.0;342468.0
353730;201807;1108;683;425;648479.4;405445.22;1053924.6
353740;201807;656;358;298;341245.8;284292.0;625537.8
353750;201807;89;55;34;51938.14;32436.0;84374.14
353760;201807;2780;1041;1739;991055.9;1655403.8;2646459.8
353770;201807;97;80;17;75843.0;16218.0;92061.0
353780;201807;1165;572;593;543971.94;564747.0;1108719.0
353790;201807;506;294;212;278407.5;199649.34;478056.84
353800;201807;3273;1675;1598;1589300.9;1522875.9;3112176.8
353810;201807;235;133;102;126028.71;97299.0;223327.7
353820;201807;185;88;97;83952.0;91913.41;175865.4
353830;201807;47;40;7;38160.0;6678.0;44838.0
353850;201807;169;86;83;82044.0;79182.0;161226.0
353860;201807;472;217;255;206302.5;242983.8;449286.3
353870;201807;5131;2579;2552;2442826.0;2423542.5;4866368.5
353880;201807;683;489;194;465170.4;184122.12;649292.5
353890;201807;589;332;257;316156.0;244892.0;561048.0
353900;201807;129;64;65;61056.0;62010.0;123066.0
353910;201807;175;86;89;82044.0;84906.0;166950.0
353920;201807;450;245;205;232538.4;195127.16;427665.56
353930;201807;1024;603;421;573569.8;400938.8;974508.56
353940;201807;185;99;86;93682.8;81186.0;174868.8
353950;201807;529;323;206;307156.8;196515.0;503671.8
353960;201807;69;56;13;53424.0;12402.0;65826.0
353970;201807;74;43;31;41022.0;29574.0;70596.0
353980;201807;1539;755;784;717896.94;747001.75;1464898.8
353990;201807;73;42;31;40068.0;29574.0;69642.0
354000;201807;369;183;186;173915.0;177249.2;351164.2
354010;201807;93;52;41;49608.0;38637.0;88245.0
354020;201807;544;344;200;327222.0;190800.0;518022.0
354025;201807;53;42;11;40068.0;10494.0;50562.0
354030;201807;64;36;28;34344.0;26712.0;61056.0
354040;201807;97;68;29;64490.4;27666.0;92156.4
354050;201807;192;105;87;99884.0;82998.0;182882.0
354060;201807;767;370;397;352980.0;376497.4;729477.4
354070;201807;879;517;362;491688.03;345348.0;837036.0
354075;201807;219;117;102;111332.0;96354.8;207686.8
354080;201807;290;125;165;118963.8;157410.0;276373.8
354085;201807;19;12;7;11448.0;6678.0;18126.0
354090;201807;315;176;139;167823.0;132606.0;300429.0
354100;201807;5635;2352;3283;2233213.5;3126444.2;5359658.0
354105;201807;85;41;44;39114.0;41976.0;81090.0
354110;201807;50;23;27;21942.0;25758.0;47700.0
354120;201807;144;101;43;96345.0;41022.0;137367.0
354130;201807;700;465;235;443372.0;223900.0;667272.0
354140;201807;3152;1481;1671;1410051.4;1592598.9;3002650.2
354150;201807;661;413;248;391789.03;235161.0;626950.06
354160;201807;722;457;265;434785.5;252524.0;687309.5
354165;201807;23;14;9;13356.0;8586.0;21942.0
354170;201807;179;120;59;113812.2;56286.0;170098.2
354180;201807;68;42;26;39742.0;24804.0;64546.0
354190;201807;211;98;113;91870.2;107802.0;199672.2
354200;201807;130;72;58;68211.0;55332.0;123543.0
354210;201807;67;34;33;32436.0;31482.0;63918.0
354220;201807;636;391;245;372346.2;232490.34;604836.56
354230;201807;163;68;95;64872.0;89676.6;154548.6
354240;201807;316;205;111;194616.48;105894.0;300510.5
354250;201807;93;56;37;53424.0;35298.0;88722.0
354260;201807;1974;921;1053;868273.06;1001770.7;1870043.8
354270;201807;94;71;23;67734.0;21942.0;89676.0
354280;201807;40;22;18;20988.0;17172.0;38160.0
354290;201807;141;99;42;93635.1;40068.0;133703.1
354300;201807;420;286;134;272527.0;127678.0;400205.0
354310;201807;102;76;26;71550.2;24804.0;96354.2
354320;201807;179;97;82;92538.0;78228.0;170766.0
354323;201807;16;14;2;13356.0;1908.0;15264.0
354325;201807;109;63;46;59296.0;43884.0;103180.0
354330;201807;2644;880;1764;834885.25;1680976.1;2515861.5
354340;201807;10615;5203;5412;4951988.0;5155653.5;1,01E+14
354350;201807;125;82;43;78228.0;40878.9;119106.9
354360;201807;88;49;39;46746.0;37206.0;83952.0
354370;201807;266;148;118;141192.0;112572.0;253764.0
354380;201807;212;126;86;119418.0;82044.0;201462.0
354390;201807;2790;1014;1776;965695.25;1693505.0;2659200.2
354400;201807;331;175;156;166283.0;148538.0;314821.0
354410;201807;620;296;324;280758.44;308810.0;589568.44
354420;201807;275;173;102;165042.0;97308.0;262350.0
354425;201807;316;184;132;175536.0;125928.0;301464.0
354430;201807;191;120;71;112905.9;66970.8;179876.7
354440;201807;40;28;12;26712.0;11448.0;38160.0
354450;201807;50;36;14;34344.0;13356.0;47700.0
354460;201807;104;60;44;57240.0;41976.0;99216.0
354470;201807;41;28;13;26712.0;12402.0;39114.0
354480;201807;118;60;58;57231.0;55322.46;112553.46
354490;201807;144;90;54;85700.97;51516.0;137216.97
354500;201807;394;196;198;186984.0;188892.0;375876.0
354510;201807;104;72;32;68688.0;30528.0;99216.0
354515;201807;39;14;25;13356.0;23850.0;37206.0
354520;201807;1647;723;924;688175.2;881057.56;1569232.8
354530;201807;675;354;321;335994.8;305376.2;641371.0
354540;201807;282;159;123;151686.0;117337.23;269023.22
354550;201807;40;23;17;21942.0;16218.0;38160.0
354560;201807;158;90;68;85574.0;64862.46;150436.45
354570;201807;136;87;49;82998.0;46746.0;129744.0
354580;201807;1981;938;1043;892275.0;994436.25;1886711.2
354600;201807;268;148;120;138978.92;114465.69;253444.61
354610;201807;74;65;9;61056.58;8577.0;69633.58
354620;201807;62;19;43;18126.0;41022.0;59148.0
354625;201807;18;11;7;10494.0;6674.0;17168.0
354630;201807;321;213;108;202827.34;103032.0;305859.34
354640;201807;808;525;283;496924.38;269982.0;766906.4
354650;201807;74;43;31;40753.02;29545.92;70298.94
354660;201807;809;597;212;565274.56;202248.0;767522.56
354670;201807;277;98;179;92300.0;169813.0;262113.0
354680;201807;1271;485;786;462690.0;749367.0;1212057.0
354690;201807;84;55;29;51517.0;27666.0;79183.0
354700;201807;78;56;22;53424.0;20988.0;74412.0
354710;201807;57;39;18;36569.96;17172.0;53741.96
354720;201807;20;19;1;18126.0;954.0;19080.0
354730;201807;1868;790;1078;750742.2;1028221.2;1778963.4
354740;201807;60;42;18;40068.0;17172.0;57240.0
354750;201807;433;256;177;244215.0;168858.0;413073.0
354760;201807;513;313;200;296041.0;190514.0;486555.0
354765;201807;12;5;7;4770.0;6678.0;11448.0
354770;201807;342;228;114;217512.0;107992.8;325504.8
354780;201807;8166;3333;4833;3167397.8;4606822.0;7774220.0
354790;201807;113;66;47;62964.0;44838.0;107802.0
354800;201807;442;243;199;231822.0;189540.92;421362.9
354805;201807;104;52;52;48972.0;49608.0;98580.0
354810;201807;135;77;58;73458.0;55332.0;128790.0
354820;201807;186;79;107;75157.0;102078.0;177235.0
354830;201807;42;23;19;21942.0;18126.0;40068.0
354840;201807;58;39;19;37206.0;18126.0;55332.0
354850;201807;4598;2045;2553;1943672.1;2431476.0;4375148.0
354860;201807;326;160;166;152640.0;156256.52;308896.53
354870;201807;12074;5469;6605;5190234.0;6291309.0;1,15E+14
354880;201807;3048;1145;1903;1090692.5;1814168.8;2904861.2
354890;201807;2898;1610;1288;1529183.5;1227769.4;2756952.8
354900;201807;59;38;21;36252.0;20034.0;56286.0
354910;201807;1233;650;583;616532.25;556182.0;1172714.2
354920;201807;49;41;8;39114.0;7632.0;46746.0
354925;201807;13;7;6;6678.0;5724.0;12402.0
354930;201807;31;28;3;26442.0;2862.0;29304.0
354940;201807;820;601;219;570685.7;208926.0;779611.7
354950;201807;218;147;71;139571.0;67734.0;207305.0
354960;201807;164;64;100;61056.0;95114.0;156170.0
354970;201807;877;572;305;540829.1;290331.03;831160.1
354980;201807;8491;3141;5350;2988811.2;5101181.0;8089992.0
354990;201807;9166;4352;4814;4137313.2;4586101.5;8723415.0
354995;201807;520;181;339;172674.0;323091.2;495765.2
355000;201807;488;164;324;156451.23;308857.5;465308.72
355010;201807;619;390;229;372060.0;216254.48;588314.5
355020;201807;717;454;263;432157.6;250894.0;683051.56
355030;201807;206408;80133;126275;7,62E+14;1,20E+15;1,97E+16
355040;201807;729;342;387;324217.6;369007.2;693224.8
355050;201807;154;102;52;96037.77;49608.0;145645.77
355060;201807;1571;781;790;740224.94;752468.3;1492693.2
355070;201807;1448;708;740;672562.2;704967.0;1377529.1
355080;201807;202;116;86;110664.0;81156.8;191820.8
355090;201807;300;199;101;187748.0;96354.0;284102.0
355100;201807;4900;2399;2501;2268181.2;2383826.8;4652008.0
355110;201807;272;173;99;164085.0;94446.0;258531.0
355120;201807;81;58;23;55332.0;21942.0;77274.0
355130;201807;54;30;24;28620.0;22896.0;51516.0
355140;201807;183;122;61;115672.5;58194.0;173866.5
355150;201807;689;414;275;393712.0;261873.0;655585.0
355160;201807;466;223;243;210357.95;231822.0;442179.97
355170;201807;2075;1080;995;1029054.94;947334.75;1976389.6
355180;201807;626;268;358;254718.0;340697.25;595415.25
355190;201807;222;151;71;144054.0;67734.0;211788.0
355200;201807;120;69;51;65826.0;48654.0;114480.0
355210;201807;719;407;312;388278.0;297629.47;685907.44
355220;201807;6796;3633;3163;3455395.8;3008957.2;6464353.0
355230;201807;107;63;44;60102.0;41971.23;102073.23
355240;201807;4393;1900;2493;1800347.1;2374184.0;4174531.2
355250;201807;5439;2608;2831;2482217.2;2697360.8;5179578.0
355255;201807;50;31;19;29574.0;18126.0;47700.0
355260;201807;187;113;74;106829.12;70568.46;177397.58
355270;201807;167;99;68;94446.0;64157.0;158603.0
355280;201807;6440;2684;3756;2555047.8;3578236.5;6133284.0
355290;201807;76;57;19;54378.0;18126.0;72504.0
355300;201807;186;121;65;114480.8;61724.0;176204.8
355310;201807;108;60;48;57240.0;45792.0;103032.0
355320;201807;91;48;43;45792.0;40074.6;85866.6
355330;201807;273;153;120;145962.0;114480.0;260442.0
355340;201807;1574;538;1036;510645.62;987316.0;1497961.6
355350;201807;140;72;68;68688.0;64872.0;133560.0
355360;201807;181;115;66;109500.12;62964.0;172464.12
355365;201807;25;20;5;19080.0;4770.0;23850.0
355370;201807;1057;610;447;576063.75;425161.0;1001224.75
355380;201807;785;521;264;496442.53;251677.0;748119.5
355385;201807;66;47;19;44838.0;18126.0;62964.0
355390;201807;105;62;43;59148.0;41022.0;100170.0
355395;201807;184;112;72;105747.23;68688.0;174435.23
355400;201807;1568;968;600;920427.3;570873.8;1491301.1
355410;201807;4930;2338;2592;2212997.5;2463845.2;4676843.0
355420;201807;51;38;13;36252.0;12402.0;48654.0
355430;201807;347;211;136;199958.4;129744.0;329702.4
355440;201807;85;51;34;48654.0;32436.0;81090.0
355450;201807;459;226;233;213172.14;221244.66;434416.78
355460;201807;70;54;16;50562.42;15264.0;65826.42
355465;201807;52;33;19;31482.0;18126.0;49608.0
355470;201807;181;73;108;68688.1;103032.0;171720.1
355475;201807;13;8;5;7632.0;4770.0;12402.0
355480;201807;469;209;260;197488.34;247372.2;444860.53
355490;201807;116;82;34;78228.0;32436.0;110664.0
355495;201807;53;26;27;24804.0;25758.0;50562.0
355500;201807;1653;929;724;880686.7;690661.44;1571348.1
355510;201807;273;198;75;184412.62;71550.0;255962.62
355520;201807;31;24;7;22610.0;6678.0;29288.0
355530;201807;24;16;8;15264.0;7632.0;22896.0
355535;201807;80;39;41;37206.0;39114.0;76320.0
355540;201807;2383;941;1442;896255.5;1373752.0;2270007.5
355550;201807;66;40;26;38160.0;24804.0;62964.0
355560;201807;240;120;120;114480.0;113844.0;228324.0
355570;201807;30;20;10;19080.0;9540.0;28620.0
355580;201807;266;183;83;174582.0;78891.23;253473.23
355590;201807;24;15;9;14310.0;8586.0;22896.0
355600;201807;267;137;130;130698.0;123729.23;254427.23
355610;201807;220;146;74;139284.0;70596.0;209880.0
355620;201807;1296;604;692;575643.8;659658.4;1235302.1
355630;201807;417;303;114;289062.0;107802.96;396864.97
355635;201807;123;59;64;56286.0;61043.0;117329.0
355640;201807;578;333;245;316728.16;233730.0;550458.2
355645;201807;834;358;476;340053.3;452224.8;792278.1
355650;201807;2148;898;1250;852469.6;1192481.5;2044951.0
355660;201807;256;138;118;131652.0;112572.0;244224.0
355670;201807;502;194;308;185076.0;293545.8;478621.8
355680;201807;206;118;88;111619.0;83952.0;195571.0
355690;201807;87;40;47;38160.0;44494.0;82654.0
355695;201807;13;10;3;9540.0;2862.0;12402.0
355700;201807;1137;585;552;552667.6;526036.0;1078703.6
355710;201807;2222;1216;1006;1156427.5;959533.2;2115960.8
355715;201807;20;18;2;17172.0;1908.0;19080.0
355720;201807;207;125;82;117660.08;78228.0;195888.08
355730;201807;94;53;41;49687.95;39114.0;88801.95
410010;201807;132;112;20;106848.0;19080.0;125928.0
410020;201807;106;93;13;88722.0;12402.0;101124.0
410030;201807;163;104;59;98548.4;56286.0;154834.4
410040;201807;980;537;443;511391.7;422432.0;933823.7
410045;201807;27;22;5;20988.0;4770.0;25758.0
410050;201807;481;269;212;256626.0;201580.2;458206.2
410060;201807;276;211;65;201294.0;62010.0;263304.0
410070;201807;310;257;53;245178.0;50562.0;295740.0
410080;201807;165;107;58;102078.0;55332.0;157410.0
410090;201807;74;65;9;61801.0;8586.0;70387.0
410100;201807;299;215;84;204795.19;79325.1;284120.28
410105;201807;48;29;19;27666.0;18126.0;45792.0
410110;201807;315;191;124;182214.0;118296.0;300510.0
410115;201807;29;20;9;19080.0;8586.0;27666.0
410120;201807;438;225;213;214363.8;203202.0;417565.8
410130;201807;46;29;17;27666.0;16218.0;43884.0
410140;201807;3117;1528;1589;1452143.0;1512281.6;2964424.5
410150;201807;2725;1101;1624;1048915.2;1548699.8;2597615.0
410160;201807;496;314;182;299269.8;173628.0;472897.8
410165;201807;64;42;22;40068.0;20988.0;61056.0
410170;201807;167;124;43;116871.0;41022.0;157893.0
410180;201807;2143;1246;897;1184695.2;854487.94;2039183.1
410185;201807;34;30;4;28620.0;3816.0;32436.0
410190;201807;450;283;167;269982.0;159318.0;429300.0
410200;201807;952;713;239;679257.56;228006.0;907263.56
410210;201807;559;293;266;279522.0;253478.0;533000.0
410220;201807;41;22;19;20988.0;18126.0;39114.0
410230;201807;130;70;60;66780.0;57240.0;124020.0
410240;201807;731;481;250;458301.8;238500.0;696801.8
410250;201807;371;274;97;260791.84;92533.23;353325.06
410260;201807;300;179;121;170480.0;115434.0;285914.0
410270;201807;30;19;11;18126.0;10494.0;28620.0
410275;201807;63;46;17;43884.0;16218.0;60102.0
410280;201807;324;187;137;178138.52;130698.0;308836.53
410290;201807;231;146;85;139284.0;81090.0;220374.0
410300;201807;81;65;16;62010.0;15264.0;77274.0
410302;201807;24;16;8;15264.0;7632.0;22896.0
410304;201807;46;32;14;30528.0;13356.0;43884.0
410305;201807;213;117;96;110950.2;91584.0;202534.2
410310;201807;263;168;95;160272.0;90610.92;250882.92
410315;201807;50;36;14;34320.0;13356.0;47676.0
410320;201807;140;98;42;93492.0;40068.0;133560.0
410322;201807;33;24;9;22896.0;8586.0;31482.0
410330;201807;169;120;49;114480.0;46556.0;161036.0
410335;201807;99;60;39;57240.0;37206.0;94446.0
410337;201807;40;35;5;33390.0;4770.0;38160.0
410340;201807;31;29;2;27666.0;1908.0;29574.0
410345;201807;221;140;81;133560.0;77274.0;210834.0
410347;201807;53;40;13;38160.0;12402.0;50562.0
410350;201807;230;139;91;132606.0;86814.0;219420.0
410360;201807;460;281;179;265530.4;170194.0;435724.4
410370;201807;2409;1036;1373;984749.3;1307062.9;2291812.2
410380;201807;216;140;76;133560.0;72504.0;206064.0
410390;201807;369;273;96;260438.0;91584.0;352022.0
410395;201807;34;22;12;20988.0;10781.0;31769.0
410400;201807;842;424;418;403167.2;397422.1;800589.3
410405;201807;93;71;22;67734.0;20988.0;88722.0
410410;201807;40;31;9;29574.0;8586.0;38160.0
410420;201807;1656;818;838;778177.9;798499.0;1576676.9
410425;201807;178;83;95;78992.0;90630.0;169622.0
410430;201807;2189;1290;899;1227259.0;856768.3;2084027.4
410440;201807;388;289;99;274753.0;94446.0;369199.0
410442;201807;355;239;116;227053.0;110664.0;337717.0
410445;201807;415;290;125;276660.0;119250.0;395910.0
410450;201807;407;209;198;199386.0;188892.0;388278.0
410460;201807;417;226;191;215308.27;182214.0;397522.25
410465;201807;191;121;70;114193.8;66780.0;180973.8
410470;201807;228;146;82;139284.0;78228.0;217512.0
410480;201807;5918;2922;2996;2767396.8;2853055.8;5620452.5
410490;201807;1407;927;480;882861.0;456013.0;1338874.0
410500;201807;269;153;116;145962.0;110664.0;256626.0
410510;201807;177;129;48;123066.0;45783.0;168849.0
410520;201807;251;188;63;179352.0;60102.0;239454.0
410530;201807;238;87;151;82998.0;144050.0;227048.0
410540;201807;315;227;88;215739.97;83947.23;299687.2
410550;201807;1606;694;912;661789.8;868848.4;1530638.1
410560;201807;143;112;31;106848.0;29574.0;136422.0
410570;201807;429;299;130;283158.2;124020.0;407178.2
410580;201807;3155;1427;1728;1359456.8;1648036.0;3007492.8
410590;201807;405;285;120;271890.0;114480.0;386370.0
410600;201807;187;160;27;152640.0;25758.0;178398.0
410610;201807;56;45;11;42930.0;10494.0;53424.0
410620;201807;239;173;66;165042.0;62964.0;228006.0
410630;201807;444;258;186;246132.0;177444.0;423576.0
410640;201807;991;620;371;587663.25;352327.28;939990.56
410645;201807;100;74;26;70215.0;24804.0;95019.0
410650;201807;365;248;117;235638.0;111618.0;347256.0
410655;201807;78;60;18;57240.0;17172.0;74412.0
410657;201807;43;18;25;17172.0;23850.0;41022.0
410660;201807;602;427;175;405829.0;166950.0;572779.0
410670;201807;75;63;12;60102.0;11448.0;71550.0
410680;201807;193;161;32;152926.2;30528.0;183454.2
410685;201807;14;9;5;8586.0;4770.0;13356.0
410690;201807;28163;12269;15894;1,17E+14;1,51E+14;2,68E+14
410700;201807;324;239;85;227720.0;81090.0;308810.0
410710;201807;124;101;23;96354.0;21942.0;118296.0
410712;201807;21;14;7;13356.0;6678.0;20034.0
410715;201807;86;64;22;61056.0;20988.0;82044.0
410720;201807;605;361;244;344394.0;232767.0;577161.0
410725;201807;181;130;51;124020.0;48654.0;172674.0
410730;201807;83;51;32;48654.0;30528.0;79182.0
410740;201807;112;81;31;77274.0;29574.0;106848.0
410750;201807;216;160;56;152640.0;53419.23;206059.23
410752;201807;24;14;10;13356.0;9540.0;22896.0
410753;201807;53;23;30;21269.43;28620.0;49889.43
410754;201807;39;23;16;21561.0;15264.0;36825.0
410755;201807;80;55;25;52470.0;23850.0;76320.0
410760;201807;730;414;316;394645.56;301464.0;696109.56
410765;201807;1660;799;861;756272.8;820240.25;1576513.0
410770;201807;107;86;21;82044.0;20034.0;102078.0
410773;201807;48;35;13;33390.0;12402.0;45792.0
410775;201807;177;134;43;127168.2;41022.0;168190.2
410780;201807;78;42;36;40068.0;34344.0;74412.0
410785;201807;52;42;10;40068.0;9540.0;49608.0
410790;201807;73;35;38;33390.0;36252.0;69642.0
410800;201807;293;185;108;175537.0;103032.0;278569.0
410810;201807;25;21;4;20034.0;3530.0;23564.0
410820;201807;179;131;48;124831.0;45792.0;170623.0
410830;201807;8474;3842;4632;3655678.0;4415991.5;8071669.5
410832;201807;103;70;33;66780.0;31482.0;98262.0
410840;201807;1436;801;635;761886.06;604491.0;1366377.0
410845;201807;65;41;24;38828.0;22896.0;61724.0
410850;201807;194;135;59;128504.0;56286.0;184790.0
410855;201807;51;44;7;41976.0;6678.0;48654.0
410860;201807;672;395;277;375876.75;264258.0;640134.75
410865;201807;103;81;22;77274.0;20988.0;98262.0
410870;201807;161;135;26;128790.0;24804.0;153594.0
410880;201807;1122;565;557;538499.6;531314.0;1069813.6
410890;201807;79;54;25;51516.0;23850.0;75366.0
410895;201807;73;56;17;53424.0;16218.0;69642.0
410900;201807;20;12;8;11448.0;7632.0;19080.0
410910;201807;17;15;2;14310.0;1908.0;16218.0
410920;201807;32;22;10;20988.0;9540.0;30528.0
410930;201807;510;327;183;311746.97;174582.0;486328.97
410940;201807;4303;2547;1756;2420229.5;1671960.4;4092189.8
410950;201807;114;85;29;81090.0;27666.0;108756.0
410960;201807;773;349;424;332660.0;404306.0;736966.0
410965;201807;66;51;15;48367.8;14310.0;62677.8
410970;201807;629;453;176;431694.2;167904.0;599598.2
410975;201807;110;64;46;60545.0;43884.0;104429.0
410980;201807;1590;715;875;679563.8;833792.0;1513355.9
410990;201807;267;180;87;171720.0;82711.8;254431.8
411000;201807;63;39;24;37206.0;22896.0;60102.0
411005;201807;25;20;5;19080.0;4770.0;23850.0
411007;201807;244;142;102;135468.0;97308.0;232776.0
411010;201807;578;403;175;384462.0;166950.0;551412.0
411020;201807;292;201;91;191754.0;86814.0;278568.0
411030;201807;19;9;10;8586.0;9540.0;18126.0
411040;201807;51;36;15;34344.0;14310.0;48654.0
411050;201807;218;170;48;161565.72;45665.12;207230.84
411060;201807;512;345;167;329121.0;159318.0;488439.0
411065;201807;64;56;8;53424.0;7632.0;61056.0
411070;201807;1204;796;408;753524.3;388278.0;1141802.2
411080;201807;242;174;68;165996.0;64872.0;230868.0
411090;201807;115;87;28;82998.0;26712.0;109710.0
411095;201807;269;111;158;105417.0;150722.0;256139.0
411100;201807;114;95;19;90630.0;18126.0;108756.0
411110;201807;121;85;36;81090.0;34344.0;115434.0
411120;201807;184;135;49;128790.0;46746.0;175536.0
411125;201807;182;82;100;77579.28;95400.0;172979.28
411130;201807;127;108;19;102394.0;17919.37;120313.37
411140;201807;190;130;60;123998.12;56715.3;180713.42
411150;201807;1229;814;415;775878.7;395910.0;1171788.6
411155;201807;122;84;38;80136.0;36252.0;116388.0
411160;201807;20;9;11;8586.0;10494.0;19080.0
411170;201807;55;50;5;47413.8;4770.0;52183.8
411180;201807;961;639;322;608366.0;307183.22;915549.25
411190;201807;340;196;144;186316.2;137376.0;323692.2
411200;201807;676;441;235;419443.88;223046.3;642490.2
411210;201807;683;373;310;354292.22;295740.0;650032.2
411220;201807;145;109;36;103986.0;34344.0;138330.0
411230;201807;41;37;4;35298.0;3816.0;39114.0
411240;201807;124;85;39;81090.0;37206.0;118296.0
411250;201807;426;313;113;298602.0;107802.0;406404.0
411260;201807;21;14;7;13356.0;6678.0;20034.0
411270;201807;296;158;138;150732.0;131652.0;282384.0
411275;201807;205;180;25;171004.6;23850.0;194854.6
411280;201807;226;159;67;151369.0;63918.0;215287.0
411290;201807;58;43;15;41022.0;14310.0;55332.0
411295;201807;146;114;32;108756.0;30528.0;139284.0
411300;201807;69;35;34;33390.0;32436.0;65826.0
411310;201807;89;68;21;64872.0;20034.0;84906.0
411320;201807;753;544;209;517164.2;197783.28;714947.5
411325;201807;42;26;16;24804.0;15264.0;40068.0
411330;201807;921;596;325;566581.6;309319.6;875901.2
411340;201807;26;17;9;16218.0;8272.0;24490.0
411342;201807;72;54;18;51516.0;17172.0;68688.0
411345;201807;125;63;62;60102.0;59148.0;119250.0
411350;201807;488;388;100;368673.62;95105.0;463778.62
411360;201807;55;35;20;33390.0;19080.0;52470.0
411370;201807;14256;5832;8424;5542369.5;8022446.0;1,36E+14
411373;201807;186;138;48;131652.0;45792.0;177444.0
411375;201807;71;59;12;56286.0;11448.0;67734.0
411380;201807;94;70;24;66780.0;22896.0;89676.0
411390;201807;134;89;45;84906.0;42930.0;127836.0
411400;201807;355;266;89;253755.0;84906.0;338661.0
411410;201807;443;231;212;219706.2;201962.0;421668.2
411420;201807;1024;472;552;447712.2;526131.2;973843.4
411430;201807;417;267;150;254050.2;143091.0;397141.2
411435;201807;36;25;11;23850.0;10494.0;34344.0
411440;201807;477;384;93;364645.0;88722.0;453367.0
411450;201807;427;355;72;338670.0;68688.0;407358.0
411460;201807;762;301;461;286306.1;438345.6;724651.7
411470;201807;85;63;22;60102.0;20988.0;81090.0
411480;201807;641;364;277;344776.4;263971.8;608748.2
411490;201807;294;184;110;175536.0;104940.0;280476.0
411500;201807;112;94;18;89472.33;16505.0;105977.33
411510;201807;217;176;41;167156.06;39114.0;206270.06
411520;201807;5923;2309;3614;2198964.8;3440857.8;5639822.5
411530;201807;115;80;35;76320.0;33390.0;109710.0
411535;201807;48;19;29;18126.0;27666.0;45792.0
411540;201807;354;246;108;233661.9;103032.0;336693.9
411545;201807;55;39;16;37206.0;15264.0;52470.0
411550;201807;74;56;18;53424.0;17172.0;70596.0
411560;201807;388;177;211;168194.38;201294.0;369488.38
411570;201807;777;298;479;283997.0;456766.47;740763.44
411573;201807;34;21;13;20034.0;12402.0;32436.0
411575;201807;266;166;100;158364.0;95400.0;253764.0
411580;201807;1253;499;754;473785.84;717468.4;1191254.2
411585;201807;79;40;39;38160.0;37206.0;75366.0
411590;201807;25;18;7;17172.0;6678.0;23850.0
411600;201807;28;12;16;11448.0;15264.0;26712.0
411605;201807;250;108;142;103006.0;135468.0;238474.0
411610;201807;236;160;76;152640.0;72504.0;225144.0
411620;201807;362;205;157;195093.0;149139.0;344232.0
411630;201807;57;40;17;38160.0;16218.0;54378.0
411640;201807;34;28;6;26712.0;5724.0;32436.0
411650;201807;13;8;5;7632.0;4770.0;12402.0
411660;201807;32;25;7;23850.0;6678.0;30528.0
411670;201807;245;185;60;176490.0;57240.0;233730.0
411680;201807;153;132;21;125928.0;20034.0;145962.0
411690;201807;596;315;281;299932.44;267728.3;567660.75
411695;201807;62;46;16;43884.0;15264.0;59148.0
411700;201807;162;140;22;133560.0;20988.0;154548.0
411705;201807;103;67;36;63918.0;34344.0;98262.0
411710;201807;303;204;99;193549.81;94446.0;287995.8
411720;201807;140;91;49;86814.0;46746.0;133560.0
411721;201807;66;55;11;52470.0;10494.0;62964.0
411722;201807;98;42;56;40068.0;53424.0;93492.0
411725;201807;149;116;33;110091.8;31482.0;141573.8
411727;201807;73;57;16;54378.0;14977.8;69355.8
411729;201807;32;26;6;24804.0;5724.0;30528.0
411730;201807;547;354;193;336125.97;183835.8;519961.75
411740;201807;37;23;14;21942.0;13356.0;35298.0
411745;201807;69;46;23;43093.0;21942.0;65035.0
411750;201807;869;413;456;392905.9;434055.7;826961.56
411760;201807;1202;908;294;864983.2;280467.0;1145450.2
411770;201807;446;299;147;285226.9;140238.0;425464.9
411780;201807;374;240;134;228960.0;127836.0;356796.0
411790;201807;538;302;236;286226.47;224840.34;511066.8
411800;201807;169;133;36;126882.0;34344.0;161226.0
411810;201807;166;126;40;120204.0;38160.0;158364.0
411820;201807;2085;1021;1064;971439.44;1014332.3;1985771.8
411830;201807;12;12;0;11448.0;0.0;11448.0
411840;201807;1956;1219;737;1160731.8;702605.0;1863336.8
411845;201807;51;20;31;19080.0;29574.0;48654.0
411850;201807;1238;704;534;670048.4;507482.47;1177530.9
411860;201807;45;29;16;27380.0;15264.0;42644.0
411870;201807;75;55;20;52470.0;18793.8;71263.8
411880;201807;425;271;154;258420.0;146171.88;404591.88
411885;201807;106;70;36;66780.0;34344.0;101124.0
411890;201807;321;204;117;192422.98;111608.46;304031.44
411900;201807;70;51;19;48654.0;18126.0;66780.0
411910;201807;178;141;37;134504.45;34458.48;168962.94
411915;201807;2108;910;1198;867273.75;1141590.0;2008863.9
411920;201807;127;105;22;100170.0;20988.0;121158.0
411925;201807;14;9;5;8586.0;4770.0;13356.0
411930;201807;800;587;213;558092.0;203202.0;761294.0
411940;201807;589;417;172;397341.0;164063.56;561404.56
411950;201807;898;479;419;456298.2;399058.2;855356.4
411960;201807;987;693;294;658267.7;280476.0;938743.7
411965;201807;25;17;8;16218.0;7632.0;23850.0
411970;201807;73;65;8;62010.0;7632.0;69642.0
411980;201807;201;128;73;121825.8;69642.0;191467.8
411990;201807;5057;2945;2112;2792569.2;2013127.4;4805697.0
411995;201807;457;172;285;164088.0;271890.0;435978.0
412000;201807;304;182;122;172747.2;116378.46;289125.66
412010;201807;51;29;22;27666.0;20988.0;48654.0
412015;201807;46;32;14;30528.0;13356.0;43884.0
412020;201807;27;23;4;21655.8;3816.0;25471.8
412030;201807;59;50;9;47700.0;8586.0;56286.0
412033;201807;54;36;18;34320.0;17172.0;51492.0
412035;201807;70;44;26;41976.0;24804.0;66780.0
412040;201807;37;26;11;24518.0;10494.0;35012.0
412050;201807;200;150;50;143100.0;47700.0;190800.0
412060;201807;754;585;169;555228.75;160235.8;715464.56
412065;201807;50;34;16;32436.0;15264.0;47700.0
412070;201807;160;108;52;102364.2;49608.0;151972.2
412080;201807;281;149;132;142146.0;125928.0;268074.0
412085;201807;32;16;16;15264.0;15264.0;30528.0
412090;201807;755;480;275;456251.2;262350.0;718601.2
412100;201807;248;208;40;197479.0;38160.0;235639.0
412110;201807;70;56;14;53424.0;13356.0;66780.0
412120;201807;309;205;104;194997.6;99216.0;294213.6
412125;201807;80;47;33;44551.8;31482.0;76033.8
412130;201807;45;33;12;30891.0;11448.0;42339.0
412135;201807;29;17;12;16218.0;11448.0;27666.0
412140;201807;319;226;93;214964.81;88722.0;303686.8
412150;201807;256;178;78;168858.05;74412.0;243270.05
412160;201807;85;51;34;48654.0;32436.0;81090.0
412170;201807;665;465;200;443323.8;190800.0;634123.8
412175;201807;38;28;10;26712.0;9540.0;36252.0
412180;201807;195;155;40;147270.61;37539.9;184810.52
412190;201807;336;267;69;254045.44;65826.0;319871.44
412200;201807;197;124;73;118296.0;69642.0;187938.0
412210;201807;75;58;17;55332.0;16218.0;71550.0
412215;201807;238;164;74;156456.0;70309.8;226765.8
412217;201807;72;56;16;53424.0;15264.0;68688.0
412220;201807;824;616;208;587664.0;198432.0;786096.0
412230;201807;336;204;132;192994.2;125891.46;318885.66
412240;201807;1334;652;682;618326.7;648452.06;1266778.8
412250;201807;383;246;137;234684.0;130698.0;365382.0
412260;201807;127;93;34;88722.0;32436.0;121158.0
412265;201807;171;135;36;128185.84;34344.0;162529.84
412270;201807;84;53;31;50562.0;29574.0;80136.0
412280;201807;92;73;19;69642.0;18126.0;87768.0
412290;201807;97;64;33;61056.0;31482.0;92538.0
412300;201807;213;138;75;131652.0;71406.9;203058.9
412310;201807;43;38;5;36252.0;4770.0;41022.0
412320;201807;93;79;14;75366.0;13356.0;88722.0
412330;201807;173;152;21;145008.0;20034.0;165042.0
412340;201807;148;103;45;98262.0;42644.0;140906.0
412350;201807;612;310;302;294738.3;288108.0;582846.3
412360;201807;29;25;4;23850.0;3816.0;27666.0
412370;201807;157;137;20;129104.0;19080.0;148184.0
412380;201807;261;194;67;184789.8;63814.0;248603.8
412382;201807;52;28;24;26712.0;22896.0;49608.0
412385;201807;143;103;40;98262.0;38160.0;136422.0
412390;201807;282;215;67;205110.0;63918.0;269028.0
412395;201807;69;54;15;51516.0;14310.0;65826.0
412400;201807;76;54;22;51516.0;20988.0;72504.0
412402;201807;254;121;133;115429.23;126595.8;242025.03
412405;201807;814;326;488;308568.53;464866.66;773435.2
412410;201807;947;594;353;563814.6;336762.0;900576.6
412420;201807;14;12;2;11448.0;1908.0;13356.0
412430;201807;21;15;6;14310.0;5724.0;20034.0
412440;201807;602;330;272;312507.5;257647.08;570154.56
412450;201807;80;68;12;64872.0;11448.0;76320.0
412460;201807;81;62;19;59148.0;18126.0;77274.0
412470;201807;264;210;54;199576.8;51516.0;251092.8
412480;201807;170;129;41;122112.9;39114.0;161226.9
412490;201807;165;141;24;134514.0;22896.0;157410.0
412500;201807;473;383;90;363807.8;85860.0;449667.8
412510;201807;185;153;32;145215.0;30528.0;175743.0
412520;201807;134;74;60;70596.0;57240.0;127836.0
412530;201807;106;56;50;53424.0;47413.8;100837.8
412535;201807;104;76;28;72486.0;26712.0;99198.0
412540;201807;69;35;34;33390.0;32436.0;65826.0
412545;201807;94;69;25;65826.0;23850.0;89676.0
412550;201807;3539;1602;1937;1524644.6;1845610.9;3370255.5
412555;201807;14;10;4;9540.0;3816.0;13356.0
412560;201807;587;438;149;415262.2;142146.0;557408.2
412570;201807;730;404;326;383587.38;310718.0;694305.4
412575;201807;80;57;23;54378.0;21942.0;76320.0
412580;201807;163;110;53;104940.0;50562.0;155502.0
412590;201807;33;31;2;29574.0;1908.0;31482.0
412600;201807;179;135;44;128790.0;41976.0;170766.0
412610;201807;31;19;12;18126.0;11448.0;29574.0
412620;201807;148;130;18;124020.0;17172.0;141192.0
412625;201807;2201;1177;1024;1120723.9;975018.56;2095742.4
412627;201807;71;56;15;53424.0;14310.0;67734.0
412630;201807;424;284;140;269402.44;133560.0;402962.44
412635;201807;68;20;48;19080.0;45792.0;64872.0
412640;201807;122;81;41;77274.0;39114.0;116388.0
412650;201807;346;217;129;207018.0;123061.23;330079.22
412660;201807;479;296;183;281669.0;174582.0;456251.0
412665;201807;51;45;6;42930.0;5724.0;48654.0
412667;201807;281;193;88;183327.55;83709.8;267037.34
412670;201807;60;51;9;48654.0;8586.0;57240.0
412680;201807;296;234;62;223236.0;59148.0;282384.0
412690;201807;119;77;42;73458.0;39782.0;113240.0
412700;201807;161;109;52;103986.0;49322.0;153308.0
412710;201807;1404;870;534;823686.6;507528.2;1331214.8
412720;201807;229;158;71;150732.0;67734.0;218466.0
412730;201807;198;159;39;151686.0;36252.0;187938.0
412740;201807;423;232;191;221184.9;182214.0;403398.9
412750;201807;468;270;198;256626.0;188892.0;445518.0
412760;201807;264;136;128;129744.0;122112.0;251856.0
412770;201807;2129;1205;924;1145187.0;879961.0;2025148.0
412780;201807;153;120;33;114480.0;31482.0;145962.0
412785;201807;271;136;135;129267.0;128790.0;258057.0
412788;201807;36;21;15;20034.0;14310.0;34344.0
412790;201807;136;112;24;106180.2;22896.0;129076.2
412795;201807;153;114;39;108756.0;37206.0;145962.0
412796;201807;298;210;88;199175.19;83818.44;282993.62
412800;201807;563;367;196;349558.38;186984.0;536542.4
412810;201807;3013;1668;1345;1586674.5;1281885.0;2868559.5
412820;201807;934;612;322;572915.8;306112.0;879027.8
412830;201807;15;12;3;11448.0;2862.0;14310.0
412840;201807;224;161;63;152640.2;60102.0;212742.2
412850;201807;784;532;252;505620.0;240408.0;746028.0
412853;201807;174;93;81;88722.0;77274.0;165996.0
412855;201807;216;117;99;110506.82;94446.0;204952.81
412860;201807;89;66;23;62964.0;21942.0;84906.0
412862;201807;60;44;16;41976.0;15264.0;57240.0
412863;201807;6;5;1;4770.0;954.0;5724.0
412865;201807;43;33;10;31482.0;9540.0;41022.0
412870;201807;109;73;36;69642.0;34344.0;103986.0
412880;201807;98;73;25;69642.0;23850.0;93492.0
420005;201807;39;34;5;32436.0;4198.0;36634.0
420010;201807;371;244;127;231588.34;120872.0;352460.34
420020;201807;77;65;12;62010.0;11448.0;73458.0
420030;201807;29;26;3;24804.0;2862.0;27666.0
420040;201807;106;81;25;77274.0;23850.0;101124.0
420050;201807;54;34;20;32436.0;19080.0;51516.0
420055;201807;20;19;1;18126.0;954.0;19080.0
420060;201807;33;24;9;22896.0;8586.0;31482.0
420070;201807;104;88;16;83952.0;15254.46;99206.46
420075;201807;11;10;1;9540.0;954.0;10494.0
420080;201807;51;45;6;41260.5;5724.0;46984.5
420090;201807;34;32;2;29750.49;1908.0;31658.49
420100;201807;166;138;28;130698.2;26712.0;157410.2
420110;201807;19;19;0;18126.0;0.0;18126.0
420120;201807;50;38;12;36252.0;11448.0;47700.0
420125;201807;85;68;17;64872.0;16218.0;81090.0
420127;201807;34;30;4;28620.0;3816.0;32436.0
420130;201807;392;245;147;233434.45;139989.95;373424.4
420140;201807;1289;742;547;706543.4;521772.0;1228315.4
420150;201807;45;40;5;38160.0;4770.0;42930.0
420160;201807;37;35;2;33390.0;1908.0;35298.0
420165;201807;19;14;5;13356.0;4770.0;18126.0
420170;201807;68;44;24;41976.0;22896.0;64872.0
420180;201807;24;22;2;20988.0;1908.0;22896.0
420190;201807;31;28;3;26712.0;2862.0;29574.0
420195;201807;127;62;65;59148.0;62010.0;121158.0
420200;201807;1277;575;702;543209.6;668670.4;1211880.0
420205;201807;67;36;31;34344.0;29574.0;63918.0
420207;201807;106;61;45;58194.0;42920.46;101114.46
420208;201807;23;18;5;17172.0;3911.4;21083.4
420209;201807;20;16;4;15264.0;3816.0;19080.0
420210;201807;468;226;242;215317.8;230782.69;446100.47
420213;201807;45;36;9;34344.0;8586.0;42930.0
420215;201807;27;23;4;21942.0;3816.0;25758.0
420220;201807;65;42;23;40068.0;21942.0;62010.0
420230;201807;775;441;334;419951.0;318149.47;738100.44
420240;201807;2295;1547;748;1467198.2;713153.2;2180351.5
420243;201807;38;31;7;29574.0;6678.0;36252.0
420245;201807;115;63;52;60102.0;49608.0;109710.0
420250;201807;54;32;22;30528.0;20988.0;51516.0
420253;201807;43;35;8;33390.0;7632.0;41022.0
420257;201807;13;11;2;10494.0;1908.0;12402.0
420260;201807;101;88;13;83952.0;12402.0;96354.0
420270;201807;38;31;7;29570.0;6678.0;36248.0
420280;201807;283;210;73;198471.06;68384.1;266855.16
420285;201807;19;12;7;11448.0;6678.0;18126.0
420287;201807;49;30;19;28620.0;18126.0;46746.0
420290;201807;981;693;288;657942.94;274684.3;932627.25
420300;201807;1384;1101;283;1046144.4;267502.12;1313646.5
420310;201807;59;47;12;44838.0;11448.0;56286.0
420315;201807;35;31;4;29574.0;3816.0;33390.0
420320;201807;849;432;417;411150.16;397814.0;808964.1
420325;201807;0;0;0;0.0;0.0;0.0
420330;201807;122;83;39;79182.0;37091.52;116273.52
420340;201807;163;111;52;104932.0;49588.92;154520.92
420350;201807;253;185;68;174935.78;64872.0;239807.78
420360;201807;760;580;180;550246.6;171053.78;721300.44
420370;201807;112;71;41;67544.0;38828.0;106372.0
420380;201807;1138;814;324;772446.1;308059.03;1080505.1
420390;201807;256;167;89;157487.52;84190.5;241678.02
420395;201807;187;134;53;127836.0;49676.8;177512.8
420400;201807;243;182;61;172675.0;58194.0;230869.0
420410;201807;60;46;14;43884.0;13356.0;57240.0
420415;201807;33;31;2;29574.0;1908.0;31482.0
420417;201807;50;37;13;35298.0;12382.92;47680.92
420419;201807;12;12;0;11448.0;0.0;11448.0
420420;201807;2811;1720;1091;1628375.2;1038525.9;2666901.0
420425;201807;74;62;12;59139.0;11134.26;70273.26
420430;201807;1273;888;385;843445.25;365536.12;1208981.4
420435;201807;16;14;2;13356.0;1908.0;15264.0
420440;201807;108;73;35;69014.68;33238.6;102253.28
420445;201807;22;19;3;18126.0;2862.0;20988.0
420450;201807;79;38;41;36252.0;39114.0;75366.0
420455;201807;211;158;53;150694.92;50506.38;201201.3
420460;201807;2350;1564;786;1486666.8;749591.8;2236258.5
420470;201807;118;84;34;80136.0;32436.0;112572.0
420475;201807;6;6;0;5724.0;0.0;5724.0
420480;201807;875;653;222;617660.3;210739.0;828399.3
420490;201807;112;88;24;83952.0;22896.0;106848.0
420500;201807;659;288;371;272781.2;353934.0;626715.2
420510;201807;19;16;3;15264.0;2862.0;18126.0
420515;201807;26;20;6;19080.0;5724.0;24804.0
420517;201807;10;10;0;9540.0;0.0;9540.0
420519;201807;0;0;0;0.0;0.0;0.0
420520;201807;69;52;17;49608.0;16218.0;65826.0
420530;201807;168;113;55;106827.02;52470.0;159297.02
420535;201807;21;19;2;18126.0;1908.0;20034.0
420540;201807;5000;2956;2044;2808162.8;1944682.1;4752845.0
420543;201807;26;26;0;24804.0;0.0;24804.0
420545;201807;197;139;58;131652.0;55312.92;186964.92
420550;201807;857;689;168;654408.3;160114.73;814523.06
420555;201807;39;27;12;25758.0;11448.0;37206.0
420560;201807;67;54;13;51134.4;12402.0;63536.4
420570;201807;152;90;62;85860.0;59138.46;144998.45
420580;201807;294;131;163;124974.0;155216.0;280190.0
420590;201807;521;369;152;351472.7;145008.0;496480.7
420600;201807;101;52;49;49608.0;46746.0;96354.0
420610;201807;37;35;2;33104.0;1908.0;35012.0
420620;201807;75;61;14;58194.0;13356.0;71550.0
420630;201807;159;117;42;111609.23;40060.0;151669.23
420640;201807;94;83;11;78991.2;10494.0;89485.2
420650;201807;242;128;114;121444.2;108137.23;229581.44
420660;201807;55;42;13;39304.8;12402.0;51706.8
420665;201807;38;28;10;26426.0;9540.0;35966.0
420670;201807;318;239;79;227280.95;75347.46;302628.4
420675;201807;15;14;1;13356.0;954.0;14310.0
420680;201807;36;26;10;24804.0;9540.0;34344.0
420690;201807;177;145;32;137566.8;30528.0;168094.8
420700;201807;663;453;210;432060.3;200087.81;632148.1
420710;201807;153;89;64;84906.0;60769.8;145675.8
420720;201807;109;89;20;84896.46;19080.0;103976.46
420730;201807;553;354;199;336649.5;188560.66;525210.2
420740;201807;46;45;1;42930.0;954.0;43884.0
420750;201807;502;336;166;320257.8;158364.0;478621.8
420757;201807;19;16;3;14453.1;2862.0;17315.1
420760;201807;38;31;7;29574.0;6678.0;36252.0
420765;201807;71;58;13;55332.0;12402.0;67734.0
420768;201807;66;58;8;55332.0;7632.0;62964.0
420770;201807;84;70;14;66780.0;13356.0;80136.0
420775;201807;45;41;4;39114.0;3816.0;42930.0
420780;201807;239;188;51;179342.45;48654.0;227996.45
420785;201807;15;11;4;10494.0;3816.0;14310.0
420790;201807;176;146;30;139191.3;27638.46;166829.77
420800;201807;75;57;18;53614.8;17172.0;70786.8
420810;201807;252;216;36;206055.0;33533.1;239588.1
420820;201807;2342;1392;950;1322259.4;904951.8;2227211.2
420830;201807;594;332;262;314433.94;248984.45;563418.44
420840;201807;151;113;38;107802.0;35548.0;143350.0
420845;201807;446;197;249;187553.06;236306.0;423859.06
420850;201807;234;186;48;177444.0;45792.0;223236.0
420860;201807;63;54;9;51516.0;8586.0;60102.0
420870;201807;117;84;33;80136.0;31482.0;111618.0
420880;201807;175;122;53;116378.46;49798.8;166177.27
420890;201807;876;429;447;405224.84;425856.6;831081.44
420895;201807;10;10;0;9540.0;0.0;9540.0
420900;201807;424;331;93;313715.03;88684.38;402399.4
420910;201807;5808;3257;2551;3096964.0;2428944.2;5525908.5
420915;201807;77;71;6;67734.0;5724.0;73458.0
420917;201807;20;14;6;13356.0;5724.0;19080.0
420920;201807;22;15;7;14310.0;6678.0;20988.0
420930;201807;2718;1670;1048;1588567.6;994465.75;2583033.2
420940;201807;618;446;172;424139.6;162436.08;586575.7
420945;201807;8;6;2;5724.0;1908.0;7632.0
420950;201807;57;52;5;49608.0;4770.0;54378.0
420960;201807;114;89;25;84868.92;23841.0;108709.92
420970;201807;303;243;60;230155.84;57212.46;287368.3
420980;201807;23;23;0;21942.0;0.0;21942.0
420985;201807;63;55;8;52470.0;7632.0;60102.0
420990;201807;75;59;16;56286.0;15264.0;71550.0
421000;201807;33;22;11;20988.0;10494.0;31482.0
421003;201807;69;45;24;42930.0;22887.0;65817.0
421005;201807;9;5;4;4770.0;3816.0;8586.0
421010;201807;762;534;228;508187.0;216406.2;724593.2
421020;201807;29;24;5;22896.0;4770.0;27666.0
421030;201807;130;110;20;104557.0;19080.0;123637.0
421040;201807;70;60;10;57240.0;9540.0;66780.0
421050;201807;319;231;88;218275.2;83952.0;302227.2
421055;201807;24;20;4;19080.0;3816.0;22896.0
421060;201807;81;55;26;52470.0;24804.0;77274.0
421070;201807;51;46;5;43884.0;4770.0;48654.0
421080;201807;34;31;3;29574.0;2862.0;32436.0
421085;201807;25;20;5;19080.0;4770.0;23850.0
421090;201807;43;32;11;30528.0;10494.0;41022.0
421100;201807;131;97;34;92538.0;32436.0;124974.0
421105;201807;219;177;42;168571.8;40044.69;208616.48
421110;201807;112;91;21;86193.9;20034.0;106227.9
421120;201807;156;121;35;114938.46;33370.92;148309.38
421125;201807;17;12;5;11448.0;4770.0;16218.0
421130;201807;818;529;289;503536.06;274666.53;778202.56
421140;201807;32;23;9;21226.5;8586.0;29812.5
421145;201807;40;31;9;29574.0;8586.0;38160.0
421150;201807;109;79;30;75366.0;28620.0;103986.0
421160;201807;65;43;22;41012.46;20988.0;62000.46
421165;201807;17;16;1;15264.0;954.0;16218.0
421170;201807;195;170;25;161267.84;23841.0;185108.84
421175;201807;152;100;52;95400.0;49560.38;144960.38
421180;201807;58;37;21;34936.0;20034.0;54970.0
421185;201807;17;14;3;13356.0;2862.0;16218.0
421187;201807;0;0;0;0.0;0.0;0.0
421189;201807;38;30;8;28620.0;7622.46;36242.46
421190;201807;1567;971;596;925371.44;567561.56;1492933.0
421200;201807;90;68;22;63918.7;20988.0;84906.7
421205;201807;27;19;8;18126.0;7632.0;25758.0
421210;201807;182;123;59;117342.0;56286.0;173628.0
421220;201807;278;221;57;210213.9;54378.0;264591.9
421223;201807;54;46;8;43694.0;7632.0;51326.0
421225;201807;68;43;25;41022.0;23850.0;64872.0
421227;201807;96;72;24;68688.0;22896.0;91584.0
421230;201807;54;41;13;39114.0;12402.0;51516.0
421240;201807;18;18;0;17172.0;0.0;17172.0
421250;201807;356;222;134;210454.0;127044.18;337498.2
421260;201807;27;22;5;20988.0;4770.0;25758.0
421265;201807;0;0;0;0.0;0.0;0.0
421270;201807;53;47;6;44838.0;5724.0;50562.0
421280;201807;339;191;148;182214.0;139474.8;321688.8
421290;201807;325;212;113;202010.0;105676.26;307686.25
421300;201807;25;20;5;19080.0;4770.0;23850.0
421310;201807;54;41;13;38446.2;12402.0;50848.2
421315;201807;30;20;10;19080.0;9540.0;28620.0
421320;201807;133;94;39;89676.0;37206.0;126882.0
421330;201807;108;82;26;76110.12;24795.0;100905.12
421335;201807;38;25;13;23850.0;12402.0;36252.0
421340;201807;294;199;95;188082.05;90630.0;278712.06
421350;201807;184;109;75;103543.0;71550.0;175093.0
421360;201807;691;512;179;484446.25;170175.06;654621.3
421370;201807;195;150;45;143100.0;42596.1;185696.1
421380;201807;127;102;25;97303.23;23850.0;121153.23
421390;201807;15;11;4;10494.0;3816.0;14310.0
421400;201807;116;98;18;93492.0;17172.0;110664.0
421410;201807;22;19;3;18126.0;2862.0;20988.0
421415;201807;22;21;1;20034.0;954.0;20988.0
421420;201807;151;124;27;117723.6;25758.0;143481.6
421430;201807;14;10;4;9540.0;3816.0;13356.0
421440;201807;56;43;13;41022.0;12402.0;53424.0
421450;201807;96;83;13;79182.0;12402.0;91584.0
421460;201807;57;48;9;44987.77;8586.0;53573.77
421470;201807;70;46;24;43884.0;22896.0;66780.0
421480;201807;637;474;163;451433.0;155493.0;606926.0
421490;201807;23;22;1;20312.0;954.0;21266.0
421500;201807;514;331;183;313991.3;174304.44;488295.75
421505;201807;28;19;9;18126.0;8586.0;26712.0
421507;201807;33;27;6;25758.0;5724.0;31482.0
421510;201807;74;48;26;45792.0;24804.0;70596.0
421520;201807;67;58;9;54569.0;8586.0;63155.0
421530;201807;54;49;5;46746.0;4770.0;51516.0
421535;201807;27;26;1;24537.0;954.0;25491.0
421540;201807;58;50;8;47700.0;7632.0;55332.0
421545;201807;96;73;23;69156.0;21942.0;91098.0
421550;201807;289;211;78;200627.0;74412.0;275039.0
421555;201807;26;21;5;20034.0;4675.0;24709.0
421560;201807;8;7;1;6678.0;954.0;7632.0
421565;201807;124;90;34;85860.0;32436.0;118296.0
421567;201807;31;26;5;24804.0;4770.0;29574.0
421568;201807;32;30;2;28620.0;1908.0;30528.0
421569;201807;7;7;0;6678.0;0.0;6678.0
421570;201807;153;104;49;99216.0;46746.0;145962.0
421575;201807;27;22;5;20988.0;4770.0;25758.0
421580;201807;722;430;292;409171.2;277614.34;686785.56
421590;201807;22;21;1;20034.0;954.0;20988.0
421600;201807;110;75;35;71550.0;32151.0;103701.0
421605;201807;105;75;30;71217.0;28620.0;99837.0
421610;201807;189;150;39;142146.2;37206.0;179352.2
421620;201807;1103;661;442;628094.94;421648.9;1049743.9
421625;201807;22;20;2;19080.0;1908.0;20988.0
421630;201807;292;185;107;175679.8;101220.0;276899.8
421635;201807;16;8;8;7632.0;7632.0;15264.0
421640;201807;99;85;14;80900.0;13356.0;94256.0
421650;201807;287;169;118;161206.92;112552.92;273759.84
421660;201807;2144;1290;854;1227085.9;813544.25;2040630.1
421670;201807;188;133;55;126882.0;52470.0;179352.0
421680;201807;170;153;17;145962.0;16209.0;162171.0
421690;201807;354;245;109;232657.38;103022.58;335679.97
421700;201807;59;37;22;35298.0;20130.0;55428.0
421710;201807;24;24;0;22896.0;0.0;22896.0
421715;201807;8;7;1;6678.0;954.0;7632.0
421720;201807;588;428;160;405579.16;150913.27;556492.44
421725;201807;12;5;7;4770.0;6678.0;11448.0
421730;201807;40;28;12;26004.12;11448.0;37452.12
421740;201807;88;42;46;40068.0;43884.0;83952.0
421750;201807;228;171;57;160688.52;54378.0;215066.52
421755;201807;26;24;2;22896.0;1908.0;24804.0
421760;201807;107;76;31;72504.0;29574.0;102078.0
421770;201807;580;391;189;370246.38;180041.3;550287.7
421775;201807;29;19;10;18126.0;9540.0;27666.0
421780;201807;195;153;42;145962.0;40068.0;186030.0
421790;201807;160;133;27;125989.5;25758.0;151747.5
421795;201807;17;13;4;12402.0;3816.0;16218.0
421800;201807;487;312;175;296851.3;166712.0;463563.3
421810;201807;70;55;15;52470.0;14310.0;66780.0
421820;201807;314;216;98;205396.2;93492.0;298888.2
421825;201807;128;107;21;102078.0;20034.0;122112.0
421830;201807;131;101;30;96354.0;28620.0;124974.0
421835;201807;3;3;0;2862.0;0.0;2862.0
421840;201807;59;49;10;46737.0;9540.0;56277.0
421850;201807;77;67;10;63918.0;9536.0;73454.0
421860;201807;42;33;9;31482.0;8586.0;40068.0
421870;201807;976;744;232;701350.75;220543.42;921894.2
421875;201807;54;46;8;43884.0;7632.0;51516.0
421880;201807;164;121;43;115434.0;40736.0;156170.0
421885;201807;27;22;5;20988.0;4770.0;25758.0
421890;201807;119;84;35;80136.0;33381.0;113517.0
421895;201807;43;40;3;38160.0;2862.0;41022.0
421900;201807;153;124;29;117935.1;27630.0;145565.1
421910;201807;67;44;23;41976.0;21942.0;63918.0
421915;201807;33;28;5;26712.0;4770.0;31482.0
421917;201807;41;31;10;29574.0;9540.0;39114.0
421920;201807;33;30;3;28620.0;2862.0;31482.0
421930;201807;748;582;166;553201.25;158337.0;711538.25
421935;201807;57;50;7;47700.0;6678.0;54378.0
421940;201807;40;37;3;35298.0;2862.0;38160.0
421950;201807;838;555;283;522682.0;267530.1;790212.06
421960;201807;42;35;7;33104.0;6656.12;39760.12
421970;201807;373;236;137;224645.12;130667.12;355312.25
421985;201807;33;21;12;20034.0;11448.0;31482.0
422000;201807;0;0;0;0.0;0.0;0.0
430003;201807;204;51;153;47938.5;145962.0;193900.5
430005;201807;36;28;8;26712.0;7632.0;34344.0
430010;201807;277;194;83;184599.0;79182.0;263781.0
430020;201807;153;100;53;95114.0;50562.0;145676.0
430030;201807;133;105;28;99883.8;26712.0;126595.8
430040;201807;2983;1736;1247;1646974.0;1187989.4;2834963.2
430045;201807;66;57;9;54091.8;8586.0;62677.8
430047;201807;6;5;1;4770.0;954.0;5724.0
430050;201807;79;66;13;62964.0;12402.0;75366.0
430055;201807;17;14;3;13356.0;2862.0;16218.0
430057;201807;5;3;2;2862.0;1908.0;4770.0
430060;201807;3651;2181;1470;2073430.9;1398939.8;3472370.8
430063;201807;59;54;5;51516.0;4770.0;56286.0
430064;201807;151;124;27;118296.0;25758.0;144054.0
430066;201807;10;7;3;6678.0;2862.0;9540.0
430070;201807;43;33;10;31482.0;9540.0;41022.0
430080;201807;68;45;23;42230.33;21942.0;64172.33
430085;201807;34;12;22;11448.0;20988.0;32436.0
430087;201807;32;23;9;21799.0;8586.0;30385.0
430090;201807;71;64;7;60769.8;6678.0;67447.8
430100;201807;129;87;42;82044.0;40068.0;122112.0
430105;201807;143;72;71;68498.0;67428.72;135926.72
430107;201807;20;15;5;14310.0;4770.0;19080.0
430110;201807;414;244;170;231907.86;162094.14;394002.0
430120;201807;140;129;11;122112.0;10494.0;132606.0
430130;201807;800;501;299;477333.9;284959.8;762293.7
430140;201807;122;114;8;108756.0;7632.0;116388.0
430150;201807;112;72;40;67925.0;37206.0;105131.0
430155;201807;32;29;3;27666.0;2862.0;30528.0
430160;201807;3795;2249;1546;2127976.0;1472718.6;3600694.5
430163;201807;333;151;182;143005.34;173599.38;316604.72
430165;201807;26;18;8;17172.0;7632.0;24804.0
430170;201807;84;74;10;70596.0;9540.0;80136.0
430175;201807;84;65;19;62010.0;17458.2;79468.2
430180;201807;107;84;23;80136.0;21321.9;101457.9
430185;201807;34;26;8;24804.0;7632.0;32436.0
430187;201807;99;41;58;39114.0;55026.8;94140.8
430190;201807;221;127;94;121110.3;88999.46;210109.77
430192;201807;15;14;1;13356.0;954.0;14310.0
430195;201807;14;9;5;8586.0;4770.0;13356.0
430200;201807;167;148;19;140524.2;18126.0;158650.2
430205;201807;20;19;1;18126.0;954.0;19080.0
430210;201807;636;493;143;466506.0;134561.9;601067.9
430215;201807;16;11;5;10494.0;4770.0;15264.0
430220;201807;68;49;19;46746.0;18126.0;64872.0
430222;201807;12;7;5;6678.0;4770.0;11448.0
430223;201807;13;7;6;6678.0;5724.0;12402.0
430225;201807;4;3;1;2862.0;954.0;3816.0
430230;201807;295;181;114;171720.0;108660.6;280380.6
430235;201807;52;36;16;34344.0;15254.46;49598.46
430237;201807;29;22;7;20988.0;6678.0;27666.0
430240;201807;130;84;46;79945.2;43884.0;123829.2
430245;201807;74;63;11;60102.0;10494.0;70596.0
430250;201807;190;111;79;105884.46;75356.46;181240.92
430258;201807;12;10;2;9540.0;1908.0;11448.0
430260;201807;34;29;5;27666.0;4760.46;32426.46
430265;201807;34;29;5;27646.92;4770.0;32416.92
430270;201807;551;412;139;389944.75;131749.02;521693.75
430280;201807;1049;645;404;610840.0;382916.6;993756.56
430290;201807;378;219;159;207018.8;151686.0;358704.8
430300;201807;2129;1178;951;1119339.5;904204.4;2023543.8
430310;201807;1981;1044;937;989691.4;890865.94;1880557.4
430320;201807;51;43;8;41007.69;7632.0;48639.69
430330;201807;94;84;10;79659.0;9520.92;89179.92
430340;201807;67;59;8;56286.0;7632.0;63918.0
430350;201807;1681;1170;511;1104050.9;485996.75;1590047.6
430355;201807;26;23;3;21942.0;2862.0;24804.0
430360;201807;82;39;43;37206.0;41022.0;78228.0
430367;201807;28;20;8;19080.0;7632.0;26712.0
430370;201807;56;48;8;45792.0;7632.0;53424.0
430380;201807;129;96;33;91011.6;31482.0;122493.6
430390;201807;617;385;232;367003.8;220736.02;587739.8
430400;201807;140;108;32;101124.0;30508.92;131632.92
430410;201807;61;48;13;45792.0;12402.0;58194.0
430420;201807;502;329;173;311386.8;163545.56;474932.38
430430;201807;52;49;3;46110.63;2051.1;48161.73
430435;201807;158;118;40;111618.0;37444.5;149062.5
430440;201807;502;334;168;318636.0;160081.2;478717.2
430450;201807;1188;979;209;927085.6;199376.45;1126462.1
430460;201807;5096;2803;2293;2659107.8;2181755.0;4840862.5
430461;201807;17;15;2;14310.0;1908.0;16218.0
430462;201807;9;6;3;5724.0;2862.0;8586.0
430463;201807;1025;542;483;515121.9;460430.1;975552.0
430465;201807;26;14;12;13356.0;11448.0;24804.0
430466;201807;666;483;183;458874.2;174391.2;633265.4
430467;201807;99;57;42;53137.8;40058.46;93196.26
430468;201807;110;68;42;64872.0;39816.91;104688.91
430469;201807;23;18;5;17172.0;4770.0;21942.0
430470;201807;1166;644;522;608691.56;496032.3;1104723.9
430471;201807;50;37;13;35278.92;12402.0;47680.92
430480;201807;97;60;37;56095.2;35288.46;91383.66
430485;201807;6;6;0;5438.0;0.0;5438.0
430490;201807;89;72;17;67877.7;16218.0;84095.7
430495;201807;37;27;10;25758.0;9540.0;35298.0
430500;201807;191;126;65;119917.8;61634.46;181552.27
430510;201807;3159;2090;1069;1985941.9;1018653.1;3004595.0
430511;201807;16;16;0;15264.0;0.0;15264.0
430512;201807;136;97;39;92538.0;37206.0;129744.0
430513;201807;52;43;9;40545.0;8586.0;49131.0
430515;201807;31;29;2;27666.0;1908.0;29574.0
430517;201807;167;148;19;140238.0;18106.92;158344.92
430520;201807;371;259;112;246419.0;106819.38;353238.38
430530;201807;89;52;37;49608.0;35298.0;84906.0
430535;201807;476;319;157;303840.44;149750.16;453590.6
430537;201807;10;10;0;9540.0;0.0;9540.0
430540;201807;73;50;23;47700.0;21942.0;69642.0
430543;201807;370;115;255;109710.0;243270.0;352980.0
430544;201807;43;40;3;38160.0;2862.0;41022.0
430545;201807;349;169;180;160730.0;171208.66;331938.66
430550;201807;42;34;8;32436.0;7632.0;40068.0
430558;201807;5;3;2;2862.0;1908.0;4770.0
430560;201807;50;22;28;20988.0;26712.0;47700.0
430570;201807;104;44;60;41976.0;57182.76;99158.76
430580;201807;123;99;24;94446.0;21655.8;116101.8
430583;201807;14;14;0;13356.0;0.0;13356.0
430585;201807;8;3;5;2862.0;4770.0;7632.0
430587;201807;14;7;7;6678.0;6678.0;13356.0
430590;201807;152;122;30;115147.8;28620.0;143767.8
430593;201807;4;4;0;3816.0;0.0;3816.0
430595;201807;18;14;4;13356.0;3816.0;17172.0
430597;201807;51;27;24;25758.0;22896.0;48654.0
430600;201807;221;155;66;147860.45;62677.8;210538.27
430605;201807;161;102;59;97308.0;56276.46;153584.45
430607;201807;28;23;5;21942.0;4770.0;26712.0
430610;201807;1640;769;871;731041.4;826334.3;1557375.6
430613;201807;3;3;0;2862.0;0.0;2862.0
430620;201807;114;82;32;78228.0;30518.46;108746.46
430630;201807;45;39;6;37206.0;5724.0;42930.0
430632;201807;32;27;5;25758.0;4770.0;30528.0
430635;201807;41;37;4;35298.0;3816.0;39114.0
430637;201807;56;32;24;30528.0;22896.0;53424.0
430640;201807;203;113;90;106371.0;85860.0;192231.0
430642;201807;27;25;2;23850.0;1908.0;25758.0
430645;201807;35;29;6;27666.0;5724.0;33390.0
430650;201807;255;206;49;196238.0;46698.3;242936.3
430655;201807;4;4;0;3816.0;0.0;3816.0
430660;201807;970;472;498;448713.9;473565.8;922279.7
430670;201807;73;50;23;47700.0;21942.0;69642.0
430673;201807;69;38;31;36252.0;29574.0;65826.0
430675;201807;13;10;3;9540.0;2862.0;12402.0
430676;201807;496;300;196;285494.12;186913.06;472407.2
430680;201807;250;172;78;161607.8;74412.0;236019.8
430690;201807;533;318;215;302466.25;203435.06;505901.3
430692;201807;7;5;2;4770.0;1908.0;6678.0
430693;201807;147;98;49;93492.0;46736.46;140228.45
430695;201807;75;65;10;61075.08;9540.0;70615.08
430697;201807;57;35;22;33390.0;20988.0;54378.0
430700;201807;1587;1113;474;1050296.1;451909.8;1502206.0
430705;201807;19;18;1;17172.0;954.0;18126.0
430710;201807;260;169;91;161226.0;86814.0;248040.0
430720;201807;107;91;16;86623.2;15264.0;101887.2
430730;201807;120;102;18;96354.0;17172.0;113526.0
430740;201807;67;43;24;41022.0;22896.0;63918.0
430745;201807;36;29;7;27380.0;6678.0;34058.0
430750;201807;343;229;114;217522.64;107802.0;325324.62
430755;201807;81;46;35;43884.0;33390.0;77274.0
430760;201807;366;220;146;207209.72;139255.92;346465.62
430770;201807;1456;754;702;716645.7;664602.56;1381248.2
430780;201807;316;202;114;191726.72;108689.76;300416.47
430781;201807;28;23;5;21942.0;4770.0;26712.0
430783;201807;53;42;11;39750.13;10494.0;50244.13
430786;201807;6;3;3;2862.0;2862.0;5724.0
430790;201807;503;325;178;308778.12;169516.45;478294.6
430800;201807;157;129;28;123046.92;26712.0;149758.92
430805;201807;43;39;4;37206.0;3816.0;41022.0
430807;201807;38;25;13;23850.0;12402.0;36252.0
430810;201807;75;49;26;46746.0;24804.0;71550.0
430820;201807;136;85;51;81090.0;47986.2;129076.2
430825;201807;12;10;2;9540.0;1908.0;11448.0
430830;201807;236;222;14;211482.92;13356.0;224838.92
430840;201807;126;86;40;82044.0;37492.2;119536.2
430843;201807;5;3;2;2862.0;1908.0;4770.0
430845;201807;70;39;31;37206.0;29574.0;66780.0
430850;201807;574;399;175;379119.6;166846.77;545966.4
430860;201807;158;99;59;93778.2;55608.66;149386.86
430865;201807;68;37;31;34630.2;29259.18;63889.38
430870;201807;82;66;16;62296.2;15264.0;77560.2
430880;201807;160;121;39;115414.92;37206.0;152620.92
430885;201807;7;6;1;5724.0;954.0;6678.0
430890;201807;334;207;127;195818.05;121158.0;316976.03
430900;201807;537;372;165;350404.2;156933.0;507337.2
430905;201807;90;37;53;35298.0;50562.0;85860.0
430910;201807;265;148;117;141192.0;110942.0;252134.0
430912;201807;4;4;0;3816.0;0.0;3816.0
430915;201807;35;27;8;25758.0;7345.8;33103.8
430920;201807;4286;2378;1908;2261130.8;1817494.6;4078625.5
430925;201807;5;4;1;3567.96;954.0;4521.96
430930;201807;2110;1252;858;1186762.9;818281.5;2005044.4
430940;201807;257;163;94;154824.66;89656.92;244481.58
430950;201807;156;125;31;119250.0;29574.0;148824.0
430955;201807;22;14;8;13356.0;7632.0;20988.0
430957;201807;18;17;1;16218.0;954.0;17172.0
430960;201807;238;158;80;148299.3;76320.0;224619.3
430965;201807;107;67;40;63918.0;38160.0;102078.0
430970;201807;83;69;14;65826.0;12402.0;78228.0
430975;201807;36;32;4;30528.0;3816.0;34344.0
430980;201807;47;29;18;27666.0;17172.0;44838.0
430990;201807;118;89;29;84906.0;27666.0;112572.0
430995;201807;115;110;5;103699.8;4770.0;108469.8
431000;201807;304;138;166;129505.2;158364.0;287869.2
431010;201807;337;203;134;192803.4;127816.92;320620.3
431020;201807;1940;1134;806;1073751.4;764812.25;1838563.6
431030;201807;42;33;9;31482.0;8586.0;40068.0
431033;201807;390;197;193;187127.2;184122.0;371249.2
431036;201807;14;9;5;8586.0;4770.0;13356.0
431040;201807;130;79;51;74412.0;48544.29;122956.29
431041;201807;37;25;12;23850.0;11448.0;35298.0
431043;201807;46;26;20;24804.0;19080.0;43884.0
431046;201807;12;7;5;6678.0;4770.0;11448.0
431050;201807;203;131;72;124401.6;68444.06;192845.66
431053;201807;76;45;31;42166.8;29574.0;71740.8
431055;201807;62;42;20;40068.0;19060.92;59128.92
431057;201807;17;17;0;16218.0;0.0;16218.0
431060;201807;1674;1058;616;1000239.8;585822.0;1586061.9
431065;201807;19;11;8;10494.0;7632.0;18126.0
431070;201807;70;65;5;62010.0;4770.0;66780.0
431075;201807;7;7;0;6678.0;0.0;6678.0
431080;201807;138;87;51;82711.8;48654.0;131365.8
431085;201807;31;28;3;26712.0;2862.0;29574.0
431087;201807;13;11;2;10494.0;1908.0;12402.0
431090;201807;55;43;12;41022.0;11448.0;52470.0
431100;201807;1230;734;496;689459.0;473184.0;1162643.0
431110;201807;247;157;90;149778.0;85564.46;235342.45
431112;201807;29;17;12;16218.0;11448.0;27666.0
431113;201807;30;21;9;20034.0;8586.0;28620.0
431115;201807;153;107;46;101441.87;43874.46;145316.33
431120;201807;614;361;253;342458.2;240100.14;582558.3
431123;201807;4;3;1;2862.0;954.0;3816.0
431125;201807;93;83;10;79182.0;9540.0;88722.0
431127;201807;9;4;5;3816.0;4770.0;8586.0
431130;201807;664;428;236;406785.6;224838.72;631624.3
431140;201807;733;501;232;476714.0;221251.69;697965.7
431142;201807;35;27;8;24546.0;7632.0;32178.0
431150;201807;203;148;55;141192.0;52460.46;193652.45
431160;201807;56;50;6;47700.0;5724.0;53424.0
431162;201807;19;14;5;13356.0;4770.0;18126.0
431164;201807;4;4;0;3816.0;0.0;3816.0
431170;201807;106;86;20;82044.0;19080.0;101124.0
431171;201807;58;33;25;31243.5;23840.46;55083.96
431173;201807;1;1;0;954.0;0.0;954.0
431175;201807;203;100;103;94160.0;98252.46;192412.45
431177;201807;75;56;19;53424.0;17439.92;70863.92
431179;201807;13;11;2;10494.0;1908.0;12402.0
431180;201807;450;276;174;263304.0;165977.45;429281.47
431190;201807;88;68;20;64872.0;19080.0;83952.0
431198;201807;70;48;22;45792.0;20988.0;66780.0
431200;201807;21;17;4;16218.0;3816.0;20034.0
431205;201807;23;23;0;21942.0;0.0;21942.0
431210;201807;89;55;34;52137.0;32436.0;84573.0
431213;201807;30;25;5;23850.0;4770.0;28620.0
431215;201807;25;22;3;20988.0;2862.0;23850.0
431217;201807;5;4;1;3816.0;954.0;4770.0
431220;201807;67;58;9;55332.0;8586.0;63918.0
431225;201807;150;99;51;94437.0;48634.92;143071.92
431230;201807;98;86;12;82044.0;11448.0;93492.0
431235;201807;8;8;0;7632.0;0.0;7632.0
431237;201807;26;18;8;17172.0;7632.0;24804.0
431238;201807;13;10;3;9254.0;2862.0;12116.0
431240;201807;1006;649;357;617486.6;340253.62;957740.25
431242;201807;36;36;0;34344.0;0.0;34344.0
431244;201807;11;8;3;7632.0;2862.0;10494.0
431245;201807;55;41;14;39114.0;13356.0;52470.0
431247;201807;14;12;2;11448.0;1908.0;13356.0
431250;201807;273;142;131;135401.22;124954.92;260356.14
431260;201807;61;46;15;43884.0;14310.0;58194.0
431261;201807;19;13;6;12402.0;5724.0;18126.0
431262;201807;15;15;0;14310.0;0.0;14310.0
431265;201807;159;84;75;80136.0;71550.0;151686.0
431267;201807;13;12;1;11448.0;954.0;12402.0
431270;201807;318;265;53;252810.0;50562.0;303372.0
431275;201807;40;38;2;36252.0;1908.0;38160.0
431280;201807;19;15;4;13475.25;3816.0;17291.25
431290;201807;23;19;4;18126.0;3816.0;21942.0
431295;201807;4;4;0;3816.0;0.0;3816.0
431300;201807;23;20;3;19080.0;2862.0;21942.0
431301;201807;7;7;0;6678.0;0.0;6678.0
431303;201807;53;35;18;33265.98;16885.8;50151.78
431306;201807;226;119;107;113069.98;102078.0;215147.98
431308;201807;7;5;2;4770.0;1908.0;6678.0
431310;201807;65;56;9;53424.0;8586.0;62010.0
431320;201807;121;71;50;67714.92;47404.26;115119.18
431330;201807;171;111;60;105894.0;57240.0;163134.0
431333;201807;33;27;6;25758.0;5724.0;31482.0
431335;201807;10;5;5;4770.0;4770.0;9540.0
431337;201807;326;155;171;147183.2;162094.14;309277.34
431339;201807;23;20;3;19080.0;2862.0;21942.0
431340;201807;3021;1746;1275;1659838.8;1213290.0;2873128.8
431342;201807;41;24;17;22896.0;16218.0;39114.0
431344;201807;17;17;0;16218.0;0.0;16218.0
431346;201807;4;4;0;3816.0;0.0;3816.0
431349;201807;35;32;3;30528.0;2862.0;33390.0
431350;201807;918;539;379;510878.25;359906.03;870784.3
431360;201807;47;42;5;40068.0;4770.0;44838.0
431365;201807;319;152;167;144988.92;158354.45;303343.38
431370;201807;1347;797;550;757820.1;524522.5;1282342.6
431380;201807;97;83;14;79182.0;13356.0;92538.0
431390;201807;499;275;224;261348.5;213390.72;474739.22
431395;201807;283;124;159;118296.0;151667.0;269963.0
431400;201807;39;29;10;27666.0;9540.0;37206.0
431402;201807;104;72;32;68688.0;30528.0;99216.0
431403;201807;20;12;8;11448.0;7632.0;19080.0
431405;201807;645;346;299;328444.03;284933.0;613377.0
431406;201807;31;27;4;25758.0;3816.0;29574.0
431407;201807;53;42;11;40068.0;10494.0;50562.0
431410;201807;3319;2008;1311;1902199.2;1246162.5;3148361.8
431413;201807;16;13;3;12402.0;2862.0;15264.0
431415;201807;71;52;19;49608.0;18126.0;67734.0
431417;201807;23;12;11;11448.0;10494.0;21942.0
431420;201807;306;215;91;204473.95;86814.0;291287.97
431430;201807;43;18;25;17172.0;23850.0;41022.0
431440;201807;8970;6390;2580;6027765.0;2453608.2;8481373.0
431442;201807;28;15;13;14310.0;12402.0;26712.0
431445;201807;27;21;6;20034.0;5724.0;25758.0
431446;201807;7;6;1;5724.0;954.0;6678.0
431447;201807;87;62;25;59148.0;23850.0;82998.0
431449;201807;52;45;7;42930.0;6678.0;49608.0
431450;201807;416;284;132;269886.6;125212.5;395099.1
431454;201807;0;0;0;0.0;0.0;0.0
431455;201807;48;38;10;36252.0;9540.0;45792.0
431460;201807;531;366;165;347112.9;157123.8;504236.7
431470;201807;117;91;26;86122.54;24554.0;110676.54
431475;201807;11;10;1;9540.0;954.0;10494.0
431477;201807;37;25;12;23850.0;11448.0;35298.0
431478;201807;8;7;1;6678.0;954.0;7632.0
431480;201807;507;319;188;302780.53;179304.3;482084.8
431490;201807;28210;16078;12132;1,53E+14;1,15E+14;2,68E+14
431500;201807;78;53;25;50323.5;23850.0;74173.5
431505;201807;39;24;15;22896.0;14310.0;37206.0
431507;201807;12;10;2;9540.0;1908.0;11448.0
431510;201807;269;179;90;169926.4;84877.38;254803.8
431513;201807;23;19;4;18126.0;3816.0;21942.0
431514;201807;9;8;1;7632.0;954.0;8586.0
431515;201807;80;67;13;63918.0;12402.0;76320.0
431517;201807;3;2;1;1908.0;954.0;2862.0
431520;201807;37;33;4;31482.0;3816.0;35298.0
431530;201807;1594;716;878;682682.6;837188.06;1519870.8
431531;201807;24;22;2;20988.0;1908.0;22896.0
431532;201807;26;18;8;17172.0;7632.0;24804.0
431535;201807;25;16;9;15264.0;8586.0;23850.0
431540;201807;142;126;16;119183.22;15264.0;134447.22
431545;201807;17;15;2;14310.0;1908.0;16218.0
431550;201807;355;203;152;193375.8;144912.6;338288.4
431555;201807;13;12;1;11448.0;954.0;12402.0
431560;201807;4551;3212;1339;3033600.0;1275136.4;4308736.5
431570;201807;814;434;380;409934.2;359649.47;769583.7
431575;201807;36;25;11;23850.0;10494.0;34344.0
431580;201807;92;66;26;62010.0;24804.0;86814.0
431590;201807;137;114;23;107802.0;21942.0;129744.0
431595;201807;11;10;1;9540.0;954.0;10494.0
431600;201807;215;123;92;117322.92;87768.0;205090.92
431610;201807;127;92;35;86527.8;33390.0;119917.8
431620;201807;43;35;8;33390.0;7632.0;41022.0
431630;201807;140;116;24;110664.0;22896.0;133560.0
431640;201807;1352;841;511;797162.8;485233.84;1282396.6
431642;201807;39;36;3;33867.0;2862.0;36729.0
431643;201807;45;19;26;18126.0;24804.0;42930.0
431645;201807;299;173;126;165042.0;119917.8;284959.8
431647;201807;10;10;0;9540.0;0.0;9540.0
431650;201807;35;26;9;24804.0;8586.0;33390.0
431660;201807;292;187;105;176490.0;100170.0;276660.0
431670;201807;223;107;116;99454.5;110635.38;210089.88
431673;201807;3;3;0;2862.0;0.0;2862.0
431675;201807;30;25;5;23563.8;4770.0;28333.8
431680;201807;1119;809;310;767016.0;294691.12;1061707.1
431690;201807;4809;2929;1880;2771623.0;1789306.2;4560929.0
431695;201807;26;20;6;19080.0;5724.0;24804.0
431697;201807;0;0;0;0.0;0.0;0.0
431700;201807;179;139;40;132606.0;38160.0;170766.0
431710;201807;4021;1735;2286;1652457.0;2179400.5;3831857.5
431720;201807;1396;840;556;791992.75;529456.44;1321449.2
431725;201807;1;1;0;954.0;0.0;954.0
431730;201807;1205;818;387;772371.7;369198.0;1141569.8
431740;201807;1363;683;680;647060.1;646929.4;1293989.5
431750;201807;1872;1213;659;1146925.5;626749.94;1773675.4
431755;201807;6;5;1;4770.0;954.0;5724.0
431760;201807;1068;686;382;654062.4;364199.6;1018262.0
431770;201807;393;288;105;274075.47;100150.92;374226.38
431775;201807;28;21;7;20034.0;6678.0;26712.0
431780;201807;563;352;211;334978.03;201284.45;536262.5
431790;201807;158;120;38;113526.0;36204.3;149730.3
431795;201807;13;12;1;11448.0;954.0;12402.0
431800;201807;3387;1779;1608;1682117.0;1528427.1;3210544.2
431805;201807;17;15;2;14310.0;1908.0;16218.0
431810;201807;612;412;200;390414.97;190666.98;581081.94
431820;201807;311;177;134;168858.0;127836.0;296694.0
431830;201807;2335;1417;918;1348197.6;874511.6;2222709.2
431840;201807;523;353;170;333138.4;160883.38;494021.78
431842;201807;34;28;6;26712.0;5724.0;32436.0
431843;201807;12;8;4;7632.0;3816.0;11448.0
431844;201807;14;12;2;11448.0;1908.0;13356.0
431845;201807;29;26;3;24804.0;2862.0;27666.0
431846;201807;27;23;4;21942.0;3816.0;25758.0
431848;201807;15;12;3;11448.0;2862.0;14310.0
431849;201807;9;7;2;6678.0;1908.0;8586.0
431850;201807;809;669;140;636713.5;133321.5;770035.0
431860;201807;107;76;31;72504.0;28620.0;101124.0
431861;201807;3;2;1;1908.0;954.0;2862.0
431862;201807;52;33;19;31482.0;18126.0;49608.0
431870;201807;3458;2044;1414;1940622.8;1345783.8;3286406.5
431880;201807;958;700;258;661761.8;245178.0;906939.8
431890;201807;1299;804;495;761496.94;470623.0;1232119.9
431900;201807;180;128;52;122112.0;48816.18;170928.19
431910;201807;57;44;13;41976.0;12402.0;54378.0
431912;201807;37;20;17;19080.0;16218.0;35298.0
431915;201807;126;100;26;95400.0;24804.0;120204.0
431920;201807;145;107;38;101791.8;36252.0;138043.8
431930;201807;85;69;16;65110.5;15264.0;80374.5
431935;201807;4;3;1;2862.0;954.0;3816.0
431936;201807;14;13;1;12402.0;954.0;13356.0
431937;201807;18;13;5;12402.0;4770.0;17172.0
431940;201807;461;311;150;293927.4;141850.95;435778.38
431950;201807;494;317;177;300225.1;168706.44;468931.53
431960;201807;731;423;308;399642.22;293670.9;693313.1
431970;201807;72;64;8;61056.0;7632.0;68688.0
431971;201807;3;3;0;2862.0;0.0;2862.0
431973;201807;22;17;5;16218.0;4770.0;20988.0
431975;201807;7;6;1;5724.0;954.0;6678.0
431980;201807;205;129;76;122493.6;72504.0;194997.6
431990;201807;1226;663;563;631029.0;537056.0;1168085.0
432000;201807;1680;913;767;863049.25;728153.25;1591202.5
432010;201807;281;184;97;174238.56;92538.0;266776.56
432020;201807;169;137;32;130698.0;30528.0;161226.0
432023;201807;18;14;4;13356.0;3816.0;17172.0
432026;201807;67;61;6;58194.0;5724.0;63918.0
432030;201807;64;28;36;26712.0;34344.0;61056.0
432032;201807;22;19;3;18126.0;2862.0;20988.0
432035;201807;50;39;11;37206.0;10494.0;47700.0
432040;201807;105;73;32;69642.0;30528.0;100170.0
432045;201807;8;7;1;6678.0;954.0;7632.0
432050;201807;69;40;29;38160.0;27666.0;65826.0
432055;201807;101;74;27;70596.0;25758.0;96354.0
432057;201807;1;0;1;0.0;954.0;954.0
432060;201807;34;31;3;29574.0;2862.0;32436.0
432065;201807;30;27;3;25758.0;2862.0;28620.0
432067;201807;86;76;10;72484.92;9540.0;82024.92
432070;201807;411;307;104;290428.06;99187.92;389616.0
432080;201807;816;565;251;537330.94;239406.38;776737.3
432085;201807;16;12;4;11448.0;3816.0;15264.0
432090;201807;258;160;98;152640.0;93492.0;246132.0
432100;201807;175;117;58;111331.8;55332.0;166663.8
432110;201807;622;428;194;398213.0;184122.0;582335.0
432120;201807;955;579;376;551698.2;358618.12;910316.3
432130;201807;506;367;139;348782.4;131508.9;480291.3
432132;201807;24;21;3;20034.0;2862.0;22896.0
432135;201807;79;65;14;62010.0;13356.0;75366.0
432140;201807;264;209;55;199090.27;52470.0;251560.27
432143;201807;193;123;70;117342.0;66780.0;184122.0
432145;201807;273;188;85;178112.6;80803.8;258916.4
432146;201807;15;14;1;13356.0;954.0;14310.0
432147;201807;131;61;70;58194.0;66756.15;124950.15
432149;201807;17;13;4;12402.0;3816.0;16218.0
432150;201807;838;526;312;501555.97;295626.16;797182.1
432160;201807;1389;721;668;685488.7;636347.4;1321836.0
432162;201807;4;3;1;2862.0;954.0;3816.0
432163;201807;18;14;4;13356.0;3816.0;17172.0
432166;201807;120;90;30;86338.0;28620.0;114958.0
432170;201807;225;123;102;116389.0;97308.0;213697.0
432180;201807;525;324;201;306329.6;191468.0;497797.6
432183;201807;9;7;2;6678.0;1908.0;8586.0
432185;201807;82;71;11;67734.0;10494.0;78228.0
432190;201807;457;256;201;243832.86;191650.14;435483.0
432195;201807;84;72;12;68688.0;11448.0;80136.0
432200;201807;418;272;146;259488.0;139236.84;398724.84
432210;201807;122;79;43;73601.1;41022.0;114623.1
432215;201807;59;55;4;52470.0;3816.0;56286.0
432218;201807;20;19;1;18126.0;954.0;19080.0
432220;201807;688;347;341;330027.56;324806.75;654834.3
432225;201807;14;8;6;7155.0;5724.0;12879.0
432230;201807;143;87;56;82759.5;53424.0;136183.5
432232;201807;16;14;2;13356.0;1908.0;15264.0
432234;201807;4;3;1;2862.0;954.0;3816.0
432235;201807;2;2;0;1908.0;0.0;1908.0
432237;201807;30;17;13;16218.0;12402.0;28620.0
432240;201807;4286;2401;1885;2280825.0;1790621.4;4071446.5
432250;201807;1040;667;373;632932.75;355679.8;988612.56
432252;201807;41;35;6;32913.0;5724.0;38637.0
432253;201807;58;46;12;43884.0;11448.0;55332.0
432254;201807;24;11;13;10494.0;12402.0;22896.0
432255;201807;14;13;1;12402.0;954.0;13356.0
432260;201807;881;694;187;660369.3;177444.5;837813.8
432270;201807;232;169;63;161226.0;60102.0;221328.0
432280;201807;124;91;33;86337.8;31482.0;117819.8
432285;201807;1;1;0;954.0;0.0;954.0
432290;201807;70;63;7;58192.76;6678.0;64870.76
432300;201807;4648;2663;1985;2521356.0;1889963.1;4411319.0
432310;201807;115;92;23;87479.76;21942.0;109421.76
432320;201807;19;15;4;14310.0;3816.0;18126.0
432330;201807;18;13;5;12402.0;4770.0;17172.0
432335;201807;7;6;1;5724.0;954.0;6678.0
432340;201807;39;36;3;34344.0;2862.0;37206.0
432345;201807;98;69;29;65826.0;27666.0;93492.0
432350;201807;24;23;1;21942.0;954.0;22896.0
432360;201807;6;4;2;3816.0;1908.0;5724.0
432370;201807;25;25;0;23850.0;0.0;23850.0
432375;201807;36;32;4;30528.0;3816.0;34344.0
432377;201807;8;8;0;7632.0;0.0;7632.0
432380;201807;167;75;92;70882.2;87720.3;158602.5
500020;201807;249;139;110;132606.0;104338.98;236944.98
500025;201807;117;58;59;54378.0;56286.0;110664.0
500060;201807;1401;866;535;825591.6;509351.66;1334943.2
500070;201807;776;371;405;353583.0;386360.47;739943.44
500080;201807;132;102;30;97308.0;28620.0;125928.0
500085;201807;136;110;26;104654.0;23969.25;128623.25
500090;201807;334;160;174;152640.0;165996.0;318636.0
500100;201807;716;381;335;361280.12;319018.0;680298.1
500110;201807;2231;1011;1220;964167.44;1163057.6;2127225.0
500124;201807;312;178;134;169812.0;127549.8;297361.8
500150;201807;330;130;200;124011.0;190430.45;314441.47
500190;201807;532;364;168;346588.2;159786.0;506374.2
500200;201807;198;168;30;159929.0;28620.0;188549.0
500210;201807;1438;516;922;492049.38;878415.44;1370464.9
500215;201807;242;139;103;131648.42;98262.0;229910.42
500220;201807;786;509;277;485341.84;264248.47;749590.3
500230;201807;260;176;84;167188.5;79659.0;246847.5
500240;201807;701;487;214;463834.8;203869.8;667704.6
500260;201807;583;219;364;208926.0;347256.0;556182.0
500270;201807;28529;12201;16328;1,16E+14;1,56E+14;2,72E+14
500280;201807;190;70;120;66780.0;114480.0;181260.0
500290;201807;1190;706;484;672571.0;461727.0;1134298.0
500295;201807;413;251;162;239454.0;154538.45;393992.47
500310;201807;63;20;43;19080.0;41022.0;60102.0
500315;201807;718;429;289;409256.47;275696.47;684952.94
500320;201807;3618;1824;1794;1737673.4;1710096.0;3447769.2
500325;201807;921;510;411;486063.0;390854.44;876917.44
500330;201807;1473;683;790;649360.25;753326.6;1402686.9
500345;201807;324;243;81;230859.2;77274.0;308133.2
500348;201807;245;146;99;139284.0;94427.46;233711.45
500350;201807;136;66;70;62964.0;66780.0;129744.0
500370;201807;5412;2441;2971;2321186.0;2832163.8;5153350.0
500375;201807;353;256;97;243959.84;92538.0;336497.84
500380;201807;598;342;256;326110.6;244214.45;570325.06
500390;201807;72;36;36;34344.0;34344.0;68688.0
500400;201807;215;146;69;139264.92;65817.0;205081.92
500410;201807;554;218;336;207926.16;320396.22;528322.4
500430;201807;548;381;167;363474.0;159318.0;522792.0
500440;201807;205;105;100;99397.43;95400.0;194797.44
500450;201807;404;174;230;165290.8;219410.45;384701.25
500460;201807;308;156;152;148814.45;144712.27;293526.72
500470;201807;446;348;98;331120.47;92529.0;423649.47
500480;201807;113;67;46;63918.0;43884.0;107802.0
500490;201807;105;42;63;40063.23;60102.0;100165.23
500500;201807;1428;505;923;479752.9;879965.1;1359718.0
500510;201807;50;38;12;36252.0;11439.0;47691.0
500515;201807;108;76;32;72504.0;30242.0;102746.0
500520;201807;343;190;153;179925.0;145672.0;325597.0
500525;201807;87;49;38;46746.0;35965.8;82711.8
500540;201807;912;383;529;365315.75;503655.84;868971.6
500560;201807;880;497;383;472399.03;365057.84;837456.9
500568;201807;1005;583;422;552620.6;402298.0;954918.6
500570;201807;1213;681;532;646204.06;504625.25;1150829.2
500580;201807;338;172;166;163792.27;158351.0;322143.25
500600;201807;309;157;152;149067.27;144990.0;294057.28
500620;201807;932;654;278;618425.6;265021.2;883446.8
500625;201807;79;67;12;63536.4;11448.0;74984.4
500627;201807;25;12;13;11448.0;12402.0;23850.0
500630;201807;1566;836;730;796199.7;696133.8;1492333.5
500635;201807;521;299;222;284826.25;211644.9;496471.12
500640;201807;432;226;206;213030.0;196505.45;409535.47
500660;201807;5546;2118;3428;2017138.8;3265610.2;5282749.0
500690;201807;568;205;363;195213.23;344623.25;539836.5
500710;201807;356;172;184;163802.0;175518.0;339320.0
500720;201807;979;571;408;543050.7;389022.9;932073.6
500730;201807;200;120;80;114480.0;76315.23;190795.23
500740;201807;843;371;472;352646.94;450009.75;802656.7
500750;201807;141;45;96;42930.0;91555.92;134485.92
500755;201807;126;90;36;85574.0;34344.0;119918.0
500769;201807;748;428;320;407976.28;305267.0;713243.25
500770;201807;434;230;204;219410.45;194606.45;414016.9
500780;201807;172;114;58;108470.0;55332.0;163802.0
500790;201807;1034;516;518;490901.25;494131.47;985032.7
500793;201807;258;141;117;134514.0;111609.0;246123.0
500795;201807;177;126;51;120194.46;48645.0;168839.45
500797;201807;43;32;11;30528.0;10494.0;41022.0
500800;201807;407;177;230;168849.0;219133.8;387982.8
500830;201807;2224;1245;979;1185318.1;932926.7;2118244.8
500840;201807;141;105;36;100170.0;34335.0;134505.0
510010;201807;169;94;75;89666.46;71521.38;161187.84
510020;201807;491;232;259;221034.06;246549.95;467584.03
510025;201807;1676;957;719;912098.56;683417.6;1595516.2
510030;201807;674;350;324;333853.9;308321.9;642175.8
510035;201807;133;60;73;57212.46;69623.46;126835.92
510040;201807;390;176;214;167904.0;203709.27;371613.25
510050;201807;424;233;191;221531.66;181390.45;402922.12
510060;201807;115;58;57;55322.46;54368.46;109690.92
510080;201807;223;90;133;85827.69;126768.06;212595.75
510100;201807;75;34;41;32436.0;39094.92;71530.92
510120;201807;38;23;15;21942.0;14310.0;36252.0
510125;201807;393;241;152;229231.89;144984.92;374216.8
510130;201807;569;332;237;316322.8;225684.19;542007.0
510140;201807;391;129;262;123057.0;249943.23;373000.22
510160;201807;92;41;51;39114.0;48650.0;87764.0
510170;201807;862;524;338;499621.06;321828.38;821449.44
510180;201807;2876;1399;1477;1331365.1;1407143.9;2738509.0
510185;201807;11;6;5;5724.0;4770.0;10494.0
510190;201807;220;71;149;67734.0;142141.23;209875.23
510250;201807;2612;1542;1070;1469999.0;1019638.1;2489637.0
510260;201807;202;146;56;139101.84;53387.46;192489.3
510263;201807;460;253;207;240358.58;196713.05;437071.62
510267;201807;665;373;292;354333.75;278287.9;632621.7
510268;201807;56;29;27;27666.0;25758.0;53424.0
510269;201807;69;32;37;30519.0;35298.0;65817.0
510270;201807;406;207;199;197299.98;189419.94;386719.9
510279;201807;231;171;60;163107.0;56934.92;220041.92
510285;201807;173;73;100;69623.46;95400.0;165023.45
510300;201807;528;292;236;278136.12;225069.84;503205.97
510305;201807;210;98;112;93469.46;106772.22;200241.69
510310;201807;113;58;55;55332.0;52460.46;107792.46
510320;201807;872;543;329;517454.2;313716.38;831170.56
510325;201807;415;166;249;158354.45;237259.8;395614.25
510330;201807;430;239;191;227993.0;182194.92;410187.9
510335;201807;596;326;270;310957.38;256847.58;567804.94
510336;201807;49;35;14;33390.0;13356.0;46746.0
510337;201807;120;49;71;46736.46;67724.46;114460.92
510340;201807;17323;8284;9039;7881003.5;8613845.0;1,65E+14
510343;201807;72;51;21;48644.46;20034.0;68678.46
510345;201807;159;105;54;100160.46;51210.92;151371.38
510350;201807;673;375;298;356817.06;284227.38;641044.44
510360;201807;197;118;79;112563.0;75292.92;187855.92
510370;201807;144;73;71;69613.38;67611.6;137224.98
510380;201807;90;63;27;60102.0;25749.0;85851.0
510385;201807;58;27;31;25758.0;29565.0;55323.0
510390;201807;120;50;70;47700.0;66741.84;114441.84
510395;201807;42;31;11;29574.0;10494.0;40068.0
510410;201807;710;474;236;452192.0;225120.69;677312.7
510420;201807;583;281;302;267138.34;286726.16;553864.5
510450;201807;53;30;23;28620.0;21942.0;50562.0
510452;201807;44;26;18;24804.0;17172.0;41976.0
510454;201807;59;27;32;25758.0;30518.46;56276.46
510455;201807;128;80;48;76300.92;45792.0;122092.92
510460;201807;186;99;87;94265.92;82960.38;177226.3
510480;201807;752;433;319;411955.8;303988.38;715944.2
510490;201807;355;182;173;173258.34;164556.16;337814.5
510500;201807;253;192;61;183158.45;58194.0;241352.45
510510;201807;798;456;342;434423.72;326239.38;760663.1
510515;201807;1173;614;559;585396.4;533239.4;1118635.8
510517;201807;250;105;145;99883.8;138306.69;238190.48
510520;201807;238;156;82;148730.77;77917.84;226648.6
510523;201807;93;66;27;62964.0;25748.46;88712.46
510525;201807;742;421;321;400879.84;306123.3;707003.1
510530;201807;15;11;4;10494.0;3816.0;14310.0
510550;201807;268;118;150;112563.0;143091.0;255654.0
510558;201807;273;135;138;128757.15;131623.92;260381.06
510560;201807;402;245;157;233444.0;149760.0;383204.0
510562;201807;634;447;187;425107.16;177911.45;603018.6
510590;201807;804;418;386;398715.84;368216.7;766932.5
510600;201807;259;143;116;136398.92;110626.92;247025.84
510610;201807;172;83;89;79162.92;84610.46;163773.38
510615;201807;198;84;114;80116.92;108756.0;188872.92
510617;201807;19;11;8;10494.0;7632.0;18126.0
510618;201807;118;55;63;52470.0;59625.0;112095.0
510619;201807;102;72;30;68679.0;28611.0;97290.0
510620;201807;184;101;83;96344.46;79182.0;175526.45
510621;201807;198;125;73;119231.46;69614.46;188845.92
510622;201807;456;292;164;278475.84;156141.92;434617.75
510623;201807;349;236;113;225087.84;107773.38;332861.22
510624;201807;86;43;43;41013.0;41022.0;82035.0
510625;201807;536;330;206;314619.3;195946.52;510565.8
510626;201807;107;69;38;65826.0;36252.0;102078.0
510627;201807;61;43;18;41022.0;17172.0;58194.0
510628;201807;161;97;64;92491.92;60998.76;153490.69
510629;201807;257;164;93;156456.0;87758.46;244214.45
510630;201807;469;239;230;227921.22;219073.95;446995.16
510631;201807;11;3;8;2862.0;7346.0;10208.0
510637;201807;343;194;149;184730.19;142008.84;326739.03
510642;201807;975;545;430;519588.2;410077.44;929665.6
510645;201807;0;0;0;0.0;0.0;0.0
510650;201807;1475;978;497;932867.94;474006.75;1406874.6
510665;201807;86;43;43;40966.0;41022.0;81988.0
510670;201807;65;37;28;35298.0;26712.0;62010.0
510675;201807;1161;701;460;668722.25;438817.22;1107539.5
510677;201807;359;176;183;166898.84;174452.22;341351.06
510680;201807;102;60;42;57222.0;40059.0;97281.0
510682;201807;199;98;101;93170.0;96354.0;189524.0
510685;201807;53;38;15;36252.0;14310.0;50562.0
510700;201807;618;360;258;343283.9;245998.77;589282.7
510704;201807;1088;590;498;560452.06;473470.8;1033922.9
510706;201807;128;64;64;61051.23;61018.92;122070.15
510710;201807;392;266;126;252774.23;120089.68;372863.9
510715;201807;63;47;16;44828.46;15264.0;60092.46
510718;201807;210;116;94;110570.76;89666.46;200237.22
510719;201807;36;19;17;18126.0;16218.0;34344.0
510720;201807;197;132;65;125919.0;61723.8;187642.8
510724;201807;91;36;55;34334.46;52437.38;86771.84
510726;201807;55;28;27;26702.46;25740.0;52442.46
510729;201807;75;34;41;32436.0;39075.84;71511.84
510730;201807;471;266;205;253746.0;195422.45;449168.47
510735;201807;110;42;68;40068.0;64872.0;104940.0
510740;201807;30;17;13;16218.0;12402.0;28620.0
510757;201807;20;16;4;15264.0;3816.0;19080.0
510760;201807;7057;3725;3332;3544100.2;3173474.0;6717574.5
510770;201807;715;341;374;325116.3;356610.3;681726.6
510774;201807;16;6;10;5724.0;9540.0;15264.0
510775;201807;114;86;28;82034.46;26702.46;108736.92
510776;201807;28;7;21;6678.0;20034.0;26712.0
510777;201807;184;81;103;77245.38;98233.38;175478.77
510779;201807;50;23;27;21933.0;25720.92;47653.92
510780;201807;292;164;128;156393.45;122047.0;278440.47
510785;201807;446;241;205;229857.84;195503.22;425361.06
510787;201807;190;95;95;90621.0;90612.23;181233.23
510788;201807;0;0;0;0.0;0.0;0.0
510790;201807;2413;1258;1155;1198272.4;1099871.2;2298143.8
510792;201807;1095;622;473;592605.5;450826.34;1043431.8
510794;201807;119;60;59;57240.0;56257.92;113497.92
510795;201807;2391;1383;1008;1312562.1;958968.8;2271531.0
510800;201807;187;114;73;108737.46;69633.0;178370.45
510805;201807;170;116;54;110664.0;51516.0;162180.0
510810;201807;96;40;56;38077.38;53299.98;91377.36
510820;201807;257;120;137;114053.46;129698.03;243751.48
510830;201807;67;41;26;39114.0;24795.0;63909.0
510835;201807;7;5;2;4770.0;1908.0;6678.0
510840;201807;9280;4580;4700;4353905.0;4476418.0;8830323.0
510850;201807;213;88;125;83942.46;119212.38;203154.84
510860;201807;382;166;216;158186.52;205402.42;363588.94
510880;201807;66;50;16;47681.46;15264.0;62945.46
510885;201807;71;43;28;41003.46;26683.38;67686.84
510890;201807;70;40;30;38160.0;28620.0;66780.0
510895;201807;184;108;76;103032.0;72195.46;175227.45
520005;201807;35;24;11;22896.0;10494.0;33390.0
520010;201807;276;124;152;118296.0;144913.0;263209.0
520013;201807;643;391;252;372986.0;240121.8;613107.8
520015;201807;51;37;14;35298.0;13356.0;48654.0
520017;201807;99;58;41;55046.0;39114.0;94160.0
520020;201807;25;13;12;12402.0;11448.0;23850.0
520025;201807;2009;1088;921;1036769.25;877194.4;1913963.6
520030;201807;791;407;384;387315.0;365715.9;753030.9
520050;201807;77;52;25;49608.0;23850.0;73458.0
520055;201807;44;30;14;28620.0;13356.0;41976.0
520060;201807;176;113;63;107802.0;60102.0;167904.0
520080;201807;597;423;174;402619.1;165996.0;568615.1
520082;201807;20;14;6;13356.0;5724.0;19080.0
520085;201807;102;75;27;71550.0;25758.0;97308.0
520090;201807;91;63;28;60102.0;26712.0;86814.0
520110;201807;9065;3945;5120;3758388.8;4881841.0;8640230.0
520120;201807;14;8;6;7431.66;5724.0;13155.66
520130;201807;768;533;235;508186.8;223751.9;731938.7
520140;201807;11757;6650;5107;6336285.0;4869726.0;1,12E+14
520145;201807;46;34;12;32436.0;11448.0;43884.0
520150;201807;189;147;42;140238.0;40068.0;180306.0
520160;201807;30;23;7;21942.0;6678.0;28620.0
520170;201807;230;143;87;136390.0;82961.0;219351.0
520180;201807;134;72;62;68688.0;59148.0;127836.0
520215;201807;217;134;83;127549.8;78895.8;206445.6
520235;201807;70;53;17;50562.0;16218.0;66780.0
520250;201807;135;81;54;77274.0;51229.8;128503.8
520260;201807;111;68;43;64872.0;40068.0;104940.0
520280;201807;46;32;14;29861.0;13356.0;43217.0
520310;201807;39;26;13;24804.0;12402.0;37206.0
520320;201807;168;106;62;101114.46;59148.0;160262.45
520330;201807;789;412;377;393002.47;359631.0;752633.44
520340;201807;348;197;151;187938.0;144035.45;331973.47
520350;201807;521;236;285;225144.0;271843.0;496987.0
520355;201807;86;51;35;48654.0;33390.0;82044.0
520357;201807;24;17;7;16218.0;6678.0;22896.0
520360;201807;1;1;0;954.0;0.0;954.0
520380;201807;141;72;69;68688.0;65826.0;134514.0
520390;201807;279;118;161;112095.0;153331.5;265426.5
520393;201807;14;11;3;10494.0;2862.0;13356.0
520396;201807;98;59;39;56286.0;37206.0;93492.0
520400;201807;222;131;91;123353.2;86814.0;210167.2
520410;201807;198;101;97;96345.0;92529.0;188874.0
520420;201807;22;15;7;14310.0;6678.0;20988.0
520425;201807;302;133;169;125929.0;160750.2;286679.2
520430;201807;459;236;223;224857.8;212686.0;437543.8
520440;201807;611;414;197;394956.0;187918.92;582874.94
520450;201807;1934;867;1067;826289.44;1016995.3;1843284.8
520455;201807;60;43;17;41022.0;16218.0;57240.0
520460;201807;32;16;16;15264.0;15264.0;30528.0
520465;201807;24;21;3;20034.0;2862.0;22896.0
520470;201807;419;259;160;246780.62;152640.0;399420.62
520480;201807;80;46;34;43884.0;32391.0;76275.0
520485;201807;124;43;81;41022.0;76988.0;118010.0
520490;201807;410;299;111;285061.97;105894.0;390955.97
520495;201807;172;105;67;100170.0;63918.0;164088.0
520500;201807;173;130;43;124020.0;41022.0;165042.0
520505;201807;177;91;86;86809.23;82044.0;168853.23
520510;201807;1765;875;890;832359.7;846832.0;1679191.8
520520;201807;34;27;7;25758.0;6678.0;32436.0
520530;201807;231;173;58;163318.12;55322.46;218640.58
520540;201807;524;351;173;333547.03;165042.0;498589.03
520545;201807;153;89;64;84906.0;61056.0;145962.0
520547;201807;54;30;24;28620.0;22896.0;51516.0
520549;201807;1150;560;590;533916.0;562742.0;1096658.0
520551;201807;292;152;140;145008.0;133274.0;278282.0
520552;201807;46;27;19;25758.0;18126.0;43884.0
520570;201807;16;9;7;8586.0;6678.0;15264.0
520580;201807;284;171;113;163124.45;107802.0;270926.47
520590;201807;163;99;64;94446.0;60769.8;155215.8
520620;201807;1175;550;625;523842.47;595954.25;1119796.8
520630;201807;43;26;17;24804.0;16218.0;41022.0
520640;201807;411;234;177;223236.0;168858.0;392094.0
520650;201807;60;40;20;38160.0;19080.0;57240.0
520660;201807;36;19;17;18117.0;16218.0;34335.0
520670;201807;35;30;5;28620.0;4770.0;33390.0
520680;201807;56;37;19;35298.0;18126.0;53424.0
520690;201807;32;10;22;9540.0;20959.92;30499.92
520710;201807;39;35;4;33390.0;3816.0;37206.0
520725;201807;196;125;71;119250.0;67734.0;186984.0
520735;201807;59;41;18;39114.0;17172.0;56286.0
520740;201807;410;202;208;191993.4;198423.0;390416.4
520750;201807;36;27;9;25758.0;8586.0;34344.0
520753;201807;55;37;18;35298.0;17172.0;52470.0
520760;201807;113;77;36;73458.0;34344.0;107802.0
520780;201807;291;220;71;209880.0;67715.0;277595.0
520790;201807;165;84;81;79849.8;77274.0;157123.8
520800;201807;3453;1848;1605;1760595.0;1530636.0;3291231.0
520810;201807;172;125;47;119090.6;44838.0;163928.6
520815;201807;5;5;0;4770.0;0.0;4770.0
520830;201807;138;92;46;87768.0;43597.8;131365.8
520840;201807;349;230;119;218943.0;113526.0;332469.0
520850;201807;113;72;41;68669.46;38961.36;107630.82
520860;201807;1691;1080;611;1028899.56;581750.2;1610649.8
520870;201807;30885;15203;15682;1,45E+14;1,49E+14;2,94E+14
520880;201807;1084;590;494;562860.0;471256.9;1034116.94
520890;201807;804;469;335;445795.4;319485.47;765280.9
520910;201807;1028;544;484;514731.94;461736.0;976467.94
520915;201807;102;77;25;73458.0;23840.46;97298.46
520920;201807;405;199;206;189273.6;196514.45;385788.06
520929;201807;17;16;1;15264.0;954.0;16218.0
520940;201807;76;49;27;46746.0;25758.0;72504.0
520945;201807;21;13;8;12402.0;7632.0;20034.0
520960;201807;46;30;16;28620.0;15264.0;43884.0
520970;201807;319;200;119;189884.8;113239.8;303124.6
520980;201807;84;64;20;61056.0;19080.0;80136.0
520990;201807;479;322;157;307188.0;149778.0;456966.0
520993;201807;129;62;67;59148.0;63918.0;123066.0
520995;201807;242;135;107;127837.0;101506.0;229343.0
521000;201807;1582;929;653;884263.6;622581.0;1506844.6
521010;201807;669;312;357;297321.38;340511.75;637833.1
521015;201807;18;11;7;10494.0;6678.0;17172.0
521020;201807;1458;1021;437;973404.9;416484.7;1389889.6
521030;201807;46;33;13;31482.0;12402.0;43884.0
521040;201807;945;581;364;554036.2;346970.0;901006.2
521056;201807;41;29;12;27666.0;11448.0;39114.0
521060;201807;133;84;49;80136.0;46746.0;126882.0
521080;201807;464;348;116;331983.0;110664.0;442647.0
521090;201807;528;316;212;299837.44;202248.0;502085.44
521100;201807;277;206;71;196515.0;67734.0;264249.0
521120;201807;1056;732;324;697755.8;308801.0;1006556.8
521130;201807;363;260;103;248030.45;97376.6;345407.06
521140;201807;185;105;80;100170.0;76320.0;176490.0
521150;201807;2793;1218;1575;1160107.9;1501277.5;2661385.2
521160;201807;32;17;15;16218.0;14310.0;30528.0
521170;201807;195;115;80;109700.46;76320.0;186020.45
521180;201807;1139;719;420;684295.25;399965.2;1084260.5
521190;201807;2536;1074;1462;1024576.94;1393968.8;2418545.8
521200;201807;47;34;13;32436.0;12402.0;44838.0
521205;201807;12;9;3;8586.0;2862.0;11448.0
521210;201807;143;82;61;78228.0;58194.0;136422.0
521220;201807;820;562;258;533515.75;246076.0;779591.75
521225;201807;31;20;11;19080.0;10494.0;29574.0
521230;201807;109;72;37;68401.8;35298.0;103699.8
521250;201807;6240;3585;2655;3413574.2;2530277.2;5943851.5
521260;201807;23;15;8;14310.0;7632.0;21942.0
521270;201807;141;109;32;103986.0;30528.0;134514.0
521280;201807;437;260;177;246831.6;168858.0;415689.6
521290;201807;30;11;19;10494.0;18126.0;28620.0
521295;201807;98;66;32;62735.04;30528.0;93263.04
521300;201807;228;117;111;111600.0;105543.38;217143.38
521305;201807;35;24;11;22896.0;10494.0;33390.0
521308;201807;1096;814;282;776305.7;268733.0;1045038.7
521310;201807;1352;801;551;762106.4;524462.94;1286569.4
521340;201807;18;15;3;14310.0;2862.0;17172.0
521350;201807;131;96;35;91584.0;33390.0;124974.0
521370;201807;190;123;67;117055.8;63631.8;180687.6
521375;201807;190;107;83;102078.0;78895.8;180973.8
521377;201807;52;35;17;33390.0;16218.0;49608.0
521380;201807;1094;716;378;678678.25;360612.0;1039290.25
521385;201807;15;8;7;7632.0;6678.0;14310.0
521390;201807;106;85;21;80772.04;20034.0;100806.04
521400;201807;329;211;118;201007.8;112524.3;313532.1
521405;201807;149;78;71;74412.0;67734.0;142146.0
521410;201807;63;42;21;40068.0;20034.0;60102.0
521440;201807;204;145;59;137519.1;56286.0;193805.1
521450;201807;721;397;324;378738.0;309096.0;687834.0
521460;201807;1189;732;457;698041.8;435958.9;1134000.8
521470;201807;14;9;5;8586.0;4770.0;13356.0
521480;201807;47;32;15;30501.0;14245.0;44746.0
521483;201807;314;170;144;161894.0;137376.0;299270.0
521486;201807;284;182;102;172836.19;96641.0;269477.2
521487;201807;22;11;11;10494.0;10494.0;20988.0
521490;201807;27;16;11;15264.0;10494.0;25758.0
521500;201807;117;76;41;72504.0;39114.0;111618.0
521520;201807;41;29;12;27666.0;11448.0;39114.0
521523;201807;618;380;238;359203.3;227052.0;586255.3
521525;201807;45;30;15;28620.0;14023.8;42643.8
521530;201807;250;133;117;126882.0;111618.0;238500.0
521540;201807;31;17;14;16218.0;13356.0;29574.0
521550;201807;89;40;49;37845.92;46690.92;84536.84
521560;201807;804;545;259;519644.0;246943.0;766587.0
521565;201807;54;37;17;35298.0;16218.0;51516.0
521570;201807;503;338;165;322442.47;157315.3;479757.75
521580;201807;59;37;22;35298.0;20988.0;56286.0
521590;201807;38;20;18;19080.0;17172.0;36252.0
521600;201807;28;17;11;16218.0;10494.0;26712.0
521630;201807;242;123;119;117332.46;112535.96;229868.42
521640;201807;302;156;146;148824.0;139284.0;288108.0
521645;201807;30;16;14;15264.0;13356.0;28620.0
521680;201807;221;140;81;133560.0;77274.0;210834.0
521690;201807;2;2;0;1908.0;0.0;1908.0
521710;201807;1181;554;627;527943.8;597862.8;1125806.6
521720;201807;541;368;173;351062.47;165004.45;516066.9
521730;201807;630;304;326;289921.0;309897.56;599818.56
521740;201807;917;373;544;355528.47;517785.3;873313.75
521760;201807;1627;898;729;855114.6;695152.0;1550266.6
521770;201807;809;512;297;488448.0;282870.53;771318.56
521800;201807;2065;1286;779;1223302.0;741788.1;1965090.1
521805;201807;34;19;15;18126.0;14310.0;32436.0
521810;201807;92;58;34;54187.8;32436.0;86623.8
521830;201807;957;679;278;645572.25;265203.0;910775.25
521839;201807;91;60;31;57240.0;29574.0;86814.0
521850;201807;1127;599;528;570026.94;503387.7;1073414.6
521860;201807;347;213;134;203202.0;127550.0;330752.0
521870;201807;73;42;31;40068.0;29574.0;69642.0
521878;201807;42;20;22;19080.0;20988.0;40068.0
521880;201807;4569;2066;2503;1968694.4;2386353.0;4355047.5
521890;201807;588;414;174;394178.62;165709.8;559888.44
521900;201807;295;237;58;225461.95;55332.0;280793.97
521910;201807;150;104;46;99216.0;43884.0;143100.0
521920;201807;54;27;27;25758.0;25758.0;51516.0
521925;201807;36;21;15;20034.0;14310.0;34344.0
521930;201807;1123;639;484;609410.0;461101.88;1070511.9
521935;201807;34;26;8;24804.0;7632.0;32436.0
521940;201807;189;96;93;91584.0;88717.23;180301.23
521945;201807;14;12;2;11448.0;1908.0;13356.0
521950;201807;9;5;4;4770.0;3816.0;8586.0
521960;201807;77;57;20;54378.0;19080.0;73458.0
521970;201807;420;269;151;256339.8;144054.0;400393.8
521971;201807;96;49;47;46746.0;44838.0;91584.0
521973;201807;28;13;15;12402.0;14310.0;26712.0
521975;201807;1182;602;580;574117.2;552404.7;1126521.9
521980;201807;243;167;76;159318.0;72504.0;231822.0
521990;201807;73;53;20;50562.0;19080.0;69642.0
522000;201807;288;183;105;174582.0;100170.0;274752.0
522005;201807;20;12;8;11448.0;7632.0;19080.0
522010;201807;1139;635;504;605781.0;480243.6;1086024.6
522015;201807;54;33;21;31473.0;20034.0;51507.0
522020;201807;862;465;397;442656.2;377956.12;820612.3
522026;201807;28;20;8;19080.0;7632.0;26712.0
522028;201807;16;12;4;11448.0;3816.0;15264.0
522040;201807;747;297;450;283320.0;429245.47;712565.44
522045;201807;2147;1359;788;1295740.2;751218.8;2046959.0
522050;201807;167;81;86;77274.0;82044.0;159318.0
522060;201807;561;353;208;336475.8;198336.6;534812.4
522068;201807;134;89;45;84619.8;42930.0;127549.8
522070;201807;11;11;0;10494.0;0.0;10494.0
522100;201807;46;25;21;23850.0;20034.0;43884.0
522108;201807;38;29;9;27666.0;8586.0;36252.0
522119;201807;55;29;26;27666.0;24804.0;52470.0
522130;201807;75;28;47;26703.0;44811.0;71514.0
522140;201807;3765;1910;1855;1817653.2;1767515.5;3585168.8
522145;201807;52;32;20;30528.0;19080.0;49608.0
522150;201807;65;50;15;47700.0;14310.0;62010.0
522155;201807;58;39;19;37197.0;18126.0;55323.0
522157;201807;4;3;1;2862.0;954.0;3816.0
522160;201807;1739;1020;719;971935.2;685630.8;1657566.0
522170;201807;394;265;129;252810.0;123066.0;375876.0
522180;201807;37;20;17;19080.0;16218.0;35298.0
522185;201807;1967;762;1205;723641.25;1149049.0;1872690.2
522190;201807;49;28;21;26712.0;19938.6;46650.6
522200;201807;296;179;117;170766.0;111618.0;282384.0
522205;201807;167;113;54;107802.0;51516.0;159318.0
522220;201807;162;117;45;111618.0;42930.0;154548.0
522230;201807;32;26;6;24804.0;5724.0;30528.0
530010;201807;55619;28578;27041;2,71E+14;2,57E+14;5,29E+14
110001;201808;520;411;109;391130.47;103340.96;494471.4
110002;201808;2787;1696;1091;1616737.8;1039916.5;2656654.2
110003;201808;95;75;20;71064.0;19080.0;90144.0
110004;201808;2010;1300;710;1238077.8;677044.25;1915122.0
110005;201808;438;353;85;335606.9;81090.0;416696.9
110006;201808;456;353;103;335721.75;98242.92;433964.66
110007;201808;82;65;17;62010.0;16218.0;78228.0
110008;201808;241;134;107;126600.9;102078.0;228678.9
110009;201808;800;553;247;525654.9;235439.0;761093.9
110010;201808;1808;1117;691;1064415.2;658910.2;1723325.5
110011;201808;1862;1443;419;1374968.2;399716.47;1774684.6
110012;201808;4140;2399;1741;2282227.5;1659823.1;3942050.5
110013;201808;771;591;180;563804.44;171720.0;735524.44
110014;201808;377;323;54;307378.8;51516.0;358894.8
110015;201808;1430;1154;276;1097897.1;263284.9;1361182.0
110018;201808;1123;678;445;646498.0;424517.22;1071015.2
110020;201808;15444;9060;6384;8599539.0;6081583.5;1,47E+14
110025;201808;657;488;169;462361.03;161217.0;623578.0
110026;201808;41;28;13;26712.0;12402.0;39114.0
110028;201808;1642;1194;448;1134474.6;424370.94;1558845.5
110029;201808;138;122;16;116388.0;15264.0;131652.0
110030;201808;2478;1677;801;1597051.4;763253.44;2360304.8
110032;201808;389;304;85;289707.0;81086.0;370793.0
110033;201808;677;504;173;477813.0;164755.8;642568.8
110034;201808;371;272;99;257176.0;93779.0;350955.0
110037;201808;103;86;17;82044.0;16218.0;98262.0
110040;201808;347;238;109;227052.0;103986.0;331038.0
110045;201808;948;642;306;610943.0;290220.38;901163.4
110050;201808;96;79;17;75080.0;16218.0;91298.0
110060;201808;86;46;40;43884.0;38160.0;82044.0
110070;201808;119;72;47;68688.0;44552.0;113240.0
110080;201808;408;248;160;234082.98;152616.16;386699.12
110090;201808;34;28;6;26712.0;5724.0;32436.0
110092;201808;107;59;48;56286.0;45722.0;102008.0
110094;201808;195;140;55;133560.0;52470.0;186030.0
110100;201808;31;25;6;23850.0;5724.0;29574.0
110110;201808;65;40;25;38160.0;23850.0;62010.0
110120;201808;72;59;13;56286.0;12402.0;68688.0
110130;201808;300;244;56;231301.12;53424.0;284725.12
110140;201808;244;159;85;151495.2;81080.46;232575.66
110143;201808;52;44;8;41976.0;7632.0;49608.0
110145;201808;25;19;6;18126.0;5724.0;23850.0
110146;201808;24;12;12;11448.0;11448.0;22896.0
110147;201808;38;30;8;28620.0;7632.0;36252.0
110148;201808;40;28;12;26660.57;11448.0;38108.57
110149;201808;299;215;84;204823.8;80136.0;284959.8
110150;201808;86;60;26;57240.0;24804.0;82044.0
110155;201808;8;7;1;6678.0;954.0;7632.0
110160;201808;71;60;11;57240.0;10494.0;67734.0
110170;201808;204;165;39;157410.0;36919.8;194329.8
110175;201808;44;32;12;30528.0;11448.0;41976.0
110180;201808;94;81;13;77274.0;12402.0;89676.0
120001;201808;139;96;43;91584.0;41014.0;132598.0
120005;201808;192;120;72;114459.0;68688.0;183147.0
120010;201808;1034;668;366;633262.1;348639.8;981901.9
120013;201808;147;102;45;97232.82;42739.2;139972.02
120017;201808;92;57;35;54334.24;33369.0;87703.24
120020;201808;3584;2862;722;2708706.0;686398.25;3395104.2
120025;201808;586;332;254;314637.1;241424.48;556061.56
120030;201808;1038;869;169;821061.25;160511.0;981572.25
120032;201808;49;41;8;39114.0;7632.0;46746.0
120033;201808;219;191;28;181866.75;26712.0;208578.75
120034;201808;157;113;44;105894.0;41976.0;147870.0
120035;201808;30;22;8;20988.0;7632.0;28620.0
120038;201808;390;252;138;239646.88;131608.23;371255.12
120039;201808;22;21;1;20034.0;954.0;20988.0
120040;201808;14134;9800;4334;9286760.0;4124283.2;1,34E+14
120042;201808;47;41;6;39114.0;5724.0;44838.0
120043;201808;12;3;9;2862.0;8586.0;11448.0
120045;201808;537;347;190;328468.8;180233.7;508702.5
120050;201808;1269;968;301;917161.44;287149.22;1204310.6
120060;201808;1433;1166;267;1108526.1;253764.0;1362290.1
120070;201808;506;363;143;342624.03;136412.45;479036.5
120080;201808;166;105;61;99661.58;57911.74;157573.31
130002;201808;149;104;45;99216.0;42930.0;142146.0
130006;201808;76;43;33;41022.0;31482.0;72504.0
130008;201808;143;76;67;71805.6;63239.72;135045.31
130010;201808;139;76;63;72482.12;60102.0;132584.12
130014;201808;245;177;68;168858.0;64872.0;233730.0
130020;201808;94;50;44;47700.0;41976.0;89676.0
130030;201808;907;549;358;523746.0;341522.47;865268.44
130040;201808;317;160;157;152640.0;148824.28;301464.28
130050;201808;569;309;260;294499.8;248040.0;542539.8
130060;201808;876;599;277;566318.2;261876.6;828194.8
130063;201808;581;325;256;310050.0;244158.36;554208.4
130068;201808;188;123;65;117342.0;61723.8;179065.8
130070;201808;1329;917;412;864799.44;389542.9;1254342.4
130080;201808;660;432;228;411746.4;217503.0;629249.4
130083;201808;72;39;33;36942.0;31482.0;68424.0
130090;201808;373;193;180;182442.95;171720.0;354162.97
130100;201808;1134;512;622;488448.0;593101.8;1081549.8
130110;201808;701;307;394;292728.0;375876.0;668604.0
130115;201808;175;72;103;68688.0;98262.0;166950.0
130120;201808;1633;1021;612;974034.0;583848.0;1557882.0
130130;201808;633;435;198;414990.0;188892.0;603882.0
130140;201808;1504;1132;372;1079307.9;353934.2;1433242.1
130150;201808;422;359;63;342486.0;60102.0;402588.0
130160;201808;471;269;202;256626.0;192708.0;449334.0
130165;201808;26;18;8;17172.0;7632.0;24804.0
130170;201808;971;700;271;667729.4;258534.0;926263.4
130180;201808;147;89;58;84906.0;55332.0;140238.0
130185;201808;2337;1211;1126;1153386.0;1073612.9;2226999.0
130190;201808;3616;2261;1355;2152194.2;1291368.0;3443562.2
130195;201808;290;232;58;221328.0;55332.0;276660.0
130200;201808;173;80;93;76310.46;88722.0;165032.45
130210;201808;80;40;40;38160.0;38160.0;76320.0
130220;201808;184;127;57;121158.0;54378.0;175536.0
130230;201808;333;208;125;198432.0;119250.0;317682.0
130240;201808;1435;908;527;864892.4;502180.84;1367073.2
130250;201808;4807;3117;1690;2966763.8;1612126.6;4578890.0
130255;201808;424;207;217;197478.0;206731.8;404209.8
130260;201808;54319;26193;28126;2,50E+13;2,68E+14;5,18E+14
130270;201808;1524;990;534;943983.0;509436.0;1453419.0
130280;201808;115;71;44;67734.0;41976.0;109710.0
130290;201808;2109;1533;576;1461815.0;549217.8;2011032.8
130300;201808;433;308;125;293545.8;119250.0;412795.8
130310;201808;891;466;425;444564.0;405450.0;850014.0
130320;201808;455;244;211;231822.0;201294.0;433116.0
130330;201808;703;422;281;402588.0;267787.8;670375.8
130340;201808;3347;1997;1350;1900845.4;1286183.0;3187028.5
130350;201808;468;301;167;287132.12;159318.0;446450.12
130353;201808;821;342;479;325982.0;456966.0;782948.0
130356;201808;807;371;436;353934.0;415929.78;769863.75
130360;201808;67;41;26;39114.0;24804.0;63918.0
130370;201808;683;510;173;486540.0;165042.0;651582.0
130380;201808;612;423;189;403542.0;180306.0;583848.0
130390;201808;491;390;101;372060.0;96354.0;468414.0
130395;201808;181;40;141;38160.0;134514.0;172674.0
130400;201808;70;45;25;42930.0;23850.0;66780.0
130406;201808;2086;1293;793;1229908.2;755290.75;1985199.0
130410;201808;480;205;275;195570.0;262330.9;457900.9
130420;201808;3183;2571;612;2448947.2;583848.0;3032795.2
130423;201808;161;76;85;72504.0;81090.0;153594.0
130426;201808;147;87;60;82998.0;57240.0;140238.0
130430;201808;409;270;139;257580.0;132606.0;390186.0
130440;201808;203;68;135;64872.0;128790.0;193662.0
140002;201808;34;13;21;12402.0;20034.0;32436.0
140005;201808;205;126;79;119965.5;75366.0;195331.5
140010;201808;10288;6940;3348;6583588.5;3191984.8;9775573.0
140015;201808;151;66;85;62964.0;81090.0;144054.0
140017;201808;118;80;38;76320.0;36252.0;112572.0
140020;201808;478;321;157;305280.0;149778.0;455058.0
140023;201808;32;17;15;15999.0;14310.0;30309.0
140028;201808;19;12;7;11448.0;6678.0;18126.0
140030;201808;349;249;100;237546.0;94798.98;332344.97
140040;201808;57;40;17;38160.0;16122.6;54282.6
140045;201808;244;112;132;106848.0;125928.0;232776.0
140047;201808;596;410;186;389128.38;176681.0;565809.4
140050;201808;149;96;53;90771.0;50562.0;141333.0
140060;201808;37;26;11;24069.42;10494.0;34563.42
140070;201808;33;30;3;27866.05;2862.0;30728.05
150010;201808;4702;2923;1779;2786634.5;1694973.0;4481607.5
150013;201808;151;106;45;101124.0;42930.0;144054.0
150020;201808;1053;570;483;543780.0;460782.0;1004562.0
150030;201808;718;293;425;279522.0;405450.0;684972.0
150034;201808;199;127;72;121158.0;68688.0;189846.0
150040;201808;1402;842;560;803268.0;534240.0;1337508.0
150050;201808;679;404;275;384414.8;262150.0;646564.8
150060;201808;4742;3070;1672;2925594.2;1594840.5;4520435.0
150070;201808;315;144;171;137376.0;163134.0;300510.0
150080;201808;14414;7259;7155;6914838.5;6818634.0;1,37E+14
150085;201808;397;248;149;236582.45;142146.0;378728.47
150090;201808;758;645;113;615330.0;107802.0;723132.0
150095;201808;345;216;129;205294.12;122245.56;327539.7
150100;201808;57;40;17;38160.0;16218.0;54378.0
150110;201808;173;83;90;79182.0;85860.0;165042.0
150120;201808;429;318;111;303372.0;105894.0;409266.0
150125;201808;55;23;32;21942.0;30528.0;52470.0
150130;201808;1915;1028;887;980712.0;846193.25;1826905.2
150140;201808;54302;25443;28859;2,42E+14;2,75E+14;5,18E+13
150145;201808;183;105;78;100170.0;74412.0;174582.0
150150;201808;2832;1303;1529;1242844.5;1455246.2;2698090.8
150157;201808;428;299;129;285246.0;123061.23;408307.22
150160;201808;122;97;25;92538.0;23850.0;116388.0
150170;201808;3665;2721;944;2594641.5;900289.8;3494931.2
150172;201808;324;223;101;212742.0;96354.0;309096.0
150175;201808;84;51;33;48654.0;31482.0;80136.0
150178;201808;766;514;252;489402.0;240408.0;729810.0
150180;201808;3090;1499;1591;1429808.0;1517499.4;2947307.5
150190;201808;330;213;117;203202.0;111618.0;314820.0
150195;201808;124;62;62;59148.0;59148.0;118296.0
150200;201808;201;96;105;91584.0;100170.0;191754.0
150210;201808;3159;2562;597;2443089.8;568532.5;3011622.2
150215;201808;524;344;180;328176.0;171434.0;499610.0
150220;201808;3848;2618;1230;2496012.8;1171302.4;3667315.0
150230;201808;1145;927;218;883778.06;207972.0;1091750.0
150240;201808;5795;3433;2362;3271926.8;2253339.0;5525265.5
150250;201808;33;16;17;15264.0;16218.0;31482.0
150260;201808;77;47;30;44838.0;28620.0;73458.0
150270;201808;2353;1534;819;1462401.8;780448.75;2242850.5
150275;201808;561;347;214;331038.0;204156.0;535194.0
150276;201808;111;48;63;45792.0;60102.0;105894.0
150277;201808;770;328;442;312893.47;421668.0;734561.44
150280;201808;339;209;130;199386.0;124020.0;323406.0
150285;201808;75;38;37;36252.0;35298.0;71550.0
150290;201808;971;594;377;566380.25;359372.0;925752.25
150293;201808;666;312;354;297638.47;337716.0;635354.44
150295;201808;475;217;258;207018.0;245979.44;452997.44
150300;201808;77;40;37;38160.0;35298.0;73458.0
150304;201808;150;101;49;96354.0;46746.0;143100.0
150307;201808;391;322;69;307188.0;65826.0;373014.0
150309;201808;565;412;153;393048.0;145962.0;539010.0
150310;201808;258;174;84;165996.0;80136.0;246132.0
150320;201808;1778;1232;546;1175046.6;520645.5;1695692.1
150330;201808;2072;1201;871;1145086.2;830934.0;1976020.2
150340;201808;201;137;64;130459.5;61056.0;191515.5
150345;201808;606;328;278;312730.75;265212.0;577942.75
150350;201808;410;323;87;305747.47;82998.0;388745.47
150360;201808;4578;2951;1627;2811663.5;1552148.5;4363812.0
150370;201808;768;544;224;518210.0;213400.8;731610.8
150375;201808;196;104;92;99216.0;87768.0;186984.0
150380;201808;1381;935;446;891990.0;425484.0;1317474.0
150390;201808;735;421;314;401630.0;299556.0;701186.0
150400;201808;103;86;17;82044.0;16218.0;98262.0
150405;201808;1258;821;437;781962.5;416325.6;1198288.1
150410;201808;137;90;47;85860.0;44838.0;130698.0
150420;201808;7403;4074;3329;3885232.2;3174194.2;7059426.5
150430;201808;508;341;167;325314.0;159318.0;484632.0
150440;201808;574;342;232;325505.0;221328.0;546833.0
150442;201808;2183;1182;1001;1123564.1;954663.0;2078227.1
150445;201808;518;333;185;317682.0;175536.0;493218.0
150450;201808;263;129;134;123066.0;127836.0;250902.0
150460;201808;757;574;183;545769.06;174562.92;720332.0
150470;201808;1328;805;523;766443.8;498942.0;1265385.8
150475;201808;220;172;48;164088.0;45792.0;209880.0
150480;201808;1259;878;381;837612.0;363187.8;1200799.8
150490;201808;608;333;275;317682.0;262350.0;580032.0
150495;201808;332;236;96;225144.0;91584.0;316728.0
150497;201808;302;208;94;198432.0;89666.46;288098.47
150500;201808;425;289;136;275706.0;129744.0;405450.0
150503;201808;896;437;459;416612.0;437868.0;854480.0
150506;201808;1026;675;351;643950.0;334844.47;978794.44
150510;201808;1234;697;537;664652.0;512298.0;1176950.0
150520;201808;272;182;90;173628.0;85860.0;259488.0
150530;201808;1588;869;719;825878.3;685926.0;1511804.2
150540;201808;240;166;74;158364.0;70596.0;228960.0
150543;201808;730;418;312;398180.53;297361.8;695542.3
150548;201808;492;345;147;329130.0;140238.0;469368.0
150549;201808;62;46;16;43884.0;15264.0;59148.0
150550;201808;2865;1512;1353;1441495.0;1290476.0;2731971.0
150553;201808;3155;1868;1287;1780260.6;1227788.5;3008049.0
150555;201808;144;76;68;72504.0;64872.0;137376.0
150560;201808;56;43;13;41022.0;12402.0;53424.0
150563;201808;76;41;35;39114.0;33390.0;72504.0
150565;201808;169;101;68;96354.0;64872.0;161226.0
150570;201808;407;270;137;257560.92;130698.0;388258.9
150580;201808;1573;699;874;666846.0;833796.0;1500642.0
150590;201808;786;490;296;467460.0;282384.0;749844.0
150600;201808;463;282;181;269028.0;172674.0;441702.0
150610;201808;143;123;20;116493.0;19080.0;135573.0
150611;201808;129;91;38;86814.0;36252.0;123066.0
150613;201808;3235;1995;1240;1903230.0;1182951.0;3086181.0
150616;201808;496;299;197;285008.0;187938.0;472946.0
150618;201808;1219;658;561;627503.56;535194.0;1162697.6
150619;201808;402;307;95;292878.0;90630.0;383508.0
150620;201808;1273;743;530;708822.0;505333.8;1214155.8
150630;201808;304;203;101;193662.0;96354.0;290016.0
150635;201808;492;209;283;199386.0;269982.0;469368.0
150640;201808;61;28;33;26712.0;31482.0;58194.0
150650;201808;2328;1380;948;1316196.4;904101.8;2220298.2
150655;201808;245;183;62;174582.0;59148.0;233730.0
150658;201808;108;61;47;58194.0;44838.0;103032.0
150660;201808;496;346;150;330084.0;143100.0;473184.0
150670;201808;1016;376;640;358408.8;610541.44;968950.25
150680;201808;9698;5289;4409;5038249.0;4204136.5;9242385.0
150690;201808;52;32;20;30528.0;19080.0;49608.0
150700;201808;526;339;187;323215.2;178398.0;501613.2
150710;201808;279;165;114;157410.0;108756.0;266166.0
150715;201808;853;522;331;497005.9;315745.38;812751.3
150720;201808;427;331;96;315774.0;91297.8;407071.8
150730;201808;941;506;435;482715.0;414703.8;897418.8
150740;201808;224;158;66;150732.0;62964.0;213696.0
150745;201808;802;439;363;418806.0;346302.0;765108.0
150746;201808;54;33;21;31482.0;20034.0;51516.0
150747;201808;259;205;54;195570.0;51516.0;247086.0
150750;201808;132;75;57;71550.0;54378.0;125928.0
150760;201808;1739;1141;598;1088514.0;570492.0;1659006.0
150770;201808;369;194;175;185076.0;166774.95;351850.94
150775;201808;97;45;52;42930.0;49608.0;92538.0
150780;201808;189;99;90;94446.0;85860.0;180306.0
150790;201808;864;470;394;448380.0;375876.0;824256.0
150795;201808;1471;859;612;819486.0;583848.0;1403334.0
150796;201808;384;224;160;213696.0;152640.0;366336.0
150797;201808;284;162;122;154548.0;116388.0;270936.0
150800;201808;1414;854;560;813757.25;534226.0;1347983.2
150803;201808;590;490;100;467460.0;95400.0;562860.0
150805;201808;187;121;66;115434.0;62950.46;178384.45
150808;201808;998;551;447;525654.0;426438.0;952092.0
150810;201808;3402;2353;1049;2241605.2;999859.2;3241464.5
150812;201808;429;228;201;217512.0;191754.0;409266.0
150815;201808;968;640;328;609181.5;312912.0;922093.5
150820;201808;1562;959;603;913932.0;575242.94;1489174.9
150830;201808;824;579;245;550998.4;233730.0;784728.4
150835;201808;188;112;76;106848.0;72504.0;179352.0
150840;201808;1335;857;478;817578.0;456012.0;1273590.0
160005;201808;50;29;21;27666.0;20034.0;47700.0
160010;201808;199;128;71;122112.0;67730.0;189842.0
160015;201808;114;65;49;62010.0;46746.0;108756.0
160020;201808;127;72;55;68688.0;52470.0;121158.0
160021;201808;43;23;20;21942.0;19080.0;41022.0
160023;201808;115;69;46;65826.0;43884.0;109710.0
160025;201808;31;14;17;13356.0;16218.0;29574.0
160027;201808;1489;846;643;804508.7;612668.0;1417176.8
160030;201808;15579;8042;7537;7664012.5;7184796.5;1,48E+14
160040;201808;314;182;132;173628.0;125928.0;299556.0
160050;201808;690;349;341;332946.0;324550.8;657496.8
160053;201808;323;187;136;178112.0;129744.0;307856.0
160055;201808;26;19;7;18126.0;6678.0;24804.0
160060;201808;6456;3397;3059;3229956.5;2917328.2;6147285.0
160070;201808;167;103;64;98262.0;61056.0;159318.0
160080;201808;82;44;38;41976.0;36252.0;78228.0
170025;201808;24;14;10;13356.0;9540.0;22896.0
170030;201808;230;188;42;179155.0;40068.0;219223.0
170035;201808;224;106;118;101124.0;112572.0;213696.0
170040;201808;186;142;44;135181.8;41976.0;177157.8
170070;201808;327;199;128;189846.0;122112.0;311958.0
170100;201808;367;267;100;254718.0;95400.0;350118.0
170105;201808;62;51;11;48654.0;10494.0;59148.0
170110;201808;106;66;40;62964.0;38160.0;101124.0
170130;201808;64;31;33;29574.0;31196.0;60770.0
170190;201808;101;66;35;62964.0;33390.0;96354.0
170200;201808;391;263;128;250225.2;122007.76;372232.97
170210;201808;6006;3160;2846;3005772.0;2713053.8;5718826.0
170215;201808;100;46;54;43884.0;51516.0;95400.0
170220;201808;1408;1037;371;989011.8;353648.0;1342659.8
170230;201808;155;101;54;96354.0;51516.0;147870.0
170240;201808;538;358;180;341532.0;171720.0;513252.0
170255;201808;1103;886;217;845034.1;206731.8;1051765.9
170270;201808;38;28;10;26712.0;9349.2;36061.2
170290;201808;90;66;24;62964.0;22896.0;85860.0
170300;201808;85;57;28;53614.8;26712.0;80326.8
170305;201808;47;36;11;34344.0;10494.0;44838.0
170307;201808;63;47;16;44838.0;15264.0;60102.0
170310;201808;103;56;47;53424.0;44838.0;98262.0
170320;201808;21;17;4;16218.0;3816.0;20034.0
170330;201808;24;22;2;20988.0;1908.0;22896.0
170360;201808;24;14;10;13356.0;9540.0;22896.0
170370;201808;121;63;58;60102.0;55332.0;115434.0
170380;201808;85;63;22;60102.0;20988.0;81090.0
170382;201808;44;39;5;37206.0;4770.0;41976.0
170384;201808;139;103;36;98262.0;34344.0;132606.0
170386;201808;62;27;35;25758.0;33390.0;59148.0
170388;201808;49;19;30;18126.0;28620.0;46746.0
170389;201808;23;19;4;18126.0;3816.0;21942.0
170390;201808;58;34;24;32427.0;22896.0;55323.0
170410;201808;34;24;10;22896.0;9540.0;32436.0
170460;201808;16;13;3;12402.0;2862.0;15264.0
170510;201808;29;22;7;20988.0;6678.0;27666.0
170550;201808;1515;873;642;832842.0;611705.0;1444547.0
170555;201808;113;79;34;75366.0;32436.0;107802.0
170560;201808;98;72;26;68688.0;24804.0;93492.0
170600;201808;39;19;20;18126.0;19080.0;37206.0
170610;201808;190;101;89;96196.59;84602.0;180798.6
170625;201808;38;20;18;19080.0;17172.0;36252.0
170650;201808;82;62;20;59148.0;19080.0;78228.0
170700;201808;564;431;133;407296.5;126595.8;533892.3
170710;201808;161;99;62;94446.0;59139.0;153585.0
170720;201808;83;67;16;63918.0;15264.0;79182.0
170730;201808;63;37;26;35298.0;24804.0;60102.0
170740;201808;80;59;21;56286.0;20034.0;76320.0
170755;201808;69;36;33;34344.0;31482.0;65826.0
170765;201808;137;68;69;64586.0;65826.0;130412.0
170770;201808;227;135;92;127692.9;87768.0;215460.9
170820;201808;595;390;205;372060.0;195141.0;567201.0
170825;201808;31;19;12;18126.0;11448.0;29574.0
170830;201808;81;62;19;59148.0;18126.0;77274.0
170900;201808;197;150;47;143100.0;44838.0;187938.0
170930;201808;822;431;391;410850.0;372442.0;783292.0
170950;201808;3029;1331;1698;1268516.2;1617775.2;2886291.5
170980;201808;18;10;8;9540.0;7632.0;17172.0
171050;201808;138;107;31;102078.0;29574.0;131652.0
171070;201808;38;31;7;29574.0;6678.0;36252.0
171090;201808;41;30;11;28620.0;10494.0;39114.0
171110;201808;20;13;7;12402.0;6678.0;19080.0
171150;201808;41;20;21;19080.0;20034.0;39114.0
171180;201808;22;10;12;9540.0;11448.0;20988.0
171190;201808;144;84;60;80136.0;57240.0;137376.0
171195;201808;64;50;14;47700.0;13356.0;61056.0
171200;201808;48;21;27;20034.0;25758.0;45792.0
171215;201808;3;3;0;2862.0;0.0;2862.0
171240;201808;55;45;10;42930.0;9540.0;52470.0
171245;201808;56;51;5;48654.0;4770.0;53424.0
171250;201808;71;37;34;35298.0;32426.46;67724.46
171270;201808;17;13;4;12402.0;3816.0;16218.0
171280;201808;39;36;3;34201.0;2862.0;37063.0
171320;201808;995;565;430;539010.0;408216.6;947226.6
171330;201808;425;205;220;195570.0;209880.0;405450.0
171360;201808;90;65;25;62010.0;23850.0;85860.0
171370;201808;25;13;12;12402.0;11448.0;23850.0
171380;201808;135;110;25;104940.0;23333.89;128273.89
171395;201808;55;34;21;32436.0;20034.0;52470.0
171420;201808;302;197;105;187938.0;99883.8;287821.8
171430;201808;66;53;13;50562.0;12402.0;62964.0
171488;201808;198;106;92;101124.0;87768.0;188892.0
171500;201808;58;32;26;30528.0;24804.0;55332.0
171510;201808;67;44;23;41976.0;21942.0;63918.0
171515;201808;43;36;7;34344.0;6392.0;40736.0
171525;201808;30;26;4;24804.0;3816.0;28620.0
171550;201808;12;7;5;6678.0;4770.0;11448.0
171570;201808;60;31;29;29574.0;27666.0;57240.0
171575;201808;335;209;126;199386.0;120194.46;319580.47
171610;201808;1715;864;851;822357.0;810305.7;1632662.6
171620;201808;133;92;41;87214.68;39114.0;126328.68
171630;201808;53;29;24;27666.0;22896.0;50562.0
171650;201808;271;180;91;171720.0;86814.0;258534.0
171660;201808;267;144;123;137376.0;117338.0;254714.0
171665;201808;50;34;16;32436.0;15264.0;47700.0
171670;201808;434;253;181;239492.66;172387.8;411880.47
171700;201808;65;57;8;54378.0;7632.0;62010.0
171720;201808;26;9;17;8586.0;16218.0;24804.0
171750;201808;105;57;48;54378.0;45792.0;100170.0
171780;201808;74;59;15;56286.0;14310.0;70596.0
171790;201808;75;64;11;61056.0;10494.0;71550.0
171800;201808;36;28;8;26712.0;7632.0;34344.0
171820;201808;2066;1171;895;1114758.8;849222.8;1963981.5
171830;201808;38;31;7;29574.0;6678.0;36252.0
171840;201808;65;38;27;36252.0;25758.0;62010.0
171845;201808;33;20;13;19080.0;12402.0;31482.0
171850;201808;41;30;11;28620.0;10494.0;39114.0
171855;201808;79;62;17;59148.0;16218.0;75366.0
171865;201808;9;8;1;7632.0;954.0;8586.0
171870;201808;31;22;9;20988.0;8586.0;29574.0
171875;201808;80;55;25;52470.0;23850.0;76320.0
171880;201808;29;19;10;18126.0;9540.0;27666.0
171884;201808;47;24;23;22896.0;21942.0;44838.0
171886;201808;124;46;78;43884.0;74125.8;118009.8
171888;201808;24;18;6;17172.0;5724.0;22896.0
171889;201808;20;16;4;15264.0;3816.0;19080.0
171890;201808;57;47;10;44838.0;9540.0;54378.0
171900;201808;43;30;13;28620.0;12402.0;41022.0
172000;201808;38;33;5;31482.0;4770.0;36252.0
172010;201808;40;34;6;31625.1;5724.0;37349.1
172015;201808;25;16;9;14790.0;8299.8;23089.8
172020;201808;133;85;48;81090.0;45792.0;126882.0
172025;201808;32;21;11;20034.0;10494.0;30528.0
172030;201808;37;22;15;20988.0;14310.0;35298.0
172049;201808;74;46;28;43884.0;26712.0;70596.0
172065;201808;146;93;53;88672.0;50562.0;139234.0
172080;201808;93;64;29;59873.84;27666.0;87539.84
172085;201808;25;12;13;11448.0;12402.0;23850.0
172090;201808;411;315;96;299713.4;90821.0;390534.4
172093;201808;24;18;6;17172.0;5724.0;22896.0
172097;201808;16;8;8;7632.0;7346.0;14978.0
172100;201808;4768;2697;2071;2566986.2;1972597.2;4539583.5
172110;201808;82;55;27;52470.0;25758.0;78228.0
172120;201808;1706;1465;241;1391493.6;228787.4;1620281.0
172125;201808;4;4;0;3816.0;0.0;3816.0
172130;201808;16;12;4;11448.0;3816.0;15264.0
172208;201808;193;123;70;117342.0;66780.0;184122.0
172210;201808;409;198;211;188892.0;201008.0;389900.0
210005;201808;2953;1841;1112;1753261.2;1057702.0;2810963.2
210010;201808;187;96;91;91584.0;86814.0;178398.0
210015;201808;31;21;10;20034.0;9540.0;29574.0
210020;201808;346;185;161;176490.0;153594.0;330084.0
210030;201808;347;219;128;208926.0;122103.0;331029.0
210040;201808;151;117;34;111618.0;32436.0;144054.0
210043;201808;266;183;83;174582.0;79182.0;253764.0
210047;201808;600;324;276;308714.4;263294.47;572008.9
210050;201808;300;219;81;208926.0;77274.0;286200.0
210055;201808;43;33;10;31482.0;9540.0;41022.0
210060;201808;559;443;116;422522.78;110664.0;533186.8
210070;201808;418;311;107;296694.0;102078.0;398772.0
210080;201808;104;94;10;89676.0;9540.0;99216.0
210083;201808;310;138;172;131652.0;164088.0;295740.0
210087;201808;43;32;11;29726.64;10494.0;40220.64
210090;201808;488;339;149;323406.0;142146.0;465552.0
210095;201808;487;357;130;340568.47;124020.0;464588.47
210100;201808;697;532;165;507194.1;156456.02;663650.1
210110;201808;149;84;65;80136.0;62010.0;142146.0
210120;201808;5442;4118;1324;3921653.0;1261842.6;5183495.5
210125;201808;213;125;88;119250.0;83952.0;203202.0
210130;201808;528;286;242;271890.0;230848.92;502738.9
210135;201808;34;20;14;19080.0;13356.0;32436.0
210140;201808;4410;3464;946;3301786.2;902246.0;4204032.0
210150;201808;363;230;133;219420.0;126882.0;346302.0
210160;201808;3398;2862;536;2727488.8;511058.0;3238546.8
210170;201808;1156;912;244;870048.0;232776.0;1102824.0
210173;201808;123;102;21;97308.0;20034.0;117342.0
210177;201808;448;222;226;211788.0;215604.0;427392.0
210180;201808;32;17;15;16218.0;14310.0;30528.0
210190;201808;419;272;147;259488.0;140238.0;399726.0
210193;201808;1;1;0;954.0;0.0;954.0
210197;201808;78;52;26;49608.0;24785.88;74393.88
210200;201808;645;511;134;487055.16;127836.0;614891.2
210203;201808;258;173;85;164756.0;81090.0;245846.0
210207;201808;387;303;84;289062.0;80136.0;369198.0
210210;201808;782;715;67;682110.0;63918.0;746028.0
210215;201808;80;68;12;64872.0;11448.0;76320.0
210220;201808;394;325;69;310050.0;65539.8;375589.8
210230;201808;310;237;73;226098.0;69642.0;295740.0
210232;201808;1480;949;531;905060.0;506565.0;1411625.0
210235;201808;158;125;33;119060.0;31482.0;150542.0
210237;201808;44;24;20;22896.0;19080.0;41976.0
210240;201808;92;75;17;71550.0;16218.0;87768.0
210250;201808;187;151;36;144054.0;34344.0;178398.0
210255;201808;348;257;91;245178.0;86814.0;331992.0
210260;201808;419;268;151;255672.0;144054.0;399726.0
210270;201808;692;444;248;423576.0;236592.0;660168.0
210275;201808;53;40;13;38160.0;12402.0;50562.0
210280;201808;1049;681;368;646859.3;349736.5;996595.8
210290;201808;501;329;172;313866.0;164088.0;477954.0
210300;201808;6040;3550;2490;3382063.2;2374268.2;5756331.5
210310;201808;106;73;33;69642.0;31482.0;101124.0
210312;201808;122;80;42;76320.0;40068.0;116388.0
210315;201808;115;87;28;82998.0;26712.0;109710.0
210317;201808;127;90;37;85860.0;35298.0;121158.0
210320;201808;2397;1975;422;1882439.9;402588.0;2285027.8
210325;201808;129;90;39;84906.0;36920.0;121826.0
210330;201808;5416;2820;2596;2685171.5;2476574.5;5161746.0
210340;201808;1379;994;385;947476.0;367219.06;1314695.1
210350;201808;614;507;107;483439.5;102078.0;585517.5
210355;201808;136;110;26;104940.0;24804.0;129744.0
210360;201808;2616;1650;966;1570953.6;921278.0;2492231.5
210370;201808;1245;555;690;529470.0;658260.0;1187730.0
210375;201808;188;97;91;91995.0;86814.0;178809.0
210380;201808;728;544;184;518976.0;175536.0;694512.0
210390;201808;206;171;35;163134.0;33390.0;196524.0
210400;201808;425;359;66;342486.0;62945.0;405431.0
210405;201808;1021;694;327;662076.0;311958.0;974034.0
210407;201808;55;43;12;41022.0;11448.0;52470.0
210408;201808;65;58;7;55332.0;6678.0;62010.0
210409;201808;323;270;53;257580.0;50562.0;308142.0
210410;201808;442;343;99;327222.0;94437.0;421659.0
210420;201808;197;161;36;153594.0;34344.0;187938.0
210430;201808;37;27;10;25758.0;9540.0;35298.0
210440;201808;371;227;144;216558.0;137376.0;353934.0
210450;201808;152;114;38;108756.0;36252.0;145008.0
210455;201808;224;121;103;115434.0;98262.0;213696.0
210460;201808;344;218;126;207972.0;120204.0;328176.0
210462;201808;62;52;10;49608.0;9540.0;59148.0
210465;201808;174;127;47;121158.0;44838.0;165996.0
210467;201808;534;382;152;364428.0;145008.0;509436.0
210470;201808;43;34;9;32436.0;8586.0;41022.0
210480;201808;1320;940;380;896760.0;362520.0;1259280.0
210490;201808;223;137;86;130698.0;82044.0;212742.0
210500;201808;585;310;275;295740.0;262350.0;558090.0
210510;201808;557;432;125;412128.0;119250.0;531378.0
210515;201808;434;243;191;231822.0;182214.0;414036.0
210520;201808;409;358;51;341245.8;48654.0;389899.8
210530;201808;9452;5053;4399;4808489.5;4188839.2;8997328.0
210535;201808;129;93;36;88722.0;34344.0;123066.0
210540;201808;1556;952;604;907063.8;574785.0;1481848.8
210542;201808;1191;591;600;563432.4;572114.0;1135546.4
210545;201808;12;11;1;10494.0;954.0;11448.0
210547;201808;131;112;19;106848.0;18126.0;124974.0
210550;201808;737;523;214;497375.0;204156.0;701531.0
210560;201808;179;150;29;143100.0;27666.0;170766.0
210565;201808;30;22;8;20988.0;7632.0;28620.0
210570;201808;1365;1076;289;1025264.25;275706.0;1300970.2
210580;201808;110;96;14;91584.0;13356.0;104940.0
210590;201808;774;616;158;586900.8;150732.0;737632.8
210592;201808;31;27;4;25758.0;3816.0;29574.0
210594;201808;107;88;19;83952.0;18126.0;102078.0
210596;201808;90;75;15;71550.0;14310.0;85860.0
210598;201808;128;92;36;87768.0;34344.0;122112.0
210600;201808;336;284;52;270936.0;49608.0;320544.0
210610;201808;254;235;19;223236.0;18126.0;241362.0
210620;201808;47;27;20;25758.0;19080.0;44838.0
210630;201808;63;60;3;57240.0;2862.0;60102.0
210632;201808;1099;734;365;700236.0;347733.0;1047969.0
210635;201808;18;15;3;14310.0;2862.0;17172.0
210637;201808;105;73;32;69642.0;30528.0;100170.0
210640;201808;592;519;73;495126.0;69642.0;564768.0
210650;201808;417;336;81;319618.62;76320.0;395938.62
210660;201808;404;295;109;280763.0;103862.0;384625.0
210663;201808;22;11;11;10494.0;10494.0;20988.0
210667;201808;113;36;77;34344.0;73458.0;107802.0
210670;201808;269;236;33;224429.0;31482.0;255911.0
210675;201808;567;299;268;285246.0;255672.0;540918.0
210680;201808;210;133;77;126882.0;73458.0;200340.0
210690;201808;645;514;131;490356.0;124974.0;615330.0
210700;201808;189;140;49;133560.0;46746.0;180306.0
210710;201808;295;168;127;160081.2;121158.0;281239.2
210720;201808;130;109;21;103986.0;20034.0;124020.0
210725;201808;71;62;9;59148.0;8586.0;67734.0
210730;201808;26;19;7;18126.0;6678.0;24804.0
210735;201808;415;278;137;265212.0;130412.0;395624.0
210740;201808;557;469;88;447426.0;83952.0;531378.0
210745;201808;157;115;42;109710.0;40068.0;149778.0
210750;201808;2438;1110;1328;1056985.0;1266892.9;2323878.0
210760;201808;270;200;70;190800.0;66765.69;257565.69
210770;201808;406;314;92;299556.0;87481.8;387037.8
210780;201808;425;309;116;294786.0;110664.0;405450.0
210790;201808;189;146;43;139284.0;41022.0;180306.0
210800;201808;152;112;40;106848.0;38160.0;145008.0
210805;201808;45;41;4;39114.0;3816.0;42930.0
210810;201808;493;379;114;360898.2;108756.0;469654.2
210820;201808;2330;1854;476;1760271.4;454104.0;2214375.5
210825;201808;171;89;82;84906.0;78228.0;163134.0
210830;201808;804;499;305;475092.0;290016.0;765108.0
210840;201808;210;142;68;135468.0;64872.0;200340.0
210845;201808;254;161;93;153594.0;88722.0;242316.0
210850;201808;842;538;304;513252.0;290016.0;803268.0
210860;201808;4127;2149;1978;2048620.2;1886706.8;3935327.0
210870;201808;477;360;117;343440.0;111618.0;455058.0
210880;201808;65;47;18;44838.0;17172.0;62010.0
210890;201808;348;290;58;276660.0;55332.0;331992.0
210900;201808;588;382;206;364424.0;196524.0;560948.0
210905;201808;67;34;33;32436.0;31482.0;63918.0
210910;201808;2012;1493;519;1423032.0;495126.0;1918158.0
210920;201808;225;68;157;64872.0;149778.0;214650.0
210923;201808;80;58;22;55332.0;20988.0;76320.0
210927;201808;433;184;249;175536.0;237546.0;413082.0
210930;201808;65;52;13;49608.0;12402.0;62010.0
210940;201808;93;71;22;67734.0;20988.0;88722.0
210945;201808;200;94;106;89676.0;101124.0;190800.0
210950;201808;521;377;144;359658.0;137371.23;497029.22
210955;201808;75;50;25;47700.0;23850.0;71550.0
210960;201808;2428;1055;1373;1004848.4;1309556.0;2314404.5
210970;201808;116;102;14;97308.0;13356.0;110664.0
210975;201808;91;82;9;78228.0;8586.0;86814.0
210980;201808;1209;533;676;508367.53;644618.0;1152985.5
210990;201808;4354;2724;1630;2597595.2;1555020.0;4152615.2
211000;201808;1383;1099;284;1048160.0;270649.8;1318809.8
211003;201808;928;636;292;606744.0;278559.0;885303.0
211010;201808;498;439;59;418806.0;56286.0;475092.0
211020;201808;1610;592;1018;564768.0;970952.56;1535720.6
211023;201808;28;24;4;22609.8;3816.0;26425.8
211027;201808;67;45;22;42930.0;20988.0;63918.0
211030;201808;384;259;125;247086.0;119250.0;366336.0
211040;201808;323;251;72;239168.0;68688.0;307856.0
211050;201808;1180;763;417;727882.94;397527.22;1125410.1
211060;201808;689;584;105;555228.0;100170.0;655398.0
211065;201808;22;18;4;17172.0;3816.0;20988.0
211070;201808;929;756;173;719612.75;165042.0;884654.75
211080;201808;87;83;4;79182.0;3816.0;82998.0
211085;201808;60;32;28;30242.0;26712.0;56954.0
211090;201808;91;73;18;69642.0;17172.0;86814.0
211100;201808;506;407;99;387991.8;94446.0;482437.8
211102;201808;263;177;86;168858.0;82044.0;250902.0
211105;201808;222;150;72;143100.0;68688.0;211788.0
211107;201808;136;78;58;74412.0;55332.0;129744.0
211110;201808;830;533;297;507910.0;283329.0;791239.0
211120;201808;5799;2515;3284;2393646.2;3131844.2;5525490.5
211125;201808;32;25;7;23850.0;6678.0;30528.0
211130;201808;45860;19467;26393;1,85E+14;2,52E+14;4,37E+14
211140;201808;431;365;66;347252.0;62964.0;410216.0
211150;201808;1293;826;467;787670.1;445228.0;1232898.1
211153;201808;166;98;68;93492.0;64872.0;158364.0
211157;201808;64;50;14;47700.0;13356.0;61056.0
211160;201808;716;597;119;568822.5;113526.0;682348.5
211163;201808;0;0;0;0.0;0.0;0.0
211167;201808;10;8;2;7632.0;1908.0;9540.0
211170;201808;449;314;135;299556.0;128790.0;428346.0
211172;201808;122;85;37;81090.0;35298.0;116388.0
211174;201808;268;161;107;153594.0;102078.0;255672.0
211176;201808;517;374;143;356796.0;136422.0;493218.0
211178;201808;97;62;35;59148.0;33390.0;92538.0
211180;201808;209;164;45;156456.0;42767.82;199223.81
211190;201808;67;61;6;58194.0;5724.0;63918.0
211195;201808;30;19;11;18126.0;10494.0;28620.0
211200;201808;156;136;20;129400.56;19080.0;148480.56
211210;201808;521;331;190;315106.2;181260.0;496366.2
211220;201808;4055;2292;1763;2178725.5;1675565.0;3854290.5
211223;201808;96;91;5;86632.74;4770.0;91402.74
211227;201808;70;50;20;47700.0;19080.0;66780.0
211230;201808;785;640;145;610560.0;138310.92;748870.94
211240;201808;417;314;103;299202.88;98262.0;397464.88
211245;201808;199;89;110;84906.0;104940.0;189846.0
211250;201808;1643;1404;239;1338424.1;228006.0;1566430.1
211260;201808;828;654;174;623916.0;165996.0;789912.0
211270;201808;2067;1632;435;1556928.0;414036.2;1970964.2
211280;201808;1861;1125;736;1072296.8;702144.0;1774440.8
211285;201808;206;120;86;114480.0;82044.0;196524.0
211290;201808;690;465;225;443419.2;214650.0;658069.2
211300;201808;816;630;186;600742.06;177444.0;778186.06
211400;201808;1591;910;681;868140.0;649674.0;1517814.0
220005;201808;18;17;1;16218.0;954.0;17172.0
220010;201808;87;67;20;63918.0;18793.8;82711.8
220020;201808;631;499;132;475061.03;125928.0;600989.06
220025;201808;108;104;4;99216.0;3816.0;103032.0
220027;201808;37;30;7;28620.0;6678.0;35298.0
220030;201808;98;81;17;77274.0;16218.0;93492.0
220040;201808;1143;864;279;823092.94;266166.0;1089259.0
220045;201808;39;29;10;27666.0;9540.0;37206.0
220050;201808;671;553;118;526400.94;112552.92;638953.9
220060;201808;176;150;26;143100.0;24804.0;167904.0
220070;201808;99;90;9;85860.0;8586.0;94446.0
220080;201808;11;10;1;9540.0;954.0;10494.0
220090;201808;35;28;7;26712.0;6678.0;33390.0
220095;201808;2;1;1;954.0;954.0;1908.0
220100;201808;27;23;4;21942.0;3816.0;25758.0
220105;201808;26;24;2;22520.0;1908.0;24428.0
220110;201808;213;195;18;185743.8;17172.0;202915.8
220115;201808;49;46;3;43884.0;2862.0;46746.0
220117;201808;20;18;2;17172.0;1908.0;19080.0
220120;201808;1488;1079;409;1028030.4;390166.9;1418197.4
220130;201808;27;26;1;24804.0;954.0;25758.0
220140;201808;99;78;21;73458.0;20034.0;93492.0
220150;201808;469;336;133;320544.0;126882.0;447426.0
220155;201808;4;4;0;3816.0;0.0;3816.0
220157;201808;18;15;3;14310.0;2862.0;17172.0
220160;201808;76;65;11;62010.0;10494.0;72504.0
220170;201808;38;36;2;34344.0;1908.0;36252.0
220173;201808;7;7;0;6678.0;0.0;6678.0
220177;201808;5;5;0;4770.0;0.0;4770.0
220180;201808;65;64;1;61051.23;954.0;62005.23
220190;201808;1058;950;108;906300.0;103032.0;1009332.0
220191;201808;44;39;5;37206.0;4770.0;41976.0
220192;201808;68;65;3;62010.0;2862.0;64872.0
220194;201808;42;38;4;36252.0;3816.0;40068.0
220196;201808;104;86;18;82044.0;17172.0;99216.0
220198;201808;5;4;1;3816.0;954.0;4770.0
220200;201808;429;355;74;338337.0;70596.0;408933.0
220202;201808;37;33;4;31482.0;3816.0;35298.0
220205;201808;40;36;4;34344.0;3816.0;38160.0
220207;201808;18;17;1;16218.0;954.0;17172.0
220208;201808;84;45;39;42930.0;37206.0;80136.0
220209;201808;31;28;3;26712.0;2862.0;29574.0
220210;201808;15;13;2;12402.0;1908.0;14310.0
220211;201808;26;26;0;24804.0;0.0;24804.0
220213;201808;43;39;4;37206.0;3530.0;40736.0
220217;201808;37;29;8;27666.0;7632.0;35298.0
220220;201808;2064;1326;738;1261378.8;702649.94;1964028.8
220225;201808;14;7;7;6678.0;6678.0;13356.0
220230;201808;949;747;202;712189.6;192068.81;904258.44
220240;201808;148;135;13;128790.0;12402.0;141192.0
220245;201808;32;29;3;26963.04;2862.0;29825.04
220250;201808;113;102;11;97308.0;10494.0;107802.0
220253;201808;43;36;7;34344.0;6678.0;41022.0
220255;201808;28;25;3;23850.0;2862.0;26712.0
220260;201808;684;496;188;473184.0;179352.0;652536.0
220265;201808;12;9;3;8586.0;2862.0;11448.0
220270;201808;704;623;81;593616.94;76797.0;670413.94
220271;201808;43;36;7;34344.0;6678.0;41022.0
220272;201808;27;27;0;25758.0;0.0;25758.0
220273;201808;15;13;2;12402.0;1908.0;14310.0
220275;201808;59;48;11;45792.0;10494.0;56286.0
220277;201808;13;11;2;10494.0;1908.0;12402.0
220280;201808;15;12;3;11448.0;2862.0;14310.0
220285;201808;45;42;3;40068.0;2862.0;42930.0
220290;201808;1413;1207;206;1148186.8;196477.0;1344663.8
220300;201808;49;47;2;44838.0;1908.0;46746.0
220310;201808;313;264;49;251852.0;46737.0;298589.0
220320;201808;440;407;33;386848.0;31482.0;418330.0
220323;201808;0;0;0;0.0;0.0;0.0
220325;201808;16;11;5;10494.0;4770.0;15264.0
220327;201808;13;12;1;11448.0;954.0;12402.0
220330;201808;206;144;62;137376.0;59148.0;196524.0
220335;201808;134;116;18;110664.0;17172.0;127836.0
220340;201808;28;17;11;16218.0;10494.0;26712.0
220342;201808;56;48;8;45792.0;7632.0;53424.0
220345;201808;86;78;8;74412.0;7632.0;82044.0
220350;201808;431;376;55;356081.4;52470.0;408551.4
220360;201808;43;31;12;29574.0;11448.0;41022.0
220370;201808;1134;920;214;876916.8;203869.8;1080786.6
220375;201808;26;24;2;22896.0;1908.0;24804.0
220380;201808;40;33;7;31482.0;6678.0;38160.0
220385;201808;26;23;3;21942.0;2862.0;24804.0
220390;201808;2268;1291;977;1226920.5;930961.5;2157882.0
220400;201808;29;26;3;24804.0;2862.0;27666.0
220410;201808;16;15;1;14310.0;954.0;15264.0
220415;201808;14;13;1;12402.0;954.0;13356.0
220420;201808;125;103;22;98262.0;20701.8;118963.8
220430;201808;130;118;12;110903.8;11448.0;122351.8
220435;201808;21;15;6;14305.23;5724.0;20029.23
220440;201808;288;247;41;235638.0;39114.0;274752.0
220450;201808;339;171;168;161968.98;160272.0;322240.97
220455;201808;55;53;2;50562.0;1908.0;52470.0
220460;201808;18;18;0;16504.2;0.0;16504.2
220465;201808;106;69;37;65826.0;35298.0;101124.0
220470;201808;243;215;28;205110.0;26712.0;231822.0
220480;201808;72;62;10;59148.0;9540.0;68688.0
220490;201808;87;75;12;71550.0;11448.0;82998.0
220500;201808;100;84;16;80136.0;15264.0;95400.0
220510;201808;381;302;79;287345.0;75175.2;362520.2
220515;201808;22;19;3;18126.0;2862.0;20988.0
220520;201808;371;333;38;316367.0;36233.0;352600.0
220525;201808;25;17;8;16218.0;7632.0;23850.0
220527;201808;38;29;9;27666.0;7776.0;35442.0
220530;201808;36;14;22;13356.0;20988.0;34344.0
220535;201808;9;8;1;7632.0;954.0;8586.0
220540;201808;59;50;9;47700.0;8586.0;56286.0
220545;201808;57;39;18;37206.0;17172.0;54378.0
220550;201808;651;498;153;474328.8;145962.0;620290.8
220551;201808;25;19;6;18126.0;5724.0;23850.0
220552;201808;10;10;0;9540.0;0.0;9540.0
220553;201808;49;44;5;41976.0;4770.0;46746.0
220554;201808;13;8;5;7345.8;4770.0;12115.8
220555;201808;26;23;3;21942.0;2862.0;24804.0
220556;201808;52;48;4;45792.0;3816.0;49608.0
220557;201808;56;50;6;47700.0;5724.0;53424.0
220558;201808;7;2;5;1908.0;4770.0;6678.0
220559;201808;5;5;0;4770.0;0.0;4770.0
220560;201808;60;38;22;36061.2;20988.0;57049.2
220570;201808;794;483;311;459578.12;296694.0;756272.1
220580;201808;566;520;46;496060.9;43197.92;539258.8
220585;201808;6;5;1;4770.0;954.0;5724.0
220590;201808;14;14;0;13356.0;0.0;13356.0
220595;201808;59;44;15;41976.0;14310.0;56286.0
220600;201808;24;12;12;11448.0;11448.0;22896.0
220605;201808;20;19;1;18126.0;954.0;19080.0
220610;201808;62;53;9;50562.0;8586.0;59148.0
220620;201808;561;444;117;423337.5;111618.0;534955.5
220630;201808;6;4;2;3816.0;1908.0;5724.0
220635;201808;37;33;4;31482.0;3816.0;35298.0
220640;201808;97;76;21;72504.0;20034.0;92538.0
220650;201808;113;107;6;102078.0;5724.0;107802.0
220660;201808;33;27;6;25758.0;5724.0;31482.0
220665;201808;4;4;0;3816.0;0.0;3816.0
220667;201808;16;14;2;13356.0;1908.0;15264.0
220669;201808;29;26;3;24804.0;2862.0;27666.0
220670;201808;72;56;16;53424.0;15264.0;68688.0
220672;201808;67;45;22;42930.0;20988.0;63918.0
220675;201808;36;28;8;26712.0;7632.0;34344.0
220680;201808;37;32;5;30528.0;4770.0;35298.0
220690;201808;45;43;2;41022.0;1908.0;42930.0
220695;201808;57;26;31;24804.0;29574.0;54378.0
220700;201808;1576;1209;367;1151544.8;350118.0;1501662.8
220710;201808;4;2;2;1908.0;1908.0;3816.0
220720;201808;108;88;20;83713.5;18936.9;102650.4
220730;201808;19;18;1;17172.0;954.0;18126.0
220735;201808;3;1;2;954.0;1908.0;2862.0
220740;201808;47;42;5;40068.0;4770.0;44838.0
220750;201808;101;84;17;80136.0;16218.0;96354.0
220755;201808;14;14;0;13356.0;0.0;13356.0
220760;201808;52;49;3;46746.0;2862.0;49608.0
220770;201808;5666;2953;2713;2811872.8;2582078.5;5393951.0
220775;201808;23;11;12;10494.0;11448.0;21942.0
220777;201808;17;16;1;15264.0;954.0;16218.0
220779;201808;17;14;3;13356.0;2862.0;16218.0
220780;201808;878;752;126;716740.2;119918.0;836658.2
220785;201808;15;9;6;8586.0;5724.0;14310.0
220790;201808;1021;814;207;774154.0;197478.0;971632.0
220793;201808;12;12;0;11448.0;0.0;11448.0
220795;201808;21;20;1;19080.0;954.0;20034.0
220800;201808;3982;3045;937;2902724.0;892921.9;3795645.8
220810;201808;63;55;8;52470.0;7632.0;60102.0
220820;201808;241;219;22;208926.0;20988.0;229914.0
220830;201808;1192;1012;180;965443.25;171701.0;1137144.2
220840;201808;2356;1640;716;1553670.2;679850.75;2233521.0
220850;201808;53;45;8;42930.0;7632.0;50562.0
220855;201808;13;8;5;7632.0;4770.0;12402.0
220860;201808;8;7;1;6678.0;954.0;7632.0
220865;201808;22;20;2;19080.0;1908.0;20988.0
220870;201808;64;61;3;58194.0;2862.0;61056.0
220880;201808;319;245;74;233062.2;70310.0;303372.2
220885;201808;40;37;3;35298.0;2862.0;38160.0
220887;201808;17;17;0;16218.0;0.0;16218.0
220890;201808;102;90;12;85860.0;11448.0;97308.0
220900;201808;51;29;22;27666.0;20988.0;48654.0
220910;201808;55;47;8;44838.0;7632.0;52470.0
220915;201808;9;8;1;7632.0;954.0;8586.0
220920;201808;40;36;4;34344.0;3816.0;38160.0
220930;201808;41;40;1;38160.0;954.0;39114.0
220935;201808;16;16;0;15264.0;0.0;15264.0
220937;201808;44;41;3;39114.0;2862.0;41976.0
220940;201808;53;49;4;46746.0;3816.0;50562.0
220945;201808;0;0;0;0.0;0.0;0.0
220950;201808;48;44;4;41976.0;3816.0;45792.0
220955;201808;35;32;3;30528.0;2862.0;33390.0
220960;201808;2;2;0;1908.0;0.0;1908.0
220965;201808;30;27;3;25758.0;2862.0;28620.0
220970;201808;49;42;7;40068.0;6678.0;46746.0
220975;201808;10;9;1;8586.0;954.0;9540.0
220980;201808;32;30;2;28620.0;1908.0;30528.0
220985;201808;69;61;8;58194.0;7632.0;65826.0
220987;201808;31;29;2;27666.0;1908.0;29574.0
220990;201808;16;15;1;14310.0;954.0;15264.0
220995;201808;35;30;5;28620.0;4770.0;33390.0
220997;201808;48;38;10;36252.0;9540.0;45792.0
221000;201808;1142;1028;114;977279.6;108469.8;1085749.4
221005;201808;63;57;6;54378.0;5724.0;60102.0
221010;201808;17;14;3;13356.0;2862.0;16218.0
221020;201808;43;41;2;39114.0;1908.0;41022.0
221030;201808;30;24;6;22896.0;5724.0;28620.0
221035;201808;22;22;0;20988.0;0.0;20988.0
221037;201808;12;6;6;5724.0;5724.0;11448.0
221038;201808;26;23;3;21942.0;2862.0;24804.0
221039;201808;23;23;0;21942.0;0.0;21942.0
221040;201808;261;225;36;214650.0;34344.0;248994.0
221050;201808;235;200;35;190800.0;33390.0;224190.0
221060;201808;1762;1553;209;1479092.8;199386.0;1678478.8
221062;201808;30;29;1;27666.0;954.0;28620.0
221063;201808;14;10;4;9540.0;3816.0;13356.0
221065;201808;51;44;7;41976.0;6678.0;48654.0
221070;201808;139;120;19;114480.0;18126.0;132606.0
221080;201808;376;333;43;317682.0;40735.8;358417.8
221090;201808;34;33;1;31482.0;954.0;32436.0
221093;201808;56;37;19;35298.0;18126.0;53424.0
221095;201808;11;10;1;9540.0;954.0;10494.0
221097;201808;20;17;3;16218.0;2862.0;19080.0
221100;201808;24944;14443;10501;1,38E+14;1,00E+14;2,38E+13
221110;201808;1054;780;274;743834.0;261396.0;1005230.0
221120;201808;536;398;138;379406.0;131652.0;511058.0
221130;201808;946;772;174;735248.8;165996.0;901244.8
221135;201808;36;33;3;31482.0;2862.0;34344.0
221140;201808;41;34;7;32436.0;6678.0;39114.0
221150;201808;14;11;3;10494.0;2862.0;13356.0
221160;201808;12;12;0;11448.0;0.0;11448.0
221170;201808;13;13;0;12402.0;0.0;12402.0
230010;201808;169;155;14;147870.0;13356.0;161226.0
230015;201808;120;100;20;95400.0;19080.0;114480.0
230020;201808;1602;1358;244;1292603.9;231888.56;1524492.4
230030;201808;1639;1184;455;1123967.0;434070.0;1558037.0
230040;201808;206;181;25;171195.5;23850.0;195045.5
230050;201808;211;155;56;147870.0;53424.0;201294.0
230060;201808;158;129;29;122302.8;27666.0;149968.8
230070;201808;284;253;31;241362.0;29574.0;270936.0
230075;201808;840;733;107;697279.0;101791.8;799070.8
230080;201808;184;158;26;150732.0;24804.0;175536.0
230090;201808;105;74;31;69832.8;29574.0;99406.8
230100;201808;1959;1167;792;1111012.0;755549.0;1866561.0
230110;201808;2677;1722;955;1640351.2;910497.8;2550849.0
230120;201808;962;768;194;730269.1;185057.0;915326.1
230125;201808;145;120;25;114480.0;23850.0;138330.0
230130;201808;473;424;49;404496.0;46746.0;451242.0
230140;201808;203;176;27;167904.0;25758.0;193662.0
230150;201808;159;125;34;119250.0;32436.0;151686.0
230160;201808;921;792;129;755091.0;123066.0;878157.0
230170;201808;595;547;48;517325.7;45792.0;563117.7
230180;201808;77;72;5;68688.0;4770.0;73458.0
230185;201808;405;354;51;336064.62;48654.0;384718.62
230190;201808;2231;1805;426;1717990.5;406087.0;2124077.5
230195;201808;493;429;64;409266.0;61056.0;470322.0
230200;201808;378;326;52;310040.47;49608.0;359648.47
230205;201808;359;234;125;221752.53;119250.0;341002.53
230210;201808;1265;1010;255;961212.94;242487.8;1203700.8
230220;201808;1448;994;454;947512.8;433097.0;1380609.8
230230;201808;891;779;112;742975.2;106848.0;849823.2
230240;201808;1651;1423;228;1356620.8;217512.0;1574132.8
230250;201808;1781;1472;309;1400127.1;294786.0;1694913.1
230260;201808;2997;1841;1156;1752743.0;1101870.8;2854613.8
230270;201808;1360;1091;269;1038596.0;255433.5;1294029.5
230280;201808;2739;2036;703;1935945.2;669994.2;2605939.5
230290;201808;402;363;39;341232.72;37206.0;378438.72
230300;201808;519;385;134;366030.72;127836.0;493866.72
230310;201808;424;318;106;303224.12;101124.0;404348.12
230320;201808;936;797;139;756488.0;132606.0;889094.0
230330;201808;304;244;60;232012.8;57050.0;289062.8
230340;201808;450;361;89;343441.0;84906.0;428347.0
230350;201808;3061;1942;1119;1852601.2;1064951.2;2917552.5
230360;201808;275;216;59;205268.0;56286.0;261554.0
230365;201808;136;109;27;103271.0;25758.0;129029.0
230370;201808;9794;4844;4950;4611696.0;4718512.0;9330208.0
230380;201808;469;402;67;383222.0;62964.6;446186.6
230390;201808;516;287;229;272844.0;218466.0;491310.0
230393;201808;266;220;46;208587.95;43884.0;252471.95
230395;201808;341;276;65;263056.0;62010.0;325066.0
230400;201808;595;472;123;448380.0;116845.92;565225.94
230410;201808;2626;1641;985;1559123.8;938978.0;2498101.8
230420;201808;6150;4054;2096;3847273.2;1994998.1;5842271.5
230423;201808;315;273;42;260442.0;40068.0;300510.0
230425;201808;375;310;65;295139.0;62010.0;357149.0
230426;201808;113;99;14;93720.96;13069.8;106790.76
230427;201808;79;76;3;72504.0;2862.0;75366.0
230428;201808;1371;706;665;673256.9;634410.0;1307666.9
230430;201808;456;371;85;353739.2;81090.0;434829.2
230435;201808;806;569;237;541674.44;224858.61;766533.06
230440;201808;84495;37437;47058;3,56E+13;4,48E+14;8,05E+13
230445;201808;271;189;82;180115.2;78228.0;258343.2
230450;201808;541;438;103;417852.0;98262.0;516114.0
230460;201808;59;49;10;46746.0;9540.0;56286.0
230465;201808;305;248;57;236592.0;54378.0;290970.0
230470;201808;1906;1499;407;1430046.0;387171.1;1817217.1
230480;201808;153;146;7;138997.8;6678.0;145675.8
230490;201808;285;230;55;219420.0;52470.0;271890.0
230495;201808;438;329;109;312983.38;103986.0;416969.38
230500;201808;955;715;240;681156.0;228960.0;910116.0
230510;201808;47;38;9;36252.0;8586.0;44838.0
230520;201808;382;303;79;288675.0;75366.0;364041.0
230523;201808;2139;1346;793;1281713.8;756054.94;2037768.6
230526;201808;298;251;47;239454.0;44047.0;283501.0
230530;201808;672;499;173;473757.2;164088.2;637845.4
230533;201808;186;177;9;168858.0;8586.0;177444.0
230535;201808;350;264;86;251856.0;82044.0;333900.0
230540;201808;1837;1609;228;1532342.1;216939.8;1749281.9
230550;201808;3671;2354;1317;2236722.8;1255640.5;3492363.2
230560;201808;577;441;136;419569.4;128790.0;548359.4
230565;201808;205;150;55;143100.0;51706.8;194806.8
230570;201808;303;268;35;255672.0;33390.0;289062.0
230580;201808;1108;820;288;780028.6;273798.0;1053826.6
230590;201808;964;750;214;711924.1;203869.8;915793.9
230600;201808;258;235;23;223446.06;21942.0;245388.06
230610;201808;336;268;68;255482.0;64872.0;320354.0
230620;201808;170;140;30;132606.0;28620.0;161226.0
230625;201808;722;526;196;500230.7;186116.69;686347.4
230630;201808;1283;1019;264;971840.0;251474.4;1223314.4
230640;201808;3655;3167;488;3014369.8;464774.56;3479144.2
230650;201808;403;351;52;333932.44;49593.69;383526.12
230655;201808;663;577;86;549504.8;81935.76;631440.56
230660;201808;353;298;55;284292.0;52183.8;336475.8
230670;201808;427;380;47;362520.0;44838.0;407358.0
230680;201808;198;180;18;171720.0;17172.0;188892.0
230690;201808;871;758;113;723112.94;107802.0;830914.94
230700;201808;717;609;108;580986.0;102726.8;683712.8
230710;201808;733;694;39;661599.0;37206.0;698805.0
230720;201808;151;128;23;121720.86;21942.0;143662.86
230725;201808;248;197;51;187938.0;48645.0;236583.0
230730;201808;11845;6427;5418;6115246.5;5160127.0;1,13E+14
230740;201808;647;522;125;497702.0;118559.46;616261.44
230750;201808;815;693;122;659930.3;116388.0;776318.3
230760;201808;1341;1159;182;1100953.2;173608.92;1274562.1
230763;201808;316;264;52;249900.95;49608.0;299508.94
230765;201808;7016;3300;3716;3142612.5;3543802.2;6686415.0
230770;201808;4942;2545;2397;2418175.0;2284706.2;4702881.5
230780;201808;689;605;84;574268.1;80121.69;654389.8
230790;201808;212;177;35;168858.0;32589.4;201447.4
230800;201808;1127;825;302;786739.94;288108.0;1074848.0
230810;201808;1308;1163;145;1108500.2;138139.2;1246639.5
230820;201808;339;241;98;228675.0;93492.0;322167.0
230830;201808;937;811;126;770180.44;120204.0;890384.44
230835;201808;280;241;39;228960.0;36491.0;265451.0
230837;201808;165;140;25;133560.0;23850.0;157410.0
230840;201808;914;734;180;698996.5;171434.0;870430.5
230850;201808;1489;1302;187;1241631.0;178112.0;1419743.0
230860;201808;297;224;73;213696.0;69642.0;283338.0
230870;201808;1820;1551;269;1478681.0;256054.0;1734735.0
230880;201808;44;33;11;31482.0;10494.0;41976.0
230890;201808;564;516;48;492141.8;45778.0;537919.8
230900;201808;273;209;64;199386.0;60859.0;260245.0
230910;201808;198;159;39;150922.8;37206.0;188128.8
230920;201808;402;316;86;301464.0;82044.0;383508.0
230930;201808;927;653;274;620100.6;261396.0;881496.6
230940;201808;841;674;167;642519.0;159128.0;801647.0
230945;201808;491;411;80;391618.0;76320.0;467938.0
230950;201808;376;322;54;307188.0;51516.0;358704.0
230960;201808;2581;1752;829;1664375.8;790561.0;2454936.8
230970;201808;1757;991;766;944323.7;729791.06;1674114.8
230980;201808;211;178;33;169812.0;31482.0;201294.0
230990;201808;140;113;27;107802.0;25001.47;132803.47
231000;201808;213;193;20;182214.0;19080.0;201294.0
231010;201808;141;111;30;105607.8;28620.0;134227.8
231020;201808;1305;905;400;861749.0;381600.0;1243349.0
231025;201808;995;753;242;715244.2;229341.8;944586.0
231030;201808;1131;946;185;902480.0;176204.0;1078684.0
231040;201808;140;97;43;91793.88;40291.0;132084.88
231050;201808;988;881;107;838709.9;102078.0;940787.9
231060;201808;144;126;18;120204.0;17172.0;137376.0
231070;201808;1454;1026;428;976563.1;408293.0;1384856.1
231080;201808;260;243;17;231011.1;16218.0;247229.1
231085;201808;568;354;214;336763.0;204156.0;540919.0
231090;201808;240;198;42;188892.0;40068.0;228960.0
231095;201808;164;132;32;125928.0;30528.0;156456.0
231100;201808;129;109;20;103986.0;17839.8;121825.8
231110;201808;355;308;47;291642.1;44838.0;336480.1
231120;201808;293;252;41;240403.23;39114.0;279517.22
231123;201808;141;134;7;127836.0;6678.0;134514.0
231126;201808;304;250;54;238213.8;51516.0;289729.8
231130;201808;4569;3560;1009;3387012.2;961799.25;4348811.5
231135;201808;212;183;29;174582.0;26782.0;201364.0
231140;201808;3099;2286;813;2177305.5;774628.94;2951934.5
231150;201808;364;347;17;331038.0;16218.0;347256.0
231160;201808;1210;957;253;910097.44;241133.05;1151230.5
231170;201808;533;355;178;338670.0;169812.0;508482.0
231180;201808;1656;1410;246;1344376.8;234655.38;1579032.1
231190;201808;193;170;23;162180.0;21942.0;184122.0
231195;201808;217;187;30;177674.0;28620.0;206294.0
231200;201808;832;677;155;645858.0;146610.0;792468.0
231210;201808;608;509;99;484632.8;94446.0;579078.8
231220;201808;1041;752;289;714728.06;275706.0;990434.06
231230;201808;1405;1127;278;1074204.0;264448.8;1338652.9
231240;201808;1389;1008;381;961345.8;362491.6;1323837.4
231250;201808;112;104;8;99216.0;7632.0;106848.0
231260;201808;289;187;102;178398.0;97022.0;275420.0
231270;201808;1010;838;172;793852.4;164088.0;957940.4
231280;201808;59;45;14;42215.0;13356.0;55571.0
231290;201808;7252;4053;3199;3860401.2;3049215.0;6909616.0
231300;201808;627;581;46;554274.0;43884.0;598158.0
231310;201808;713;661;52;629377.0;49608.0;678985.0
231320;201808;570;435;135;414514.0;128770.92;543284.94
231325;201808;91;82;9;78228.0;8586.0;86814.0
231330;201808;2027;1563;464;1485268.6;441130.6;1926399.1
231335;201808;248;221;27;210834.0;25758.0;236592.0
231340;201808;1634;1205;429;1148426.1;408979.8;1557405.9
231350;201808;1213;999;214;952474.0;203584.0;1156058.0
231355;201808;427;371;56;353934.0;53424.0;407358.0
231360;201808;482;379;103;359086.2;98262.0;457348.2
231370;201808;89;75;14;71550.0;13356.0;84906.0
231375;201808;290;212;78;202248.0;74412.0;276660.0
231380;201808;469;384;85;364740.7;80899.2;445639.88
231390;201808;199;162;37;154548.0;35298.0;189846.0
231395;201808;736;459;277;437294.53;264258.0;701552.5
231400;201808;1074;891;183;847456.8;174239.38;1021696.25
231410;201808;1323;1079;244;1025551.4;231804.0;1257355.4
240010;201808;393;178;215;168660.27;204867.1;373527.34
240020;201808;2215;1746;469;1662858.2;447422.0;2110280.2
240030;201808;134;113;21;107802.0;20034.0;127836.0
240040;201808;31;31;0;29574.0;0.0;29574.0
240050;201808;516;442;74;420814.44;70596.0;491410.44
240060;201808;67;63;4;60102.0;3816.0;63918.0
240070;201808;195;152;43;145008.0;41022.0;186030.0
240080;201808;460;308;152;293828.0;144054.7;437882.72
240090;201808;103;92;11;87462.72;10494.0;97956.72
240100;201808;1453;1371;82;1304961.5;78037.2;1382998.8
240110;201808;1003;637;366;606726.25;349021.0;955747.25
240120;201808;138;118;20;112572.0;19080.0;131652.0
240130;201808;286;268;18;254955.55;17172.0;272127.53
240140;201808;82;64;18;61056.0;17172.0;78228.0
240145;201808;701;620;81;590955.3;77274.0;668229.3
240150;201808;20;15;5;14310.0;4741.38;19051.38
240160;201808;42;37;5;35298.0;4770.0;40068.0
240165;201808;36;30;6;28382.0;5724.0;34106.0
240170;201808;93;71;22;67257.0;20988.0;88245.0
240180;201808;78;64;14;61056.0;13356.0;74412.0
240185;201808;44;40;4;38150.46;3816.0;41966.46
240190;201808;13;10;3;9540.0;2862.0;12402.0
240200;201808;3029;1703;1326;1618586.6;1263765.0;2882351.8
240210;201808;169;131;38;124974.0;36252.0;161226.0
240220;201808;1100;790;310;753517.0;295730.47;1049247.5
240230;201808;833;773;60;734608.06;56592.0;791200.06
240240;201808;123;88;35;83252.35;33390.0;116642.35
240250;201808;87;77;10;73458.0;9540.0;82998.0
240260;201808;1801;1342;459;1279581.1;436617.2;1716198.2
240270;201808;191;167;24;158936.4;22610.0;181546.4
240280;201808;43;33;10;30719.0;9540.0;40259.0
240290;201808;50;49;1;46746.0;954.0;47700.0
240300;201808;178;100;78;94827.6;74412.0;169239.6
240310;201808;2030;1118;912;1056437.0;866544.4;1922981.4
240320;201808;206;196;10;186703.77;9540.0;196243.77
240325;201808;4306;2636;1670;2507273.5;1590057.9;4097331.2
240330;201808;66;62;4;59148.0;3816.0;62964.0
240340;201808;106;76;30;72504.0;28620.0;101124.0
240350;201808;90;80;10;76320.0;9540.0;85860.0
240360;201808;443;317;126;302418.0;120204.0;422622.0
240370;201808;41;39;2;37206.0;1908.0;39114.0
240375;201808;69;41;28;39114.0;26712.0;65826.0
240380;201808;228;186;42;177444.0;39973.0;217417.0
240390;201808;15;12;3;11448.0;2862.0;14310.0
240400;201808;76;72;4;68688.0;3816.0;72504.0
240410;201808;11;7;4;6678.0;3816.0;10494.0
240420;201808;901;697;204;662412.4;193566.6;855979.0
240430;201808;264;248;16;235681.89;15264.0;250945.89
240440;201808;78;45;33;42930.0;31482.0;74412.0
240450;201808;213;144;69;136803.8;65826.0;202629.8
240460;201808;61;48;13;45792.0;12402.0;58194.0
240470;201808;237;205;32;194726.66;30528.0;225254.66
240480;201808;15;14;1;13260.6;954.0;14214.6
240485;201808;76;65;11;62010.0;10494.0;72504.0
240490;201808;48;47;1;44628.12;954.0;45582.12
240500;201808;85;67;18;63918.0;17172.0;81090.0
240510;201808;50;35;15;33390.0;14310.0;47700.0
240520;201808;124;119;5;113526.0;4770.0;118296.0
240530;201808;55;49;6;46746.0;5724.0;52470.0
240540;201808;78;67;11;63918.0;10494.0;74412.0
240550;201808;15;13;2;12402.0;1908.0;14310.0
240560;201808;372;276;96;262200.22;91584.0;353784.22
240570;201808;473;294;179;279172.2;170766.0;449938.2
240580;201808;1253;1014;239;961871.9;226848.2;1188720.1
240590;201808;30;28;2;26712.0;1908.0;28620.0
240600;201808;111;108;3;103032.0;2862.0;105894.0
240610;201808;510;426;84;406047.7;79373.0;485420.7
240615;201808;20;19;1;18126.0;954.0;19080.0
240620;201808;97;93;4;88722.0;3816.0;92538.0
240630;201808;35;33;2;31482.0;1908.0;33390.0
240640;201808;26;22;4;20988.0;3816.0;24804.0
240650;201808;238;198;40;188033.9;38160.0;226193.9
240660;201808;99;87;12;82998.0;11448.0;94446.0
240670;201808;293;172;121;161989.3;115434.0;277423.3
240680;201808;49;38;11;36252.0;10494.0;46746.0
240690;201808;49;46;3;43884.0;2862.0;46746.0
240700;201808;190;157;33;149778.0;31482.0;181260.0
240710;201808;1931;1233;698;1175085.6;665873.44;1840959.1
240720;201808;1067;782;285;744873.9;271890.0;1016763.9
240725;201808;66;61;5;58194.0;4770.0;62964.0
240730;201808;133;115;18;109710.0;17172.0;126882.0
240740;201808;243;205;38;194205.78;35298.02;229503.8
240750;201808;38;26;12;24804.0;11448.0;36252.0
240760;201808;33;30;3;28620.0;2862.0;31482.0
240770;201808;147;114;33;108756.0;31482.0;140238.0
240780;201808;685;570;115;542339.44;109710.0;652049.44
240790;201808;37;36;1;34344.0;954.0;35298.0
240800;201808;8762;5963;2799;5650231.5;2663227.5;8313459.0
240810;201808;20128;11113;9015;1,06E+14;8590026.0;1,91E+14
240820;201808;214;136;78;129453.03;74412.0;203865.03
240830;201808;1629;1332;297;1264584.8;283338.0;1547922.8
240840;201808;81;71;10;67734.0;9540.0;77274.0
240850;201808;86;75;11;71550.0;10494.0;82044.0
240860;201808;114;111;3;105894.0;2862.0;108756.0
240870;201808;61;54;7;51516.0;6678.0;58194.0
240880;201808;30;27;3;25748.46;2862.0;28610.46
240890;201808;1194;708;486;671522.75;463640.0;1135162.8
240895;201808;47;34;13;32436.0;12402.0;44838.0
240910;201808;159;144;15;137376.0;14310.0;151686.0
240920;201808;15;12;3;11448.0;2862.0;14310.0
240930;201808;386;350;36;332946.0;34344.0;367290.0
240933;201808;32;25;7;23850.0;6678.0;30528.0
240940;201808;2436;2153;283;2038997.5;267100.9;2306098.2
240950;201808;53;50;3;47700.0;2862.0;50562.0
240960;201808;32;26;6;24804.0;5724.0;30528.0
240970;201808;127;90;37;85860.0;34544.0;120404.0
240980;201808;187;149;38;142146.0;35679.6;177825.6
240990;201808;119;78;41;74412.0;39114.0;113526.0
241000;201808;68;63;5;60102.0;4770.0;64872.0
241010;201808;62;50;12;47700.0;11448.0;59148.0
241020;201808;111;104;7;99216.0;6678.0;105894.0
241025;201808;10;4;6;3816.0;5724.0;9540.0
241030;201808;119;97;22;92538.0;20988.0;113526.0
241040;201808;35;29;6;27666.0;5724.0;33390.0
241050;201808;89;78;11;74412.0;10494.0;84906.0
241060;201808;28;24;4;22896.0;3816.0;26712.0
241070;201808;14;14;0;13356.0;0.0;13356.0
241080;201808;64;57;7;54091.8;6678.0;60769.8
241090;201808;51;42;9;40068.0;8571.69;48639.69
241100;201808;75;65;10;62010.0;9540.0;71550.0
241105;201808;6;2;4;1908.0;3816.0;5724.0
241110;201808;45;43;2;41022.0;1908.0;42930.0
241120;201808;1440;1111;329;1056431.8;313866.0;1370297.8
241140;201808;222;183;39;173629.0;37206.0;210835.0
241142;201808;41;39;2;37206.0;1908.0;39114.0
241150;201808;1230;1081;149;1028556.0;142146.0;1170702.0
241160;201808;22;21;1;20034.0;954.0;20988.0
241170;201808;43;39;4;37206.0;3816.0;41022.0
241180;201808;48;40;8;37985.42;7632.0;45617.42
241190;201808;38;37;1;35298.0;954.0;36252.0
241200;201808;3891;2120;1771;2016945.6;1687613.6;3704559.2
241210;201808;71;60;11;57240.0;9636.0;66876.0
241220;201808;1393;935;458;891525.06;436898.9;1328424.0
241230;201808;243;203;40;193471.2;38160.0;231631.2
241240;201808;53;40;13;38160.0;12402.0;50562.0
241250;201808;1102;1018;84;970314.0;80136.0;1050450.0
241255;201808;47;37;10;35298.0;9540.0;44838.0
241260;201808;639;502;137;478903.22;130698.0;609601.25
241270;201808;47;34;13;32436.0;12402.0;44838.0
241280;201808;99;86;13;82044.0;12402.0;94446.0
241290;201808;109;82;27;78228.0;25758.0;103986.0
241300;201808;79;56;23;53424.0;21942.0;75366.0
241310;201808;52;39;13;37063.0;12402.0;49465.0
241320;201808;28;14;14;13356.0;13356.0;26712.0
241330;201808;62;56;6;53424.0;5724.0;59148.0
241335;201808;62;55;7;51802.2;6678.0;58480.2
241340;201808;186;139;47;132606.0;44838.0;177444.0
241350;201808;61;56;5;53424.0;4770.0;58194.0
241355;201808;40;37;3;35298.0;2862.0;38160.0
241360;201808;49;48;1;45792.0;954.0;46746.0
241370;201808;45;38;7;36127.98;6678.0;42805.98
241380;201808;38;35;3;33390.0;2862.0;36252.0
241390;201808;76;61;15;58003.2;14310.0;72313.2
241400;201808;208;169;39;160558.2;37206.0;197764.2
241410;201808;178;161;17;153594.0;16122.6;169716.6
241415;201808;98;78;20;74412.0;19080.0;93492.0
241420;201808;102;77;25;73458.0;23679.0;97137.0
241430;201808;28;27;1;25758.0;954.0;26712.0
241440;201808;489;406;83;387310.0;79182.0;466492.0
241445;201808;38;36;2;34344.0;1908.0;36252.0
241450;201808;278;228;50;217512.0;47700.0;265212.0
241460;201808;136;125;11;119012.0;10494.0;129506.0
241470;201808;43;36;7;34344.0;6678.0;41022.0
241475;201808;64;62;2;59148.0;1908.0;61056.0
241480;201808;101;72;29;67734.69;27666.0;95400.69
241490;201808;8;7;1;6678.0;954.0;7632.0
241500;201808;47;34;13;32436.0;12402.0;44838.0
250010;201808;101;87;14;82854.9;13356.0;96210.9
250020;201808;31;27;4;25758.0;3816.0;29574.0
250030;201808;819;610;209;580595.2;198337.6;778932.8
250040;201808;339;284;55;270936.0;52183.8;323119.8
250050;201808;234;194;40;184785.8;38160.0;222945.8
250053;201808;54;41;13;39114.0;12402.0;51516.0
250057;201808;0;0;0;0.0;0.0;0.0
250060;201808;456;348;108;331992.0;102745.8;434737.8
250070;201808;701;583;118;554164.0;112572.0;666736.0
250073;201808;7;7;0;6678.0;0.0;6678.0
250077;201808;197;146;51;138892.86;48654.0;187546.86
250080;201808;424;331;93;314153.2;88722.0;402875.2
250090;201808;199;131;68;124020.0;64852.92;188872.92
250100;201808;513;422;91;402588.0;86433.0;489021.0
250110;201808;561;422;139;400804.03;132606.0;533410.0
250115;201808;24;7;17;6678.0;16218.0;22896.0
250120;201808;111;83;28;79182.0;26712.0;105894.0
250130;201808;573;462;111;440748.0;105704.0;546452.0
250135;201808;14;8;6;7632.0;5724.0;13356.0
250140;201808;79;71;8;67734.0;7632.0;75366.0
250150;201808;580;429;151;407712.6;143739.19;551451.75
250153;201808;10;9;1;8586.0;954.0;9540.0
250157;201808;28;23;5;21942.0;4770.0;26712.0
250160;201808;215;168;47;160272.0;44838.0;205110.0
250170;201808;62;44;18;41976.0;17172.0;59148.0
250180;201808;4086;2777;1309;2636195.2;1243688.0;3879883.2
250190;201808;870;574;296;545926.5;282384.0;828310.5
250200;201808;52;43;9;41022.0;8586.0;49608.0
250205;201808;23;20;3;19080.0;2862.0;21942.0
250210;201808;89;77;12;73458.0;11448.0;84906.0
250215;201808;63;54;9;51516.0;8586.0;60102.0
250220;201808;27;21;6;20034.0;5724.0;25758.0
250230;201808;77;70;7;66776.0;6678.0;73454.0
250240;201808;243;201;42;190943.1;40068.0;231011.1
250250;201808;398;340;58;324360.0;55332.0;379692.0
250260;201808;32;29;3;27666.0;2862.0;30528.0
250270;201808;59;46;13;43884.0;12402.0;56286.0
250280;201808;375;312;63;297648.0;60102.0;357750.0
250290;201808;93;88;5;83665.8;4770.0;88435.8
250300;201808;555;379;176;360918.72;167891.0;528809.7
250310;201808;45;41;4;39114.0;3816.0;42930.0
250320;201808;2010;1373;637;1304587.4;606143.8;1910731.1
250330;201808;82;72;10;68688.0;9540.0;78228.0
250340;201808;24;20;4;19080.0;3816.0;22896.0
250350;201808;139;89;50;84619.8;47127.6;131747.4
250355;201808;33;25;8;23850.0;7632.0;31482.0
250360;201808;203;166;37;158364.0;35298.0;193662.0
250370;201808;2386;1617;769;1536420.0;733023.0;2269443.0
250375;201808;14;10;4;9540.0;3816.0;13356.0
250380;201808;53;38;15;36252.0;14310.0;50562.0
250390;201808;42;35;7;33390.0;6678.0;40068.0
250400;201808;15858;8043;7815;7648928.5;7449204.5;1,51E+14
250403;201808;404;329;75;313384.22;71550.0;384934.22
250407;201808;60;52;8;49608.0;7632.0;57240.0
250410;201808;33;28;5;26712.0;4770.0;31482.0
250415;201808;43;29;14;27646.92;13336.92;40983.84
250420;201808;47;39;8;37206.0;7632.0;44838.0
250430;201808;1523;1296;227;1234191.0;216558.0;1450749.0
250435;201808;16;13;3;12402.0;2862.0;15264.0
250440;201808;690;591;99;561121.4;94446.0;655567.4
250450;201808;88;72;16;68688.0;14596.2;83284.2
250460;201808;423;290;133;276660.0;126872.46;403532.47
250470;201808;86;63;23;60102.0;21942.0;82044.0
250480;201808;328;261;67;248994.0;63918.0;312912.0
250485;201808;1;1;0;954.0;0.0;954.0
250490;201808;212;176;36;167904.0;34344.0;202248.0
250500;201808;79;58;21;55332.0;20034.0;75366.0
250510;201808;736;576;160;548741.0;151631.44;700372.44
250520;201808;176;122;54;116368.92;51511.23;167880.16
250523;201808;116;97;19;92538.0;18126.0;110664.0
250527;201808;101;80;21;76315.23;20034.0;96349.23
250530;201808;7;5;2;4770.0;1908.0;6678.0
250535;201808;24;20;4;19080.0;3816.0;22896.0
250540;201808;127;98;29;92776.5;27666.0;120442.5
250550;201808;71;68;3;64872.0;2862.0;67734.0
250560;201808;41;33;8;31482.0;7632.0;39114.0
250570;201808;151;121;30;115434.0;28620.0;144054.0
250580;201808;124;98;26;93267.8;24804.0;118071.8
250590;201808;20;16;4;15264.0;3816.0;19080.0
250600;201808;1243;841;402;800407.4;383508.0;1183915.4
250610;201808;150;130;20;124020.0;19080.0;143100.0
250620;201808;22;18;4;17172.0;3816.0;20988.0
250625;201808;67;50;17;47700.0;16218.0;63918.0
250630;201808;3026;1946;1080;1848444.0;1029253.5;2877697.5
250640;201808;205;171;34;163134.0;32436.0;195570.0
250650;201808;30;20;10;19080.0;9540.0;28620.0
250660;201808;44;34;10;32436.0;9540.0;41976.0
250670;201808;60;40;20;38160.0;19080.0;57240.0
250680;201808;387;318;69;303372.0;65826.0;369198.0
250690;201808;1857;1287;570;1224359.5;543398.8;1767758.4
250700;201808;929;816;113;775065.6;107592.12;882657.75
250710;201808;448;347;101;331038.0;96354.0;427392.0
250720;201808;106;83;23;79182.0;21942.0;101124.0
250730;201808;382;320;62;304326.6;59148.0;363474.6
250740;201808;51;47;4;44838.0;3816.0;48654.0
250750;201808;20652;12425;8227;1,18E+14;7839183.0;1,96E+14
250760;201808;76;56;20;53424.0;19080.0;72504.0
250770;201808;350;230;120;217483.52;112071.35;329554.88
250780;201808;55;41;14;39114.0;13356.0;52470.0
250790;201808;473;307;166;290970.9;157648.5;448619.4
250800;201808;153;141;12;133798.5;11448.0;145246.5
250810;201808;79;61;18;58194.0;17172.0;75366.0
250820;201808;157;129;28;123066.0;26712.0;149778.0
250830;201808;420;288;132;273750.5;125928.0;399678.5
250840;201808;52;50;2;47700.0;1908.0;49608.0
250850;201808;53;41;12;39114.0;11448.0;50562.0
250855;201808;14;12;2;11448.0;1908.0;13356.0
250860;201808;202;147;55;140238.0;52183.8;192421.8
250870;201808;34;31;3;29574.0;2862.0;32436.0
250880;201808;78;60;18;57230.46;17172.0;74402.46
250890;201808;2482;1844;638;1757649.6;607793.5;2365443.0
250900;201808;128;109;19;103986.0;18126.0;122112.0
250905;201808;123;96;27;91584.0;25758.0;117342.0
250910;201808;1179;839;340;799443.6;323969.8;1123413.5
250915;201808;110;77;33;73458.0;31482.0;104940.0
250920;201808;138;107;31;102078.0;29574.0;131652.0
250930;201808;167;103;64;98262.0;61056.0;159318.0
250933;201808;1;1;0;954.0;0.0;954.0
250937;201808;6;5;1;4770.0;954.0;5724.0
250939;201808;32;24;8;22896.0;7632.0;30528.0
250940;201808;101;76;25;72504.0;23850.0;96354.0
250950;201808;70;47;23;44838.0;21942.0;66780.0
250960;201808;92;51;41;48654.0;39114.0;87768.0
250970;201808;1205;858;347;816911.0;330084.0;1146995.0
250980;201808;92;65;27;62010.0;25758.0;87768.0
250990;201808;166;129;37;122593.77;35255.07;157848.84
251000;201808;76;68;8;64681.2;7632.0;72313.2
251010;201808;101;79;22;75362.0;20209.53;95571.53
251020;201808;82;72;10;67877.1;9540.0;77417.1
251030;201808;44;34;10;32436.0;9540.0;41976.0
251040;201808;53;38;15;36252.0;14310.0;50562.0
251050;201808;23;21;2;20034.0;1908.0;21942.0
251060;201808;49;38;11;35298.0;10494.0;45792.0
251065;201808;3;3;0;2862.0;0.0;2862.0
251070;201808;25;20;5;19071.0;4770.0;23841.0
251080;201808;4743;2299;2444;2181740.8;2325023.0;4506763.5
251090;201808;199;171;28;163134.0;26712.0;189846.0
251100;201808;17;16;1;15264.0;954.0;16218.0
251110;201808;45;36;9;34344.0;8586.0;42930.0
251120;201808;1829;1116;713;1059754.2;680202.0;1739956.2
251130;201808;382;312;70;297648.0;66780.0;364428.0
251140;201808;524;342;182;325124.8;173459.34;498584.12
251150;201808;301;262;39;249176.0;37206.0;286382.0
251160;201808;97;82;15;78224.0;14310.0;92534.0
251170;201808;100;80;20;76291.38;19075.23;95366.61
251180;201808;292;185;107;176481.23;102069.23;278550.47
251190;201808;189;129;60;122737.83;57240.0;179977.83
251200;201808;255;207;48;197478.0;45792.0;243270.0
251203;201808;34;32;2;30528.0;1908.0;32436.0
251207;201808;95;79;16;75366.0;15264.0;90630.0
251210;201808;1423;1027;396;978204.5;377116.2;1355320.8
251220;201808;47;37;10;35298.0;9540.0;44838.0
251230;201808;467;390;77;372060.0;73458.0;445518.0
251240;201808;100;72;28;67734.0;26712.0;94446.0
251250;201808;1346;963;383;915812.9;365239.0;1281051.9
251260;201808;13;8;5;7632.0;4770.0;12402.0
251270;201808;343;257;86;245178.0;81901.0;327079.0
251272;201808;64;59;5;56286.0;4770.0;61056.0
251274;201808;27;22;5;20988.0;4770.0;25758.0
251275;201808;24;16;8;15264.0;7632.0;22896.0
251276;201808;17;13;4;12402.0;3816.0;16218.0
251278;201808;8;7;1;6678.0;954.0;7632.0
251280;201808;100;95;5;90630.0;4770.0;95400.0
251290;201808;711;539;172;514206.0;164088.0;678294.0
251300;201808;17;14;3;13356.0;2862.0;16218.0
251310;201808;371;266;105;253760.0;100170.0;353930.0
251315;201808;19;18;1;17172.0;954.0;18126.0
251320;201808;59;48;11;45792.0;10494.0;56286.0
251330;201808;80;71;9;67734.0;8586.0;76320.0
251335;201808;12;7;5;6678.0;4770.0;11448.0
251340;201808;696;413;283;394002.0;268957.25;662959.25
251350;201808;37;35;2;33390.0;1908.0;35298.0
251360;201808;74;65;9;61803.94;8586.0;70389.94
251365;201808;14;14;0;13356.0;0.0;13356.0
251370;201808;5351;3639;1712;3467292.0;1631914.0;5099206.0
251380;201808;50;40;10;38160.0;9540.0;47700.0
251385;201808;3;3;0;2862.0;0.0;2862.0
251390;201808;692;547;145;520694.2;137090.0;657784.2
251392;201808;12;6;6;5724.0;5724.0;11448.0
251394;201808;9;9;0;8586.0;0.0;8586.0
251396;201808;15;10;5;9540.0;4770.0;14310.0
251398;201808;18;15;3;14310.0;2862.0;17172.0
251400;201808;42;35;7;33390.0;6678.0;40068.0
251410;201808;34;29;5;27666.0;4770.0;32436.0
251420;201808;104;78;26;74412.0;24804.0;99216.0
251430;201808;40;37;3;35298.0;2862.0;38160.0
251440;201808;33;22;11;20988.0;10494.0;31482.0
251445;201808;55;50;5;47700.0;4770.0;52470.0
251450;201808;414;364;50;345600.8;47700.0;393300.8
251455;201808;2;1;1;954.0;954.0;1908.0
251460;201808;16;12;4;11448.0;3816.0;15264.0
251465;201808;5;2;3;1908.0;2862.0;4770.0
251470;201808;47;37;10;35298.0;9540.0;44838.0
251480;201808;26;24;2;22896.0;1908.0;24804.0
251490;201808;123;85;38;80613.0;35299.0;115912.0
251500;201808;119;95;24;90630.0;22133.0;112763.0
251510;201808;39;30;9;28620.0;8586.0;37206.0
251520;201808;25;25;0;23850.0;0.0;23850.0
251530;201808;4514;3178;1336;3025786.5;1274248.2;4300035.0
251540;201808;74;65;9;62010.0;8586.0;70596.0
251550;201808;415;320;95;304326.2;90106.0;394432.2
251560;201808;24;17;7;16218.0;6678.0;22896.0
251570;201808;20;20;0;19080.0;0.0;19080.0
251580;201808;124;102;22;97308.0;20988.0;118296.0
251590;201808;121;90;31;86041.0;29574.0;115615.0
251593;201808;24;14;10;13356.0;9540.0;22896.0
251597;201808;55;45;10;42930.0;9540.0;52470.0
251600;201808;1091;777;314;739766.5;297947.9;1037714.4
251610;201808;209;159;50;151686.0;47033.0;198719.0
251615;201808;3;3;0;2862.0;0.0;2862.0
251620;201808;4261;2839;1422;2698565.8;1353823.0;4052388.8
251630;201808;448;331;117;315774.0;111609.0;427383.0
251640;201808;150;106;44;101124.0;41976.0;143100.0
251650;201808;271;198;73;187059.1;69642.0;256701.1
251660;201808;226;204;22;194616.0;20797.2;215413.2
251670;201808;359;279;80;264470.0;76320.0;340790.0
251675;201808;3;3;0;2862.0;0.0;2862.0
251680;201808;98;88;10;83952.0;9540.0;93492.0
251690;201808;344;288;56;273798.0;53073.89;326871.88
251700;201808;285;240;45;228373.3;42915.69;271288.97
251710;201808;22;15;7;14310.0;6678.0;20988.0
251720;201808;31;21;10;20034.0;9254.0;29288.0
251740;201808;10;8;2;7632.0;1908.0;9540.0
260005;201808;3194;1806;1388;1711835.4;1323271.1;3035106.5
260010;201808;1518;1085;433;1030331.5;411079.3;1441410.8
260020;201808;426;376;50;358704.0;47700.0;406404.0
260030;201808;580;419;161;398958.97;153594.0;552553.0
260040;201808;854;531;323;505486.44;308132.47;813618.9
260050;201808;1154;828;326;789674.0;309764.2;1099438.2
260060;201808;413;374;39;356032.8;37206.0;393238.8
260070;201808;1463;925;538;878328.0;510282.38;1388610.4
260080;201808;733;578;155;550601.1;147870.0;698471.1
260090;201808;570;359;211;342258.12;201294.0;543552.1
260100;201808;231;162;69;153738.0;65826.0;219564.0
260105;201808;234;133;101;126882.0;96354.0;223236.0
260110;201808;2768;2051;717;1956645.0;683208.0;2639853.0
260120;201808;2935;1458;1477;1381214.2;1406770.1;2787984.2
260130;201808;156;110;46;104940.0;43884.0;148824.0
260140;201808;2161;1421;740;1347152.2;704415.44;2051567.8
260150;201808;226;149;77;142146.0;73458.0;215604.0
260160;201808;300;256;44;244224.0;41976.0;286200.0
260170;201808;3402;2079;1323;1976606.6;1260758.9;3237365.5
260180;201808;143;121;22;115434.0;20988.0;136422.0
260190;201808;2300;1612;688;1534697.9;656066.0;2190764.0
260200;201808;905;741;164;706139.06;156170.0;862309.06
260210;201808;1418;1010;408;963389.25;388269.12;1351658.4
260220;201808;726;663;63;632502.0;60102.0;692604.0
260230;201808;1209;919;290;874535.0;276660.0;1151195.0
260240;201808;227;173;54;164088.0;51516.0;215604.0
260250;201808;79;61;18;58194.0;17172.0;75366.0
260260;201808;1000;720;280;686880.0;267120.0;954000.0
260270;201808;427;345;82;327747.2;77941.8;405689.0
260280;201808;1413;901;512;859077.0;488162.0;1347239.0
260290;201808;6419;3443;2976;3265865.0;2832394.0;6098259.0
260300;201808;885;781;104;743005.6;98930.0;841935.6
260310;201808;516;410;106;389761.47;101124.0;490885.47
260320;201808;883;661;222;630307.2;211788.0;842095.2
260330;201808;36;27;9;25758.0;8586.0;34344.0
260340;201808;71;52;19;49608.0;18126.0;67734.0
260345;201808;5663;3183;2480;3030405.8;2364862.8;5395268.5
260350;201808;486;357;129;338834.1;123066.0;461900.1
260360;201808;284;145;139;138330.0;132577.38;270907.38
260370;201808;668;439;229;416186.88;218326.0;634512.9
260380;201808;605;434;171;414036.0;161989.56;576025.56
260390;201808;297;252;45;239329.98;41976.0;281305.97
260392;201808;101;89;12;84906.0;11448.0;96354.0
260400;201808;4081;2350;1731;2233282.8;1651003.2;3884286.0
260410;201808;14810;7733;7077;7361467.0;6749013.0;1,41E+13
260415;201808;123;112;11;106848.0;10494.0;117342.0
260420;201808;1787;1073;714;1018565.06;679502.6;1698067.6
260430;201808;192;176;16;166692.66;15264.0;181956.66
260440;201808;226;163;63;154778.0;60102.0;214880.0
260450;201808;476;344;132;326891.0;125928.0;452819.0
260460;201808;844;447;397;423768.8;378733.22;802502.0
260470;201808;370;230;140;218656.8;133465.0;352121.8
260480;201808;211;135;76;128790.0;72504.0;201294.0
260490;201808;216;175;41;166950.0;39114.0;206064.0
260500;201808;1138;768;370;730384.2;352693.8;1083078.0
260510;201808;747;594;153;565722.0;145008.0;710730.0
260515;201808;259;232;27;221328.0;25281.0;246609.0
260520;201808;3341;1990;1351;1891160.5;1286174.6;3177335.2
260530;201808;798;647;151;614745.6;144054.0;758799.6
260540;201808;568;432;136;412128.0;128790.72;540918.75
260545;201808;12;9;3;8586.0;2862.0;11448.0
260550;201808;348;216;132;206064.0;125928.0;331992.0
260560;201808;527;397;130;378452.0;123733.8;502185.8
260570;201808;1018;834;184;792917.8;175249.8;968167.6
260580;201808;262;234;28;223236.0;26712.0;249948.0
260590;201808;662;382;280;363016.1;267120.0;630136.06
260600;201808;8216;4207;4009;3992900.0;3820717.5;7813617.5
260610;201808;493;332;161;316728.0;153307.8;470035.8
260620;201808;3669;1927;1742;1826888.2;1658696.0;3485584.2
260630;201808;78;75;3;71550.0;2862.0;74412.0
260640;201808;3727;2034;1693;1936672.6;1615065.2;3551738.0
260650;201808;317;229;88;218466.0;83336.67;301802.66
260660;201808;510;350;160;333518.4;152640.0;486158.4
260670;201808;103;76;27;72504.0;25758.0;98262.0
260680;201808;3685;2070;1615;1957886.8;1540080.9;3497967.5
260690;201808;122;96;26;91584.0;24804.0;116388.0
260700;201808;327;201;126;190990.8;120204.0;311194.8
260710;201808;37;34;3;32436.0;2862.0;35298.0
260720;201808;2260;1354;906;1285509.8;861977.2;2147486.8
260730;201808;617;467;150;445518.0;140905.8;586423.8
260740;201808;59;55;4;52470.0;3816.0;56286.0
260750;201808;638;443;195;422297.62;186030.0;608327.6
260760;201808;615;331;284;315774.0;270936.0;586710.0
260765;201808;987;521;466;493985.8;444325.5;938311.3
260770;201808;223;168;55;160272.0;52470.0;212742.0
260775;201808;825;492;333;467985.8;317673.0;785658.8
260780;201808;270;176;94;167904.0;89676.0;257580.0
260790;201808;12285;6785;5500;6446798.5;5239287.0;1,17E+14
260795;201808;167;116;51;109500.12;48654.0;158154.12
260800;201808;287;239;48;227529.0;45792.0;273321.0
260805;201808;173;112;61;106119.14;58194.0;164313.14
260810;201808;739;648;91;616942.25;86814.0;703756.25
260820;201808;317;214;103;202826.8;98262.0;301088.78
260825;201808;199;137;62;130524.57;59148.0;189672.56
260830;201808;265;171;94;163134.0;89676.0;252810.0
260840;201808;233;169;64;160559.0;61056.0;221615.0
260845;201808;211;145;66;138330.0;62964.0;201294.0
260850;201808;506;367;139;348454.1;132606.0;481060.1
260860;201808;256;192;64;182970.34;61056.0;244026.34
260870;201808;378;274;104;260156.42;99216.0;359372.4
260875;201808;721;510;211;485426.7;201294.0;686720.7
260880;201808;1597;977;620;930385.3;591289.2;1521674.5
260890;201808;2433;1704;729;1619843.9;694513.0;2314356.8
260900;201808;1039;720;319;685577.8;304326.0;989903.8
260910;201808;280;219;61;208926.0;58194.0;267120.0
260915;201808;306;208;98;198432.0;93492.0;291924.0
260920;201808;177;99;78;94446.0;74412.0;168858.0
260930;201808;389;333;56;317682.0;53338.45;371020.44
260940;201808;2872;1568;1304;1491963.9;1243519.9;2735483.8
260950;201808;2036;1181;855;1120321.9;815670.0;1935991.9
260960;201808;14241;7415;6826;7039200.0;6503795.0;1,35E+14
260970;201808;440;377;63;358869.0;60102.0;418971.0
260980;201808;193;171;22;162847.8;20988.0;183835.8
260990;201808;2580;2123;457;2023025.0;435310.2;2458335.2
261000;201808;4376;2582;1794;2450778.0;1709688.0;4160466.0
261010;201808;185;137;48;130698.0;44974.23;175672.23
261020;201808;612;459;153;437743.0;145962.0;583705.0
261030;201808;226;165;61;157396.0;57945.96;215341.95
261040;201808;368;328;40;312912.0;37873.8;350785.8
261050;201808;476;417;59;397818.0;56286.0;454104.0
261060;201808;1332;883;449;840086.5;428346.0;1268432.5
261070;201808;9086;4617;4469;4379810.0;4255643.5;8635453.0
261080;201808;389;295;94;280658.0;89676.0;370334.0
261090;201808;2266;1739;527;1650426.0;501986.0;2152412.0
261100;201808;1089;766;323;728713.8;306272.16;1034985.94
261110;201808;8174;5006;3168;4770389.0;3019304.5;7789693.5
261120;201808;274;230;44;219420.0;41971.23;261391.23
261130;201808;573;337;236;320974.1;224954.0;545928.1
261140;201808;190;124;66;118296.0;62964.0;181260.0
261150;201808;680;407;273;388278.0;259388.73;647666.75
261153;201808;73;69;4;64872.31;3816.0;68688.31
261160;201808;77562;39080;38482;3,72E+13;3,67E+14;7,39E+14
261170;201808;456;342;114;325638.38;108756.0;434394.38
261180;201808;1810;1119;691;1062403.6;659214.0;1721617.6
261190;201808;613;428;185;407875.12;176481.0;584356.1
261200;201808;217;191;26;181449.3;24804.0;206253.3
261210;201808;34;31;3;29574.0;2862.0;32436.0
261220;201808;2607;1838;769;1747280.9;733053.8;2480334.5
261230;201808;329;245;84;233730.0;80121.69;313851.7
261240;201808;453;391;62;369000.94;59148.0;428148.94
261245;201808;225;189;36;180019.8;34344.0;214363.8
261247;201808;159;122;37;116388.0;35298.0;151686.0
261250;201808;2868;1462;1406;1393928.2;1340213.9;2734142.0
261255;201808;256;232;24;221041.8;22896.0;243937.8
261260;201808;871;752;119;717408.0;113526.0;830934.0
261270;201808;179;139;40;132606.0;38160.0;170766.0
261280;201808;164;136;28;129744.0;26712.0;156456.0
261290;201808;125;87;38;82759.5;36252.0;119011.5
261300;201808;1242;884;358;843336.0;341532.0;1184868.0
261310;201808;769;511;258;486921.8;245511.9;732433.7
261320;201808;554;372;182;354719.0;173628.0;528347.0
261330;201808;930;732;198;695329.5;188046.45;883375.94
261340;201808;301;169;132;161226.0;125928.0;287154.0
261350;201808;810;580;230;552366.2;219420.0;771786.2
261360;201808;1244;807;437;769476.4;416612.0;1186088.4
261370;201808;5037;3094;1943;2937233.2;1850700.5;4787934.0
261380;201808;577;426;151;404505.62;143768.0;548273.6
261390;201808;3463;2305;1158;2194963.2;1101443.5;3296406.8
261400;201808;281;254;27;241743.6;25758.0;267501.6
261410;201808;1086;723;363;689742.0;346297.22;1036039.25
261420;201808;893;561;332;533927.25;316709.47;850636.75
261430;201808;329;299;30;284400.0;28333.8;312733.8
261440;201808;122;111;11;105894.0;10494.0;116388.0
261450;201808;2497;2076;421;1977844.2;401386.03;2379230.2
261460;201808;728;583;145;555228.0;138330.0;693558.0
261470;201808;256;197;59;187128.0;56247.84;243375.84
261480;201808;366;294;72;279237.0;68684.0;347921.0
261485;201808;339;206;133;195856.2;126882.0;322738.2
261500;201808;625;423;202;403542.0;192708.0;596250.0
261510;201808;48;32;16;30528.0;15264.0;45792.0
261520;201808;109;96;13;91584.0;12402.0;103986.0
261530;201808;4193;2661;1532;2529940.0;1460246.1;3990186.0
261540;201808;1098;676;422;644440.4;402588.0;1047028.4
261550;201808;287;144;143;136280.0;136402.92;272682.9
261560;201808;803;534;269;506480.2;255472.6;761952.8
261570;201808;374;292;82;278568.0;78228.0;356796.0
261580;201808;378;295;83;280666.0;79182.0;359848.0
261590;201808;194;158;36;150732.0;34344.0;185076.0
261600;201808;299;241;58;229151.0;54855.0;284006.0
261610;201808;104;92;12;87291.0;11448.0;98739.0
261618;201808;65;51;14;48654.0;13356.0;62010.0
261620;201808;201;122;79;116388.0;75366.0;191754.0
261630;201808;585;452;133;428847.6;126882.0;555729.6
261640;201808;6409;3399;3010;3235284.5;2867926.0;6103210.5
261650;201808;494;317;177;301740.66;168858.0;470598.66
270010;201808;532;471;61;449048.0;57431.0;506479.0
270020;201808;305;244;61;232421.38;58194.0;290615.38
270030;201808;9245;5932;3313;5643012.0;3157882.0;8800894.0
270040;201808;2019;1249;770;1191059.0;733339.8;1924398.8
270050;201808;178;130;48;124020.0;45792.0;169812.0
270060;201808;116;65;51;62010.0;48654.0;110664.0
270070;201808;902;656;246;624300.6;234379.27;858679.9
270080;201808;38;32;6;30528.0;5724.0;36252.0
270090;201808;20;16;4;15264.0;3816.0;19080.0
270100;201808;1252;831;421;789775.5;399487.7;1189263.2
270110;201808;143;107;36;102078.0;34344.0;136422.0
270120;201808;228;187;41;177546.55;39114.0;216660.55
270130;201808;248;172;76;163515.6;72504.0;236019.6
270135;201808;102;63;39;60102.0;37206.0;97308.0
270140;201808;1318;801;517;763297.2;492255.2;1255552.4
270150;201808;267;213;54;203202.0;51516.0;254718.0
270160;201808;529;397;132;378738.0;125260.2;503998.2
270170;201808;742;480;262;456775.2;248707.8;705483.0
270180;201808;71;55;16;52152.04;15054.12;67206.16
270190;201808;101;90;11;85860.0;10494.0;96354.0
270200;201808;107;96;11;91393.2;10494.0;101887.2
270210;201808;482;251;231;239454.0;220087.8;459541.8
270220;201808;185;145;40;138330.0;38160.0;176490.0
270230;201808;2120;1276;844;1210907.8;803268.6;2014176.4
270235;201808;735;556;179;530172.7;170400.95;700573.6
270240;201808;3146;2454;692;2328497.5;657376.0;2985873.5
270250;201808;174;121;53;115434.0;50562.0;165996.0
270255;201808;223;192;31;183168.0;29192.4;212360.4
270260;201808;340;270;70;257580.0;66780.0;324360.0
270270;201808;112;47;65;44829.0;62010.0;106839.0
270280;201808;197;121;76;115434.0;72484.92;187918.92
270290;201808;1191;901;290;858318.44;275783.47;1134101.9
270300;201808;287;185;102;176490.0;97021.8;273511.8
270310;201808;920;738;182;701655.1;172923.12;874578.25
270320;201808;885;755;130;718598.8;123733.8;842332.6
270330;201808;275;230;45;218466.0;42930.0;261396.0
270340;201808;60;48;12;45792.0;11448.0;57240.0
270350;201808;90;46;44;43645.5;41976.0;85621.5
270360;201808;73;41;32;39114.0;30528.0;69642.0
270370;201808;53;41;12;39114.0;11448.0;50562.0
270375;201808;70;41;29;39114.0;27666.0;66780.0
270380;201808;1078;614;464;584802.0;442656.0;1027458.0
270390;201808;196;110;86;104940.0;82044.0;186984.0
270400;201808;707;516;191;491049.28;182214.0;673263.25
270410;201808;697;502;195;478590.03;186020.45;664610.5
270420;201808;409;270;139;255882.0;132530.92;388412.9
270430;201808;32873;23517;9356;2,24E+14;8917865.0;3,13E+14
270440;201808;492;385;107;367290.0;101791.8;469081.8
270450;201808;782;414;368;394074.5;350118.66;744193.2
270460;201808;200;155;45;147870.0;42930.0;190800.0
270470;201808;1397;936;461;892136.44;439794.0;1331930.4
270480;201808;535;433;102;410792.8;96592.5;507385.3
270490;201808;25;20;5;19080.0;4770.0;23850.0
270500;201808;512;420;92;400680.0;87768.0;488448.0
270510;201808;744;454;290;433116.0;276660.0;709776.0
270520;201808;360;221;139;210625.0;132606.0;343231.0
270530;201808;65;57;8;53972.91;7632.0;61604.91
270540;201808;123;94;29;89676.0;27666.0;117342.0
270550;201808;1736;1314;422;1252947.0;402106.22;1655053.2
270560;201808;313;146;167;139284.0;159318.0;298602.0
270570;201808;466;313;153;296677.56;145762.05;442439.62
270580;201808;83;62;21;59148.0;20034.0;79182.0
270590;201808;73;60;13;57240.0;12402.0;69642.0
270600;201808;179;147;32;140238.0;30528.0;170766.0
270610;201808;194;159;35;151677.0;33390.0;185067.0
270620;201808;30;29;1;27666.0;954.0;28620.0
270630;201808;3902;2972;930;2823285.8;885055.44;3708341.2
270640;201808;899;661;238;628790.6;226737.8;855528.4
270642;201808;215;182;33;173628.0;31482.0;205110.0
270644;201808;268;181;87;172483.73;82993.23;255476.97
270650;201808;272;160;112;152640.0;106848.0;259488.0
270660;201808;259;210;49;200340.0;46746.0;247086.0
270670;201808;3188;2429;759;2307211.2;721168.44;3028379.8
270680;201808;469;270;199;257571.0;189841.23;447412.22
270690;201808;1127;713;414;678449.9;394946.47;1073396.4
270700;201808;36;27;9;25758.0;8586.0;34344.0
270710;201808;896;678;218;644468.3;207972.0;852440.3
270720;201808;253;191;62;182214.0;58861.8;241075.8
270730;201808;1945;1133;812;1078641.4;772542.2;1851183.6
270740;201808;44;27;17;25758.0;16218.0;41976.0
270750;201808;647;474;173;452006.0;164375.0;616381.0
270760;201808;304;217;87;207018.0;82998.0;290016.0
270770;201808;2799;1789;1010;1700366.8;962586.0;2662952.8
270780;201808;91;56;35;53419.23;33372.46;86791.69
270790;201808;262;177;85;168858.0;81090.0;249948.0
270800;201808;1992;1600;392;1524607.2;372469.84;1897077.1
270810;201808;299;238;61;227037.69;58185.23;285222.9
270820;201808;159;104;55;99216.0;52375.0;151591.0
270830;201808;910;662;248;630781.0;236302.0;867083.0
270840;201808;1422;1048;374;999052.9;355128.0;1354180.9
270850;201808;1653;1010;643;957378.4;613403.44;1570781.9
270860;201808;2474;1609;865;1532656.4;822312.56;2354969.0
270870;201808;122;66;56;62964.0;53424.0;116388.0
270880;201808;920;686;234;652599.1;222351.58;874950.75
270890;201808;339;247;92;235151.06;87763.23;322914.28
270895;201808;72;62;10;59148.0;9540.0;68688.0
270900;201808;104;79;25;75366.0;23850.0;99216.0
270910;201808;327;260;67;246895.2;63918.0;310813.2
270915;201808;1861;1125;736;1068647.8;700137.2;1768785.0
270920;201808;492;414;78;3949;;
